Mod,likes,downloads,time,unique_dl,views,dl_dif
502,7,519,367,215,9582,304
442,3,110,395,47,5562,63
260,730,9691,436,6019,91962,3672
130,31,1038,458,483,13034,555
507,188,5517,365,2407,28134,3110
953,444,11027,180,5580,48257,5447
347,5,98,416,57,4241,41
961,19,187,178,172,4083,15
632,196,4139,268,1542,53290,2597
70,7,106,467,42,5892,64
83,996,18596,444,13848,153861,4748
714,246,3724,232,2081,32783,1643
188,9,148,448,133,14271,15
422,73,954,400,783,11921,171
618,65,1278,277,976,20316,302
592,9,101,301,81,6003,20
564,125,1207,320,874,31597,333
256,59,1627,437,889,29626,738
1114,88,1796,102,1164,20360,632
414,704,16143,402,11633,78234,4510
220,1,73,443,45,4940,28
436,111,6588,397,881,31350,5707
109,23,946,460,520,19520,426
326,841,12521,420,7269,108659,5252
449,1026,22332,389,13755,122074,8577
282,534,6609,429,4308,46098,2301
1140,34,671,93,531,8631,140
776,76,675,217,582,5996,93
293,16,258,426,139,5496,119
98,3,293,462,125,8540,168
84,417,23352,464,7425,199735,15927
173,30,1205,450,519,14893,686
888,60,939,194,330,13654,609
311,13,649,423,259,10996,390
20,4,46,475,26,3948,20
146,248,2833,456,2231,40747,602
359,361,3937,413,2612,45410,1325
716,54,432,231,385,12916,47
537,14,469,337,235,8282,234
425,72,1615,400,424,25579,1191
289,14,243,426,218,9228,25
798,30,574,211,413,9368,161
547,58,731,332,573,31895,158
913,80,757,189,683,11078,74
416,113,1753,401,1070,28438,683
284,31,293,428,264,10209,29
103,10,416,461,182,7007,234
179,7,152,450,73,4889,79
966,21,198,177,154,7248,44
979,2,35,171,24,2528,11
323,32,574,420,371,14882,203
795,61,613,212,404,9617,209
143,120,4505,456,1831,65987,2674
935,58,1769,183,1322,17959,447
1142,14,122,93,81,3476,41
36,22,679,473,317,11668,362
437,3,47,397,24,4260,23
969,103,1868,175,1453,14149,415
270,82,705,433,556,16081,149
210,4,46,445,40,5361,6
560,286,3582,321,2230,32544,1352
677,132,1338,249,1142,15175,196
981,185,3325,170,2593,31086,732
255,172,2268,437,1007,20151,1261
100,40,328,461,288,22094,40
386,86,1187,409,1041,20555,146
983,41,305,170,284,9746,21
1110,83,1520,104,1251,19370,269
498,13,361,369,177,6995,184
1072,1,7,120,7,784,0
1030,63,678,148,469,7462,209
506,64,1614,366,960,29189,654
741,0,71,224,29,1897,42
22,0,231,474,124,5562,107
468,16,369,382,324,14095,45
1143,21,874,92,475,12873,399
174,24,1077,451,445,12316,632
66,4,129,468,82,11154,47
350,233,13624,415,3697,73477,9927
931,93,1225,183,793,8693,432
524,23,714,351,412,12373,302
851,34,676,199,524,9668,152
207,572,20219,446,7281,197899,12938
297,4,95,425,57,15695,38
226,2,48,442,25,5049,23
773,18,220,218,207,4328,13
47,14,195,471,118,6889,77
625,20,204,272,170,13021,34
770,13,161,218,121,3508,40
635,78,581,267,506,12646,75
757,31,352,221,287,11931,65
899,136,1906,192,1831,20090,75
287,218,2213,428,1694,23811,519
73,1,71,466,31,8280,40
1,6,479,481,190,29871,289
668,505,14990,253,4132,67512,10858
558,913,24201,325,13535,111489,10666
1100,113,2248,110,1914,22270,334
429,47,766,399,614,24398,152
211,3,90,445,43,7327,47
521,161,4079,355,2696,38312,1383
1069,83,1123,121,830,10762,293
366,250,3764,412,2194,37156,1570
792,128,1359,213,1143,9595,216
428,373,6577,399,5442,41029,1135
404,10,624,405,135,8074,489
532,267,6037,343,2741,76494,3296
639,33,449,266,447,12410,2
440,62,1017,396,620,22899,397
258,5,94,436,54,6275,40
184,1,31,449,28,7642,3
970,40,1682,175,1314,23270,368
216,589,17447,444,11030,111439,6417
943,54,1631,181,1184,18649,447
574,715,12172,310,7770,97990,4402
648,109,1396,262,1292,35815,104
296,889,18880,425,9333,128112,9547
514,0,0,359,0,4778,0
77,0,0,104,0,1770,0
1064,127,3196,124,1588,19906,1608
62,3,87,468,30,5353,57
381,333,4219,409,2398,54712,1821
992,41,1129,167,997,21518,132
157,121,3220,453,1946,40401,1274
697,134,1407,236,821,8707,586
420,87,1994,401,1443,18949,551
541,34,293,335,216,22234,77
18,33,854,475,455,18068,399
904,385,9383,191,5464,35285,3919
885,8,258,194,157,3635,101
267,54,471,434,373,17102,98
623,88,605,273,514,9100,91
375,20,2892,410,489,18224,2403
732,15,296,226,146,5221,150
328,462,5241,413,4170,79955,1071
1010,175,2322,159,2157,29202,165
667,175,4370,253,3401,52061,969
649,257,3029,261,1578,18072,1451
599,30,435,294,346,12221,89
351,36,518,415,416,16746,102
335,5,154,419,47,12627,107
424,404,8008,400,5732,35545,2276
253,22,969,436,430,11342,539
575,3,39,309,23,4657,16
551,136,1748,332,908,16568,840
374,83,946,410,640,15656,306
883,54,845,194,401,11722,444
614,16,188,279,146,7652,42
529,270,3749,344,2830,35891,919
939,498,13534,182,7959,93598,5575
803,255,3396,210,2026,32818,1370
538,3,123,337,53,4211,70
46,10,287,471,137,7955,150
332,427,7534,420,5934,52881,1600
858,50,1182,197,663,22832,519
361,3,49,413,42,10545,7
151,1,42,455,21,3377,21
439,2,20,397,12,4212,8
930,6,190,183,105,5306,85
52,12,317,470,152,7603,165
749,0,34,222,13,1594,21
344,36,722,417,658,14037,64
578,403,3653,307,2885,30095,768
932,12,242,183,241,5582,1
496,786,32796,371,10108,159431,22688
354,255,3509,414,2507,30876,1002
1053,24,408,128,378,8836,30
120,8,325,459,253,7142,72
1028,11,86,151,59,7075,27
978,308,12346,173,5442,63731,6904
327,130,1266,420,1057,25046,209
219,13,471,443,304,9251,167
994,49,421,165,375,7760,46
906,307,9288,190,4157,56700,5131
443,42,997,394,506,15498,491
1126,60,602,100,476,8938,126
977,7,293,173,133,9639,160
37,311,4146,471,3451,231453,695
13,35,857,476,380,12256,477
357,10,221,414,106,7432,115
150,2,49,455,24,3841,25
869,85,1101,196,629,12064,472
922,4,213,186,108,4852,105
473,3,85,381,39,4967,46
1129,5,58,97,46,2079,12
621,291,4824,274,2640,48586,2184
406,56,1185,404,730,22667,455
831,264,2939,203,2781,28857,158
286,166,3078,428,1800,30024,1278
478,23,817,378,106,14509,711
57,7,130,470,67,9858,63
779,4,26,216,25,1756,1
664,83,1188,254,618,11001,570
517,6,234,359,74,6877,160
469,2,84,382,29,5058,55
962,531,15974,178,7630,63105,8344
755,41,491,222,297,13476,194
619,0,97,276,56,4299,41
320,685,9322,421,6188,92385,3134
61,1,28,469,15,3532,13
800,32,380,211,311,8464,69
760,124,8531,220,2288,24925,6243
722,1,18,230,18,1745,0
1062,32,527,125,369,6434,158
571,36,359,314,213,6653,146
38,11,194,472,88,6917,106
651,205,4988,259,2221,30377,2767
280,10,207,430,105,7546,102
728,1,11,228,10,1450,1
133,174,2701,457,1700,42008,1001
727,493,9760,228,7510,33752,2250
85,35,572,464,337,13945,235
581,15,221,306,114,3429,107
1133,40,350,94,333,5615,17
912,0,105,189,22,2612,83
927,26,380,184,330,11458,50
451,108,1518,388,892,27364,626
140,28,694,457,381,17537,313
515,72,749,359,515,18783,234
643,274,3313,265,2378,49025,935
319,59,802,421,655,21106,147
224,1,40,442,20,3333,20
941,3,20,182,18,2426,2
116,5375,190654,459,81756,1046279,108898
25,85,3063,474,1474,33833,1589
321,372,6176,421,3611,57482,2565
1122,60,954,101,653,11791,301
617,108,1677,277,967,18275,710
1066,191,3464,123,2867,27993,597
503,678,11578,367,5485,76802,6093
568,18,127,317,113,3928,14
734,34,263,226,245,6469,18
890,121,3220,194,1673,23298,1547
467,162,3368,383,1302,32407,2066
850,197,4435,199,1272,36578,3163
331,561,10952,420,5388,108390,5564
875,200,3550,195,1652,36092,1898
884,154,1646,194,1232,20953,414
1094,125,1684,112,1523,17310,161
739,183,3686,225,2063,28090,1623
1068,30,411,122,206,5181,205
69,14,346,467,179,7027,167
820,11,177,205,113,2824,64
301,452,5421,425,4160,43891,1261
759,11,73,221,69,2097,4
1011,63,375,159,357,6820,18
460,409,9524,385,5288,41307,4236
777,26,546,216,271,4524,275
246,53,712,438,434,26704,278
114,1,44,460,23,4233,21
1046,22,255,140,205,7669,50
1149,0,0,91,0,2471,0
901,15,154,192,150,5890,4
330,1310,36370,420,25199,175927,11171
387,105,1228,408,1006,14910,222
596,26,244,299,203,4433,41
182,17,299,449,184,17311,115
1156,61,2267,90,923,16359,1344
426,409,8431,399,5720,36349,2711
48,36,825,471,476,20527,349
318,135,1612,421,868,27019,744
690,72,1166,241,None,None,NA
569,0,49,317,13,2063,36
764,2,18,220,16,1439,2
631,26,333,268,302,10321,31
45,12,418,471,214,8650,204
113,3,15,460,9,10363,6
836,160,2611,202,1024,26299,1587
268,103,1464,434,1096,21907,368
949,212,3682,180,1961,23124,1721
377,203,1788,410,1295,26992,493
194,6,122,448,69,4136,53
369,571,7372,411,5722,51884,1650
1007,13,181,160,146,13319,35
1083,52,910,117,535,9730,375
536,4,231,339,105,10552,126
1039,193,5145,145,2984,25470,2161
421,518,10291,400,6302,41333,3989
585,96,1328,304,762,16300,566
671,96,813,252,606,15318,207
315,2,311,422,62,6968,249
499,6,473,370,68,7349,405
217,3,77,444,24,1936,53
577,10,254,308,161,6751,93
948,66,826,181,688,13164,138
178,11,299,450,145,5528,154
603,2,100,288,34,4807,66
477,31,1167,379,603,19100,564
445,386,7194,393,5618,57111,1576
767,34,552,219,527,10044,25
849,80,1157,199,451,7668,706
775,47,699,217,587,10014,112
774,52,687,217,648,11815,39
878,0,11,195,10,995,1
212,39,427,444,338,14673,89
573,123,1643,314,1301,34764,342
882,6,83,195,76,2179,7
838,2,21,202,19,1264,2
684,13,463,242,229,5639,234
742,21,327,224,316,9097,11
500,1,70,369,26,3352,44
363,219,4056,412,2078,47572,1978
14,33,1091,475,532,17973,559
999,100,3313,163,1376,18834,1937
1047,213,3544,140,3509,45761,35
898,20,170,192,142,3081,28
854,12,88,198,83,3876,5
958,67,540,179,474,5949,66
866,156,4968,196,1987,23138,2981
53,1057,25034,470,18846,219651,6188
223,3,111,442,59,4066,52
1050,40,1016,137,794,16059,222
681,35,709,245,686,16841,23
812,1,14,208,13,939,1
834,922,51242,203,9616,181415,41626
717,3,32,231,31,3268,1
1145,61,1008,92,859,12781,149
1017,18,350,154,172,8101,178
646,15,271,262,254,7750,17
810,25,566,208,316,5508,250
874,142,1677,196,1538,13944,139
726,24,168,228,128,7929,40
23,9,230,474,142,7029,88
106,13,652,461,219,7784,433
1111,34,340,103,265,7740,75
1041,111,1926,144,1774,22472,152
657,119,1309,251,1162,18289,147
11,0,131,476,49,6944,82
365,5,114,412,75,4075,39
1055,32,249,127,181,9079,68
152,2,70,454,51,5915,19
920,557,13198,186,7174,76380,6024
231,4,43,442,27,4124,16
74,15,274,466,184,9900,90
1054,10,122,127,112,4887,10
860,7,169,197,166,3891,3
937,106,1516,182,1181,15257,335
41,13,210,472,106,7262,104
995,155,2809,165,2252,16477,557
816,4,81,206,41,1976,40
142,3,45,456,21,4046,24
501,4,100,369,58,3541,42
176,6,91,450,44,3012,47
161,21,514,453,373,8755,141
702,26,294,237,262,9355,32
181,2260,51023,449,32586,239210,18437
772,27,346,218,220,7339,126
593,7,85,300,80,4247,5
277,25,583,431,316,17905,267
1044,89,1254,142,1087,16514,167
1130,80,1658,95,1415,12848,243
967,93,2361,176,2254,31506,107
891,11,90,193,83,2708,7
459,1,43,386,23,2294,20
302,38,778,425,578,20401,200
804,170,3150,210,2185,16826,965
180,10,326,449,153,10928,173
39,1,68,472,35,7715,33
1098,61,813,111,641,10208,172
49,10,165,471,93,8306,72
154,0,21,454,14,2952,7
841,64,785,202,636,18669,149
683,327,3954,244,2720,31457,1234
744,131,1346,223,748,18165,598
281,1,35,429,17,2992,18
145,0,16,456,10,3016,6
811,23,264,208,183,13525,81
711,4,26,234,23,2230,3
306,82,2227,424,1447,35802,780
613,243,3049,279,1959,18495,1090
622,99,885,273,710,12131,175
886,133,2020,194,1350,20033,670
50,289,9624,470,4123,104512,5501
982,163,2723,170,2136,17245,587
8,14,382,476,210,18767,172
542,70,804,335,572,25145,232
640,105,1120,266,796,19850,324
372,96,940,411,614,18766,326
876,39,418,195,398,9950,20
1105,20,225,107,223,7189,2
1079,95,1708,119,1212,18605,496
26,25,636,474,353,9751,283
602,19,357,290,314,8835,43
785,5,34,215,30,2003,4
132,14,568,458,263,9701,305
769,34,276,219,231,6485,45
1057,113,1486,125,1352,16117,134
942,32,362,182,210,10195,152
1120,53,773,101,455,9235,318
911,52,968,190,709,12194,259
628,83,679,269,580,11406,99
655,285,7021,259,4518,40527,2503
945,68,661,181,607,9714,54
694,54,504,240,354,12244,150
31,4,210,473,105,6062,105
531,0,68,343,21,3223,47
747,8,91,222,76,2944,15
861,28,596,197,546,10627,50
693,2386,84676,240,56012,281799,28664
1040,4,85,144,52,6117,33
985,87,941,170,895,11259,46
494,49,483,372,315,21884,168
430,278,5305,398,1716,40152,3589
601,373,6210,292,4554,40099,1656
579,6,340,307,124,6867,216
572,124,1002,313,884,17855,118
539,4,300,337,121,8549,179
479,2310,90428,378,39658,242251,50770
400,128,3674,406,1394,55697,2280
1159,31,708,90,370,11128,338
580,37,213,306,147,12685,66
341,11,218,418,114,6984,104
309,255,2959,423,2178,65708,781
189,27,1140,448,369,13728,771
556,247,2249,327,1887,35373,362
24,6,136,474,73,5164,63
370,109,876,411,613,17067,263
1013,83,1058,159,720,10367,338
508,2,63,365,24,4884,39
475,167,2151,380,1187,31731,964
973,0,6,175,3,1779,3
139,1,35,457,24,2644,11
1049,42,555,138,432,10306,123
276,141,2093,432,1363,23535,730
952,39,333,180,266,6001,67
842,502,19841,201,7259,52096,12582
371,1941,63284,411,30770,249581,32514
688,233,2987,241,1674,33211,1313
214,6,171,445,84,6194,87
1095,17,291,112,151,6192,140
733,3,19,226,16,2556,3
781,179,5381,215,2985,45724,2396
835,7,87,202,46,3564,41
633,32,164,268,146,5541,18
880,164,2352,195,1864,28383,488
391,11,206,408,185,19209,21
15,65,2308,475,1145,43003,1163
687,430,6818,241,4563,54217,2255
1003,92,1200,162,1031,8028,169
814,703,36135,207,9526,117468,26609
933,11,183,183,176,5438,7
64,11,182,468,114,6426,68
364,106,3474,412,1700,39245,1774
1092,137,2752,113,851,22365,1901
783,22,654,215,396,5614,258
554,447,4887,328,4062,49368,825
737,1,21,225,20,1744,1
917,105,3270,182,694,18094,2576
905,400,12311,191,5518,54466,6793
725,164,2007,229,1438,21982,569
199,445,11649,447,4226,106318,7423
1000,9,142,163,24,5715,118
796,44,636,212,545,8138,91
401,6,139,406,74,6036,65
438,175,4492,397,2716,41434,1776
586,241,3344,304,1242,38059,2102
791,118,2205,213,1594,31139,611
349,106,1618,415,1286,34495,332
454,302,4786,387,3392,64273,1394
58,21,276,470,187,8601,89
634,201,2263,268,1724,21372,539
19,14,221,475,111,5989,110
126,163,1629,458,1084,30569,545
230,42,1857,442,763,19459,1094
97,7,230,462,89,5514,141
829,185,2705,204,2087,23136,618
34,20,484,473,310,12970,174
615,140,1391,279,1127,18737,264
754,59,1684,222,863,13718,821
1086,0,59,116,18,1456,41
782,15,240,215,220,6117,20
746,55,501,223,448,8997,53
1045,131,5662,141,2567,39297,3095
708,185,4349,234,2832,46885,1517
314,134,1329,422,883,16444,446
273,57,978,433,519,15037,459
35,33,1454,473,719,20875,735
701,13,129,237,126,13572,3
859,23,223,197,208,6735,15
1026,111,2179,151,1696,23107,483
1023,22,188,153,164,4137,24
75,15,187,466,123,7583,64
518,183,2206,358,1762,23589,444
907,51,398,191,324,10712,74
788,676,17336,214,11378,54335,5958
997,59,644,164,399,15399,245
435,8,153,397,80,4850,73
679,291,3421,247,2473,43151,948
863,30,336,197,311,5879,25
1005,0,35,161,21,3809,14
821,3,18,205,16,1579,2
71,60,5049,467,1311,27168,3738
855,258,6422,198,1977,37420,4445
616,177,2401,279,1655,46268,746
853,286,5335,199,3323,35977,2012
606,336,6771,286,3213,69163,3558
1147,18,263,91,202,6354,61
763,56,656,220,500,21593,156
753,431,10813,222,6260,77132,4553
264,108,1146,435,647,22989,499
1119,118,3788,101,1305,22224,2483
1081,0,8,118,7,1810,1
611,16,312,282,273,9563,39
447,192,3541,392,2875,18442,666
867,61,1036,196,530,17087,506
183,375,4939,449,2987,46831,1952
644,23,134,264,127,6300,7
55,20,950,470,272,9317,678
117,4,232,459,117,7011,115
680,34,276,245,262,10531,14
526,103,992,346,708,27054,284
402,175,3761,405,1916,71423,1845
108,11,399,460,173,7914,226
768,165,1821,219,1436,21553,385
910,25,242,190,147,3693,95
193,14,391,448,204,5605,187
397,28,279,406,272,6450,7
715,4,51,232,47,3227,4
661,20,111,256,94,3400,17
1033,253,5529,147,2834,30462,2695
848,4,112,200,78,3560,34
729,146,1878,227,1309,15538,569
940,4,300,182,118,6231,182
1097,55,1662,111,556,11502,1106
44,14,704,472,375,15217,329
316,18,192,422,146,9338,46
1089,38,533,114,491,7985,42
299,5,80,425,47,3913,33
93,96,1269,463,859,37115,410
965,119,2106,177,777,12907,1329
790,1,25,214,23,2128,2
164,295,2533,452,1812,63321,721
1152,5,75,91,66,1949,9
229,353,9893,442,6628,53671,3265
493,335,6136,373,4905,111333,1231
457,2,33,386,19,2380,14
807,2,76,210,41,3037,35
195,6,67,447,52,7315,15
91,6,176,463,54,5723,122
29,32,1196,474,649,15358,547
201,34,2002,447,782,24298,1220
944,18,128,181,112,3369,16
171,163,1814,451,1293,29805,521
822,49,254,205,211,4885,43
232,2,55,441,33,3893,22
587,60,808,303,453,9382,355
159,632,8537,453,5362,82946,3175
894,47,559,193,314,5010,245
431,1355,32966,398,16210,137111,16756
839,244,3392,202,1862,28295,1530
1127,211,5144,100,3108,30397,2036
815,20,343,206,300,6088,43
63,845,15286,468,10531,186084,4755
963,125,2636,177,902,22981,1734
1087,62,1139,115,655,9691,484
1121,4,20,101,20,1313,0
288,117,1053,428,817,17220,236
823,52,1117,204,561,9797,556
719,63,585,231,529,12150,56
533,0,216,343,85,8247,131
1134,7,47,94,41,1285,6
136,4,65,457,64,11340,1
1038,166,2628,145,2285,23473,343
597,1,53,299,13,3127,40
411,1011,10624,403,7757,62420,2867
629,20,266,269,224,8619,42
123,13,895,458,295,8206,600
656,157,1678,257,1245,24980,433
495,287,4277,371,2382,67478,1895
43,4,73,472,44,4351,29
241,9,206,440,112,7525,94
1058,160,2718,127,2496,13362,222
713,3,36,233,36,2846,0
923,3,21,185,21,2016,0
610,809,15359,282,9972,102456,5387
1027,33,292,151,249,4942,43
1032,64,527,148,494,7268,33
383,32,1229,409,406,13212,823
817,13,170,206,115,8920,55
565,286,2731,319,2007,31590,724
177,152,5036,450,2226,67400,2810
959,497,11010,179,6565,64255,4445
187,2,44,448,39,7625,5
557,1321,37871,326,18552,120617,19319
250,0,77,438,34,1780,43
65,8,158,468,90,11623,68
990,45,692,168,316,7447,376
1151,5,66,91,46,2229,20
236,1,63,441,29,3359,34
213,7,144,445,87,9846,57
598,181,2985,294,1137,27273,1848
1024,11,112,152,112,5494,0
358,14,180,413,115,11458,65
390,2,78,408,46,3427,32
647,503,7375,262,4581,69243,2794
251,8,165,438,110,5847,55
956,234,6531,179,2320,64030,4211
562,515,7789,320,6456,105699,1333
1116,162,5205,102,2581,35828,2624
10,177,11864,476,3254,130126,8610
486,129,2284,378,1550,24772,734
263,33,635,435,534,14995,101
456,1,40,386,19,1936,21
721,149,1756,228,1085,19905,671
765,1,21,219,21,1371,0
310,86,956,423,491,23998,465
102,45,1632,461,752,15548,880
295,0,52,425,28,2500,24
877,54,1118,195,583,17221,535
1074,105,3584,120,1699,19288,1885
881,101,1095,195,996,16063,99
712,8,185,233,87,4665,98
528,183,4569,345,2332,41157,2237
1015,24,429,158,399,3910,30
540,37,985,335,600,14880,385
523,408,9912,351,5146,65123,4766
914,397,9498,189,6323,42861,3175
148,4,210,455,105,5085,105
563,49,452,319,344,13601,108
919,5,219,186,87,4321,132
353,3,46,415,28,4182,18
1036,432,11919,146,9064,47247,2855
903,49,651,191,611,9350,40
272,1232,25261,433,15974,233989,9287
964,19,258,177,256,7668,2
248,5,57,438,33,3180,24
410,438,9574,404,3628,51737,5946
584,604,8899,304,7809,41905,1090
1090,16,121,113,82,5044,39
638,297,2733,266,1859,26891,874
709,11,58,234,49,4556,9
916,133,2427,188,1608,20345,819
740,2,27,223,23,1745,4
192,12,214,448,118,8568,96
228,238,5089,442,1733,67882,3356
544,139,1231,330,920,16845,311
474,414,5181,381,3800,51763,1381
118,5,199,459,128,7273,71
204,19,598,446,259,10776,339
466,27,197,383,188,9122,9
262,1256,18890,435,9548,154720,9342
604,23,471,288,433,11320,38
265,206,1978,435,1334,27979,644
738,153,2514,225,1604,21268,910
915,4,44,189,22,2197,22
104,10,187,461,108,5081,79
706,252,3024,236,2338,27564,686
900,45,452,192,421,5615,31
394,1208,25086,407,15189,104559,9897
845,190,3616,200,1549,36972,2067
929,214,5544,183,3510,34808,2034
605,1396,63192,287,18042,290573,45150
345,2,32,417,16,4629,16
512,12,485,360,159,10735,326
1153,3,41,90,21,1417,20
950,47,966,180,487,9321,479
446,27,316,392,284,8831,32
452,3,74,388,36,3431,38
771,1,43,218,41,2936,2
307,858,19780,423,12428,102665,7352
662,3,45,256,42,4224,3
570,22,183,316,147,8168,36
600,1086,23660,292,15898,99452,7762
660,35,451,257,360,13656,91
30,258,11197,474,4276,97238,6921
382,11,620,409,321,8612,299
206,3,57,446,31,3303,26
1102,1,7,109,7,1006,0
720,84,1024,230,589,16758,435
724,3,31,229,29,2569,2
955,24,253,179,213,9693,40
290,6,242,426,95,3838,147
1060,9,160,126,103,3753,57
609,27,216,283,198,7170,18
127,3,198,458,108,6174,90
80,219,6250,465,3441,92128,2809
837,310,5025,202,2897,50738,2128
723,76,843,229,595,16937,248
407,4,77,404,45,4323,32
119,1,54,459,28,4454,26
993,49,384,166,357,8033,27
1037,42,350,145,325,9028,25
291,50,763,426,243,36148,520
976,169,1657,173,1625,14073,32
926,104,1216,183,1197,10645,19
125,3,216,458,76,5911,140
766,25,183,219,177,14666,6
998,14,173,163,136,3286,37
134,37,1865,457,812,26896,1053
696,5,55,239,48,4114,7
704,1946,42163,236,35391,256986,6772
472,10,192,381,127,8423,65
589,199,2567,302,1227,29866,1340
348,5,88,416,64,4181,24
1128,18,273,95,213,5476,60
827,192,2770,204,2187,26646,583
242,1093,16410,438,10398,167981,6012
1020,11,104,156,96,4713,8
1031,46,630,148,378,7992,252
590,19,151,302,122,15950,29
368,5,229,411,134,5023,95
971,54,429,175,373,5095,56
56,39,1247,470,591,15621,656
99,36,1301,461,708,14878,593
1025,14,384,152,373,8936,11
51,6,629,470,178,8961,451
487,10,256,377,141,6372,115
198,16,330,447,111,11752,219
1016,157,2698,158,2041,24688,657
1136,6,49,94,49,5535,0
567,46,374,317,284,6391,90
588,0,40,302,21,2265,19
298,11,442,425,240,7036,202
968,29,638,175,282,11926,356
86,184,4957,464,2783,63515,2174
582,574,8264,305,5265,67728,2999
750,37,314,222,253,10235,61
352,9,189,415,94,4654,95
505,88,774,367,607,20459,167
936,336,11839,182,5761,48247,6078
801,250,3469,210,1918,32361,1551
313,1052,16428,423,10550,92937,5878
591,6,121,301,111,5679,10
434,1,60,397,35,2850,25
735,34,454,226,389,10534,65
918,117,1188,187,922,13902,266
274,20,249,433,193,24582,56
819,6,81,206,77,4018,4
215,3,145,445,57,6041,88
675,109,968,250,707,16007,261
304,89,1486,424,1080,39774,406
444,418,9778,394,5380,40662,4398
543,306,4622,333,3118,41938,1504
409,4,68,404,49,6239,19
1048,43,396,139,246,11110,150
254,18,471,437,254,6256,217
488,4,103,377,41,4489,62
463,5,58,385,50,4226,8
996,3,22,164,19,3394,3
121,9,150,459,84,3556,66
865,1,12,196,11,1769,1
252,17,262,438,207,15621,55
413,657,8835,403,6483,84331,2352
1088,41,852,115,390,6077,462
384,38,1199,409,677,15432,522
846,20,408,200,378,10363,30
797,63,463,211,454,9300,9
641,1049,37689,265,13908,217295,23781
1034,77,1197,147,929,10187,268
928,351,5794,184,3220,36195,2574
1002,35,495,162,311,8508,184
1150,15,351,91,323,8624,28
1085,3,120,115,116,3705,4
833,16,175,198,165,8324,10
595,243,4622,299,1833,27165,2789
169,1432,38600,451,21754,223020,16846
412,449,8766,403,5511,55919,3255
1101,45,979,109,906,11866,73
324,243,7066,420,1984,45357,5082
553,13,228,329,165,7498,63
1106,32,444,107,376,9187,68
471,2,58,381,50,3688,8
676,70,825,249,555,9301,270
924,7,165,185,97,3813,68
691,30,384,241,259,8724,125
752,562,6974,222,5375,46684,1599
857,10,135,198,127,3834,8
1014,116,1008,159,941,15406,67
205,4,60,446,33,3073,27
787,205,3205,214,2752,22886,453
141,2,42,456,28,2801,14
1019,257,5618,156,2991,42538,2627
630,111,1279,269,860,27692,419
555,88,1346,328,798,11043,548
552,11,339,330,171,7017,168
33,7,202,473,111,7370,91
1125,12,164,101,152,3562,12
862,15,84,197,77,4345,7
830,52,527,203,451,8519,76
957,28,219,179,179,4201,40
673,250,4242,251,3005,36865,1237
986,335,5648,170,5481,38618,167
334,16,787,420,291,8073,496
652,1257,47270,259,18851,252788,28419
705,4,22,236,22,3182,0
237,1,62,439,30,3556,32
329,696,11700,420,8602,39255,3098
1051,99,1279,136,1261,21311,18
895,214,4165,192,3280,29329,885
1061,24,230,126,167,9760,63
76,200,7688,466,4362,70508,3326
921,31,479,186,290,6392,189
92,15,338,463,216,7928,122
360,122,1144,413,997,15718,147
980,40,778,171,652,5282,126
389,90,1409,408,685,23921,724
203,72,1392,446,742,26109,650
626,193,3016,271,2557,41813,459
312,7,441,414,121,5663,320
991,5,252,167,90,4807,162
448,5,209,389,80,7253,129
234,118,1426,441,961,34883,465
325,32,836,420,549,16170,287
786,15,132,215,83,3647,49
870,65,920,196,477,13894,443
984,203,4736,170,2064,28823,2672
156,0,31,453,11,5178,20
79,8,174,465,88,6320,86
511,4,143,362,68,6480,75
1035,12,86,146,78,3429,8
110,8,420,460,152,5216,268
1080,42,555,118,479,8240,76
960,38,420,179,224,13344,196
1141,6,52,93,46,2325,6
509,7,116,365,60,6399,56
1008,186,4587,160,1980,31111,2607
1065,3,65,123,56,2444,9
692,19,228,240,185,5114,43
292,880,13117,426,7442,94895,5675
559,51,427,323,342,9500,85
534,1,96,342,42,4702,54
650,383,3522,260,3154,41709,368
245,43,314,438,275,24996,39
654,44,480,259,387,6387,93
261,6,110,436,50,4865,60
379,1,116,410,47,3237,69
32,15,262,473,135,17171,127
659,20,605,257,388,12769,217
405,69,1084,404,570,11021,514
946,89,1379,181,1110,13792,269
843,37,309,201,297,5439,12
561,17,155,321,129,6706,26
367,6,121,412,61,4150,60
235,15,476,441,172,9247,304
423,3,63,400,31,3459,32
1052,234,2980,134,2912,26184,68
343,129,1738,417,1267,11283,471
925,2,22,185,22,1976,0
21,17,440,474,255,14246,185
42,13,468,472,188,7892,280
388,54,929,408,500,20999,429
789,38,501,214,346,8594,155
545,2,38,332,38,3864,0
864,34,388,197,322,4601,66
784,56,569,215,462,6160,107
988,52,665,169,474,7793,191
112,23,1536,460,551,17038,985
583,251,4548,304,3485,42140,1063
455,312,4323,386,2778,40312,1545
94,82,2550,463,2206,57247,344
896,15,265,192,176,4537,89
780,27,269,215,221,5492,48
269,84,749,433,601,19271,148
909,100,1861,190,956,16077,905
337,14,139,419,106,6113,33
695,34,221,240,165,5034,56
700,3,26,237,24,2305,2
645,349,5755,263,4222,68364,1533
432,64,612,398,559,12015,53
427,337,3222,399,2295,32712,927
627,4,126,271,44,3333,82
138,6,68,457,44,5312,24
710,34,241,234,218,10042,23
826,6,140,200,74,3935,66
689,3,209,241,104,5351,105
417,709,11541,401,7572,75338,3969
300,85,5309,425,1191,43939,4118
419,2,55,401,29,2537,26
396,22,337,406,290,30259,47
872,106,1233,194,842,20785,391
1056,23,638,127,614,10593,24
871,21,257,196,255,6297,2
954,111,3601,141,1340,23997,2261
470,36,831,381,781,20776,50
840,73,684,202,512,8142,172
1018,93,1509,156,778,14060,731
778,41,1356,216,543,12206,813
620,371,4814,275,3607,60643,1207
1117,24,260,102,217,5944,43
158,4,116,453,67,7209,49
686,175,3141,242,2234,23812,907
805,48,366,210,199,4176,167
938,42,453,182,339,7519,114
682,628,15339,241,7883,88375,7456
751,57,714,222,429,6972,285
239,30,299,440,267,27925,32
612,1967,56952,280,28729,209105,28223
550,8,205,332,98,6938,107
1021,13,49,155,45,2697,4
149,2,72,455,43,8866,29
222,4,164,442,71,17235,93
271,254,2739,433,1987,33824,752
1091,98,2136,113,1626,20553,510
513,154,1485,360,1198,19584,287
566,62,457,317,398,6019,59
525,584,7539,350,5981,88166,1558
818,298,6391,206,3190,31332,3201