Mod,likes,downloads,time,unique_dl,views,dl_dif
260,7,42,2310,28,11347,14
1951,61,1656,1943,1161,31479,495
3741,176,1568,1064,1243,23959,325
1387,325,8608,2106,4723,78805,3885
1611,1473,24725,2052,14566,215464,10159
3329,123,2710,1549,1611,53554,1099
721,269,10606,2249,4239,86226,6367
3763,201,2785,1057,2283,22415,502
413,134,1926,2294,1299,49383,627
618,393,17310,2264,9298,108897,8012
3735,15,211,1078,125,6246,86
57,21,310,2327,215,59738,95
3764,5,98,1056,54,3488,44
1597,16,931,2055,592,36681,339
256,609,7498,2311,4598,81583,2900
226,90,1024,2314,577,37044,447
130,623,4602,2324,3335,48240,1267
220,3459,62691,2315,38251,393372,24440
436,88,4334,2292,3274,66344,1060
1836,899,20809,1993,13959,318134,6850
1009,112,9138,2191,2718,98494,6420
428,1758,73419,2293,33956,311458,39463
1540,149,5363,2071,2376,106816,2987
282,43,599,2309,329,33375,270
1140,265,6340,2168,4672,45911,1668
84,162,1744,2326,1190,29754,554
2124,193,5859,1858,3830,42393,2029
173,0,11,2320,10,17321,1
3875,96,1581,942,1272,33566,309
311,8,274,2305,113,7654,161
1796,37,783,2002,542,16411,241
20,26,312,2330,207,38978,105
68,95,664,2327,433,100711,231
1447,236,5516,2092,3789,30242,1727
3432,513,6473,1453,4728,26109,1745
425,109,3774,2293,2460,66765,1314
1480,328,11135,2086,4641,46593,6494
4089,13,181,746,112,6450,69
1620,64,1873,2047,914,33800,959
3135,1795,48108,1658,19323,322475,28785
89,45,657,2326,473,46425,184
2065,58,1452,1887,1009,22291,443
418,376,10046,2294,7004,51657,3042
3587,55,1294,1298,770,29322,524
336,3930,58568,2302,37766,570645,20802
103,9,109,2325,82,25304,27
966,18,304,2196,208,7173,96
4013,0,0,841,0,31487,0
641,22,590,2261,421,12894,169
935,822,38445,2200,20735,222929,17710
1800,282,11248,2001,4334,101061,6914
1771,98,3470,2009,1724,32847,1746
355,439,7828,2300,4067,79557,3761
36,119,1113,2329,881,194945,232
437,6,377,2292,300,28276,77
270,1,11,2309,7,111136,4
210,65,621,2316,397,60026,224
1493,10,661,2083,265,27892,396
981,39,1755,2195,1151,32841,604
4027,402,5741,791,4112,53621,1629
3695,199,1920,1131,1520,49781,400
2905,59,1174,1759,820,23883,354
197,28,354,2317,168,27101,186
100,29,258,2325,179,55789,79
208,47,340,2316,219,27734,121
4302,23,480,422,327,5585,153
80,223,2197,2326,1489,174448,708
1630,68,1944,2042,1331,29352,613
3943,29,352,894,218,11249,134
1399,3273,120410,2103,61880,753223,58530
3526,117,2483,1364,1632,41738,851
1093,289,7147,2176,4213,47674,2934
1077,1067,24590,2179,11395,119571,13195
1863,3,122,1982,69,5836,53
22,32,601,2330,316,26234,285
257,53,644,2310,546,42718,98
1647,34,2172,2037,728,24098,1444
4021,82,1020,819,529,20830,491
350,209,2406,2300,1473,42963,933
1179,21,666,2161,449,27464,217
3775,59,1049,1051,648,23590,401
3114,169,2787,1667,1574,21723,1213
2075,48,1591,1884,918,25237,673
524,13,1044,2278,397,24757,647
851,4568,177104,2216,56573,759220,120531
1261,38,1158,2141,686,22041,472
207,754,8261,2316,5635,101568,2626
4284,25,391,424,253,4714,138
1189,65,2187,2157,1488,72662,699
1873,48,2116,1979,1308,35220,808
1734,4864,107406,2016,66481,537159,40925
3835,58,795,974,681,14757,114
3790,861,19005,1022,9976,146914,9029
1779,14,405,2008,284,11526,121
305,72,1114,2305,503,119455,611
2134,32,1088,1853,677,14169,411
1510,6,309,2078,208,11340,101
1041,220,7175,2186,3782,71830,3393
3801,676,11992,1014,8856,64387,3136
2951,7,413,1739,147,13086,266
2068,31,1202,1886,761,46154,441
3662,866,11850,1175,7814,45713,4036
54,30,275,2328,212,51830,63
822,406,11423,2223,7543,72195,3880
558,35,2738,2273,2058,60215,680
817,77,2084,2224,1246,41488,838
231,839,12165,2313,8108,263312,4057
366,13,231,2299,129,53140,102
4159,108,1556,633,1239,23796,317
3973,452,8372,873,3668,55548,4704
2455,465,11265,1835,6956,62809,4309
2544,7,315,1828,207,9324,108
532,152,4563,2277,2707,25682,1856
4008,17,228,852,165,18809,63
3613,23,220,1253,188,4962,32
184,627,7632,2319,4557,468009,3075
919,82,2721,2201,1910,16477,811
463,577,42355,2288,14624,190459,27731
1633,66,2015,2041,1277,42232,738
3257,408,8455,1612,5813,57334,2642
514,10,355,2280,293,25265,62
4258,113,1911,476,993,11213,918
1329,165,13953,2128,4958,124854,8995
518,788,22480,2280,12557,79526,9923
1763,305,4957,2011,3475,53212,1482
1043,136,13173,2186,3691,112095,9482
1373,83,5726,2114,3770,47404,1956
157,1829,22165,2322,15502,207079,6663
4223,15,391,532,231,16975,160
4318,10,124,344,115,5290,9
1113,964,52238,2173,22177,328912,30061
1999,35,1291,1914,916,30272,375
3280,23,731,1603,276,10554,455
2090,19,589,1876,402,25231,187
18,151,2607,2330,1704,91220,903
1564,280,7821,2064,4659,74954,3162
885,101,2440,2207,1481,20829,959
485,205,6343,2284,5136,29068,1207
1194,132,2931,2156,2209,27565,722
3328,888,12900,1552,9319,103042,3581
4126,87,975,683,782,29056,193
328,45,927,2303,354,34197,573
3030,106,1927,1704,1564,15854,363
145,14,102,2323,77,27058,25
649,409,26315,2261,11945,169683,14370
4305,3,70,345,56,3981,14
4122,49,429,687,293,17083,136
4396,24,297,98,259,3567,38
1265,45,1722,2141,1259,55160,463
903,296,9386,2205,5577,74357,3809
2132,24,458,1855,295,15786,163
4216,435,8229,529,2873,49647,5356
883,1227,47559,2207,21840,260517,25719
1934,274,6582,1952,4611,49452,1971
421,43,2286,2293,1637,36874,649
1684,230,15390,2026,5543,63420,9847
803,109,8211,2227,2628,34940,5583
280,163,2136,2309,1655,150500,481
46,48,597,2329,396,114789,201
441,274,12072,2292,6134,102820,5938
1508,424,7925,2078,5217,56001,2708
1418,65,2937,2097,1672,34478,1265
1708,574,19318,2021,10487,125877,8831
3337,128,2524,1543,1555,22054,969
4,717,9831,2330,5749,140671,4082
4145,139,1890,648,1335,22561,555
151,1,22,2323,19,20545,3
1321,3428,73743,2129,42739,219202,31004
828,122,8101,2221,2645,77199,5456
3701,178,2447,1123,1736,39594,711
52,25,245,2328,84,38465,161
4317,15,208,347,198,6211,10
1697,47,1740,2024,883,28764,857
4207,14,223,554,130,6525,93
120,352,4408,2324,3397,60782,1011
4133,373,3889,672,2881,27452,1008
1814,9,224,1999,166,8820,58
327,29,377,2303,201,64381,176
3233,38,660,1623,437,26220,223
179,1050,15269,2319,9561,127467,5708
3146,163,2819,1653,1570,24914,1249
4024,49,328,799,242,7370,86
677,54,2705,2256,1638,42607,1067
1882,826,21256,1976,12648,186598,8608
1126,333,15195,2171,8876,144325,6319
669,33,2215,2258,1495,64890,720
37,10,146,2329,87,46608,59
317,578,8657,2304,5664,143521,2993
4375,16,259,180,179,9256,80
259,2391,42745,2310,24287,382802,18458
1554,559,16817,2067,7727,94243,9090
1986,17,507,1919,359,16764,148
150,2,28,2323,19,25664,9
3939,26,239,899,184,9771,55
869,5,386,2210,228,30112,158
922,101,2678,2201,2011,52215,667
1943,35,802,1945,377,17445,425
1406,633,27393,2101,10823,143811,16570
4273,4,151,441,90,3669,61
1227,105,3833,2149,2624,72364,1209
2870,280,7612,1771,4693,73687,2919
2102,75,2216,1870,1348,29359,868
1334,32,1007,2127,678,56197,329
1056,46,1090,2183,762,11950,328
1725,14,805,2019,555,19627,250
3996,163,5841,860,1206,61720,4635
4214,88,860,541,606,11919,254
202,10114,256388,2317,105349,943525,151039
3674,797,20520,1164,7045,114039,13475
3836,77,822,971,644,14852,178
3427,124,1963,1454,1352,29938,611
142,3,8,2323,7,14913,1
61,1544,21512,2327,14545,154773,6967
4255,29,1378,481,456,14740,922
458,202,5428,2290,3316,28585,2112
3625,67,1787,1230,1152,21822,635
4285,22,385,424,242,5970,143
2920,23,842,1753,419,22394,423
4271,59,1303,446,721,7200,582
1805,34,773,2000,449,10837,324
722,505,10709,2248,7455,43276,3254
1062,46,879,2183,664,17005,215
289,150,1694,2308,1006,40960,688
1477,758,16102,2087,10452,96653,5650
651,974,27070,2260,17273,106320,9797
3316,799,30661,1571,12880,231740,17781
3483,178,3309,1407,2089,21443,1220
1609,11,413,2052,258,26857,155
1828,128,4161,1995,2326,74126,1835
1737,529,18775,2015,5145,71154,13630
3602,17,427,1277,240,14841,187
600,316,14052,2267,6380,100621,7672
581,508,18041,2269,8912,74467,9129
3597,405,6378,1288,3617,46181,2761
3436,213,6070,1449,3962,64740,2108
740,626,30135,2244,16232,205440,13903
1496,24,680,2082,459,11765,221
2120,298,6937,1861,4851,58010,2086
95,1245,13861,2325,9194,178242,4667
3858,165,1922,955,1220,20397,702
4111,41,260,697,183,5324,77
1895,49,3587,1971,870,49717,2717
1211,75,4101,2152,2739,39004,1362
2099,143,2521,1870,1669,33986,852
1124,133,3046,2171,2129,40596,917
321,9,129,2304,113,64082,16
3804,929,13073,1012,7408,68299,5665
3456,420,7157,1440,4987,67732,2170
2066,38,1662,1887,902,20359,760
1206,14,323,2154,245,13397,78
400,98,1380,2296,803,36794,577
192,527,5381,2318,4152,125543,1229
3697,82,1365,1130,780,22626,585
734,761,32763,2246,14363,155745,18400
88,27,549,2326,315,70459,234
1593,22,514,2056,348,7792,166
3969,872,17735,877,9097,77277,8638
284,24,668,2308,376,105604,292
1629,62,2477,2043,1406,75803,1071
593,191,4215,2268,3056,36029,1159
2020,86,3354,1910,2112,38280,1242
1402,702,27392,2102,14876,135437,12516
884,157,3320,2207,1539,26086,1781
1688,106,2077,2025,1489,20967,588
3380,825,12422,1489,7090,54624,5332
4151,171,3117,641,2162,53042,955
69,4324,57266,2327,39258,503647,18008
1654,439,18505,2034,10170,134768,8335
3306,503,7507,1578,4872,39544,2635
3864,72,1165,953,734,33006,431
301,10160,177598,2306,103214,895206,74384
2018,7,464,1911,315,22798,149
3795,85,1000,1020,686,21619,314
690,128,8388,2254,6315,81377,2073
777,1579,54530,2233,30746,359017,23784
4397,12,120,95,110,2582,10
4252,285,18587,483,2332,44994,16255
1127,89,1764,2171,1273,30161,491
1925,4,327,1955,190,9390,137
1168,176,4129,2164,2868,39426,1261
387,366,5503,2296,2965,108530,2538
908,44,2075,2204,1456,31067,619
596,125,7940,2268,4689,101030,3251
182,44,732,2319,520,104795,212
4199,89,726,577,635,20025,91
4019,12,263,821,84,6102,179
731,32,1380,2247,620,53333,760
1937,20,519,1950,294,23886,225
1389,38,1401,2106,882,26082,519
318,12,65,2304,36,34934,29
2009,515,13827,1912,8797,101651,5030
3012,166,2401,1709,1603,24031,798
764,2045,36875,2239,21953,201778,14922
1349,96,4039,2123,2436,49155,1603
3294,157,5640,1596,2029,61233,3611
2033,704,29055,1906,10475,67267,18580
113,44,590,2324,457,39426,133
2981,1348,28657,1729,11456,100796,17201
1219,66,2011,2152,1440,74454,571
2141,67,2089,1851,1310,19295,779
1102,166,5725,2175,3578,51556,2147
1575,22,606,2061,371,17899,235
4266,35,405,451,291,16115,114
4161,49,505,630,362,19722,143
3405,623,11083,1466,5884,62023,5199
1007,62,3474,2192,1677,48884,1797
536,24,817,2276,439,20277,378
1712,180,8413,2020,5025,43905,3388
585,39,1518,2269,1177,20861,341
671,1056,34556,2257,21081,163469,13475
3627,19,240,1229,176,7404,64
4321,12,190,329,130,3641,60
499,11,1207,2282,936,24682,271
265,3,118,2310,55,9183,63
1359,204,5456,2120,3579,59135,1877
1441,41,1700,2093,1175,17395,525
1549,2593,44955,2069,23078,205832,21877
577,11271,409406,2270,170195,1526823,239211
3666,19,225,1171,201,5411,24
1558,199,7268,2066,2945,122184,4323
603,55,1914,2267,1452,62793,462
1991,81,1545,1918,1123,28995,422
519,274,9612,2280,6830,65308,2782
3495,99,2235,1391,1531,29926,704
3327,57,1241,1552,1066,29103,175
4237,40,509,515,452,11691,57
775,358,14954,2234,9210,80242,5744
3477,135,1851,1413,1323,18800,528
1472,813,18420,2089,9706,86360,8714
1076,365,12649,2179,6172,83803,6477
3748,325,6879,1062,4018,41117,2861
1700,76,1214,2023,771,20165,443
500,82,3307,2282,1336,18945,1971
1715,1864,47894,2020,29190,169839,18704
3692,39,654,1135,346,18033,308
1047,48,1809,2185,1060,37868,749
1997,191,6224,1916,4078,49315,2146
3210,1135,16530,1631,10301,132967,6229
1780,1969,51641,2008,27728,149646,23913
4170,142,2133,619,1474,24580,659
1256,69,7177,2142,1125,44203,6052
3934,31,759,907,468,17465,291
4268,3,38,448,28,1919,10
1324,795,30707,2129,17328,133855,13379
4353,53,620,244,428,5751,192
3897,1232,17892,933,12689,99298,5203
1428,385,13893,2096,8494,124843,5399
736,0,756,2245,453,12408,303
1400,42,4522,2103,852,17868,3670
1063,222,10407,2182,6877,181337,3530
1751,20,774,2013,542,31178,232
2081,133,3951,1880,2550,33699,1401
1280,307,6009,2137,4354,50383,1655
2017,8,506,1911,327,18291,179
726,56,1406,2248,875,19237,531
1952,99,6272,1943,2472,41360,3800
814,692,38299,2224,17035,250753,21264
2107,107,1486,1869,947,20701,539
399,119,5397,2296,839,167577,4558
1565,72,2106,2063,1212,30909,894
3120,41,1501,1665,850,27090,651
3850,13,212,959,126,8219,86
3400,324,3800,1469,2634,28005,1166
11,376,9669,2330,3914,151515,5755
1055,1472,143746,2184,28972,495654,114774
4144,51,2575,651,458,21359,2117
1689,87,2313,2025,1450,21793,863
1853,34,1038,1984,647,21191,391
1756,144,2939,2012,2050,32997,889
4293,29,452,423,340,3637,112
496,113,4101,2282,2496,100182,1605
4394,54,613,103,552,9037,61
2042,264,7280,1903,4596,62446,2684
1601,1823,43499,2054,21903,331073,21596
1170,137,11661,2163,4918,64101,6743
816,12528,327489,2224,155696,968776,171793
3057,544,13559,1693,6727,118394,6832
842,213,15543,2218,8861,106814,6682
3776,39,554,1050,455,16298,99
3399,215,3191,1470,2013,21506,1178
1921,101,3576,1958,2459,36459,1117
1642,27,2020,2038,1400,21643,620
2741,114,4288,1805,2172,40499,2116
3797,132,1686,1019,1110,35102,576
3626,440,12062,1230,6719,91574,5343
2116,8,238,1864,151,14926,87
772,104,6860,2237,2796,50625,4064
70,50,323,2327,189,50177,134
3553,506,9013,1341,7143,98331,1870
2855,84,3917,1776,1935,36489,1982
1744,26,647,2014,447,14883,200
967,30,1069,2196,492,11093,577
891,89,3171,2206,1940,19540,1231
302,7,75,2306,53,32925,22
1606,1740,30667,2052,20620,107891,10047
1762,2568,43519,2011,26045,169245,17474
3754,541,9115,1060,6959,53432,2156
1465,13,953,2090,532,28109,421
2056,497,15393,1892,7869,45568,7524
283,3,61,2308,25,13465,36
3774,52,754,1052,560,12432,194
1643,30,2039,2038,1244,20074,795
191,16,182,2318,118,34408,64
3833,46,958,977,625,27266,333
2871,70,2990,1771,1620,39342,1370
4034,820,14099,775,5649,59795,8450
4112,40,493,695,283,15741,210
811,138,3502,2225,2236,23298,1266
1385,214,7729,2107,5086,98188,2643
3744,7,55,1063,49,2994,6
3551,52,768,1342,611,13287,157
613,168,6512,2265,3922,89860,2590
3767,115,2896,1055,1280,29081,1616
982,105,5187,2195,3548,66716,1639
8,955,12598,2330,9056,89088,3542
1380,152,14198,2110,5870,92320,8328
3658,39,576,1183,498,15573,78
2036,40,1013,1905,783,13689,230
719,57,1152,2249,879,24057,273
4299,21,421,422,299,4331,122
1522,505,19447,2075,10596,125826,8851
1087,31,1047,2178,753,78215,294
1894,132,5141,1971,2412,58337,2729
3942,612,11744,898,4555,100614,7189
1367,1625,41124,2115,20119,125836,21005
737,93,1502,2244,1055,44990,447
3411,141,1547,1462,1186,19460,361
3643,550,7977,1203,4948,44611,3029
132,35,404,2324,289,42211,115
498,203,5404,2282,3778,60527,1626
3137,19,381,1658,199,11217,182
3914,2675,64574,924,24878,342338,39696
3404,22,1062,1466,766,26311,296
3883,46,1188,937,720,44857,468
616,99,5793,2264,2689,69448,3104
4026,15,176,792,122,8390,54
1804,30,947,2000,605,32349,342
2913,104,2214,1754,1113,17589,1101
3440,367,7302,1447,4704,40091,2598
3616,13,281,1247,233,8185,48
4063,199,2582,768,1587,14140,995
1075,138,2638,2180,1722,72817,916
1815,59,2893,1999,1304,61884,1589
225,61,737,2314,511,35493,226
2002,402,13591,1913,6927,62988,6664
3313,0,0,1573,0,7508,0
1660,8249,246973,2033,122767,1184009,124206
1950,6,203,1943,149,11169,54
124,131,1046,2324,721,21372,325
1084,15,292,2178,164,10447,128
3952,163,2985,887,1588,48308,1397
703,1176,33590,2250,22622,129725,10968
542,70,4547,2275,3089,88510,1458
4361,12,175,217,143,8717,32
579,20,381,2270,225,29285,156
1475,11,1013,2088,577,29570,436
3359,235,5717,1516,3200,61825,2517
479,293,10913,2286,7381,61286,3532
1192,79,6661,2157,2774,72108,3887
466,293,5391,2288,3491,31525,1900
580,77,1905,2270,1340,32662,565
4064,42,446,768,302,4707,144
2074,30,840,1884,465,10083,375
1862,120,4951,1982,3078,45761,1873
24,25,473,2330,216,40158,257
3410,82,926,1464,698,13938,228
4311,306,11825,397,2318,47637,9507
2022,349,10068,1910,6454,77234,3614
3578,395,4435,1319,3451,33465,984
1961,13,383,1936,293,17312,90
1199,77,2114,2155,1454,48776,660
1850,7,312,1987,212,8001,100
973,79,1399,2196,870,22496,529
3691,60,924,1136,653,16689,271
3924,788,11686,910,7137,55238,4549
1769,116,7013,2010,2459,69398,4554
4140,19,166,659,114,12696,52
1602,105,3232,2054,1835,34977,1397
1591,275,4905,2057,3222,36844,1683
1821,5,390,1997,240,14108,150
254,6,222,2311,98,15616,124
3345,104,1376,1536,1030,20639,346
867,336,6020,2211,4460,42002,1560
3352,131,3309,1525,1771,75732,1538
1848,15,617,1987,457,17426,160
986,54,2235,2194,1378,36036,857
1232,4,208,2148,152,11549,56
1266,109,7214,2140,3686,76624,3528
687,1002,29265,2255,17159,90559,12106
3009,789,10732,1710,7065,51273,3667
4286,0,14,424,9,2049,5
933,236,6004,2200,3669,50569,2335
2970,119,1959,1733,1303,15839,656
1726,73,3333,2018,2042,30186,1291
60,6,26,2327,17,26495,9
931,7,312,2201,163,20146,149
4169,65,770,619,621,11758,149
1419,4,244,2097,172,11754,72
723,104,9462,2248,6950,56053,2512
2039,29,743,1904,512,18193,231
1092,27,1317,2177,821,33288,496
1104,84,2156,2175,1668,22247,488
1174,112,2352,2163,1736,22292,616
1834,65,1565,1993,1057,27084,508
1276,131,3252,2138,1581,41836,1671
119,308,5404,2324,3489,142638,1915
889,154,4441,2206,2636,76619,1805
725,60,4014,2248,2877,53148,1137
1840,359,7632,1990,5610,31760,2022
278,38,560,2309,228,23386,332
2759,17,730,1801,341,20449,389
1353,149,2323,2122,1669,26775,654
3381,334,11966,1489,3839,73432,8127
1201,1208,43506,2155,17490,157212,26016
3539,73,1229,1354,882,29694,347
586,158,3870,2269,2647,28932,1223
4068,91,858,766,598,7574,260
4291,18,415,423,308,3475,107
3641,15,412,1205,245,17352,167
287,37,559,2308,355,38943,204
769,26,652,2238,527,38595,125
2030,103,3298,1907,2021,30897,1277
1230,171,12570,2149,3135,72836,9435
3765,7,175,1055,85,6670,90
3920,70,1113,912,557,24136,556
97,175,3798,2325,2132,188810,1666
829,797,37452,2221,19088,222288,18364
2209,124,2839,1846,1586,29600,1253
4219,29,149,536,112,10782,37
4081,18,211,757,127,5554,84
297,304,3001,2307,2034,49388,967
4129,19,340,676,185,17143,155
746,284,9000,2243,6095,66374,2905
4281,14,336,424,229,2919,107
1278,453,12618,2138,8609,150757,4009
2092,185,8304,1875,4997,100021,3307
662,238,7171,2259,5787,115276,1384
2113,71,5232,1867,1041,26464,4191
546,18,869,2275,646,27613,223
273,57,1050,2309,643,129195,407
35,180,6061,2329,1248,157573,4813
4108,209,3791,704,2044,41869,1747
701,239,3920,2250,2616,40672,1304
2010,185,2368,1911,1594,58158,774
3659,21,420,1180,241,18912,179
2535,282,3889,1829,2493,27673,1396
433,265,6808,2292,4661,36054,2147
4290,10,130,424,91,3780,39
3771,604,11777,1054,6525,49525,5252
2998,278,7167,1719,3897,43434,3270
1677,466,7569,2029,5320,37963,2249
435,3967,179904,2292,71312,783063,108592
1067,431,12945,2182,7589,51938,5356
4191,25,308,591,186,13306,122
2206,156,2848,1846,1898,20642,950
1750,64,2180,2013,1451,46035,729
1005,119,6407,2192,2735,57989,3672
821,154,6949,2223,3290,62891,3659
806,61,1464,2227,1008,34512,456
1233,219,6000,2148,4860,33979,1140
4308,35,863,411,552,15479,311
606,322,15669,2265,8306,75494,7363
767,1493,36342,2238,23117,132406,13225
1910,338,8521,1962,5549,71493,2972
3594,34,975,1289,642,26016,333
2571,473,7069,1826,4264,36275,2805
1673,32,2162,2030,821,26100,1341
1119,83,3240,2172,1953,57847,1287
892,5,150,2206,112,10747,38
4015,52,951,807,571,17859,380
611,742,27138,2265,17185,125054,9953
1517,223,5846,2077,3701,21655,2145
1332,38,998,2127,709,18376,289
23,3614,58189,2330,38467,349363,19722
628,152,15584,2263,3595,87154,11989
3759,6,144,1058,80,5883,64
2027,7,223,1907,171,15826,52
4378,44,447,157,390,6653,57
1382,230,10933,2108,6434,112853,4499
1942,36,1527,1946,917,25213,610
2706,280,13328,1810,5959,134985,7369
2063,399,11137,1888,7486,41550,3651
3636,162,4405,1213,2591,48947,1814
4215,295,3213,540,1853,42351,1360
2053,160,3012,1893,1578,35880,1434
4359,3,64,222,51,3042,13
910,264,8701,2203,4470,51275,4231
1703,82,4798,2022,2244,60988,2554
193,29,374,2318,274,33790,100
397,25,269,2296,200,20894,69
2097,181,4291,1871,2369,35183,1922
272,11,129,2309,109,63768,20
848,78,8397,2216,5546,76472,2851
1996,209,10415,1917,2856,57781,7559
3542,120,2663,1351,1928,42542,735
1286,7,520,2135,400,23653,120
1754,42,938,2012,596,22367,342
728,517,10823,2248,6858,84408,3965
3326,50,1097,1553,709,17968,388
44,8179,113090,2329,78692,629344,34398
1886,119,2841,1974,1957,23580,884
1981,380,13901,1923,8242,93800,5659
1070,40,2207,2182,773,29160,1434
1210,184,5602,2153,3559,52133,2043
1416,638,18340,2098,8326,60073,10014
3356,85,1406,1520,1204,33703,202
965,90,2584,2196,1691,24936,893
164,183,1982,2321,1104,75127,878
3098,4540,112599,1676,52949,714869,59650
684,206,5113,2255,3894,67780,1219
1432,610,17897,2095,10920,98253,6977
493,29,1931,2283,1318,37813,613
1221,60,2116,2151,1247,27953,869
3770,6,150,1054,103,7336,47
694,57,1365,2253,773,22819,592
1757,155,4303,2011,2500,63341,1803
2919,286,7284,1753,4311,65330,2973
91,1053,22319,2325,11122,358156,11197
3732,55,1310,1085,911,31199,399
31,116,1566,2329,968,55195,598
3529,80,1703,1361,1102,19983,601
73,3073,48761,2327,34978,452322,13783
1563,25,1644,2065,1087,40641,557
4240,251,8750,509,2761,76558,5989
232,444,5852,2313,4008,125667,1844
3293,197,2780,1596,2025,26944,755
2972,5,237,1733,101,15042,136
3749,13,283,1061,175,6992,108
1984,53,2690,1920,1046,40800,1644
63,109,1154,2327,695,85635,459
3339,1413,49757,1542,18945,213506,30812
1777,40,2003,2009,790,44267,1213
2055,465,9195,1892,6700,38935,2495
3995,11,149,862,108,6477,41
1569,84,2458,2063,1196,71354,1262
240,164,1470,2312,1035,38605,435
823,1464,26376,2223,18936,131966,7440
3689,71,768,1137,569,16158,199
3877,101,2321,941,1478,43131,843
482,10,582,2285,317,20998,265
1134,966,35507,2169,22450,296046,13057
116,24,423,2324,302,68384,121
4066,63,763,768,502,5917,261
3560,802,10753,1333,7734,93038,3019
1824,211,13980,1996,6552,81639,7428
1994,325,8979,1917,4221,41386,4758
1908,206,5041,1963,3345,104119,1696
123,11,204,2324,150,35569,54
589,1057,33161,2268,16818,205989,16343
1430,1991,85422,2096,48340,401015,37082
2050,372,9378,1897,6653,62618,2725
3822,16,515,987,220,14614,295
43,73,1168,2329,586,53530,582
1944,25,1318,1945,630,16759,688
241,46,584,2312,220,32028,364
1058,1542,61903,2183,35005,443505,26898
674,9,598,2257,323,14254,275
3760,119,1462,1058,1217,17865,245
610,17,746,2265,436,26072,310
2070,17,380,1886,261,10983,119
2052,335,16215,1893,6106,82645,10109
59,54,802,2327,567,51379,235
1861,65,472,1982,360,18672,112
3656,130,2193,1188,1408,44349,785
959,330,6849,2196,4438,58680,2411
1223,865,29691,2151,15970,156680,13721
1790,246,8865,2004,4258,66526,4607
3562,60,1031,1327,616,27034,415
2915,24,1903,1754,460,51660,1443
4379,19,423,154,254,5854,169
1393,35,1843,2105,843,32579,1000
3655,632,10257,1189,6546,99699,3711
65,33,295,2327,225,43985,70
990,394,6443,2194,3770,40019,2673
2857,61,2129,1775,970,36735,1159
3050,273,3708,1694,2561,21268,1147
1173,11,269,2163,178,13063,91
1716,304,6903,2020,4266,87299,2637
1923,135,3409,1955,1856,20311,1553
1272,29,695,2139,500,21448,195
1739,21,1234,2015,699,22899,535
358,2,34,2299,23,23445,11
3363,95,1721,1512,1323,48736,398
390,108,1834,2296,1296,63981,538
251,19,161,2311,63,63023,98
1361,2582,48558,2119,31092,148472,17466
3254,367,6841,1612,3643,75181,3198
2172,104,5327,1848,3134,51013,2193
1394,116,2850,2105,1432,43411,1418
902,7,456,2205,242,15216,214
4210,48,509,545,345,15688,164
1721,228,5459,2019,3465,51541,1994
3303,25,609,1584,443,21891,166
286,7796,148997,2308,72359,1047923,76638
4280,12,347,424,240,2930,107
3425,282,3170,1455,1930,40224,1240
9,840,12122,2330,7145,168440,4977
1262,615,11621,2141,6997,61385,4624
310,31,681,2305,264,48865,417
3868,279,8386,951,3236,80550,5150
4341,30,445,274,290,6838,155
3295,3570,159095,1594,48232,804505,110863
1244,62,5161,2145,2892,48993,2269
3681,121,1885,1157,965,13552,920
4010,156,2334,843,1893,49552,441
1074,118,3783,2180,2276,39495,1507
3700,181,3544,1125,2065,36013,1479
4200,400,10264,572,4166,42115,6098
2570,21,409,1826,291,14938,118
2112,72,1380,1868,872,18687,508
670,83,1478,2258,1015,17916,463
3783,46,1123,1042,683,24678,440
3731,81,1583,1088,1290,23450,293
2785,86,2100,1792,1106,18698,994
3384,522,7001,1486,4679,73041,2322
563,127,4809,2272,3703,53089,1106
572,21,492,2271,310,13497,182
1640,504,24494,2039,7536,126458,16958
3756,7,40,1059,35,4068,5
1036,169,8326,2186,2855,34292,5471
14,7252,163463,2330,83677,1165319,79786
964,104,2135,2196,1597,28862,538
248,1045,13002,2311,9038,176546,3964
1870,8,366,1980,171,14587,195
4398,2,26,94,20,5209,6
832,247,8487,2221,4109,120994,4378
4032,14,107,782,90,7135,17
4235,9,249,516,120,4378,129
1209,189,7741,2153,5378,69051,2363
1341,1024,36487,2125,16835,98779,19652
4226,383,4817,525,4084,26184,733
1538,189,6145,2072,2601,42549,3544
1957,34,1220,1940,677,25305,543
3335,59,4374,1544,1008,41264,3366
1395,521,35908,2104,10691,143381,25217
544,15,778,2275,572,30363,206
3127,900,26919,1663,12229,156826,14690
3869,3022,46288,947,37460,234363,8828
3782,1278,44522,1042,13865,103229,30657
247,23,230,2311,122,38090,108
1949,2805,48594,1944,26329,291683,22265
3361,455,7070,1512,5086,45146,1984
1444,3374,156083,2092,56009,574878,100074
604,31,1678,2266,927,47301,751
570,115,2817,2271,2157,22847,660
3196,123,8513,1633,1450,43695,7063
4363,47,918,211,575,15316,343
104,71,680,2325,491,121782,189
706,1718,43571,2250,26173,197467,17398
520,579,13597,2279,10064,119837,3533
929,137,2172,2201,1553,14625,619
813,42,1084,2224,865,20112,219
3807,82,1236,1008,640,16908,596
2015,2,321,1911,220,12382,101
4264,12,255,453,153,7473,102
3256,855,21944,1612,9567,114454,12377
1486,1006,44490,2084,16302,216855,28188
1860,7,354,1982,236,7587,118
1467,989,18649,2090,12871,88030,5778
40,13,211,2329,156,42691,55
1773,28,780,2009,534,12657,246
3668,10,113,1170,90,8057,23
4166,93,1928,619,724,21155,1204
997,16,518,2192,381,37427,137
698,31,1800,2252,1337,35899,463
1615,937,20831,2050,13376,71645,7455
1772,31,409,2009,289,13788,120
660,515,12721,2259,8541,69930,4180
4163,14,174,626,93,3532,81
1618,17,292,2048,171,13263,121
30,61,814,2329,542,47964,272
4384,29,419,132,248,5326,171
1975,27,449,1926,331,14650,118
3742,24,272,1063,184,6683,88
188,217,1429,2318,1136,102767,293
724,75,3346,2248,2348,49356,998
4395,39,348,98,297,4588,51
1420,2657,45970,2097,21806,251916,24164
1060,380,6549,2183,4479,37869,2070
609,169,3500,2265,2372,40493,1128
127,625,9986,2324,6146,202365,3840
1730,429,9406,2016,5908,51492,3498
1617,1725,100183,2049,18638,476917,81545
1153,283,8482,2165,5491,51516,2991
4023,173,1559,802,1068,25086,491
1931,82,2321,1952,1590,39437,731
392,16569,307574,2296,164744,2760385,142830
2787,56,1371,1792,884,15760,487
3725,340,4751,1093,2769,71989,1982
356,32,322,2300,244,52385,78
914,119,6555,2202,4715,43718,1840
1483,370,16454,2085,9861,100511,6593
1960,934,32818,1936,14809,268284,18009
160,1,65,2322,38,27649,27
1376,145,5508,2112,4092,54912,1416
915,154,5102,2202,3727,53699,1375
1752,193,5037,2012,2057,25376,2980
2869,107,4162,1771,1525,44575,2637
766,114,5478,2238,3358,70116,2120
209,115,1401,2316,934,35860,467
134,1,6,2323,6,11184,0
4261,25,748,464,398,12819,350
567,314,10285,2271,7121,71649,3164
3812,37,915,997,348,14959,567
3506,914,18710,1379,13955,149696,4755
2003,1179,27736,1913,16442,111465,11294
472,5,187,2287,123,11581,64
4205,50,440,559,341,12939,99
4101,1346,49580,724,10409,188460,39171
3481,178,2752,1408,1105,19431,1647
312,76,886,2305,587,52109,299
827,485,15315,2221,8205,103911,7110
1300,9,253,2133,172,8464,81
1131,2267,57421,2170,32718,376443,24703
1187,241,6756,2158,4355,40867,2401
486,1595,34715,2284,22694,112048,12021
3644,6,143,1202,88,10945,55
1735,11,598,2016,222,12080,376
2061,12,320,1889,236,15687,84
1429,313,5870,2096,4264,58401,1606
368,7,51,2299,34,30019,17
2977,29,574,1731,339,11847,235
56,83,719,2327,496,66935,223
177,441,6992,2320,4972,104147,2020
1269,14,866,2140,590,25045,276
4370,35,419,183,257,9653,162
1022,36,699,2188,421,21979,278
198,34,711,2317,263,71928,448
1257,49,1558,2142,914,22126,644
1267,21,1067,2140,802,18759,265
4018,223,4275,821,3052,83394,1223
4168,112,1428,619,1060,21917,368
1414,431,14353,2098,7893,74317,6460
1409,222,24570,2099,9407,136294,15163
762,604,19707,2240,12528,94519,7179
1753,61,1614,2012,1043,41946,571
429,5228,152605,2293,79123,613198,73482
3854,969,20044,956,9840,141165,10204
1624,36,987,2045,575,14619,412
582,213,9276,2269,4446,49823,4830
3509,200,6847,1376,3136,67893,3711
352,45,414,2300,284,24210,130
4117,692,11251,692,6121,85575,5130
2137,195,9233,1853,5028,57017,4205
423,135,11856,2293,5633,121869,6223
1225,11,293,2150,233,31194,60
2044,307,6971,1902,5182,39061,1789
735,949,24387,2245,16208,135504,8179
1304,137,5095,2133,2124,49812,2971
1866,5,131,1981,97,17938,34
274,118,1840,2309,1005,54338,835
3595,564,7978,1289,4905,109820,3073
2069,31,937,1886,661,18903,276
955,296,7501,2197,5150,77944,2351
4009,126,2074,850,1407,32969,667
1745,210,5301,2014,3594,42991,1707
1988,13,320,1919,197,25058,123
1876,2055,89975,1978,31491,440551,58484
304,15,448,2306,236,48365,212
4231,16,415,520,232,8032,183
1108,7,609,2174,420,68374,189
385,8747,123705,2297,82886,572347,40819
267,60,549,2310,398,20791,151
4377,5,92,166,68,1703,24
3628,32,522,1229,351,11243,171
1498,14,617,2081,450,23739,167
3540,68,1558,1354,958,41132,600
944,4,307,2198,101,21735,206
2540,0,0,1828,0,24916,0
4143,243,2690,656,2231,50501,459
805,43,1771,2227,1182,24353,589
1417,0,133,2098,90,6899,43
1767,102,1735,2011,1240,24760,495
1366,29,787,2115,576,18368,211
1511,229,10571,2078,6036,51480,4535
525,1047,25721,2278,16948,211632,8773
4332,4,59,303,36,2812,23
347,2609,43337,2301,26533,431545,16804
1034,48,1971,2186,1325,44847,646
3781,674,27680,863,6496,79889,21184
4017,63,625,823,457,9558,168
332,579,12812,2303,6459,220852,6353
1911,154,2471,1962,1651,15159,820
146,149,1773,2323,870,69078,903
2851,20,794,1778,509,23626,285
3647,5,293,1196,190,12374,103
540,945,17583,2276,9708,81229,7875
1607,224,9544,2052,2806,40910,6738
3263,805,31050,1611,10696,167942,20354
339,53,900,2302,588,46507,312
1101,10,240,2175,181,8298,59
1648,135,2807,2037,1780,16755,1027
434,37,3218,2292,2479,69128,739
3036,171,5155,1701,2403,31800,2752
667,74,2237,2258,1635,38495,602
3719,168,3054,1099,2121,41681,933
3640,1038,27388,1205,11646,165752,15742
676,493,11238,2256,6243,91525,4995
4156,81,848,638,640,18897,208
691,1011,50922,2254,18562,120147,32360
3556,56,751,1339,643,33255,108
1570,52,2840,2063,1667,58422,1173
873,973,53222,2210,17735,129804,35487
752,12,850,2242,480,23664,370
1560,57,1295,2066,932,21263,363
4119,192,2342,692,1321,33926,1021
857,93,2320,2214,1569,51491,751
3709,269,4021,1115,2850,41614,1171
141,1,85,2323,43,11158,42
1019,12,266,2189,189,15261,77
4327,26,289,312,193,6086,96
2078,554,10491,1881,5691,89447,4800
3532,186,4153,1357,2296,46890,1857
4218,67,1175,537,688,78999,487
599,156,16577,2267,4594,104466,11983
4278,5,51,425,36,3723,15
4257,5,89,476,55,5117,34
4358,84,761,223,572,11175,189
862,329,9284,2212,5652,55830,3632
673,20,1061,2257,807,14061,254
3023,7,447,1706,281,24058,166
535,277,5519,2276,3701,28821,1818
391,39,518,2296,265,27826,253
3965,204,2187,881,1528,28652,659
895,124,4247,2206,2154,60464,2093
45,28,565,2329,301,84172,264
393,661,8442,2296,6448,82005,1994
980,467,18901,2195,9106,62934,9795
3688,152,2377,1138,1587,80936,790
1473,29,1921,2089,1049,48405,872
626,135,2536,2263,1784,36380,752
1369,268,10946,2114,5953,51473,4993
3780,27,719,1048,291,15119,428
1519,494,10769,2075,7500,139354,3269
3682,290,4384,1157,2480,49411,1904
951,123,2544,2197,1833,41892,711
3663,557,11620,1174,5288,78103,6332
668,54,1238,2258,922,25704,316
4116,5,124,692,97,6503,27
4279,23,504,424,355,5684,149
1284,138,3449,2136,1924,18456,1525
1819,14,874,1997,273,15300,601
156,98,1583,2322,908,53279,675
1723,84,1471,2019,787,22904,684
491,37,4238,2283,1923,47040,2315
3629,135,1746,1229,1287,22651,459
1002,52,1828,2192,881,28033,947
1556,206,10083,2067,6062,74872,4021
3525,35,719,1364,317,35438,402
1362,67,1701,2118,1124,20576,577
2971,5,376,1733,204,18110,172
462,225,17777,2289,7726,117722,10051
4376,48,760,165,587,15586,173
1065,102,18086,2182,2218,74690,15868
3332,67,882,1546,654,19871,228
1013,205,3399,2190,2024,30729,1375
371,27,160,2298,108,18764,52
534,65,2059,2277,1338,30783,721
1720,7,119,2020,89,9223,30
3837,47,987,971,508,13802,479
3829,10,213,979,133,8198,80
1520,184,6750,2075,3286,72982,3464
802,57,4799,2227,2469,45156,2330
939,2081,45134,2199,34820,141713,10314
4234,36,638,517,588,19326,50
245,28,477,2311,315,13043,162
592,2,125,2268,97,14561,28
654,174,6546,2260,3763,80630,2783
4250,324,4286,485,2597,39363,1689
379,312,5198,2297,3650,126222,1548
659,51,858,2259,630,11028,228
1188,71,1504,2158,1152,15367,352
3772,7,114,1053,69,5762,45
1195,4,79,2156,66,6102,13
4298,18,392,422,310,4221,82
843,214,8321,2218,3992,50418,4329
644,104,7570,2261,2980,71394,4590
4343,24,776,269,536,15301,240
702,85,3127,2250,2273,34691,854
1125,129,3108,2171,2167,15098,941
1253,258,22768,2143,4700,88469,18068
2887,72,1253,1765,747,16527,506
343,61,761,2301,490,25481,271
3605,16,316,1272,241,15350,75
925,81,1902,2201,1345,21797,557
42,29,239,2329,144,31922,95
1918,22,453,1958,311,12946,142
4180,26,354,608,293,14738,61
1795,1436,47514,2002,22992,201243,24522
1990,272,4789,1918,3128,48371,1661
3710,528,13127,1114,5961,68162,7166
3743,7,124,1063,83,5420,41
2963,5,111,1736,62,17283,49
1027,83,2303,2187,1528,51060,775
1242,185,6641,2146,4402,48120,2239
488,7,721,2284,493,25127,228
1973,875,35779,1929,13649,218911,22130
1928,40,1809,1953,1220,27641,589
1482,33,1055,2085,711,18712,344
503,27,865,2282,682,28169,183
5,166,1679,2330,1240,77440,439
4198,333,3150,580,2400,37727,750
2016,5,293,1911,201,15455,92
10,19,173,2330,111,12887,62
1959,47,1399,1940,635,21650,764
2577,1210,41838,1825,16011,119773,25827
2106,213,10830,1869,6298,94414,4532
2005,18,538,1913,310,44132,228
765,133,14996,2239,2731,72929,12265
190,170,3667,2318,2073,127290,1594
909,11,390,2203,315,26094,75
1186,9,556,2158,332,11545,224
1112,1414,34788,2174,17822,237431,16966
3386,160,3967,1483,2791,57905,1176
427,34,1357,2293,1033,34523,324
826,1936,35087,2222,24428,124004,10659
47,44,428,2328,320,68423,108
3842,145,1907,971,1496,28893,411
3910,127,3800,928,1023,43580,2777
2997,880,12822,1721,7645,54500,5177
3007,86,1286,1712,746,25684,540
1935,133,4360,1952,2435,54399,1925
3479,85,1865,1410,1316,24240,549
1277,19,1076,2138,587,31968,489
954,211,4240,2197,2922,32534,1318
4031,95,1145,784,814,17485,331
840,1897,32872,2219,14954,120239,17918
620,61,2538,2263,1848,24808,690
2077,316,5031,1882,3948,24458,1083
242,9,126,2312,93,21025,33
4172,65,2678,617,683,28902,1995
1841,41,1764,1989,1282,25248,482
4115,92,1025,693,651,13652,374
374,168,3269,2298,2248,153597,1021
2067,112,1062,1886,727,14567,335
334,5,45,2302,29,20697,16
3255,663,17763,1612,7949,97877,9814
2549,63,1753,1828,753,13043,1000
531,71,4331,2277,1831,32207,2500
3094,6,233,1677,106,11469,127
4167,155,3536,619,2309,28638,1227
2824,4,204,1784,66,11718,138
314,2299,47101,2304,26503,429944,20598
1898,16,779,1966,497,25109,282
3683,188,2572,1156,1892,23112,680
168,4,36,2321,31,17611,5
1340,4,229,2125,150,11753,79
566,90,5064,2271,3533,53723,1531
3227,34,990,1626,593,44884,397
1596,1027,27457,2055,10845,129064,16612
1185,3430,88104,2159,52591,446907,35513
502,10,283,2282,216,17552,67
442,62,3506,2291,2799,34363,707
459,173,7835,2290,4856,75218,2979
4176,37,276,613,245,7744,31
3902,30,250,808,178,9707,72
507,171,5714,2281,4006,45947,1708
2012,2,277,1911,192,13091,85
3423,155,1980,1456,1526,24736,454
2914,26,992,1754,633,27287,359
4162,7,129,628,85,3953,44
1619,768,11388,2047,7043,59583,4345
1603,36,956,2054,578,20865,378
983,11,413,2195,332,17815,81
1169,407,18581,2163,7880,159164,10701
249,106,951,2311,616,21968,335
4197,216,3843,582,1957,46081,1886
1879,32,765,1978,431,25850,334
1053,335,10635,2184,3740,53583,6895
326,31,407,2303,273,17140,134
4160,49,811,631,474,17541,337
449,93,6488,2290,4260,158978,2228
794,43,1661,2229,1255,30271,406
2105,670,20710,1869,10867,104041,9843
678,166,3565,2256,2594,36808,971
276,16,267,2309,141,25665,126
776,86,6100,2234,3853,61197,2247
293,96,1314,2307,877,40167,437
1851,27,1118,1986,592,18904,526
1616,315,8402,2049,3794,71906,4608
200,759,7477,2317,5450,237311,2027
888,130,3092,2206,2044,50912,1048
1144,0,1563,2167,1136,33071,427
1976,97,2401,1926,1208,17147,1193
1293,17,243,2134,179,9989,64
1504,1617,34748,2079,23280,302148,11468
4294,20,425,423,326,3414,99
3844,12,139,967,108,8075,31
793,2366,83320,2229,47615,534386,35705
831,510,26733,2221,11953,156690,14780
4300,3,31,422,27,4978,4
3862,35,295,953,195,6486,100
1902,2452,54200,1965,32575,396420,21625
547,101,2178,2274,1442,32272,736
4131,81,946,674,630,11160,316
1348,37,711,2123,516,20209,195
1939,72,2475,1948,1674,32361,801
4272,24,395,445,262,12762,133
1610,271,12302,2052,5526,74662,6776
994,933,31650,2193,19542,145772,12108
2031,71,1957,1906,1170,34557,787
906,245,13433,2205,6974,115248,6459
497,244,7250,2282,4476,64084,2774
143,4,29,2323,22,17884,7
1490,760,23769,2084,14262,170754,9507
1355,113,6320,2121,3451,55290,2869
653,35,1792,2260,1071,21413,721
1731,600,27153,2016,13379,187672,13774
1440,33,684,2093,455,13726,229
1818,43,1301,1998,876,23898,425
169,1,12,2321,9,13911,3
1680,91,2139,2028,1379,31661,760
3722,5706,93411,1098,49608,337199,43803
3279,101,3873,1604,1331,53968,2542
809,431,5615,2225,4051,99248,1564
3420,463,9066,1458,6310,97128,2756
255,26,248,2311,160,24598,88
4074,96,823,764,554,6576,269
1573,21,1030,2062,608,18789,422
306,43,573,2305,425,124281,148
2755,92,3208,1802,2048,75383,1160
2714,36,740,1810,474,18830,266
2123,223,7510,1858,4657,45750,2853
3630,49,1356,1225,616,33848,740
1273,42,571,2139,439,13924,132
1281,460,13904,2137,8822,69647,5082
506,132,3810,2281,2253,65122,1557
2135,32,1317,1853,992,14082,325
1760,400,20175,2011,7083,61205,13092
1143,46,1423,2167,1007,32766,416
1704,63,1454,2022,709,23076,745
1692,577,43094,2024,7404,120986,35690
1015,80,4790,2190,2164,48750,2626
510,544,22028,2281,9914,79855,12114
3276,11,248,1606,144,8328,104
3810,45,854,997,217,10587,637
1625,9,577,2045,352,10884,225
1356,86,3916,2121,1018,22833,2898
3252,754,14329,1612,8378,98503,5951
4082,83,832,757,570,8465,262
2007,4,164,1913,100,12080,64
1927,649,20584,1955,10118,110635,10466
166,918,8499,2321,5587,289436,2912
3504,397,6207,1381,4133,40373,2074
3705,228,4180,1120,2159,52952,2021
1940,349,11443,1948,7557,62561,3886
1729,203,7909,2017,2792,39761,5117
4313,10,145,390,84,6350,61
1160,16,477,2164,297,15082,180
3671,520,8872,1168,5390,47304,3482
1852,14,468,1985,325,16444,143
3652,109,2012,1192,1272,60836,740
279,4,57,2309,39,26110,18
58,45,471,2327,359,52336,112
642,23,416,2261,318,16005,98
211,45,386,2316,285,63672,101
1872,313,12380,1979,8101,70327,4279
1069,38,1168,2182,740,21788,428
167,503,5149,2321,3528,95313,1621
1827,0,259,1996,173,12655,86
3413,85,1646,1460,809,12551,837
1152,615,17668,2165,12937,125119,4731
471,4,559,2287,402,27715,157
785,30,1059,2231,791,53403,268
440,13,1229,2292,720,28571,509
1858,9,377,1982,265,10712,112
2521,255,6360,1829,4371,61297,1989
1639,8,172,2039,113,10967,59
943,22,901,2198,551,23784,350
3001,272,4154,1716,2490,25434,1664
648,813,18818,2261,12268,72327,6550
296,81,1373,2307,565,86970,808
1464,492,12674,2090,8541,136467,4133
4399,0,42,92,40,1828,2
3241,39,800,1621,373,18201,427
4312,17,123,391,77,10548,46
3321,64,2396,1568,1263,47010,1133
4062,22,208,768,150,9927,58
1016,0,1029,2189,825,23589,204
2013,2,337,1911,228,13695,109
1857,33,612,1982,399,10703,213
2139,31,1185,1852,780,28031,405
2014,5,288,1911,189,13066,99
1979,14,761,1924,296,27188,465
666,636,29843,2258,16760,197155,13083
1343,633,19534,2124,9250,119840,10284
1812,41,1210,1999,731,21292,479
375,15,230,2298,159,16529,71
6,49,777,2330,283,42003,494
1317,1,64,2130,44,15778,20
4393,43,502,106,343,5769,159
2641,27,735,1820,458,13515,277
1299,125,2394,2133,1721,22309,673
4346,38,399,265,313,7302,86
351,250,3794,2300,1692,179500,2102
335,479,5001,2302,3101,60639,1900
424,140,2014,2293,1372,25576,642
253,29,195,2311,146,20345,49
575,21,582,2270,330,22191,252
712,2351,158096,2249,50182,575787,107914
90,62,717,2326,525,47331,192
34,92,532,2329,350,133027,182
403,199,3281,2295,2034,48460,1247
3496,393,6770,1391,3629,84266,3141
147,32,309,2323,201,41170,108
4301,3,43,422,36,8611,7
4348,49,714,262,352,6870,362
3694,14,197,1134,141,8445,56
1146,64,3104,2166,1607,30155,1497
3843,35,518,969,304,16905,214
1533,2113,79608,2072,34227,434346,45381
4097,17,428,730,224,11374,204
2952,5,194,1738,90,14206,104
439,116,4194,2292,3195,50324,999
2080,43,1197,1880,730,19529,467
930,1404,31589,2201,20382,118459,11207
3574,60,1324,1321,1044,13861,280
1525,166,3233,2073,2276,21620,957
344,11,77,2301,58,61302,19
1491,146,5309,2084,2439,82870,2870
932,41,2480,2200,917,27072,1563
4003,97,1276,856,562,10444,714
354,2900,83562,2300,31757,686662,51805
550,133,3876,2274,1996,45742,1880
1028,0,7614,2187,4011,66593,3603
1856,44,1052,1982,546,17045,506
1718,203,7375,2020,4567,89353,2808
1308,192,15726,2132,7047,112508,8679
250,30,439,2311,193,15153,246
136,401,5559,2323,4342,94285,1217
1985,711,19368,1919,6926,104614,12442
4275,76,1525,438,1175,27234,350
1398,82,2931,2103,2144,26130,787
1774,41,1679,2009,1160,23641,519
322,22,400,2304,153,39987,247
1413,191,3465,2098,2643,35479,822
3403,18,270,1466,179,12583,91
1178,115,1445,2161,1038,18489,407
2672,1315,25859,1817,12551,100137,13308
333,178,2157,2302,1286,73884,871
697,704,16613,2252,10578,61899,6035
1663,243,5759,2032,4030,42690,1729
4344,16,354,269,252,7815,102
473,7317,231366,2287,112141,779073,119225
3584,26,491,1310,405,17611,86
3010,228,4027,1710,2612,21293,1415
361,134,3902,2299,1609,71171,2293
1690,229,8790,2025,3932,71579,4858
1365,200,8131,2116,4554,131921,3577
478,9,224,2286,180,13428,44
178,139,818,2320,647,79740,171
664,16411,402094,2258,207564,1087590,194530
3645,139,2248,1200,1327,25232,921
1487,43,1340,2084,884,31389,456
2059,74,2007,1890,906,12806,1101
619,10,284,2264,216,15303,68
1823,127,2591,1997,1545,39182,1046
1651,119,2486,2037,1385,31804,1101
320,23,242,2304,147,14233,95
755,406,15126,2242,8475,104377,6651
3855,39,605,955,382,6975,223
760,72,3640,2240,2344,34684,1296
879,21,416,2209,324,36840,92
3435,243,6319,1451,3788,47697,2531
1854,122,3621,1983,2319,41144,1302
1954,64,2286,1942,1568,52813,718
4211,280,4135,545,2754,35700,1381
1011,38,2300,2190,608,38871,1692
2019,1022,32714,1910,12392,140194,20322
1972,1,57,1930,39,13532,18
3598,41,1052,1288,760,12839,292
2372,9,401,1840,186,22130,215
1071,138,2558,2182,1759,45680,799
1148,52,1581,2166,644,23493,937
133,14,49,2324,43,38558,6
727,326,20365,2248,12756,166404,7609
3362,185,3728,1512,2647,46223,1081
363,19,161,2299,126,25967,35
4329,57,790,308,511,7348,279
1423,122,4154,2097,2427,31462,1727
912,457,14917,2203,7956,96168,6961
3746,57,713,1062,514,10141,199
874,1582,61552,2210,25205,277280,36347
3251,67,1694,1612,1119,22400,575
295,195,2620,2307,1290,45703,1330
1742,454,10583,2014,7189,106593,3394
1732,1288,61729,2016,20547,139784,41182
4355,96,1108,241,798,9819,310
4331,150,6776,302,974,31084,5802
1320,363,8926,2130,6197,49300,2729
346,307,3817,2301,2522,100808,1295
1676,83,1448,2029,863,27669,585
319,9,195,2304,111,49214,84
224,7,69,2315,52,6178,17
1835,167,4364,1993,2188,44998,2176
50,27,408,2328,266,53968,142
372,58,1272,2298,743,25677,529
25,81,1286,2330,821,94969,465
632,24,857,2262,653,51912,204
1313,345,13195,2131,5193,99001,8002
2784,1104,24908,1792,12041,92500,12867
1066,0,12770,2182,7019,95505,5751
1830,478,18380,1995,7279,141900,11101
957,23,1558,2197,734,19406,824
1905,90,2945,1964,2170,33882,775
1214,298,6871,2152,4641,71723,2230
2130,18,405,1855,236,16920,169
1832,1131,42624,1994,19276,157944,23348
1650,56,2248,2037,1200,23973,1048
890,55,1089,2206,643,19469,446
2636,1986,42015,1820,24408,249056,17607
1782,27,673,2007,404,18267,269
1247,33,757,2144,550,26495,207
3805,23,562,1009,323,9654,239
66,80,627,2327,445,72995,182
1200,73,1385,2155,1043,18085,342
1438,94,5665,2094,1323,32578,4342
820,65,3113,2223,2274,59329,839
1509,31,1321,2078,697,13049,624
1920,51,1347,1958,909,24863,438
4241,53,721,508,502,11926,219
183,221,2868,2319,1823,143002,1045
264,22,293,2310,223,12442,70
791,104,4405,2230,3164,49998,1241
4242,39,625,508,464,11241,161
3667,8,339,1170,200,15985,139
1435,4991,173476,2094,71664,350299,101812
624,17,737,2263,602,21948,135
4287,1,24,424,12,4459,12
1120,9303,292336,2172,117498,870726,174838
2062,497,9418,1889,6114,35181,3304
114,302,6163,2324,3383,93141,2780
1833,131,3695,1994,2388,20040,1307
3808,13,289,1005,117,15866,172
4288,1,9,424,7,3409,2
4179,77,938,608,643,18792,295
330,11,131,2303,93,25411,38
3112,244,10876,1668,5317,90778,5559
1622,66,2692,2046,1856,24187,836
1390,3990,119712,2105,56792,428902,62920
1156,143,18452,2165,5465,70432,12987
2096,34,770,1872,528,13507,242
126,470,26705,2324,4954,277166,21751
3755,13,315,1060,190,10085,125
4127,359,7229,682,2366,60832,4863
808,22,654,2226,461,17717,193
76,41,554,2327,336,19801,218
3304,358,10294,1581,5329,111059,4965
135,34,604,2323,357,34121,247
2064,264,4656,1888,2482,36428,2174
1566,420,14727,2063,6842,52960,7885
268,157,2111,2310,766,51965,1345
1635,21,1378,2040,440,16647,938
2001,77,3525,1913,1504,40700,2021
4150,54,723,642,483,12728,240
1644,3,235,2038,122,20855,113
1323,39,726,2129,495,27991,231
1808,659,16166,2000,7019,89088,9147
1003,43,1295,2192,924,23523,371
3466,19,622,1432,373,23244,249
131,17,104,2324,53,23012,51
3096,71,1221,1676,718,12027,503
3906,763,13681,929,6467,119906,7214
4185,16,226,599,200,6371,26
3469,63,1097,1426,786,15346,311
893,172,14749,2206,5713,93526,9036
3690,110,1257,1136,938,20442,319
85,5,43,2326,26,22815,17
2861,353,9212,1773,5521,74836,3691
412,194,2760,2294,2010,53569,750
1404,75,2441,2101,1695,28957,746
2922,29,1660,1752,523,19597,1137
1207,11,475,2154,359,20132,116
2617,177,6844,1821,3706,65881,3138
4030,87,1501,784,750,16526,751
1594,1140,21420,2056,12830,122574,8590
1901,3,215,1966,145,9466,70
849,36,2218,2216,1517,46413,701
291,63,691,2308,492,67564,199
3788,92,1212,1035,883,24184,329
3253,657,14165,1612,6760,116584,7405
882,1803,31935,2208,21605,110400,10330
4165,61,690,620,552,14045,138
3912,175,5240,927,3739,70277,1501
3615,36,1979,1247,748,28045,1231
742,18,1702,2244,827,42611,875
2809,99,1512,1786,973,24644,539
4386,1,30,125,19,2734,11
695,16,987,2253,689,21542,298
898,18,337,2205,276,16371,61
3818,277,4092,988,2610,49869,1482
2129,42,1453,1856,1084,20745,369
958,380,11843,2196,6480,68168,5363
1727,47,3446,2018,1941,42491,1505
1358,27,354,2120,253,12871,101
223,44,674,2315,418,19539,256
1180,782,38569,2161,10849,166423,27720
3372,18,708,1497,495,13992,213
812,253,19383,2224,7409,120110,11974
1544,376,6336,2071,4389,26071,1947
4152,599,11054,637,5767,66115,5287
3931,225,5524,909,2836,41652,2688
1600,94,1932,2055,1073,26943,859
3813,72,818,997,610,15733,208
3452,23,567,1442,328,25208,239
3144,38,728,1654,377,10793,351
1709,64,2103,2021,940,31005,1163
1017,9,371,2189,202,16050,169
646,470,27022,2261,9426,95318,17596
501,12,471,2282,266,17557,205
1471,20,834,2089,620,27199,214
1208,58,2462,2153,1781,43512,681
1579,388,12739,2060,6352,87300,6387
4324,22,251,325,174,7242,77
3723,2528,26820,1094,17257,150150,9563
899,37,891,2205,600,22147,291
621,97,5856,2263,2547,61944,3309
3649,151,3319,1194,2392,49812,927
1702,24,556,2022,352,17235,204
4389,3,128,118,49,5900,79
4208,93,996,552,738,25985,258
786,114,3734,2231,2112,56288,1622
1307,950,31832,2132,21111,218908,10721
4192,17,276,589,160,12812,116
3368,677,10668,1504,6654,93381,4014
920,1316,39399,2201,16908,233743,22491
1589,364,6289,2057,3831,77835,2458
1859,12,362,1982,242,8325,120
1010,13,639,2191,477,16952,162
203,140,1580,2317,1083,66701,497
1913,276,8659,1961,4586,86405,4073
4307,43,540,414,376,7436,164
140,118,1213,2323,940,263656,273
1842,16,868,1989,619,16724,249
3402,58,1055,1469,779,33028,276
1971,10,113,1930,85,6211,28
1740,133,2190,2015,1365,17944,825
4277,48,764,425,656,12907,108
504,46,1372,2282,1054,33179,318
1298,1358,53559,2133,27078,224719,26481
1992,5,81,1918,63,14162,18
4154,71,640,638,465,11489,175
1581,302,21742,2060,5496,48444,16246
4137,85,1217,667,730,15546,487
181,4804,78313,2319,49513,637826,28800
1713,304,7545,2020,4559,40220,2986
3860,66,1232,953,791,20763,441
4135,23,360,671,185,8572,175
277,15075,279729,2309,150862,1784334,128867
3232,167,4500,1623,2990,53166,1510
2071,78,2032,1885,1217,28613,815
1044,35,985,2185,708,27874,277
1130,21,615,2170,379,18444,236
643,807,24880,2261,15764,101179,9116
2464,128,4427,1834,2659,52071,1768
194,68,547,2318,411,22708,136
174,333,10986,2320,3492,151286,7494
4297,23,393,422,308,3756,85
180,12,152,2319,97,11763,55
39,13,119,2329,83,37552,36
1098,314,8297,2175,4966,52297,3331
79,563,6357,2326,4412,206471,1945
154,108,1330,2322,1014,35899,316
841,250,7705,2218,5286,50287,2419
657,245,7255,2259,4629,33321,2626
4090,10,102,745,83,3739,19
937,116,2208,2200,1474,30260,734
13,1957,43425,2330,22969,551530,20456
1215,859,30681,2152,19614,137908,11067
1888,53,1741,1973,727,34081,1014
3323,62,1393,1556,824,24167,569
3918,399,11543,919,5522,105119,6021
3287,172,3726,1600,2383,51328,1343
1889,121,11876,1973,2126,68670,9750
1891,118,6269,1972,3150,63154,3119
886,106,1983,2207,1332,26282,651
3816,93,2263,989,1202,28889,1061
17,263,3566,2330,2539,152057,1027
1711,43,1780,2020,958,18394,822
3045,72,3790,1695,1148,33960,2642
4276,47,854,436,567,13496,287
165,21,130,2321,118,26554,12
876,104,2026,2210,1361,26475,665
4182,373,5975,604,3548,25852,2427
4146,160,2193,647,1497,31316,696
4186,141,2120,596,1362,24124,758
3794,166,4086,1020,2587,41592,1499
1079,342,16798,2179,8712,112951,8086
602,116,5206,2267,2441,97213,2765
3617,197,3209,1247,2083,60630,1126
1057,276,7439,2183,5106,56724,2333
942,547,36480,2198,12251,199599,24229
907,107,5027,2204,2448,46916,2579
3573,42,619,1321,458,20051,161
3673,120,2158,1165,1251,38849,907
2085,462,9371,1878,5950,64779,3421
4292,18,317,423,251,2917,66
144,535,5851,2323,3444,70668,2407
1122,571,15408,2172,10328,173443,5080
1839,3743,124867,1991,36305,428860,88562
4303,19,364,422,245,4821,119
1258,12,664,2142,447,15521,217
51,5,83,2328,68,19472,15
1121,6,341,2172,246,11178,95
861,1124,215716,2212,18545,412292,197171
693,64,3019,2253,2116,73344,903
4335,335,4436,277,2697,23206,1739
494,59,2510,2283,1556,78976,954
1255,33,815,2143,597,9762,218
3623,44,522,1230,372,11893,150
739,246,9473,2244,6942,85086,2531
1182,4,211,2160,135,12529,76
1699,69,1610,2023,1164,38329,446
1761,127,3794,2011,2362,34666,1432
4304,21,434,422,281,6430,153
1683,159,14154,2027,3526,74738,10628
3530,29,361,1361,271,12247,90
1945,54,2893,1944,1272,34810,1621
3680,10,104,1160,75,9578,29
661,462,10538,2259,7938,113840,2600
4340,37,481,275,267,8070,214
2058,1230,23897,1890,13370,122920,10527
115,37,510,2324,379,80889,131
1159,304,10293,2165,6655,56925,3638
341,19,175,2302,98,51364,77
2104,77,2202,1869,1482,35807,720
3779,16,154,1049,139,7484,15
309,51,610,2305,378,15698,232
556,64,3155,2273,2221,68685,934
2060,326,7899,1889,4908,48515,2991
1335,27,998,2127,700,59628,298
1733,31,1511,2016,979,26782,532
370,284,2985,2299,2093,60875,892
1347,267,16134,2123,6150,75407,9984
3000,139,2460,1717,1482,24020,978
1826,293,15808,1996,8536,119633,7272
475,321,20113,2286,7365,110140,12748
1410,399,20526,2099,10659,111553,9867
139,76,1724,2323,677,97431,1047
67,947,14077,2327,9190,177485,4887
1422,74,5836,2097,2304,56247,3532
4259,67,1163,475,708,12325,455
665,164,3556,2258,2536,74014,1020
672,90,2858,2257,1900,35033,958
688,42,928,2254,635,19821,293
3537,222,3636,1354,2263,27152,1373
685,128,6212,2255,2985,67997,3227
1224,230,9693,2151,6178,101887,3515
1095,362,39609,2176,8667,201200,30942
338,433,8355,2302,4515,164442,3840
781,1251,26264,2233,14262,116073,12002
835,712,13680,2220,9065,94574,4615
1445,166,7325,2092,3798,72986,3527
4342,7,244,272,189,4885,55
880,53,1065,2208,760,29297,305
3866,33,461,952,387,8414,74
1541,107,2022,2071,1443,17926,579
1604,7,517,2054,308,55525,209
1246,217,9792,2145,5549,67402,4243
108,27,211,2325,177,37225,34
2049,39,1631,1898,819,33723,812
4174,15,351,614,184,10709,167
4245,482,6861,497,4575,34657,2286
3670,26,420,1169,215,7800,205
4121,163,1922,688,1130,31519,792
2928,152,7200,1748,4000,62271,3200
4323,27,321,328,293,10214,28
64,43,433,2327,323,38816,110
3679,955,20008,1161,11309,112376,8699
904,1360,41727,2205,18845,107622,22882
4069,100,1202,766,616,7360,586
1379,39,1573,2110,1051,32246,522
2852,56,1488,1777,1020,36774,468
3706,111,1840,1120,1244,28900,596
3462,166,2269,1434,1267,14461,1002
3620,2337,56629,1245,22490,276413,34139
4113,13,285,694,177,6083,108
28,3095,67510,2329,35692,411544,31818
1089,0,0,2177,0,9823,0
7,62,644,2330,343,78798,301
4309,34,468,410,418,8244,50
3266,154,4171,1610,3058,92790,1113
1231,256,12805,2149,6206,69321,6599
1838,1691,36869,1991,20348,131813,16521
98,2051,26198,2325,16520,359765,9678
3609,5,182,1268,145,10944,37
1977,55,4997,1926,1602,59855,3395
4141,162,1599,659,1345,30847,254
438,28,1277,2292,788,34590,489
4155,108,1030,638,722,16513,308
1728,232,4751,2018,3510,39705,1241
1707,49,1382,2021,861,34735,521
2713,81,1986,1810,1188,37830,798
349,29,314,2300,219,15637,95
1791,266,11807,2003,5723,128724,6084
480,28,1854,2285,846,22718,1008
4360,4,41,218,16,2205,25
454,250,9770,2290,4694,80023,5076
3745,10,160,1063,99,5071,61
634,139,3608,2262,2600,34907,1008
331,176,2160,2303,1267,72308,893
1403,565,11589,2102,6216,72162,5373
1904,4,132,1964,92,14030,40
3500,296,8592,1388,2948,42026,5644
186,64,461,2319,356,129656,105
1585,207,8933,2058,4878,93876,4055
1970,103,3972,1931,2621,44150,1351
230,13,59,2313,52,57170,7
72,46,469,2327,363,39348,106
3879,23,298,941,251,13631,47
3511,665,14827,1373,8246,58478,6581
615,3028,82876,2264,53754,346432,29122
754,218,5930,2242,4274,44036,1656
1086,132,4720,2178,3024,46244,1696
782,5,394,2233,198,23027,196
2048,9,535,1900,379,21362,156
1396,67,1818,2104,1236,46585,582
3474,14,233,1420,177,11597,56
1045,162,7506,2185,5228,45174,2278
852,135,6644,2216,3084,47688,3560
1139,30,1631,2168,888,23058,743
683,92,3862,2255,2992,160009,870
1238,393,28289,2147,11995,104995,16294
189,20,446,2318,207,26456,239
3678,345,7014,1162,3726,74086,3288
2108,12,322,1869,192,17096,130
1595,168,7479,2055,4367,59310,3112
75,248,2972,2327,1754,84233,1218
3331,26,454,1546,354,27703,100
4246,34,736,486,390,11133,346
3270,637,16143,1610,9164,141588,6979
574,384,23863,2271,14910,142113,8953
1234,7,337,2148,248,14791,89
175,17,109,2320,80,36531,29
4247,142,1807,489,1212,13517,595
315,192,4123,2304,2024,136425,2099
763,239,9581,2239,6373,61117,3208
753,33,1927,2242,1515,34496,412
2115,883,22916,1864,14487,86910,8429
573,1030,20664,2271,13177,96610,7487
395,1374,14332,2296,9618,186505,4714
1613,289,8473,2051,5681,36382,2792
1869,28,1125,1980,653,27115,472
1571,117,3748,2063,2196,54073,1552
538,6,338,2276,194,16709,144
4352,15,304,244,226,4364,78
152,36,502,2323,356,26271,146
87,165,1591,2326,1280,110945,311
561,110,3890,2272,2893,53355,997
3974,66,521,871,312,8722,209
2094,76,5485,1873,1790,34796,3695
3055,5,317,1694,145,13629,172
402,104,2316,2296,1198,39905,1118
359,65,1289,2299,741,54950,548
4028,65,1289,791,768,23706,521
2608,39,617,1822,471,15275,146
490,427,20861,2284,13791,143343,7070
1849,49,1292,1987,926,23152,366
4206,138,2208,558,1492,25200,716
2563,65,1726,1827,957,19892,769
4369,1,25,191,22,1406,3
4178,231,2674,609,1780,17455,894
4085,0,417,752,346,8626,71
4236,169,1561,515,1116,13107,445
699,161,9702,2251,6500,53992,3202
1033,210,8383,2186,5478,100808,2905
759,166,3736,2241,2438,27842,1298
853,1262,56966,2216,21668,128996,35298
1899,21,813,1966,514,11200,299
940,167,5259,2199,3420,39808,1839
4228,92,1755,524,898,19795,857
1254,770,44847,2143,16524,138593,28323
316,2155,41349,2304,25238,248710,16111
163,71,673,2321,371,74968,302
299,98,812,2306,336,148473,476
4153,73,664,638,522,12339,142
3653,1594,41819,1191,22743,244341,19076
1322,58,2741,2129,1561,65412,1180
3713,85,1766,1111,1167,32522,599
1695,66,1401,2024,1045,12902,356
122,2136,37753,2324,20524,448141,17229
3881,59,992,941,612,22762,380
2076,21,305,1883,222,12779,83
1580,273,8142,2060,5701,67306,2441
457,845,18713,2290,13412,94855,5301
3465,817,12206,1432,8139,115098,4067
195,7,81,2317,66,32860,15
1512,1358,23381,2077,15610,86604,7771
29,16,506,2329,186,34440,320
201,481,9772,2317,5282,165251,4490
2098,106,7875,1870,1906,51772,5969
729,19,761,2248,526,17511,235
1171,26,1071,2163,654,15652,417
3708,2004,70060,1117,23237,206510,46823
587,67,3126,2269,2358,108345,768
159,340,2792,2322,2124,83439,668
894,213,8232,2206,5541,89090,2691
1775,83,2032,2009,1436,22184,596
431,5,349,2293,226,13997,123
121,25,322,2324,218,26343,104
1250,32,1408,2144,1107,24633,301
246,9,89,2311,50,17839,39
4364,359,5960,206,3656,36732,2304
4391,1,113,112,77,5110,36
963,205,19688,2196,5797,138804,13891
877,172,3355,2210,2330,41292,1025
4072,24,344,765,211,18467,133
288,19,314,2308,216,21822,98
789,28,1278,2230,959,40407,319
1956,5,78,1940,51,19187,27
2156,4,182,1849,118,12996,64
1478,484,25379,2087,17024,304236,8355
533,44,1239,2277,931,22280,308
2008,150,2013,1912,1320,57740,693
4283,13,372,424,255,3125,117
1559,13,1031,2066,212,15271,819
1912,146,4198,1962,2880,51111,1318
2153,44,629,1850,396,15859,233
3753,40,379,1059,322,8395,57
3431,207,5394,1453,2247,58120,3147
3937,16,261,902,169,8485,92
411,5,191,2295,96,30286,95
185,99,1024,2319,795,150868,229
656,6,381,2259,170,10174,211
1653,32,844,2035,612,16316,232
3792,238,3430,1021,2443,59516,987
3638,261,4172,1211,2874,22787,1298
3707,103,1907,1120,1547,40150,360
1408,23,1052,2100,580,27562,472
1741,1400,33848,2014,19062,153471,14786
2101,105,4996,1870,1554,26652,3442
839,250,8865,2219,5486,84592,3379
545,661,45046,2275,14442,293358,30604
3013,583,12345,1709,8290,70974,4055
3704,59,1017,1122,660,25359,357
3258,5679,247703,1612,58260,745074,189443
565,527,18252,2271,10989,83953,7263
2193,13,259,1847,186,18858,73
815,817,27718,2224,17831,147501,9887
187,3,45,2319,37,22539,8
557,281,6983,2273,4745,36181,2238
730,77,1578,2248,1152,19828,426
2144,101,3829,1851,2772,25474,1057
784,23,738,2231,535,26670,203
1151,218,12878,2166,6522,111589,6356
2110,385,6601,1868,5259,61195,1342
236,11,86,2312,38,17993,48
4270,98,1787,446,1139,9640,648
3989,146,1569,863,1123,16938,446
4260,91,1246,474,852,16732,394
3401,545,6299,1469,4222,46709,2077
1237,64,1302,2147,800,13393,502
3046,387,7304,1695,3775,34341,3529
1584,185,6244,2058,2944,42909,3300
1494,245,11930,2083,4440,129293,7490
2126,26,1015,1856,730,12548,285
647,5899,305188,2261,126651,1231787,178537
233,223,3013,2313,2034,96194,979
4217,9,427,538,146,14875,281
1724,13,406,2019,286,31289,120
1810,85,2747,2000,1617,32441,1130
3738,18,221,1067,179,37258,42
1661,50,2154,2033,926,24341,1228
1675,107,3621,2029,2520,45943,1101
3482,25,560,1407,409,29244,151
707,175,3617,2249,2704,36512,913
3826,18,232,985,173,13788,59
263,10,260,2310,164,139301,96
640,76,3251,2262,2081,56175,1170
4088,12,163,748,93,12975,70
4372,81,1737,182,1496,24389,241
2037,242,7091,1905,3217,46491,3874
3305,504,13678,1581,8467,84718,5211
102,29,611,2325,340,78120,271
2138,213,5331,1852,2998,39431,2333
3887,0,0,628,0,3821,0
881,787,22843,2208,13333,80392,9510
2554,15,826,1828,506,27772,320
3480,4807,103337,1408,52113,443720,51224
2118,86,1700,1862,1336,29464,364
896,240,10777,2206,3785,92579,6992
129,20,243,2324,179,26269,64
1115,351,14229,2173,5747,93953,8482
523,6,352,2279,271,11105,81
3393,49,1122,1478,513,11361,609
404,65,676,2295,517,72491,159
4243,128,962,506,830,31685,132
3803,1538,23347,1013,17278,175019,6069
1982,148,3036,1922,1584,31243,1452
2804,0,0,1787,0,10332,0
1621,202,6142,2046,4138,56161,2004
4138,14,217,665,135,16251,82
303,536,6170,2306,3683,165814,2487
3734,90,1996,1080,1217,25115,779
1085,125,9469,2178,4279,65075,5190
3947,141,1088,894,794,7566,294
2128,48,1258,1856,868,17037,390
4096,464,8404,732,4309,44614,4095
3778,12,243,1005,95,16102,148
748,9,281,2243,224,17444,57
1218,541,19116,2152,11378,127059,7738
3987,149,1895,867,1276,24081,619
638,168,11882,2262,7837,84967,4045
601,75,4820,2267,1887,42912,2933
4289,18,363,424,213,7133,150
1294,102,3220,2134,2156,57559,1064
3130,37,1607,1662,444,19546,1163
941,46,1109,2199,821,28816,288
1289,3,140,2135,98,7187,42
4120,21,268,690,193,7594,75
2790,119,1724,1791,1109,20169,615
1906,175,4825,1964,3412,34871,1413
118,260,2144,2324,1854,170346,290
204,394,4940,2317,3383,99249,1557
2093,138,5460,1873,3439,67956,2021
1995,201,6567,1917,4434,77855,2133
290,311,3930,2308,2668,68746,1262
262,74,1159,2310,773,35741,386
2011,12,891,1911,609,15511,282
3766,251,3461,1055,2694,23801,767
3314,733,12852,1571,6866,73431,5986
3364,32,807,1511,586,27271,221
1282,44,1189,2137,746,19073,443
394,289,3801,2296,2908,150735,893
1038,60,1999,2186,1360,18537,639
19,345,5925,2330,3619,188695,2306
605,345,16200,2266,6190,60415,10010
3696,73,1358,1130,760,13779,598
345,38,307,2301,228,75243,79
3552,8840,188408,1342,90936,673923,97472
1698,171,4286,2023,2466,59454,1820
1903,10,554,1965,221,12918,333
410,582,7387,2295,3639,201398,3748
1368,26,948,2115,552,17908,396
2038,16,729,1905,478,20155,251
4328,145,1204,309,907,14091,297
952,422,7829,2197,5147,90333,2682
3873,0,281,943,241,11364,40
783,161,16447,2232,7907,107300,8540
745,566,13905,2243,9142,60461,4763
4016,105,1485,825,800,22604,685
243,3,15,2312,12,19781,3
3510,11,283,1375,188,12190,95
4362,23,484,211,272,6396,212
1936,300,6541,1950,4910,38836,1631
377,27,861,2298,444,45975,417
1249,36,989,2144,695,27957,294
934,161,5536,2200,2323,61369,3213
137,60,818,2323,586,117438,232
1470,58,1271,2089,514,12392,757
4065,51,544,768,337,5905,207
633,93,3976,2262,2428,40214,1548
4320,45,586,330,429,5618,157
4347,29,427,265,276,8559,151
2792,106,2705,1791,1729,31371,976
3739,6,98,1064,59,4117,39
1241,312,10734,2146,7436,67659,3298
993,415,13876,2193,9208,170040,4668
1037,17,550,2186,362,15104,188
1371,24,825,2114,480,36397,345
3773,244,3045,1053,2432,67818,613
1204,24,560,2154,333,15090,227
461,100,2860,2289,2010,38284,850
530,16,1056,2277,667,31073,389
836,317,17901,2220,5260,136978,12641
125,691,7183,2324,5184,95666,1999
1193,62,1264,2156,948,18503,316
3073,21,319,1686,208,13582,111
2100,90,2315,1870,1446,23881,869
972,28,1132,2196,879,19439,253
1372,14,602,2114,352,18100,250
1532,1612,47166,2072,25871,174829,21295
1216,42,2053,2152,1418,19643,635
1893,22,867,1972,382,24549,485
3654,52,1046,1191,626,25878,420
1907,354,11541,1963,5764,110410,5777
704,22,640,2250,473,22888,167
214,570,9724,2316,6250,97253,3474
4239,51,705,511,527,13362,178
3311,116,2212,1576,1682,32813,530
1271,358,36858,2139,11375,182521,25483
1157,30,2727,2165,1658,43168,1069
1004,102,3816,2192,1930,44768,1886
380,19,158,2297,115,67781,43
1064,94,9302,2182,1751,74516,7551
348,314,4377,2300,2779,64912,1598
1031,64,1791,2187,1022,25114,769
1251,127,3257,2143,2342,30005,915
1091,11,394,2177,311,11941,83
1922,58,1798,1957,1243,29877,555
971,10618,275040,2196,126313,734651,148727
3348,329,7350,1528,5144,139864,2206
4263,16,165,454,116,8109,49
2897,19,475,1762,267,15459,208
4102,51,993,716,421,13603,572
3962,789,8767,883,6756,92362,2011
1243,38,1622,2145,1236,31869,386
4157,88,1975,637,937,22095,1038
4093,23,291,741,220,15844,71
3983,131,2309,868,710,42991,1599
1932,224,4898,1952,3195,60575,1703
2091,398,19293,1875,8738,120381,10555
837,36,846,2219,646,14525,200
227,21,228,2313,133,28986,95
128,30,714,2324,347,32424,367
4181,174,2619,606,1791,16334,828
1655,21,1494,2034,475,19556,1019
3278,81,1479,1605,1040,36988,439
4147,51,518,647,361,8353,157
4232,7,109,518,72,3381,37
1292,123,5036,2135,3024,42544,2012
4244,117,2904,503,1840,31516,1064
298,418,4483,2306,3784,183592,699
617,20,1082,2264,788,29221,294
968,40,1592,2196,737,15419,855
3991,144,4466,749,1203,38071,3263
340,22,199,2302,156,21001,43
750,3426,133009,2242,64998,554019,68011
505,32,1524,2282,1241,28648,283
1552,15,444,2068,324,19318,120
591,197,4799,2268,2540,35885,2259
1240,52,5702,2146,3064,51118,2638
1877,39,1645,1978,1033,23339,612
761,17,532,2240,417,14237,115
4306,31,418,415,360,11113,58
196,1,6,2317,5,17484,1
1032,44,1857,2187,1139,34427,718
215,683,7298,2316,4072,367973,3226
1685,39,1475,2025,558,20780,917
4025,82,477,794,420,13618,57
4248,116,2511,488,1023,30795,1488
4201,39,588,567,427,8568,161
625,17,604,2263,338,15225,266
155,44,387,2322,274,14204,113
543,130,5267,2275,3608,61026,1659
465,83,4238,2288,2764,43280,1474
1670,50,2835,2031,1106,30299,1729
1948,51,2385,1944,1132,30007,1253
3486,443,6149,1402,4364,37281,1785
1919,266,5943,1958,4258,42146,1685
2973,6,164,1733,110,14435,54
1637,11,474,2040,294,16777,180
252,5,94,2311,41,9347,53
3651,122,1271,1194,913,18525,358
2127,51,1760,1856,1328,13837,432
384,25,354,2297,238,16571,116
948,3,133,2198,96,24836,37
797,531,27663,2228,14219,162423,13444
15,9582,306390,2330,112913,2408161,193477
323,20,263,2304,181,33127,82
928,3742,111585,2201,35418,319298,76167
4029,38,577,787,370,20695,207
1407,184,5948,2100,3528,25036,2420
2902,38,895,1760,539,13336,356
3806,58,1466,1008,775,22227,691
470,487,9126,2287,6042,56133,3084
3957,201,2276,884,1442,31087,834
1301,13,273,2133,209,9517,64
1110,10291,276362,2174,135411,788405,140951
1386,235,10194,2107,5601,96498,4593
576,17,1227,2270,462,22708,765
2000,41,543,1914,332,10530,211
324,12,143,2303,95,21299,48
2125,81,4454,1857,1689,48003,2765
4374,35,929,181,586,15670,343
4345,66,847,266,599,9234,248
956,267,6563,2197,3702,49646,2861
2041,197,7423,1904,3358,42601,4065
464,7,640,2288,344,26408,296
1529,5,216,2073,121,11200,95
636,52,4195,2262,2774,56748,1421
594,65,1982,2268,1129,21861,853
924,218,5793,2201,3780,52590,2013
3827,30,739,985,511,18175,228
1978,730,20439,1924,9706,193268,10733
3541,442,4406,1354,3141,39095,1265
1748,67,1340,2013,759,17191,581
4351,21,412,246,355,8274,57
483,466,15429,2285,8528,77362,6901
1008,460,13566,2191,8514,99127,5052
1599,11,690,2055,345,16141,345
4295,29,575,423,422,6415,153
205,223,3630,2316,1688,92616,1942
3622,9,280,1234,142,8353,138
787,133,4878,2230,3493,55365,1385
4053,560,6951,771,5391,46214,1560
3624,47,1028,1230,691,22271,337
1118,160,7314,2172,4568,44832,2746
1608,17,999,2052,346,23857,653
555,2824,157794,2273,66314,652408,91480
2004,178,6169,1913,2600,53222,3569
3572,216,18685,1322,2831,79587,15854
4187,807,9857,596,7259,50335,2598
1523,124,2452,2075,1745,36811,707
3583,1973,41443,1310,23931,171387,17512
4196,78,1009,583,763,41288,246
872,150,13167,2210,7157,87587,6010
1871,14,513,1980,303,19341,210
3536,9,125,1355,107,8541,18
4020,28,243,821,176,7101,67
1586,95,7090,2058,1380,69742,5710
1068,625,23401,2182,11808,128262,11593
3467,62,1256,1429,587,11090,669
686,19069,716523,2255,291059,3897028,425464
663,20,1085,2259,540,18892,545
1061,26,741,2183,579,20143,162
153,13567,224408,2322,127629,1277979,96779
921,16,1200,2201,794,37752,406
949,86,1719,2198,1218,16892,501
3524,296,3613,1364,2550,20589,1063
1900,437,12178,1966,7022,68396,5156
4080,60,524,758,292,12992,232
3448,29,296,1443,223,17578,73
4158,83,1380,636,659,18395,721
1330,260,17582,2127,7827,70050,9755
4230,77,2310,521,1100,23744,1210
448,45,3150,2290,2171,32515,979
234,17,147,2313,112,27846,35
1172,126,3010,2163,1969,22230,1041
2095,202,8070,1873,3222,44982,4848
824,209,9499,2223,5739,154646,3760
774,234,8413,2234,5911,75244,2502
1082,520,29698,2178,8793,129740,20905
213,38,657,2316,467,42558,190
870,597,19413,2210,9599,103335,9814
630,593,13807,2263,7662,69880,6145
3789,353,4606,1022,3234,62908,1372
3557,88,2273,1338,1172,30154,1101
1788,12,648,2006,379,14438,269
1370,352,15768,2114,10084,130079,5684
3762,8,95,1057,62,4450,33
830,7,206,2221,176,15067,30
110,1269,15943,2324,10370,368938,5573
1080,16,637,2179,407,16206,230
960,111,4684,2196,3444,30714,1240
1141,16,694,2168,451,26191,243
509,90,5427,2281,2353,62065,3074
598,1272,37165,2268,21562,185496,15603
1458,52,2626,2091,1277,39926,1349
325,8,111,2303,78,11199,33
692,94,3125,2254,2421,67965,704
1926,23,1736,1955,493,20988,1243
1664,126,3278,2031,2047,32193,1231
559,70,2277,2273,1639,28129,638
1825,1522,46784,1996,18452,196118,28332
281,104,1273,2309,968,54730,305
4149,43,308,642,210,16967,98
650,644,46254,2261,16404,267452,29850
261,17,209,2310,124,16927,85
1938,138,3449,1950,1656,34301,1793
41,580,7264,2329,4624,71328,2640
4011,387,3581,834,2285,39290,1296
3698,257,5017,1128,2489,34233,2528
4296,22,426,423,313,3777,113
1020,691,40108,2189,7435,109304,32673
367,118,1063,2299,736,55862,327
235,304,4443,2313,2729,83990,1714
1397,613,17916,2104,11537,104468,6379
4322,120,1987,328,1242,24533,745
3928,137,1427,909,1108,9678,319
1484,190,3688,2085,1903,42685,1785
3044,135,4446,1696,2087,31147,2359
1424,11,1191,2097,890,20383,301
1507,581,26077,2078,14272,135513,11805
1572,34,1555,2063,896,22729,659
1392,149,6503,2105,3854,43617,2649
4212,15,250,544,180,16167,70
1107,88,1762,2175,1287,26270,475
1989,83,3446,1918,2185,35815,1261
635,1394,24449,2262,16584,77727,7865
112,643,9204,2324,6268,197305,2936
1021,157,4883,2189,2610,51075,2273
455,25,1207,2290,740,32650,467
94,151,1644,2325,1175,116299,469
1784,3154,138893,2007,51706,426696,87187
1506,49,2262,2078,1173,37445,1089
1226,109,4944,2149,2380,71925,2564
2744,131,4845,1805,2188,34905,2657
1693,82,4603,2024,1605,55417,2998
269,114,1139,2310,864,48800,275
3799,102,2128,1017,1340,24693,788
4282,27,521,424,375,3768,146
1518,22,1060,2076,664,50841,396
2341,50,4054,1841,1638,45182,2416
645,1322,104414,2261,32760,366584,71654
489,5,296,2284,229,21301,67
3612,43,987,1253,667,21538,320
1746,31,1077,2014,420,16637,657
138,160,1750,2323,1138,43062,612
710,69,1659,2249,911,19154,748
3981,1870,19888,869,11209,123888,8679
271,103,1618,2309,780,43976,838
1682,460,13471,2027,4434,65315,9037
1792,125,3045,2003,1945,37383,1100
4035,17,215,774,109,11358,106
300,273,3907,2306,2602,72308,1305
419,378,8887,2294,5555,67123,3332
1701,184,6774,2022,3978,66394,2796
105,11,179,2325,102,43140,77
1714,262,6176,2020,4019,43724,2157
560,81,3021,2273,2092,38193,929
871,309,9187,2210,5486,58607,3701
1710,18,694,2021,321,28599,373
1974,12,645,1927,432,17762,213
1822,111,6307,1997,2909,62126,3398
865,1377,28275,2212,11103,88074,17172
778,170,5480,2233,3885,29719,1595
3846,152,3720,965,2197,47383,1523
4224,25,344,531,265,11794,79
800,88,1943,2228,1581,15563,362
81,41,334,2326,269,57097,65
3072,25,745,1687,474,18049,271
4118,235,2326,692,1610,34760,716
111,1,41,2324,9,46780,32
1766,147,6036,2011,3828,79092,2208
4274,41,855,439,456,8996,399
682,247,12036,2255,4857,59519,7179
1770,67,1749,2009,1158,28540,591
4084,19,181,752,118,6847,63
751,11,599,2242,449,21919,150
3761,23,308,1057,238,9285,70
799,15,821,2228,554,40412,267
239,49,578,2312,383,116380,195
1929,184,5324,1953,2652,48658,2672
1018,4254,148175,2189,81208,711745,66967
1947,17,318,1944,197,18920,121
583,183,3508,2269,2335,20405,1173
149,0,4,2323,1,13094,3
4316,20,251,347,213,9096,38
4366,3,59,198,48,2566,11
222,253,2233,2315,1707,173468,526
1123,10,463,2171,315,24393,148
989,90,1924,2194,1188,24342,736
396,10,93,2296,79,26328,14
4220,269,4493,536,3259,51105,1234
798,125,7446,2228,3669,69134,3777
2121,1441,50753,1860,25224,251971,25529
2624,356,16087,1820,5612,96768,10475
1235,365,10983,2148,7235,68689,3748