Mod,likes,downloads,time,unique_dl,views,dl_dif
42223,7,138,1310,126,4417,12
8844,15,781,3360,420,12973,361
42510,3,42,1058,34,2404,8
28885,8,100,2294,87,1691,13
12175,1,290,3184,49,2327,241
43136,22,213,666,182,4731,31
30150,26,454,2231,450,5398,4
42330,48,670,1211,559,10574,111
42250,39,552,1296,514,8148,38
14399,25,585,3026,518,8688,67
6097,7,186,3524,164,2918,22
43328,4,54,514,48,2471,6
42263,1,63,1271,45,2419,18
1540,44,637,3728,591,10638,46
43233,44,328,600,297,2789,31
7785,3,47,3438,47,1910,0
40421,10,319,1657,275,6071,44
42613,106,1347,976,1267,10702,80
14646,4,156,3009,144,4469,12
42586,182,1953,983,1677,13825,276
32886,503,13974,2095,11732,50050,2242
43170,18,360,636,274,4181,86
42529,5,121,1047,94,5455,27
32579,5,245,2108,159,7491,86
42238,248,3801,1303,3445,28887,356
43660,3,21,303,19,899,2
23155,18,877,2577,572,14101,305
33070,18,469,2087,410,13140,59
42207,39,867,1332,696,13319,171
41951,18,295,1459,277,6733,18
43239,10,189,596,147,4620,42
42999,12,117,819,100,3352,17
42931,15,454,849,168,6182,286
19882,55,1084,2753,920,7204,164
43302,5,82,544,57,1900,25
27545,556,13528,2370,8674,76454,4854
15606,2,74,2956,61,3949,13
19657,25,485,2766,442,5179,43
43386,18,384,465,368,5167,16
33919,12,383,2056,338,6115,45
27816,12,566,2354,326,5831,240
42454,83,888,1108,874,10070,14
42573,194,3913,1006,2314,22835,1599
23065,37,717,2581,488,9229,229
20507,22,1222,2720,1051,17057,171
42341,45,814,1204,660,27818,154
42159,458,8246,1379,6145,37392,2101
24229,0,56,2526,50,2838,6
15485,2,208,2964,176,6146,32
38170,848,18721,1806,17309,74617,1412
31814,3,93,2144,86,3295,7
6683,14,824,3500,785,20021,39
42090,11,256,1437,224,9434,32
41784,229,3855,1488,3525,30873,330
42514,4,91,1054,69,5677,22
43453,9,195,433,182,2865,13
42690,6,81,950,60,5888,21
25299,45,1065,2478,972,12661,93
11984,6,272,3194,120,5734,152
12378,5,291,3172,88,3484,203
11048,11,224,3242,218,7574,6
42342,230,3184,1203,2863,24838,321
42873,4,86,868,85,2774,1
43160,3,83,644,56,3438,27
19867,13,196,2754,177,3776,19
18663,7,144,2810,133,2884,11
42219,12,117,1316,92,3096,25
42092,39,838,1437,747,15747,91
42513,11,207,1054,180,3255,27
35482,11,209,1981,188,4364,21
24392,1,55,2518,48,2246,7
43446,2,119,434,91,1787,28
42109,11,128,1432,113,3879,15
42200,22,208,1338,176,34468,32
41730,67,1371,1500,1051,15955,320
38472,55,953,1785,840,6096,113
43325,33,374,521,342,4451,32
22532,18,359,2606,312,5797,47
43171,30,270,636,229,2501,41
41941,11,177,1462,146,5024,31
42194,14,305,1345,239,4772,66
42240,46,714,1302,591,9121,123
42700,10,180,947,146,8261,34
42121,8,315,1428,301,3707,14
14435,1572,154159,3024,39362,329074,114797
9235,56,1387,3338,1270,23045,117
42205,1,71,1334,58,2419,13
43663,0,57,300,39,1696,18
28868,7,138,2294,127,5213,11
12956,91,2788,3139,2292,22066,496
42792,10,145,904,121,3895,24
43019,5,98,793,73,3102,25
26014,5,156,2445,136,7672,20
6857,39,5309,3492,763,9898,4546
38480,3,71,1785,65,3467,6
21070,2,254,2687,138,5525,116
23274,4,236,2571,219,6998,17
42448,304,5211,1113,4870,40069,341
42101,83,1404,1435,1335,12221,69
43052,17,221,770,167,2329,54
42935,96,1282,846,1071,18766,211
8718,39,1017,3368,779,11674,238
9057,1,442,3349,57,3364,385
42664,100,1033,957,799,9435,234
42297,32,374,1244,365,2689,9
43134,33,377,667,268,4303,109
33402,2,37,2075,32,2025,5
42123,17,394,1427,347,5910,47
25731,4,212,2458,200,4332,12
35562,9,215,1975,189,6215,26
42693,236,3834,950,2278,29919,1556
42371,37,680,1176,514,8547,166
43795,13,400,230,267,5156,133
42933,395,6028,847,5193,42321,835
33973,339,4490,2054,3850,20852,640
39940,30,582,1693,538,4704,44
37488,20,288,1852,227,3817,61
31840,8,152,2143,132,3785,20
42418,42,833,1153,547,7778,286
42574,4,48,1004,45,4627,3
32649,1,83,2105,58,3202,25
42798,63,503,899,455,6622,48
35563,11,280,1975,236,7918,44
43131,141,1326,669,1098,13521,228
39030,65,913,1749,665,13158,248
25409,163,2835,2473,2615,29797,220
1477,2,90,3750,75,2674,15
5056,34,2187,3577,906,11960,1281
1003,72,1547,3969,1526,25048,21
23923,10,176,2540,154,4094,22
16829,8,273,2898,241,3325,32
23663,72,1076,2551,918,8958,158
28693,4,243,2303,219,10845,24
43545,2,77,376,74,2427,3
39774,12,321,1705,297,6890,24
16333,0,42,2924,37,2261,5
43012,67,1843,807,612,9452,1231
14949,24,628,2990,548,6562,80
28729,192,3792,2301,3435,15046,357
40026,19,273,1687,222,4423,51
20927,32,582,2695,508,8131,74
42756,1,50,927,39,4274,11
42311,11,196,1235,163,4324,33
35796,0,43,1956,37,2040,6
23653,4,114,2552,104,4097,10
42197,4,42,1342,41,3166,1
42226,4694,84479,1309,72084,346427,12395
43530,61,1407,383,838,7855,569
27454,26,431,2376,384,5129,47
42078,5,180,1438,174,6083,6
41127,6,111,1589,105,3014,6
40196,132,5085,1677,3320,52093,1765
33185,6,130,2083,100,2764,30
43045,99,1461,776,1217,11096,244
19914,4,152,2752,145,2644,7
43169,7,95,636,63,2351,32
8894,24,495,3358,495,5244,0
24347,34,684,2520,618,8388,66
1200,614,25867,3900,13477,143305,12390
20055,13,312,2744,279,4810,33
34029,7,184,2052,157,2838,27
43282,39,440,563,378,4345,62
27549,3,167,2369,150,3310,17
43462,16,186,428,159,3928,27
35353,39,1959,1988,1672,21081,287
42560,80,1191,1024,956,15002,235
26564,6,490,2420,412,7746,78
43381,21,295,471,286,5563,9
42336,24,187,1206,159,3411,28
42139,325,7951,1406,7013,65029,938
26905,10,164,2404,144,3060,20
15456,20,791,2965,728,12528,63
7204,3,129,3473,122,3134,7
39539,7,236,1718,180,6739,56
41706,19,365,1503,333,4643,32
10569,42,2139,3268,1481,25178,658
27744,4,169,2359,160,2076,9
33873,4,61,2057,52,2023,9
15877,1,143,2946,71,3334,72
43253,4,54,585,35,1429,19
43038,8,112,782,77,2572,35
18343,27,936,2824,874,8172,62
42466,13,197,1094,178,2972,19
13463,13,572,3096,326,5597,246
9069,16,920,3348,905,15331,15
43258,6,41,582,31,2647,10
29671,127,2189,2254,1975,13138,214
42478,8,160,1084,147,2821,13
43342,2,39,504,31,1458,8
23714,77,1294,2549,1099,9507,195
1256,54,10231,3884,1465,30712,8766
14006,16,318,3053,300,10138,18
43219,154,2507,605,2081,11265,426
37243,1,62,1868,60,2244,2
32509,43,833,2111,721,6662,112
43225,50,538,603,441,7054,97
42306,91,5097,1239,934,16885,4163
42601,13,194,979,149,3956,45
43457,3,58,433,53,1736,5
22617,10,248,2603,214,3080,34
28259,15,447,2329,365,7739,82
34387,22,397,2040,351,11616,46
40085,39,627,1683,612,11341,15
29695,3,160,2252,145,3820,15
42619,29,446,974,364,5788,82
20882,27,413,2698,319,5421,94
1756,20,2234,3677,344,4683,1890
1274,19,614,3880,553,11511,61
43549,0,42,374,34,1034,8
23060,2,29,2581,28,2244,1
26654,18,407,2417,354,3152,53
17935,59,943,2844,627,8761,316
26455,1,83,2425,71,2091,12
42106,26,813,1435,521,8751,292
43531,4,81,382,35,1677,46
43818,9,100,213,96,3768,4
20712,0,92,2709,59,2399,33
42323,0,0,1221,0,1521,0
42185,1,45,1357,38,2308,7
41727,0,27,1501,23,1491,4
42382,6,106,1171,92,5406,14
43167,25,272,637,233,3969,39
30669,163,3391,2201,2819,15762,572
42259,16,139,1280,120,3431,19
43385,143,2563,467,1537,21207,1026
42654,34,405,960,349,12752,56
42189,123,2015,1353,1501,24776,514
23391,7,179,2565,167,5087,12
42717,66,2641,930,959,13855,1682
35997,12,258,1941,217,5775,41
9483,19,323,3321,318,4962,5
1456,9,9097,3758,219,3501,8878
42158,172,3763,1382,3131,37562,632
40885,31,388,1614,333,8171,55
42301,80,1004,1239,871,8015,133
1475,59,1234,3750,1002,7996,232
37861,4,222,1827,133,3640,89
29602,26,458,2258,443,3941,15
14312,5,102,3033,90,4097,12
27479,296,4868,2374,4259,19374,609
40161,16,242,1679,214,7641,28
43014,591,9402,805,8632,64228,770
37588,32,554,1846,479,4272,75
43542,3,63,376,47,1658,16
42991,127,1311,824,1245,20114,66
43579,0,67,351,21,1748,46
36873,3906,90721,1890,73681,334384,17040
37512,26,654,1851,579,6174,75
42636,45,619,967,548,7483,71
42196,884,13278,1344,11462,100487,1816
27262,92,2318,2387,1677,22568,641
1059,24,9364,3947,772,18490,8592
43078,12,98,745,89,2099,9
22259,7,115,2620,102,3727,13
42339,33,390,1205,338,8049,52
18440,12,491,2820,450,9015,41
16043,28,560,2938,462,8634,98
21320,0,44,2672,37,2490,7
22862,7,334,2591,300,7044,34
16238,38,1316,2929,1207,7830,109
43140,387,11506,656,6892,33355,4614
1457,302,4496,3757,3990,42597,506
42095,4,132,1437,124,3164,8
2995,8,1427,3641,624,10197,803
21255,8,279,2675,223,4089,56
29399,586,15646,2267,11451,68936,4195
42332,120,3008,1209,2131,27484,877
42312,1,79,1234,66,2008,13
42799,551,7865,896,7161,50704,704
42182,12,315,1359,255,12733,60
37206,25,545,1870,430,6743,115
29019,2,217,2287,190,6138,27
4468,178,4990,3603,3403,22608,1587
42243,6,157,1299,108,2989,49
34852,22,244,2014,232,7170,12
42360,0,0,1180,0,8065,0
43329,14,213,514,146,2404,67
25337,7,95,2476,94,1547,1
43242,6,91,595,85,2323,6
43434,4,129,439,102,2571,27
42754,83,801,930,702,10553,99
28284,2,124,2328,112,3067,12
43211,52,578,613,569,3690,9
38272,35,731,1799,641,5401,90
42987,66,810,831,733,6342,77
1092,11,218,3939,172,3952,46
42172,79,1034,1368,869,14694,165
42602,4,92,979,73,3176,19
27448,23,608,2376,511,5226,97
15455,1,57,2965,51,1831,6
42399,2729,45388,1165,43398,246979,1990
37133,35,891,1875,768,10406,123
43097,40,446,724,421,3798,25
1766,40,694,3673,640,9036,54
6211,13,547,3521,540,9870,7
42706,12,237,945,154,5463,83
42567,57,881,1019,792,26321,89
26077,1,95,2443,92,2513,3
7783,4,788,3438,221,5125,567
14947,58,1945,2990,1671,30550,274
21116,1,54,2685,54,1876,0
22551,296,11594,2605,6886,30156,4708
25680,1,71,2460,62,1511,9
43501,19,437,397,256,7172,181
37921,4,68,1822,57,2568,11
43055,50,550,763,488,4371,62
42314,13,456,1229,312,5396,144
21981,105,3056,2634,2762,14274,294
43682,6,44,293,42,1303,2
20494,33,1216,2722,1081,14570,135
43540,4,57,377,48,3560,9
42530,8,161,1046,120,3470,41
42417,324,4448,1153,4073,30590,375
43478,12,153,415,144,2387,9
42310,42,708,1237,699,10558,9
23876,2,69,2542,65,2099,4
43535,42,334,379,332,5420,2
37590,4,137,1846,130,2437,7
28439,11,317,2319,286,12944,31
43450,1,37,434,24,1721,13
22618,19,669,2603,596,5904,73
40500,4,138,1649,128,2853,10
42102,16,216,1435,192,2845,24
40521,9,133,1648,115,3857,18
1005,49,1273,3968,1247,17578,26
41332,41,597,1559,560,5933,37
11058,0,335,3241,42,2407,293
12590,41,907,3161,877,6408,30
43741,2,28,268,28,824,0
42579,31,486,994,329,6535,157
43480,16,227,414,224,4013,3
20996,2,150,2691,132,2833,18
6151,7,261,3523,239,3589,22
43154,167,2175,646,2168,12823,7
42921,145,2018,859,1609,14328,409
43350,102,1131,496,971,10012,160
23770,6,117,2547,77,3784,40
43287,5,74,561,74,1455,0
30205,128,2484,2227,2223,28129,261
998,355,8651,3970,8046,72450,605
42982,78,1063,831,935,6272,128
43699,1,51,287,30,2138,21
43175,83,1047,635,943,15015,104
36700,29,518,1902,439,4725,79
18825,4,200,2803,184,5135,16
42502,12,260,1064,233,3044,27
42016,6,102,1449,77,3030,25
32887,525,15589,2095,13715,60015,1874
13974,16,525,3055,285,4462,240
23388,1164,19815,2565,18117,116292,1698
7143,4,68,3476,52,1718,16
42380,33,536,1172,470,6652,66
42463,12,218,1095,193,2933,25
32693,27,605,2103,498,9137,107
21885,25,589,2640,531,5444,58
43274,3,63,567,40,2287,23
1426,169,3823,3777,3669,30304,154
22575,3,63,2604,54,2701,9
35080,251,5388,2003,4705,27765,683
2084,6,411,3656,201,3836,210
42324,136,2528,1220,2160,34347,368
42453,6,381,609,157,2208,224
8249,12,252,3399,179,2748,73
42867,3,140,869,90,2194,50
28884,1,30,2294,27,1412,3
32101,13,198,2129,184,4452,14
23815,26,389,2545,373,5876,16
11428,3,196,3222,104,3515,92
43257,16,93,583,76,1832,17
14814,3,300,2997,212,4731,88
26325,27,1161,2432,1004,10499,157
41030,0,0,1603,0,2365,0
22286,50,1087,2619,732,6812,355
43248,63,937,590,842,15043,95
37602,2,143,1845,130,4271,13
25851,191,5100,2453,4562,43135,538
43194,3,31,626,25,1790,6
42460,15,217,1101,155,9767,62
30835,11,151,2193,129,3167,22
4684,3,438,3595,295,3833,143
42329,6,166,1212,149,2981,17
34013,23,253,2053,208,4320,45
6006,3436,131063,3527,77427,493676,53636
43622,8,99,317,91,1542,8
35400,357,6022,1986,5686,26312,336
43224,29,386,604,324,4795,62
42352,67,1169,1185,1044,9411,125
22899,27,724,2588,597,9678,127
10282,4,64,3282,54,2680,10
25775,7,310,2456,281,7187,29
43037,89,764,784,695,10597,69
43503,5,54,396,44,2433,10
42251,105,1906,1295,1757,21788,149
31268,12,237,2173,218,4229,19
43509,4,49,392,31,1511,18
10307,75,1800,3281,1683,24172,117
8716,27,612,3368,500,5278,112
43498,4,124,400,105,3672,19
39741,27,685,1707,604,8026,81
24238,20,460,2526,382,4459,78
15454,4,153,2965,139,2074,14
14894,86,2066,2993,1631,25661,435
43690,3,63,291,62,1374,1
33639,43,704,2066,629,9670,75
43811,0,66,216,50,2050,16
14288,23,559,3035,491,13210,68
43279,5,82,564,61,4477,21
43178,33,296,633,230,4049,66
15595,14,355,2957,290,4383,65
16176,18,393,2932,329,5450,64
14924,6,102,2991,101,3006,1
34863,125,2992,2014,2695,14751,297
43378,5,127,472,104,2895,23
3347,25,818,3635,609,12993,209
37400,427,12192,1858,7502,37256,4690
43065,117,1386,756,1049,15189,337
42945,98,1289,836,1233,18372,56
1553,18,746,3726,669,8769,77
29985,46,829,2239,745,6994,84
9967,358,17247,3297,9185,46378,8062
42294,7,102,1248,74,3136,28
9506,6,160,3320,146,2173,14
29388,165,3018,2267,2688,37868,330
42632,7,62,970,52,1936,10
25560,1,54,2467,52,2348,2
6024,0,76,3527,75,2694,1
38423,351,9080,1788,7958,28167,1122
6377,3,390,3513,159,3067,231
10472,14,1402,3273,837,7757,565
43146,47,486,650,402,5384,84
43291,138,1916,557,1801,13109,115
43402,1,39,457,33,795,6
42733,41,641,939,506,9014,135
42715,88,4668,930,1281,19271,3387
6060,11,5957,3526,358,7053,5599
42577,8,89,995,77,1920,12
3874,122,1995,3623,1915,14580,80
43348,108,1389,497,902,12828,487
34846,97,1753,2015,1545,15977,208
41265,12,175,1569,133,3911,42
7170,13,4771,3475,445,16240,4326
32606,14,110,2107,106,1899,4
21407,45,1168,2667,1001,9405,167
4711,3,128,3593,122,2455,6
3596,10,1515,3630,201,3426,1314
42267,564,8927,1268,6899,72436,2028
1634,243,5046,3711,4876,25458,170
38788,1,58,1763,49,2664,9
42384,88,1314,1170,1011,9588,303
22921,120,2659,2587,2035,20304,624
41778,41,686,1491,602,13275,84
40494,31,680,1650,531,8985,149
43156,151,1861,646,1844,10329,17
37072,178,3199,1879,3019,20466,180
42595,42,1365,981,462,8491,903
25670,5,123,2460,112,10285,11
42650,1,47,962,32,1917,15
27280,114,1705,2387,1491,15516,214
29470,14,443,2263,358,9508,85
8302,17,1846,3395,522,7330,1324
12651,5,109,3157,101,2375,8
9791,4,356,3305,126,5845,230
42486,8,108,1080,97,2162,11
42494,15,291,1068,225,3477,66
21669,26,665,2652,595,8317,70
42402,67,1646,1163,747,11485,899
42709,69,3657,930,1024,10595,2633
31012,197,3226,2187,3134,19439,92
24047,1,57,2534,56,2265,1
42496,5,55,1066,52,2547,3
42686,26,311,951,241,2280,70
34278,314,6731,2045,6045,50806,686
42941,98,1291,839,1103,9943,188
10741,9,336,3257,281,5614,55
42528,50,765,1047,686,7590,79
36520,10,195,1912,168,3632,27
43288,121,1486,560,1345,14468,141
29570,21,389,2259,339,3414,50
42434,6,213,1134,171,21037,42
42232,5,198,1305,105,3628,93
40702,36,585,1632,568,7582,17
42731,17,1251,930,274,6621,977
35793,0,52,1956,44,1928,8
37051,2,56,1880,46,2870,10
43240,42,507,596,407,7042,100
14891,363,8419,2993,8220,39016,199
14890,9,208,2993,179,4004,29
43814,5,82,215,80,1838,2
34418,117,1381,2038,1267,13491,114
43236,18,176,563,160,2569,16
30210,7,321,2227,288,5992,33
41678,250,3790,1508,3489,26290,301
43513,5,58,389,58,1510,0
4009,35,849,3619,788,7143,61
42519,3,73,1051,55,3241,18
42390,8,105,1169,92,3302,13
42901,3,82,868,51,3465,31
25270,6,163,2479,144,1766,19
42230,12,191,1307,164,2865,27
33091,88,7896,2086,949,24899,6947
26733,6,86,2413,74,1830,12
42319,8,115,1225,93,3114,22
40073,0,426,1684,393,6395,33
42165,52,895,1374,779,9761,116
31355,17,265,2169,250,5176,15
42096,63,897,1437,749,11072,148
25278,37,1003,2479,869,7942,134
21149,346,7119,2681,6250,54667,869
42458,9,183,1103,143,2364,40
25725,328,5852,2458,5159,30095,693
1667,56,909,3700,809,9070,100
22049,1,65,2631,55,2102,10
25630,209,2886,2462,2627,14350,259
29579,22,323,2258,258,5952,65
43105,35,515,717,463,5005,52
18155,0,19,2833,18,2530,1
32427,484,15019,2115,12690,45663,2329
43505,5,86,395,82,1998,4
12958,36,967,3139,948,14958,19
43619,7,73,322,45,1709,28
15451,10,364,2965,335,5432,29
31635,727,17644,2153,14257,131426,3387
15626,12,438,2956,399,4754,39
20500,18,599,2721,518,7334,81
42277,38,535,1259,421,6227,114
21677,5,140,2651,137,3000,3
1570,126,4603,3723,3677,32716,926
37913,20,401,1823,337,7671,64
1560,12,231,3725,225,3714,6
42915,4,48,861,39,2897,9
27390,18,289,2379,260,3173,29
43327,185,2788,515,2327,17877,461
14955,219,4164,2989,3462,24963,702
12961,25,818,3139,778,10618,40
15504,38,1064,2962,1003,18265,61
43292,4,151,554,114,2628,37
42383,2,104,1171,99,3448,5
38825,11,135,1761,119,3131,16
19602,237,4467,2769,3961,32084,506
43456,0,13,433,12,883,1
24561,82,1151,2510,1095,11420,56
43345,1,41,501,40,2654,1
38894,14,221,1757,189,3376,32
24842,32,449,2498,393,7663,56
42723,17,681,930,338,9245,343
27265,12,390,2387,275,4405,115
37427,39,508,1856,454,4867,54
43431,37,480,444,394,5811,86
42773,652,10011,911,8899,56847,1112
23200,3,71,2575,69,3326,2
18082,9,279,2835,242,5723,37
12419,39,1250,3169,1022,11254,228
12231,8,235,3181,216,3335,19
42378,60,764,1172,646,4691,118
27800,14,489,2354,360,10421,129
27062,2,340,2400,130,3884,210
43768,62,1324,251,812,8290,512
43228,0,0,602,0,1421,0
42471,8,113,1089,100,2664,13
42981,26,459,831,338,5576,121
25351,6,94,2476,92,2511,2
38827,2,65,1761,49,2199,16
18389,32,861,2822,799,5845,62
28345,1,80,2324,76,3287,4
43213,92,1316,611,1233,11386,83
43581,2,86,350,66,2373,20
6017,2,77,3527,59,2348,18
30360,1,115,2218,80,5294,35
27304,177,3701,2385,3390,22355,311
22047,4,184,2631,158,3732,26
7958,14,2870,3421,405,7353,2465
28886,3,143,2294,115,2140,28
25264,15,485,2480,402,4471,83
28236,5,97,2330,77,2204,20
42266,30,390,1268,323,4162,67
39939,28,649,1693,577,5716,72
7919,8,587,3425,318,3506,269
22642,2,106,2602,101,5210,5
43181,98,1466,632,1323,11430,143
43608,12,143,331,138,3874,5
42462,37,685,1096,566,10840,119
20596,5,65,2716,60,2542,5
42522,231,2803,1051,2537,19699,266
43271,6,74,569,68,2764,6
43267,47,560,574,480,4330,80
26466,28,467,2425,368,6468,99
17888,136,2375,2846,2233,19538,142
28348,5,164,2324,143,4410,21
14689,6,280,3007,253,6550,27
37854,131,1668,1827,1608,16869,60
42372,35,394,1175,372,8321,22
21405,25,544,2667,533,4940,11
23363,298,5218,2566,4475,20908,743
6212,81,2133,3521,1944,20273,189
19710,7,192,2763,182,4219,10
42359,135,2033,1181,1520,17934,513
27588,2043,47296,2367,34414,192862,12882
42247,40,503,1297,450,7169,53
12960,38,1024,3139,966,11132,58
42535,76,1054,1042,874,12381,180
26338,18,534,2431,377,5633,157
42780,22,308,908,187,6479,121
15234,128,3158,2974,2402,28969,756
43182,25,290,632,251,4967,39
43717,0,17,278,15,923,2
11904,47,1467,3198,1355,27981,112
18982,61,1390,2798,1132,9933,258
42432,6,71,1135,65,4190,6
37792,25,638,1832,366,6984,272
13122,13,256,3128,213,3749,43
28891,26,384,2293,328,3926,56
19028,22,883,2796,523,8792,360
43674,2,39,295,27,1160,12
37695,6,88,1840,82,1967,6
19465,109,2205,2775,1931,8964,274
30736,9,118,2198,109,2449,9
39337,9,217,1729,202,8410,15
42354,26,429,1182,347,5598,82
43290,11,121,559,113,3613,8
28519,330,6054,2313,5509,22918,545
31868,1,49,2142,39,2320,10
14661,6,987,3008,262,7359,725
36948,131,2767,1886,1796,18068,971
21345,76,1310,2671,1159,9014,151
42150,4,126,1392,104,3479,22
43027,3,111,790,90,3185,21
16202,286,15138,2931,12523,107260,2615
43451,8,82,434,73,1401,9
34185,8,112,2048,100,2360,12
42134,201,3154,1418,2914,21093,240
34489,3,122,2035,112,5021,10
12830,9,246,3147,238,3671,8
29713,83,1384,2252,1213,12457,171
22029,63,978,2631,890,8778,88
43338,12,148,505,108,2225,40
27082,10,393,2399,315,8798,78
28293,85,2961,2327,1493,21642,1468
43061,3,40,757,32,1622,8
3915,99,2172,3622,1839,21031,333
35483,16,498,1980,417,13342,81
28830,45,960,2296,887,22823,73
40289,12,259,1670,230,8704,29
43101,439,4555,719,4296,23159,259
27969,11,276,2345,246,4643,30
42569,15,138,1017,110,3495,28
43035,75,833,786,531,6367,302
6044,66,1382,3526,1291,6698,91
1674,7,101,3699,93,2285,8
42575,1621,42008,1004,29108,169788,12900
41360,27,348,1555,317,4796,31
41737,447,7405,1498,6611,52758,794
43305,17,292,538,226,6792,66
19934,2,96,2751,90,2470,6
14194,2,167,3042,164,6150,3
23648,0,0,2552,0,3862,0
34290,7,203,2044,181,3324,22
43120,319,4088,683,3483,27446,605
42509,2054,39974,1059,31834,239333,8140
12736,6,72,3152,63,2331,9
24454,6,97,2516,97,2460,0
42283,27,308,1256,239,7009,69
9647,8,273,3312,166,2847,107
42014,11,188,1450,163,5802,25
27090,5,97,2398,88,2806,9
42484,2,57,1080,42,1456,15
27303,149,2675,2385,2490,21856,185
8359,104,3388,3391,1935,16560,1453
42271,266,3909,1265,3457,25319,452
23012,3,102,2583,96,2232,6
41896,44,1134,1468,848,11897,286
42504,135,1846,1063,1349,20736,497
42473,170,2878,1088,2159,23789,719
10293,32,637,3282,626,8957,11
43427,2,56,448,33,1489,23
39446,5,84,1723,68,3574,16
6130,5,153,3524,122,3212,31
35580,72,1421,1973,1077,11729,344
11275,10,286,3229,285,8494,1
27305,228,4403,2385,3955,28961,448
42086,42,701,1437,633,7401,68
42979,251,5797,832,3052,35753,2745
19335,13,381,2782,325,7109,56
34620,0,62,2028,60,5415,2
42168,7,78,1372,69,7790,9
43873,0,16,178,14,265,2
36599,6,237,1907,199,3285,38
25275,11,456,2479,374,4225,82
40060,56,922,1685,815,6388,107
33334,7,123,2078,101,3314,22
35938,1,53,1946,42,2155,11
38080,10,244,1813,227,4613,17
33251,17,256,2081,224,6883,32
42409,3,39,1160,37,2532,2
35237,52,755,1994,668,8367,87
43757,4,64,263,51,2585,13
43018,27,307,803,200,3497,107
15175,157,2944,2977,2539,14948,405
38444,17,417,1787,373,8581,44
42193,17,263,1345,191,4494,72
43005,6,184,814,149,4212,35
42488,4,90,1079,69,4434,21
22956,16,310,2585,272,6818,38
18016,163,2691,2838,2382,18777,309
43003,104,1356,816,1017,8928,339
42321,16,311,1223,281,7422,30
23981,585,12967,2537,11225,55889,1742
18159,25,397,2833,363,5427,34
25468,100,4568,2471,2660,21780,1908
42307,1,32,1239,31,2077,1
29341,269,6121,2269,4903,29420,1218
43028,24,275,789,182,4055,93
42157,19,245,1382,219,4821,26
23113,0,74,2578,66,2364,8
34184,11,155,2048,134,3678,21
42178,2,72,1366,60,2836,12
37660,13,237,1842,197,3930,40
19467,60,1495,2775,1240,8765,255
7390,3,66,3463,65,1994,1
30632,3,114,2203,77,4486,37
2612,2,530,3647,208,2452,322
43526,3,49,385,37,1580,12
42568,18,242,1018,208,2878,34
42202,168,2746,1337,2545,19338,201
43226,23,219,603,182,4499,37
6051,20,421,3526,398,4626,23
42187,4,118,1353,103,4786,15
15453,4,186,2965,169,2486,17
16826,4,320,2898,278,4431,42
37000,17,278,1883,275,5697,3
16830,14,256,2898,230,4077,26
39343,3,230,1728,180,3047,50
43118,65,554,695,531,11157,23
41799,37,662,1485,595,15808,67
6166,3,114,3522,110,2158,4
42476,2,60,1084,46,3390,14
39430,7,88,1724,76,7471,12
28479,41,746,2317,627,15888,119
28258,2,67,2329,59,2130,8
41280,18,492,1567,227,9583,265
43582,3,76,348,71,2105,5
31904,9,200,2140,130,3256,70
43090,42,661,734,581,7324,80
30236,33,563,2226,459,5801,104
24395,2,174,2518,152,4584,22
8380,224,4481,3389,4437,75979,44
42554,580,10665,1032,9381,41420,1284
43311,470,7713,532,7233,52402,480
21886,10,267,2640,226,7565,41
43445,10,149,434,126,5736,23
37539,21,545,1849,346,4998,199
43321,0,33,524,29,1415,4
43657,77,1710,304,1067,8794,643
30766,7,109,2196,95,1970,14
37509,12,279,1851,242,4168,37
42907,20,307,862,205,5409,102
43057,418,5961,762,5716,35530,245
42245,197,3709,1298,2677,23113,1032
23886,8,216,2542,194,8695,22
42501,12,209,1064,185,2945,24
42278,41,528,1259,468,4709,60
10272,21,1312,3283,402,4618,910
42464,17,161,1095,154,6274,7
43339,154,1928,505,1787,11591,141
43749,73,1181,265,934,18172,247
43561,13,139,367,138,2961,1
39308,15,339,1730,299,8496,40
43115,12,141,700,116,4326,25
42988,71,966,831,868,5839,98
40523,0,229,1648,198,4897,31
39573,3,126,1715,117,4630,9
42521,217,2688,1051,2573,17708,115
34288,8,207,2044,175,3031,32
30696,463,8682,2199,8148,33651,534
43042,0,0,778,0,1500,0
27157,1,47,2394,45,4161,2
43616,6,68,326,41,1707,27
42333,163,2122,1208,1896,46422,226
31051,1042,32201,2185,21563,122700,10638
43437,14,129,438,125,1704,4
42658,133,2203,959,2070,20330,133
42344,107,1409,1196,1169,18068,240
42343,440,5994,1199,5324,35907,670
43173,0,32,636,31,1734,1
43334,3,98,509,77,3756,21
42234,72,1061,1304,907,14073,154
27024,6,80,2401,74,2934,6
21589,14,297,2657,264,4232,33
19604,1038,27636,2769,23263,227928,4373
43694,3,45,289,45,1959,0
43785,2,53,240,53,2195,0
42423,8,91,537,88,2525,3
31389,10,323,2167,247,5385,76
40111,11,238,1682,186,4295,52
42379,29,558,1172,480,3876,78
34588,270,46943,2030,5724,59810,41219
23743,6,103,2548,96,2728,7
39350,961,18404,1728,15340,72031,3064
42450,113,1916,1110,1847,15108,69
42804,1,52,894,17,1603,35
11902,42,1238,3198,1173,17423,65
42103,312,4602,1435,4495,21969,107
14156,6,445,3045,166,7882,279
30023,17,264,2237,163,4479,101
42317,51,703,1226,532,9665,171
19717,64,1996,2763,1616,17416,380
42119,17,348,1430,305,12167,43
42282,12,179,1256,146,4175,33
43222,35,389,604,378,3479,11
6100,45,1881,3524,1740,22668,141
43320,46,2428,526,1393,27625,1035
30562,121,2352,2207,1929,20906,423
9414,18,420,3326,369,6853,51
43432,4,68,443,48,2053,20
42376,126,2250,1173,1739,27482,511
37795,846,18651,1832,15874,214888,2777
12831,18,550,3147,538,5830,12
28889,24,1203,2293,393,11332,810
26581,14,229,2420,196,4109,33
36711,109,1624,1901,1385,17012,239
4337,19,856,3607,641,6448,215
26260,1482,34062,2434,25968,163881,8094
10860,9,724,3251,232,7623,492
42295,29,535,1248,486,14116,49
10448,133,5765,3275,5574,39360,191
28122,12,491,2337,397,10984,94
40700,21,318,1632,292,7100,26
20116,13,327,2741,289,4483,38
42880,0,24,868,16,1302,8
43365,78,1804,484,1431,24069,373
10192,7,323,3286,136,4339,187
22933,193,3996,2586,3876,29709,120
30679,5,140,2200,129,2820,11
4788,4,215,3590,122,2244,93
21670,27,579,2652,530,5166,49
41052,21,293,1600,260,4820,33
26259,42,644,2434,553,4423,91
37871,20,420,1825,390,5665,30
16979,2,131,2891,113,4609,18
42160,55,585,1378,526,7136,59
29091,15,195,2283,181,3280,14
43644,15,93,308,93,3423,0
43102,2,92,718,44,3876,48
40277,6,53,1671,43,2159,10
14679,1,84,3007,77,3178,7
6928,51,1227,3489,1010,10455,217
22002,577,10971,2633,9563,64851,1408
43127,2,84,672,66,2665,18
41173,29,448,1585,386,4952,62
12547,287,6504,3164,5912,62027,592
43672,5,50,296,23,1215,27
43235,1,35,599,27,1580,8
18790,4,96,2805,89,4190,7
39405,35,1022,1725,882,12858,140
27696,23,905,2361,633,9536,272
23346,290,5297,2567,4720,18600,577
26836,279,7102,2408,5929,26490,1173
6845,25,337,3493,337,4979,0
43845,3,45,196,41,1117,4
9227,47,1616,3338,1154,13067,462
945,19,469,3986,461,7061,8
27457,95,1616,2375,1552,8917,64
5155,57,2302,3571,1272,12543,1030
42170,54,1316,1370,1130,14369,186
42220,4,94,1312,83,2152,11
1683,0,65,3698,64,1940,1
43011,3,39,807,31,1645,8
42430,64,837,1136,644,8879,193
41116,2,115,1590,102,4348,13
13279,56,1843,3112,1607,17827,236
8708,1,68,3368,66,2215,2
29817,32,690,2247,598,10115,92
9330,3,487,3331,111,2608,376
22382,4,186,2615,178,3229,8
42394,4,53,1168,50,2125,3
28887,19,878,2294,379,9910,499
7113,17,939,3478,920,17835,19
42151,9,337,1389,290,6157,47
43346,18,107,499,95,1674,12
1422,256,5851,3777,5346,52343,505
26513,57,1078,2422,932,13821,146
33916,38,941,2056,845,10660,96
42948,6,119,798,86,3094,33
27890,16,176,2350,154,3322,22
43107,16,924,716,117,6119,807
16555,14,209,2913,189,3513,20
21837,33,705,2644,620,4912,85
42242,7,174,1301,159,2098,15
42246,8,172,1297,106,4930,66
42428,10,176,1138,141,4188,35
43454,3,40,434,36,1885,4
42313,776,12755,1231,12095,79961,660
42326,9,97,1217,80,2896,17
22161,59,938,2625,706,11270,232
42908,11,164,862,124,2449,40
43475,6,446,416,305,7019,141
12440,5,218,3168,209,2993,9
955,11,14093,3984,362,8694,13731
37866,11,230,1826,196,4586,34
43193,59,801,626,702,16213,99
42421,4,83,1147,57,3490,26
42256,37,468,1285,384,10226,84
42209,155,3528,1331,2717,25457,811
38391,81,819,1790,754,7316,65
43024,13,174,793,142,4872,32
43368,17,290,483,261,4019,29
43080,11,137,744,96,2599,41
38056,20,553,1815,423,11079,130
42638,2,37,967,20,1911,17
28421,3,109,2320,95,6029,14
12737,293,4670,3152,3987,33475,683
42274,23,262,1263,241,3774,21
22966,2,139,2585,134,5015,5
43033,19,285,788,115,1635,170
28861,325,5369,2294,4998,46385,371
27965,46,1497,2345,858,12332,639
27420,13,249,2378,207,4511,42
3879,2087,44152,3623,39838,163824,4314
13793,7,217,3072,133,5379,84
43263,15,238,579,206,7167,32
8740,9,317,3367,294,9468,23
34046,49,831,2052,648,7726,183
42884,4,49,868,36,1299,13
43871,1,28,179,27,1284,1
17639,11,307,2855,269,2710,38
34244,18,146,2046,130,4601,16
43641,9,124,311,117,2439,7
42879,2,59,868,45,1584,14
40620,10,282,1639,254,6070,28
14394,71,2165,3026,1995,25920,170
42210,3,92,1328,78,4969,14
42089,14,185,1437,169,2582,16
41771,19,449,1491,395,9394,54
30554,1,64,2207,57,10370,7
43063,3,77,757,59,3447,18
6012,6,281,3527,254,2774,27
43317,16,180,529,133,3085,47
43212,55,578,613,423,4743,155
43067,11,134,756,111,3265,23
21418,17,503,2667,430,4814,73
32493,20,363,2112,298,9154,65
41615,406,6972,1519,6482,44311,490
38352,67,1534,1792,1119,13006,415
42524,70,1042,1050,778,11907,264
42919,77,1088,860,903,9219,185
39083,8,117,1745,99,2264,18
43283,25,577,562,315,5483,262
27848,1,80,2353,68,2268,12
42860,199,2311,872,1683,17199,628
43246,56,737,591,638,9432,99
42451,51,648,1110,529,11542,119
43143,87,775,654,687,12041,88
8570,5,972,3377,196,8749,776
42392,126,2241,1168,1971,24969,270
42406,349,7421,1162,4975,36514,2446
40075,0,317,1684,295,6907,22
42499,18,251,1064,213,3106,38
42122,4,202,1428,184,4909,18
38353,19,345,1792,332,4226,13
1559,5,158,3725,156,4748,2
13315,17,433,3108,368,7558,65
32981,8,186,2091,176,5624,10
42108,10,296,1432,267,5160,29
42347,737,20875,1195,10495,114809,10380
43585,0,10,346,10,1165,0
6103,6,297,3524,285,4644,12
2363,41,1154,3652,983,16449,171
43500,1,29,398,19,1383,10
42656,139,1882,959,1690,11716,192
42393,3,218,1168,110,4699,108
6363,8,182,3514,182,3779,0
42928,79,987,850,842,10538,145
42098,18,240,1437,230,3867,10
26620,1,46,2418,37,1944,9
42582,253,3993,985,2993,25577,1000
42526,778,19393,1048,14629,115005,4764
42241,32,619,1302,551,10189,68
41074,18,270,1596,227,3694,43
39437,9,188,1723,153,3324,35
27550,4,56,2369,52,1582,4
42120,118,2301,1428,1941,19333,360
13198,29,1102,3116,923,10543,179
29965,31,509,2239,491,4400,18
14678,2,87,3007,82,3116,5
39329,328,6566,1729,5326,43264,1240
42201,7,141,1338,111,8173,30
14414,117,3291,3025,2340,22841,951
3875,955,27134,3623,19491,126157,7643
43187,59,616,631,510,6592,106
43680,29,466,294,457,5625,9
42719,64,4864,930,1208,20517,3656
24666,63,1455,2505,1326,21769,129
43415,1,19,452,17,901,2
43508,22,309,392,229,4611,80
20499,20,744,2721,717,7047,27
40636,5,179,1638,170,4597,9
23233,61,978,2573,924,7517,54
40204,119,2665,1676,2225,24226,440
37708,50,732,1839,731,5242,1
26306,16,477,2432,422,8086,55
42387,6,94,1169,75,3129,19
30049,29,654,2236,571,9447,83
43020,1,45,800,33,2378,12
25740,2,80,2457,68,3169,12
42986,63,770,831,745,6761,25
43864,20,251,185,209,1408,42
39884,20,231,1697,178,4833,53
41046,5,168,1600,136,3488,32
28849,17,337,2295,315,9273,22
16090,27,971,2935,912,15997,59
23108,17,508,2579,349,7318,159
22675,9,331,2600,311,8994,20
41337,466,8863,1558,7274,56605,1589
7555,57,1680,3453,1224,16621,456
42439,4,104,1123,87,4332,17
43309,18,290,536,272,5702,18
32628,41,990,2106,804,17400,186
26791,12,209,2410,176,2193,33
43472,8,112,419,99,2646,13
42255,52,923,1291,770,13225,153
42080,833,15769,1438,13803,84562,1966
11905,38,978,3198,915,15554,63
39442,13,236,1723,223,6510,13
22616,16,388,2603,349,5234,39
36360,36,706,1920,633,9597,73
11908,55,1325,3198,1240,14789,85
43001,721,13091,817,10245,51186,2846
21377,147,3297,2669,2948,12178,349
22051,24,508,2631,321,9097,187
43476,0,30,416,30,1307,0
28858,84,2884,2294,1636,22062,1248
8848,9,251,3360,235,4999,16
13779,4,218,3073,165,4312,53
16326,2,169,2924,138,2599,31
31997,6,143,2135,136,2622,7
31105,9,184,2182,170,2145,14
15546,34,1147,2960,970,23875,177
42126,345,7530,1427,4814,28043,2716
43347,16,144,498,140,3703,4
43077,238,2448,747,2297,23139,151
42536,4,101,1041,68,3807,33
36810,37,590,1895,504,6590,86
38823,2,104,1761,91,2622,13
41584,21,492,1523,446,13643,46
43520,80,1155,388,1148,9709,7
24867,10,232,2497,201,6975,31
43008,180,2584,810,2159,24308,425
31077,8,273,2183,249,7018,24
23035,52,1017,2583,887,15174,130
43751,3,87,264,57,3533,30
43196,51,698,622,570,9795,128
32173,24,453,2126,389,13670,64
32809,12,530,2098,306,12861,224
42322,12,327,1221,201,3333,126
34621,15,257,2028,213,4466,44
26883,0,51,2406,48,3000,3
12795,2,325,3149,86,2970,239
43186,14,166,631,110,2328,56
43306,15,471,537,443,8159,28
22263,9,425,2620,383,7240,42
43144,66,849,653,765,6297,84
42832,166,2282,882,1589,20764,693
42900,8,130,868,94,3254,36
39431,447,10149,1724,8266,56097,1883
37570,28,356,1847,291,6011,65
42673,154,1501,954,1382,15798,119
27551,5,55,2369,52,1558,3
8008,4,150,3417,139,3455,11
43142,0,29,656,22,1400,7
42427,4,27,1139,26,2151,1
43504,2,33,396,26,1494,7
41161,23,358,1586,311,4879,47
23292,15,368,2570,337,4839,31
36459,13,166,1915,142,3613,24
43662,5,40,300,33,1772,7
43040,8,127,779,111,5097,16
43089,8,78,734,67,2288,11
42782,67,634,908,528,7201,106
17937,2,216,2844,201,2914,15
43098,110,1462,722,1045,10343,417
27263,20,371,2387,315,4539,56
43455,3,54,433,47,1623,7
42549,50,500,1038,420,10000,80
42441,4,94,1122,71,3564,23
23720,25,557,2549,510,6844,47
39067,10,143,1746,127,3691,16
42559,11,154,1027,125,6189,29
42338,2,129,1205,110,3013,19
22788,50,733,2595,637,7997,96
42827,5,217,885,99,3321,118
24391,10,313,2518,240,4441,73
42474,8,125,1086,102,2182,23
35561,13,318,1975,277,10437,41
42272,9,259,1265,211,5347,48
42985,84,1106,831,988,6766,118
23365,12,121,2566,99,2254,22
43205,27,345,615,211,3694,134
1774,3,118,3671,100,2370,18
43296,22,524,552,440,10100,84
42389,15,168,1169,149,6093,19
25676,140,4129,2460,3596,23402,533
40078,18,434,1684,389,6020,45
6744,3,49,3498,47,1938,2
20872,186,3695,2699,3094,20128,601
42669,31,498,954,428,4387,70
28269,1,89,2328,77,3030,12
11194,96,1624,3233,1451,10367,173
42100,152,3097,1436,2034,28944,1063
33854,60,1249,2058,1125,12054,124
41717,64,1063,1502,962,20815,101
15259,17,262,2973,223,5257,39
42410,44,485,1159,407,4418,78
15444,8,198,2965,177,4581,21
41222,26,287,1577,267,7723,20
43031,86,1269,789,916,10353,353
29479,12,197,2263,174,8733,23
21156,277,10589,2681,9283,43606,1306
42320,11,244,1225,195,4108,49
2257,37,878,3653,765,13967,113
27314,170,2605,2385,2289,24878,316
43543,23,261,376,215,4443,46
21164,24,515,2680,442,5646,73
43208,24,171,614,77,2424,94
6932,1190,28394,3489,24622,201479,3772
1443,4,155,3775,153,2603,2
31942,141,6267,2138,2619,47792,3648
5001,8,482,3580,251,3464,231
23183,56,1293,2576,932,18566,361
25387,28,850,2474,759,9539,91
42262,2507,43510,1271,38791,204528,4719
42553,11,137,1034,95,2861,42
43528,56,2220,385,554,10754,1666
14561,6,150,3015,145,2620,5
27264,26,405,2387,334,8754,71
33050,4,115,2088,62,2632,53
27212,6,196,2391,169,3319,27
13554,79,1580,3089,1538,22114,42
24537,29,768,2511,654,7958,114
21884,50,1497,2640,1395,7003,102
15718,1,71,2952,65,3303,6
43148,32,1508,650,425,4870,1083
43034,33,547,787,497,7017,50
22373,35,792,2615,692,8055,100
42834,114,1176,882,991,14310,185
27987,20,363,2344,323,3403,40
1424,208,4709,3777,4583,32309,126
12587,1,265,3161,83,2690,182
14461,55,2796,3022,1491,23381,1305
43351,0,0,496,0,3019,0
43188,14,144,631,126,2319,18
19600,49,1630,2769,968,7159,662
1784,5,139,3668,138,3064,1
21297,145,3017,2673,2551,12041,466
43763,7,74,254,63,1730,11
42381,3,141,1171,125,6611,16
39836,13,236,1701,201,5572,35
27503,4,139,2372,124,2300,15
43029,2,7,789,7,7192,0
43784,1,30,240,18,1049,12
43245,3,18,593,9,1490,9
39828,3,84,1701,77,4524,7
23440,28,1011,2562,920,9844,91
42924,35,376,859,345,7740,31
43353,37,423,495,419,4835,4
23334,4,102,2568,88,5565,14
42498,11,204,1064,167,2707,37
43198,2,65,621,49,3250,16
33216,5,105,2082,86,2492,19
6028,5,106,3527,100,2396,6
34844,168,3823,2015,3431,18810,392
24273,34,830,2524,734,16044,96
15445,1,102,2965,89,1950,13
30660,0,71,2201,39,2840,32
43304,6,97,543,86,2930,11
43066,20,269,756,239,4382,30
42563,13,186,1022,153,4057,33
11662,30,468,3209,434,6583,34
31920,6,126,2140,112,2885,14
41570,50,1449,1527,1023,19868,426
42465,2,85,1095,57,6354,28
43180,20,247,632,190,3762,57
20602,1,33,2716,31,2695,2
42022,13,227,1449,193,4968,34
42396,335,7381,1167,4553,36890,2828
43404,2,47,457,30,817,17
3470,3,760,3632,101,2766,659
41191,0,15,1582,15,1085,0
28807,41,1105,2297,979,6506,126
34522,37,673,2033,544,6309,129
43112,85,1013,704,1000,10969,13
43191,185,2943,628,2664,19154,279
32643,23,339,2105,318,4297,21
18108,25,553,2835,405,6214,148
5671,13,954,3544,243,4344,711
1704,9,238,3696,233,3387,5
41045,4,82,1600,74,2854,8
15313,42,1490,2970,1348,9464,142
42592,18,242,981,175,5412,67
42911,10,147,861,103,2594,44
38449,10,262,1786,224,4602,38
41714,27,894,1503,694,7012,200
42237,5,150,1304,134,3382,16
24388,1,35,2518,33,2411,2
39748,10,181,1706,150,4141,31
40934,21,293,1610,250,4188,43
42093,15,264,1437,251,3458,13
6107,13,348,3524,272,5596,76
43666,13,276,299,253,2864,23
42703,53,676,946,502,5518,174
14843,2,128,2996,121,8549,7
41588,55,721,1523,597,15273,124
42261,14,271,1273,174,4232,97
23870,2,103,2542,95,8387,8
42469,52,717,1089,605,5903,112
30600,117,1589,2205,1276,13464,313
43460,6,71,434,61,1191,10
35481,46,725,1981,600,19403,125
42386,17,262,1169,234,4523,28
42939,32,386,841,276,4769,110
28750,4,130,2300,113,2514,17
27307,28,441,2385,385,5444,56
43278,17,198,564,155,2569,43
38171,28,382,1806,280,5592,102
6309,3,621,3516,96,1816,525
39890,41,1012,1696,768,16721,244
5512,49,30002,3553,759,5216,29243
26558,7,110,2420,101,3250,9
43637,0,62,314,45,856,17
42186,52,660,1356,591,7709,69
18967,4,62,2798,62,1938,0
6589,14,809,3504,387,11287,422
10411,11,1606,3277,299,11368,1307
43229,11,164,602,138,3445,26
43412,7,105,453,42,1921,63
42411,7,114,1159,84,3676,30
6131,4,117,3524,113,3043,4
25542,1,71,2467,61,4225,10
30818,9,488,2194,368,9420,120
13504,130,2386,3094,2148,32424,238
27750,7,182,2358,170,2419,12
40193,38,595,1677,556,11097,39
42583,28,322,985,249,8981,73
37010,130,2337,1883,2238,21387,99
22207,11,306,2623,282,5058,24
1189,30,10199,3903,949,17597,9250
30387,17,550,2217,472,6739,78
29969,15,211,2239,186,4293,25
42467,60,906,1093,607,10829,299
23147,6,137,2577,113,3235,24
21822,37,627,2644,576,11956,51
42667,5,62,956,54,1909,8
42167,6,100,1373,94,5395,6
38722,43,966,1767,737,12856,229
17686,7,145,2854,133,3927,12
42584,8,113,984,105,2669,8
43704,1,83,285,74,2438,9
18104,9,348,2835,324,4597,24
21939,11,226,2638,199,5515,27
14887,138,2550,2993,2094,17693,456
1627,24,459,3713,410,4052,49
42424,5,131,1146,117,6102,14
2678,249,10037,3647,6710,42746,3327
43204,36,425,618,361,5982,64
24298,10,429,2522,370,8184,59
43177,164,1732,633,1593,16445,139
22541,155,4289,2606,3787,40502,502
29101,63,1525,2283,1322,14601,203
33095,1,150,2086,103,3594,47
11040,9,219,3242,212,5444,7
43772,0,24,246,22,946,2
42299,30,349,1242,247,5851,102
23383,5,363,2565,314,9947,49
37856,500,10031,1827,8944,46396,1087
43466,9,99,426,76,1665,23
25650,79,2251,2461,1218,10394,1033
10059,65,2794,3292,2273,47312,521
42009,184,2642,1450,1954,23057,688
31167,44,1202,2179,941,17040,261
29540,5,103,2260,93,2512,10
14162,2,128,3045,95,2595,33
42459,20,466,1102,407,10350,59
42422,3,35,1148,24,1381,11
30954,23,416,2189,407,4215,9
9337,1,62,3331,62,3478,0
42291,90,2325,1249,1956,23019,369
28406,27,650,2320,564,15000,86
13464,9,278,3096,260,4965,18
42622,6,146,973,109,2540,37
33146,1,57,2084,47,3387,10
22139,28,630,2626,465,9533,165
42327,106,2005,1217,1370,11307,635
37860,30,441,1827,378,4587,63
42373,10,420,1175,314,8155,106
42758,584,8139,926,7392,47166,747
42084,12,297,1437,282,5456,15
1676,2,50,3699,48,1779,2
29461,126,5462,2263,4744,19679,718
13969,40,890,3056,665,7855,225
25770,199,5390,2456,4352,27837,1038
21725,134,2429,2649,2126,9705,303
35761,7,141,1959,115,4916,26
22928,3,82,2586,71,3558,11
43722,1,41,277,23,1298,18
42413,24,193,1156,174,5332,19
43532,2,26,380,22,1184,4
42940,16,167,840,130,3565,37
6121,5,89,3524,88,2322,1
15840,1,69,2947,59,1629,10
38824,10,141,1761,124,2267,17
42308,7,114,1237,101,3888,13
26487,9,162,2424,146,3794,16
25085,111,1868,2487,1292,14730,576
37038,318,5142,1881,4887,25804,255
43373,4,56,478,50,1861,6
33316,6,231,2079,181,6902,50
33218,4,281,2082,211,4878,70
37947,233,6637,1821,4637,31524,2000
38626,102,1591,1773,1515,22861,76
1062,6,140,3947,135,4263,5
28061,396,14562,2340,11908,44467,2654
2158,16,1046,3655,572,7592,474
42608,11,257,979,173,5493,84
42171,38,926,1370,863,8626,63
42244,49,947,1298,729,16590,218
42489,17,215,1079,205,3517,10
42445,5,118,1118,96,5371,22
28063,54,719,2340,603,7844,116
42871,47,493,868,404,5196,89
43695,10,136,289,107,2048,29
9494,64,1172,3320,1166,20506,6
43374,27,368,476,357,4505,11
7127,15,229,3477,216,2675,13
34076,1,55,2051,40,2593,15
41387,2,111,1552,92,3723,19
18984,2,73,2798,65,3179,8
22138,6,199,2626,186,9710,13
33268,217,2466,2080,2090,17857,376
43541,57,816,377,698,4925,118
27183,72,4581,2392,2270,19947,2311
43209,59,1193,613,1170,14792,23
28311,457,15727,2326,13298,44502,2429
43079,25,232,745,213,4826,19
43667,5,119,299,80,2302,39
32461,4,95,2113,73,4566,22
43104,29,304,717,265,4999,39
43515,3,66,389,65,1246,1
26530,47,1492,2422,830,20746,662
42839,7,96,882,67,2418,29
35114,7,236,2001,210,8970,26
42762,66,873,919,781,10065,92
43210,8,110,613,105,2257,5
42064,2,134,1441,90,3471,44
26088,5,317,2442,301,9133,16
42990,171,2420,827,1703,27224,717
27358,5,111,2382,105,3728,6
42930,3,134,849,71,3023,63
42725,23,1322,930,242,6196,1080
10354,12,346,3279,313,5645,33
12735,12,203,3152,100,2925,103
43589,6,77,343,76,1716,1
42925,12,108,858,77,2550,31
43260,24,242,580,191,4188,51
27167,0,134282,2393,16311,265207,117971
43126,6,118,675,75,1948,43
42400,25,569,1165,406,7217,163
42135,1,188,1415,161,3341,27
7518,30,653,3455,644,7287,9
5840,18,237,3535,222,3969,15
23089,4,108,2580,100,3259,8
35932,24,476,1946,412,5045,64
25147,150,3009,2484,2420,23184,589
6602,36,815,3504,713,9730,102
25515,18,659,2469,583,5842,76
42104,4,105,1435,89,4159,16
27246,78,1640,2388,1420,14307,220
25111,10,306,2485,269,4106,37
1425,178,4373,3777,4142,28552,231
42192,5,128,1345,111,2766,17
34970,14,225,2008,206,4603,19
42270,411,5949,1266,5301,39633,648
29464,585,17558,2263,14660,48873,2898
30765,79,1259,2197,1096,10121,163
43767,4,60,251,57,1855,3
43679,1,17,294,13,634,4
27322,40,752,2384,699,9518,53
36744,8,558,1900,366,10191,192
37538,28,484,1849,428,5090,56
18789,1,95,2805,86,3398,9
41102,4603,133638,1593,90583,616113,43055
40437,9,153,1655,146,4948,7
32379,5,54,2116,51,2094,3
40438,7,182,1655,162,3831,20
26348,299,16728,2430,5273,95284,11455
42784,144,1325,906,1213,9223,112
27132,2,125,2395,119,2010,6
41996,10,207,1453,175,4092,32
42156,1,17,1383,16,2470,1
42395,338,5044,1168,4816,47275,228
43286,50,902,555,832,9103,70
19006,52,1042,2797,906,8978,136
42221,8,121,1310,98,1751,23
12273,3,133,3178,130,2788,3
42483,143,1884,1080,1710,18966,174
42515,5,136,1054,112,4085,24
43389,9,241,462,190,6218,51
42998,24,375,820,309,6426,66
30563,413,9604,2207,8127,69748,1477
7968,32,551,3420,548,3938,3
9871,11,309,3302,309,6473,0
41307,75,1046,1563,867,9136,179
20505,2,111,2721,103,2487,8
7272,15,1052,3470,262,3619,790
26573,0,123,2420,110,2739,13
43109,35,486,711,450,6059,36
32675,32,1103,2104,572,10274,531
42366,67,1480,1176,1378,16486,102
42609,49,691,977,560,9537,131
42581,4,138,989,106,3260,32
3970,0,773,3620,110,2610,663
5304,5,992,3563,315,2276,677
42113,159,3413,1432,2609,14085,804
33468,24,418,2072,378,4871,40
43119,112,1042,684,1000,8412,42
23418,0,93,2563,76,3520,17
14257,8,228,3038,131,4284,97
27905,51,1155,2349,1027,9972,128
42118,108,1527,1430,1397,19918,130
43684,1,31,293,29,1061,2
42927,18,224,843,179,3515,45
43064,31,233,757,210,5150,23
3870,114,1814,3623,1702,15425,112
20886,2,116,2698,88,2778,28
3833,201,4249,3624,3586,32872,663
23606,756,37353,2555,24005,158198,13348
31813,448,10082,2144,8932,82569,1150
39170,125,1758,1740,1491,10841,267
13971,38,522,3056,485,7155,37
42905,22,768,862,246,9006,522
28916,598,17089,2293,14595,54537,2494
40979,18,347,1607,306,10407,41
36621,20,365,1906,310,6522,55
33651,9,171,2066,142,4221,29
43551,7,103,373,98,1261,5
25746,5,130,2457,119,2951,11
43085,48,566,738,555,5658,11
4588,6,824,3598,142,2455,682
10770,105,2679,3256,2245,15984,434
43367,23,455,483,418,6152,37
22281,6,176,2619,153,4754,23
21875,181,3545,2641,2961,30740,584
42558,111,1914,1028,1297,10506,617
42520,201,2388,1051,2290,14894,98
34167,3,158,2048,106,3735,52
12333,6,206,3175,205,7750,1
19139,8,196,2792,144,2708,52
42365,17,291,1176,205,5215,86
42492,47,538,1070,465,11986,73
41911,2,49,1466,42,1767,7
39659,6,77,1711,61,2522,16
43723,0,25,277,11,1111,14
28774,596,18907,2299,15187,57839,3720
42995,21,288,820,246,4267,42
42675,39,512,953,418,3778,94
37803,10,218,1831,187,3950,31
38558,81,2498,1778,2238,10286,260
27355,83,1281,2382,1159,14281,122
42279,12,128,1258,104,3377,24
28744,288,8780,2300,5222,34590,3558
22189,71,1604,2624,1455,17847,149
38912,13,324,1756,301,9008,23
42527,15,386,1047,332,4495,54
43168,5,70,637,53,2256,17
43375,196,4278,476,2146,46258,2132
34725,162,5175,2023,2796,41908,2379
42853,480,6356,874,5932,36353,424
29884,7,144,2243,125,2951,19
42355,15,206,1182,187,3520,19
20134,16,264,2740,215,2520,49
1419,127,3317,3777,3109,22115,208
42328,5,148,1214,133,3699,15
34412,10,188,2038,140,3799,48
21995,10,275,2633,246,7725,29
39367,12,219,1727,157,4009,62
43506,2,50,395,40,1429,10
39279,6,171,1732,108,4096,63
34364,4,130,2041,82,4580,48
28893,61,2634,2293,1471,40285,1163
22932,45,1170,2586,905,17738,265
28772,20,316,2299,288,4844,28
27747,4,166,2358,158,2007,8
28562,347,6693,2310,6091,26642,602
3867,247,22106,3624,8882,59169,13224
36872,94,1101,1890,1047,11909,54
16327,14,558,2924,459,7293,99
42456,31,437,1107,362,8324,75
24389,1,76,2518,69,2046,7
35089,3,68,2002,56,2888,12
39965,28,642,1691,492,10296,150
40760,15,200,1626,184,5136,16
43216,50,799,606,632,7850,167
6528,11,638,3507,576,7960,62
43162,22,300,644,199,3493,101
38826,21,347,1761,315,7333,32
42268,27,476,1267,382,9434,94
42628,3,72,972,47,1318,25
17432,44,1468,2865,1167,23101,301
33217,4,48,2082,42,2357,6
1747,5,86,3681,85,2382,1
5846,74,1546,3535,1424,17568,122
1677,0,51,3699,48,2130,3
42512,40,485,1057,409,5465,76
29281,27,369,2274,329,7904,40
40894,2,137,1613,132,4050,5
42455,11,89,1107,82,2692,7
42416,32,500,1153,422,5120,78
42507,34,345,1062,313,7502,32
7662,66,2108,3447,1465,10905,643
9496,45,1199,3320,1190,21275,9
43273,19,141,568,136,1895,5
3677,0,341,3628,76,2467,265
31940,15,326,2139,272,5326,54
42140,7,131,1404,107,2568,24
43438,10,52,437,50,1005,2
43754,4,42,263,39,1262,3
42503,22,388,1064,347,4474,41
14627,2,111,3011,71,3344,40
24341,10,84,2521,72,2552,12
7389,36,1198,3463,624,7823,574
42565,5,77,1021,68,2195,9
1286,88,2524,3877,2312,20290,212
41626,222,4942,1517,4135,42684,807
28800,1,107,2298,92,3468,15
42893,3,57,868,50,2246,7
1216,9,159,3899,156,3437,3
42115,15,228,1431,209,4467,19
43207,71,3579,614,2991,30223,588
20701,4,68,2710,64,1900,4
42989,81,1278,831,1017,8637,261
17814,2,127,2849,105,5363,22
41789,41,582,1487,520,7617,62
42648,13,113,964,92,3813,21
30424,37,472,2214,400,7677,72
1695,8,205,3697,188,4615,17
1563,3,73,3723,73,2144,0
42129,19,476,1426,435,7741,41
12189,411,7406,3183,5254,40627,2152
42350,12,317,1189,238,5192,79
6206,14,629,3521,625,6923,4
8668,32,1442,3371,1246,21159,196
22442,8,195,2612,151,3227,44
34422,5,166,2038,152,7447,14
43006,72,600,811,562,10134,38
43190,34,510,630,323,4114,187
6757,41,1851,3497,932,6786,919
27306,361,7144,2385,6144,45858,1000
3877,8,152,3623,134,5199,18
35423,31,622,1984,550,7625,72
27859,15,335,2352,293,3654,42
36876,24,445,1890,414,5344,31
43639,3,58,312,51,1919,7
12088,0,141,3189,89,5648,52
23335,368,6305,2568,5473,30480,832
42932,35,341,849,337,9227,4
8537,106,2951,3379,2406,15133,545
37804,9,311,1831,155,4661,156
1430,152,2557,3777,2385,32037,172
43238,211,2986,596,2668,21288,318
43564,5,53,364,42,1350,11
27708,32,431,2360,386,3707,45
22969,284,6904,2585,6173,33332,731
41220,9,177,1578,117,4546,60
42280,3,248,1258,209,4191,39
25930,4,170,2449,121,3629,49
15671,12,493,2954,362,4540,131
41810,27,371,1482,366,8231,5
42508,18,276,1060,256,5074,20
42599,6,63,979,48,2108,15
34530,2,126,2033,118,2708,8
24294,25,677,2522,579,6613,98
34074,10,168,2051,123,4518,45
6045,2,140,3526,119,3173,21
43046,18,219,773,189,3601,30
43467,1,31,424,16,1461,15
18689,3,117,2809,99,2455,18
3936,10,422,3622,416,7854,6
35368,206,4090,1988,3615,19452,475
29469,20,794,2263,664,14760,130
43569,0,139,1757,96,3610,43
30788,185,5533,2196,4810,22979,723
41542,255,5629,1530,4064,36226,1565
43630,5,120,315,66,1935,54
19510,10179,268100,2773,185504,1144691,82596
32356,1,46,2117,42,2593,4
25376,2,82,2475,76,2935,6
43217,6,56,605,48,1798,8
23219,113,4005,2573,1741,17025,2264
17828,8,422,2849,386,4648,36
37001,92,1958,1883,1784,27955,174
30917,45,1156,2191,990,8302,166
42896,1,52,868,33,1631,19
43436,7,100,439,77,3373,23
32639,10,193,2105,169,8088,24
42133,7,96,1420,79,3761,17
11743,1,189,3205,72,4739,117
37468,16,320,1854,269,6010,51
28268,11,236,2328,200,4863,36
42629,115,2355,971,1738,20523,617
37885,31,941,1825,546,7439,395
30791,176,4694,2195,3526,35160,1168
41654,76,1391,1512,1113,19776,278
26557,4,113,2420,103,3153,10
42111,56,927,1432,773,11541,154
10351,4,149,3279,144,2753,5
19727,15,262,2762,237,4144,25
42147,5,169,1393,127,4212,42
42802,17,211,894,167,5227,44
42571,31,520,1011,367,8584,153
39605,232,4234,1713,3635,29683,599
34453,4,149,2037,125,6955,24
1957,18,1283,3659,1024,11936,259
42490,74,1076,1078,971,6138,105
42385,19,514,1169,316,5526,198
42505,16,237,1062,218,3525,19
42576,92,1024,996,962,7829,62
42116,28,230,1431,196,3818,34
43199,15,163,621,148,6551,15
41658,498,7203,1512,6639,37133,564
43473,5,133,419,116,3349,17
42063,13,217,1441,212,5630,5
8715,23,647,3368,599,7035,48
42388,14,193,1169,156,6224,37
43330,36,1360,511,531,8288,829
30436,7,112,2214,95,1865,17
6958,46,1904,3487,884,12450,1020
36406,1830,32318,1918,30144,136525,2174
35815,2,155,1954,96,6620,59
26870,130,1985,2406,1751,18572,234
21935,9,195,2638,173,6838,22
28363,7,317,2323,283,6159,34
33049,2,86,2088,78,4747,8
43471,28,255,421,210,2350,45
42523,211,2477,1051,2367,15828,110
28860,0,37,2294,29,2095,8
27948,11,211,2346,179,4922,32
43151,61,642,648,582,8869,60
2548,6,446,3648,298,4752,148
37489,534,11532,1852,10493,48100,1039
39450,6,192,1723,139,4023,53
11990,5,74,3193,62,2410,12
40529,22,339,1647,282,4724,57
41298,160,2648,1563,2332,27694,316
42188,34,535,1353,458,15041,77
41733,31,433,1499,402,7518,31
8670,2,123,3371,114,3796,9
43459,2,64,433,51,1642,13
22868,4,160,2590,139,6726,21
14432,6,122,3024,89,3346,33
42721,80,4703,930,1148,24879,3555
15987,33,498,2941,431,4404,67
1655,4,10312,3704,77,2437,10235
42213,6,49,1326,40,2815,9
31045,26,547,2185,507,7587,40
21710,143,2602,2649,2135,18754,467
42276,0,0,1259,0,5094,0
43139,33,462,656,402,4022,60
25386,31,583,2474,578,4874,5
22160,7,184,2625,157,3402,27
43054,17,260,767,175,4890,85
42265,19,325,1269,266,4445,59
6101,34,697,3524,568,8027,129
40299,120,1914,1670,1809,16822,105
26734,12,277,2413,249,3070,28
17379,67,1111,2867,927,7757,184
42130,51,677,1424,617,7435,60
43275,98,1365,567,1264,13779,101
34851,37,836,2014,465,9806,371
24048,3,124,2534,115,2278,9
38822,24,287,1761,265,3739,22
6015,4,99,3527,81,2375,18
43361,13,203,489,137,3297,66
12816,74,2007,3148,1868,14452,139
40967,103,1397,1608,1235,12888,162
40501,2,96,1649,89,2738,7
42191,0,0,1349,0,10960,0
5856,6,746,3535,280,8241,466
17872,3,176,2847,106,4742,70
43266,161,2455,575,1628,17381,827
43202,53,515,619,480,7160,35
6127,30,572,3524,506,6377,66
31867,3,164,2142,133,3170,31
42364,12,437,1177,327,7227,110
43645,4,39,308,37,1326,2
32506,100,2284,2111,1808,19690,476
1417,116,3067,3777,2912,27320,155
42980,8,137,832,98,2593,39
22443,10,281,2612,231,7598,50
1002,49,1972,3969,1192,17246,780
4386,2,261,3606,254,3735,7
42851,121,1673,875,1292,10369,381
42169,22,505,1371,440,10642,65
42269,101,1757,1266,1369,17287,388
42179,54,779,1363,580,8021,199
42107,7,117,1433,108,2784,9
9407,59,2785,3326,2028,20962,757
42518,29,457,1052,380,9045,77
37228,6,140,1869,127,10354,13
43733,14,123,271,111,1588,12
39938,0,30,1693,28,2123,2
3880,7024,167967,3623,126860,1102942,41107
37899,22,881,1824,650,10464,231
23442,7,434,2562,410,13876,24
1014,75,1228,3965,1218,10995,10
32285,1,79,2121,71,3119,8
6858,6,124,3492,122,2902,2
33478,22,518,2072,450,8667,68
43719,6,25,278,24,1060,1
43333,7,74,509,60,2536,14
42353,7,121,1184,117,2042,4
43625,0,28,316,25,1356,3
37976,12,329,1819,293,7330,36
43495,0,41,404,28,1216,13
29223,9,306,2277,238,5579,68
43072,378,6047,747,5328,31150,719
39462,13,289,1722,255,7032,34
3105,4,282,3639,134,3162,148
4906,22,1139,3584,571,6682,568
42289,2,62,1251,48,2809,14
29866,6,138,2244,124,3249,14
21042,2,149,2688,136,3209,13
13218,32,736,3115,618,6237,118
43611,6,48,329,41,1527,7
28547,17,436,2311,382,6924,54
36455,2,98,1916,82,10069,16
39125,193,3005,1742,2782,19946,223
24097,2,62,2531,53,1416,9
43527,51,565,385,521,6139,44
37435,39,472,1856,412,8333,60
42525,6,105,1050,82,3185,23
43482,7,86,413,80,1967,6
25477,4,172,2471,163,2026,9
38967,5,168,1752,145,3680,23
42562,51,610,1023,494,6596,116
43022,53,762,796,663,6635,99
43132,4,88,668,64,1918,24
43388,6,84,463,74,2738,10
26243,2,82,2435,69,2439,13
38369,288,9352,1792,7719,33682,1633
21827,1,42,2644,37,2787,5
28771,5,173,2299,152,4665,21
14458,157,3437,3022,2956,30206,481
23875,8,315,2542,271,7553,44
34180,39,427,2048,364,3616,63
43761,2,30,254,20,1018,10
26039,30,480,2444,416,4157,64
42506,20,220,1062,214,6076,6
3612,55,883,3629,833,12033,50
43133,117,1468,668,1324,13577,144
27266,56,1613,2387,1325,9563,288
33722,8,152,2063,127,3462,25
38296,14,298,1797,218,4920,80
9874,32,596,3302,417,4025,179
43789,5,98,237,51,1555,47
35094,130,2900,2002,2665,33102,235
43390,6,108,462,100,3439,8
43244,27,214,594,185,3462,29
28833,1,57,2296,54,2472,3
42162,30,325,1377,277,2920,48
42081,0,92,1437,71,12566,21
29480,13,330,2263,311,9785,19
42431,226,4057,1136,2863,21427,1194
43371,8,284,482,242,3749,42
43152,169,2282,647,2207,15419,75
6010,11,283,3527,263,3133,20
24857,19,414,2497,351,3761,63
36869,14,230,1891,210,4621,20
35386,16,267,1987,250,4846,17
43124,135,1458,680,1269,9679,189
10994,82,1698,3244,1464,13853,234
15026,28,500,2985,424,7694,76
19638,15,165,2767,146,2560,19
43357,13,109,492,88,3091,21
42511,55,725,1057,614,6509,111
27239,32,483,2389,454,9571,29
31655,18,389,2152,338,2543,51
43546,5,57,375,47,2019,10
6163,2,3439,3522,108,4771,3331
7486,1,866,3458,45,2042,821
8146,5,407,3406,138,2254,269
42149,159,2476,1392,2014,26836,462
30047,27,462,2236,452,4312,10
22610,0,71,2603,62,2627,9
33982,94,2082,2054,1550,13455,532
42163,6,110,1376,106,3723,4
33370,41,698,2076,608,5702,90
42183,10,108,1357,97,2757,11
38889,22,529,1757,445,8523,84
43830,2,35,204,29,1009,6
42203,2,36,1337,27,6023,9
43214,101,2066,609,1347,13367,719
43044,8,167,777,126,3844,41
42652,49,475,961,426,6008,49
43739,1,36,269,28,977,8
33271,9,142,2080,116,4542,26
42480,139,1933,1081,1839,21557,94
42195,4,75,1345,62,1891,13
42153,63,1024,1386,851,13978,173
30199,15,233,2228,213,4850,20
40734,29,381,1629,303,7126,78
42741,16,178,938,134,5349,44
27117,1,127,2397,118,3692,9
12550,41,696,3164,661,13850,35
43435,3,46,439,44,2142,2
43015,130,1960,805,1351,10961,609
27565,2,131,2368,87,2940,44
26561,5,116,2420,106,2122,10
23195,4,201,2575,179,5078,22
1610,311,5761,3716,5432,53847,329
19543,24,464,2772,404,15724,60
21422,46,1326,2667,1170,23245,156
43596,8,84,339,61,1882,23
42796,1486,29289,900,26256,107617,3033
38528,14,302,1781,265,4996,37
43562,3,71,366,40,1306,31
21252,3,182,2675,152,3405,30
35750,2,154,1960,112,4577,42
969,27,767,3980,676,9460,91
33432,205,2908,2074,2724,35311,184
23107,69,1619,2579,1469,16801,150
43116,31,257,699,162,3548,95
43358,25,292,491,252,3765,40
42668,22,403,956,346,7116,57
42110,2,51,1432,45,1645,6
43670,1,38,296,34,1117,4
43403,6,60,457,48,1419,12
42216,4,80,1318,76,2312,4
43251,1,25,587,20,1680,5
42236,12,190,1304,170,3491,20
43600,2,84,338,73,1447,11
27458,111,2189,2375,1973,20804,216
14861,3,511,2995,255,13456,256
1356,15,8314,3837,403,5535,7911
18656,1,242,2810,223,3747,19
32974,4,94,2092,77,3477,17
24376,131,4109,2519,3686,26230,423
42848,4,66,876,48,2252,18
35478,4,220,1981,187,3130,33
31746,4,64,2148,56,1751,8
22076,31,339,2629,267,3468,72
43714,7,72,279,56,2104,16
42177,88,1996,1366,1590,21818,406
35794,0,43,1956,38,2209,5
42331,3,97,1210,79,2868,18
43419,8,70,450,59,2979,11
43497,6,50,402,47,1514,3
41726,5,159,1501,127,4294,32
42903,95,4982,866,1946,51637,3036
31571,23,207,2157,200,5164,7
21970,132,2582,2635,2383,12182,199
19153,20,418,2791,349,5038,69
42993,5,240,821,153,2345,87
1479,17,449,3750,404,3488,45
43215,7,57,609,49,2394,8
30810,8,138,2194,115,3686,23
31068,3,184,2184,143,3495,41
23676,186,3805,2551,3207,31588,598
43147,15,541,650,268,6654,273
42131,21,322,1421,273,4665,49
36891,12,340,1890,265,4388,75
43047,2,10,772,9,1505,1
7519,6,169,3455,169,2439,0
27069,76,1242,2399,1112,15507,130
35622,118,2295,1970,2004,18344,291
42433,22,456,1134,370,6812,86
9125,9,131,3345,104,1873,27
42938,12,137,842,108,2644,29
27895,41,1512,2350,967,18963,545
42552,5,44,1034,39,2060,5
6098,17,548,3524,462,4741,86
20491,68,2415,2722,2065,16538,350
29906,214,4124,2242,3917,19189,207
18927,8,272,2800,242,5668,30
22587,97,2447,2604,2076,11721,371
43822,4,50,210,41,1079,9
27139,10,151,2395,125,2018,26
3882,1177,22945,3623,21111,203348,1834
13384,140,2687,3103,2238,16501,449
42561,65,852,1024,702,10438,150
42830,62,873,885,667,8761,206
42479,13,233,1082,212,4704,21
38235,12,218,1802,215,6123,3
37535,7,195,1849,148,8354,47
42425,20,300,1145,231,6162,69
43502,31,235,397,222,3351,13
6673,12,2095,3501,223,2663,1872
28275,3,96,2328,82,2502,14
37328,120,1666,1863,1578,14980,88
42420,114,3136,1152,2186,28192,950
40958,11,265,1609,248,7623,17
42042,72,966,1445,865,11830,101
5583,2,894,3549,206,6047,688
33408,1,62,2075,48,1589,14
9754,393,24620,3308,14062,113667,10558
26309,16,589,2432,530,10417,59
42239,61,950,1302,823,7834,127
21375,40,779,2669,722,5050,57
24777,11,153,2501,145,2236,8
42085,3,29,1437,25,1573,4
35923,8,151,1947,136,7551,15
42760,12,225,920,181,3470,44
43155,153,1952,646,1892,9768,60
42164,54,659,1374,566,8589,93
6031,50,1209,3526,1168,20755,41
29862,5,62,2244,48,2280,14
43614,2,55,329,21,1032,34
41728,10,229,1501,186,5498,43
31248,20,284,2175,238,7660,46
42228,19,281,1308,279,5152,2
43576,30,336,353,301,4488,35
42137,26,534,1412,417,10048,117
42296,10,309,1246,183,5675,126
35948,44,1295,1945,1170,25130,125
1691,31,786,3697,622,6457,164
43276,7,108,566,96,2391,12
36017,10,180,1940,140,2621,40
11665,11,220,3209,208,3422,12
43184,39,381,632,327,5193,54
43016,56,1204,804,864,12144,340
43137,5,37,658,26,4540,11
41649,49,859,1512,672,9209,187
42444,23,302,1118,272,5197,30
43602,58,732,336,650,8932,82
1650,2,90,3705,86,3291,4
42534,1,72,1042,43,2241,29
42580,46,654,991,537,7054,117
42143,9,133,1400,119,3646,14
29374,3,125,2268,112,3199,13
27198,9,159,2391,141,6020,18
42252,27,522,1294,439,6347,83
42685,80,1283,951,873,11484,410
1671,279,5781,3700,5187,53735,594
43377,15,196,474,178,2772,18
37208,27,464,1870,439,7162,25
39957,50,649,1691,546,9997,103
6030,6,91,3527,88,2304,3
39122,110,2048,1742,1838,15618,210
33285,13,462,2079,379,10388,83
32210,174,3401,2124,3153,16446,248
6047,35,921,3526,879,11343,42
40077,0,390,1684,360,6551,30
28254,85,2231,2329,1994,51570,237
37362,3,174,1861,142,5393,32
1622,170,4183,3714,3845,41237,338
33153,8,310,2084,263,7396,47
42397,11,263,1167,200,4187,63
23357,61,1020,2567,895,12416,125
41947,415,8856,1460,7728,59584,1128
43563,10,113,365,111,3215,2
23745,17,254,2548,224,5036,30
43277,28,294,565,287,3941,7
20998,1,137,2690,69,2639,68
43268,59,601,574,580,6825,21
43683,4,61,293,31,1545,30
43511,54,763,390,755,6445,8
8479,55,2657,3383,1137,10982,1520
13582,7,132,3088,117,2773,15
43499,6,67,398,57,1166,10
22024,33,721,2632,309,8206,412
3906,167,2979,3622,2727,35196,252
43448,4,59,433,57,1589,2
30633,2,71,2203,64,2984,7
18971,1,126,2798,81,2591,45
43607,4,75,333,70,2708,5
21528,161,3111,2660,2661,25773,450
38976,24,614,1751,426,10964,188
42495,55,618,1068,522,4010,96
28113,3,111,2338,99,2308,12
36812,27,560,1895,442,7609,118
41371,50,1153,1554,798,10653,355
1423,191,4191,3777,4026,27312,165
43603,80,928,334,926,8516,2
8796,5,182,3363,173,2275,9
41589,1280,27662,1522,24205,180273,3457
37330,47,798,1863,735,8928,63
22441,15,172,2612,141,2482,31
12259,0,357,3179,32,4610,325
42858,126,1515,872,1207,15650,308
42407,150,2474,1162,2090,17899,384
43729,11,221,272,94,3270,127
15325,21,364,2969,321,7560,43
42937,4,153,843,90,5584,63
42727,7,89,930,67,2008,22
43429,52,733,447,614,8855,119
29206,108,1823,2277,1705,11579,118
20928,24,442,2695,372,6813,70
21639,14,542,2654,481,10076,61
21855,12,338,2643,236,6104,102
13981,4,160,3055,142,3326,18
14467,3,239,3022,158,4831,81
36945,8755,191878,1887,153924,1267462,37954
42146,109,2216,1394,2070,16655,146
940,8,644,3988,320,7867,324
42744,109,1317,933,1004,12901,313
43087,525,6535,737,6077,36039,458
30152,26,454,2231,441,4155,13
36373,38,722,1919,570,6963,152
43636,6,46,314,38,1416,8
43084,21,147,739,122,2869,25
41635,10,219,1516,172,9968,47
43017,100,1295,803,1175,10844,120
29542,32,584,2260,553,5431,31
28599,5,235,2308,215,5731,20
42481,5,90,1081,65,3876,25
1713,15,298,3691,296,5343,2
43376,12,143,475,139,2323,4
28252,15,387,2329,353,6934,34
24293,6,158,2523,108,3041,50
37672,25,473,1841,440,6813,33
14889,46,673,2993,591,7892,82
43060,25,243,757,234,4978,9
30268,0,80,2224,71,2457,9
15341,3,96,2969,79,2279,17
23654,4,88,2552,77,2958,11
33096,10,296,2086,278,7076,18
42875,3,113,868,74,2031,39
22684,68,2358,2600,807,9900,1551
21265,0,78,2674,73,2612,5
41833,3,87,1478,82,2821,5
43039,1329,33402,780,21277,209253,12125
41238,16,297,1574,235,4506,62
27057,6,89,2400,82,2561,7
42405,335,7209,1162,4720,31548,2489
20557,53,3569,2718,1091,23084,2478
7147,4,94,3476,91,3527,3
23197,56,978,2575,777,6358,201
40303,0,80,1670,68,3874,12
43036,47,666,784,560,9760,106
27312,67,1207,2385,1050,12961,157
28848,4,217,2295,206,5442,11
43183,35,262,632,237,3714,25
28552,295,6183,2311,5609,32589,574
937,18,2938,3988,605,11439,2333
27221,5,292,2390,182,5528,110
42235,26,380,1304,352,5640,28
7934,10,301,3424,299,4319,2
42468,26,384,1091,340,2916,44
28862,15,479,2294,414,6288,65
40223,12,222,1675,191,5240,31
43668,2,34,299,21,1621,13
19942,71,1649,2750,1127,8634,522
42377,43,1143,1173,656,6726,487
12957,42,1183,3139,1119,12125,64
15452,4,170,2965,152,2258,18
6050,25,559,3526,536,5844,23
17949,5,73,2842,65,3323,8
37249,408,7197,1868,6173,30773,1024
29407,4,328,2267,185,4626,143
1699,6,134,3697,125,3619,9
40784,18,343,1624,317,7225,26
43241,118,1319,595,1182,11529,137
37130,11,138,1875,132,3669,6
8993,1,33,3352,33,2040,0
43130,158,2432,670,2117,21726,315
15529,0,120,2961,80,3868,40
37242,1,59,1868,51,2232,8
42287,5,116,1254,87,3983,29
43135,10,138,667,116,3453,22
34296,3,132,2044,109,3473,23
43391,15,239,462,181,3370,58
42438,17,244,1129,167,5473,77
42822,10,201,890,137,5794,64
43521,2,67,386,60,1196,7
32196,13,348,2124,308,5183,40
43164,44,433,641,398,7654,35
23986,187,3638,2536,3208,13929,430
42099,140,3284,1436,2743,13978,541
36009,12,248,1940,181,5219,67
42005,28,426,1451,364,6615,62
43601,1,16,338,9,2250,7
16991,10,344,2890,316,7606,28
29272,5,113,2274,109,3563,4
43254,56,832,584,677,10887,155
23408,2,108,2564,97,7155,11
43465,2,35,426,34,1823,1
43673,3,39,296,29,1246,10
34186,10,146,2048,130,3263,16
6018,9,214,3527,171,3182,43
7064,26,1667,3480,475,9597,1192
43121,42,619,682,581,17235,38
41239,10,151,1574,148,7893,3
19350,6,257,2781,196,6163,61
41720,14,411,1502,386,5252,25
43539,14,147,378,143,2075,4
43059,4,50,757,42,2647,8
5535,5709,203002,3552,139997,1287536,63005
42334,12,200,1208,147,5659,53
13407,13,236,3102,209,3046,27
43075,106,7141,749,1374,14818,5767
42566,66,689,1020,512,10095,177
28917,8,434,2292,237,6799,197
8729,11,407,3367,394,8066,13
10457,15,906,3274,385,5543,521
31656,47,914,2152,846,7329,68
43529,2,68,384,62,973,6
43430,1,20,444,17,1472,3
28892,12,453,2293,268,4881,185
42161,226,3215,1377,3029,35061,186
38773,94,1372,1764,1359,13231,13
37578,27,509,1846,448,12531,61
30830,37,526,2194,396,5204,130
28867,4,117,2294,96,2274,21
22938,34,872,2586,749,9100,123
42071,5,237,1440,74,3231,163
42257,132,2161,1282,1953,20848,208
11325,34,1281,3227,766,10732,515
1421,106,2738,3777,2585,20094,153
31629,39,735,2154,620,5681,115
42254,4,62,1292,54,3975,8
43487,0,22,408,22,2043,0
42493,47,498,1069,425,5925,73
42517,17,175,1053,161,4404,14
42174,20,364,1368,311,3571,53
11932,18,511,3196,471,9594,40
43664,4,43,300,32,2335,11
42660,2,20,958,16,1652,4
1613,62,2063,3716,1775,11418,288
1530,17,453,3734,408,5566,45
42112,56,1053,1432,800,11864,253
43313,12,231,514,194,5341,37
40031,29,363,1686,334,7316,29
31066,9,181,2184,134,4821,47
26290,4,56,2433,49,1822,7
43301,5,51,544,40,1989,11
19743,12,202,2761,174,3272,28
28890,4,117,2293,99,2976,18
23572,38,746,2556,683,14108,63
43676,5,70,295,66,1316,4
30197,12,305,2228,278,3922,27
42578,26,293,994,264,8463,29
37737,9,206,1836,196,4836,10
21372,48,1059,2669,893,10081,166
43021,39,421,798,418,5684,3
27860,18,371,2352,325,5309,46
43586,10,125,345,84,2215,41
42292,39,647,1249,532,5531,115
6038,48,1176,3526,1159,14599,17
3653,9,233,3629,216,5520,17
43110,460,5519,710,4779,35890,740
43303,9,102,543,86,2463,16
43483,2,89,413,88,2037,1
1476,3,101,3750,100,4201,1
43043,11,162,778,125,3152,37
42482,109,1175,1080,1002,9501,173
42184,13,97,1357,88,2664,9
30209,12,238,2227,201,5457,37
26544,21,325,2421,282,4214,43
23890,59,1517,2542,1395,7666,122
42589,2,86,981,59,6172,27
43425,11,208,449,203,3302,5
37576,34,926,1846,794,16309,132
6749,147,3855,3498,3703,15096,152
43158,2,49,645,32,1866,17
43153,156,2099,647,1986,11588,113
26559,0,19,2420,19,1120,0
23746,3262,90388,2548,61644,317586,28744
42141,6,151,1402,132,5810,19
42125,295,5246,1427,4618,48820,628
43166,7,228,638,149,4156,79
41317,50,615,1561,592,15972,23
28864,9,226,2294,208,5886,18
11170,3,353,3234,126,6821,227
43076,50,732,748,682,11324,50
32912,13,190,2094,172,2824,18
1371,2,145,3820,119,8408,26
39406,25,431,1725,380,6130,51
31894,1,43,2141,38,2674,5
1658,61,1063,3703,997,8003,66
43314,2,44,531,39,1786,5
42934,55,1092,846,901,14019,191
33920,1,95,2056,84,2515,11
42249,220,5154,1296,3205,39616,1949
43372,13,232,481,224,3958,8
42729,44,1548,930,529,8346,1019
42375,18,227,1174,193,5486,34
37963,38,806,1820,724,7485,82
28866,14,231,2294,193,4516,38
26555,15,361,2420,308,3250,53
43002,19,161,817,140,2739,21
32381,12,457,2116,171,4729,286
27566,13,484,2368,200,2779,284
1724,4,76,3689,71,2983,5
42138,82,857,1408,782,10235,75
42713,35,675,930,507,7006,168
14971,12,293,2989,277,4525,16
28213,668,10723,2331,9536,43584,1187
40199,228,4289,1677,3623,21686,666
12458,25,1385,3167,539,6219,846
32872,1,54,2095,47,3238,7
43307,1,24,537,21,1213,3
8666,13,1497,3371,256,3572,1241
42325,18,448,1218,382,7655,66
43237,55,512,597,391,5932,121
23822,5,226,2545,176,8359,50
43315,6,75,531,53,2518,22
9046,9,367,3350,178,2533,189
43700,0,21,286,14,600,7
26913,12,323,2404,308,3778,15
43696,5,69,288,57,1306,12
42083,4,103,1437,98,5815,5
42485,3,35,1080,31,1219,4
43165,12,148,492,138,5208,10
28175,17,320,2334,284,4313,36
17976,5,94,2841,85,4220,9
21113,54,1461,2685,1324,11920,137
42752,8,122,930,92,4407,30
43264,5,104,577,71,2677,33
37977,70,1791,1818,1538,26010,253
8738,50,1118,3367,990,15334,128
11898,86,3297,3198,2367,35136,930
1427,223,4189,3777,3925,46532,264
30186,476,12862,2228,9515,61784,3347
43106,62,519,716,491,5776,28
42564,42,642,1022,541,6254,101
43577,4,53,352,52,1130,1
29555,71,1868,2259,1620,16188,248
36837,3,65,1892,62,2721,3
42855,202,1925,873,1594,19237,331
42155,237,6856,1384,4160,92051,2696
1698,5,138,3697,132,3523,6
15054,9,157,2983,147,2801,10
42233,67,731,1304,593,6775,138
4388,4,367,3606,161,6537,206
10415,45,1116,3276,1065,17697,51
18926,5,134,2800,116,3050,18
42642,10,134,966,100,2884,34
36991,8,200,1884,173,6094,27
43227,12,152,603,135,3973,17
42114,2,64,1431,57,1635,7
40402,11,317,1659,246,6431,71
4976,3,99,3581,97,5153,2
42391,8,95,1169,81,3356,14
39369,530,8893,1727,8316,34790,577
6462,8,665,3510,144,3581,521
39318,4,114,1729,99,3968,15
43095,31,463,731,330,4935,133
43489,9,92,408,85,3097,7
43697,4,50,288,48,1126,2
22666,10,296,2600,276,6032,20
6102,28,812,3524,671,9184,141
37821,8,189,1829,171,3741,18
25411,15,455,2473,400,4871,55
42097,108,1687,1437,1487,10027,200
38938,1,35,1754,29,2514,6
35845,18,241,1953,204,4145,37
42027,17,188,1448,168,7649,20
43792,4,28,233,28,3025,0
42597,5,86,979,72,2715,14
33917,10,196,2056,172,2787,24
18259,2,87,2828,75,3244,12
42145,3817,78056,1397,56728,584542,21328
43485,2,37,411,37,1392,0
42812,44,345,892,295,9818,50
41803,32,517,1485,507,10511,10
42190,1114,19213,1351,15823,66316,3390
43538,3,54,378,42,1084,12
34480,8,146,2036,130,3707,16
32372,4,102,2116,86,3145,16
27222,67,1141,2390,983,8841,158
40439,73,1150,1655,1040,8624,110
38464,19,384,1785,329,6860,55
8449,114,1900,3386,1663,10650,237
21948,48,606,2637,548,6845,58
42437,89,1931,1130,1167,17614,764
42983,73,933,831,841,5558,92
14680,5,296,3007,282,5611,14
42500,11,216,1064,185,2618,31
23066,25,847,2581,733,9596,114
4022,0,73,3618,70,2974,3
41408,71,1695,1548,1472,18113,223
23651,5,120,2552,106,2423,14
37058,6,67,1879,62,3724,5
33426,124,2649,2075,2522,16893,127
42206,8,126,1332,97,3205,29
42929,7,86,851,84,2206,2
29684,19,509,2253,385,9258,124
40448,313,8685,1654,7720,74448,965
35180,11,174,1997,168,4970,6
42477,8,183,1084,144,8327,39
43083,289,3468,739,3468,19846,0
42154,14,269,1386,241,5725,28
42861,22,157,870,145,3893,12
43383,18,598,469,340,5227,258
43469,8,68,423,66,5273,2
43074,11,198,749,150,4888,48
43295,14,208,553,203,3493,5
42677,83,1672,953,1204,9569,468
42105,2,95,1435,77,3021,18
26730,2,67,2413,63,3892,4
1420,59,1073,3777,1031,7169,42
43627,20,253,315,222,4162,31
17614,0,46,2856,42,1693,4
42826,1,41,889,16,1544,25
7278,13,422,3470,339,7050,83
1110,17,331,3932,322,6457,9
42124,40,571,1427,511,7592,60
26379,9,163,2428,137,2462,26
35751,3,72,1960,65,3647,7
21985,59,1997,2634,1795,10960,202
43458,3,81,434,40,1433,41
42173,27,702,1368,644,5723,58
11586,20,446,3213,437,5677,9
28768,2,106,2299,91,3294,15
37007,55,1380,1883,1267,14697,113
6011,8,286,3527,265,2853,21
42627,3,40,965,29,2377,11
42943,2,58,838,43,2582,15
43380,237,4248,472,3900,27458,348
35564,27,451,1975,389,18516,62
1313,4,223,3860,221,5124,2
33380,5,305,2076,157,6018,148
42253,4,66,1294,56,2693,10
14164,4,142,3045,107,3003,35
30958,38,476,2189,406,7018,70
41650,443,8457,1512,6783,47197,1674
43514,1,13,389,11,1081,2
42293,6,153,1249,119,2482,34
1900,2,203,3660,106,7376,97
27765,205,6753,2357,3873,22120,2880
43294,15,127,553,114,2805,13
40054,2,63,1685,52,1585,11
43493,10,133,406,115,2263,18
43827,0,37,207,34,1023,3
31429,16,221,2165,189,3877,32
5384,29,1237,3558,437,6947,800
18290,4,135,2827,97,2625,38
42340,63,1642,1204,1316,15568,326
33443,2,131,2073,52,3143,79
30831,105,1569,2194,1261,9920,308
1246,97,2263,3889,2041,11300,222
42088,4,98,1437,89,3106,9
19723,12,241,2762,222,4152,19
39956,18,458,1691,319,4812,139
30803,2,61,2195,53,1604,8
5755,10,2084,3540,384,6967,1700
42288,10,160,1253,87,3442,73
42532,155,2777,1043,1682,18121,1095
43185,58,908,631,864,9806,44
42412,449,10323,1157,6537,40431,3786
27764,7,185,2357,177,3446,8
13028,34,491,3135,441,5718,50
27123,5,138,2396,112,3024,26
40053,365,5953,1685,5467,23171,486
41544,54,1100,1529,961,15043,139
20028,6,170,2745,159,3140,11
42457,5,136,1106,100,3060,36
30763,8,192,2197,129,2185,63
41851,5,90,1476,85,2797,5
36220,2,42,1927,37,3077,5
37805,8,190,1831,158,4033,32
43231,24,359,602,255,5075,104
16114,10,140,2934,130,2492,10
42079,1,12,1438,10,1183,2
13877,20,1100,3065,548,8323,552
26553,2,99,2421,90,2557,9
40947,457,9211,1609,6604,80062,2607
15193,110,1856,2976,1649,12032,207
43108,564,7198,715,6960,26560,238
43486,52,799,409,667,4933,132
39024,1,51,1749,50,1744,1
43452,1,50,433,26,1034,24
43103,74,1018,718,816,9935,202
18447,1,82,2820,78,4009,4
42415,16,367,1154,307,10416,60
43234,453,6243,600,6054,44044,189
42136,382,6988,1412,6853,73942,135
13608,11,432,3086,371,11531,61
42300,403,5972,1239,4996,53393,976
3652,27,877,3629,818,15445,59
41622,1258,34864,1517,22024,175835,12840
1091,19,386,3939,378,5462,8
43247,1,24,590,19,1464,5
27375,3,57,2380,55,1488,2
42132,12,314,1420,148,4798,166
39139,23,427,1742,313,5417,114
25556,18,423,2467,392,4598,31
43163,11,99,642,81,2025,18
43474,11,307,419,177,5334,130
43189,20,239,630,203,4195,36
15459,10,195,2965,161,7694,34
9656,7,1695,3311,251,2964,1444
43488,94,935,408,853,7117,82
42309,103,1963,1237,1748,16190,215
42166,14,267,1373,216,4024,51
1555,56,12904,3725,939,8400,11965
39348,261,8021,1728,6275,30218,1746
6039,63,1109,3526,1105,12001,4
42275,2,58,1261,49,2227,9
42555,379,5778,1032,5328,26813,450
14872,6,205,2994,201,7831,4