Mod,likes,downloads,time,unique_dl,views,dl_dif
43218,36,331,472,276,3959,55
41726,5,159,1368,110,3963,49
43620,101,1049,188,747,10050,302
43609,1,35,196,32,1267,3
1209,53,965,3766,888,16507,77
13504,130,2386,2961,1972,31089,414
40026,19,273,1554,210,4207,63
43375,196,4278,343,3154,36886,1124
43798,5,81,91,63,974,18
1727,4,176,3555,144,6575,32
42799,551,7865,763,6346,43864,1519
24238,20,460,2393,396,4260,64
8832,2,44,3228,38,1664,6
1462,8,219,3622,181,3844,38
40085,39,627,1550,542,10264,85
1670,40,855,3567,722,15664,133
8920,10,313,3224,276,11256,37
23335,368,6305,2435,5040,26368,1265
12795,2,325,3016,189,2790,136
1545,148,3192,3595,2823,31412,369
12550,41,696,3031,608,13046,88
30830,37,526,2061,442,4517,84
42153,63,1024,1253,814,13006,210
43352,68,605,363,494,5771,111
1687,0,37,3565,32,1684,5
42177,88,1996,1233,1455,19781,541
42685,80,1283,818,968,10144,315
42924,35,376,726,322,6469,54
3476,1,62,3499,47,1618,15
26733,6,86,2280,69,1715,17
19543,24,464,2639,386,15050,78
35932,24,476,1813,431,4860,45
43530,61,1407,250,1045,5658,362
28275,3,96,2195,81,2410,15
42188,34,535,1220,420,13829,115
43486,52,799,276,606,3544,193
35622,118,2295,1837,1757,16080,538
42196,884,13278,1211,10297,89839,2981
1642,6,212,3575,192,3620,20
3675,2,126,3495,111,2202,15
10290,7,144,3149,134,2313,10
42500,11,216,931,178,2449,38
42595,42,1365,848,943,7777,422
5864,5,148,3401,122,6035,26
21164,24,515,2547,434,5476,81
43165,12,148,359,106,4359,42
20507,22,1222,2587,1031,16419,191
43113,595,8493,570,6573,28452,1920
7785,3,47,3305,41,1815,6
27305,228,4403,2252,3710,27075,693
37051,2,56,1747,44,2796,12
43744,0,27,134,19,727,8
951,10,180,3852,152,4826,28
8443,2,63,3253,51,1910,12
1211,7,212,3766,189,7540,23
1215,9,254,3766,217,8246,37
32887,525,15589,1962,13179,56779,2410
25387,28,850,2341,739,8779,111
43626,4,30,182,23,443,7
39828,3,84,1568,75,4351,9
1744,5,189,3549,156,6944,33
13582,7,132,2955,110,2658,22
4906,22,1139,3451,626,6502,513
4386,2,261,3473,202,3611,59
30205,128,2484,2094,2040,25593,444
23292,15,368,2437,315,4614,53
42981,26,459,698,329,4738,130
1200,614,25867,3767,21313,134020,4554
22684,68,2358,2467,2031,9339,327
23107,69,1619,2446,1413,16076,206
1088,13,458,3806,395,12684,63
43103,74,1018,585,666,8422,352
42071,5,237,1307,202,2994,35
35368,206,4090,1855,3613,17761,477
4009,35,849,3486,678,6815,171
43083,289,3468,606,2807,16257,661
1696,3,140,3564,119,4136,21
43137,5,37,525,23,4131,14
1743,45,851,3549,758,11728,93
1680,1,58,3565,51,1788,7
24298,10,429,2389,347,7727,82
13122,13,256,2995,209,3587,47
5592,152,3123,3416,2674,59558,449
43052,17,221,637,152,2179,69
36744,8,558,1767,368,9593,190
1717,21,368,3558,303,5780,65
1068,17,404,3812,358,7632,46
5446,6,233,3422,207,4066,26
1784,5,139,3535,116,2890,23
42113,159,3413,1299,2898,12527,515
43611,6,48,196,38,1314,10
37977,70,1791,1685,1509,24568,282
13974,16,525,2922,425,4206,100
15504,38,1064,2829,968,17539,96
32101,13,198,1996,174,4256,24
43124,135,1458,547,1184,8833,274
43531,4,81,249,51,1365,30
42169,22,505,1238,422,10203,83
42275,2,58,1128,48,2128,10
15452,4,170,2832,149,2163,21
1227,3,115,3764,94,3339,21
37206,25,545,1737,455,6395,90
9806,0,83,3171,70,4402,13
23743,6,103,2415,94,2642,9
8318,24,611,3261,539,13107,72
28562,347,6693,2177,5529,24134,1164
7626,3,122,3316,111,3897,11
21405,25,544,2534,429,4100,115
4388,4,367,3473,202,6359,165
26530,47,1492,2289,1278,19810,214
30818,9,488,2061,425,9073,63
14679,1,84,2874,74,3055,10
43407,47,694,323,592,5625,102
43023,100,983,662,820,8717,163
43462,16,186,295,118,3205,68
25477,4,172,2338,158,1915,14
43064,31,233,624,193,4652,40
5847,64,1221,3402,1052,9050,169
11325,34,1281,3094,681,9097,600
37427,39,508,1723,414,4571,94
28833,1,57,2163,52,2352,5
7254,9,285,3338,252,3938,33
42584,8,113,851,93,2420,20
43292,4,151,421,92,2309,59
43070,37,436,621,368,5140,68
14414,117,3291,2892,2727,21551,564
25725,328,5852,2325,4941,26497,911
1515,5,99,3610,82,2988,17
30436,7,112,2081,95,1766,17
14006,16,318,2920,262,9905,56
42428,10,176,1005,131,3875,45
43316,130,1363,397,1103,12573,260
1788,4,189,3534,159,2865,30
937,18,2938,3855,1341,11179,1597
6126,7,229,3391,202,5082,27
42935,96,1282,713,965,16331,317
1272,1,55,3747,40,3292,15
19727,15,262,2629,229,3784,33
42420,114,3136,1019,1813,23643,1323
42261,14,271,1140,218,4041,53
1774,3,118,3538,100,2370,18
1602,3,72,3584,68,2657,4
10282,4,64,3149,46,2582,18
1025,4,70,3825,61,3193,9
43800,20,260,91,231,2808,29
27551,5,55,2236,49,1422,6
42120,118,2301,1295,1787,17304,514
43238,211,2986,463,2309,16834,677
35761,7,141,1826,113,4778,28
1034,6,114,3822,104,4033,10
27167,0,134282,2260,107933,256525,26349
43216,50,799,473,614,6075,185
10293,32,637,3149,568,8604,69
43453,9,195,300,151,2482,44
43169,7,95,503,57,2007,38
1286,88,2524,3744,1750,16609,774
30023,17,264,2104,213,4241,51
42444,23,302,985,261,4922,41
42511,55,725,924,577,5929,148
1509,3,95,3612,77,5258,18
42085,3,29,1304,22,1477,7
42473,170,2878,955,2003,22146,875
43272,42,666,436,514,4857,152
11082,1,55,3107,43,2180,12
42427,4,27,1006,24,2032,3
43180,20,247,499,165,3264,82
7958,14,2870,3288,1241,6871,1629
15987,33,498,2808,415,4206,83
42498,11,204,931,161,2528,43
27198,9,159,2258,131,5763,28
30958,38,476,2056,371,6355,105
41280,18,492,1434,413,9196,79
42173,27,702,1235,623,5471,79
17639,11,307,2722,257,2563,50
23870,2,103,2409,93,8177,10
43469,8,68,290,49,4071,19
43026,183,1976,658,1634,19268,342
43667,5,119,166,60,1789,59
20928,24,442,2562,358,6551,84
3919,4,360,3489,315,10226,45
43334,3,98,376,69,3293,29
14661,6,987,2875,865,7069,122
42988,71,966,698,731,5080,235
43199,15,163,488,124,5555,39
19006,52,1042,2664,869,8534,173
15877,1,143,2813,106,3221,37
43779,18,217,111,200,4670,17
19139,8,196,2659,176,2484,20
1555,56,12904,3592,5384,8073,7520
22575,3,63,2471,50,2491,13
1279,2,138,3745,97,8789,41
43801,4,23,90,19,719,4
1730,9,209,3554,189,6166,20
42489,17,215,946,182,3239,33
42901,3,82,735,45,3170,37
1577,6,191,3589,146,7748,45
22532,18,359,2473,303,5518,56
1281,5,129,3745,111,3621,18
25337,7,95,2343,88,1401,7
42597,5,86,846,72,2715,14
15451,10,364,2832,326,5228,38
9871,11,309,3169,283,6348,26
18927,8,272,2667,235,5512,37
43606,34,435,200,354,2949,81
1549,27,535,3594,489,16575,46
38825,11,135,1628,117,3065,18
43616,6,68,193,34,1445,34
19510,10179,268100,2640,199165,1041801,68935
43273,19,141,435,109,1539,32
42213,6,49,1193,37,2655,12
43001,721,13091,684,10544,39475,2547
42518,29,457,919,352,8429,105
43184,39,381,499,294,4347,87
6040,16,638,3393,559,5684,79
42888,5,67,735,57,2633,10
12956,91,2788,3006,2293,21174,495
14627,2,111,2878,89,3213,22
39698,23,301,1575,224,4441,77
991,25,405,3839,357,9152,48
5846,74,1546,3402,1288,16743,258
23440,28,1011,2429,901,9417,110
42093,15,264,1304,220,3222,44
43318,135,1457,395,1133,9984,324
41544,54,1100,1396,896,14063,204
30917,45,1156,2058,970,8010,186
42397,11,263,1034,220,3920,43
1638,7,88,3576,82,2823,6
41803,32,517,1352,468,10074,49
43436,7,100,306,77,2853,23
1600,2,51,3584,43,1975,8
1672,68,1020,3566,914,16517,106
12440,5,218,3035,191,2834,27
42139,325,7951,1273,6775,62348,1176
42164,54,659,1241,518,7948,141
29206,108,1823,2144,1550,10307,273
7960,6,144,3288,126,3703,18
32461,4,95,1980,81,4458,14
43437,14,129,305,99,1316,30
42382,6,106,1038,84,5077,22
42948,6,119,665,77,2725,42
43107,16,924,583,638,5004,286
19743,12,202,2628,169,3110,33
42413,24,193,1023,159,5084,34
43632,5,74,181,49,755,25
43025,21,278,659,201,4008,77
1634,243,5046,3578,4298,23662,748
43535,42,334,246,259,4160,75
1747,5,86,3548,74,2254,12
1049,4,230,3815,209,5711,21
31389,10,323,2034,273,5150,50
8629,13,345,3241,315,7613,30
25411,15,455,2340,397,4715,58
43411,27,410,320,313,6321,97
32606,14,110,1974,95,1767,15
42105,2,95,1302,75,2922,20
43700,0,21,153,13,417,8
1274,19,614,3747,486,11061,128
28771,5,173,2166,149,4503,24
23363,298,5218,2433,4112,18038,1106
22189,71,1604,2491,1424,16034,180
42267,564,8927,1135,7092,65577,1835
43297,29,250,414,202,3503,48
43514,1,13,256,9,874,4
27057,6,89,2267,77,2436,12
1610,311,5761,3583,4824,50877,937
42496,5,55,933,47,2352,8
30696,463,8682,2066,7328,30507,1354
42022,13,227,1316,185,4819,42
14352,3,105,2897,96,6796,9
42312,1,79,1101,65,1941,14
6031,50,1209,3393,1004,19867,205
43383,18,598,336,274,3952,324
42095,4,132,1304,119,3027,13
42354,26,429,1049,324,5194,105
43696,5,69,155,45,958,24
43305,17,292,405,196,5233,96
34480,8,146,1903,127,3600,19
13969,40,890,2923,735,7374,155
1650,2,90,3572,71,3158,19
7407,8,173,3329,155,3039,18
42903,95,4982,733,2077,43149,2905
21837,33,705,2511,605,4063,100
43040,8,127,646,89,4543,38
6028,5,106,3394,91,2267,15
6589,14,809,3371,501,10970,308
576,10,203,4309,178,8152,25
33334,7,123,1945,95,3169,28
29281,27,369,2141,318,7102,51
1682,1,58,3565,52,1789,6
37130,11,138,1742,124,3526,14
6169,16,480,3389,432,7254,48
37488,20,288,1719,232,3540,56
43775,0,13,113,9,745,4
26077,1,95,2310,89,2379,6
7919,8,587,3292,378,3395,209
9688,4,205,3177,187,7302,18
3970,0,773,3487,332,2504,441
42858,126,1515,739,1268,14203,247
38480,3,71,1652,60,3283,11
42206,8,126,1199,92,3015,34
31840,8,152,2010,128,3591,24
42117,291,4454,1297,4009,19086,445
43575,16,195,221,177,3002,18
25299,45,1065,2345,927,11856,138
43380,237,4248,339,3530,21951,718
43089,8,78,601,61,2071,17
982,6,171,3843,161,6945,10
43702,3,35,153,28,866,7
36810,37,590,1762,469,6088,121
43119,112,1042,551,779,6558,263
43104,29,304,584,233,4382,71
43577,4,53,219,39,913,14
43347,16,144,365,111,3137,33
43733,14,123,138,96,1241,27
43065,117,1386,623,932,13224,454
42484,2,57,947,40,1355,17
39139,23,427,1609,334,5115,93
35114,7,236,1868,203,8728,33
28858,84,2884,2161,2406,20390,478
8718,39,1017,3235,707,11142,310
43398,3,57,325,43,1262,14
26564,6,490,2287,401,7587,89
42812,44,345,759,287,8369,58
23388,1164,19815,2432,16077,103246,3738
29461,126,5462,2130,4689,19158,773
1451,3,137,3634,117,4554,20
1957,18,1283,3526,1017,11531,266
3882,1177,22945,3490,18578,186110,4367
7967,9,140,3287,131,2673,9
1512,6,199,3611,183,5601,16
7064,26,1667,3347,811,9346,856
43581,2,86,217,56,1924,30
43304,6,97,410,69,2604,28
43534,2,24,246,22,1010,2
15175,157,2944,2844,2448,14298,496
1647,5,58,3574,50,2602,8
43782,3,65,108,49,1112,16
6683,14,824,3367,712,19611,112
43683,4,61,160,33,1119,28
43642,36,351,178,283,6664,68
43799,14,235,91,206,2313,29
8716,27,612,3235,448,5006,164
2158,16,1046,3522,665,7205,381
37058,6,67,1746,58,3569,9
39855,8,171,1567,163,4894,8
42252,27,522,1161,417,5994,105
43666,13,276,166,191,2152,85
37072,178,3199,1746,2794,18560,405
41615,406,6972,1386,6029,41795,943
41622,1258,34864,1384,28542,160711,6322
43495,0,41,271,26,1027,15
26088,5,317,2309,298,9000,19
42112,56,1053,1299,914,10512,139
42310,42,708,1104,581,9154,127
28552,295,6183,2178,5116,29374,1067
43628,30,296,182,262,2629,34
43234,453,6243,467,4769,36486,1474
27566,13,484,2235,406,2607,78
30763,8,192,2064,159,2070,33
42106,26,813,1302,587,8050,226
42394,4,53,1035,47,1971,6
42839,7,96,749,56,2139,40
7200,7,190,3340,173,5190,17
43756,5,31,130,29,1222,2
27265,12,390,2254,326,4155,64
27458,111,2189,2242,1744,18742,445
36837,3,65,1759,59,2663,6
13463,13,572,2963,495,5431,77
1446,0,65,3638,51,2939,14
43739,1,36,136,21,665,15
25264,15,485,2347,387,4211,98
26559,0,19,2287,17,1040,2
43170,18,360,503,232,3489,128
43763,7,74,121,45,1180,29
43509,4,49,259,37,1257,12
42638,2,37,834,17,1785,20
12961,25,818,3006,736,10151,82
43378,5,127,339,86,2425,41
15485,2,208,2831,171,5964,37
26259,42,644,2301,538,4182,106
42135,1,188,1282,154,3146,34
36891,12,340,1757,253,4238,87
43442,21,400,303,332,2756,68
6009,9,312,3394,261,4071,51
7205,4,159,3340,138,2730,21
43267,47,560,441,425,3670,135
39367,12,219,1594,177,3863,42
28259,15,447,2196,359,7355,88
43044,8,167,644,112,3595,55
43627,20,253,182,178,2960,75
42762,66,873,786,712,9160,161
21422,46,1326,2534,1143,22593,183
43526,3,49,252,33,1311,16
1203,19,727,3767,667,15166,60
23886,8,216,2409,187,8252,29
43522,7,259,253,187,4100,72
43777,4,64,112,41,950,23
25556,18,423,2334,373,4339,50
21939,11,226,2505,194,5311,32
23200,3,71,2442,67,3204,4
42121,8,315,1295,286,3541,29
29969,15,211,2106,176,3996,35
6210,14,608,3388,546,15424,62
23890,59,1517,2409,1356,7354,161
42581,4,138,856,117,2958,21
42122,4,202,1295,178,4643,24
42109,11,128,1299,104,3660,24
42418,42,833,1020,691,6886,142
42223,7,138,1177,119,4230,19
8570,5,972,3244,383,8626,589
37795,846,18651,1699,14844,161593,3807
27765,205,6753,2224,5692,20128,1061
31746,4,64,2015,53,1689,11
37792,25,638,1699,476,6347,162
43260,24,242,447,152,3508,90
20882,27,413,2565,311,5029,102
43585,0,10,213,6,935,4
5056,34,2187,3444,1058,11682,1129
21418,17,503,2534,420,4233,83
19350,6,257,2648,193,6041,64
42352,67,1169,1052,956,8701,213
6686,10,333,3367,269,5384,64
43220,11,106,471,79,1688,27
1050,13,602,3815,550,8278,52
42388,14,193,1036,152,5651,41
7662,66,2108,3314,1511,10563,597
30562,121,2352,2074,1859,19952,493
31105,9,184,2049,156,1960,28
15445,1,102,2832,88,1864,14
43658,13,257,145,200,3578,57
42317,51,703,1093,634,9031,69
43008,180,2584,677,1757,19507,827
12737,293,4670,3019,3819,31811,851
43508,22,309,259,265,3657,44
33920,1,95,1923,82,2431,13
28864,9,226,2161,195,5604,31
43144,66,849,520,677,4839,172
42238,248,3801,1170,3017,24662,784
43460,6,71,301,51,956,20
43644,15,93,175,81,2969,12
43014,591,9402,672,7407,54838,1995
43400,16,180,324,159,3112,21
43510,5,65,258,60,1286,5
36017,10,180,1807,139,2408,41
33185,6,130,1950,103,2636,27
43657,77,1710,171,1418,7501,292
42933,395,6028,714,5090,35778,938
42713,35,675,797,470,6429,205
28889,24,1203,2160,918,10662,285
1291,2,80,3741,67,3019,13
43640,10,294,3839,256,25773,38
42723,17,681,797,428,8189,253
27545,556,13528,2237,9780,67629,3748
7973,9,231,3287,199,7139,32
6860,5,153,3359,134,3916,19
30660,0,71,2068,61,2748,10
42847,29,353,744,255,5630,98
23876,2,69,2409,63,1985,6
42483,143,1884,947,1533,16661,351
1110,17,331,3799,284,6174,47
42220,4,94,1179,79,2008,15
12273,3,133,3045,111,2655,22
43331,41,526,378,423,4522,103
42299,30,349,1109,272,5479,77
42192,5,128,1212,104,2659,24
43470,224,3567,289,2918,17374,649
41851,5,90,1343,76,2666,14
43182,25,290,499,237,4325,53
27747,4,166,2225,153,1890,13
43222,35,389,471,327,2907,62
37866,11,230,1693,182,4344,48
13279,56,1843,2979,1580,17137,263
1454,24,678,3626,474,6296,204
16043,28,560,2805,429,8025,131
43376,12,143,342,105,1846,38
43613,1,28,195,25,1048,3
28348,5,164,2191,137,4272,27
1541,18,243,3595,203,4426,40
3875,955,27134,3490,16744,110782,10390
27479,296,4868,2241,3770,17215,1098
43102,2,92,585,52,3433,40
13793,7,217,2939,179,5248,38
43158,2,49,512,41,1561,8
42219,12,117,1183,85,2936,32
43520,80,1155,255,869,7742,286
35482,11,209,1848,179,4223,30
43589,6,77,210,62,1341,15
40199,228,4289,1544,3564,19918,725
42569,15,138,884,103,3202,35
39279,6,171,1599,147,3848,24
43177,164,1732,500,1396,14866,336
10994,82,1698,3111,1319,12939,379
7015,8,221,3350,196,4213,25
1457,302,4496,3624,3598,39391,898
1076,21,789,3810,723,14875,66
43387,24,182,331,139,1841,43
42834,114,1176,749,918,12486,258
20557,53,3569,2585,2600,21753,969
8003,2,89,3284,80,2616,9
42576,92,1024,863,839,6796,185
6209,9,208,3388,181,6140,27
29555,71,1868,2126,1565,15516,303
9589,1,98,3182,92,3314,6
42190,1114,19213,1218,14340,59619,4873
43796,10,160,95,123,1068,37
42900,8,130,735,81,2979,49
14561,6,150,2882,127,2504,23
23714,77,1294,2416,1058,8547,236
43358,25,292,358,205,3018,87
21345,76,1310,2538,1103,8175,207
1702,1,40,3564,37,1751,3
1419,127,3317,3644,2925,21427,392
43227,12,152,470,113,3287,39
43655,10,119,134,102,1543,17
27132,2,125,2262,118,1925,7
38296,14,298,1664,227,4616,71
5535,5709,203002,3419,157699,1212512,45303
35845,18,241,1820,193,3922,48
1569,10,124,3590,112,5427,12
43143,87,775,521,599,10146,176
43175,83,1047,502,789,12222,258
1785,22,359,3535,322,5849,37
43330,36,1360,378,1110,5566,250
43441,83,1299,303,1051,6629,248
29884,7,144,2110,115,2808,29
38826,21,347,1628,290,6609,57
42478,8,160,951,118,2372,42
38272,35,731,1666,645,5221,86
43368,17,290,350,189,3098,101
41706,19,365,1370,301,4377,64
1219,24,510,3766,422,11619,88
37576,34,926,1713,760,15650,166
43390,6,108,329,74,2812,34
39348,261,8021,1595,6696,27491,1325
1228,106,2005,3764,1751,14793,254
1691,31,786,3564,555,6252,231
14924,6,102,2858,82,2901,20
42134,201,3154,1285,2557,18898,597
1632,4,89,3578,73,2578,16
22029,63,978,2498,796,7880,182
43266,161,2455,442,1874,14083,581
33268,217,2466,1947,1889,16355,577
27565,2,131,2235,110,2744,21
11040,9,219,3109,190,5202,29
43697,4,50,155,34,867,16
21320,0,44,2539,36,2406,8
42289,2,62,1118,45,2613,17
32643,23,339,1972,284,3916,55
28830,45,960,2163,843,21750,117
3936,10,422,3489,374,7552,48
15840,1,69,2814,58,1544,11
12458,25,1385,3034,978,6021,407
13971,38,522,2923,440,6617,82
34422,5,166,1905,144,7229,22
19882,55,1084,2620,951,6295,133
6006,3436,131063,3394,101629,447307,29434
37228,6,140,1736,123,10031,17
37805,8,190,1698,159,3934,31
945,19,469,3853,418,6857,51
11428,3,196,3089,104,3400,92
1544,18,441,3595,394,9827,47
1007,24,391,3835,328,5855,63
41789,41,582,1354,509,7312,73
31656,47,914,2019,780,6461,134
14164,4,142,2912,118,2874,24
43076,50,732,615,497,9006,235
43015,130,1960,672,1570,9622,390
43223,9,110,471,90,1559,20
30209,12,238,2094,191,5167,47
42347,737,20875,1062,16484,104431,4391
1590,20,305,3586,274,8998,31
33091,88,7896,1953,6348,23890,1548
42116,28,230,1298,184,3635,46
43580,4,51,217,39,811,12
43306,15,471,404,317,6038,154
35353,39,1959,1855,1672,21081,287
27965,46,1497,2212,1277,11443,220
1684,0,43,3565,37,1768,6
43231,24,359,469,264,4324,95
43502,31,235,264,213,2674,22
23408,2,108,2431,94,7010,14
42549,50,500,905,395,9229,105
42138,82,857,1275,690,9179,167
43039,1329,33402,647,23768,174923,9634
42879,2,59,735,39,1414,20
26544,21,325,2288,272,4012,53
42522,231,2803,918,2319,18142,484
43674,2,39,162,22,906,17
43539,14,147,245,109,1697,38
13198,29,1102,2983,892,9953,210
43568,70,589,231,422,4141,167
27375,3,57,2247,51,1396,6
29866,6,138,2111,121,3169,17
6203,16,426,3388,369,9007,57
8993,1,33,3219,26,1942,7
35483,16,498,1847,437,12569,61
39836,13,236,1568,198,5303,38
1099,10,254,3802,230,6155,24
1252,2,46,3755,40,2459,6
42565,5,77,888,61,1992,16
40193,38,595,1544,492,10400,103
43743,2,49,134,42,752,7
7518,30,653,3322,598,7012,55
43197,38,441,489,321,3276,120
25278,37,1003,2346,883,7495,120
28599,5,235,2175,211,5569,24
43255,22,291,451,225,3592,66
1560,12,231,3592,206,3544,25
6103,6,297,3391,226,4488,71
23346,290,5297,2434,4152,15780,1145
42997,34,382,687,297,2780,85
1725,7,207,3556,190,7002,17
33973,339,4490,1921,3427,18876,1063
20055,13,312,2611,269,4608,43
28213,668,10723,2198,8033,37456,2690
33095,1,150,1953,119,3462,31
32381,12,457,1983,355,4424,102
42185,1,45,1224,34,2180,11
41896,44,1134,1335,946,10900,188
42733,41,641,806,417,7625,224
28867,4,117,2161,92,2164,25
43447,36,607,300,552,5123,55
27306,361,7144,2252,5693,42964,1451
25270,6,163,2346,141,1674,22
43728,5,30,141,23,488,7
11140,2,209,3103,194,8823,15
17828,8,422,2716,380,4531,42
43341,137,2007,371,1623,15929,384
42130,51,677,1291,506,6385,171
1080,33,884,3807,771,14722,113
42400,25,569,1032,492,6700,77
28113,3,111,2205,96,2155,15
39067,10,143,1613,122,3581,21
43549,0,42,241,26,767,16
43132,4,88,535,69,1703,19
43195,55,856,493,601,5986,255
42719,64,4864,797,3446,18029,1418
43207,71,3579,481,1941,20328,1638
30236,33,563,2093,441,5376,122
1335,9,170,3719,152,3759,18
42582,253,3993,852,3151,23185,842
18440,12,491,2687,437,8707,54
990,14,392,3839,361,27058,31
42836,38,385,749,336,5965,49
567,9,343,4305,309,14185,34
29684,19,509,2120,417,8424,92
43290,11,121,426,99,3159,22
42760,12,225,787,171,3166,54
41584,21,492,1390,428,12993,64
1475,59,1234,3617,796,7630,438
6104,8,249,3391,200,2648,49
37921,4,68,1689,56,2477,12
42558,111,1914,895,1643,9297,271
1117,0,50,3797,45,4327,5
43529,2,68,251,51,704,17
42527,15,386,914,285,3944,101
43150,16,163,516,141,3484,22
43033,19,285,655,123,1490,162
7486,1,866,3325,396,1934,470
37578,27,509,1713,425,12031,84
8537,106,2951,3246,2181,14474,770
35481,46,725,1848,616,17835,109
42513,11,207,921,170,2993,37
4588,6,824,3465,298,2275,526
10472,14,1402,3140,1218,7611,184
22862,7,334,2458,295,6859,39
42826,1,41,756,21,1398,20
43332,38,566,376,447,3936,119
42896,1,52,735,27,1451,25
25670,5,123,2327,109,9802,14
39446,5,84,1590,67,3454,17
28439,11,317,2186,279,12432,38
40073,0,426,1551,389,6134,37
42792,10,145,771,119,3575,26
43046,18,219,640,153,3073,66
41307,75,1046,1430,861,8520,185
1046,10,206,3816,188,10688,18
14703,1,65,2872,60,4247,5
43511,54,763,257,551,4458,212
6095,7,123,3391,115,1668,8
1189,30,10199,3770,4811,17041,5388
6170,20,456,3389,394,9682,62
9874,32,596,3169,438,3852,158
42411,7,114,1026,82,3562,32
42451,51,648,977,536,10933,112
1566,2,50,3590,44,1861,6
40437,9,153,1522,124,4558,29
43283,25,577,429,262,4577,315
22938,34,872,2453,708,8564,164
8380,224,4481,3256,3842,71438,639
1567,4,65,3590,60,2340,5
21885,25,589,2507,517,5176,72
43206,44,228,482,197,2377,31
42156,1,17,1250,15,2373,2
1194,107,2188,3769,1887,26490,301
33426,124,2649,1942,2241,15345,408
14467,3,239,2889,141,4568,98
42875,3,113,735,55,1711,58
1032,7,153,3823,135,3676,18
29479,12,197,2130,158,8142,39
43421,98,1491,316,1203,4523,288
43748,51,736,133,624,7490,112
1114,32,726,3799,650,11109,76
15325,21,364,2836,312,7356,52
43123,23,191,520,158,3241,33
43159,5,126,511,95,1787,31
6845,25,337,3360,264,4785,73
34076,1,55,1918,48,2448,7
29579,22,323,2125,241,5380,82
43705,8,59,152,48,719,11
15606,2,74,2823,58,3821,16
7783,4,788,3305,442,4993,346
6045,2,140,3393,103,3010,37
42321,16,311,1090,260,6799,51
42706,12,237,812,145,5170,92
11932,18,511,3063,427,8896,84
43211,52,578,480,439,3078,139
5408,6,43,3424,33,4082,10
43736,1,13,137,10,432,3
43717,0,17,145,13,680,4
42123,17,394,1294,331,5648,63
15313,42,1490,2837,1323,9155,167
43244,27,214,461,183,3069,31
10031,10,272,3161,247,5041,25
5755,10,2084,3407,1150,6699,934
1597,2,70,3585,54,3453,16
42014,11,188,1317,160,5544,28
27764,7,185,2224,172,3292,13
22281,6,176,2486,146,4548,30
42938,12,137,709,88,2097,49
42240,46,714,1169,561,8676,153
23815,26,389,2412,349,5545,40
30150,26,454,2098,415,5035,39
40402,11,317,1526,261,6140,56
8019,1,71,3284,66,5133,5
1466,1,49,3619,41,3248,8
42235,26,380,1171,317,5169,63
43544,62,906,243,714,6550,192
585,6,112,4362,92,8342,20
1234,30,941,3762,831,15153,110
21297,145,3017,2540,2473,11077,544
7389,36,1198,3330,738,7376,460
42207,39,867,1199,664,12517,203
1059,24,9364,3814,3464,17924,5900
41771,19,449,1358,368,8734,81
26487,9,162,2291,140,3646,22
1077,24,1390,3809,1234,31117,156
28236,5,97,2197,73,2095,24
41220,9,177,1445,146,4311,31
35562,9,215,1842,180,5947,35
11174,11,268,3101,247,6430,21
31167,44,1202,2046,1024,16399,178
42416,32,500,1020,398,4795,102
23233,61,978,2440,801,6344,177
12590,41,907,3028,803,6066,104
1113,64,1678,3799,1503,30171,175
40077,0,390,1551,360,6224,30
43487,0,22,275,17,1717,5
1657,18,448,3570,357,6681,91
42502,12,260,931,218,2840,42
22259,7,115,2487,100,3586,15
43056,32,287,630,251,3150,36
1259,5,98,3750,84,2924,14
27987,20,363,2211,311,3231,52
43754,4,42,130,35,886,7
42137,26,534,1279,429,9370,105
8525,1,93,3247,87,1883,6
43723,0,25,144,13,848,12
29542,32,584,2127,510,5079,74
41951,18,295,1326,255,6497,40
40760,15,200,1493,177,4910,23
27117,1,127,2264,115,3548,12
34852,22,244,1881,218,6688,26
1122,13,219,3796,195,7772,24
43320,46,2428,393,1541,20371,887
40784,18,343,1491,302,6631,41
36711,109,1624,1768,1461,15248,163
22286,50,1087,2486,897,6041,190
21669,26,665,2519,574,7786,91
43427,2,56,315,29,1252,27
2612,2,530,3514,207,2342,323
39024,1,51,1616,46,1680,5
1570,126,4603,3590,3923,31576,680
43401,9,117,324,96,2156,21
6151,7,261,3390,230,3453,31
27969,11,276,2212,240,4451,36
37602,2,143,1712,122,4036,21
42373,10,420,1042,360,7523,60
14461,55,2796,2889,2392,22473,404
1011,18,261,3834,241,5695,20
42395,338,5044,1035,4279,41818,765
43471,28,255,288,215,1950,40
33722,8,152,1930,123,3334,29
42423,8,91,404,75,2254,16
42632,7,62,837,47,1770,15
42247,40,503,1164,429,6789,74
42151,9,337,1256,279,5794,58
1900,2,203,3527,106,7229,97
1256,54,10231,3751,6024,29518,4207
1081,7,223,3807,205,8622,18
42118,108,1527,1297,1294,17721,233
1417,116,3067,3644,2717,26732,350
42334,12,200,1075,138,5152,62
42430,64,837,1003,595,7993,242
1619,4,166,3582,145,3999,21
42016,6,102,1316,81,2952,21
37947,233,6637,1688,5803,28437,834
43105,35,515,584,385,4396,130
6995,16,469,3352,408,7408,61
6122,19,564,3391,509,15842,55
8597,3,67,3243,57,3023,10
22049,1,65,2498,52,1993,13
1608,31,832,3584,736,22218,96
1530,17,453,3601,293,5317,160
43668,2,34,166,21,1215,13
6011,8,286,3394,238,2726,48
42534,1,72,909,39,2081,33
19465,109,2205,2642,1904,8623,301
43221,19,195,471,172,3873,23
27062,2,340,2267,282,3749,58
26553,2,99,2288,86,2444,13
5543,31,799,3418,727,19850,72
42342,230,3184,1070,2527,21974,657
43139,33,462,523,343,3342,119
43360,11,125,356,109,2393,16
42193,17,263,1212,229,4299,34
27503,4,139,2239,117,2152,22
1787,15,311,3535,281,8683,30
42104,4,105,1302,86,3905,19
36520,10,195,1779,155,3312,40
43689,7,103,158,75,1169,28
43550,6,200,240,120,4449,80
42608,11,257,846,173,5493,84
33982,94,2082,1921,1409,12261,673
8796,5,182,3230,149,2144,33
42686,26,311,818,217,2054,94
18104,9,348,2702,317,4485,31
30810,8,138,2061,111,3578,27
31814,3,93,2011,81,3141,12
1678,1,58,3566,53,1728,5
20701,4,68,2577,62,1785,6
14435,1572,154159,2891,121625,301635,32534
39437,9,188,1590,150,3254,38
10448,133,5765,3142,5098,38432,667
34013,23,253,1920,201,4073,52
42727,7,89,797,67,1845,22
3648,1,50,3496,43,3807,7
30766,7,109,2063,92,1852,17
6685,10,164,3367,139,2762,25
26654,18,407,2284,347,3029,60
12816,74,2007,3015,1706,13646,301
42084,12,297,1304,266,5176,31
8620,9,389,3241,342,5660,47
35815,2,155,1821,137,6411,18
7390,3,66,3330,52,1910,14
32912,13,190,1961,164,2719,26
42270,411,5949,1133,5138,34788,811
3677,0,341,3495,104,2377,237
42505,16,237,929,203,3264,34
1607,5,186,3584,148,3880,38
25275,11,456,2346,369,4039,87
9029,3,65,3218,55,1630,10
33251,17,256,1948,207,6484,49
5762,10,274,3407,239,6602,35
6462,8,665,3377,274,3449,391
42456,31,437,974,344,7905,93
42377,43,1143,1040,879,5796,264
43506,2,50,262,34,1201,16
43727,2,55,141,40,703,15
22051,24,508,2498,429,8696,79
27304,177,3701,2252,3167,20882,534
42855,202,1925,740,1579,17927,346
1690,9,266,3564,212,11434,54
8348,0,44,3258,39,2162,5
43077,238,2448,614,2175,21137,273
18689,3,117,2676,99,2455,18
3941,4,347,3489,310,8442,37
37737,9,206,1703,186,4673,20
41360,27,348,1422,268,4324,80
22024,33,721,2499,542,7601,179
42509,2054,39974,926,33197,209604,6777
1371,2,145,3687,90,7568,55
42448,304,5211,980,4118,35529,1093
40967,103,1397,1475,1187,11587,210
11151,2,85,3102,74,4503,11
38827,2,65,1628,45,2073,20
42262,2507,43510,1138,36616,170961,6894
42433,22,456,1001,355,6441,101
1456,9,9097,3625,4443,3338,4654
12175,1,290,3051,155,2232,135
43762,135,1921,121,1642,11227,279
41650,443,8457,1379,7121,43916,1336
43602,58,732,203,560,7661,172
42355,15,206,1049,180,3338,26
41222,26,287,1444,250,7388,37
38080,10,244,1680,213,4445,31
43541,57,816,244,663,3565,153
37885,31,941,1692,824,6718,117
20134,16,264,2607,235,2353,29
35400,357,6022,1853,4963,23304,1059
22932,45,1170,2453,1028,16692,142
33432,205,2908,1941,2443,32569,465
1220,3,124,3766,107,5364,17
33370,41,698,1943,584,5442,114
43217,6,56,472,44,1576,12
40636,5,179,1505,155,4411,24
21156,277,10589,2548,9125,42233,1464
43761,2,30,121,14,709,16
8848,9,251,3227,235,4999,16
42080,833,15769,1305,12647,77735,3122
1271,2,126,3748,110,3590,16
28254,85,2231,2196,1894,49559,337
42445,5,118,985,98,5089,20
37860,30,441,1694,360,4383,81
26243,2,82,2302,67,2294,15
43792,4,28,100,20,1794,8
947,4,98,3853,85,2992,13
574,4,234,4313,194,7291,40
4022,0,73,3485,57,2814,16
26338,18,534,2298,470,5379,64
1695,8,205,3564,170,4449,35
9125,9,131,3212,90,1723,41
41730,67,1371,1367,935,14004,436
24097,2,62,2398,51,1322,11
31813,448,10082,2011,8255,75998,1827
43456,0,13,300,11,749,2
11170,3,353,3101,201,6618,152
28061,396,14562,2207,11516,42010,3046
42499,18,251,931,202,2890,49
42146,109,2216,1261,1974,15804,242
23923,10,176,2407,148,3893,28
43507,16,221,260,175,2759,46
42125,295,5246,1294,4157,44755,1089
42147,5,169,1260,137,3870,32
42236,12,190,1171,157,3285,33
36876,24,445,1757,399,5032,46
33050,4,115,1955,90,2565,25
39125,193,3005,1609,2564,18199,441
27222,67,1141,2257,876,7952,265
42292,39,647,1116,482,5020,165
6029,8,151,3394,132,3401,19
22207,11,306,2490,271,4806,35
42385,19,514,1036,387,5320,127
11743,1,189,3072,115,4621,74
43152,169,2282,514,1730,12580,552
42210,3,92,1195,75,4789,17
43646,17,168,173,151,3347,17
6101,34,697,3391,489,7539,208
27307,28,441,2252,360,5128,81
1766,40,694,3540,591,8694,103
38423,351,9080,1655,7550,25963,1530
37804,9,311,1698,263,4494,48
42562,51,610,890,473,5883,137
43433,19,187,307,144,1899,43
6124,153,4283,3391,3740,30724,543
36700,29,518,1769,421,4507,97
1453,145,2925,3627,2547,36580,378
8303,7,264,3262,215,3404,49
42996,61,643,687,476,3957,167
18790,4,96,2672,85,3902,11
42939,32,386,708,286,4370,100
24857,19,414,2364,361,3615,53
42943,2,58,705,38,2339,20
26791,12,209,2277,180,2086,29
43630,5,120,182,63,1568,57
43059,4,50,624,40,2432,10
43346,18,107,366,79,1433,28
25376,2,82,2342,73,2811,9
23108,17,508,2446,424,7052,84
19657,25,485,2633,426,4946,59
43720,12,195,145,161,1974,34
42259,16,139,1147,107,3209,32
12345,29,897,3041,832,14876,65
42159,458,8246,1246,5444,32951,2802
30199,15,233,2095,202,4654,31
21985,59,1997,2501,1767,10222,230
41127,6,111,1456,97,2919,14
11904,47,1467,3065,1292,27062,175
22160,7,184,2492,152,3237,32
1648,8,293,3573,195,4072,98
12831,18,550,3014,476,5534,74
41408,71,1695,1415,1383,16943,312
29388,165,3018,2134,2566,36262,452
43291,138,1916,424,1462,10547,454
41784,229,3855,1355,3262,28794,593
1679,79,1642,3566,1380,21725,262
43243,2,70,462,58,1069,12
38352,67,1534,1659,1250,11515,284
43672,5,50,163,18,919,32
27266,56,1613,2254,1187,8737,426
1663,1,78,3569,70,3082,8
43778,1,22,112,19,678,3
42437,89,1931,997,1526,16599,405
1728,7,268,3554,222,5352,46
27239,32,483,2256,403,8661,80
1071,8,247,3811,217,5203,30
31066,9,181,2051,158,4716,23
6063,3,109,3392,96,2767,13
26306,16,477,2299,409,7767,68
42297,32,374,1111,305,2407,69
42853,480,6356,741,4936,31951,1420
41265,12,175,1436,136,3724,39
43047,2,10,639,8,1382,2
22642,2,106,2469,100,5105,6
1517,11,346,3606,329,7570,17
1442,12,587,3642,500,8100,87
43774,3,50,113,40,750,10
42613,106,1347,843,1045,9311,302
1009,101,2445,3834,2188,36515,257
9791,4,356,3172,205,5649,151
1063,50,1054,3814,931,13096,123
43373,4,56,345,36,1559,20
42476,2,60,951,47,3207,13
41161,23,358,1453,288,4592,70
42230,12,191,1174,154,2650,37
10192,7,323,3153,204,4182,119
43174,14,89,502,72,1491,17
14814,3,300,2864,270,4491,30
28175,17,320,2201,291,4165,29
42752,8,122,797,88,4090,34
12231,8,235,3048,196,3214,39
43108,564,7198,582,5553,21741,1645
42490,74,1076,945,844,5562,232
42422,3,35,1015,22,1276,13
27183,72,4581,2259,4034,19355,547
18825,4,200,2670,182,4984,18
43016,56,1204,671,992,11029,212
43254,56,832,451,543,9022,289
6208,11,393,3388,353,4774,40
28363,7,317,2190,272,5864,45
42905,22,768,729,559,8475,209
21377,147,3297,2536,2756,10858,541
43257,16,93,450,63,1613,30
43656,2,101,130,82,1554,19
21970,132,2582,2502,2191,10986,391
43167,25,272,504,195,3452,77
37330,47,798,1730,702,8419,96
43226,23,219,470,157,3994,62
1677,0,51,3566,42,2024,9
6148,6,141,3390,121,3377,20
42660,2,20,825,15,1492,5
42508,18,276,927,234,4554,42
42103,312,4602,1302,3857,18626,745
42729,44,1548,797,1135,7502,413
43233,44,328,467,241,2364,87
6130,5,153,3391,102,2995,51
24293,6,158,2390,131,2727,27
43424,88,1151,316,938,4736,213
1289,3,113,3741,99,4456,14
40702,36,585,1499,476,6768,109
43130,158,2432,537,1726,17440,706
37672,25,473,1708,407,6384,66
33146,1,57,1951,47,3290,10
30633,2,71,2070,59,2874,12
29091,15,195,2150,167,3074,28
23383,5,363,2432,299,9649,64
38773,94,1372,1631,1117,11623,255
43038,8,112,649,70,2315,42
42170,54,1316,1237,1038,12887,278
31268,12,237,2040,213,4096,24
1662,7,182,3569,164,4048,18
6746,41,825,3365,748,7813,77
42580,46,654,858,517,6421,137
43679,1,17,161,8,465,9
42327,106,2005,1084,1690,10335,315
6052,6,86,3393,70,2018,16
1700,72,1324,3564,1198,19654,126
42798,63,503,766,439,6054,64
9768,16,189,3174,170,3061,19
43515,3,66,256,46,977,20
3899,20,343,3490,285,8356,58
1676,2,50,3566,38,1643,12
36599,6,237,1774,191,3159,46
6190,10,176,3388,158,4303,18
43721,1,21,144,17,444,4
5307,13,645,3430,587,8883,58
13608,11,432,2953,362,11207,70
4930,18,337,3450,291,3876,46
12105,2,45,3055,37,1798,8
1489,67,1119,3616,989,13167,130
42344,107,1409,1063,1091,16874,318
39938,0,30,1560,27,2069,3
38558,81,2498,1645,2187,9898,311
20494,33,1216,2589,1044,13971,172
43179,19,223,500,169,1540,54
22002,577,10971,2500,9575,58280,1396
42393,3,218,1035,177,4462,41
1665,5,207,3568,185,5413,22
42717,66,2641,797,1948,12894,693
37249,408,7197,1735,5944,27241,1253
41239,10,151,1441,142,7682,9
6214,32,669,3388,558,13456,111
40885,31,388,1481,325,7602,63
43430,1,20,311,13,1238,7
42748,4,123,799,82,1767,41
27069,76,1242,2266,1064,14746,178
43505,5,86,262,69,1645,17
43569,0,139,1624,108,3485,31
8517,15,338,3248,314,3819,24
40060,56,922,1552,701,5586,221
27157,1,47,2261,45,3975,2
43669,3,46,165,33,935,13
43710,14,90,147,78,2558,12
1422,256,5851,3644,4940,49400,911
43623,8,47,184,46,1224,1
35796,0,43,1823,35,1986,8
37489,534,11532,1719,9622,43174,1910
6107,13,348,3391,238,5328,110
43448,4,59,300,50,1411,9
42359,135,2033,1048,1457,16788,576
35423,31,622,1851,517,7130,105
31068,3,184,2051,135,3363,49
43645,4,39,175,24,1010,15
12960,38,1024,3006,923,10641,101
8449,114,1900,3253,1495,9718,405
42162,30,325,1244,258,2723,67
998,355,8651,3837,7105,68999,1546
43317,16,180,396,114,2539,66
5304,5,992,3430,433,2170,559
14432,6,122,2891,104,3148,18
43097,40,446,591,333,3249,113
12088,0,141,3056,96,5517,45
42166,14,267,1240,194,3773,73
20491,68,2415,2589,2136,15948,279
42668,22,403,823,322,6636,81
43715,3,32,146,18,705,14
42126,345,7530,1294,5579,24793,1951
42479,13,233,949,188,4195,45
13554,79,1580,2956,1402,21199,178
7968,32,551,3287,482,3739,69
24666,63,1455,2372,1240,20660,215
36945,8755,191878,1754,126802,1014123,65076
42573,194,3913,873,3178,20710,735
26836,279,7102,2275,6085,25049,1017
6704,2,54,3367,46,1978,8
43153,156,2099,514,1562,9427,537
42561,65,852,891,622,9368,230
43480,16,227,281,162,2648,65
38449,10,262,1653,221,4514,41
42226,4694,84479,1176,63494,302347,20985
29469,20,794,2130,611,13745,183
21407,45,1168,2534,977,9047,191
43005,6,184,681,145,3503,39
7096,14,295,3346,268,18195,27
14689,6,280,2874,238,6398,42
10569,42,2139,3135,1791,23778,348
28750,4,130,2167,112,2400,18
34725,162,5175,1890,4383,39109,792
43662,5,40,167,30,923,10
7035,4,86,3349,74,2830,12
42421,4,83,1014,66,3309,17
43315,6,75,398,44,2046,31
43205,27,345,482,234,3196,111
19028,22,883,2663,760,8330,123
42530,8,161,913,114,3248,47
8018,16,473,3284,439,5280,34
42521,217,2688,918,2232,16149,456
39405,35,1022,1592,843,12094,179
1268,5,117,3748,100,3533,17
43020,1,45,667,29,2172,16
42332,120,3008,1076,1992,25264,1016
43521,2,67,253,45,963,22
1445,0,39,3642,30,1921,9
43147,15,541,517,365,5667,176
7716,15,446,3311,376,5083,70
1412,0,64,3647,54,3593,10
39308,15,339,1597,278,7967,61
43595,10,120,207,101,1917,19
1413,5,192,3646,176,8713,16
38528,14,302,1648,243,4749,59
15193,110,1856,2843,1501,11224,355
43597,3,29,206,27,1104,2
2548,6,446,3515,293,4615,153
43101,439,4555,586,3558,20173,997
28547,17,436,2178,358,6461,78
42202,168,2746,1204,2353,17482,393
42098,18,240,1304,201,3486,39
3497,0,78,3499,69,2254,9
24454,6,97,2383,92,2340,5
43458,3,81,301,63,1197,18
4024,8,203,3485,175,5255,28
42512,40,485,924,389,4925,96
26581,14,229,2287,190,3972,39
29019,2,217,2154,181,5968,36
42191,0,0,1216,0,10323,0
16555,14,209,2780,184,3357,25
27314,170,2605,2252,2127,23108,478
1280,1,79,3745,64,3155,15
43354,2,49,359,36,1418,13
43653,7,148,139,122,1965,26
1022,3,104,3827,92,3223,12
43118,65,554,562,440,9428,114
6064,5,113,3392,99,3000,14
34530,2,126,1900,113,2643,13
43209,59,1193,480,664,10116,529
21375,40,779,2536,688,4732,91
1476,3,101,3617,75,4044,26
25731,4,212,2325,186,4160,26
13028,34,491,3002,405,5402,86
28891,26,384,2160,314,3749,70
41030,0,0,1470,0,2220,0
6050,25,559,3393,442,5269,117
15529,0,120,2828,97,3696,23
17976,5,94,2708,84,4059,10
1470,5,119,3618,109,2878,10
6163,2,3439,3389,1320,4540,2119
42700,10,180,814,129,7101,51
11194,96,1624,3100,1283,9543,341
42908,11,164,729,114,2221,50
43439,29,368,304,313,3878,55
42341,45,814,1071,584,26678,230
7204,3,129,3340,109,3035,20
37538,28,484,1716,400,4646,84
32210,174,3401,1991,2943,15273,458
572,0,34,4317,24,3086,10
43183,35,262,499,201,3121,61
41799,37,662,1352,544,14864,118
1222,4,116,3765,105,3922,11
42322,12,327,1088,263,3137,64
43405,12,169,324,113,2106,56
3611,143,1934,3496,1652,15451,282
18663,7,144,2677,116,2584,28
43055,50,550,630,387,3697,163
43011,3,39,674,28,1510,11
9337,1,62,3198,54,3394,8
43481,40,377,281,290,2976,87
37400,427,12192,1725,10558,33465,1634
19604,1038,27636,2636,21032,208892,6604
8528,5,54,3246,51,2286,3
43780,0,10,110,7,666,3
34489,3,122,1902,112,4951,10
18971,1,126,2665,115,2413,11
4788,4,215,3457,120,2141,95
40196,132,5085,1544,4255,46633,830
43639,3,58,179,43,1573,15
32981,8,186,1958,159,5220,27
22441,15,172,2479,133,2329,39
32506,100,2284,1978,1576,17074,708
11990,5,74,3060,53,2293,21
42592,18,242,848,175,5412,67
27390,18,289,2246,239,2988,50
1430,152,2557,3644,2054,30000,503
30554,1,64,2074,56,9996,8
6123,15,546,3391,492,15050,54
43622,8,99,184,65,1167,34
42648,13,113,831,83,3409,30
23089,4,108,2447,97,3066,11
43794,1,35,97,33,703,2
15626,12,438,2823,387,4562,51
18982,61,1390,2665,1106,9448,284
37660,13,237,1709,187,3699,50
38171,28,382,1673,263,5356,119
43319,63,537,394,466,4802,71
29407,4,328,2134,279,4469,49
42197,4,42,1209,37,3074,5
35580,72,1421,1840,1155,11067,266
25650,79,2251,2328,1920,9957,331
41337,466,8863,1425,6562,50765,2301
37435,39,472,1723,371,7799,101
6673,12,2095,3368,963,2572,1132
6309,3,621,3383,263,1724,358
16176,18,393,2799,315,5169,78
23981,585,12967,2404,11094,50419,1873
42523,211,2477,918,2036,14294,441
27550,4,56,2236,51,1488,5
42380,33,536,1039,441,6276,95
9495,15,482,3187,444,12570,38
42179,54,779,1230,507,7068,272
14887,138,2550,2860,1920,16073,630
40054,2,63,1552,49,1498,14
15456,20,791,2832,710,12197,81
42237,5,150,1171,127,3242,23
26730,2,67,2280,62,3672,5
19717,64,1996,2630,1711,16669,285
16327,14,558,2791,491,7031,67
10059,65,2794,3159,2238,46008,556
14458,157,3437,2889,2856,28267,581
23822,5,226,2412,182,7999,44
31655,18,389,2019,316,2361,73
42108,10,296,1299,253,4989,43
42110,2,51,1299,44,1565,7
42253,4,66,1161,50,2492,16
42383,2,104,1038,91,3212,13
3347,25,818,3502,602,12698,216
43591,20,349,209,308,4725,41
42650,1,47,829,30,1754,17
43382,12,142,338,128,3107,14
14949,24,628,2857,515,6179,113
13779,4,218,2940,194,4161,24
1735,4,126,3552,108,3514,18
43757,4,64,130,54,1877,10
43192,50,590,495,446,5679,144
7127,15,229,3344,183,2558,46
969,27,767,3847,690,9142,77
42519,3,73,918,61,3033,12
43681,5,94,160,66,1649,28
41626,222,4942,1384,4092,40363,850
42330,48,670,1078,515,9781,155
39318,4,114,1596,96,3901,18
28807,41,1105,2164,946,6293,159
20500,18,599,2588,520,6991,79
42293,6,153,1116,120,2310,33
1013,0,7,3832,6,1890,1
2257,37,878,3520,722,13167,156
43374,27,368,343,236,3370,132
35793,0,52,1823,42,1843,10
6046,13,183,3393,165,2734,18
21677,5,140,2518,135,2858,5
39337,9,217,1596,197,8131,20
43583,2,59,215,40,1207,19
14678,2,87,2874,75,2964,12
43296,22,524,419,378,7959,146
42133,7,96,1287,78,3637,18
39450,6,192,1590,167,3836,25
42658,133,2203,826,1522,15466,681
43649,11,205,130,174,2754,31
42172,79,1034,1235,881,13876,153
42272,9,259,1132,198,4903,61
1014,75,1228,3832,997,10479,231
43321,0,33,391,23,1187,10
1214,4,161,3766,138,4897,23
1624,4,213,3581,168,5292,45
955,11,14093,3851,4516,8342,9577
43450,1,37,301,22,1377,15
12735,12,203,3019,136,2806,67
43129,95,1321,537,931,15102,390
29695,3,160,2119,138,3589,22
42579,31,486,861,398,5996,88
23770,6,117,2414,105,3627,12
5001,8,482,3447,271,3345,211
42477,8,183,951,131,7701,52
15341,3,96,2836,76,2177,20
1480,0,21,3617,17,1619,4
1694,31,703,3564,547,7149,156
42865,1,31,736,29,1797,2
1137,14,533,3794,453,13801,80
43030,464,7102,656,6047,33178,1055
18656,1,242,2677,222,3645,20
25680,1,71,2327,61,1428,10
580,33,595,4365,518,16699,77
43054,17,260,634,123,4268,137
22382,4,186,2482,171,3015,15
43691,8,50,158,40,1315,10
3874,122,1995,3490,1570,13431,425
31920,6,126,2007,109,2715,17
7282,2,129,3336,119,4071,10
1639,4,92,3576,78,1878,14
43772,0,24,113,14,620,10
10444,171,3608,3142,3247,37431,361
8479,55,2657,3250,1536,10694,1121
42160,55,585,1245,518,6442,67
43561,13,139,234,103,2268,36
1054,4,144,3815,131,5809,13
1686,4,103,3565,85,2814,18
43477,16,292,282,207,2607,85
1033,41,780,3823,646,9622,134
22541,155,4289,2473,3800,39386,489
34851,37,836,1881,682,9228,154
1627,24,459,3580,328,3860,131
5724,10,187,3408,156,8808,31
23651,5,120,2419,104,2315,16
19710,7,192,2630,171,3988,21
42998,24,375,687,290,5860,85
23197,56,978,2442,807,6003,171
33917,10,196,1923,165,2653,31
33217,4,48,1949,41,2252,7
43357,13,109,359,75,2372,34
1498,14,240,3615,208,5515,32
42313,776,12755,1098,10556,70994,2199
34296,3,132,1911,106,3386,26
1635,6,385,3578,301,6217,84
1459,9,114,3623,96,2920,18
42174,20,364,1235,295,3426,69
42851,121,1673,742,1347,8904,326
43686,0,11,159,10,468,1
43708,0,12,151,9,490,3
9748,0,27,3175,24,1487,3
13218,32,736,2982,647,5966,89
42568,18,242,885,170,2594,72
43189,20,239,497,165,3650,74
43275,98,1365,434,1047,11412,318
43485,2,37,278,28,1144,9
7193,2,147,3341,142,5782,5
43558,7,70,235,53,1044,17
11905,38,978,3065,873,15118,105
1553,18,746,3593,462,8399,284
12419,39,1250,3036,1155,10683,95
28284,2,124,2195,111,2965,13
42150,4,126,1259,100,3367,26
24391,10,313,2385,224,4033,89
6333,5,116,3382,102,2394,14
6013,12,305,3394,257,3077,48
14955,219,4164,2856,3313,23198,851
34522,37,673,1900,525,6126,148
42102,16,216,1302,182,2655,34
16991,10,344,2757,312,7480,32
1135,54,1394,3795,1152,15815,242
43784,1,30,107,11,699,19
22047,4,184,2498,154,3610,30
7826,28,837,3302,741,12935,96
1199,6,192,3768,157,5391,35
35180,11,174,1864,156,4602,18
42721,80,4703,797,3102,22162,1601
43284,18,142,429,110,2023,32
42279,12,128,1125,94,3141,34
31045,26,547,2052,480,7166,67
43572,3,139,226,104,1643,35
1605,6,96,3584,80,3373,16
12378,5,291,3039,152,3331,139
1633,15,263,3578,215,20703,48
25085,111,1868,2354,1587,13843,281
43248,63,937,457,671,11661,266
3881,194,3413,3490,2891,32985,522
8844,15,781,3227,471,12490,310
43501,19,437,264,299,5523,138
1568,10,202,3590,176,6522,26
42343,440,5994,1066,5056,32957,938
28744,288,8780,2167,7579,31376,1201
42506,20,220,929,196,5665,24
42555,379,5778,899,4798,24507,980
1535,1,42,3598,36,2095,6
23745,17,254,2415,219,4888,35
6212,81,2133,3388,1711,18939,422
43278,17,198,431,156,2206,42
34863,125,2992,1881,2541,13739,451
42945,98,1289,703,1035,15311,254
43555,66,661,236,492,5055,169
22928,3,82,2453,70,3439,12
30210,7,321,2094,272,5677,49
34621,15,257,1895,201,4300,56
9057,1,442,3216,148,3145,294
42507,34,345,929,291,6947,54
1218,1,77,3766,64,3717,13
43293,34,363,421,306,4325,57
14215,13,249,2908,225,6322,24
8918,11,167,3224,149,2773,18
42586,182,1953,850,1600,12134,353
43063,3,77,624,56,3132,21
42248,26,459,1163,408,4369,51
541,11,258,4304,221,6154,37
42571,31,520,878,450,7993,70
40529,22,339,1514,273,4491,66
14889,46,673,2860,551,7503,122
41778,41,686,1358,572,12266,114
1246,97,2263,3756,1868,10615,395
43072,378,6047,614,4834,26162,1213
42744,109,1317,800,949,11193,368
37899,22,881,1691,754,9937,127
958,42,754,3850,642,19585,112
42280,3,248,1125,204,4028,44
42107,7,117,1300,94,2519,23
24341,10,84,2388,68,2450,16
1426,169,3823,3644,3360,29278,463
21670,27,579,2519,514,4908,65
42664,100,1033,824,734,8214,299
37871,20,420,1692,368,5474,52
34186,10,146,1915,124,3132,22
28258,2,67,2196,59,2038,8
43542,3,63,243,36,1409,27
12547,287,6504,3031,5351,59308,1153
43240,42,507,463,407,7042,100
8352,5,77,3258,68,2855,9
42567,57,881,886,707,23087,174
42504,135,1846,930,1389,19239,457
39573,3,126,1582,113,4395,13
1592,8,208,3586,184,5172,24
1207,47,779,3766,714,6313,65
42654,34,405,827,325,11769,80
5155,57,2302,3438,1450,11878,852
3877,8,152,3490,121,4981,31
43186,14,166,498,120,2005,46
39957,50,649,1558,523,9565,126
43090,42,661,601,451,5843,210
25542,1,71,2334,60,4102,11
28868,7,138,2161,118,5004,20
8890,3,100,3225,91,7108,9
37854,131,1668,1694,1468,15573,200
3612,55,883,3496,733,11227,150
42339,33,390,1072,323,7405,67
42564,42,642,889,507,5415,135
43497,6,50,269,36,1285,14
22610,0,71,2470,59,2478,12
14162,2,128,2912,105,2462,23
43629,2,58,182,53,998,5
43420,129,2097,316,1676,9845,421
16829,8,273,2765,234,3188,39
43338,12,148,372,94,1883,54
42510,3,42,925,31,2293,11
19638,15,165,2634,134,2396,31
39430,7,88,1591,71,7271,17
43594,7,47,207,38,889,9
43029,2,7,656,7,5935,0
1369,6,215,3690,178,5594,37
43785,2,53,107,39,1513,14
30387,17,550,2084,436,6296,114
8894,24,495,3225,424,4983,71
42405,335,7209,1029,6151,28857,1058
43204,36,425,485,303,5081,122
6206,14,629,3388,528,6706,101
28479,41,746,2184,647,15052,99
1488,29,475,3616,415,6037,60
38967,5,168,1619,141,3589,27
35089,3,68,1869,60,2822,8
43087,525,6535,604,5168,31459,1367
2680,5,131,3514,119,5175,12
43650,13,183,151,156,2575,27
43343,5,77,370,55,1787,22
42468,26,384,958,320,2780,64
42244,49,947,1165,664,15325,283
41589,1280,27662,1389,21895,164033,5767
6363,8,182,3381,160,3671,22
26513,57,1078,2289,870,12816,208
7143,4,68,3343,43,1616,25
43115,12,141,567,102,3870,39
42143,9,133,1267,113,3492,20
42132,12,314,1287,273,4581,41
43576,30,336,220,238,3929,98
43573,13,139,224,104,1156,35
42266,30,390,1135,324,3722,66
43229,11,164,469,114,2805,50
34167,3,158,1915,148,3501,10
21265,0,78,2541,70,2466,8
43369,11,143,349,125,3205,18
18155,0,19,2700,17,2383,2
7272,15,1052,3337,418,3479,634
42517,17,175,920,150,4084,25
12830,9,246,3014,221,3494,25
43675,8,113,162,103,1840,10
42619,29,446,841,312,4827,134
32427,484,15019,1982,11952,42312,3067
43482,7,86,280,62,1398,24
42929,7,86,718,77,2052,9
26325,27,1161,2299,1020,10279,141
36621,20,365,1773,294,6256,71
3917,24,709,3489,647,13395,62
25468,100,4568,2338,3928,21105,640
23606,756,37353,2422,31747,151637,5606
29464,585,17558,2130,14022,45875,3536
2084,6,411,3523,259,3694,152
1599,2,68,3584,58,3060,10
43676,5,70,162,46,896,24
42450,113,1916,977,1685,13252,231
42467,60,906,960,716,10100,190
1765,0,0,3540,0,4815,0
1621,25,514,3582,465,10871,49
23035,52,1017,2450,829,14169,188
29570,21,389,2126,333,3243,56
42399,2729,45388,1032,37074,212273,8314
42306,91,5097,1106,3819,14773,1278
42919,77,1088,727,770,7834,318
1574,24,624,3589,539,8692,85
31635,727,17644,2020,13273,121298,4371
23365,12,121,2433,96,2154,25
11662,30,468,3076,381,6160,87
1526,6,142,3604,123,3483,19
29862,5,62,2111,46,2194,16
43024,13,174,660,119,3975,55
43432,4,68,310,42,1793,26
42559,11,154,894,117,5909,37
42161,226,3215,1244,2768,32676,447
15459,10,195,2832,159,7535,36
28916,598,17089,2160,13670,50345,3419
43116,31,257,566,197,3222,60
33285,13,462,1946,357,9950,105
42409,3,39,1027,36,2363,3
6102,28,812,3391,600,8837,212
23183,56,1293,2443,1042,17666,251
32579,5,245,1975,178,7138,67
37803,10,218,1698,178,3786,40
42114,2,64,1298,56,1556,8
32872,1,54,1962,47,3144,7
43423,166,2804,316,2222,12024,582
42867,3,140,736,82,2010,58
42861,22,157,737,133,3632,24
29965,31,509,2106,460,4152,49
1745,133,3650,3549,3192,48103,458
43489,9,92,275,79,2657,13
26260,1482,34062,2301,23848,149370,10214
42145,3817,78056,1264,61214,505935,16842
43002,19,161,684,115,2423,46
43191,185,2943,495,2180,15709,763
43028,24,275,656,189,3727,86
33873,4,61,1924,49,1950,12
40734,29,381,1496,281,6562,100
27895,41,1512,2217,1321,17908,191
1540,44,637,3595,516,10244,121
42520,201,2388,918,1972,13587,416
43100,334,3409,587,2761,13695,648
35564,27,451,1842,343,16920,108
28885,8,100,2161,80,1526,20
43406,86,907,323,754,6972,153
42325,18,448,1085,396,7054,52
1036,15,238,3821,203,6765,35
43151,61,642,515,450,7250,192
43661,7,101,169,90,1390,11
42392,126,2241,1035,1918,22917,323
39890,41,1012,1563,864,16097,148
41116,2,115,1457,100,4275,15
43504,2,33,263,27,1261,6
28693,4,243,2170,215,10543,28
43601,1,16,205,7,1778,9
43499,6,67,265,43,908,24
38056,20,553,1682,439,10450,114
43586,10,125,212,88,1868,37
24867,10,232,2364,197,6781,35
14156,6,445,2912,349,7687,96
34364,4,130,1908,108,4481,22
36872,94,1101,1757,970,11092,131
43277,28,294,432,236,3359,58
26883,0,51,2273,45,2920,6
42300,403,5972,1106,4463,48048,1509
25740,2,80,2324,67,3051,13
21372,48,1059,2536,882,9384,177
42480,139,1933,948,1707,19816,226
31051,1042,32201,2052,26547,111717,5654
14890,9,208,2860,168,3800,40
1266,14,256,3748,226,7454,30
7206,6,159,3340,132,2640,27
42932,35,341,716,288,8203,53
36373,38,722,1786,619,6722,103
43410,35,493,321,432,3859,61
37000,17,278,1750,248,5345,30
40894,2,137,1480,125,3900,12
26348,299,16728,2297,12546,82571,4182
42027,17,188,1315,162,7374,26
1095,2,53,3805,48,4280,5
31942,141,6267,2005,5295,45324,972
5013,4,67,3446,57,2325,10
42986,63,770,698,637,5926,133
40958,11,265,1476,241,7379,24
43435,3,46,306,33,1759,13
42063,13,217,1308,205,5500,12
42482,109,1175,947,841,7895,334
42439,4,104,990,85,4123,19
43670,1,38,163,27,833,11
43425,11,208,316,161,2678,47
6098,17,548,3391,413,4561,135
42390,8,105,1036,86,2979,19
1778,6,112,3537,100,3161,12
42268,27,476,1134,345,8743,131
14891,363,8419,2860,5880,29009,2539
10411,11,1606,3144,919,11047,687
31940,15,326,2006,290,4949,36
23663,72,1076,2418,869,8368,207
43224,29,386,471,273,3782,113
9414,18,420,3193,338,6528,82
26466,28,467,2292,389,6122,78
24376,131,4109,2386,3561,25129,548
8008,4,150,3284,121,3352,29
43596,8,84,206,50,1473,34
28849,17,337,2162,292,8660,45
17872,3,176,2714,157,4614,19
7170,13,4771,3342,1720,15913,3051
9235,56,1387,3205,1188,22148,199
29399,586,15646,2134,13136,63021,2510
26561,5,116,2287,104,2013,12
21827,1,42,2511,36,2694,6
42921,145,2018,726,1605,12693,413
43062,16,161,624,122,3259,39
24229,0,56,2393,49,2727,7
41635,10,219,1383,166,9641,53
32693,27,605,1970,473,8679,132
1534,17,407,3598,357,11902,50
42082,1,43,1304,41,3730,2
42455,11,89,974,71,2366,18
6099,4,327,3391,289,6849,38
42652,49,475,828,367,5165,108
6211,13,547,3388,465,9478,82
43171,30,270,503,202,2154,68
43463,87,1252,293,919,7869,333
42893,3,57,735,37,2024,20
37588,32,554,1713,463,4106,91
6044,66,1382,3393,1184,6346,198
7145,7,312,3343,280,5239,32
43247,1,24,457,17,1286,7
43631,88,1351,181,1072,13034,279
42993,5,240,688,204,1999,36
43651,10,152,134,131,2151,21
10415,45,1116,3143,936,16894,180
23274,4,236,2438,213,6788,23
38444,17,417,1654,349,8223,68
5554,18,309,3418,272,3568,37
17935,59,943,2711,743,7819,200
25515,18,659,2336,579,5589,80
43685,7,81,159,75,1582,6
23060,2,29,2448,27,2126,2
43364,21,415,353,264,4010,151
43075,106,7141,616,5599,12093,1542
42832,166,2282,749,1742,17875,540
43112,85,1013,571,890,9851,123
1704,9,238,3563,208,3275,30
28861,325,5369,2161,4301,40629,1068
32639,10,193,1972,163,7773,30
7430,0,49,3327,42,1978,7
32372,4,102,1983,81,2993,21
38626,102,1591,1640,1402,21622,189
6748,7,147,3365,130,3132,17
7278,13,422,3337,286,6803,136
18108,25,553,2702,461,5288,92
1257,72,1186,3751,1042,31189,144
6847,24,476,3360,409,4965,67
43190,34,510,497,359,3147,151
1217,17,216,3766,185,3768,31
43325,33,374,388,274,3796,100
1616,9,182,3583,136,5624,46
28774,596,18907,2166,14607,54370,4300
41570,50,1449,1394,1302,18654,147
1656,21,283,3571,248,6670,35
34844,168,3823,1882,3231,17132,592
26913,12,323,2271,298,3572,25
1107,4,103,3800,93,6301,10
43091,221,2211,598,1810,14255,401
1630,4,63,3579,58,1949,5
28122,12,491,2204,379,10220,112
43389,9,241,329,154,5001,87
43173,0,32,503,25,1381,7
18343,27,936,2691,848,7805,88
40053,365,5953,1552,4429,19511,1524
28860,0,37,2161,30,2029,7
42952,127,2045,701,1522,7412,523
28519,330,6054,2180,5199,20532,855
42111,56,927,1299,816,10842,111
13384,140,2687,2970,2082,15128,605
42493,47,498,936,413,5546,85
28866,14,231,2161,191,4294,40
42129,19,476,1293,400,7250,76
16979,2,131,2758,111,4510,20
26290,4,56,2300,45,1738,11
43078,12,98,612,82,1942,16
42255,52,923,1158,748,12297,175
43391,15,239,329,146,2730,93
29817,32,690,2114,582,9125,108
1683,0,65,3565,55,1816,10
10770,105,2679,3123,2200,15355,479
6019,11,194,3394,172,4122,22
43178,33,296,500,202,3458,94
24047,1,57,2401,51,2149,6
43253,4,54,452,32,1265,22
43543,23,261,243,174,3566,87
24561,82,1151,2377,990,10032,161
42168,7,78,1239,70,7471,8
33919,12,383,1923,329,5906,54
43659,5,75,170,59,934,16
37243,1,62,1735,53,2167,9
20998,1,137,2557,120,2559,17
22601,68,976,2470,817,7363,159
33096,10,296,1953,265,6855,31
33216,5,105,1949,83,2383,22
42980,8,137,699,84,2207,53
39539,7,236,1585,191,6490,45
42079,1,12,1305,10,1018,2
29374,3,125,2135,108,3085,17
22551,296,11594,2472,9585,28033,2009
6030,6,91,3394,78,2168,13
42256,37,468,1152,363,9567,105
42353,7,121,1051,109,1896,12
42871,47,493,735,374,4781,119
38824,10,141,1628,118,2220,23
7147,4,94,3343,83,3401,11
6684,26,450,3367,410,10550,40
6497,9,112,3375,101,2841,11
43342,2,39,371,27,1215,12
43786,45,715,106,580,5974,135
1423,191,4191,3644,3679,25990,512
43566,2,205,231,159,4912,46
22899,27,724,2455,637,9208,87
31629,39,735,2021,602,5467,133
21875,181,3545,2508,2907,26649,638
43493,10,133,273,90,1938,43
42780,22,308,775,202,5833,106
43037,89,764,651,644,9801,120
43593,12,109,208,86,1756,23
43202,53,515,486,440,6207,75
1603,3,129,3584,117,3983,12
42115,15,228,1298,198,4210,30
43714,7,72,146,40,1379,32
32509,43,833,1978,696,6404,137
43287,5,74,428,62,1238,12
15671,12,493,2821,448,4355,45
33478,22,518,1939,446,8347,72
42931,15,454,716,332,5529,122
8012,8,170,3284,159,3217,11
39343,3,230,1595,200,2946,30
27860,18,371,2219,306,4987,65
42667,5,62,823,50,1765,12
22969,284,6904,2452,5706,30719,1198
1542,68,1320,3595,1169,18272,151
27696,23,905,2228,774,8933,131
1612,19,429,3583,378,7460,51
1669,5,132,3567,114,6904,18
23065,37,717,2448,513,8910,204
43773,4,82,113,62,1417,20
6018,9,214,3394,146,3018,68
42599,6,63,846,48,2108,15
42167,6,100,1240,90,5079,10
1714,1,60,3558,53,2083,7
42328,5,148,1081,123,3495,25
42301,80,1004,1106,815,7428,189
9227,47,1616,3205,1168,12094,448
38894,14,221,1624,183,3256,38
7854,5,109,3299,100,3154,9
27750,7,182,2225,164,2276,18
42995,21,288,687,208,3827,80
42254,4,62,1159,49,3749,13
10169,9,153,3155,141,4759,12
6010,11,283,3394,237,3025,46
39605,232,4234,1580,3084,25112,1150
30632,3,114,2070,104,4351,10
37010,130,2337,1750,1921,19194,416
25111,10,306,2352,267,3939,39
33153,8,310,1951,258,7261,52
40521,9,133,1515,109,3659,24
43365,78,1804,351,1305,15901,499
43524,79,722,253,588,8267,134
987,6,154,3841,127,3876,27
43498,4,124,267,73,2770,51
27905,51,1155,2216,985,9532,170
43160,3,83,511,48,3064,35
7934,10,301,3291,253,4109,48
24347,34,684,2387,587,8033,97
6207,1,110,3388,104,3054,6
24273,34,830,2391,696,15401,134
38976,24,614,1618,516,10338,98
944,26,758,3854,674,15907,84
43724,1,32,112,31,1069,1
1709,4,67,3560,52,2758,15
43340,43,644,372,555,5748,89
42589,2,86,848,61,5521,25
43719,6,25,145,16,726,9
1216,9,159,3766,135,2836,24
1629,12,302,3580,270,8373,32
42186,52,660,1223,562,7307,98
1654,10,172,3571,159,5096,13
6149,1,89,3390,77,3435,12
34453,4,149,1904,117,6713,32
43682,6,44,160,32,919,12
43414,28,275,319,230,2408,45
43635,34,441,181,396,5353,45
42203,2,36,1204,26,5828,10
42703,53,676,813,486,5110,190
34620,0,62,1895,59,5301,3
43741,2,28,135,19,571,9
15595,14,355,2824,284,4170,71
42907,20,307,729,181,4857,126
21995,10,275,2500,233,7411,42
43307,1,24,404,19,1071,5
43451,8,82,301,59,1118,23
43695,10,136,156,84,1416,52
25746,5,130,2324,112,2828,18
42338,2,129,1072,105,2836,24
43562,3,71,233,35,1106,36
43066,20,269,623,213,3936,56
23357,61,1020,2434,817,11327,203
42464,17,161,962,145,5987,16
43540,4,57,244,37,2614,20
43545,2,77,243,55,1855,22
26870,130,1985,2273,1650,16643,335
42379,29,558,1039,459,3649,99
19153,20,418,2658,332,4796,86
42320,11,244,1092,184,3695,60
43135,10,138,534,96,2916,42
43472,8,112,286,94,2112,18
42319,8,115,1092,95,2866,20
29480,13,330,2130,296,9397,34
43684,1,31,160,22,759,9
34185,8,112,1915,92,2200,20
11908,55,1325,3065,1168,14135,157
1552,3,235,3593,210,4796,25
3906,167,2979,3489,2492,33212,487
41727,0,27,1368,22,1407,5
9069,16,920,3215,806,14809,114
36991,8,200,1751,171,5895,29
42184,13,97,1224,86,2558,11
1587,17,577,3586,429,5686,148
38938,1,35,1621,28,2458,7
43168,5,70,504,41,1904,29
10272,21,1312,3150,717,4374,595
6858,6,124,3359,103,2790,21
41658,498,7203,1379,6066,33002,1137
42570,713,11059,881,9092,30389,1967
3880,7024,167967,3490,125453,1003138,42514
23875,8,315,2409,267,7281,48
42999,12,117,686,86,2996,31
32809,12,530,1965,438,12328,92
23653,4,114,2419,99,3897,15
42263,1,63,1138,42,2247,21
1611,96,2033,3583,1814,18427,219
22617,10,248,2470,206,2825,42
5839,1,73,3402,67,2407,6
35237,52,755,1861,630,7822,125
42773,652,10011,778,8113,47620,1898
34074,10,168,1918,136,4357,32
43467,1,31,291,14,1164,17
42372,35,394,1042,357,7814,37
13464,9,278,2963,243,4848,35
42375,18,227,1041,182,5160,45
43618,5,51,189,49,1079,2
1598,3,99,3585,87,2577,12
42485,3,35,947,29,1116,6
8648,1,67,3240,58,2213,9
37133,35,891,1742,748,9882,143
42425,20,300,1012,217,5902,83
3105,4,282,3506,181,3048,101
6757,41,1851,3364,1136,6472,715
1500,25,501,3615,448,5010,53
24389,1,76,2385,67,1957,9
36406,1830,32318,1785,26470,121103,5848
4976,3,99,3448,83,5031,16
42294,7,102,1115,77,2959,25
29272,5,113,2141,101,3384,12
36360,36,706,1787,563,8821,143
42131,21,322,1288,255,4259,67
43326,40,604,385,440,4736,164
1550,12,178,3594,152,6251,26
1501,2,144,3615,117,5456,27
22921,120,2659,2454,2099,18312,560
37512,26,654,1718,566,6049,88
27816,12,566,2221,471,5327,95
43127,2,84,539,60,2310,24
9647,8,273,3179,191,2730,82
42097,108,1687,1304,1450,9482,237
1210,55,1107,3766,995,15983,112
39659,6,77,1578,59,2421,18
43345,1,41,368,34,2333,7
1557,9,89,3592,72,2166,17
41996,10,207,1320,173,3963,34
27948,11,211,2213,173,4756,38
33402,2,37,1942,30,1936,7
946,96,1871,3853,1624,10454,247
38391,81,819,1657,677,6677,142
43605,21,193,201,152,1915,41
42983,73,933,698,722,4856,211
42462,37,685,963,497,9719,188
6016,4,105,3394,89,6230,16
41654,76,1391,1379,1027,17667,364
42178,2,72,1233,58,2608,14
11991,2,123,3060,99,2779,24
43043,11,162,645,110,2859,52
14670,2,111,2875,97,3464,14
43452,1,50,300,39,886,11
43745,5,112,134,78,1358,34
37861,4,222,1694,194,3531,28
28892,12,453,2160,349,4398,104
6121,5,89,3391,77,2216,12
6015,4,99,3394,75,2279,24
6744,3,49,3365,36,1819,13
43492,0,14,274,11,710,3
5946,11,259,3397,208,5291,51
5754,8,535,3407,470,9189,65
43707,3,56,151,49,1024,7
26558,7,110,2287,100,3114,10
43648,7,150,155,110,1579,40
40303,0,80,1537,65,3701,15
6312,34,802,3383,691,10931,111
43210,8,110,480,84,1927,26
8359,104,3388,3258,2260,15781,1128
3876,33,534,3490,472,5883,62
43242,6,91,462,69,1913,22
43751,3,87,131,51,2868,36
43619,7,73,189,39,1412,34
39884,20,231,1564,185,4685,46
7519,6,169,3322,140,2306,29
42457,5,136,973,95,2812,41
1065,57,1469,3813,1266,17748,203
43049,8,36,637,30,1235,6
24395,2,174,2385,151,4411,23
42365,17,291,1043,237,4820,54
43003,104,1356,683,1087,7299,269
28886,3,143,2161,111,2011,32
42431,226,4057,1003,3227,19459,830
43528,56,2220,252,1747,7795,473
43634,8,89,181,84,1946,5
39774,12,321,1572,259,6338,62
42465,2,85,962,54,5943,31
43768,62,1324,118,1138,5839,186
16202,286,15138,2798,12523,105555,2615
6128,6,206,3391,177,5180,29
42474,8,125,953,106,2047,19
42288,10,160,1120,144,3308,16
43271,6,74,436,57,2426,17
43434,4,129,306,85,2122,44
6168,31,682,3389,598,6697,84
43335,19,154,376,122,3691,32
43074,11,198,616,135,4407,63
11984,6,272,3061,174,5552,98
40204,119,2665,1543,2352,22747,313
42460,15,217,968,160,8914,57
40075,0,317,1551,289,6538,28
35923,8,151,1814,130,7292,21
43032,19,298,656,248,4130,50
14894,86,2066,2860,1460,23107,606
43701,4,39,153,31,845,8
33651,9,171,1933,134,3962,37
6164,23,626,3389,543,8558,83
40031,29,363,1553,322,7003,41
42340,63,1642,1071,1253,13716,389
42245,197,3709,1165,3247,21230,462
33854,60,1249,1925,1061,11321,188
42271,266,3909,1132,3441,21982,468
28893,61,2634,2160,1794,35433,840
42494,15,291,935,198,3141,93
1136,4,207,3794,181,7800,26
22076,31,339,2496,260,3268,79
42209,155,3528,1198,2390,22946,1138
38353,19,345,1659,298,3932,47
43734,11,87,138,66,1087,21
43698,3,49,155,36,1000,13
39939,28,649,1560,545,5437,104
42324,136,2528,1087,2183,31794,345
36459,13,166,1782,127,3340,39
5550,6,185,3418,157,4066,28
29602,26,458,2125,400,3655,58
43415,1,19,319,15,766,4
1048,42,889,3816,764,11790,125
1674,7,101,3566,80,2132,21
42163,6,110,1243,97,3544,13
35948,44,1295,1812,1113,23907,182
28293,85,2961,2194,2490,20635,471
42391,8,95,1036,77,3075,18
42501,12,209,931,177,2737,32
42860,199,2311,739,1879,15772,432
43371,8,284,349,166,2825,118
19723,12,241,2629,213,3947,28
42982,78,1063,698,824,5622,239
1008,12,199,3835,179,7008,20
1125,2,45,3796,40,2957,5
27454,26,431,2243,369,4901,62
25386,31,583,2341,539,4572,44
43166,7,228,505,167,3595,61
41728,10,229,1368,206,5302,23
582,12,284,4308,247,17855,37
43081,357,4066,610,3323,22833,743
6047,35,921,3393,785,10762,136
6928,51,1227,3356,907,10223,320
42092,39,838,1304,706,14932,132
43556,5,66,235,56,2242,10
6958,46,1904,3354,1169,11916,735
1477,2,90,3617,66,2462,24
9990,54,1794,3163,1643,15005,151
23066,25,847,2448,719,9200,128
43637,0,62,181,45,856,17
43061,3,40,624,30,1450,10
43559,11,166,235,132,1755,34
8041,24,430,3277,390,6540,40
41588,55,721,1390,568,14221,153
993,13,368,3838,316,11105,52
6154,8,291,3390,254,3807,37
43465,2,35,293,28,1554,7
42101,83,1404,1302,1196,10703,208
24294,25,677,2389,555,6232,122
20028,6,170,2612,151,2980,19
43012,67,1843,674,1415,8584,428
42661,104,937,825,717,6774,220
24777,11,153,2368,139,2113,14
43361,13,203,356,111,2785,92
41717,64,1063,1369,916,19217,147
43250,1,22,455,16,1097,6
43564,5,53,231,28,1081,25
25351,6,94,2343,83,2321,11
6127,30,572,3391,488,6109,84
1031,10,292,3823,205,10484,87
43303,9,102,410,73,2214,29
25930,4,170,2316,146,3533,24
4531,1,14,3468,7,963,7
7916,1,146,3293,134,3662,12
1538,4,165,3595,139,4811,26
42488,4,90,946,59,3912,31
1444,2,68,3642,58,2382,10
43156,151,1861,513,1476,8259,385
43532,2,26,247,18,974,8
43110,460,5519,577,4573,29606,946
43141,44,373,523,285,3574,88
5185,2,67,3436,58,7101,9
43527,51,565,252,428,4915,137
42216,4,80,1185,72,2244,8
39748,10,181,1573,159,3933,22
41298,160,2648,1430,2237,25786,411
30788,185,5533,2063,4759,20897,774
42669,31,498,821,372,3918,126
43567,4,26,231,23,1061,3
28887,19,878,2161,673,9403,205
43208,24,171,481,124,2120,47
42350,12,317,1056,226,4818,91
10741,9,336,3124,277,5379,59
41542,255,5629,1397,4237,31636,1392
43230,2,68,469,55,1326,13
42424,5,131,1013,109,5870,22
21255,8,279,2542,230,3893,49
5856,6,746,3402,400,8129,346
43500,1,29,265,17,1165,12
43031,86,1269,656,827,8816,442
43198,2,65,488,39,2787,26
11058,0,335,3108,175,2307,160
39431,447,10149,1591,8235,51731,1914
43607,4,75,200,46,2124,29
21710,143,2602,2516,2073,16782,529
8249,12,252,3266,175,2633,77
27549,3,167,2236,146,3168,21
23720,25,557,2416,479,6498,78
24392,1,55,2385,47,2158,8
11950,3,296,3063,265,6905,31
8668,32,1442,3238,1246,21159,196
23572,38,746,2423,644,13180,102
6065,10,172,3392,148,3342,24
43126,6,118,542,72,1795,46
6213,3,213,3388,194,5767,19
42381,3,141,1038,120,6358,21
28884,1,30,2161,25,1348,5
43235,1,35,466,25,1384,10
39965,28,642,1558,517,9879,125
43131,141,1326,536,1145,12067,181
42100,152,3097,1303,2488,26870,609
24388,1,35,2385,31,2321,4
1469,2,67,3618,55,1861,12
30563,413,9604,2074,7776,62395,1828
27139,10,151,2262,119,1901,32
16333,0,42,2791,36,2176,6
43034,33,547,654,409,5641,138
31867,3,164,2009,129,3064,35
32196,13,348,1991,299,4967,49
43525,4,41,253,39,1241,2
43069,96,1174,622,1028,10613,146
32649,1,83,1972,74,3052,9
43019,5,98,660,64,2807,34
43738,1,28,136,23,1206,5
42930,3,134,716,101,2664,33
43699,1,51,154,31,1678,20
9330,3,487,3198,211,2435,276
24842,32,449,2365,393,7421,56
43188,14,144,498,99,1915,45
43309,18,290,403,211,4676,79
4618,5,167,3464,131,2135,36
14394,71,2165,2893,1903,25233,262
23391,7,179,2432,162,4886,17
18259,2,87,2695,74,3087,13
34588,270,46943,1897,40251,54146,6692
41102,4603,133638,1460,102623,539041,31015
43225,50,538,470,370,5840,168
6100,45,1881,3391,1494,21995,387
43600,2,84,205,57,1192,27
43474,11,307,286,170,4589,137
42677,83,1672,820,993,8045,679
3620,51,1188,3496,1037,15440,151
23986,187,3638,2403,3003,12492,635
13981,4,160,2922,135,3175,25
5384,29,1237,3425,751,6507,486
19914,4,152,2619,140,2522,12
43466,9,99,293,57,1354,42
32974,4,94,1959,79,3339,15
42552,5,44,901,37,1947,7
42758,584,8139,793,6323,41795,1816
42402,67,1646,1030,1304,10617,342
43302,5,82,411,46,1701,36
43473,5,133,286,96,2778,37
37570,28,356,1714,277,5667,79
39369,530,8893,1594,7091,29761,1802
43403,6,60,324,48,1419,12
40277,6,53,1538,41,2066,12
32493,20,363,1979,291,8701,72
43155,153,1952,513,1527,7748,425
36455,2,98,1783,80,9659,18
43082,14,88,607,78,2700,10
34046,49,831,1919,667,6841,164
11902,42,1238,3065,1108,16764,130
42656,139,1882,826,1493,10313,389
25775,7,310,2323,273,6985,37
23418,0,93,2430,73,3330,20
43633,33,335,181,267,4428,68
43035,75,833,653,504,5760,329
43301,5,51,411,35,1777,16
37976,12,329,1686,276,7075,53
21149,346,7119,2548,5886,51627,1233
21639,14,542,2521,464,9761,78
43328,4,54,381,43,2036,11
42250,39,552,1163,466,7483,86
17937,2,216,2711,198,2811,18
43641,9,124,178,80,1676,44
27024,6,80,2268,66,2716,14
22442,8,195,2479,147,3088,48
26455,1,83,2292,68,1926,15
43194,3,31,493,23,1521,8
16826,4,320,2765,275,4328,45
42622,6,146,840,103,2375,43
35478,4,220,1848,184,2997,36
19942,71,1649,2617,1448,7836,201
42782,67,634,775,520,6631,114
31868,1,49,2009,38,2249,11
6205,20,407,3388,361,5965,46
43747,8,143,133,119,2478,24
43310,18,520,401,388,3226,132
43214,101,2066,476,1639,11230,427
43196,51,698,489,461,7905,237
38889,22,529,1624,450,8083,79
1666,6,203,3568,157,3793,46
43324,4,25,388,20,1149,5
42754,83,801,797,638,9403,163
1003,72,1547,3836,1293,24376,254
42454,83,888,975,750,8763,138
43120,319,4088,550,3262,23852,826
1283,7,193,3744,171,4710,22
43329,14,213,381,130,2065,83
7650,1,53,3314,43,3074,10
9975,25,329,3164,282,6712,47
42165,52,895,1241,742,9278,153
40620,10,282,1506,235,5818,47
41947,415,8856,1327,7225,55571,1631
31012,197,3226,2054,2832,17826,394
34184,11,155,1915,132,3511,23
1073,17,257,3811,210,5984,47
1790,4,135,3533,118,3527,17
26620,1,46,2285,36,1829,10
17432,44,1468,2732,1297,22605,171
42366,67,1480,1043,1257,15216,223
42985,84,1106,698,842,5755,264
10307,75,1800,3148,1536,23063,264
43677,4,35,162,28,572,7
27420,13,249,2245,197,4328,52
1002,49,1972,3836,1682,16667,290
43789,5,98,104,62,957,36
1018,2,49,3830,39,3295,10
43359,27,238,356,174,2675,64
43422,102,1464,316,1184,4853,280
26379,9,163,2295,131,2309,32
43722,1,41,144,19,959,22
42194,14,305,1212,235,4571,70
42329,6,166,1079,143,2828,23
42532,155,2777,910,2458,16142,319
43647,9,171,151,142,1517,29
43181,98,1466,499,1224,9233,242
43412,7,105,320,50,1599,55
22966,2,139,2452,130,4917,9
20116,13,327,2608,277,4221,50
43219,154,2507,472,2026,8505,481
12189,411,7406,3050,4768,37486,2638
25409,163,2835,2340,2428,28098,407
1742,22,497,3550,415,7915,82
43215,7,57,476,39,1938,18
43523,18,152,253,122,1546,30
43353,37,423,362,297,3655,126
19867,13,196,2621,171,3601,25
21981,105,3056,2501,2618,13666,438
42141,6,151,1269,124,5489,27
34387,22,397,1907,321,10730,76
4636,5,249,3463,209,3689,40
35080,251,5388,1870,4606,25587,782
42514,4,91,921,65,5354,26
42471,8,113,956,95,2481,18
41046,5,168,1467,128,3249,40
32675,32,1103,1971,891,9681,212
34290,7,203,1911,175,3242,28
39462,13,289,1589,239,6690,50
1051,5,116,3815,102,3319,14
43413,9,191,319,145,1778,46
42515,5,136,921,107,3834,29
28421,3,109,2187,89,5808,20
28252,15,387,2196,325,6513,62
1701,0,32,3564,29,2073,3
35563,11,280,1842,220,7387,60
1562,3,88,3590,80,2818,8
29470,14,443,2130,338,9009,105
36812,27,560,1762,496,7252,64
42756,1,50,794,36,3983,14
42884,4,49,735,29,1131,20
42804,1,52,761,24,1462,28
43251,1,25,454,18,1527,7
34288,8,207,1911,173,2881,34
43022,53,762,663,592,5952,170
29713,83,1384,2119,1171,11705,213
1196,7,189,3769,167,5869,22
9656,7,1695,3178,795,2841,900
5710,3,91,3409,77,9632,14
14872,6,205,2861,185,7608,20
8740,9,317,3234,294,9468,23
1718,1,49,3557,43,3881,6
42673,154,1501,821,1237,14277,264
34244,18,146,1913,122,4427,24
1212,6,87,3766,68,3715,19
1452,4,115,3631,95,5023,20
42438,17,244,996,169,5304,75
7101,4,132,3346,120,4160,12
21725,134,2429,2516,2085,8853,344
11048,11,224,3109,189,7373,35
43459,2,64,300,42,1377,22
37208,27,464,1737,381,6062,83
28269,1,89,2195,73,2947,16
43579,0,67,218,17,1494,50
43455,3,54,300,40,1427,14
32356,1,46,1984,40,2529,6
43416,200,3719,318,2953,16513,766
43327,185,2788,382,1945,14916,843
42155,237,6856,1251,5259,87858,1597
43133,117,1468,535,1109,11563,359
35561,13,318,1842,259,9630,59
17888,136,2375,2713,1911,17117,464
41332,41,597,1426,515,5211,82
42459,20,466,969,384,9606,82
43419,8,70,317,51,2394,19
43457,3,58,300,42,1428,16
42880,0,24,735,13,1169,11
22138,6,199,2493,176,9304,23
43193,59,801,493,585,13799,216
38823,2,104,1628,85,2548,19
43349,3,50,364,43,1120,7
10152,3,123,3155,109,3193,14
15026,28,500,2852,458,7511,42
42466,13,197,961,165,2754,32
17614,0,46,2723,41,1598,5
43084,21,147,606,105,2464,42
8670,2,123,3238,114,3796,9
1543,119,3624,3595,3227,37595,397
15444,8,198,2832,174,4471,24
28729,192,3792,2168,3200,13886,592
23442,7,434,2429,402,13631,32
43067,11,134,623,96,2929,38
43409,19,234,322,205,3464,29
42078,5,180,1305,170,5887,10
22666,10,296,2467,268,5849,28
25851,191,5100,2320,4430,41824,670
1313,4,223,3727,203,4963,20
42583,28,322,852,208,7672,114
42526,778,19393,915,15540,103480,3853
30424,37,472,2081,381,7273,91
43565,27,149,231,138,1096,11
43241,118,1319,462,1052,10268,267
42158,172,3763,1249,3064,35108,699
4337,19,856,3474,642,6268,214
42936,10,99,712,68,1312,31
6097,7,186,3391,137,2774,49
32285,1,79,1988,68,3017,11
42221,8,121,1177,88,1634,33
1336,6,188,3718,161,4463,27
1191,32,458,3770,404,9211,54
12335,20,409,3042,357,5732,52
1609,5,129,3583,113,2951,16
1126,8,333,3796,300,5969,33
43121,42,619,549,519,15428,100
28862,15,479,2161,388,5861,91
28768,2,106,2166,85,3110,21
20499,20,744,2588,701,6836,43
43018,27,307,670,181,3209,126
42827,5,217,752,115,2891,102
43582,3,76,215,48,1480,28
34029,7,184,1919,153,2768,31
35750,2,154,1827,125,4446,29
43348,108,1389,364,1123,10304,266
43237,55,512,464,345,4980,167
42629,115,2355,838,2080,18218,275
43574,6,106,223,86,1020,20
25770,199,5390,2323,4260,26627,1130
42091,2,35,1304,31,1677,4
41720,14,411,1369,370,5036,41
43663,0,57,167,26,1077,31
43749,73,1181,132,880,13436,301
43476,0,30,283,26,1105,4
1643,17,233,3575,195,6441,38
23676,186,3805,2418,2755,27220,1050
43795,13,400,97,310,3304,90
42575,1621,42008,871,34971,145836,7037
32379,5,54,1983,46,2023,8
24537,29,768,2378,617,7475,151
9754,393,24620,3175,21057,111181,3563
3653,9,233,3496,202,5319,31
29223,9,306,2144,233,5351,73
40700,21,318,1499,271,6733,47
43288,121,1486,427,1185,12599,301
38722,43,966,1634,725,12036,241
1282,5,163,3745,143,4544,20
1098,3,143,3802,131,5801,12
1667,56,909,3567,738,8438,171
43269,31,335,439,284,4830,51
42495,55,618,935,518,3767,100
41371,50,1153,1421,973,10034,180
14680,5,296,2874,255,5490,41
27312,67,1207,2252,968,12217,239
1750,6,92,3547,76,2314,16
28917,8,434,2159,314,6424,120
43563,10,113,232,85,2465,28
28345,1,80,2191,73,3195,7
43154,167,2175,513,1718,10395,457
27355,83,1281,2249,1080,13099,201
30791,176,4694,2062,3748,31883,946
43533,4,58,247,45,729,13
22161,59,938,2492,836,10672,102
32173,24,453,1993,410,13306,43
13407,13,236,2969,195,2915,41
1425,178,4373,3644,3833,27265,540
6043,8,312,3393,279,3660,33
11275,10,286,3096,246,8268,40
1112,41,1267,3799,1146,20249,121
18290,4,135,2694,118,2508,17
18082,9,279,2702,233,5493,46
7113,17,939,3345,777,17193,162
42709,69,3657,797,2568,9388,1089
43590,8,41,210,36,2446,5
22788,50,733,2462,617,7674,116
42239,61,950,1169,769,7168,181
19600,49,1630,2636,1380,6193,250
34412,10,188,1905,170,3636,18
1091,19,386,3806,300,5010,86
43276,7,108,433,72,1971,36
1420,59,1073,3644,957,6753,116
19602,237,4467,2636,3676,29449,791
15259,17,262,2840,225,5122,37
43109,35,486,578,335,4589,151
42277,38,535,1126,360,5451,175
34418,117,1381,1905,1211,12162,170
1601,3,72,3584,66,2470,6
42979,251,5797,699,4480,31061,1317
42440,0,9,989,9,1385,0
42566,66,689,887,497,9384,192
13877,20,1100,2932,962,8076,138
43128,364,5237,538,4387,19920,850
6749,147,3855,3365,3368,13681,487
34846,97,1753,1882,1443,14646,310
42741,16,178,805,125,5001,53
43690,3,63,158,36,920,27
1356,15,8314,3704,4028,5169,4286
43694,3,45,156,42,1362,3
41173,29,448,1452,358,4718,90
14646,4,156,2876,130,4276,26
43625,0,28,183,18,924,10
43449,32,281,301,237,3884,44
1294,5,103,3739,87,3810,16
37038,318,5142,1748,4290,22574,852
43706,13,136,152,108,2649,28
42242,7,174,1168,150,1952,24
974,20,754,3846,669,11122,85
43314,2,44,398,34,1517,10
985,92,3281,3841,2928,30381,353
42387,6,94,1036,72,2912,22
6125,6,258,3391,213,6008,45
33049,2,86,1955,76,4659,10
43445,10,149,301,100,4741,49
42081,0,92,1304,66,11734,26
30736,9,118,2065,104,2349,14
42360,0,0,1047,0,7693,0
31571,23,207,2024,188,4986,19
40994,106,1644,1473,1342,8538,302
43386,18,384,332,259,3877,125
28268,11,236,2195,190,4518,46
43612,7,101,196,87,1500,14
14892,8,116,2860,100,3007,16
43080,11,137,611,85,2376,52
1622,170,4183,3581,3400,39053,783
29341,269,6121,2136,5233,26849,888
42278,41,528,1126,430,4261,98
43006,72,600,678,483,9109,117
1713,15,298,3558,243,5086,55
14947,58,1945,2857,1666,29770,279
984,2,101,3841,91,3097,10
43468,15,222,290,139,2194,83
9967,358,17247,3164,13876,42406,3371
14861,3,511,2862,436,13160,75
42934,55,1092,713,700,10877,392
31429,16,221,2032,175,3662,46
43767,4,60,118,42,1063,18
43599,2,39,205,33,930,6
42628,3,72,839,57,1220,15
25630,209,2886,2329,2363,13098,523
40501,2,96,1516,85,2656,11
21822,37,627,2511,522,11083,105
25676,140,4129,2327,3458,22401,671
30679,5,140,2067,125,2758,15
1726,3,115,3555,102,3942,13
35938,1,53,1813,40,2104,13
42659,0,37,825,26,2009,11
36220,2,42,1794,36,2961,6
10457,15,906,3141,558,5383,348
43350,102,1131,363,928,8385,203
37963,38,806,1687,702,6957,104
42891,6,52,735,43,1957,9
42386,17,262,1036,225,4181,37
27800,14,489,2221,417,9911,72
7040,4,103,3348,89,2332,14
1756,20,2234,3544,1029,4439,1205
2082,4,165,3523,141,5170,24
20927,32,582,2562,448,7167,134
42083,4,103,1304,94,5538,9
42195,4,75,1212,58,1799,17
32628,41,990,1973,793,15939,197
1109,13,210,3799,184,5010,26
16238,38,1316,2796,1207,7830,109
20505,2,111,2588,100,2376,11
42990,171,2420,694,2004,23668,416
42553,11,137,901,121,2284,16
42940,16,167,707,120,3226,47
27708,32,431,2227,362,3480,69
999,2,72,3837,66,3967,6
37468,16,320,1721,247,5760,73
37695,6,88,1707,77,1874,11
43073,116,1499,616,1313,11640,186
30954,23,416,2056,370,3968,46
43311,470,7713,399,6061,42191,1652
20596,5,65,2583,58,2444,7
14257,8,228,2905,190,4118,38
42784,144,1325,773,1032,8258,293
39442,13,236,1590,213,6337,23
43759,11,101,127,95,1803,6
43282,39,440,430,325,3835,115
42376,126,2250,1040,1902,25860,348
6932,1190,28394,3356,21545,186537,6849
3470,3,760,3499,273,2643,487
42295,29,535,1115,441,13069,94
6039,63,1109,3393,954,11289,155
42941,98,1291,706,1114,9098,177
39170,125,1758,1607,1396,10114,362
42136,382,6988,1279,6052,65982,936
1658,61,1063,3570,916,7444,147
22675,9,331,2467,304,8798,27
42088,4,98,1304,85,2946,13
42234,72,1061,1171,866,13162,195
9506,6,160,3187,133,2080,27
6204,4,126,3388,115,2352,11
43592,3,63,209,52,1278,11
12958,36,967,3006,891,14319,76
1441,10,396,3642,332,7406,64
42233,67,731,1171,571,6361,160
43388,6,84,330,75,2321,9
3935,11,428,3489,376,8441,52
43617,6,114,192,71,2197,43
41714,27,894,1370,764,6744,130
43286,50,902,422,652,7307,250
43362,2,59,356,50,3795,9
1575,3,54,3589,52,3029,2
21935,9,195,2505,167,6507,28
42157,19,245,1249,210,4502,35
30835,11,151,2060,124,3060,27
43483,2,89,280,63,1659,26
41191,0,15,1449,13,1031,2
42690,6,81,817,56,5509,25
38912,13,324,1623,296,8773,28
40111,11,238,1549,181,4092,57
42265,19,325,1136,240,3832,85
43095,31,463,598,304,4557,159
43187,59,616,498,443,5711,173
43140,387,11506,523,8535,23795,2971
42463,12,218,962,173,2660,45
42987,66,810,698,632,5612,178
13315,17,433,2975,376,7204,57
43294,15,127,420,94,2475,33
26573,0,123,2287,107,2596,16
42802,17,211,761,149,4773,62
27263,20,371,2254,306,4292,65
37856,500,10031,1694,8523,42007,1508
38472,55,953,1652,809,5804,144
42064,2,134,1308,113,3255,21
42415,16,367,1021,277,9631,90
23147,6,137,2444,111,3087,26
3596,10,1515,3497,649,3276,866
41737,447,7405,1365,6202,49308,1203
4684,3,438,3462,315,3698,123
40438,7,182,1522,153,3618,29
23334,4,102,2435,86,5413,16
30360,1,115,2085,100,5182,15
42407,150,2474,1029,1987,15956,487
1005,49,1273,3835,1098,17037,175
43418,211,3749,317,2953,14450,796
42524,70,1042,917,839,10904,203
43680,29,466,161,400,4213,66
43791,4,57,102,50,1234,7
26557,4,113,2287,102,3044,11
35997,12,258,1808,209,5560,49
27890,16,176,2217,152,3195,24
40439,73,1150,1522,952,7965,198
11586,20,446,3080,390,5501,56
12259,0,357,3046,161,4422,196
42333,163,2122,1075,1762,43512,360
1664,3,44,3568,39,1792,5
42187,4,118,1220,101,4600,17
42249,220,5154,1163,4161,36912,993
12587,1,265,3028,164,2524,101
42486,8,108,947,89,2028,19
42309,103,1963,1104,1675,15377,288
42915,4,48,728,35,2657,13
42830,62,873,752,630,7993,243
42200,22,208,1205,159,32216,49
1045,7,197,3816,175,5469,22
42336,24,187,1073,153,3134,34
41317,50,615,1428,538,14494,77
16114,10,140,2801,118,2288,22
1671,279,5781,3567,4764,51938,1017
6024,0,76,3394,64,2562,12
16090,27,971,2802,875,15389,96
42189,123,2015,1220,1557,23224,458
1777,28,603,3538,492,8876,111
43394,14,178,328,131,6392,47
42410,44,485,1026,362,3906,123
31904,9,200,2007,173,3071,27
42525,6,105,917,74,2851,31
38170,848,18721,1673,15754,64980,2967
30152,26,454,2098,409,3885,45
42925,12,108,725,68,2269,40
43636,6,46,181,32,1074,14
9493,18,489,3187,448,12060,41
1258,28,651,3751,587,10402,64
1118,1,95,3797,90,5868,5
6036,23,574,3393,496,7028,78
22868,4,160,2457,136,6538,24
2678,249,10037,3514,6520,40510,3517
21589,14,297,2524,252,4046,45
39940,30,582,1560,506,4477,76
42503,22,388,931,323,4162,65
43399,76,938,324,727,8515,211
40078,18,434,1551,384,5594,50
42099,140,3284,1303,2617,12722,667
40979,18,347,1474,288,9831,59
43608,12,143,198,106,3210,37
3915,99,2172,3489,1693,19414,479
3652,27,877,3496,743,14976,134
8146,5,407,3273,185,2133,222
29671,127,2189,2121,1842,11898,347
2995,8,1427,3508,661,9771,766
43057,418,5961,629,4740,30243,1221
43764,2,78,120,55,614,23
14312,5,102,2900,79,3970,23
6060,11,5957,3393,2447,6563,3510
27744,4,169,2226,155,1960,14
12639,5,137,3025,125,3819,12
1697,1,97,3564,84,3634,13
41733,31,433,1366,383,7130,50
11665,11,220,3076,183,3249,37
27859,15,335,2219,294,3470,41
583,1,68,4361,61,4050,7
8074,3,263,3276,234,3543,29
6528,11,638,3374,510,7738,128
23113,0,74,2445,62,2240,12
42364,12,437,1044,311,6859,126
1789,103,2131,3533,1908,26163,223
42432,6,71,1002,60,3946,11
42563,13,186,889,146,3835,40
43402,1,39,324,33,795,6
6035,8,436,3393,394,6557,42
22616,16,388,2470,335,5034,53
8729,11,407,3234,363,7874,44
28772,20,316,2166,268,4580,48
38235,12,218,1669,203,5869,15
14971,12,293,2856,265,4353,28
43045,99,1461,643,1060,9622,401
42609,49,691,844,512,8562,179
949,41,616,3853,529,5964,87
42991,127,1311,691,1004,16834,307
40223,12,222,1542,199,5068,23
39122,110,2048,1609,1641,13879,407
43654,5,116,155,100,1319,16
28800,1,107,2165,90,3373,17
34970,14,225,1875,187,4343,38
1471,3,38,3618,34,1966,4
42371,37,680,1043,521,8001,159
34180,39,427,1915,344,3397,83
1129,12,188,3796,176,5430,12
43588,11,244,211,233,2515,11
1486,26,661,3616,468,5585,193
43249,26,312,457,262,5109,50
43245,3,18,460,9,1279,9
7339,24,910,3332,820,13203,90
37535,7,195,1716,168,7844,27
42089,14,185,1304,152,2421,33
29906,214,4124,2109,3488,16907,636
1427,223,4189,3644,3369,44256,820
43551,7,103,240,68,889,35
43491,0,15,274,14,1034,1
27246,78,1640,2255,1294,13117,346
37590,4,137,1713,120,2292,17
42796,1486,29289,767,20238,84528,9051
19467,60,1495,2642,1295,7949,200
42911,10,147,728,92,2396,55
42251,105,1906,1162,1618,20120,288
43106,62,519,583,422,5141,97
37913,20,401,1690,327,7339,74
43438,10,52,304,41,828,11
39350,961,18404,1595,12324,59166,6080
43377,15,196,341,145,2315,51
18789,1,95,2672,81,3260,14
40299,120,1914,1537,1546,14437,368
1267,11,270,3748,240,7338,30
43212,55,578,480,347,4109,231
42535,76,1054,909,819,11279,235
26555,15,361,2287,286,3034,75
42577,8,89,862,63,1719,26
40500,4,138,1516,119,2694,19
24048,3,124,2401,112,2148,12
42205,1,71,1201,55,2297,16
43098,110,1462,589,1123,8190,339
2252,23,804,3521,730,20792,74
43086,53,601,604,508,4715,93
21855,12,338,2510,298,5792,40
43760,3,21,124,17,683,4
29101,63,1525,2150,1227,13518,298
1645,4,142,3574,120,3128,22
6038,48,1176,3393,1052,13813,124
1415,52,848,3645,689,10556,159
27848,1,80,2220,65,2158,15
43027,3,111,657,78,2545,33
43429,52,733,314,616,6855,117
42291,90,2325,1116,2000,21782,325
1659,19,684,3570,595,12865,89
7027,5,180,3350,166,5503,14
1213,5,251,3766,232,4619,19
6017,2,77,3394,53,2254,24
43185,58,908,498,626,7395,282
1724,4,76,3556,57,2856,19
43228,0,0,469,0,1246,0
28406,27,650,2187,536,14213,114
33443,2,131,1940,119,3052,12
41074,18,270,1463,220,3544,50
1264,10,296,3748,246,5895,50
42154,14,269,1253,232,5558,37
1661,15,322,3570,266,9394,56
43270,17,204,437,178,4210,26
3833,201,4249,3491,3415,30521,834
43766,73,938,120,806,9148,132
7817,2,69,3303,62,4155,7
43236,18,176,430,121,1643,55
6602,36,815,3371,587,9437,228
7555,57,1680,3320,1246,16179,434
15455,1,57,2832,49,1738,8
22373,35,792,2482,664,7359,128
42042,72,966,1312,845,10793,121
43333,7,74,376,53,2142,21
14194,2,167,2909,146,6014,21
6026,4,142,3394,125,7514,17
21252,3,182,2542,149,3304,33
1242,0,53,3758,44,2846,9
42434,6,213,1001,166,20438,47
43021,39,421,665,355,4601,66
10015,5,129,3162,109,4208,20
43279,5,82,431,53,3786,29
23155,18,877,2444,734,13495,143
37362,3,174,1728,140,5283,34
43454,3,40,301,23,1330,17
6980,13,300,3352,269,5036,31
41810,27,371,1349,340,7918,31
42307,1,32,1106,27,1953,5
43408,9,141,322,99,3398,42
42927,18,224,710,157,3178,67
1116,13,375,3797,331,6933,44
36873,3906,90721,1757,66120,290479,24601
23219,113,4005,2440,3257,15838,748
42928,79,987,717,704,9136,283
33380,5,305,1943,278,5903,27
31248,20,284,2042,233,7359,51
33070,18,469,1954,385,12364,84
42269,101,1757,1133,1384,14932,373
20712,0,92,2576,81,2296,11
43146,47,486,517,343,4295,143
42171,38,926,1237,792,7514,134
19934,2,96,2618,87,2353,9
43730,15,184,140,138,2561,46
1556,1,90,3592,78,4485,12
43464,32,642,293,554,10671,88
43673,3,39,163,22,844,17
12651,5,109,3024,92,2258,17
42389,15,168,1036,133,5675,35
38788,1,58,1630,47,2600,11
42554,580,10665,899,9076,36318,1589
14399,25,585,2893,490,8380,95
43013,9,162,674,142,2035,20
42308,7,114,1104,98,3653,16
42323,0,0,1088,0,1445,0
37509,12,279,1718,230,3996,49
27280,114,1705,2254,1406,14632,299
42331,3,97,1077,75,2714,22
43381,21,295,338,199,4261,96
42183,10,108,1224,92,2623,16
42458,9,183,970,129,2118,54
34278,314,6731,1912,5369,45803,1362
27358,5,111,2249,102,3503,9
37007,55,1380,1750,1125,13536,255
15453,4,186,2832,164,2386,22
43264,5,104,444,80,2353,24
42574,4,48,871,41,4339,7
6167,7,395,3389,356,9957,39
43479,83,1015,281,666,29605,349
42090,11,256,1304,211,9008,45
1731,6,193,3553,156,4980,37
22139,28,630,2493,548,8943,82
31997,6,143,2002,124,2515,19
42469,52,717,956,548,5356,169
6143,30,977,3390,870,14490,107
42453,6,381,476,246,1805,135
12333,6,206,3042,177,7543,29
5840,18,237,3402,191,3713,46
21886,10,267,2507,223,7280,44
1563,3,73,3590,65,2061,8
31077,8,273,2050,244,6749,29
1708,2,35,3562,32,3305,3
35751,3,72,1827,64,3568,8
3879,2087,44152,3490,34907,143282,9245
5204,14,250,3435,218,3405,32
42642,10,134,833,84,2534,50
43274,3,63,434,35,2035,28
1443,4,155,3642,124,2438,31
43142,0,29,523,21,1254,8
42326,9,97,1084,75,2754,22
33639,43,704,1933,602,9146,102
30197,12,305,2095,253,3676,52
35386,16,267,1854,240,4549,27
42636,45,619,834,481,6613,138
37001,92,1958,1750,1684,26920,274
42314,13,456,1096,391,5199,65
7974,9,123,3287,110,2499,13
42481,5,90,948,56,3544,34
43017,100,1295,670,941,9020,354
32886,503,13974,1962,11312,47230,2662
1698,5,138,3564,119,3394,19
43213,92,1316,478,983,9333,333
30803,2,61,2062,55,1519,6
43372,13,232,348,150,3021,82
29540,5,103,2127,89,2408,14
20602,1,33,2583,30,2582,3
43148,32,1508,517,997,3912,511
1103,14,322,3801,295,7164,27
37328,120,1666,1730,1328,13229,338
21113,54,1461,2552,1241,11074,220
40934,21,293,1477,241,4047,52
23195,4,201,2442,173,4789,28
4468,178,4990,3470,3134,20322,1856
1527,3,86,3602,75,2020,11
43258,6,41,449,27,2408,14
26734,12,277,2280,237,2884,40
20886,2,116,2565,102,2641,14
14288,23,559,2902,465,12735,94
29985,46,829,2106,714,6662,115
43461,38,539,300,396,5359,143
42528,50,765,914,605,6838,160
9494,64,1172,3187,1043,19169,129
37821,8,189,1696,163,3281,26
42822,10,201,757,131,5509,70
22956,16,310,2452,258,6371,52
43239,10,189,463,149,3539,40
1561,6,99,3591,88,2934,11
3909,62,990,3489,840,12546,150
1699,6,134,3564,107,3479,27
1779,13,276,3537,239,4091,37
1499,3,121,3615,106,3706,15
7391,20,306,3330,279,3584,27
41387,2,111,1419,86,3463,25
17814,2,127,2716,103,5213,24
41833,3,87,1345,79,2747,8
11898,86,3297,3065,2468,34195,829
35794,0,43,1823,36,2144,7
43484,73,947,279,737,7059,210
1121,5,101,3797,90,4246,11
21042,2,149,2555,134,3044,15
7517,4,133,3322,123,2823,10
18984,2,73,2665,64,3048,9
1618,6,151,3582,134,5215,17
41649,49,859,1379,601,8293,258
42529,5,121,914,86,5195,35
940,8,644,3855,600,7689,44
10351,4,149,3146,123,2650,26
15718,1,71,2819,64,3214,7
43313,12,231,381,163,4629,68
17686,7,145,2721,129,3823,16
43268,59,601,441,504,5576,97
43513,5,58,256,41,1216,17
43134,33,377,534,265,3973,112
27303,149,2675,2252,2353,20750,322
37242,1,59,1735,45,2160,14
25147,150,3009,2351,2559,21418,450
43099,2,40,589,32,1990,8
43431,37,480,311,340,4488,140
43793,13,99,100,88,2162,11
43300,15,226,411,183,2569,43
1818,20,659,3530,581,8711,78
36948,131,2767,1753,2243,16443,524
41678,250,3790,1375,3251,24563,539
15054,9,157,2850,136,2673,21
1083,3,83,3807,69,2720,14
1565,3,55,3590,50,1907,5
42274,23,262,1130,225,3379,37
42257,132,2161,1149,1855,19652,306
22443,10,281,2479,228,7424,53
38822,24,287,1628,244,3514,43
21116,1,54,2552,52,1749,2
6857,39,5309,3359,2551,9456,2758
15454,4,153,2832,134,1972,19
40421,10,319,1524,265,5896,54
1655,4,10312,3571,3412,2278,6900
9496,45,1199,3187,1092,20395,107
4711,3,128,3460,98,2368,30
16326,2,169,2791,135,2491,34
21528,161,3111,2527,2504,23820,607
42417,324,4448,1020,3567,25733,881
33916,38,941,1923,792,9909,149
40161,16,242,1546,201,7247,41
43079,25,232,612,190,4308,42
22618,19,669,2470,567,5609,102
6537,7,164,3373,130,2690,34
41052,21,293,1467,242,4516,51
41911,2,49,1333,40,1700,9
31355,17,265,2036,244,4939,21
43085,48,566,605,474,5071,92
30268,0,80,2091,67,2373,13
43339,154,1928,372,1458,9712,470
42406,349,7421,1029,6083,33670,1338
43263,15,238,446,169,6161,69
10608,9,301,3132,274,5063,27
39083,8,117,1612,95,2164,22
42311,11,196,1102,156,4164,40
6131,4,117,3391,96,2876,21
4614,1,86,3464,72,1799,14
43367,23,455,350,318,5007,137
38464,19,384,1652,301,6266,83
43704,1,83,152,49,1639,34
27264,26,405,2254,308,7912,97
1062,6,140,3814,109,4082,31
42243,6,157,1166,112,2851,45
40448,313,8685,1521,7352,70913,1333
12736,6,72,3019,57,2227,15
42287,5,116,1121,86,3852,30
43660,3,21,170,11,675,10
1472,6,75,3617,63,2481,12
23746,3262,90388,2415,66835,284477,23553
1043,4,162,3819,151,9273,11
28311,457,15727,2193,12679,41686,3048
40289,12,259,1537,226,8432,33
39030,65,913,1616,691,12260,222
1006,51,1138,3835,997,15952,141
22263,9,425,2487,375,6846,50
27123,5,138,2263,107,2899,31
30669,163,3391,2068,2936,14476,455
43488,94,935,275,736,5869,199
43475,6,446,283,194,4673,252
43164,44,433,508,330,5884,103
42124,40,571,1294,465,6951,106
43496,29,281,270,217,4433,64
6106,22,615,3391,467,6293,148
27457,95,1616,2242,1304,7834,312
9425,6,436,3192,392,9704,44
40494,31,680,1517,511,8611,169
1651,6,0,3572,0,6662,0
42228,19,281,1175,258,4882,23
43598,4,59,206,55,1596,4
43336,49,867,374,717,6850,150
8588,14,509,3243,458,9754,51
28848,4,217,2162,200,5249,17
1688,1,38,3565,35,1752,3
23648,0,0,2419,0,3663,0
15457,8,191,2832,181,5484,10
1437,0,61,3643,54,2708,7
1421,106,2738,3644,2440,19487,298
43060,25,243,624,202,4063,41
42384,88,1314,1037,1132,8326,182
42937,4,153,710,115,5041,38
42378,60,764,1039,607,4248,157
43718,0,68,145,57,739,11
42246,8,172,1164,149,4638,23
1315,9,485,3727,436,19286,49
31894,1,43,2008,38,2571,5
1092,11,218,3806,136,3834,82
14843,2,128,2863,111,8403,17
1297,27,639,3738,557,8360,82
42693,236,3834,817,3255,28382,579
30047,27,462,2103,414,3954,48
1479,17,449,3617,339,3305,110
8302,17,1846,3262,793,7106,1053
30049,29,654,2103,547,9049,107
43404,2,47,324,30,817,17
41941,11,177,1329,144,4872,33
42848,4,66,743,43,2062,23
302,6,231,4170,192,8743,39
18447,1,82,2687,73,3868,9
42675,39,512,820,371,3412,141
30600,117,1589,2072,1213,12180,376
21884,50,1497,2507,1353,6695,144
39956,18,458,1558,385,4124,73
42140,7,131,1271,102,2428,29
42241,32,619,1169,530,9727,89
1233,10,146,3763,129,4067,17
5671,13,954,3411,524,3855,430
6166,3,114,3389,85,2032,29
43546,5,57,242,40,1705,17
33271,9,142,1947,121,4366,21
42086,42,701,1304,593,6749,108
43713,11,59,146,56,1224,3
961,16,443,3850,370,8181,73
43709,1,21,150,13,556,8
1069,8,142,3812,125,4575,17
42412,449,10323,1024,8384,36646,1939
42873,4,86,735,68,2491,18
23012,3,102,2450,93,2135,9
12957,42,1183,3006,1064,11656,119
42201,7,141,1205,104,7821,37
20872,186,3695,2566,2704,17113,991
36009,12,248,1807,199,5052,49
42492,47,538,937,408,10821,130
43538,3,54,245,33,873,21
42578,26,293,861,245,7939,48
43163,11,99,509,70,1786,29
42725,23,1322,797,898,5549,424
1628,5,121,3580,106,4085,15
42009,184,2642,1317,2076,21507,566
27082,10,393,2266,303,8447,90
5512,49,30002,3420,10439,4879,19563
30186,476,12862,2095,10883,56735,1979
42715,88,4668,797,3513,16780,1155
26309,16,589,2299,521,10063,68
8013,11,245,3284,216,2321,29
43621,1,23,186,17,655,6
43503,5,54,263,36,1897,18
43788,3,35,105,24,1005,11
1579,15,490,3588,387,8195,103
43162,22,300,511,251,3128,49
994,151,4799,3838,4217,47418,582
43042,0,0,645,0,1203,0
5226,25,536,3433,465,5493,71
43610,5,46,197,32,1059,14
42232,5,198,1172,138,3453,60
43351,0,0,363,0,1940,0
42536,4,101,908,79,3511,22
21948,48,606,2504,520,6418,86
15234,128,3158,2841,2492,27605,666
27322,40,752,2251,664,9073,88
42602,4,92,846,73,3176,19
43652,4,69,139,57,1270,12
18016,163,2691,2705,2193,17193,498
6349,10,226,3381,190,3648,36
33218,4,281,1949,215,4719,66
43246,56,737,458,615,7667,122
27221,5,292,2257,251,5378,41
8738,50,1118,3234,990,15334,128
42282,12,179,1123,137,3870,42
26905,10,164,2271,141,2913,23
43036,47,666,651,470,8222,196
1424,208,4709,3644,4214,30840,495
8715,23,647,3235,544,6761,103
12506,7,100,3031,85,2811,15
43446,2,119,301,94,1458,25
40947,457,9211,1476,6417,68940,2794
43729,11,221,139,179,2075,42
43603,80,928,201,776,6813,152
2363,41,1154,3519,953,15734,201
23825,33,529,2412,429,6823,100
27262,92,2318,2254,1776,20256,542
10860,9,724,3118,433,7220,291
3092,2,40,3506,34,2467,6
43385,143,2563,334,2113,17020,450
21070,2,254,2554,219,5298,35
43281,12,159,430,130,2187,29
8708,1,68,3235,57,2125,11
3870,114,1814,3490,1467,14409,347
1197,41,971,3769,886,14896,85
18926,5,134,2667,115,2928,19
28890,4,117,2160,95,2777,22
26014,5,156,2312,128,7258,28
43203,4,92,485,62,1471,30
20996,2,150,2558,130,2742,20
22933,193,3996,2453,3205,25762,791
6153,8,123,3390,105,3076,18
43769,4,47,116,28,881,19
7438,3,151,3327,123,3531,28
42441,4,94,989,65,3304,29
27212,6,196,2258,161,3125,35
42119,17,348,1297,319,11515,29
42731,17,1251,797,902,6005,349
33408,1,62,1942,47,1510,15
42149,159,2476,1259,1762,23661,714
16830,14,256,2765,220,3889,36
17949,5,73,2709,62,3210,11
1287,5,146,3743,132,9354,14
42283,27,308,1123,208,6467,100
25560,1,54,2334,50,2272,4
3505,33,1230,3498,1084,12913,146
19335,13,381,2649,320,6937,61
1208,4,148,3766,133,5918,15
1559,5,158,3592,143,4621,15
1478,3,77,3617,70,3185,7
1293,18,395,3739,359,8916,36
43136,22,213,533,160,4231,53
38369,288,9352,1659,7460,31652,1892
43753,14,209,130,142,1392,67
18159,25,397,2700,353,5110,44
5583,2,894,3416,595,5939,299
6129,5,378,3391,300,9638,78
9407,59,2785,3193,2092,20459,693
43614,2,55,196,20,727,35
42276,0,0,1126,0,4937,0
11066,23,675,3107,593,8017,82
37539,21,545,1716,456,4364,89
27090,5,97,2265,85,2711,12
9046,9,367,3217,184,2374,183
6051,20,421,3393,351,4372,70
6377,3,390,3380,175,2951,215
42627,3,40,832,26,2221,14
43664,4,43,167,27,1814,16
37708,50,732,1706,598,4728,134
8306,9,275,3262,225,12236,50
42096,63,897,1304,634,9816,263
28063,54,719,2207,637,6892,82
1723,21,331,3556,286,6100,45
33468,24,418,1939,373,4566,45
1673,25,554,3566,482,13301,72
30831,105,1569,2061,1193,9450,376
39741,27,685,1574,572,7715,113
30765,79,1259,2064,985,9158,274
27448,23,608,2243,499,4964,109
39329,328,6566,1596,5378,39396,1188
43232,83,780,468,583,4124,197
43783,1,9,108,6,662,3
3930,34,815,3489,715,8686,100
42560,80,1191,891,1006,13119,185
40523,0,229,1515,190,4745,39
9483,19,323,3188,255,4704,68
7118,4,301,3345,251,5185,50
10354,12,346,3146,279,5414,67
18967,4,62,2665,58,1836,4
3867,247,22106,3491,13401,58348,8705
42989,81,1278,698,885,7413,393
42182,12,315,1226,233,11601,82
17379,67,1111,2734,982,7134,129
1379,1,74,3677,59,6258,15
18389,32,861,2689,782,5644,79
43478,12,153,282,116,2000,37
43732,2,25,139,20,1022,5
42396,335,7381,1034,6154,33958,1227
15546,34,1147,2827,917,21851,230
43295,14,208,420,156,2818,52
1613,62,2063,3583,1804,11012,259
42601,13,194,846,149,3956,45
8666,13,1497,3238,648,3327,849
23654,4,88,2419,74,2837,14
33316,6,231,1946,179,6752,52
39406,25,431,1592,361,5379,70
41045,4,82,1467,69,2762,13
35094,130,2900,1869,2458,30719,442
42296,10,309,1113,173,5171,136
2998,13,379,3508,346,11395,33
27588,2043,47296,2234,31723,175374,15573
22587,97,2447,2471,2019,10598,428
6146,4,155,3390,114,2743,41
36869,14,230,1758,200,4360,30
41238,16,297,1441,220,4241,77
43428,13,202,314,156,3772,46
42005,28,426,1318,347,6431,79
43125,16,109,544,96,2646,13
6012,6,281,3394,235,2655,46
26039,30,480,2311,405,3916,75