Mod,likes,downloads,time,unique_dl,views,dl_dif
45928,9,119,276,95,4426,24
31869,0,0,2009,0,9929,0
46347,9,105,111,98,2158,7
11976,15,864,3061,636,7057,228
9585,63,2374,3182,1655,23369,719
14749,3,86,2869,73,3449,13
3802,30,905,3492,726,13340,179
39268,12,158,1599,117,2922,41
43145,0,37,1058,30,5193,7
1687,0,23,3565,21,1505,2
41218,6,373,1445,299,9800,74
34677,0,20,1892,16,4341,4
30620,4,594,2071,449,9665,145
23292,6,187,2437,160,2696,27
46083,4,120,208,91,872,29
34153,198,7814,1916,5772,69339,2042
33650,0,133,1933,115,3507,18
17884,19,1379,2713,1036,15632,343
22321,6,131,2485,91,5696,40
25836,14,1715,2321,1272,38429,443
18405,248,11587,2689,8552,68294,3035
9184,5,225,3207,186,2341,39
33433,2,45,1941,41,5264,4
7733,68,2867,3309,2235,32432,632
17600,93,2933,2724,2241,22899,692
9388,1248,83073,3194,56268,445971,26805
13587,44,2091,2954,1543,15504,548
39649,13,444,1578,353,8333,91
12374,30,1649,3039,1376,64443,273
44992,1,107,610,84,3156,23
15122,8,668,2847,464,13046,204
22803,2,90,2461,78,2060,12
42061,83,1521,1308,1118,17874,403
29198,87,2323,2145,1839,12901,484
37027,21,647,1749,528,12181,119
3304,25,619,3502,504,4898,115
30557,38,900,2074,706,7787,194
19543,3,224,2639,186,8888,38
15067,5,271,2850,192,5869,79
2996,162,4253,3508,3215,32436,1038
35173,0,81,1865,73,3002,8
6140,56,3174,3390,2401,114741,773
40697,0,0,1500,0,7826,0
30119,64,1994,2099,1627,14208,367
13962,125,4819,2923,3751,32284,1068
38512,41,1938,1649,1454,12679,484
1642,2,114,3575,99,2607,15
2836,8,802,3511,625,31294,177
40806,120,3176,1488,2279,37393,897
10054,450,25391,3160,18969,131858,6422
14563,39,1291,2882,955,14170,336
37698,3,55,1706,47,3355,8
33511,21,701,1937,536,7146,165
6438,0,19,3378,14,1333,5
29742,193,8351,2118,6331,99633,2020
45987,14,101,251,88,1963,13
16321,44,2221,2791,1591,25610,630
23661,118,8729,2418,5967,43495,2762
23597,46,3227,2422,2547,26038,680
42039,26,1012,1312,809,15507,203
21692,10,319,2517,248,5105,71
9383,9,214,3194,186,4153,28
36026,71,893,1806,713,6892,180
36138,80,3863,1798,2875,28913,988
37083,34,576,1745,505,5383,71
23854,66,937,2410,700,10917,237
43259,7,186,1025,126,1968,60
37079,4,95,1745,81,4778,14
30990,59,5247,2055,3767,45728,1480
28964,74,5997,2157,4423,48781,1574
38538,6,372,1647,231,6021,141
6292,18,940,3384,778,20946,162
29565,38,750,2126,615,6687,135
34242,104,1517,1913,1092,33709,425
27533,12,476,2237,360,6903,116
37710,58,1424,1706,1152,18003,272
9022,8,241,3218,175,4632,66
15721,21,982,2818,792,4846,190
42981,149,3628,1107,2743,54197,885
7950,13,138,3289,113,7616,25
17532,577,42222,2727,28791,296980,13431
13813,21,975,2938,560,12143,415
4607,21,404,3464,298,3792,106
5499,9,401,3420,319,6892,82
7276,8,138,3337,106,5344,32
13933,3,297,2926,229,10761,68
41818,25,847,1347,635,14742,212
20868,18,712,2567,559,8457,153
33723,1,207,1930,166,3425,41
9024,6,194,3218,152,3502,42
38321,41,1416,1662,1110,22072,306
30415,14,519,2082,420,7595,99
36119,39,554,1799,443,5953,111
2022,13,379,3524,285,6196,94
40708,2,37,1499,27,3261,10
45112,40,629,559,492,4130,137
23395,12,641,2432,470,11931,171
38124,9,236,1676,201,6172,35
4072,510,15340,3484,11642,147682,3698
37754,5,210,1702,169,4911,41
29643,2,162,2122,139,7572,23
5381,53,3273,3426,2645,22052,628
12168,12,950,3051,713,8557,237
38169,8,164,1673,127,10150,37
15102,55,2385,2848,1750,28532,635
3684,3,186,3495,143,4445,43
36830,7,138,1760,112,4422,26
46370,6,51,101,37,1717,14
16516,12,573,2782,449,6089,124
41533,122,3079,1398,2368,33999,711
27686,1,185,2229,152,11167,33
42169,8,98,1285,76,3198,22
4517,19,732,3468,588,25362,144
38864,34,879,1626,626,10747,253
1891,10,398,3528,313,11566,85
24183,0,712,2395,576,12251,136
15727,3,307,2818,260,10127,47
37943,16,466,1688,376,5480,90
32081,24,568,1997,389,8716,179
34438,3,144,1905,99,4035,45
14223,11,542,2907,418,8502,124
11255,36,1203,3097,799,22949,404
14679,0,63,2874,51,2836,12
18700,70,2552,2676,1871,17242,681
41315,150,3325,1428,2372,46127,953
2829,142,9635,3511,6680,103815,2955
44069,342,3497,811,2716,18458,781
25934,12,957,2316,761,5179,196
45781,9,67,331,61,2067,6
26382,0,347,2295,277,4501,70
14966,14,620,2856,493,11704,127
11884,1,95,3066,75,4451,20
40673,27,648,1502,458,9476,190
46368,0,46,102,35,1402,11
21590,46,2422,2524,1707,29602,715
45616,27,456,407,372,5768,84
14292,6,110,2902,84,2714,26
43188,14,299,1048,234,9339,65
46308,1,47,125,36,1078,11
11263,4,37,3096,27,2010,10
18140,0,45,2700,33,5187,12
42584,0,0,1203,0,2931,0
23566,102,3539,2423,2741,25184,798
22414,233,5482,2480,4375,31754,1107
10956,84,1906,3113,1458,12709,448
43070,38,1404,1081,958,23895,446
45698,52,422,368,363,5854,59
23423,1,83,2430,65,4535,18
30961,1,102,2056,89,2810,13
1980,258,9494,3525,7503,65825,1991
27293,4,217,2253,176,5867,41
46349,4,40,111,38,1040,2
39146,44,1013,1608,751,16354,262
20636,117,4323,2581,3262,19060,1061
9762,52,2513,3174,2061,25354,452
23781,12,389,2414,323,10259,66
3886,107,3979,3490,2969,55109,1010
17918,4,411,2712,305,3413,106
16082,0,76,2802,59,5168,17
42912,31,658,1126,480,7168,178
34211,9,332,1914,271,5824,61
9257,27,106818,3204,36563,23385,70255
5787,18,603,3406,425,6012,178
34751,18,592,1888,503,7921,89
45897,30,421,293,343,5491,78
5532,9,166,3419,122,6096,44
27021,59,2855,2268,1993,25263,862
6828,9,315,3360,243,11372,72
8876,51,1826,3226,1304,15812,522
35182,223,8373,1864,6573,66323,1800
2253,27,1729,3521,1381,32895,348
13333,29,754,2974,586,9108,168
44064,17,187,811,143,3456,44
4381,10,401,3473,343,16142,58
31892,236,7726,2008,5460,82605,2266
12124,1,205,3054,163,4269,42
26412,0,46,2294,34,1419,12
18592,117,5895,2681,3951,63816,1944
25079,114,3521,2354,2642,26870,879
7379,82,2844,3330,2184,31572,660
40048,228,4050,1552,2747,37886,1303
43473,129,2801,963,2396,35906,405
13505,25,1117,2960,870,13607,247
23086,11,367,2447,298,9443,69
15987,11,193,2808,165,2236,28
46285,0,13,138,8,805,5
16075,75,4538,2803,3020,33367,1518
23996,29,1419,2403,1101,24443,318
13919,2,109,2927,79,3904,30
18331,2,120,2692,97,2930,23
8843,43,1430,3227,1016,16188,414
29342,7,193,2136,154,2916,39
41008,39,1427,1472,1018,24256,409
34378,0,0,1907,0,8347,0
27393,7,229,2246,183,3836,46
15201,8,258,2843,187,4561,71
11963,34,991,3062,853,10177,138
35568,0,24,1841,19,4661,5
17781,1354,105863,2718,65470,416223,40393
30684,1,93,2067,77,2749,16
16857,71,3147,2763,2294,21064,853
43147,9,243,1058,170,7870,73
37895,15,270,1691,212,3992,58
31930,15,417,2006,308,6617,109
30680,13,908,2067,696,12922,212
23807,51,1144,2413,862,10073,282
7238,16,197,3339,175,9619,22
38561,57,1828,1645,1391,8850,437
22794,2300,118800,2462,81971,621578,36829
10200,46,1693,3153,1194,21161,499
12298,6,343,3044,278,11754,65
10080,496,23434,3158,16937,114336,6497
26393,2,232,2295,189,2388,43
18145,8,244,2700,196,11524,48
29910,3,162,2108,106,3208,56
9978,4,132,3164,98,2957,34
5912,7,85,3399,57,6182,28
39977,4,143,1557,115,6392,28
7861,7,275,3298,218,7326,57
44688,70,691,705,596,8256,95
18246,39,554,2695,435,6617,119
8176,26,891,3270,691,13595,200
2689,22,603,3513,509,13592,94
15451,1,235,2832,204,3818,31
45302,2,25,498,19,1586,6
15607,75,5038,2823,3944,145730,1094
5439,17,333,3423,225,3533,108
41241,90,2779,1441,2264,40093,515
42290,8,213,1261,164,4454,49
45903,2,29,291,25,2733,4
46105,12,145,201,122,1279,23
30411,23,737,2082,608,8784,129
2600,23,4323,3515,3249,24071,1074
32672,38,2051,1971,1384,13263,667
6040,9,506,3393,396,3760,110
37224,0,94,1736,75,5646,19
10794,8,149,3121,130,8695,19
17089,62,1751,2750,1408,21522,343
33797,60,2279,1927,1707,29411,572
24813,29,1734,2366,1345,27810,389
22187,72,3995,2491,2706,24004,1289
18089,15,444,2702,354,4933,90
5040,7,219,3445,165,9986,54
46166,9,87,171,65,923,22
29161,73,2849,2147,2193,17574,656
13162,80,3596,2985,2568,34051,1028
43350,10,377,999,283,7952,94
10144,269,13402,3156,10071,75761,3331
31415,10,857,2033,638,15901,219
29206,11,532,2144,453,4187,79
5977,2918,159305,3395,121518,504407,37787
10334,103,1972,3147,1510,33131,462
29883,4,207,2110,174,4613,33
26622,6,137,2285,125,2930,12
36558,9,176,1777,134,2264,42
25542,1,40,2334,33,3122,7
38741,65,2327,1633,1565,25739,762
6628,14,403,3370,292,17882,111
2812,41,1199,3511,985,16633,214
30546,195,4655,2075,3187,16474,1468
2287,49,1539,3520,1225,21216,314
15382,3,120,2835,97,2524,23
25826,42,1551,2321,1212,9714,339
32953,11,654,1960,496,10141,158
4521,2,82,3468,71,3590,11
27216,9,263,2258,218,4845,45
1049,4,199,3815,166,5536,33
3328,5,125,3502,105,4197,20
45954,65,619,262,482,5947,137
31300,7,289,2039,224,6898,65
5826,9,187,3403,154,2564,33
34174,1,60,1915,48,2360,12
27531,24,1194,2237,991,22886,203
41411,50,1313,1415,1026,11206,287
33891,19,330,1924,287,5115,43
16112,6,452,2801,349,5708,103
46031,0,9,231,6,864,3
4064,6,175,3484,134,5316,41
4287,3,84,3476,68,2539,16
33477,2,54,1939,41,4065,13
45408,94,2072,468,1716,12693,356
31972,6,202,2004,152,5347,50
2149,41,1272,3522,1039,15406,233
11506,7,265,3084,213,9420,52
41765,90,1747,1359,1373,27153,374
30705,12,470,2066,362,10388,108
9796,7,506,3172,395,15275,111
11357,49,126412,3092,40194,19510,86218
16415,36,1372,2786,1031,10988,341
8754,6,393,3233,327,7173,66
19721,3,150,2629,124,5456,26
20382,392,19565,2594,14465,110001,5100
26437,4,170,2293,123,7410,47
20684,45,1678,2578,1242,18299,436
8313,21,668,3261,497,14328,171
39886,96,2039,1564,1515,13343,524
18106,6,289,2702,232,9003,57
24277,50,984,2390,730,10363,254
19051,0,41,2662,33,6902,8
42470,3,81,1225,64,3916,17
39669,11,620,1577,453,9583,167
28147,21,1185,2203,898,14112,287
22368,13324,980647,2482,672276,2131306,308371
6589,5,282,3371,232,7845,50
4097,7,145,3483,111,4606,34
19033,44,4147,2663,2981,39824,1166
21962,4,135,2502,94,10400,41
1682,0,36,3565,34,1634,2
7704,39,1156,3311,884,17769,272
20056,33,715,2611,551,6691,164
24884,17,311,2363,241,4140,70
11797,0,45,3069,37,2120,8
42858,20,550,1141,393,11665,157
27067,1,159,2266,125,2240,34
23939,16,600,2405,508,7084,92
42206,16,266,1278,211,10425,55
36501,28,866,1780,742,17346,124
14309,1,75,2900,62,2596,13
9877,56,937,3169,734,7195,203
33602,18,558,1934,451,9475,107
6096,4,142,3391,112,4270,30
9315,78,2364,3200,1828,22075,536
32325,2,189,1986,165,5484,24
7552,17,343,3321,269,5567,74
28767,65,2334,2166,1828,10597,506
43119,7,169,1065,119,7783,50
28443,50,1790,2186,1321,11219,469
9519,36,772,3186,618,20105,154
9065,14,575,3215,471,6814,104
27009,153,14235,2269,9701,35775,4534
34215,6,164,1914,139,4403,25
23295,75,3203,2437,2170,26398,1033
30326,8,174,2087,132,2367,42
21762,11,914,2514,703,10407,211
26029,28,1326,2311,1059,7576,267
24174,53,2537,2395,1825,47304,712
13692,207,14721,2947,11330,65875,3391
5261,5,107,3432,75,4317,32
8907,5,94,3224,74,1866,20
29492,5,112,2129,91,5435,21
30331,17,368,2087,291,9020,77
2243,67,4867,3521,3601,64353,1266
25061,6,171,2355,144,2567,27
1512,7,169,3611,128,5061,41
32870,18,1271,1962,1013,14721,258
15056,56,2021,2850,1461,12688,560
14192,326,9482,2910,7262,62735,2220
5538,2,174,3418,145,10614,29
7869,21,408,3298,336,25574,72
12567,7,453,3029,375,11192,78
6373,10,223,3380,169,3324,54
5614,27,2541,3415,1688,40659,853
12116,17,271,3054,218,5777,53
21736,19,1011,2516,798,20453,213
8945,30,992,3222,736,27675,256
23894,0,9,2409,7,2282,2
30439,36,1432,2081,1057,16026,375
31435,5,247,2032,200,12216,47
42215,7,374,1276,243,5673,131
11208,678,36421,3099,26171,155018,10250
5748,6,364,3407,284,15575,80
14343,120,3498,2897,2630,19166,868
6910,10,245,3357,188,4598,57
29090,1585,165263,2150,116512,445939,48751
27946,1,33,2213,29,3309,4
5976,45,1993,3396,1324,6757,669
20849,67,1221,2568,944,10200,277
25604,285,9370,2331,6793,46956,2577
8643,13,419,3240,311,5797,108
8326,5,134,3260,107,5198,27
35185,8,633,1864,496,8088,137
19522,32,1135,2639,974,14603,161
11362,309,17233,3092,12005,52698,5228
5706,147,7016,3409,5337,47835,1679
2867,30,2804,3510,1884,16898,920
22555,809,61745,2472,43807,258490,17938
6635,35,1659,3369,1176,37842,483
9325,18,530,3198,432,7542,98
36484,31,1172,1781,918,16702,254
13167,13,1530,2985,1211,22725,319
1812,22,787,3530,617,17116,170
4772,10,511,3458,393,11272,118
20171,2,128,2604,114,5589,14
30410,0,39,2082,22,4815,17
38398,2,97,1657,67,4115,30
24667,35,536,2372,409,4938,127
27975,6,160,2212,138,2818,22
36160,34,1105,1797,851,13573,254
45559,1,18,423,7,1701,11
8011,4329,181515,3284,125829,503830,55686
10958,31,3066,3113,2265,29637,801
11029,10,124,3109,103,10236,21
31408,41,1045,2034,793,13710,252
19950,6,137,2617,112,4552,25
31855,832,26632,2009,19069,118651,7563
36891,2,89,1757,70,2052,19
37445,59,2164,1723,1461,23140,703
45419,249,5887,466,4520,21154,1367
28252,3,134,2196,113,4367,21
32932,23,429,1960,350,4857,79
36553,21,492,1778,397,8223,95
6467,57,1133,3376,879,13696,254
1800,32,1652,3531,1244,29449,408
28509,8,295,2181,237,4587,58
37120,578,21663,1743,15948,109483,5715
31260,27,591,2041,469,6364,122
19234,10,532,2654,424,6212,108
12996,69,3439,3003,2713,19792,726
42068,69,2217,1307,1615,21631,602
6665,1208,59980,3368,40181,195411,19799
28602,42,1170,2175,922,25410,248
28639,7,337,2173,251,10041,86
19948,49,1233,2617,995,11127,238
11109,19,482,3105,373,10923,109
2049,111,1866,3524,1181,19024,685
9944,6,124,3166,108,3119,16
20240,89,1745,2599,1354,8916,391
4660,61,1456,3462,1108,19660,348
34931,219,5739,1877,4646,27964,1093
14634,36,1601,2877,1243,16682,358
4141,29,700,3482,539,23193,161
7019,37,1728,3350,1374,5518,354
13756,33,1466,2941,1150,30710,316
18722,118,7615,2675,5873,79518,1742
42250,5,94,1269,70,3610,24
31769,10,363,2014,291,6912,72
37358,0,0,1728,0,10074,0
41291,62,2686,1431,2113,26324,573
3251,27,1129,3503,889,6233,240
8539,3,165,3246,126,4166,39
10084,11,413,3158,325,5985,88
26089,16,508,2309,401,5411,107
3389,41,1114,3501,900,11644,214
39528,0,98,1585,82,11855,16
3461,58,995,3499,773,9908,222
25944,2,158,2315,126,4284,32
8131,1,142,3273,117,2909,25
6622,24,417,3370,369,7525,48
29901,155,6385,2109,4690,60111,1695
26708,16,861,2281,699,12191,162
29140,10,301,2148,247,6320,54
15956,185,6841,2809,5006,23151,1835
32298,74,3923,1987,2925,26504,998
39753,8,224,1573,171,4087,53
39544,7,210,1585,176,4937,34
6311,38,965,3383,744,9006,221
38420,6,480,1655,384,9226,96
2710,138,5221,3513,3883,54619,1338
2081,61,1584,3523,1165,15694,419
22022,6,210,2499,168,4521,42
37410,8,214,1725,175,5822,39
14287,17,649,2902,427,12547,222
36563,676,31272,1777,23254,145102,8018
25534,13,727,2335,632,11396,95
12929,11,528,3008,403,7125,125
24523,11,731,2379,597,6493,134
40462,551,12301,1520,9125,65438,3176
45836,3,79,314,65,2598,14
25364,77,5352,2342,4000,34067,1352
1953,12,350,3526,261,9516,89
4017,6,66,3486,47,3853,19
45401,72,697,470,499,7555,198
30873,21,416,2059,300,4539,116
41316,156,3539,1428,2415,23715,1124
38783,12,126,1630,105,3976,21
41436,9,267,1410,204,8354,63
34838,50,1161,1882,916,15841,245
5664,8,465,3411,341,8307,124
27571,53,5114,2235,3777,25144,1337
31432,10,180,2032,151,9558,29
38671,3,129,1638,102,5809,27
29649,155,4508,2121,3719,23255,789
32625,3,132,1973,102,2902,30
40911,0,53,1479,38,3898,15
11107,666,24983,3105,18238,118131,6745
9821,5,183,3171,146,3644,37
6026,0,90,3394,79,6777,11
33882,2,161,1924,135,10218,26
19275,15,259,2651,204,4024,55
35443,4,222,1850,181,8794,41
7980,3,21,3286,16,1883,5
11086,135,5465,3106,3751,31782,1714
43645,30,391,900,327,7091,64
16484,12,748,2783,571,6288,177
32022,15,377,2001,302,11745,75
5167,1,92,3437,82,5293,10
25227,3,130,2348,77,10448,53
40937,11,912,1477,666,19170,246
11813,2,58,3069,52,2616,6
39804,3086,123054,1570,87055,291382,35999
18857,9,380,2669,258,4307,122
28003,4,102,2210,86,1458,16
32074,1,110,1998,68,2709,42
20316,4,150,2597,123,4601,27
15050,8,339,2851,288,4297,51
21501,16,1528,2529,1151,16720,377
38387,6,137,1658,112,5265,25
37904,536,13867,1691,10245,88949,3622
32095,0,119,1997,78,4555,41
45129,274,2839,549,2348,15012,491
46204,2,12,160,11,1303,1
34543,167,4773,1899,3606,31452,1167
37696,5,380,1707,305,14628,75
12395,51,3479,3038,2661,24024,818
29017,15,414,2154,309,8051,105
35452,5,306,1850,268,5735,38
7548,12,286,3321,226,13190,60
13288,11,550,2978,419,7411,131
11560,3,124,3081,105,2597,19
7015,5,165,3350,146,3307,19
21837,5,325,2511,265,2624,60
22901,30,2880,2455,2207,18592,673
30115,22,316,2099,250,3115,66
7712,16,705,3311,580,9559,125
26870,11,560,2273,438,6670,122
10328,445,20446,3147,15635,263953,4811
3798,8,316,3493,240,5251,76
12655,5,151,3024,117,2789,34
42374,39,646,1246,514,9845,132
23242,57,2338,2439,1893,9985,445
32499,50,2380,1979,1941,20063,439
30505,6,254,2076,208,7588,46
18489,12,634,2685,530,15577,104
15231,3,106,2841,85,2053,21
12565,29,1476,3029,1078,14279,398
4246,3,96,3478,76,11592,20
19260,3,199,2652,177,8042,22
24236,57,2191,2393,1727,20622,464
39942,11,77,1559,57,4140,20
1814,17,786,3530,620,11278,166
25298,0,86,2345,65,7240,21
43426,2,93,974,61,4796,32
40757,779,53097,1493,39201,152823,13896
16323,898,74923,2791,49046,246247,25877
2536,13887,705205,3516,405169,2268666,300036
8543,155,8593,3246,6639,168520,1954
34103,29,780,1917,642,9354,138
23997,84,2549,2403,1836,11860,713
4670,13,990,3462,761,9478,229
2168,146,4502,3522,3646,54134,856
11876,7,315,3066,257,3712,58
31868,0,20,2009,16,1807,4
30654,0,32,2069,25,3095,7
13878,68,3713,2932,2616,28324,1097
31390,223,11497,2034,7368,55348,4129
11924,26,2607,3063,1865,25335,742
6363,5,114,3381,102,2737,12
1863,32,2108,3528,1647,35722,461
6851,15,673,3359,534,9501,139
43390,323,6629,984,5036,47008,1593
35065,87,1745,1870,1435,21507,310
2355,8,160,3519,130,5331,30
2345,6,478,3519,320,8517,158
2974,47,1336,3508,1075,13396,261
22537,10,956,2473,725,21574,231
27645,6,453,2231,359,8554,94
29498,1,186,2129,164,3819,22
7209,50,2360,3340,1811,21484,549
41646,128,2566,1380,1996,20139,570
36173,26,568,1796,430,7570,138
25553,3,84,2334,65,3878,19
39102,8,264,1611,204,10920,60
9537,6,362,3185,286,7655,76
24721,25,1871,2369,1509,25478,362
20340,23,466,2596,395,3727,71
36763,43,593,1765,449,7525,144
3021,33,865,3507,664,13835,201
35583,10,695,1839,430,7981,265
12499,1,15,3032,12,1719,3
19882,7,454,2620,388,3515,66
37317,10,269,1730,235,6364,34
31837,5,428,2010,352,3459,76
36201,11,366,1795,273,5901,93
37093,0,72,1744,56,2564,16
30375,4,257,2084,191,6692,66
33410,23,874,1942,617,11324,257
32798,2,54,1966,46,3232,8
11422,31,1636,3089,1263,12934,373
14212,16,316,2908,259,5442,57
23202,153,11466,2441,7837,29057,3629
37219,13,535,1736,448,12710,87
5720,79,2716,3408,2158,20199,558
26095,20,1235,2309,1009,13751,226
15063,221,11917,2850,8823,57822,3094
15046,25,704,2851,526,7870,178
17751,3,377,2718,287,5156,90
5254,35,1122,3432,837,9520,285
5268,5,205,3431,165,19313,40
25280,0,3170,2346,2372,29066,798
10730,25,797,3125,622,3877,175
39183,18,209,1606,174,4052,35
19841,20,1155,2622,876,14472,279
3409,5604,213274,3500,145715,638212,67559
26544,2,89,2288,76,1724,13
19271,5,287,2652,213,6764,74
33903,3,135,1923,113,4505,22
36427,8,425,1784,324,5845,101
7356,4,103,3331,89,4838,14
42961,18,412,1113,323,6145,89
24774,5,531,2368,423,10537,108
9539,1,63,3185,52,3049,11
41913,45,1305,1333,1020,22320,285
37212,7,194,1737,149,4225,45
3018,2,106,3507,66,3899,40
3071,27,494,3506,413,10846,81
3458,36,1117,3499,784,19544,333
44805,28,317,665,225,3722,92
38663,3,76,1638,71,4892,5
2755,119,4182,3512,3290,35310,892
3429,368,24440,3500,18776,90690,5664
34702,42,1071,1890,771,7422,300
15884,5,338,2813,277,5065,61
22805,12,352,2461,271,3468,81
15552,5,514,2827,352,14674,162
25278,4,682,2346,546,5435,136
30470,4,218,2079,169,4955,49
3030,14,336,3507,265,3476,71
33721,1,65,1930,48,4321,17
35671,285,7164,1832,5345,54981,1819
39082,0,83,1612,69,2696,14
9954,61,2059,3165,1566,26756,493
20900,24,859,2563,598,4076,261
28844,16,259,2162,211,3722,48
43272,6,175,1022,105,3072,70
25853,5,460,2320,346,7516,114
25956,3,350,2315,300,9495,50
23991,4,120,2403,96,3139,24
20540,11,358,2586,263,2034,95
4152,85,5321,3481,3653,78339,1668
45267,4,70,507,39,1823,31
15450,9,375,2832,312,5967,63
44162,323,10360,793,8456,45467,1904
40132,67,655,1548,463,5001,192
41559,63,1470,1395,1061,23020,409
13024,6,119,3002,92,4325,27
13560,1,49,2956,40,3208,9
24837,20,371,2365,310,5633,61
44875,4,116,645,102,5291,14
25400,28,1895,2341,1520,19288,375
36319,84,6800,1789,3908,35806,2892
37546,58,1898,1715,1546,19748,352
33845,30,691,1925,589,14499,102
19088,221,13446,2660,10239,107243,3207
12043,0,140,3058,115,3810,25
8856,76,4701,3227,3779,38853,922
4604,4,283,3464,201,10067,82
6360,31,1018,3381,745,23755,273
16720,20,739,2772,546,7962,193
8378,32,1676,3256,1310,21526,366
17718,68,3758,2720,2874,16601,884
1293,8,256,3739,208,6726,48
3894,5,128,3490,99,9184,29
10190,10,174,3154,130,8408,44
6089,8,241,3392,174,5938,67
28992,352,13779,2155,8260,75047,5519
44712,7,95,694,86,2702,9
15743,16,678,2817,560,8476,118
7740,9,276,3309,192,4331,84
32657,45,1612,1972,1175,23604,437
43150,35,825,1057,664,26907,161
4802,237,7768,3457,6077,31321,1691
34320,260,11542,1910,8089,71903,3453
41193,38,1095,1449,903,19120,192
14545,34,537,2883,412,10564,125
36651,4,187,1771,146,7179,41
20855,2,150,2568,104,7195,46
23059,19,432,2448,334,4325,98
15825,2,183,2814,157,3322,26
36085,36,918,1801,724,10266,194
37537,5,168,1716,139,4141,29
18586,29,770,2681,555,9517,215
4588,2,64,3465,60,2007,4
5524,72,3211,3419,2580,32300,631
10052,22,386,3160,306,8456,80
6547,3,75,3373,63,5290,12
16046,32,1004,2804,779,14097,225
39385,70,1703,1593,1341,13692,362
27498,10,258,2240,192,8582,66
12689,18,894,3022,651,24678,243
45458,0,15,457,13,1613,2
8941,7,202,3222,144,7173,58
33465,10,584,1939,481,8182,103
41605,19,809,1386,600,22797,209
24416,7,291,2384,197,3222,94
41341,0,46,1425,31,3315,15
3808,27,942,3492,782,25745,160
23069,1339,35712,2448,26825,106878,8887
41354,12,285,1423,226,15245,59
7807,17,299,3304,241,12343,58
27851,9,425,2219,337,8088,88
11367,2422,90987,3092,63727,213742,27260
40096,300,9090,1550,6505,47862,2585
32284,0,96,1988,84,4603,12
36053,7,210,1804,187,7834,23
8936,10,295,3223,202,2312,93
44392,114,2066,759,1463,11155,603
44013,33,524,820,388,5690,136
13022,8,394,3002,312,8523,82
30058,73,6655,2102,5282,31328,1373
42652,5,210,1189,129,6578,81
36453,8,257,1783,205,6652,52
13320,16,582,2975,443,8434,139
39540,6,72,1585,59,3637,13
46128,1,35,192,30,985,5
20853,1,169,2568,144,4863,25
38583,14,331,1644,245,3007,86
7547,68,4547,3321,3558,40361,989
36008,8,1455,1807,1181,7280,274
18392,5,479,2689,400,6565,79
20238,6,237,2600,195,11362,42
43123,11,162,1064,120,7428,42
16998,38,2819,2757,2043,49164,776
45310,72,1045,494,778,8081,267
26056,4,128,2310,104,2916,24
4492,225,11352,3469,7909,83013,3443
9705,1,7,3177,5,1551,2
23131,6,211,2445,154,2154,57
38766,8,851,1632,524,10930,327
24197,241,16743,2394,11074,135600,5669
3844,147,3009,3491,2260,21417,749
35875,18,443,1817,351,5174,92
43705,8,112,880,96,2569,16
27025,19,378,2268,305,7012,73
5057,22,206979,3444,73158,18399,133821
37843,27,749,1695,579,9237,170
44889,53,492,641,368,6509,124
31925,2,141,2007,104,4940,37
36384,69,2339,1786,1793,12300,546
8560,52,2568,3245,2081,23257,487
7256,31,793,3338,540,14201,253
43723,102,1428,874,1075,11535,353
4551,37,1086,3467,824,11291,262
8427,1,64,3254,53,1929,11
29293,0,41,2140,29,3757,12
11652,112,7129,3076,4953,69135,2176
27692,3,613,2229,499,11372,114
14377,87,7867,2895,5833,56302,2034
44830,98,960,657,858,18211,102
11038,16,490,3109,346,4277,144
31348,39,1450,2037,1137,11847,313
32310,6,325,1987,287,6112,38
9573,3,145,3183,123,4719,22
2560,64,2482,3515,1820,16861,662
19714,47,1412,2630,1092,15691,320
38554,16,417,1645,337,5765,80
12707,5,286,3021,235,4889,51
8019,0,56,3284,51,4840,5
12839,50,5184,3013,4062,62826,1122
5622,52,3546,3414,2713,69477,833
3176,36,1546,3505,1052,17031,494
1635,1,220,3578,183,5029,37
26465,19,2053,2292,1656,23363,397
42144,37,1061,1292,848,25904,213
1234,10,677,3762,551,12449,126
28938,564,22554,2158,16032,149527,6522
44587,26,310,727,229,6511,81
23314,68,1706,2436,1216,14008,490
35409,46,529,1853,381,6733,148
29541,5,164,2127,126,3840,38
38787,26,526,1630,448,8839,78
2039,38,833,3524,646,10134,187
34618,1,86,1896,74,4463,12
12545,2,196,3031,158,9385,38
24373,1,114,2386,92,3378,22
3843,0,43,3491,29,1905,14
36996,35,684,1750,510,10398,174
42208,201,3812,1278,2617,58812,1195
28429,8,2439,2186,1746,13428,693
6905,17,927,3357,718,7514,209
39554,6,192,1584,152,3207,40
44955,20,322,622,168,10006,154
19273,12,671,2652,487,12069,184
23716,68,3862,2416,2919,30744,943
3036,29,1098,3507,914,9088,184
42775,39,1191,1160,811,31781,380
29737,26,549,2118,450,5645,99
23747,34,1294,2415,1023,16161,271
40472,11,947,1519,722,12214,225
4639,61,1956,3463,1613,25118,343
22966,1,133,2452,109,4834,24
43356,113,1774,997,1379,10742,395
25570,51,2677,2333,1866,10649,811
23189,41,1027,2442,794,14199,233
25735,31,6263,2324,4519,28566,1744
14911,82,2988,2859,2318,20234,670
43320,35,470,1008,338,10283,132
43219,110,2497,1038,1743,24289,754
6185,31,1096,3389,859,29113,237
9059,14,502,3216,347,9167,155
13053,56,943,3000,693,21236,250
12802,3,179,3016,141,4026,38
9789,56,2126,3173,1612,45543,514
35005,27,919,1874,742,18502,177
36024,79,1238,1807,987,8385,251
35284,2,112,1858,87,4055,25
6786,6,311,3363,241,9563,70
42419,3,146,1235,105,7379,41
34292,14,131,1911,109,4059,22
24272,0,259,2391,213,26170,46
32610,6,165,1973,138,4972,27
6488,168,9187,3376,6941,48598,2246
42395,32,666,1242,449,12450,217
5862,82,2502,3401,1894,17538,608
29227,10,421,2143,348,4944,73
9321,555,24202,3199,17991,137793,6211
11494,4,233,3084,193,13055,40
6794,14,584,3362,451,22348,133
12759,10,495,3018,378,5808,117
45613,3,35,410,26,2844,9
35397,220,5709,1853,4296,54915,1413
30918,51,1044,2058,847,13988,197
41213,289,10063,1447,5764,64716,4299
2738,14,353,3513,250,6208,103
26403,4,75,2294,69,2746,6
2280,249,11615,3520,8905,70214,2710
42430,68,714,1233,526,5840,188
4879,0,74,3453,38,2193,36
4151,248,7134,3481,5565,88035,1569
38033,61,514,1683,407,4755,107
8552,11,431,3245,282,3957,149
39099,15,494,1611,364,5682,130
44863,2,43,643,34,1625,9
6831,8,380,3360,307,10361,73
6122,10,411,3391,334,11441,77
33470,30,875,1939,692,15161,183
34268,2,98,1912,81,6542,17
27042,13,315,2267,253,5739,62
27538,2,162,2237,139,5376,23
1530,3,144,3601,109,3624,35
31200,2,32,2044,30,1808,2
19705,6,256,2631,218,10382,38
3439,20,668,3500,505,16135,163
42655,132,2786,1188,1952,38831,834
41168,3,205,1452,162,4283,43
37667,5,104,1709,91,6785,13
22690,11,1439,2466,1141,18425,298
43540,71,1575,940,1240,30358,335
18942,50,1988,2666,1587,8142,401
2341,8,378,3519,280,9410,98
17806,5,248,2717,170,3451,78
4367,5,167,3473,137,6419,30
27503,1,77,2239,65,1354,12
5286,763,20277,3430,15291,52492,4986
29273,29,1955,2141,1661,12042,294
41111,30,541,1458,415,10452,126
23979,0,311694,2404,191157,597004,120537
41375,3,83,1420,59,3216,24
7696,52,1590,3311,1216,25092,374
37003,47,1603,1750,1251,13470,352
29156,3,107,2147,90,6361,17
42104,0,53,1300,44,3015,9
14727,5,195,2871,159,6988,36
27884,4,135,2218,119,7866,16
31792,5,245,2012,193,3720,52
7334,1,64,3333,44,2541,20
40490,19,426,1517,354,12444,72
33041,0,130,1956,112,5125,18
35538,1,110,1843,93,7205,17
26866,0,1607,2273,1057,15426,550
8734,2,105,3234,73,3113,32
15359,7,723,2835,517,25947,206
35779,104,5459,1824,4598,39342,861
39682,3,98,1576,79,2818,19
27430,6,216,2245,166,5777,50
17720,13,1079,2720,835,9840,244
13456,3,96,2963,80,6696,16
9612,45,1934,3180,1488,26106,446
10833,37,2280,3119,1725,13180,555
18583,26,921,2682,703,16557,218
46294,0,13,134,11,581,2
5513,6,526,3420,313,7838,213
27542,112,10418,2237,7746,66089,2672
39546,0,42,1584,34,3080,8
35815,0,61,1821,48,3474,13
26581,3,150,2287,125,3268,25
14169,5,82,2912,71,4609,11
41716,39,1380,1369,936,6875,444
35439,63,1387,1850,1081,17863,306
23121,85,2414,2445,1773,28153,641
15699,2,151,2820,111,4045,40
13922,69,3060,2927,1961,104420,1099
7894,1,120,3295,98,4070,22
11147,18,693,3102,570,7536,123
22051,7,259,2498,205,5404,54
18794,6,225,2672,194,5465,31
42677,82,2625,1182,1902,24903,723
23596,0,48,2422,42,4384,6
34785,7,162,1886,130,2091,32
25644,77,4205,2329,3115,45860,1090
5129,337,10865,3439,8043,183168,2822
31913,39,904,2007,689,8062,215
21525,25,816,2527,689,11583,127
20951,14,450,2561,344,10501,106
4448,129,3485,3470,2714,46354,771
16980,14,447,2757,335,5441,112
5453,1,68,3422,52,3090,16
44922,13,128,631,103,3348,25
44581,13,212,727,141,3305,71
19911,97,9826,2619,6774,30551,3052
15095,24,1066,2849,715,13477,351
22376,14,1742,2482,1361,14571,381
36815,5,207,1761,154,4809,53
10941,5,190,3114,123,9517,67
18878,6,681,2668,582,6917,99
42539,1,41,1210,29,4788,12
39418,93,1247,1591,954,11458,293
29547,0,0,2127,0,1394,0
23688,11,505,2417,407,11355,98
11891,3232,238833,3065,160136,389820,78697
23934,86,2736,2406,1985,49240,751
5927,3,38,3398,32,2591,6
19013,17,2860,2663,1941,33452,919
3504,371,12526,3498,9625,53927,2901
18432,3,324,2687,240,6627,84
13473,6,567,2962,413,7479,154
25508,0,1291,2336,1019,14313,272
44259,11,226,778,163,4266,63
11436,661,34002,3088,27251,75105,6751
2987,95,7232,3508,5389,27353,1843
27746,213,9329,2226,7193,62391,2136
12295,57,1649,3045,1244,20719,405
5604,15,883,3415,656,14392,227
38471,1835,129225,1652,82848,458832,46377
27941,0,105,2213,87,5757,18
16254,24,1334,2795,1082,19050,252
25629,90,1976,2329,1594,8581,382
40318,5,269,1535,203,10511,66
14116,115,2617,2913,1822,12799,795
27236,31,1784,2256,1514,16975,270
21054,8,586,2555,451,16975,135
45504,27,342,446,267,5528,75
14422,8,330,2891,258,5076,72
29378,59,2067,2135,1631,15374,436
24776,8,591,2368,487,6437,104
6743,53,906,3365,700,10894,206
34731,13,147,1889,110,3363,37
17448,463,38551,2731,26907,117240,11644
11084,327,20815,3106,14453,57593,6362
28921,0,45,2159,39,5531,6
10645,37,1059,3130,812,8518,247
10940,12,188,3114,145,5106,43
10342,24,929,3147,721,6478,208
19573,2,39,2637,33,1647,6
2032,203,10128,3524,7159,76582,2969
25821,21,1594,2321,1175,8297,419
39514,1,75,1586,55,6648,20
4758,1,100,3459,84,13468,16
5077,17,449,3443,371,8080,78
30929,18,266,2057,221,3015,45
32130,30,956,1995,690,8107,266
21262,15,357,2541,280,7740,77
19444,11,218,2643,180,8211,38
42499,5,161,1219,115,3275,46
2340,5,265,3519,212,9433,53
3441,7,80,3500,51,3278,29
25012,134,4167,2357,3310,19237,857
10699,10,422,3127,315,11321,107
30627,23,1297,2070,1002,6058,295
16249,2,159,2795,121,6416,38
15980,60,1304,2808,1010,7699,294
28732,14,321,2168,246,3654,75
8804,105,5357,3229,3804,50052,1553
15286,16,866,2838,705,22421,161
20738,3,173,2576,150,2397,23
21714,14,190,2516,148,2271,42
9937,217,12980,3166,9342,42449,3638
2065,11,317,3523,248,9921,69
32090,6,872,1997,590,11453,282
41472,20,342,1406,245,4651,97
22207,0,156,2490,128,3335,28
16310,26,683,2792,540,5920,143
21886,5,166,2507,131,4898,35
28198,26,951,2199,694,13237,257
19328,23,722,2649,536,15517,186
32709,279,8617,1970,6655,34695,1962
25749,7,134,2324,116,1854,18
46018,2,23,236,14,765,9
21005,0,81,2557,67,2000,14
35963,5,100,1811,85,5255,15
11291,8,338,3095,263,12430,75
37926,16,290,1689,239,5884,51
31906,30,1199,2007,944,16985,255
9334,4,285,3198,163,4300,122
28170,38,563,2201,447,7035,116
39367,1,80,1594,60,2652,20
23025,19,1139,2450,866,4132,273
36700,5,106,1769,94,2529,12
33456,20,1098,1940,863,14240,235
1453,16,1369,3627,1062,24640,307
3306,113,3337,3502,2438,40215,899
4441,33,697,3471,553,15628,144
31961,84,3182,2004,2319,26529,863
20071,20,807,2610,645,8685,162
8497,293,6238,3249,4835,30542,1403
20187,0,77,2603,62,2924,15
3149,48,1308,3505,1037,12962,271
41380,3,127,1420,95,5680,32
5400,32,572,3424,386,6799,186
8972,8,268,3220,228,18359,40
44663,234,3505,713,2983,40997,522
40644,15,248,1504,191,5599,57
4507,15,238,3468,194,13212,44
42020,9,89,1316,73,3382,16
9131,30,1897,3211,1394,28635,503
5908,1,181,3399,153,21210,28
4210,2,67,3479,52,3211,15
28741,37,1167,2168,927,9712,240
24234,19,775,2393,629,8092,146
29473,10,253,2130,213,3984,40
41424,75,2013,1412,1357,30798,656
22160,2,121,2492,94,2548,27
7327,967,37395,3333,25210,169938,12185
29682,1,138,2120,100,2956,38
14863,7,391,2862,314,7180,77
25625,22,1367,2330,1075,29996,292
14306,11,935,2900,726,23114,209
34739,3,179,1889,152,3033,27
16510,8,288,2782,209,7744,79
31485,4,119,2029,103,3503,16
16630,58,3553,2777,2805,35249,748
12914,50,2483,3009,1903,31593,580
19084,5,67,2661,56,2257,11
25473,35,3297,2338,2403,14324,894
15724,5,477,2818,308,12782,169
41308,87,872,1430,689,9521,183
21535,0,60,2527,48,4546,12
10744,1,136,3124,105,8596,31
37788,2,27,1700,24,4221,3
22957,21,978,2452,774,9336,204
34589,23,1015,1897,812,10278,203
38301,226,5357,1664,4049,34819,1308
2922,232,7355,3509,5517,34332,1838
27336,1,150,2250,133,5022,17
12624,49,3377,3026,2304,28768,1073
2133,14,557,3522,423,6352,134
32301,31,796,1987,600,5845,196
25583,0,98,2332,85,3368,13
3991,60,4044,3486,2617,15756,1427
9744,131,4370,3175,3361,18359,1009
33319,49,2025,1945,1724,16118,301
38901,2,124,1623,105,2269,19
33668,0,17,1932,14,2182,3
34445,48,1918,1904,1473,18618,445
45980,52,855,253,685,6054,170
27087,33,574,2266,453,7261,121
46017,6,74,236,61,2747,13
22737,54,2754,2464,1980,28668,774
46337,0,19,115,16,955,3
36249,51,1750,1793,1331,10923,419
34279,20,441,1912,320,4409,121
27912,4,116,2215,82,2906,34
34098,1,93,1917,75,2949,18
2913,10,208,3510,178,5239,30
10876,39,1151,3117,904,18361,247
36585,34,2283,1775,1736,34357,547
46239,34,496,151,435,6384,61
33130,1,150,1952,133,2673,17
2362,17,694,3519,560,51844,134
43016,4,197,1097,121,3603,76
45877,2,31,300,25,1108,6
33939,1,91,1923,77,5017,14
9117,9,125,3212,96,2880,29
4533,5,66,3467,46,3352,20
34965,44,4696,1876,3329,28690,1367
32180,12,176,1992,143,2241,33
22112,17,1135,2494,870,11360,265
37868,123,1092,1693,775,8645,317
22550,4,41,2472,32,4437,9
38076,11,96,1680,76,2086,20
26684,59,6927,2282,5180,47245,1747
39608,2,145,1580,66,4487,79
11078,1,184,3107,143,2410,41
17787,4,253,2718,207,10221,46
4058,5,160,3484,120,6579,40
8162,33,1525,3272,1123,27640,402
9731,47,1787,3176,1401,23957,386
29091,1,85,2150,70,2106,15
45741,11,139,346,119,2502,20
44164,408,7400,794,5389,51611,2011
46094,19,427,206,355,5220,72
2346,1,58,3519,44,3985,14
24220,2,321,2393,273,9124,48
17168,21,1934,2745,1558,18187,376
24710,49,1962,2369,1482,22947,480
9211,6,294,3206,227,3938,67
27406,2,48,2246,44,2025,4
35156,5,147,1865,124,4141,23
17177,1,62,2745,53,2868,9
16373,55,1668,2788,1228,15019,440
16482,30,1178,2784,909,15316,269
36354,4,332,1787,250,5712,82
38558,19,1872,1645,1545,6094,327
46148,29,537,162,419,5972,118
19411,10,689,2644,450,13960,239
17258,8,606,2740,502,12270,104
2186,5,187,3522,161,16724,26
42393,6,523,1242,349,10988,174
42717,59,2471,1175,1905,24078,566
20993,209,7182,2558,5498,50567,1684
34344,3,354,1909,295,6011,59
45069,9,102,582,95,3908,7
40829,98,2020,1486,1478,18951,542
37819,77,4016,1697,3094,25714,922
19349,20,1143,2648,809,7335,334
38363,277,6534,1659,5067,33236,1467
26888,8,611,2272,495,9324,116
38373,323,12246,1658,9171,55529,3075
40925,3,163,1478,126,5063,37
43363,7,110,994,72,5679,38
45915,19,174,285,146,5919,28
8748,10,544,3233,461,5394,83
4299,69,1664,3476,1339,15468,325
17096,35,3047,2750,2357,12807,690
26445,11,1020,2292,733,11581,287
17948,4,140,2709,108,4283,32
25516,0,21,2336,16,2277,5
20140,6,480,2606,372,7183,108
10266,315,39086,3150,27930,174534,11156
2479,36,657,3516,489,7136,168
34612,48,1439,1896,1102,11134,337
2910,12,173,3510,140,11845,33
29561,80,5025,2126,3634,20141,1391
15820,2,299,2814,250,2833,49
14057,317,67396,2916,41458,117808,25938
16251,800,46502,2795,33584,160072,12918
9859,30,1786,3169,1444,19193,342
7719,41,1366,3310,1062,14510,304
25352,16,911,2343,720,7625,191
2933,11,548,3509,381,8046,167
22822,46,3197,2460,2298,26229,899
6471,27,697,3376,574,7211,123
9434,121,5870,3192,3532,50815,2338
43097,134,3672,1072,3165,40668,507
17476,7,446,2730,373,6117,73
34821,3,137,1883,115,4912,22
16836,101,7225,2764,5238,48537,1987
18107,8,298,2702,235,3992,63
42944,6,76,1116,66,2045,10
2565,32,1218,3515,950,14381,268
37955,92,1174,1687,899,16544,275
2730,6,296,3513,255,3617,41
11317,31,2213,3095,1761,25349,452
32465,8,438,1980,345,5928,93
38221,2,170,1669,130,3368,40
43771,151,2777,860,2282,54879,495
15296,11,383,2838,311,7187,72
33383,27,734,1943,596,12338,138
16062,1,174,2804,124,3617,50
39114,1,70,1610,57,3716,13
24102,0,28,2398,24,1672,4
18717,5,221,2675,174,11666,47
16165,0,311,2799,241,10458,70
8344,94,1980,3259,1569,14130,411
34080,7,115,1918,92,6800,23
15398,6,215,2834,155,3493,60
15836,30,1552,2814,1172,15693,380
43662,32,735,895,590,9728,145
13695,106,4929,2947,3683,49210,1246
12631,4,192,3025,160,2956,32
6986,9,198,3352,143,4885,55
2972,14,123,3508,102,5495,21
13105,258,16664,2996,12821,174364,3843
40796,33,1178,1490,944,14505,234
33782,1,41,1927,37,2310,4
14438,345,16600,2891,12745,151615,3855
12867,6,426,3011,354,2989,72
22108,108,6446,2494,5200,71162,1246
25231,265,12596,2348,8393,74875,4203
22500,58,757,2475,609,8557,148
5017,16,538,3446,421,5516,117
41532,10,142,1399,98,5588,44
26796,32,675,2276,528,5543,147
6023,3,14,3394,13,2785,1
4295,41,1115,3476,820,20309,295
3978,43,3301,3487,2520,64509,781
10662,279,15399,3129,11642,86784,3757
8635,63,1902,3241,1425,18370,477
36313,25,479,1789,356,8550,123
1906,17,164,3527,121,6592,43
9355,6,73,3196,62,8466,11
6610,60,1735,3370,1389,31083,346
43094,6,298,1072,196,7418,102
10990,10,1402,3111,1102,15418,300
38125,40,987,1676,627,8704,360
36326,6,212,1789,163,4549,49
13250,44,1473,2980,1066,15387,407
8735,7,184,3234,128,3449,56
36285,9,127,1790,103,4776,24
22535,21,2009,2473,1420,33457,589
29019,0,147,2154,107,4499,40
36152,116,2130,1797,1647,12952,483
15525,18,1670,2828,1182,14628,488
28727,0,155,2169,126,6650,29
12182,69,4000,3050,3003,71885,997
34020,5,237,1919,180,5171,57
6064,4,92,3392,78,2837,14
11163,549,23656,3101,18087,82774,5569
4445,103,2851,3470,2220,31344,631
37365,52,958,1728,741,6214,217
7384,122,11071,3330,8328,92749,2743
22089,22,611,2495,465,4820,146
29811,4,125,2114,94,4421,31
32943,5,645,1960,445,13532,200
10051,4,240,3160,196,4401,44
25901,83,3915,2318,3121,19282,794
15985,10,500,2808,385,14446,115
22452,7,334,2478,288,4710,46
16987,11,619,2757,473,8637,146
11194,9,517,3100,401,4509,116
41299,9,132,1430,106,2487,26
13927,32,2433,2926,1469,15979,964
15124,514,27327,2847,19355,136578,7972
22284,332,7760,2486,5935,35409,1825
30555,112,4892,2074,3868,26123,1024
8935,3,176,3223,115,13461,61
5732,153,4355,3408,3173,34453,1182
7224,0,63,3340,46,4815,17
15291,7,124,2838,109,6278,15
35913,94,1692,1814,1294,15141,398
19595,547,30262,2636,21984,179750,8278
14823,29,527,2863,390,14444,137
5326,6,133,3429,99,8725,34
1981,9,221,3525,176,13196,45
4532,12,1218,3468,533,5588,685
27179,3,415,2260,288,9299,127
34247,18,290,1913,215,4568,75
34317,10,150,1910,128,4754,22
36292,7,171,1790,146,3941,25
16745,285,20264,2770,14646,124985,5618
8332,3,38,3260,27,1355,11
18685,28,3498,2676,2665,39238,833
32371,7,286,1983,228,6743,58
45685,85,842,375,648,7289,194
25799,456,15102,2322,12438,51510,2664
23861,17,462,2410,368,3593,94
42785,29,202,1156,164,4660,38
36035,20,1247,1806,964,13741,283
40147,264,7852,1547,5411,46439,2441
8719,11,526,3235,432,12099,94
27583,107,2170,2234,1683,16754,487
8264,55,1801,3265,1432,40038,369
37227,20,588,1736,364,11445,224
38143,4,110,1675,81,2648,29
18316,7,92,2692,74,10676,18
25078,1882,66021,2354,48436,262889,17585
9018,9,337,3218,260,9372,77
22965,847,31543,2452,24101,115265,7442
46247,15,122,150,105,1552,17
4773,49,1821,3458,1086,15299,735
37660,3,91,1709,74,2127,17
28894,7,786,2160,595,9039,191
11043,41,1158,3109,900,16440,258
5309,4,212,3430,110,3974,102
35681,1,92,1831,78,5592,14
24209,1,19,2394,15,1024,4
24525,12,427,2379,349,19830,78
28592,27,1130,2176,841,12775,289
22233,15,2312,2488,1663,32202,649
39238,81,2037,1601,1599,18766,438
39577,8,263,1582,206,13681,57
21342,2,34,2538,24,3535,10
27530,334,17335,2237,12991,140585,4344
24694,38,1819,2370,1381,18050,438
18617,505,49715,2680,32452,207701,17263
18998,82,5011,2664,3653,31824,1358
39679,286,9979,1576,6978,46760,3001
19403,36,2235,2645,1742,43227,493
22692,0,179,2466,145,4366,34
5811,3,78,3404,63,5342,15
7315,111,4368,3334,2790,13881,1578
44792,35,470,671,342,9148,128
26408,0,0,2294,0,2869,0
28666,45,1040,2172,838,8776,202
37422,9,287,1724,241,12097,46
31622,12,368,2021,306,4789,62
2320,71,1929,3519,1624,40322,305
2063,279,10545,3523,8239,81469,2306
26149,6,376,2307,291,4951,85
4891,11,846,3452,619,15168,227
44740,42,654,686,438,6306,216
14221,210,18612,2908,13692,88420,4920
23125,2,84,2445,62,3305,22
9576,5,326,3183,236,5944,90
43703,51,866,880,680,10179,186
12998,65,1469,3003,1008,31403,461
15784,3,65,2816,53,2891,12
44535,8,146,735,105,5887,41
44854,11,210,648,130,3817,80
17700,33,2186,2720,1750,14530,436
18452,3,65,2687,57,2785,8
36441,2,22,1784,17,6590,5
42519,16,331,1214,234,3179,97
39347,6,381,1595,286,7713,95
34010,194,4828,1920,3537,22450,1291
40845,2,92,1484,76,4421,16
28807,13,629,2164,510,4399,119
38116,6,374,1677,290,7562,84
43071,4,117,1081,82,2897,35
2605,13,376,3514,196,9609,180
16554,53,1808,2780,1521,18614,287
6366,62,1543,3381,1082,11554,461
21529,9,304,2527,243,4875,61
43583,2,23,924,20,1601,3
14678,0,68,2874,54,2538,14
34410,176,3141,1905,2442,14919,699
28399,71,3847,2188,3045,34575,802
43296,60,1046,1015,778,31958,268
11699,2,35,3074,22,3115,13
17812,17,747,2716,602,11055,145
21833,68,5505,2511,3808,38120,1697
3192,136,4723,3504,3643,41728,1080
7032,0,93,3349,73,3236,20
27032,18,522,2268,405,16625,117
22791,21,537,2462,437,2664,100
42761,4,94,1163,73,5870,21
30920,86,1900,2057,1477,24181,423
2086,15,1436,3523,1154,16536,282
34419,68,2268,1905,1723,11429,545
3222,10,329,3504,261,17720,68
20591,4,167,2583,137,6448,30
15810,11,507,2815,429,8380,78
18229,117,5152,2696,3889,18596,1263
37628,5,80,1710,59,3230,21
23180,3,196,2443,177,3331,19
2220,62,3152,3521,2496,30504,656
31393,11,171,2034,125,2631,46
11685,46,2621,3074,1953,38235,668
42865,107,5278,1139,3962,53041,1316
12535,2,43,3031,29,1072,14
1137,4,329,3794,263,10030,66
28973,151,4344,2156,3410,44828,934
18656,1,200,2677,160,2967,40
14345,50,3429,2897,2459,21728,970
43054,17,150,1086,125,3103,25
15520,1,84,2828,69,2391,15
4728,5,255,3460,195,9814,60
26841,13,831,2274,637,8064,194
15790,11,410,2815,331,7667,79
5373,3,170,3426,129,15319,41
10076,18,472,3158,353,5961,119
40408,26,473,1526,377,8561,96
13817,23,421,2937,318,5416,103
12366,2,162,3040,134,2284,28
21118,0,58,2552,51,3434,7
15523,122,5761,2828,4366,18991,1395
45416,0,22,467,14,2200,8
33472,27,1389,1939,1041,21145,348
28950,22,1143,2158,917,5817,226
40144,37,795,1548,632,8223,163
11444,37,4862,3088,3613,24221,1249
9343,113,2977,3197,2410,15569,567
16953,8,279,2759,211,14692,68
25353,45,1418,2343,1115,20595,303
42313,8,121,1257,88,3351,33
24226,5,492,2393,425,14563,67
42340,9,847,1252,565,15789,282
44389,139,2230,759,1910,27313,320
37147,130,4793,1741,3692,36158,1101
27037,7,240,2267,199,3085,41
29614,0,40,2124,29,2497,11
5660,30,1793,3412,1410,22153,383
45676,26,269,376,203,3422,66
36068,7,278,1803,185,4919,93
38816,164,2716,1628,2125,25344,591
24725,389,17265,2369,12470,113769,4795
17803,3,92,2717,68,4333,24
37896,1,196,1691,151,4456,45
36290,21,615,1790,467,13042,148
31853,14,247,2009,195,3637,52
30399,7,258,2083,208,4859,50
44176,50,796,791,660,17233,136
30157,21,698,2098,585,12830,113
25068,7,227,2355,186,4647,41
36262,6,110,1792,88,4481,22
14767,99,3571,2867,2836,13533,735
3945,6,200,3488,164,3551,36
19372,0,42,2647,33,1564,9
7311,14,466,3334,366,6325,100
28176,39,1495,2201,1151,13401,344
13427,19,510,2967,376,8374,134
14189,7,437,2910,354,7034,83
10871,195,6997,3117,5522,117327,1475
43982,13,199,825,152,4959,47
2583,23,229,3515,179,6533,50
20914,51,1836,2563,1386,19184,450
19739,55,1061,2628,800,6274,261
11256,73,3659,3097,2703,26552,956
24968,43,2222,2359,1735,25896,487
45804,10,129,324,90,2013,39
3782,9,205,3493,170,5177,35
35842,1,61,1820,56,3037,5
11383,2,98,3091,73,3598,25
41613,39,870,1386,633,7523,237
39064,15,441,1613,351,5497,90
35380,4,125,1854,108,3877,17
3227,118,4829,3504,3609,43399,1220
2594,4,215,3515,168,4670,47
38037,113,1149,1683,769,7687,380
42261,178,4058,1267,2988,30109,1070
6678,198,15120,3368,10276,79856,4844
40061,2,117,1552,65,5079,52
30045,4,173,2103,138,3286,35
1918,20,630,3527,491,17210,139
40261,45,1094,1539,842,23838,252
12671,3,129,3023,103,4993,26
21627,15,0,2521,0,42196,0
36015,135,4153,1807,3264,38870,889
3453,66,2582,3500,1864,21620,718
32083,10,620,1997,411,8788,209
9172,0,79,3207,64,2525,15
16055,207,6877,2804,5303,33874,1574
11478,487,30103,3085,21902,76377,8201
40601,17,156,1507,129,5004,27
45986,15,221,252,140,5003,81
5335,9,72,3428,65,2510,7
38680,9,379,1637,316,13706,63
20106,201,12094,2608,8308,65849,3786
4968,30,301,3449,247,3083,54
34265,28,737,1912,568,14902,169
14635,28,1245,2877,967,11747,278
3910,213,9832,3489,7536,59357,2296
11485,24,1482,3085,1090,10323,392
28487,35,563,2183,412,6812,151
21303,3,146,2540,98,2505,48
8886,44,2488,3225,1897,34037,591
39936,259,7575,1560,5490,32027,2085
2475,8,229,3517,181,27106,48
31717,0,44,2016,30,4038,14
39970,14,432,1558,331,8641,101
36859,4,308,1758,239,8682,69
31956,6,191,2005,145,3256,46
8879,29,1013,3226,798,14373,215
40491,194,6335,1517,4771,39554,1564
42248,16,948,1269,698,11763,250
16959,0,885,2758,678,6112,207
34009,2,30,1920,25,2092,5
8410,14,589,3255,435,13672,154
9587,11,360,3182,255,6563,105
30371,28,1743,2085,1176,28755,567
10206,25,736,3153,557,15366,179
7162,118,7573,3342,5574,37372,1999
39563,28,1737,1583,1368,20105,369
9417,29,852,3193,647,7294,205
36704,14,924,1769,719,5481,205
41267,54,1184,1436,842,18565,342
16192,48,2941,2798,2318,28839,623
21006,102,3054,2557,2321,24535,733
26765,17,825,2278,654,7289,171
19165,17,1106,2657,845,10074,261
31178,7,283,2045,236,8202,47
15012,6,259,2853,210,10251,49
10601,36,1089,3133,856,13157,233
46006,6,129,241,86,2936,43
2961,6,54,3509,45,3653,9
20159,155,9152,2605,6992,47393,2160
8745,9,352,3234,263,3992,89
12994,251,28250,3003,19815,153285,8435
10623,9,428,3132,361,3485,67
11782,14,374,3069,292,16949,82
25547,0,35,2334,27,4191,8
6177,13,675,3389,580,44561,95
18731,31,1759,2675,1301,15299,458
17040,64,3844,2753,2842,35248,1002
8799,1,35,3230,32,2106,3
46156,89,2271,177,1631,24035,640
14276,87,2287,2904,1700,15291,587
43090,45,1209,1074,766,18454,443
12534,2,59,3031,38,1311,21
18448,16,828,2687,649,11923,179
28340,57,8054,2191,5976,29454,2078
11800,1,98,3069,72,4851,26
43052,418,12088,1087,9130,89179,2958
21363,3,261,2536,194,4344,67
9541,66,4033,3185,3195,29102,838
39683,24,450,1576,344,7352,106
16723,10,283,2771,230,4752,53
20904,5,217,2563,179,4894,38
20072,84,4203,2610,3116,24182,1087
22397,7,158,2481,130,10691,28
18111,77,3036,2701,2284,23231,752
38713,13,458,1635,363,5774,95
43629,18,263,907,201,4474,62
16364,4,619,2789,493,10640,126
37920,5,72,1689,56,2859,16
41023,150,6124,1471,4039,43635,2085
2898,57,1369,3510,1060,20123,309
4054,1,31,3485,25,2045,6
30646,15,401,2069,291,13438,110
28158,13,478,2202,387,7663,91
27277,0,46,2254,34,3951,12
19375,9,295,2647,235,5565,60
26636,8,156,2285,134,4203,22
32695,28,685,1970,482,8335,203
17584,10,588,2724,419,6812,169
27520,448,20430,2238,16258,75752,4172
44681,52,754,707,547,8203,207
46095,5,64,206,57,1747,7
24954,0,7,2359,6,3731,1
44937,13,89,629,64,3458,25
5296,27545,1528486,3430,964238,4327454,564248
20108,0,503,2608,355,6461,148
42453,118,2527,1228,1878,31034,649
24374,31,2256,2386,1768,17307,488
6426,4,267,3378,152,9088,115
40824,267,10381,1486,7545,69627,2836
29286,131,3325,2140,2520,32038,805
3856,19,358,3491,271,8497,87
36500,17,418,1780,304,12921,114
39424,90,2975,1591,1988,15939,987
26513,7,370,2289,310,6622,60
27518,56,4325,2239,2636,20800,1689
29087,561,31482,2150,22637,163587,8845
3951,33,1322,3488,1047,23076,275
41004,0,284,1472,214,7236,70
12394,32,2401,3038,1866,21328,535
37547,8,156,1715,131,4955,25
8072,5,92,3276,81,4733,11
12045,24,979,3058,638,16930,341
19969,43,3872,2615,3088,33791,784
3301,2,67,3502,45,4821,22
37753,55,1359,1702,1060,12823,299
26060,41,3539,2310,2623,35884,916
15661,0,44,2821,40,1796,4
30208,38,742,2094,611,6593,131
12830,2,136,3014,118,2679,18
24649,481,17405,2372,12724,74711,4681
16873,3,175,2763,155,7711,20
15329,83,3100,2836,2323,25568,777
23543,15,851,2425,607,21057,244
26198,0,36,2304,29,1756,7
28149,1,74,2203,64,4769,10
12515,18,783,3031,606,11509,177
26795,65,2738,2276,1900,43818,838
18908,28,1683,2667,1252,21012,431
44665,1,32,712,25,1057,7
45359,173,2656,483,2134,9983,522
42358,80,2921,1248,2062,55539,859
24806,51,1476,2367,1128,12723,348
43192,14,142,1047,105,2462,37
44023,4,57,818,46,2561,11
35493,2,122,1847,103,3609,19
27247,13,1021,2255,798,11649,223
20988,2,105,2558,91,3350,14
17601,2,194,2724,145,4808,49
40848,2,208,1484,164,7303,44
9247,50,1114,3204,840,31548,274
5139,29,952,3438,795,8453,157
1526,2,94,3604,79,2908,15
22127,2,47,2493,40,1939,7
3129,8,255,3506,200,7471,55
43024,2,98,1096,64,5489,34
39375,36,1414,1594,998,11504,416
38877,29,695,1625,536,7715,159
16895,54,1787,2762,1263,17506,524
42161,3,149,1287,104,11773,45
5738,40,1329,3408,1032,17704,297
44838,71,1470,653,1019,13634,451
46008,3,54,240,36,1463,18
41148,3,162,1454,116,4226,46
41729,40,1464,1367,1003,30589,461
9560,1,115,3184,93,3745,22
9515,81,3188,3186,1726,11755,1462
31834,0,113,2010,75,1700,38
45567,26,502,421,403,4423,99
43423,3,245,974,194,3100,51
40302,32,576,1537,443,13315,133
32768,16,1229,1967,971,13132,258
18262,11,352,2695,268,6555,84
13016,34,1641,3002,1334,11079,307
35973,25,1245,1810,952,12800,293
3754,11,329,3493,223,4302,106
28415,2,80,2187,71,4332,9
33134,34,884,1951,724,14096,160
36809,2,95,1762,78,2654,17
7063,54,1562,3347,1209,11416,353
8847,18,450,3227,400,3425,50
33979,221,3111,1921,2431,17001,680
6510,14,417,3374,327,6616,90
41886,3,172,1337,142,3513,30
45105,50,487,561,391,6052,96
32961,4,100,1959,72,4032,28
1036,8,153,3821,124,5698,29
4004,16,444,3486,359,6995,85
3022,64,2897,3507,2234,39340,663
22785,16,449,2462,364,2052,85
26100,17,859,2309,700,10755,159
20963,78,3775,2560,2503,40121,1272
25024,5,303,2357,227,2325,76
37344,20,896,1729,746,11148,150
3010,11,405,3508,318,13864,87
43499,5,127,953,104,3872,23
26103,1221,79548,2309,53673,226152,25875
11153,3,139,3102,124,8203,15
7501,3,124,3324,85,3108,39
10624,2,111,3131,89,3834,22
2436,201,13785,3517,9480,87478,4305
14495,18,964,2886,770,5964,194
43831,17,263,846,213,7254,50
32960,20,1157,1959,905,11581,252
40916,10,179,1479,135,2224,44
25740,0,47,2324,37,2093,10
43737,27,432,871,333,7236,99
26922,217,11383,2271,8230,63683,3153
44930,7,74,630,70,3008,4
39235,5,164,1602,131,8200,33
41493,6,114,1403,94,4513,20
6182,6,156,3389,124,4491,32
10488,5,125,3139,108,7717,17
1841,301,21247,3529,15226,184507,6021
36031,81,1712,1806,1313,9150,399
23804,65,2605,2413,2096,13547,509
3657,24,285065,3495,97149,29112,187916
30653,5,73,2069,53,3247,20
30350,23,374,2086,289,4786,85
18723,203,27738,2675,17324,165750,10414
16764,32,792,2769,634,8518,158
25154,10,538,2351,416,13012,122
46298,11,142,132,110,2292,32
44015,6,116,819,100,2107,16
36673,871,37023,1770,25593,187785,11430
43670,21,454,893,362,9022,92
37729,43,2826,1704,2207,21122,619
24015,25,2866,2402,2141,32614,725
12102,33,846,3055,642,16483,204
19797,4,118,2625,97,2192,21
44871,7,63,645,54,1550,9
22975,7,316,2452,242,5586,74
1778,2,66,3537,50,2383,16
26901,1,80,2272,70,2589,10
40538,7,439,1513,333,11794,106
45106,59,902,560,564,7104,338
41457,1,86,1408,59,4150,27
6650,5,48,3369,41,4541,7
30184,6,226,2096,176,6142,50
14584,51,2212,2880,1866,13721,346
11181,83,5371,3101,4037,61701,1334
19036,1,307,2663,254,5231,53
16995,14,489,2757,360,5731,129
17872,0,122,2714,99,3666,23
4617,73,1741,3464,1365,36596,376
28046,9,436,2208,355,8305,81
38142,30,424,1675,325,5037,99
19351,7,593,2648,468,13613,125
20197,4,135,2603,95,6732,40
36291,13,333,1790,258,6892,75
21187,7,234,2546,198,5515,36
13642,20,2669,2951,1873,15290,796
9135,16,366,3211,260,5734,106
8392,68,4913,3256,3621,86721,1292
31645,3,197,2020,136,7680,61
18086,27,1782,2702,1332,29964,450
13275,701,30814,2979,20597,141005,10217
20404,1,54,2592,47,3987,7
33928,5,552,1923,459,7242,93
23497,11,319,2427,253,5262,66
8040,92,560,3277,435,14843,125
23331,25,1525,2435,956,7648,569
23703,30,595,2417,499,7991,96
15621,38,2680,2823,2186,7024,494
20828,28,1115,2569,862,14767,253
8075,3,115,3276,91,11758,24
10285,4,79,3149,69,2772,10
7936,3,99,3291,82,2865,17
10745,18,592,3124,461,9365,131
8050,24,657,3276,519,10588,138
5875,22,540,3401,445,5696,95
41585,328,4400,1390,3379,28749,1021
25815,0,150,2321,129,8260,21
42172,11,278,1285,221,30507,57
40412,1306,40502,1525,28302,181970,12200
31632,1,64,2021,56,5615,8
7104,5,132,3346,107,3812,25
22401,628,30773,2481,21891,137608,8882
40936,9,481,1477,326,7033,155
2177,8,280,3522,182,12029,98
2666,28,659,3514,491,6867,168
19384,95,3023,2646,2152,16682,871
25472,35,1738,2338,1294,16585,444
30966,7,177,2056,124,3598,53
6302,23,1018,3384,778,31379,240
26211,4,139,2303,99,4941,40
7278,1,186,3337,143,4347,43
8500,2105,104516,3249,69621,288739,34895
26829,3,74,2275,61,2780,13
43325,22,640,1007,472,13576,168
43893,6,101,840,87,2056,14
21607,21,897,2522,643,9422,254
45003,30,340,608,239,6249,101
34171,2,61,1915,50,2299,11
24627,4,265,2373,205,8417,60
5530,26,215,3419,173,6229,42
11647,2,53,3077,43,3572,10
36851,14,634,1758,508,14483,126
15053,11,288,2850,223,4137,65
31201,7,116,2044,102,3334,14
26913,5,228,2271,200,2474,28
16560,70,1722,2780,1334,17700,388
19509,367,18359,2640,13103,69192,5256
17278,1,135,2739,97,3161,38
21937,21,2401,2505,1885,58565,516
30571,3,85,2073,68,1694,17
11287,16,1092,3095,828,23106,264
3560,24,743,3497,629,10351,114
46057,38,345,215,293,6518,52
21778,12,466,2513,365,8229,101
35784,7,304,1824,229,6654,75
35883,18,2009,1817,1617,20596,392
26924,0,15,2271,13,1096,2
15911,40,2117,2812,1604,17523,513
26154,1,37,2307,31,1674,6
16230,25,1720,2796,1380,24130,340
18328,157,8700,2692,6254,73733,2446
46384,0,7,93,3,491,4
41261,62,806,1437,563,9512,243
12962,3,112,3006,63,2347,49
29445,4,73,2131,61,4560,12
36735,2,41,1767,30,2791,11
30972,42,947,2055,775,24353,172
18397,7,512,2689,364,7889,148
38954,1,81,1620,61,3725,20
44311,12,113,772,85,2596,28
10714,9,291,3126,223,10985,68
21110,4,111,2552,91,3603,20
28101,0,23,2205,19,4119,4
5905,3,47,3399,36,3116,11
15441,29,1177,2832,898,8280,279
12330,313,25762,3042,17515,154112,8247
3423,8,621,3500,422,19827,199
16603,6,141,2778,104,4009,37
4501,13,341,3469,263,9947,78
20509,260,5388,2587,3779,22236,1609
38234,34,1228,1669,947,14315,281
25660,73,2930,2328,2119,15455,811
33414,167,3450,1942,2298,17394,1152
20331,4,412,2597,331,12145,81
33870,60,584,1924,448,5950,136
2826,83,4014,3511,2987,27968,1027
32304,161,14719,1987,11539,55766,3180
13418,89,7341,2968,5288,98182,2053
9993,30,911,3163,756,7029,155
5828,38,1057,3403,769,16168,288
21433,2,104,2533,80,4645,24
13190,27,2259,2984,1675,21178,584
14782,9,299,2866,238,7664,61
5416,49,1354,3424,1101,26341,253
28438,16,596,2186,480,4844,116
36197,2,126,1795,105,3610,21
25152,48,1587,2351,1318,9218,269
45099,7,179,564,103,6642,76
9632,5,388,3179,310,19412,78
23415,12,279,2431,213,9293,66
9864,4,80,3169,63,3389,17
13836,20,615,2936,482,7036,133
11597,1,36,3080,30,4072,6
6684,11,263,3367,236,7256,27
45029,129,1258,600,959,14012,299
14865,10,412,2862,339,8459,73
10454,7,279,3141,221,6784,58
11254,5,258,3097,215,7139,43
43342,18,297,1001,208,5921,89
19161,3,174,2658,130,3468,44
5005,57,1294,3447,879,9268,415
43570,4,138,930,99,6902,39
41975,42,2000,1322,1526,26683,474
35227,15,511,1862,407,12766,104
19059,16,449,2662,313,3282,136
10803,1028,48826,3121,34399,164129,14427
23710,21,640,2416,505,9600,135
16767,47,2650,2768,2127,12149,523
41243,130,4619,1441,3668,42947,951
44981,39,420,615,370,9084,50
37572,73,2530,1714,1706,23715,824
15302,5,287,2837,220,19299,67
2725,13,465,3513,363,7064,102
42115,52,1894,1299,1399,29588,495
6152,8,173,3390,127,5767,46
24977,5,241,2358,202,8289,39
30658,12,430,2068,272,8823,158
13230,15,485,2982,383,13448,102
30438,6,332,2081,263,5893,69
15171,145,14039,2844,9841,74399,4198
19997,42,1632,2614,1178,24149,454
43867,4,64,844,44,2122,20
41677,19,1946,1375,1195,18159,751
45775,7,187,332,149,2434,38
42667,9,282,1185,205,10359,77
10187,69,2205,3154,1798,19217,407
33403,290,12163,1942,9066,35920,3097
2001,13,306,3524,258,15007,48
5845,147,5448,3402,4136,25713,1312
20450,9,378,2590,258,8723,120
15746,16,805,2817,617,8497,188
13101,93,4790,2996,3719,24502,1071
2196,62,2120,3521,1541,13746,579
15693,16,943,2820,670,6875,273
34498,22,1283,1902,1049,15317,234
41167,71,2788,1452,1966,33966,822
16894,6,315,2762,260,7028,55
30579,7,202,2073,147,8268,55
45901,8,89,291,63,1177,26
42301,19,1077,1260,831,11887,246
41264,20,434,1437,337,12267,97
15945,0,80,2810,71,2659,9
32266,416,8683,1988,6307,44350,2376
15715,9,381,2819,284,5853,97
23005,10,532,2450,417,4118,115
28680,13,316,2171,250,3866,66
12048,517,26520,3058,18235,186379,8285
36572,157,7841,1777,5378,48645,2463
35804,10,193,1822,146,3807,47
12378,1,43,3039,39,2671,4
7584,7,158,3318,126,12837,32
45931,139,3651,273,2895,16054,756
10169,5,114,3155,96,4596,18
36279,9,239,1791,197,8596,42
14440,2,245,2890,182,8560,63
41931,123,3953,1330,2801,45241,1152
20682,35,3094,2578,2456,30040,638
28600,5,406,2175,323,20691,83
25176,15,1247,2350,921,11663,326
15662,25,896,2821,718,14934,178
45583,10,136,418,65,1988,71
2828,67,2275,3511,1807,21963,468
22008,8,487,2500,391,12136,96
37063,27,714,1746,540,5181,174
2732,268,9715,3513,7218,127206,2497
33131,23,408,1951,341,7952,67
34705,6,90,1890,79,2523,11
21324,2,129,2539,98,1978,31
31470,13,539,2030,444,9283,95
34560,5,102,1899,88,3166,14
32360,9,735,1984,526,7884,209
39806,7,227,1570,183,3967,44
19366,19,1816,2647,1354,16942,462
10317,87,1702,3148,1350,37656,352
31962,22,933,2004,713,11210,220
27431,21,2267,2245,1958,14399,309
2068,13,323,3523,282,6445,41
36312,2,67,1789,47,2255,20
30713,13,510,2066,410,3130,100
2493,23,744,3516,521,15351,223
18053,14,524,2704,416,10892,108
38032,9,239,1683,178,4021,61
38731,69,2093,1634,1572,9817,521
29920,0,72,2108,57,4690,15
22824,6,237,2460,184,3241,53
22556,48,3598,2472,2348,15929,1250
6499,33,1000,3375,779,24149,221
16481,6,420,2784,324,4153,96
4799,50,1899,3457,1406,34498,493
40678,2,56,1501,44,8116,12
37658,7,160,1709,119,6222,41
5197,946,58932,3435,40929,205277,18003
30453,14,1272,2080,1053,9991,219
38354,56,1384,1659,1043,12588,341
39840,45,2526,1568,1603,22248,923
32774,25,444,1967,352,4802,92
39066,7,170,1613,127,5248,43
35732,2,73,1828,68,3914,5
43575,24,629,929,523,8279,106
19821,6,367,2623,290,12471,77
9333,802,27824,3198,20455,95780,7369
36203,21,416,1795,334,5183,82
37150,28,1407,1741,1126,22700,281
19235,22,728,2654,553,6186,175
19171,10,743,2657,594,8122,149
7794,99,5633,3304,4411,43066,1222
6579,9,543,3372,459,25287,84
40278,128,3336,1538,2354,45064,982
28977,5763,351942,2156,247900,1256161,104042
33312,4,102,1946,82,2939,20
28099,1,43,2206,25,2703,18
41519,27,396,1400,310,10226,86
30098,2,264,2100,169,5419,95
23308,15,643,2436,486,7757,157
30887,36,862,2059,693,19069,169
11547,9,919,3081,635,10097,284
11678,3,170,3075,138,4466,32
6223,3,58,3387,47,3245,11
19825,0,108,2623,89,8483,19
24650,4,188,2372,168,8739,20
28760,1,57,2166,33,3515,24
20009,46,3844,2613,2800,18317,1044
23499,36,2346,2427,1722,20552,624
31882,192,6132,2008,4159,22552,1973
34752,15,670,1888,529,18049,141
32072,42,1032,1998,671,12295,361
11553,4,328,3081,264,7086,64
39227,22,500,1602,392,9104,108
17313,5,242,2738,192,4866,50
10050,2,105,3160,92,3588,13
22819,899,33338,2460,23609,109938,9729
3287,48,1252,3503,976,11080,276
14291,65,7100,2902,5006,42067,2094
39832,119,2143,1568,1651,20446,492
45914,11,104,285,73,2419,31
2744,45,2011,3513,1566,32300,445
26782,1,93,2277,78,4104,15
45970,26,290,258,266,4947,24
21225,0,272,2543,200,10191,72
26692,1,171,2282,148,5913,23
2784,57,6036,3512,4419,39385,1617
46309,1,41,124,22,834,19
16128,6,515,2800,417,10292,98
20448,12,421,2590,322,6295,99
41654,3,114,1379,94,3717,20
15487,1,263,2830,192,7404,71
13166,4,183,2985,147,3425,36
25969,13,292,2314,217,4043,75
43467,22,808,964,558,10527,250
24661,18,690,2372,532,8286,158
6970,48,2794,3353,2092,70688,702
22306,67,4347,2485,3034,24377,1313
31816,12,783,2011,628,5748,155
4888,14,180,3452,138,3192,42
7941,11,528,3290,361,8870,167
40948,83,1497,1476,1128,17263,369
35479,17,526,1848,424,6189,102
33276,320,5923,1947,4799,55666,1124
13567,18,845,2955,655,15230,190
28616,224,14285,2174,9950,92475,4335
9121,14,727,3212,504,12063,223
28104,2,96,2205,77,3708,19
37818,5,185,1697,142,5635,43
45945,3,45,265,26,988,19
38045,44,452,1682,350,4319,102
26948,5,288,2270,204,11743,84
41574,80,822,1394,604,9897,218
45782,21,321,331,247,4666,74
21738,88,6301,2515,4251,54690,2050
44999,3,36,609,24,3119,12
45182,29,365,534,269,7420,96
17154,18,551,2746,446,5354,105
14055,72,6580,2917,4853,45308,1727
6155,10,591,3390,488,21336,103
40603,5,99,1507,78,1591,21
19858,28,1926,2621,1468,29810,458
22615,0,65,2470,53,4158,12
21030,12,213,2556,167,3849,46
45509,3,65,445,44,1460,21
29433,54,687,2132,542,9244,145
36324,163,5533,1789,4081,58748,1452
24872,23,957,2364,757,8067,200
1842,262,7184,3529,5556,34965,1628
3490,11,289,3499,217,7114,72
32547,0,24,1976,18,3585,6
27380,1,190,2247,149,4729,41
23303,24,1186,2436,939,16212,247
37293,2,78,1732,64,4400,14
23651,1,50,2419,43,1694,7
40670,16,562,1502,433,15847,129
35362,30,370,1855,310,3943,60
11692,49,994,3074,795,37674,199
26443,35,2028,2292,1458,27360,570
45287,17,382,501,249,6881,133
13842,38,1005,2935,685,6442,320
28557,41,1403,2177,1187,11204,216
3743,270,9064,3494,6954,160914,2110
6503,50,1575,3375,1169,9721,406
40100,5,373,1550,294,11048,79
16120,3233,427071,2800,259307,1197660,167764
45710,30,483,359,357,8332,126
31599,19,732,2023,585,10092,147
15470,24,2290,2831,1555,26056,735
18737,149,8526,2674,6181,70062,2345
29736,5,458,2118,325,5422,133
16742,67,4184,2770,3238,24835,946
42828,75,4369,1146,3341,45239,1028
8596,13,387,3243,323,4377,64
8372,0,22,3257,17,1234,5
12485,65,3310,3033,2608,30116,702
8374,56,1402,3257,978,6789,424
14737,1,65,2870,54,4253,11
32841,4,231,1964,189,5702,42
7653,76,4260,3314,3212,51170,1048
2935,29,1531,3509,1195,35363,336
29580,67,1545,2125,1265,15287,280
37898,4,146,1691,112,3518,34
38776,26,557,1631,464,12432,93
20553,1,130,2585,93,2634,37
36402,12,321,1785,249,3432,72
12457,48,45416,3034,16002,15838,29414
35047,10,263,1871,218,7708,45
37356,49,2840,1728,2179,21323,661
11468,5,154,3086,118,2670,36
23941,6,414,2405,314,7263,100
43049,21,232,1088,205,4899,27
19754,48,1901,2627,1480,21555,421
38897,14,441,1623,359,12651,82
30549,15,637,2074,500,8459,137
38726,4,83,1634,64,2877,19
30638,9,438,2070,359,6875,79
46100,4,58,204,48,1594,10
40736,13,337,1496,273,8754,64
8334,76,4180,3260,3366,35415,814
14597,0,405,2879,348,8023,57
3263,17,419,3503,316,2714,103
45881,258,4578,298,3356,17047,1222
42506,30,951,1217,624,11284,327
45120,15,99,552,82,4984,17
9513,20,1043,3186,817,22803,226
42460,5,198,1226,151,7943,47
18920,2,83,2667,73,2289,10
29013,11,350,2155,276,7569,74
3387,31,1876,3501,1486,20233,390
43032,51,561,1093,508,5420,53
37657,30,690,1709,548,4890,142
35589,93,1005,1839,772,9341,233
42680,99,1781,1182,1344,19328,437
3578,1244,70599,3497,38451,198607,32148
35016,0,21,1873,15,1982,6
14885,8,471,2860,371,9370,100
5264,13,275,3432,206,12445,69
4851,3,88,3455,68,2145,20
37774,17,516,1700,388,7152,128
29490,10,324,2129,254,5755,70
2740,122,4353,3513,3399,24035,954
41422,60,1039,1413,744,13906,295
28450,1,56,2185,44,4717,12
1136,3,158,3794,130,7658,28
34462,9,361,1904,306,5588,55
21834,66,1904,2511,1519,18083,385
2106,148,2926,3523,2280,49799,646
45672,7,62,378,48,3526,14
27878,3,109,2218,82,3333,27
9851,39,1974,3170,1476,18710,498
25319,241,5826,2344,4754,40501,1072
26892,669,58487,2272,41973,145766,16514
6881,440,21944,3358,16373,214159,5571
36826,44,736,1760,555,9885,181
5025,11,420,3446,351,5280,69
7495,23,767,3324,582,6151,185
4015,7,221,3486,174,10041,47
3073,106,10499,3506,7541,84738,2958
20308,2,41,2597,31,4241,10
4091,180,4909,3483,3961,48738,948
13576,6,107,2955,82,2317,25
2219,108,4324,3521,3382,47610,942
24128,49,3239,2397,2744,10630,495
36182,3,126,1796,107,4345,19
16019,4,329,2806,252,6502,77
19735,6,278,2629,231,7965,47
34017,10,443,1919,359,8275,84
43146,7,157,1058,98,4649,59
10872,1,102,3117,73,6282,29
20417,19,630,2592,488,9785,142
2860,3,107,3511,88,4782,19
40611,11,227,1506,184,2324,43
39057,2,34,1614,27,4346,7
23771,1,47,2414,40,1694,7
42384,62,985,1244,775,10123,210
39115,95,2165,1610,1590,17795,575
42092,100,3047,1303,2324,28513,723
15966,22,743,2809,591,11818,152
5542,21,1353,3418,982,15539,371
39044,11,327,1615,241,10375,86
14035,36,1591,2918,1248,42029,343
8164,20,307,3271,239,4092,68
30093,341,17321,2100,11317,54056,6004
19391,7,404,2646,303,10348,101
15233,6,225,2841,165,7788,60
43099,6,120,1071,97,6896,23
14981,2,138,2855,114,2508,24
12347,43,3205,3041,2637,22995,568
45529,32,327,438,225,6274,102
10129,29,1393,3156,1021,11650,372
5026,6,54,3445,39,3744,15
27055,3,233,2267,175,4175,58
42307,15,488,1258,343,8695,145
28798,90,4059,2165,2831,30068,1228
39242,464,30867,1601,23277,135145,7590
37217,91,1744,1736,1302,22320,442
43128,2,113,1064,74,2868,39
15664,18,1729,2821,1353,30365,376
17786,1,82,2718,66,4695,16
33629,3,113,1934,88,3258,25
10609,14,1033,3132,805,11516,228
31193,3,194,2044,148,4476,46
6573,3,74,3372,49,2647,25
9408,36,1949,3193,1519,29524,430
39481,193,6967,1588,5047,63938,1920
7337,2,84,3333,74,6466,10
14553,23,850,2883,638,12939,212
20335,174,5382,2596,3639,33425,1743
35299,6,154,1858,129,1634,25
25752,31,640,2324,502,7173,138
5715,16,541,3409,457,25569,84
4908,7,258,3451,189,9518,69
9478,8,114,3189,97,3164,17
19460,3,180,2642,141,3828,39
8225,32,1105,3267,870,10760,235
28251,58,2476,2196,1950,16084,526
40791,76,1447,1491,1042,14187,405
43208,11,89,1043,72,3880,17
42350,10,134,1250,99,3725,35
25524,1416,69406,2335,43089,239829,26317
14580,37,3410,2880,2561,91415,849
26110,6,325,2308,257,3458,68
29067,670,19582,2152,15719,85335,3863
14835,14,1429,2863,1015,7225,414
26314,10,5424,2299,3151,14761,2273
36082,234,7548,1802,5576,73702,1972
37594,206,6704,1713,4883,54491,1821
2570,3,261,3515,189,5239,72
31538,30,520,2025,429,6044,91
43198,3,70,1045,55,2497,15
42687,11,190,1179,146,5365,44
27100,6,104,2265,78,2492,26
43783,23,418,856,296,13717,122
21539,12,374,2526,267,3862,107
27800,2,238,2221,189,7168,49
11878,6,446,3066,347,10391,99
16890,21,1793,2762,1388,17293,405
35749,0,4699,1827,3470,34935,1229
3565,58,4272,3497,3286,67045,986
29414,10,250,2133,201,5920,49
38621,18,386,1640,279,9688,107
42152,15,538,1289,385,9514,153
9124,50,1043,3212,792,12363,251
20990,10,996,2558,785,4855,211
34206,89,3756,1914,2745,36749,1011
14476,60,3022,2888,2255,26103,767
8957,13,106488,3221,33920,4665,72568
6785,14,398,3363,327,14274,71
3269,44,1637,3503,1336,28374,301
38438,335,6912,1654,5548,23897,1364
43950,43,341,830,275,3062,66
17578,8,657,2725,532,10623,125
20225,1,145,2601,113,3282,32
15872,7,293,2813,208,7302,85
18211,45,1385,2697,1032,14161,353
18888,2,125,2668,81,1463,44
39888,9,558,1563,439,8599,119
40195,11,383,1544,267,4582,116
40317,14,233,1535,169,8145,64
13486,23,1032,2962,809,8854,223
22136,229,5268,2493,4107,24297,1161
25608,0,69,2330,45,1480,24
20953,137,6274,2561,4827,54595,1447
37609,2,133,1711,112,4192,21
14699,2,137,2873,117,3628,20
18385,646,34706,2689,26218,161642,8488
30816,267,6688,2061,5136,39843,1552
18463,144,13059,2686,10034,71880,3025
23986,20,662,2403,537,3671,125
40776,42,1338,1492,978,8157,360
39443,40,867,1590,668,12453,199
8593,10,675,3243,565,5406,110
21628,175,8181,2521,5734,38473,2447
35959,48,621,1811,472,7021,149
30416,3,132,2082,114,3216,18
8646,9,505,3240,427,4829,78
43466,4,123,964,93,3352,30
45508,2,30,445,21,1477,9
2620,31,873,3514,730,12085,143
11511,8,323,3083,264,18261,59
20681,15,491,2578,371,4144,120
38518,539,33461,1649,24283,123630,9178
25156,203,7805,2351,5001,45313,2804
26943,21,765,2270,603,31240,162
1873,26,728,3528,617,11079,111
42766,7,133,1162,104,6832,29
24153,6,168,2396,136,2493,32
11359,4,136,3092,97,7251,39
13664,41,1072,2949,841,10107,231
13298,4,134,2977,109,2930,25
45254,19,254,513,179,3297,75
36299,18,499,1790,374,9577,125
12459,24,650,3034,521,8381,129
22171,11,1412,2492,1157,10403,255
10189,15,301,3154,216,9589,85
20319,10,428,2597,358,9322,70
25829,11,1009,2321,777,10752,232
43633,9,129,905,98,6296,31
31211,0,179,2044,65,3327,114
15610,2,108,2823,78,2162,30
16064,9,510,2803,390,3689,120
45839,40,256,314,200,3761,56
37394,124,4245,1726,3268,23956,977
45525,5,58,439,49,2709,9
12805,14,1909,3015,1195,33639,714
27502,1,107,2239,88,4916,19
18240,3,116,2695,97,6419,19
32828,0,0,1964,0,6087,0
27839,10,217,2220,183,2288,34
2601,19,810,3515,607,15319,203
28751,9,447,2167,385,4321,62
32573,21,303,1975,251,4497,52
33585,6,154,1935,123,5934,31
40691,10,190,1500,138,3974,52
14787,101,3033,2866,2056,12957,977
45702,25,240,365,152,5134,88
26954,6,201,2269,150,2264,51
26778,14,373,2278,285,6325,88
39729,7,98,1574,80,3340,18
37493,4,159,1719,130,6417,29
43194,2,69,1046,53,1964,16
4916,21,573,3451,453,10306,120
46054,23,218,217,172,2413,46
44211,26,337,783,268,8186,69
3531,3,304,3498,240,4008,64
3407,12,643,3500,510,4131,133
36261,516,31459,1792,23043,148221,8416
26693,8,595,2282,489,6064,106
8765,15,681,3232,548,19827,133
45705,38,402,362,333,4965,69
1670,2,259,3567,203,6905,56
8783,4,97,3231,71,2347,26
34946,10,447,1876,386,8779,61
37443,26,585,1723,458,9434,127
28318,71,5089,2193,4050,27676,1039
34984,3,143,1875,117,3331,26
41284,63,2129,1433,1410,20877,719
3248,27,1033,3503,852,5932,181
14195,53,2784,2909,2071,28269,713
2026,101,4633,3524,3290,37172,1343
9975,4,162,3164,138,4928,24
22274,0,44,2486,37,3211,7
3169,12,318,3505,240,7516,78
45712,28,350,357,301,8167,49
9229,38,1441,3205,1127,54232,314
3428,521,11166,3500,8578,66214,2588
38310,11,211,1663,174,3818,37
36159,100,4788,1797,3584,32693,1204
14647,30,2928,2876,2174,27567,754
9885,7,62,3168,55,3706,7
4100,3,80,3483,65,2334,15
37602,1,52,1712,46,2451,6
10256,391,25136,3150,16043,104093,9093
45229,155,1568,521,1215,6792,353
22529,4,360,2474,298,5421,62
2955,41,1917,3509,1501,23068,416
15629,15,669,2822,536,15478,133
32200,6409,247943,1991,176227,499751,71716
22745,24,509,2464,412,4880,97
24604,56,1939,2374,1554,16069,385
4472,64,2935,3469,1974,17568,961
28026,3,237,2209,206,5847,31
1864,7,248,3528,184,6272,64
5050,82,2271,3444,1314,8925,957
7167,88,4707,3342,3396,18658,1311
46288,1,33,137,28,844,5
4439,18,324,3471,258,10874,66
23488,109,5331,2427,3950,49283,1381
5211,31,732,3434,537,7980,195
32453,19,1417,1981,1089,13626,328
37221,57,705,1736,539,6324,166
43412,42,263,977,211,6865,52
12390,2,124,3039,95,3839,29
33506,1,34,1938,29,2403,5
36480,23,1010,1781,800,13393,210
22675,2,233,2467,204,8865,29
2225,7,189,3521,167,5542,22
2624,4,389,3514,299,6220,90
44768,3,47,677,21,1865,26
31591,41,1335,2023,988,18870,347
18534,3,162,2684,129,3649,33
34774,7,310,1887,249,8453,61
33440,9,234,1941,183,4364,51
29139,19,589,2148,455,6037,134
3006,2,107,3508,74,4466,33
4743,2,10,3459,9,2492,1
9287,167,6430,3202,3943,19562,2487
36016,37,1018,1807,869,13668,149
7557,263,121358,3320,47253,47106,74105
30576,15,541,2073,445,11278,96
1051,3,64,3815,56,3166,8
5693,94,3076,3409,2328,30550,748
39490,2,83,1587,70,3327,13
35375,18,592,1855,480,11500,112
12752,18,742,3019,584,9382,158
37957,3,137,1687,109,7055,28
41491,7,196,1403,166,9143,30
35498,4,160,1846,128,3607,32
9045,3,111,3217,92,5419,19
20202,19,197,2602,156,6737,41
11824,2055,197881,3068,123820,617193,74061
11787,2,93,3069,77,3291,16
5369,13,398,3426,310,9718,88
40086,0,621,1550,406,10809,215
5613,9,436,3415,337,8963,99
19674,12,722,2633,568,10372,154
34652,12,224,1893,185,3251,39
9452,16,579,3190,468,13043,111
36994,111,3131,1751,2435,18423,696
12993,155,3776,3003,2789,13028,987
11259,26,1251,3096,963,28249,288
15580,131,5771,2825,4442,59673,1329
6838,131,4482,3360,3458,24876,1024
29180,0,25,2146,22,2131,3
35445,104,1088,1850,799,6411,289
3583,23,2210,3497,1796,14462,414
8325,15,590,3261,439,13800,151
29494,3,54,2129,47,2847,7
3598,16,330,3497,252,4507,78
31805,49,2020,2012,1567,17087,453
6139,2,65,3390,47,2717,18
21681,13,362,2518,305,2109,57
10383,278,22234,3145,16060,42394,6174
17603,57,3120,2724,2209,10879,911
13564,21,1189,2955,910,18719,279
29877,10,282,2110,244,6838,38
14439,12,1220,2891,828,15947,392
34275,33,986,1912,727,15434,259
46182,8,110,166,58,2573,52
40905,11,347,1480,281,17828,66
27994,0,138,2211,119,3821,19
11041,6,90,3109,79,2461,11
5071,29,566,3443,379,5280,187
13894,93,6516,2930,4308,44439,2208
41967,6,189,1323,141,4817,48
13999,2,214,2921,145,3897,69
20859,1,92,2567,71,2528,21
19225,1,49,2655,39,5541,10
2271,24,997,3520,813,51543,184
12148,29,782,3052,587,9947,195
13264,70,4815,2980,2999,41579,1816
39935,4,200,1560,167,6773,33
43327,2,62,1006,44,2072,18
26432,252,10461,2293,8078,82217,2383
38402,21,808,1657,664,11364,144
18291,26,1781,2694,1283,26718,498
43133,11,133,1062,111,4978,22
4498,94,3127,3469,2299,18947,828
30759,15,331,2064,276,7350,55
4331,85,2318,3475,1714,12533,604
35408,32,857,1853,699,13951,158
37321,18,528,1730,439,5757,89
9722,46,1146,3176,910,9170,236
4651,25,866,3463,728,7701,138
35129,0,93,1867,71,5137,22
38869,1016,31391,1625,22719,208085,8672
40222,6,256,1542,203,7245,53
28381,6,324,2189,270,6846,54
15444,6,163,2832,131,3061,32
16207,30,2643,2797,1998,54636,645
44031,7,114,816,99,2557,15
28153,11,526,2202,446,7319,80
37732,7,438,1704,290,15133,148
31699,17,1710,2017,1331,10109,379
4170,45,1193,3481,955,11507,238
33119,20,278,1952,216,3698,62
23778,8,290,2414,215,5148,75
44872,35,324,645,277,5715,47
7852,11,430,3299,337,14377,93
34633,9,263,1894,189,3675,74
4337,13,425,3474,356,5767,69
33603,3,80,1934,60,2113,20
25107,0,908,2353,689,13391,219
24282,6,577,2390,442,10116,135
43657,21,302,896,203,5613,99
12136,8,472,3053,380,7573,92
40531,3,196,1514,142,6445,54
6578,34,1074,3372,728,9401,346
41550,389,11130,1396,7889,83894,3241
39016,6,200,1616,154,3662,46
28118,8,395,2205,336,5377,59
18507,399,17337,2684,12254,62222,5083
23491,12,437,2427,339,8433,98
17747,177,12287,2718,8890,43089,3397
22271,31,5371,2486,3733,38130,1638
24156,14,542,2396,367,4619,175
8888,11,779,3225,608,9006,171
29398,32,1940,2134,1588,14350,352
28768,0,36,2166,33,1718,3
20499,12,640,2588,549,5690,91
1246,14,637,3756,470,5460,167
37366,293,5868,1728,4321,36308,1547
12554,108,8062,3030,5336,61156,2726
36858,7,210,1758,170,2946,40
30728,8,93,2065,83,5484,10
15868,2,76,2813,55,5258,21
23733,35,1252,2415,1016,8956,236
14283,42,1980,2903,1621,37507,359
36490,3,156,1781,125,2987,31
23647,0,0,2419,0,6104,0
16377,47,4613,2788,3251,33830,1362
40547,2,38,1512,29,2605,9
8662,29,1073,3238,867,12293,206
15995,37,1120,2807,875,15772,245
4128,7,209,3482,156,2477,53
4476,13,208,3469,160,14755,48
33116,11,811,1952,630,8213,181
2639,10,262,3514,218,4107,44
33186,4,129,1950,104,3398,25
6110,88,2232,3391,1559,27212,673
36064,41,430,1803,312,3815,118
28416,2,178,2187,158,3617,20
20290,11,676,2597,538,13519,138
35012,1,215,1873,168,7490,47
27608,0,36,2233,32,2406,4
38745,4,151,1633,118,8685,33
29676,244,5305,2120,4108,23766,1197
5192,10,187,3436,152,7408,35
21267,7,202,2541,148,1837,54
2428,43,1445,3517,934,10305,511
13138,21,656,2994,521,9885,135
38509,1,72,1649,63,4901,9
36509,12,139,1779,121,6220,18
12666,24,2514,3023,1904,27187,610
14680,2,277,2874,208,4588,69
25007,1,69,2358,62,8278,7
18457,2,99,2687,71,5028,28
41783,0,87,1356,63,5167,24
25772,15,719,2323,544,14852,175
36476,4,151,1782,125,4286,26
5804,3,80,3405,66,2884,14
43154,6,232,1056,153,2656,79
12645,2,54,3024,47,6622,7
27952,113,1693,2213,1428,16364,265
32173,6,260,1993,232,11237,28
17237,427,23261,2741,16253,125316,7008
10816,1,81,3120,56,2941,25
11026,1,171,3109,128,6955,43
38359,6,84,1659,68,7548,16
17754,14,1499,2718,1139,15091,360
3927,64,3022,3489,2259,18019,763
12400,4,175,3038,144,3775,31
33237,8,260,1948,201,5582,59
10261,1,132,3150,93,5207,39
42305,25,723,1259,547,8926,176
44755,13,66,681,60,5559,6
37049,0,141,1747,113,5161,28
40606,4,108,1507,88,1661,20
5120,111,3311,3440,2507,40373,804
17046,26,2233,2753,1532,18931,701
31530,80,1998,2026,1497,9751,501
13459,26,1357,2963,845,15481,512
34561,11,166,1899,140,15096,26
21753,3,78,2515,66,3257,12
45376,4,29,478,22,1353,7
14322,3,107,2899,65,1587,42
43276,47,1103,1020,830,12660,273
22524,4,385,2474,277,6145,108
14900,13,804,2860,623,4827,181
27561,0,104,2236,80,7085,24
19791,16,628,2625,477,8524,151
33424,68,1541,1942,1181,11830,360
26787,87,3504,2277,2686,14643,818
25945,12,1018,2315,810,13541,208
25556,4,168,2334,151,3121,17
18248,1,148,2695,124,7283,24
21939,5,148,2505,113,3395,35
8323,4,298,3261,190,8690,108
8930,31,758,3223,600,8487,158
3491,12,516,3499,418,7729,98
28142,2,85,2204,72,4064,13
29138,23,2200,2148,1179,13612,1021
37639,1,88,1710,71,3134,17
6035,6,328,3393,274,4551,54
21402,87,1558,2534,1209,7812,349
30169,24,544,2097,462,9148,82
40900,2,70,1480,61,10715,9
39779,11,360,1572,286,5324,74
29495,416,20811,2129,14013,116656,6798
18127,10,660,2701,507,10124,153
17540,6,1020,2726,806,8171,214
3494,31,602,3499,502,11229,100
43625,20,193,908,180,10181,13
19269,5,232,2652,144,10418,88
38618,25,769,1641,584,18894,185
38513,31,679,1649,554,11505,125
8351,6,251,3258,180,4064,71
24923,5,208,2361,181,10512,27
3114,182,9693,3506,6924,57737,2769
2530,96,2568,3516,1917,30080,651
31018,123,3816,2053,2929,18190,887
21730,31,2894,2516,2101,15951,793
2297,41,969,3520,778,16311,191
24560,14,246,2377,188,4549,58
37103,59,633,1744,491,6074,142
3279,8,185,3503,134,6382,51
18598,3,319,2681,261,8663,58
5356,33,852,3427,563,17210,289
33425,33,818,1942,654,8670,164
31477,56,4513,2029,3388,47801,1125
40596,438,10942,1508,7842,78660,3100
13434,6,283,2966,228,5955,55
45077,26,620,578,474,6339,146
15559,11,462,2826,387,8509,75
8092,60,1504,3275,1229,15746,275
12616,25,581,3026,446,8140,135
4285,2,37,3476,29,2013,8
29055,5,151,2152,115,3028,36
9935,3,146,3166,122,6765,24
3485,111,4723,3499,3774,18541,949
20624,0,764,2582,625,26838,139
21795,57,3538,2512,2501,31352,1037
43767,26,301,861,257,3935,44
43599,52,745,917,634,22415,111
5663,55,1743,3411,1119,8971,624
28245,472,53496,2197,39150,181318,14346
10312,613,23713,3148,17832,310021,5881
4156,4,28,3481,22,2167,6
20219,10,255,2601,208,12727,47
6294,34,1295,3384,920,12086,375
6025,42,1383,3394,1065,22022,318
24522,2,271,2379,223,7227,48
25562,17,619,2333,463,4698,156
9983,348,6658,3163,4377,26455,2281
25693,13,813,2326,648,5972,165
23054,2,176,2448,130,3260,46
16989,57,1974,2757,1529,10264,445
32279,1,19,1988,15,2099,4
9654,29,879,3178,599,5701,280
12887,10,284,3011,231,6788,53
15337,1,200,2836,178,10772,22
8608,50,1188,3242,947,32367,241
9208,261,10802,3206,7867,41535,2935
6315,11,143,3383,125,9525,18
11675,3,47,3075,42,2947,5
29189,6,303,2146,245,7676,58
16768,21,915,2768,698,10567,217
6276,20,758,3385,532,6910,226
42070,5,91,1307,74,3837,17
26141,118,9241,2307,6799,35565,2442
11179,97,7787,3101,5659,64756,2128
38529,152,3813,1647,2849,37387,964
23150,896,29376,2444,19921,143285,9455
27225,1,68,2257,53,3160,15
21200,20,1649,2545,1175,23950,474
32076,15,452,1998,303,4956,149
22269,85,2327,2486,1908,12194,419
29279,21,479,2141,389,7094,90
26387,0,63,2295,53,1669,10
14542,24,1055,2883,757,5164,298
37185,28,1163,1739,860,16581,303
13770,6,377,2940,315,4395,62
5878,9,174,3401,136,8476,38
7231,2,101,3339,80,4544,21
41155,2,86,1454,69,11572,17
19865,31,1402,2621,1081,12995,321
8625,2,19,3241,14,1253,5
44697,222,3019,701,2551,25293,468
5909,1,186,3399,153,7237,33
45055,14,180,588,135,7924,45
24957,11,968,2359,806,12640,162
2798,58,2391,3511,1867,17068,524
7233,51,1330,3339,1042,23205,288
24149,0,34,2396,30,2345,4
1658,13,531,3570,442,4342,89
31277,21,1906,2040,1519,10700,387
40322,17,538,1535,343,8434,195
30973,393,30893,2055,22711,181912,8182
34415,55,1637,1905,1233,7767,404
8056,2,53,3276,44,2826,9
18804,45,1530,2671,1125,14621,405
11638,34,2386,3077,1948,18296,438
11272,18,422,3096,314,6624,108
40017,20,371,1555,277,10162,94
36846,19,424,1758,327,11474,97
14484,0,126,2887,102,4456,24
14358,108,3450,2896,2607,38619,843
2646,10,406,3514,314,5276,92
8198,201,6213,3269,4719,62740,1494
35361,26,346,1855,284,4393,62
3935,1,220,3489,171,4419,49
40492,33,891,1517,578,6646,313
25683,13,651,2327,471,11710,180
27150,67,2218,2261,1767,14514,451
41714,1,90,1370,80,2853,10
7635,1,108,3315,83,3694,25
42157,53,1023,1289,827,10624,196
4863,6,317,3454,242,5090,75
41191,0,7,1449,6,988,1
41158,139,3508,1454,2531,39186,977
29137,265,11404,2148,8200,53221,3204
2882,75,3765,3510,2716,18077,1049
18251,615,30524,2695,21488,110193,9036
38018,8,252,1684,214,3940,38
44511,65,860,743,700,10131,160
11658,16,623,3076,486,13326,137
43260,7,190,1025,132,2773,58
36575,27,310,1776,262,4032,48
8598,8,717,3243,566,9241,151
20147,19,433,2606,318,4196,115
19545,5,600,2639,487,5333,113
41506,3,73,1401,62,8471,11
37875,69,651,1692,494,6731,157
7012,2,61,3351,53,2651,8
9528,36,610,3186,478,6032,132
29230,23,366,2143,296,5276,70
25864,5,265,2320,210,2969,55
23764,2,66,2415,54,3660,12
28902,254,17393,2160,8823,89306,8570
39891,131,4051,1563,2867,31209,1184
19308,5,162,2650,138,2889,24
24355,17,608,2387,494,17132,114
37320,15,318,1730,243,3068,75
19364,9,376,2647,297,13217,79
6343,17,318,3382,266,10161,52
7370,52,2702,3331,1958,10617,744
31536,15,397,2025,320,4148,77
21228,2,140,2543,108,3345,32
9118,85,2309,3212,1622,17775,687
28653,247,7524,2172,5153,41547,2371
39883,6,191,1564,155,5776,36
33317,11,571,1946,470,11441,101
27313,0,48,2252,38,1749,10
39010,5,143,1617,102,2287,41
32747,496,11590,1968,8896,47825,2694
27202,4,209,2258,179,10573,30
10722,4,314,3126,243,10871,71
14363,24,788,2896,647,23898,141
19207,49,826,2655,644,14206,182
20018,9,435,2612,328,5909,107
12687,32,1411,3022,1104,12700,307
33323,170,7713,1945,5862,48699,1851
40050,21,733,1552,538,11891,195
3573,105,8948,3497,6612,90089,2336
27097,12,352,2265,272,3811,80
32794,64,4254,1966,3239,27604,1015
4395,19,556,3472,405,8965,151
16090,3,523,2802,401,6465,122
30359,38,1093,2085,826,13722,267
37737,2,113,1703,94,3856,19
5365,36,1396,3426,1148,12306,248
46110,0,8,200,4,856,4
19337,21,712,2649,511,5691,201
9631,3,67,3180,52,3130,15
39565,2,191,1583,143,9038,48
4272,8,475,3477,327,11957,148
45550,3,54,427,32,4567,22
36216,22,365,1794,272,7718,93
23432,5,151,2430,115,7409,36
37515,58,2487,1718,1694,42657,793
29647,7,478,2122,361,5624,117
23891,4,308,2409,236,5335,72
34484,358,19091,1903,12853,141292,6238
2335,58,4953,3519,3358,42372,1595
45407,32,275,468,215,4354,60
28313,35,731,2193,599,15798,132
15714,18,595,2819,456,4978,139
39231,17,236,1602,180,5944,56
37613,450,20685,1711,15054,117446,5631
2995,1,250,3508,212,6796,38
39598,25,1016,1581,736,16221,280
43822,8,58,848,52,1222,6
7227,15,400,3339,314,10676,86
26481,4,361,2291,315,4450,46
36063,13,324,1803,260,11515,64
30725,4,291,2065,229,4473,62
16411,44,1456,2786,1097,11957,359
4682,18,782,3462,594,8526,188
33938,1,108,1923,90,9624,18
31290,14,656,2039,495,6562,161
19012,138,8370,2664,6061,25372,2309
10260,16,309,3150,257,4114,52
29995,13,823,2105,692,11992,131
21806,29,778,2512,543,4030,235
6812,60,1647,3361,1369,19141,278
20798,12,430,2571,298,7371,132
10397,10,538,3144,351,11792,187
41501,16,293,1401,229,7739,64
45269,158,6094,507,4145,39470,1949
35724,20,668,1828,559,8556,109
14570,31,783,2881,601,10360,182
40680,28,652,1501,490,18833,162
14426,18,847,2891,623,9904,224
2739,17,615,3513,454,12734,161
40104,1,33,1549,23,3667,10
24390,0,1346,2385,1024,12721,322
20337,14,1085,2596,822,6441,263
2306,20,351,3520,286,14060,65
24597,1,56,2374,44,2269,12
2621,20,706,3514,591,7737,115
14229,63,2933,2907,2322,29059,611
29212,0,157,2144,125,3315,32
8258,1,10,3265,9,1668,1
38131,1,82,1675,69,3086,13
31918,80,3523,2007,2785,44209,738
4191,891,44187,3480,29755,127801,14432
25476,19,606,2338,471,9528,135
42609,9,189,1197,126,4086,63
45926,45,1480,2427,1241,7780,239
2577,67,2901,3515,2338,56603,563
3960,51,1730,3488,1478,17190,252
27914,19,686,2215,532,11567,154
45482,69,1119,451,833,7735,286
34970,1,63,1875,57,3116,6
33210,38,3653,1949,2682,14565,971
20850,66,3591,2568,2764,21823,827
15647,34,3154,2822,2332,30036,822
4993,3,21,3447,17,2437,4
38230,0,2,1669,1,113,1
16724,15,1499,2771,1061,20121,438
2759,3,45,3512,33,9378,12
25199,17,1180,2349,934,11418,246
10085,379,16267,3158,12767,46263,3500
43907,6,116,838,86,3623,30
15865,37,5891,2813,4466,44387,1425
19425,1,312,2644,217,7196,95
11549,3,142,3081,111,2843,31
11141,22,700,3103,578,14059,122
16337,4,333,2791,271,11807,62
42631,18,330,1194,212,8113,118
28166,26,600,2201,474,6107,126
14032,98,4209,2919,3269,16143,940
24217,0,87,2393,60,3613,27
22142,19,622,2493,464,13895,158
35951,93,1332,1812,1019,14233,313
13834,2600,373480,2936,264198,641064,109282
37822,24,776,1696,623,12154,153
17611,19,761,2723,613,6381,148
16371,3,225,2788,186,3989,39
5739,3,64,3408,50,2104,14
2101,32,846,3523,684,7231,162
4424,9,250,3471,214,4134,36
20696,3,206,2577,169,2849,37
10170,91,7483,3155,5615,74649,1868
3589,15,322,3497,223,4423,99
46129,7,108,191,77,2897,31
26034,0,25,2311,23,2514,2
2748,1,59,3512,48,4655,11
29447,55,2692,2131,2010,25828,682
25605,2,178,2331,145,7240,33
4875,13,304,3453,264,7456,40
11986,48,1463,3060,1082,26225,381
28135,38,1544,2204,1265,22586,279
44957,20,234,621,201,3812,33
33415,6,122,1942,91,1856,31
10495,3,228,3139,183,2838,45
45243,11,121,518,82,1666,39
38187,75,2013,1672,1569,34356,444
36192,14,399,1795,314,9275,85
8684,24,751,3237,641,11165,110
35301,4,216,1857,181,4489,35
18979,85,2339,2665,1752,11338,587
5473,8,175,3421,138,4097,37
19973,3,129,2615,108,5581,21
3946,6,103,3488,91,12237,12
20781,0,63,2572,52,2104,11
25310,1,151,2345,123,2634,28
36462,66,2348,1782,1827,27926,521
6303,4,46,3384,33,3545,13
5687,9,128,3410,99,2191,29
36702,1,82,1769,63,4046,19
11992,1,166,3060,116,6772,50
11085,2,84,3106,54,4517,30
26138,4,386,2308,300,7967,86
22516,1,75,2474,60,3454,15
27138,116,2148,2262,1550,10820,598
12539,2,109,3031,86,2456,23
11492,2,61,3084,42,2575,19
41187,34,992,1450,694,9409,298
2144,71,3674,3522,2607,25694,1067
36733,9,202,1767,161,5837,41
29717,40,909,2118,730,7354,179
18903,25,685,2667,537,4570,148
17704,18,529,2720,385,5678,144
15465,53,2684,2832,2196,18238,488
15680,2,72,2820,59,3459,13
9999,3,163,3163,118,4860,45
32136,25,651,1995,502,17056,149
46022,3,76,235,51,2002,25
43882,43,739,843,632,14813,107
45507,2,36,445,27,1747,9
25091,285,7829,2354,6004,37005,1825
25067,6,287,2355,214,5380,73
14674,13,990,2875,765,13780,225
4646,12,121,3463,101,3670,20
36050,15,386,1804,330,13119,56
6687,5,23,3367,21,2102,2
18698,83,1686,2676,1283,11935,403
41108,103,1168,1459,851,9470,317
42434,31,601,1232,459,7866,142
7578,37,1721,3318,1271,19901,450
8144,37,1048,3273,788,7326,260
11913,4,117,3064,93,3233,24
2553,21,1771,3515,1444,16808,327
13663,3,574,2949,489,17550,85
42722,120,2361,1173,1589,34128,772
41810,1,42,1349,36,4354,6
10376,71,2562,3145,2057,27477,505
27383,6,451,2247,377,9390,74
13133,463,33551,2994,22694,253534,10857
26621,94,4821,2285,3823,53670,998
45891,3,40,294,30,1530,10
44565,72,1197,732,960,18686,237
2433,4,194,3517,150,4204,44
34075,9,166,1918,134,5929,32
11889,6,103,3065,94,1766,9
32344,32,1392,1985,1035,17869,357
21311,13,461,2540,285,10518,176
33067,57,2462,1954,1929,14598,533
22010,5,213,2500,166,4412,47
39817,11,584,1569,419,8180,165
6776,24,2044,3363,1438,22582,606
42035,76,1064,1313,838,17238,226
40387,20,577,1527,420,4881,157
28136,1,107,2204,90,3279,17
18197,148,6013,2698,4480,30449,1533
40758,42,1230,1493,975,13526,255
25027,9,367,2357,322,9368,45
18083,10,512,2702,439,5501,73
3419,66,2630,3500,2061,51769,569
14173,24,671,2911,535,6036,136
15649,30,3273,2822,2484,54807,789
5126,11,212,3440,166,6999,46
18501,72,2618,2685,2002,18202,616
39720,234,4976,1574,3744,19834,1232
29332,7,214,2137,172,10708,42
25999,5,368,2313,313,14031,55
14019,24,1432,2919,1156,29585,276
44042,64,1175,814,1031,29730,144
1965,5557,397490,3525,256695,1444868,140795
18151,7,469,2700,361,8800,108
13531,55,3726,2958,2776,16137,950
13864,17,979,2933,764,9164,215
7683,4,691,3312,336,9321,355
38149,8,146,1674,115,3324,31
4647,13,135,3463,109,6781,26
35127,65,914,1867,682,6584,232
12249,1645,143808,3047,85193,634152,58615
25846,45,1492,2320,1136,13703,356
36382,7,492,1786,373,17139,119
28077,9,532,2206,445,6874,87
14308,99,7181,2900,5281,47476,1900
34278,14,985,1912,777,10109,208
11473,193,11210,3086,8430,62499,2780
38383,125,2550,1658,2021,28956,529
42793,81,1109,1153,843,15453,266
22196,26,1181,2490,925,15419,256
16909,36,3393,2761,2626,27884,767
45116,310,6095,555,4651,65946,1444
46090,71,917,207,849,13515,68
4538,14,273,3467,204,13913,69
15132,12,649,2847,560,13727,89
13161,17,770,2985,545,9683,225
20811,11,528,2570,419,6682,109
34996,62,4905,1874,3801,33804,1104
4654,117,6645,3463,4638,22452,2007
31079,12,236,2050,198,5316,38
38994,22,735,1618,593,8586,142
7197,10,377,3340,274,8848,103
37092,11,364,1744,305,13029,59
4991,137,6571,3447,4769,41064,1802
13641,4,116,2951,89,4425,27
6452,86,2721,3377,2058,29450,663
10991,165,6313,3111,4825,29759,1488
32746,10,357,1968,272,5840,85
18461,98,1856,2686,1429,9214,427
9272,20,920,3203,728,14324,192
35312,47,470,1857,380,4147,90
23250,46,5586,2439,4070,28329,1516
29201,5,193,2145,154,6117,39
1708,1,14,3562,12,2634,2
21004,21,1015,2557,843,6391,172
3640,41,875,3496,679,20994,196
26887,0,227,2272,175,9655,52
2357,58,448457,3519,128059,16300,320398
36924,69,2148,1755,1483,30256,665
43274,25,289,1021,202,3838,87
10996,86,5125,3111,3451,36088,1674
11345,30,897,3093,682,8320,215
45391,3,36,473,33,1198,3
15541,13,692,2828,545,6214,147
12767,28,1656,3017,1219,13247,437
20779,53,830,2572,593,5997,237
30931,24,663,2057,550,8008,113
2904,8,190,3510,163,3546,27
26066,2,97,2310,83,3313,14
21640,92,1989,2521,1526,8048,463
23127,19,1409,2445,979,6148,430
10799,11,1054,3121,828,9513,226
21787,63,2918,2513,2232,38006,686
14801,0,42,2864,32,5629,10
14252,0,31,2905,24,2769,7
11205,150,4197,3099,2917,35813,1280
5474,32,678,3421,553,11077,125
25336,52,1149,2343,862,7092,287
20565,2,63,2584,55,3213,8
1972,35,1155,3525,904,15953,251
4849,18,392,3455,314,4181,78
21761,7,352,2514,279,6980,73
34417,2,89,1905,72,5329,17
15421,6,240,2833,188,5078,52
22246,0,34,2487,28,4083,6
7357,8,100255,3331,38429,5414,61826
3463,15,263,3499,218,12348,45
12416,11,1702,3036,1237,15517,465
28561,45,1011,2177,776,13552,235
34745,6,1312,1888,976,25796,336
24430,174,15055,2384,11488,72489,3567
26734,6,146,2280,124,1981,22
3756,162,7376,3493,5658,34747,1718
7265,3,143,3337,100,8818,43
20886,2,95,2565,76,2294,19
38040,5,124,1683,107,4952,17
25394,41,2672,2341,2015,24666,657
25709,99,3403,2326,2645,36448,758
42528,37,782,1213,569,17479,213
40814,52,1529,1488,1195,19566,334
28948,10,553,2158,465,7416,88
4318,82,3009,3475,2277,17177,732
45690,54,837,371,625,12626,212
42076,15,582,1305,419,11650,163
21388,195,10076,2535,7010,51419,3066
42822,23,462,1148,385,22294,77
9400,112,6596,3194,4236,54058,2360
46325,4,72,119,57,1397,15
39724,5,105,1574,89,2293,16
40054,0,16,1552,11,1020,5
11829,5,139,3068,111,3753,28
17975,4,486,2708,375,9071,111
29347,155,5657,2136,4331,43950,1326
14211,3,116,2909,85,2713,31
16359,7,165,2789,128,3678,37
11718,3,118,3073,84,11869,34
38446,1,37,1653,33,2966,4
2993,20,567,3508,437,11439,130
45894,2,120,294,86,3789,34
22627,6,14,2470,14,6042,0
33500,149,10737,1938,7692,81091,3045
37684,5,156,1707,133,2695,23
18323,34,5151,2692,3621,22534,1530
17437,188,10588,2731,7687,54005,2901
35794,0,17,1823,15,1653,2
2950,33,871,3509,699,23950,172
1121,5,72,3797,63,3865,9
5272,119,4236,3431,2960,20339,1276
41917,14,510,1332,378,12727,132
34591,20,818,1897,563,5714,255
41481,43,1285,1405,991,32143,294
940,7,647,3855,453,6535,194
26410,74,2729,2294,2148,12774,581
40928,34,760,1478,551,13800,209
24762,77,3307,2368,2357,28825,950
14101,14,608,2914,464,12318,144
5038,110,3456,3445,2558,17618,898
12236,18,1226,3048,919,16833,307
42200,4,161,1279,121,3801,40
46012,40,435,239,284,5270,151
29391,170,5918,2134,4322,45228,1596
23315,19,1102,2436,848,22986,254
4000,37,1122,3486,832,17172,290
35011,21,381,1873,293,10077,88
5887,27,1210,3400,968,16791,242
31753,143,6368,2014,4653,25158,1715
15844,3,231,2814,174,3775,57
38331,7,169,1662,128,5157,41
40227,4,233,1541,181,6509,52
3562,31,1478,3497,1164,29258,314
38313,325,6174,1663,5095,26925,1079
22832,0,115,2459,88,4218,27
27219,37,1295,2257,950,14842,345
32529,34,2197,1977,1776,33411,421
46112,10,116,199,87,1065,29
39447,0,0,1590,0,3740,0
38156,19,706,1674,533,13315,173
30352,2,102,2086,84,4205,18
32724,24,305,1969,248,2863,57
16152,27,979,2799,766,14857,213
29887,19,687,2110,487,5871,200
15003,12,1326,2854,881,13285,445
2130,12,389,3522,321,8501,68
9007,15,617,3219,418,17515,199
19047,11,515,2662,408,5587,107
42776,8,133,1160,98,2598,35
22658,11,749,2468,521,7777,228
10901,110,5347,3116,4048,24683,1299
8514,27,696,3248,496,4601,200
29363,3,257,2136,203,3974,54
23744,13,715,2415,487,6031,228
23465,5,378,2428,318,5132,60
40839,66,1447,1485,1015,15710,432
11565,2,78,3081,60,1147,18
26646,0,30,2284,25,2159,5
7212,163,9307,3340,6571,55815,2736
32251,8,267,1989,223,3879,44
4336,4,339,3474,263,7803,76
9921,1,57,3167,48,2272,9
11470,2,66,3086,53,3468,13
18980,4,155,2665,121,3702,34
37383,31,536,1727,393,6030,143
8675,4,200,3237,164,8049,36
25174,1,80,2350,63,3121,17
45065,34,316,582,276,4640,40
1454,9,288,3626,234,4112,54
5011,1260,66492,3446,45603,263801,20889
11625,12,644,3078,523,9015,121
39036,164,4728,1615,3267,43469,1461
17607,9,274,2723,230,5285,44
39428,1,112,1591,81,5200,31
41057,40,2077,1465,1274,19422,803
3075,118,4281,3506,3087,13331,1194
25665,3,221,2327,178,9386,43
22263,4,235,2487,213,4035,22
40671,5,178,1502,134,4452,44
46189,8,64,164,49,1899,15
43806,24,317,853,252,5688,65
40754,111,3228,1494,2296,38443,932
17190,88,3482,2744,2470,28825,1012
7266,26,601,3337,450,14565,151
23568,30,1615,2423,1222,19342,393
3593,4,227,3497,189,7056,38
14659,79,3975,2876,2911,21960,1064
4784,4,208,3458,180,6808,28
19397,3,238,2645,176,9511,62
18119,5,282,2701,207,15224,75
45738,13,203,346,139,2636,64
8588,3,355,3243,273,8954,82
11248,91,2256,3097,1771,46857,485
38496,29,1637,1650,1273,19732,364
45007,16,126,606,101,3979,25
38655,123,1444,1638,1127,10299,317
21503,12,320,2528,288,3964,32
14871,6,268,2861,217,8361,51
25291,1,69,2345,57,3458,12
25480,27,889,2337,756,13244,133
27191,0,64,2259,59,2582,5
14857,88,31143,2862,11805,45292,19338
23847,20,527,2411,416,4728,111
3359,58,1891,3501,1392,23761,499
21218,4,167,2543,136,8615,31
26127,3,67,2308,56,2180,11
16824,318,24457,2765,16957,182705,7500
40325,91,3749,1535,2249,94859,1500
4594,118,2387,3465,1854,44061,533
13911,15,769,2928,520,18576,249
27486,15,643,2240,459,9445,184
7457,24,109445,3326,42563,15454,66882
12889,22,987,3011,795,8325,192
14868,116,3853,2861,2809,12579,1044
22177,85,3774,2491,2744,48260,1030
31595,119,2475,2023,1842,14226,633
23489,95,9022,2427,6817,41863,2205
11923,6,276,3063,207,7001,69
26766,15,354,2278,285,6314,69
17625,32,1962,2723,1512,11736,450
5915,25,497,3398,379,4695,118
6713,22,713,3366,594,5105,119
8079,1,35,3276,30,2009,5
40471,302,10570,1519,7821,67270,2749
30674,7,196,2068,159,6215,37
5955,2,47,3396,33,5259,14
7165,2,39,3342,33,2368,6
41507,61,1932,1401,1480,18421,452
39974,21,610,1557,474,11771,136
31689,18,600,2017,503,9617,97
8113,434,15091,3274,11059,65418,4032
6021,960,27265,3394,19543,165014,7722
39149,80,3681,1607,2835,26135,846
21824,32,2277,2511,1505,9378,772
26472,76,1981,2291,1595,11775,386
5794,18,639,3405,479,4401,160
7484,359,20032,3325,11106,75238,8926
2227,154,17388,3521,12006,50816,5382
37983,7,248,1685,208,6242,40
18155,0,11,2700,9,1454,2
4126,1298,42206,3482,30050,151267,12156
22489,22,1675,2476,1451,16468,224
15418,22,1143,2833,872,10475,271
32732,55,2947,1969,2053,28650,894
15094,17,1006,2849,724,13658,282
10224,2,53,3152,32,3041,21
34830,251,16338,1882,11308,35860,5030
29898,8,271,2109,200,4364,71
19129,4,103,2659,82,1306,21
10386,1,30,3145,23,1570,7
40988,28,1331,1473,986,12497,345
17224,83,3846,2742,2957,41606,889
34138,3,120,1916,103,2612,17
4947,56,1934,3449,1551,9674,383
26543,252,16455,2288,11985,75365,4470
13494,80,3714,2961,2783,43314,931
13966,222,9607,2923,6987,76461,2620
2750,13,299,3512,255,10598,44
7107,51,779,3345,614,7381,165
46235,0,11,153,7,748,4
5994,38,1043,3395,784,10148,259
5784,0,26,3406,17,1665,9
5218,11,440,3434,324,4761,116
36933,4,243,1754,186,7030,57
32806,7,171,1965,146,6204,25
15855,4,77,2813,60,4174,17
5075,61,1632,3443,1109,15026,523
46060,15,301,215,231,2799,70
19913,100,7780,2619,6221,35453,1559
2861,3,66,3511,59,2521,7
41928,30,440,1330,321,9252,119
46005,6,77,243,57,943,20
13034,43,3132,3001,2309,45324,823
42536,10,155,1211,111,5589,44
41497,50,901,1402,651,8234,250
9149,82,1873,3209,1373,12170,500
37395,1,30,1726,24,2404,6
14619,42,3807,2878,2789,68234,1018
2399,70,1149,3518,975,45959,174
17365,31,801,2735,545,6184,256
42541,4,246,1210,165,5608,81
36376,1,73,1786,62,3010,11
5347,76,2467,3428,1904,14276,563
12384,4,279,3039,210,7214,69
24577,8,268,2376,224,7979,44
29124,47,1264,2148,995,7393,269
7322,200,5517,3333,4252,24734,1265
26380,6,310,2295,256,6240,54
46228,14,181,154,139,3079,42
2527,5,105,3516,91,6661,14
25877,18,1061,2319,841,14552,220
43729,19,344,873,302,11175,42
41962,24,586,1324,495,9333,91
23453,28,1178,2429,956,12622,222
3102,2,65,3506,54,2352,11
15379,44,3038,2835,2286,26627,752
8814,33,1733,3229,1339,25064,394
18425,14,1004,2687,811,8683,193
34194,13,250,1915,199,4316,51
32335,8,1083,1985,905,18614,178
3229,27,1041,3504,722,33077,319
29936,5,139,2107,123,7264,16
9472,8,395,3189,292,6891,103
6917,3,77,3356,62,2263,15
38999,148,5701,1617,4179,39765,1522
26352,188,6877,2297,4793,29346,2084
35870,2,99,1818,84,3069,15
22342,72,3013,2483,2227,34119,786
3223,40,1444,3504,1108,19855,336
36388,200,8897,1785,6552,61614,2345
33702,30,1360,1931,991,19287,369
15616,5,118,2823,91,3901,27
4257,29,177419,3478,65115,3605,112304
31123,146,4979,2048,3864,24539,1115
26860,70,1947,2273,1500,12571,447
32334,5,118,1985,101,3589,17
46256,2,22,147,21,2359,1
20307,1,31,2597,26,4776,5
42731,74,2033,1171,1529,22086,504
40741,13,234,1496,185,5433,49
40921,13,525,1478,405,9076,120
16830,6,162,2765,131,2686,31
46211,3,25,157,20,664,5
40825,77,1548,1486,1237,12524,311
15554,18,880,2827,634,12824,246
3354,151,6347,3501,4992,56488,1355
32327,0,37,1986,30,2959,7
17785,47,2134,2718,1657,28125,477
26495,4,190,2290,168,4667,22
36461,10,416,1782,331,6045,85
12959,838,48527,3006,34409,461475,14118
30827,119,24156,2061,20022,70063,4134
44947,12,169,624,134,2654,35
31619,23,606,2022,469,12292,137
12630,307,29516,3025,20911,145145,8605
43136,71,1432,1061,1025,20959,407
10482,5,144,3140,102,1512,42
4013,5,151,3486,112,3810,39
37548,58,1340,1715,986,9066,354
4924,15,398,3450,284,5177,114
29449,38,620,2131,518,7833,102
39831,2,146,1568,107,6932,39
19448,2,145,2642,91,6646,54
1951,266,8271,3526,6425,87969,1846
2552,60,1109,3515,739,9202,370
39212,2,358,1604,286,7033,72
38718,4,81,1635,69,3584,12
19492,33,1526,2640,1149,6425,377
41490,8,187,1403,139,5831,48
3809,58,3843,3492,3132,55778,711
12526,1,104,3031,69,3677,35
33842,0,29,1925,26,1965,3
29037,63,1431,2153,1175,24009,256
17640,3,239,2722,169,8755,70
20183,1,138,2604,103,6350,35
28341,38,1916,2191,1457,27275,459
8210,137,3030,3268,2211,43716,819
45165,3,34,538,23,2922,11
5396,39,517,3425,322,10288,195
30057,2,200,2102,167,2614,33
2338,19,886,3519,627,21315,259
21471,338,24650,2531,15954,96643,8696
37836,7,334,1695,243,5797,91
6386,134,3984,3380,2854,22851,1130
13846,1,81,2935,64,9277,17
39027,33,807,1616,610,8639,197
36132,8,379,1798,301,9174,78
29364,16,1501,2136,1238,12664,263
20943,0,124,2561,94,4127,30
10823,81,2563,3120,2003,19816,560
23399,2,92,2431,77,2049,15
18573,252,24975,2682,16688,85212,8287
23964,12,1559,2404,1214,18292,345
44081,10,217,797,161,5445,56
6536,198,8552,3373,6062,50541,2490
3649,14,877,3496,590,17338,287
33381,218,11070,1943,7703,59716,3367
40068,7,543,1551,205,6179,338
21473,38,1189,2530,967,20133,222
29756,8,412,2117,355,6952,57
9171,64,1934,3208,1397,20249,537
8451,94,8596,3253,6245,58204,2351
18272,34,1326,2694,1100,11710,226
5590,10,310,3416,224,5619,86
34468,18,661,1904,530,7913,131
41201,40,1192,1449,856,16489,336
42182,21,1079,1283,763,16228,316
1978,12,479,3525,348,20118,131
4833,86,2292,3455,1795,24833,497
27515,8,581,2239,403,5226,178
9195,41,1280,3207,954,19313,326
19771,5,407,2626,339,4959,68
8063,25,748,3276,548,14594,200
2076,64,4397,3523,2739,21157,1658
13370,760,41474,2972,28635,159591,12839
31669,140,2903,2018,2217,21227,686
11132,58,2025,3104,1620,33797,405
15113,30,3116,2848,2397,22245,719
46048,8,107,219,89,3171,18
28920,68,1507,2159,1175,12953,332
29025,5,349,2154,291,13576,58
16672,99,6857,2774,4947,61869,1910
6809,12,155,3361,125,9618,30
29669,34,1940,2121,1441,15047,499
21728,94,4439,2516,3369,37714,1070
13580,39,1685,2955,1384,33134,301
40799,90,3045,1490,2128,34973,917
3264,21,477,3503,357,3149,120
31185,17,453,2044,378,4854,75
24059,28,944,2401,661,8490,283
31734,100,1496,2015,1143,13509,353
5402,7,86,3424,72,2630,14
42003,9,572,1318,436,16464,136
29353,6,200,2136,151,2633,49
31697,18,548,2017,423,7462,125
37369,28,1274,1727,884,13939,390
6088,2,45,3392,37,3115,8
41561,536,10342,1395,7814,83948,2528
2500,5,165,3516,118,24728,47
43218,26,158,1038,132,5897,26
6481,29,2007,3376,1517,16751,490
34554,6,158,1899,130,2589,28
24757,6,195,2368,150,2998,45
4016,13,332,3486,252,4247,80
1727,1,99,3555,81,4920,18
15241,74,4360,2841,3332,32485,1028
26604,1,51,2286,36,1489,15
1907,18,668,3527,462,11295,206
38307,2,160,1663,127,4498,33
32540,8,290,1977,239,3764,51
32046,5,363,2000,189,4131,174
19068,59,2703,2661,1761,27908,942
6708,36,1589,3366,1152,28010,437
41200,0,0,1449,0,2542,0
20173,47,3593,2604,2809,13268,784
31254,36,739,2042,596,10142,143
43462,4,36,831,29,1017,7
19228,940,34019,2654,22681,188909,11338
5273,55,2664,3431,2220,13685,444
35476,45,1261,1848,1024,22645,237
7491,18,550,3324,398,12156,152
3256,19,385,3503,323,2639,62
17227,4,226,2742,163,2945,63
21713,64,3197,2516,2675,19664,522
7778,2,44,3305,35,1451,9
24839,9,326,2365,251,8733,75
20081,5,143,2609,106,2250,37
38105,27,1746,1677,1342,19346,404
5478,301,12419,3421,9497,53082,2922
2496,6,292,3516,195,29073,97
9703,3,190,3177,153,3528,37
12732,590,14684,3019,10966,67463,3718
19185,1,200,2656,165,3641,35
22471,5,208,2477,159,15528,49
45447,8,117,459,90,1779,27
17729,24,3220,2720,2603,16279,617
33834,50,1092,1925,900,14591,192
28490,166,6363,2183,4582,64121,1781
45516,1,15,441,12,1581,3
20333,8,570,2596,488,21892,82
13220,216,12939,2982,9543,103269,3396
43411,20,292,978,247,5522,45
37099,6,240,1744,196,3753,44
46074,9,145,209,105,1997,40
23422,4,550,2430,415,8536,135
36988,19,601,1751,495,7814,106
19075,4,728,2661,511,13448,217
39263,17,567,1599,407,29066,160
16744,81,3348,2770,2397,47411,951
12739,187,14644,3019,10449,79533,4195
42595,15,827,1201,571,9606,256
12125,11,87,3054,72,7382,15
5763,9,342,3407,275,3851,67
12368,3,186,3040,162,6469,24
34934,13,498,1877,395,10641,103
30915,115,6123,2058,4696,45448,1427
11612,51,1260,3079,873,16984,387
45798,5,41,327,35,2456,6
43721,41,258,874,222,3088,36
10776,5,289,3123,224,4765,65
17141,4,386,2747,291,5897,95
4832,27,720,3456,591,15292,129
26310,32,804,2299,641,9015,163
36961,4,75,1752,56,6704,19
3506,12,348,3498,146,12867,202
41670,117,1076,1377,811,14283,265
11623,22,1474,3078,1179,33662,295
40605,26,756,1507,567,16267,189
42545,3,97,1209,74,3556,23
42755,212,2309,1165,1874,17510,435
5444,7,97,3423,76,2921,21
33990,47,1097,1920,901,10717,196
15982,61,3640,2808,2772,19149,868
4386,1,136,3473,115,2702,21
12847,6,163,3013,130,2387,33
3402,231,9913,3500,7284,70398,2629
5034,17,328,3445,234,7464,94
29476,5,86,2130,67,2057,19
37275,71,2201,1733,1720,40651,481
26638,35,1016,2284,703,8216,313
25183,29,1227,2349,992,5120,235
28505,7,462,2182,353,5187,109
6813,16,805,3361,653,15471,152
39015,2,269,1616,229,4633,40
1975,15,482,3525,412,9166,70
5164,8,324,3437,228,16345,96
36635,211,8265,1772,6240,59178,2025
15568,2860,704139,2825,404842,1193981,299297
20557,6,1888,2585,1197,11237,691
24073,25,808,2400,628,8413,180
45756,0,20,341,14,1332,6
23548,54,2743,2425,1902,9199,841
2097,27361,1742557,3523,876876,4392937,865681
19972,29,3407,2615,2613,15442,794
14193,19,814,2909,612,9770,202
13270,6,513,2979,402,6931,111
30631,223,7581,2070,5494,37508,2087
3869,81,5107,3490,4046,55641,1061
45951,29,356,264,306,5219,50
15121,2,50,2847,45,4055,5
42113,1,64,1300,47,4608,17
40155,3,75,1547,36,1637,39
8033,492,20352,3277,14220,50168,6132
34245,125,5101,1913,3805,92699,1296
38151,0,16,1674,14,4803,2
13964,17,2371,2923,1781,14984,590
37268,458,15887,1733,12537,92048,3350
27275,130,6495,2254,4569,68066,1926
15708,433,16800,2819,12391,80437,4409
7119,56,2416,3345,1516,20029,900
9624,6,354,3180,283,6602,71
45918,143,1744,283,1417,8740,327
27438,8,416,2244,330,3607,86
23782,4,287,2414,218,5118,69
6308,5,227,3383,155,3952,72
17868,18,512,2714,441,8441,71
8274,46,2365,3264,1722,18436,643
21405,3,323,2534,245,2598,78
29069,12,412,2151,327,7190,85
36470,9,219,1782,180,6456,39
5036,26,600,3445,453,7702,147
6709,13,557,3366,444,7494,113
31034,264,6613,2052,4750,68209,1863
30823,30,1820,2061,1351,37778,469
33445,0,94,1940,84,2276,10
22976,0,3339,2451,2474,23885,865
4629,19,549,3463,434,5821,115
13267,160,8770,2979,5943,56535,2827
16260,13,357,2794,285,4116,72
17424,10,310,2732,240,3066,70
23843,16,891,2411,712,4867,179
16879,241,12066,2763,8265,55055,3801
8899,6,300,3225,202,8036,98
41520,9,190,1400,149,4391,41
4477,2,40,3469,34,3145,6
15979,15,536,2808,438,6975,98
7002,1,71,3351,60,3819,11
15207,2,113,2842,93,5059,20
32896,11,360,1962,298,5829,62
28529,32,1467,2179,1171,10233,296
44048,23,203,813,144,4009,59
11636,2,86,3077,73,4658,13
37978,4,189,1685,132,3088,57
29375,17,322,2135,239,3458,83
19823,17,422,2623,345,7829,77
36447,5,238,1783,190,5249,48
39393,32,2086,1593,1183,22062,903
2977,75,6240,3508,4480,29265,1760
43774,0,14,859,8,1582,6
32071,15,510,1998,356,4214,154
5750,40,1632,3407,1265,14284,367
22319,13,433,2485,343,5398,90
32829,17,585,1964,462,6706,123
4454,17,383,3470,289,12865,94
40689,5,179,1500,127,9216,52
2886,12,569,3510,442,6732,127
26249,6,206,2302,168,2085,38
15077,261,16394,2849,12167,69172,4227
26374,2,95,2296,81,1979,14
21672,3,285,2519,237,5151,48
21134,7,318,2550,250,12588,68
42516,8,352,1215,238,4557,114
41432,4,165,1411,134,4674,31
26462,0,36,2292,29,1848,7
16613,38,4683,2778,3332,32762,1351
8390,19,499,3256,416,6215,83
36827,61,1097,1760,902,6424,195
9093,100,2091,3213,1522,22214,569
42427,17,398,1233,288,4543,110
30004,71,1057,2105,810,7937,247
35163,26,753,1865,626,7475,127
8855,47,2934,3227,2251,61031,683
15514,527,29998,2829,21957,109197,8041
41593,88,1544,1389,1164,11202,380
27720,124,3988,2227,3175,22421,813
6675,4,96,3368,83,3406,13
7559,118,3236,3320,2466,27766,770
41856,7,204,1342,157,7999,47
18780,111,13345,2672,9871,54890,3474
38973,3,69,1619,56,2610,13
17261,4,74,2740,60,7404,14
21847,58,1943,2511,1531,19266,412
27370,8,282,2248,234,4650,48
27741,2,127,2226,103,4122,24
20054,478,21518,2611,15795,146993,5723
25316,50,2682,2344,2212,14575,470
12819,5,254,3015,188,4504,66
30502,12,327,2077,251,9384,76
35421,614,30438,1852,22372,149518,8066
30248,99,4192,2092,2604,18959,1588
22765,7,559,2463,453,16375,106
45729,90,2845,349,2237,12691,608
43836,0,298,846,236,4841,62
21175,836,49480,2546,35929,267881,13551
33153,0,108,1951,87,3501,21
40898,20,493,1480,378,7272,115
31495,25,921,2028,744,8436,177
41117,28,312,1457,249,5615,63
4235,11,363,3478,286,11127,77
38164,11,154,1674,116,2134,38
11352,59,1658,3093,1335,32509,323
8665,1234,57646,3238,39948,177580,17698
2206,34,737,3521,582,15216,155
21411,8,379,2534,312,9675,67
13597,111,7000,2954,5158,43506,1842
6306,103,5185,3384,4008,28979,1177
30984,125,3997,2055,2918,33462,1079
35494,45,503,1847,395,5424,108
24249,0,42,2392,35,2002,7
46297,13,119,132,91,1976,28
39911,5,137,1562,114,3604,23
20706,11,1184,2577,914,9948,270
21403,25,2319,2534,1817,17003,502
36680,1,37,1770,31,2258,6
3999,4,95,3486,78,5149,17
30386,81,1672,2084,1284,16053,388
20956,45,1724,2561,1372,12497,352
42597,71,1749,1201,1308,18486,441
31561,26,509,2024,402,5628,107
12985,227,5663,3004,4159,27586,1504
22098,86,3239,2494,2544,31308,695
41398,38,1581,1417,1127,14068,454
33838,14,567,1925,427,9312,140
9926,207,10910,3166,7892,71832,3018
9708,0,24,3177,15,1236,9
35744,13,423,1827,343,40713,80
30965,1,27,2056,21,3578,6
23160,3,114,2443,93,2602,21
2783,17,361,3512,309,11754,52
7560,32,905,3320,738,23078,167
8255,17,534,3265,405,24143,129
3391,29,908,3501,702,9043,206
40005,115,4496,1555,3249,34220,1247
44911,4,45,636,34,1737,11
4402,11,62,3472,52,6012,10
1135,11,596,3795,441,9363,155
12728,181,18143,3020,12144,91121,5999
45907,3,118,289,87,3413,31
41587,39,1023,1390,759,12731,264
35659,30,1120,1833,855,14681,265
14732,1,123,2870,97,4415,26
20426,569,21850,2591,17908,67223,3942
31693,7,171,2017,130,10159,41
29725,58,2187,2118,1701,18544,486
44304,7,114,773,97,3709,17
7316,20,721,3334,554,17400,167
16190,11,313,2798,246,4132,67
15269,0,41,2839,36,2395,5
38280,1,81,1666,65,4519,16
45344,6,52,486,37,1846,15
32681,19,611,1971,499,7158,112
39616,12,458,1580,367,4758,91
31646,17,702,2020,539,16666,163
37458,9,465,1722,328,7757,137
33869,1,75,1924,50,2464,25
4117,108,3413,3482,2800,43713,613
15422,3,262,2833,201,6288,61
45718,0,21,354,14,922,7
42695,5,166,1178,121,4824,45
46369,31,563,101,480,6143,83
14915,15,522,2859,441,10082,81
35402,10,564,1853,413,4928,151
8180,2,71,3270,53,2140,18
16401,335,14684,2787,11475,143010,3209
17363,32,845,2735,566,5590,279
44158,3,27,794,20,4862,7
32634,38,1843,1973,1310,22912,533
7843,17,464,3300,375,9467,89
26070,26,1246,2310,974,8081,272
17264,1,176,2740,122,3315,54
10558,54,1044,3136,813,9861,231
44119,10,183,802,165,5129,18
27865,146,9885,2219,7200,72589,2685
8629,1,191,3241,163,6148,28
2411,278,13329,3518,9944,68871,3385
17032,3549,482335,2754,312087,1311356,170248
39945,10,439,1559,333,7932,106
19621,4,157,2635,130,4653,27
9512,18,820,3187,627,6166,193
11460,56,1664,3086,1279,10546,385
11217,11,663,3099,534,10134,129
4847,37,2114,3455,1538,14451,576
28231,19,740,2197,584,16846,156
1997,11,1229,3525,505,7912,724
36616,9,761,1773,565,5185,196
15287,20,2172,2838,1607,17304,565
10400,3914,360234,3144,223420,856209,136814
10123,14,242,3157,195,2868,47
12012,9,391,3059,296,8692,95
8632,31,1211,3241,888,25199,323
38771,11,656,1631,514,14850,142
27949,33,2835,2213,2297,19427,538
31074,41,755,2051,607,9404,148
4934,32,330,3450,286,12770,44
25184,0,45,2349,35,1539,10
21765,11,336,2514,271,3162,65
32102,40,2912,1996,2162,36533,750
21625,2,0,2521,0,2162,0
9242,51,2462,3205,1904,24672,558
19476,192,5340,2641,3954,37942,1386
19772,432,25109,2626,15695,67907,9414
14018,1,41,2919,30,2716,11
18018,12,410,2705,284,9208,126
41364,19,507,1422,405,16025,102
38130,5,212,1675,163,5283,49
5199,40,2190,3435,1587,41125,603
39131,5,147,1609,109,4314,38
22695,79,3793,2466,2649,30550,1144
42830,54,1790,1145,1348,17476,442
5796,12,246,3405,208,9899,38
19608,7,441,2636,325,18811,116
28292,24,533,2194,427,5000,106
45938,5,52,268,35,2188,17
1839,31,580,3529,479,11719,101
19518,48,2239,2639,1776,23527,463
45240,10,178,518,145,4931,33
8168,19,498,3271,420,8881,78
26077,0,63,2310,52,2039,11
24998,54,2740,2358,1974,29343,766
35473,3,83,1848,66,3966,17
2002,6,602,3524,481,21939,121
36790,6,134,1763,87,3697,47
45061,35,322,585,247,5436,75
6114,20,424,3391,321,9978,103
9793,3,201,3172,168,7396,33
9329,4,224,3198,173,9574,51
30365,0,47,2085,39,2195,8
10908,9,451,3115,355,8849,96
13586,2,138,2954,110,7428,28
39502,33,828,1587,542,12606,286
8569,37,1121,3244,913,11189,208
43702,55,941,881,697,5265,244
39052,59,1434,1614,1068,11411,366
10798,65,4502,3121,3346,23356,1156
3310,20,1771,3502,1211,14202,560
3408,28,890,3500,662,21462,228
30755,5,116,2064,94,4364,22
45640,189,1917,394,1580,18375,337
12897,36,2482,3010,1966,10492,516
7614,187,4441,3317,3291,41461,1150
42526,9,293,1213,230,5598,63
35523,13,611,1844,499,15705,112
14036,46,2555,2918,1522,16963,1033
43398,44,583,981,481,16386,102
36164,34,742,1796,566,9433,176
42718,81,1417,1175,1074,11660,343
26421,48,1356,2294,1067,8572,289
42669,8,133,1185,102,3168,31
5437,32,872,3423,713,21923,159
31567,211,7027,2024,5072,52327,1955
8762,8,191,3232,141,2813,50
18973,1,182,2665,141,4344,41
23701,4,225,2417,203,11240,22
45496,83,855,447,627,11251,228
42433,8,265,1232,192,6377,73
38486,6,192,1651,160,10024,32
25898,74,3547,2318,2144,17750,1403
39971,44,647,1558,501,13665,146
1832,24,483,3529,398,11698,85
39143,41,1703,1608,1235,22182,468
32656,9,279,1972,232,5068,47
46362,3,105,104,78,1902,27
7055,168,7980,3348,5974,49288,2006
25225,11,326,2348,274,5398,52
34584,54,889,1897,686,9352,203
29731,1,208,2118,177,9124,31
12692,6,293,3022,245,6827,48
25033,3,471,2357,375,6814,96
30348,35,1717,2086,1452,8133,265
20795,2,0,2571,0,9524,0
3247,11,368,3503,311,4796,57
23626,62,2573,2420,2001,18090,572
21615,19,1872,2522,1427,27009,445
45618,23,214,407,193,5816,21
30668,15,1075,2068,830,19700,245
5198,713,25856,3435,18075,128371,7781
4103,26,1509,3483,1079,42292,430
41426,2,128,1412,110,4790,18
37046,9,102,1747,82,4204,20
11928,8,378,3063,308,3942,70
27991,1,67,2211,42,2617,25
2252,7,615,3521,516,15846,99
19513,26,872,2640,705,14104,167
4145,216,5292,3482,4029,77719,1263
5655,3,41,3412,33,3393,8
26088,2,258,2309,213,7880,45
39339,3,94,1595,79,4402,15
26595,21,511,2286,431,6175,80
46039,1,60,225,24,1965,36
18601,14,1284,2681,918,31547,366
16352,24,1079,2789,857,18321,222
45179,1,12,534,6,3359,6
42106,3,90,1300,79,6154,11
6350,217,8965,3381,6841,34621,2124
36857,8,222,1758,169,2919,53
7200,4,159,3340,125,4549,34
4090,38,692,3483,517,7658,175
38895,2,153,1624,128,5300,25
30175,2,329,2096,228,5442,101
20980,790,64934,2559,45738,260971,19196
44787,6,54,672,46,2163,8
4124,1,26,3482,20,1694,6
20151,7,326,2605,271,7484,55
26559,0,12,2287,11,935,1
45252,3,23,513,14,1358,9
43763,27,615,862,392,5535,223
42986,19,613,1106,423,8816,190
10891,1003,55390,3116,38673,221047,16717
42781,123,2346,1158,1776,30012,570
12961,10,549,3006,476,6710,73
15364,4,214,2835,170,4580,44
35792,34,635,1823,505,6208,130
35879,6,93,1817,81,3111,12
14113,2,172,2913,114,4429,58
7044,31,328,3348,246,4262,82
2009,61,1538,3524,1271,16362,267
17666,34,3905,2721,2793,48252,1112
29611,6,130,2124,96,3609,34
15387,5,476,2834,407,12241,69
33228,208,8033,1949,6156,55657,1877
35965,21,815,1811,673,12210,142
26305,14,2971,2299,1997,39998,974
3284,43,2660,3503,2058,26994,602
45571,17,346,420,250,5413,96
17609,59,1766,2723,1397,19551,369
9209,4,332,3206,282,24154,50
6287,79,1968,3385,1678,16688,290
33392,29,745,1942,584,4898,161
12626,504,31331,3026,21167,129971,10164
41907,0,53,1334,39,3357,14
25551,68,3088,2334,2260,31128,828
30221,5,205,2093,165,3634,40
29400,5,61,2134,47,3236,14
33204,0,63,1949,53,6815,10
25172,20,773,2350,625,11203,148
18039,3,215,2704,148,10503,67
5591,118,5682,3416,4362,41096,1320
14216,142,9243,2908,7052,51089,2191
21796,6,308,2512,196,5404,112
15940,42,1755,2810,1363,10041,392
23664,4,190,2418,162,4465,28
31809,251,6223,2012,4829,25347,1394
10337,15,754,3147,552,10381,202
3840,16,256,3491,224,11674,32
3396,14,998,3500,658,10769,340
21754,12,1825,2515,1443,15875,382
31718,0,30,2016,13,2346,17
45180,75,906,534,639,9125,267
41358,14,215,1423,150,4872,65
39172,23,420,1607,321,13150,99
35260,69,1636,1859,1312,22547,324
12188,49,1270,3050,993,24550,277
19100,3,65,2660,60,1812,5
3267,10,181,3503,150,4860,31
18933,11,359,2667,271,5217,88
36623,33,562,1772,460,11839,102
16821,26,1821,2765,1218,9423,603
11790,1,47,3069,42,2455,5
10965,10,215,3112,165,3020,50
10464,20,727,3140,549,8796,178
7068,6,133,3347,102,4172,31
14080,13,398,2915,340,7788,58
20405,16,1309,2592,1116,32196,193
14524,12,826,2884,621,9880,205
39196,25,757,1605,571,15408,186
38341,4,242,1660,175,10206,67
11462,53,1420,3086,1121,12682,299
12935,63,2748,3008,2070,27267,678
9546,13,575,3185,431,10198,144
11859,18,392,3067,291,10972,101
3104,12,262,3506,190,6409,72
35734,6,525,1828,413,27859,112
22611,35,1323,2470,918,5665,405
32444,20,952,1981,794,9344,158
41162,3,269,1453,197,5859,72
15103,67,3138,2848,2620,26193,518
22910,18,733,2455,597,5318,136
43741,143,1764,870,1542,13433,222
31132,16,614,2047,485,12378,129
41420,68,629,1414,482,9062,147
34714,38,1195,1890,954,12720,241
29255,17,681,2142,500,5343,181
35518,3,328,1845,261,4892,67
37730,6,251,1704,194,3989,57
27847,10,175,2220,162,1749,13
22796,2,101,2461,83,2839,18
3507,44,1586,3498,1215,8521,371
38675,1,73,1637,49,4100,24
11572,6,454,3081,379,21910,75
36320,335,6597,1789,5357,32348,1240
45350,8,139,485,86,3645,53
28643,100,4797,2173,3614,28525,1183
15240,56,3646,2841,2560,37275,1086
21964,6,283,2502,199,3987,84
12701,40,1203,3021,828,29330,375
7973,5,156,3287,127,7170,29
36308,12,311,1789,243,12417,68
24417,136,7686,2384,5719,35484,1967
8117,29,612,3274,452,7499,160
30478,38,1140,2079,897,12230,243
24449,6,314,2383,245,5605,69
2634,1000,76000,3514,52527,324433,23473
35099,480,10538,1869,7601,50374,2937
41994,7,283,1320,224,9877,59
21053,2,75,2555,67,5154,8
33696,27,288,1931,222,2892,66
27758,97,1875,2225,1518,10101,357
7241,5,51,3339,45,3194,6
27210,79,1629,2258,1233,9837,396
19991,70,2556,2614,1973,21834,583
23562,16,487,2424,396,12541,91
20102,22,810,2608,615,18591,195
16996,10,287,2757,221,9845,66
2811,59,1820,3511,1503,50127,317
27424,14,357,2245,276,5252,81
7048,13,395,3348,315,21951,80
5646,30,989,3412,823,15033,166
32144,31,1209,1994,984,15175,225
20679,64,2155,2578,1753,21280,402
7294,183,5233,3336,3900,33469,1333
18152,2,164,2700,127,2718,37
4883,81,3650,3453,2882,75347,768
9883,5,47,3168,41,2773,6
31120,8,264,2048,223,6175,41
39920,14,266,1561,220,12603,46
33411,31,1449,1942,1162,11688,287
29006,3,128,2155,113,15347,15
20415,6,116,2592,97,2728,19
21591,4,147,2523,117,6519,30
27616,16,1933,2233,1559,45110,374
34729,16,405,1889,308,8926,97
21726,147,16702,2516,12087,73673,4615
41262,3,208,1437,150,10441,58
35719,2,94,1828,79,3488,15
13040,7,506,3001,397,11171,109
28100,23,1611,2206,1246,32479,365
42010,209,8888,1317,6086,49885,2802
4312,160,6403,3475,4265,49784,2138
25380,28,811,2341,640,6778,171
40556,15,2251,1511,1544,24990,707
37539,0,184,1716,148,3259,36
9510,141,15401,3187,9746,40974,5655
35887,19,363,1816,298,8368,65
36712,6,221,1768,174,2772,47
29768,7,622,2116,491,7748,131
26389,2830,92897,2295,66542,337659,26355
16872,2,59,2763,44,4115,15
38066,35,698,1680,549,10965,149
16409,34,585,2786,463,3186,122
26610,78,3804,2285,3009,33460,795
5089,46,576,3442,465,8567,111
40941,32,906,1477,669,15670,237
8895,7,287,3225,218,6977,69
25451,56,1093,2339,803,5735,290
3412,3,44,3500,37,3074,7
20168,6,294,2604,238,9528,56
27749,7,356,2225,279,11229,77
34764,139,1608,1887,1147,12228,461
9870,1066,114739,3169,69786,400458,44953
11861,8,692,3067,480,12522,212
40672,9,228,1502,166,3707,62
9205,4,157,3206,127,3851,30
2557,3,198470,3515,73280,10067,125190
23074,6,233,2448,183,5547,50
7011,42,1095,3351,903,13326,192
24088,73,7832,2399,5802,88267,2030
26013,3,410,2312,323,11678,87
2653,3,159,3514,132,11373,27
34546,54,2264,1899,1697,28258,567
6615,791,39443,3370,27263,236099,12180
7222,14,214,3340,174,10572,40
40977,4,140,1474,96,2618,44
38304,15,593,1664,482,4448,111
25379,20,564,2341,480,23987,84
13625,18,441,2952,356,4392,85
44083,97,5070,797,3492,25976,1578
13489,21,1413,2961,1051,17533,362
15433,3,351,2833,259,4542,92
18235,2,174,2696,120,3376,54
31660,1,81,2019,63,2572,18
33781,28,1149,1927,942,13672,207
27181,2,100,2259,77,3539,23
34588,14,5527,1897,4627,12004,900
9690,14,398,3177,308,7008,90
17339,59,1358,2737,990,7257,368
41749,3,162,1362,126,7456,36
42077,88,2528,1305,1907,36693,621
27962,7,257,2213,187,8263,70
36725,3,91,1768,73,3929,18
20006,28,1608,2613,1245,9251,363
33325,21,538,1945,391,7504,147
32958,38,710,1959,601,11681,109
17400,88,4189,2733,2969,38106,1220
29368,23,671,2135,485,10394,186
12030,1,71,3059,58,2680,13
41936,0,35,1329,30,6145,5
945,8,400,3853,317,5095,83
30784,0,40,2063,32,2731,8
25120,2,26,2352,23,1509,3
24646,929,54912,2372,37239,160200,17673
5751,58,1906,3407,1503,23555,403
11193,99,2809,3100,1963,29804,846
44007,85,547,820,438,9203,109
3581,8,97,3497,79,4393,18
8710,5,270,3235,215,6572,55
25703,27,756,2326,634,6443,122
7926,52,1026,3291,835,22868,191
3235,19,370,3503,270,9605,100
46359,70,918,107,805,10212,113
25655,86,4184,2328,3225,22545,959
40650,17,659,1504,531,7295,128
33622,2,111,1934,96,12258,15
28002,4,58,2210,52,2320,6
31728,53,1769,2016,1322,37958,447
28362,28,790,2190,608,8311,182
23408,1,89,2431,76,6736,13
10041,34,1231,3160,975,5907,256
37867,557,17460,1693,13691,88187,3769
19931,16,656,2618,569,9464,87
42879,80,824,1136,625,8578,199
37095,27,914,1744,711,16659,203
8925,75,2130,3223,1661,30856,469
21777,3,58,2513,36,2760,22
25607,3,371,2330,305,7610,66
21419,4,256,2534,194,5961,62
13312,138,8769,2976,6090,77799,2679
12223,13,924,3049,707,10352,217
20817,6,110,2570,101,5078,9
14373,16,661,2895,541,12274,120
4922,111,3852,3450,2732,22760,1120
9390,8,164,3194,144,7436,20
11420,1,80,3089,57,2005,23
36544,0,50,1778,31,2287,19
15534,2,177,2828,143,6198,34
11382,9,186,3091,147,6700,39
10387,15,763,3145,475,19062,288
6759,6,124,3364,97,2917,27
4959,3,95,3449,74,2409,21
16507,3,130,2782,103,5540,27
28952,31,1129,2157,931,19241,198
40241,20,598,1540,451,13046,147
4804,2226,133935,3457,87736,726141,46199
36589,1,63,1775,53,6103,10
29767,13,317,2116,272,8970,45
32737,756,26656,1969,17772,156759,8884
17510,11,632,2728,465,8136,167
36513,23,560,1779,459,7568,101
11780,115,4800,3069,3590,28021,1210
18647,63,1638,2678,1128,13009,510
13289,5,417,2978,295,7800,122
28418,1,249,2187,199,4240,50
45562,5,72,423,36,2537,36
42733,5,164,1170,119,4086,45
29807,49,3866,2114,2975,35609,891
10096,7,472,3158,366,12960,106
4992,22,412,3447,343,5465,69
46027,30,414,233,355,6749,59
40548,72,835,1512,604,7247,231
6929,0,145,3356,116,3796,29
20408,5,147,2592,125,3149,22
35327,7,128,1856,111,4157,17
23104,16,740,2446,541,5200,199
17883,188,16123,2713,11688,86584,4435
2455,201,16535,3517,11024,54492,5511
13936,12,684,2926,480,12221,204
4880,12,262,3453,206,3717,56
38500,13,538,1650,420,9410,118
8138,12,150,3273,127,5885,23
39221,19,654,1603,544,17192,110
26624,17,344,2285,292,4507,52
39435,54,1006,1590,776,6586,230
6014,14,2289,3394,1345,24054,944
32740,14,230,1969,190,2806,40
35626,2,47,1837,36,2323,11
13844,27,984,2935,819,26979,165
37052,2,287,1746,219,6338,68
15086,26,3224,2849,2488,21464,736
35901,5,274,1815,219,7640,55
13713,27,1096,2945,918,14615,178
24704,1,47,2369,35,4183,12
37494,4,102,1719,79,3111,23
20119,390,33141,2607,18996,137679,14145
29415,127,3240,2133,2400,17555,840
35150,4,165,1866,141,5192,24
37463,178,3591,1722,2500,21689,1091
10753,478,20009,3123,13388,95861,6621
45480,32,423,452,348,4789,75
32883,78,2032,1962,1499,14439,533
46133,3,72,187,57,1611,15
12610,12,468,3027,411,12753,57
7670,5,249,3313,190,11782,59
43529,19,298,943,215,9404,83
32233,11,531,1989,397,5971,134
16825,3,503,2765,402,8609,101
44547,45,474,733,366,5365,108
12953,1,26,3007,18,1644,8
3947,16,602,3488,516,18308,86
45485,2,27,450,13,1428,14
41328,20,428,1426,326,4671,102
4044,23,810,3485,610,13574,200
2171,19,735,3522,545,9618,190
9517,1,116,3186,86,4705,30
26250,34,6035,2302,4956,11111,1079
5813,29,619,3404,459,7128,160
17062,8,430,2752,359,7082,71
28190,65,2022,2200,1607,14039,415
7155,77,2587,3342,1897,20491,690
33301,7,623,1946,514,5053,109
42472,57,1070,1224,782,13158,288
36916,28,383,1755,312,4395,71
15679,7,319,2820,248,4500,71
13307,4,149,2976,110,4391,39
39755,8,290,1573,197,4841,93
37780,10,222,1700,180,5471,42
36327,19,602,1789,472,7606,130
45467,23,442,455,332,6462,110
39446,0,25,1590,23,2472,2
38073,6,246,1680,194,3239,52
16171,31,1273,2799,962,15736,311
8193,2,112,3269,89,3338,23
40073,0,148,1551,101,2907,47
19223,6,302,2655,205,5421,97
24638,16,789,2372,594,11042,195
28210,11,210,2199,155,2008,55
27292,0,68,2253,55,3070,13
15976,16,708,2809,528,4722,180
2268,209,24153,3520,16408,126717,7745
43511,8,176,951,145,11851,31
6095,1,89,3391,83,1490,6
11680,14,719,3075,560,7151,159
8567,10,110,3244,86,2946,24
12908,5,71,3009,53,3506,18
31877,12,368,2008,262,4905,106
45345,29,269,486,189,2643,80
9719,2,103,3176,69,2537,34
42974,9,573,1110,321,7360,252
26146,6,482,2307,329,4733,153
27491,6,199,2240,151,5921,48
24415,123,4323,2384,3273,30256,1050
21619,57,3134,2522,2182,10695,952
11350,1,55,3093,44,3561,11
25255,19,1385,2347,1046,23297,339
2463,107,5523,3517,3823,36403,1700
42959,22,413,1114,291,8600,122
43678,116,1437,890,1243,11797,194
27652,2,260,2231,176,5203,84
37733,0,127,1704,99,6884,28
23138,3,196,2444,159,10439,37
44811,11,133,664,97,3527,36
40187,26,1281,1545,891,18735,390
10473,7,114,3140,91,2949,23
28127,39,1187,2204,932,7093,255
18945,10,459,2666,347,8392,112
7123,15,498,3344,429,13232,69
26847,11,343,2274,281,3797,62
36798,19,679,1763,519,5782,160
27111,33,1986,2264,1099,12770,887
13718,57,1715,2944,1391,22098,324
34331,4,270,1909,191,9111,79
40001,66,763,1555,596,5516,167
26685,108,2809,2282,2287,35166,522
29622,15,546,2123,439,7915,107
14743,13,265,2870,213,6593,52
45394,15,225,473,159,3843,66
31250,1,105,2042,85,1979,20
26485,236,8311,2291,6206,57717,2105
42743,127,4890,1166,3367,34443,1523
3556,47,2392,3498,1749,35877,643
10229,11,486,3152,394,6484,92
8975,21,775,3220,650,16297,125
37591,4,91,1713,74,2705,17
3415,40,1570,3500,1073,10631,497
4963,30,1731,3449,1372,16708,359
41087,40,378,1462,288,3986,90
29651,13,322,2121,254,8854,68
44956,16,461,622,274,6899,187
35411,3,89,1853,75,7234,14
40922,22,1113,1478,840,14061,273
33825,4,72,1926,60,3035,12
5367,249,11102,3426,8263,129187,2839
17879,34,3474,2714,2700,25778,774
12612,370,19867,3026,13734,142878,6133
18690,10,957,2676,770,11013,187
17791,26,2509,2717,1922,51296,587
42240,37,1331,1270,883,16905,448
27386,15,862,2247,676,11858,186
20486,6,102,2589,87,1750,15
38334,19,563,1662,444,7180,119
40170,8,426,1546,311,7697,115
44970,16,114,617,80,2050,34
13837,51,1986,2935,1398,39291,588
42096,39,821,1301,639,13577,182
4087,5,66,3483,57,3387,9
39751,27,963,1573,775,10823,188
9461,11,334,3190,251,10367,83
26550,3,123,2288,105,1817,18
8532,73,2223,3246,1689,13383,534
34611,310,10235,1896,7625,88957,2610
45140,3,49,545,23,2832,26
40756,27,494,1493,376,6116,118
13462,8,506,2963,382,8973,124
18166,58,2826,2699,2285,14947,541
42343,12,311,1252,262,8049,49
9962,146,8474,3164,6637,44851,1837
32170,6,373,1993,290,11271,83
25016,5,149,2357,127,3703,22
22026,16,579,2498,435,6717,144
29793,61,2439,2115,1846,26030,593
39796,15,605,1570,444,5028,161
9508,12,134,3187,107,3091,27
30024,0,54,2104,45,8256,9
35953,4,301,1812,255,3862,46
25511,160,4955,2336,3664,16543,1291
40077,0,101,1551,85,3621,16
43487,147,2396,959,1811,46076,585
31957,33,956,2005,658,13234,298
2027,87,3098,3524,2621,25227,477
28228,9,194,2198,149,4971,45
42449,160,4261,1229,3243,53647,1018
3979,1308,70201,3487,48366,206091,21835
14825,6,109,2863,86,3161,23
19415,19,3402,2644,2454,22815,948
36734,47,1315,1767,1039,24720,276
17572,0,219,2725,155,4647,64
31971,3,128,2004,112,5169,16
9711,228,11323,3177,8592,81632,2731
3468,5,150,3499,111,9976,39
41841,3,97,1344,80,4064,17
2231,36,1510,3521,1119,14026,391
4813,22,434,3456,360,5761,74
36095,23,861,1801,665,7803,196
19090,0,216,2660,177,4611,39
5246,61,3465,3433,2746,51219,719
3884,10,152,3490,121,3838,31
23117,75,2153,2445,1740,46219,413
8235,2729,142581,3267,94732,703243,47849
3796,1,32,3493,24,3177,8
35607,3,95,1838,77,2776,18
8477,13,313,3250,240,5432,73
43013,64,1399,1097,1121,36353,278
11318,11,636,3095,479,12094,157
19640,12,268,2634,220,4786,48
37702,13,341,1706,272,3996,69
17134,28,613,2748,474,5488,139
16635,3,201,2777,154,7539,47
2705,27,876,3513,622,12960,254
11508,1,168,3084,139,5135,29
10522,21,783,3138,644,14588,139
8706,26,986,3235,818,18088,168
13068,0,113,2999,97,8390,16
9869,5,178,3169,149,4102,29
24079,51,2721,2400,1942,16394,779
8705,18,1278,3235,1017,11801,261
2359,19,508,3519,360,33274,148
15963,8,487,2809,416,8614,71
45097,98,1020,566,822,9955,198
2947,19,776,3509,637,11172,139
33401,2,76,1942,61,2652,15
9039,3,162,3217,130,4328,32
6011,8,211,3394,172,2130,39
39557,1,42,1584,33,2191,9
11121,11,442,3104,350,3856,92
27446,43,1915,2243,1546,41448,369
22325,1,58,2484,43,2125,15
27062,0,229,2267,173,2301,56
39399,64,784,1592,625,8951,159
26756,342,11059,2279,7601,51583,3458
35258,0,598,1859,483,12842,115
40676,5,221,1501,186,7798,35
4193,86,5908,3480,4455,87248,1453
14474,48,3674,2888,2831,23912,843
7526,0,13,3322,11,2061,2
40276,4,70,1538,62,3669,8
13062,24,3913,3000,2937,64025,976
11856,4,72,3067,50,2359,22
42686,4,269,1180,191,8352,78
41806,1,35,1351,26,3102,9
4550,31,991,3467,792,9857,199
35840,3,99,1820,74,3355,25
31209,7,323,2044,250,6706,73
4877,30,1013,3453,853,11197,160
2665,1,65,3514,58,6766,7
32436,8,333,1981,256,8957,77
24287,5,264,2390,216,12206,48
16941,18,1107,2759,897,12212,210
45448,4,17,458,11,2072,6
38344,3,97,1660,79,3427,18
5313,67,1217,3429,956,13434,261
33839,22,228,1925,188,2883,40
23975,26,996,2404,838,17128,158
42801,13,115,1150,99,2239,16
27320,8,2051,2251,1554,24009,497
41273,35,1254,1435,879,28438,375
45908,7,107,289,85,1270,22
33071,4,91,1954,79,3110,12
30798,19,424,2062,301,3637,123
30744,18,692,2064,547,10157,145
15704,17,940,2819,767,10550,173
4510,6,263,3468,207,5915,56
25275,3,370,2346,261,2347,109
8126,3,239,3274,188,5734,51
6065,6,120,3392,89,2899,31
19413,34,5005,2644,3663,30247,1342
2226,11,267,3521,234,8837,33
27657,11,362,2230,172,2264,190
27470,4,186,2242,151,7244,35
43381,22,355,987,262,4517,93
38322,7,203,1662,157,11751,46
39969,21,1178,1558,927,12664,251
32823,1,224,1965,170,5218,54
27873,16,274,2219,219,8930,55
2773,157,7841,3512,5722,87013,2119
6513,268,9187,3374,7016,145089,2171
2080,5,156,3523,95,4421,61
8353,130,7697,3258,5338,34837,2359
21908,100,2359,2506,1684,16079,675
44812,12,136,664,112,6436,24
30639,5,236,2070,173,6565,63
14684,15,75,2874,55,10812,20
42509,15,239,1217,198,7894,41
26762,2,70,2278,63,2026,7
4085,9,169,3483,130,5191,39
13450,48,3332,2964,2460,18941,872
32733,0,48,1969,35,2056,13
7776,77,3671,3306,2748,44178,923
21232,2,114,2542,96,2987,18
37601,1,100,1712,68,4868,32
22628,4,345,2470,284,5797,61
20205,88,23439,2602,15933,58901,7506
3680,12,256,3495,173,2658,83
17905,41,5790,2712,4204,39781,1586
7610,31,1493,3317,1155,18407,338
28713,8,220,2170,177,5439,43
17218,90,3465,2743,2526,39474,939
36781,15,261,1764,218,3967,43
33604,17,968,1934,734,12391,234
19152,1,59,2658,42,3387,17
12971,32,1306,3005,986,18289,320
38080,3,59,1680,53,3180,6
3426,29,1937,3500,1488,41245,449
38306,15,740,1664,575,9019,165
33623,10,738,1934,578,9937,160
20134,4,106,2607,91,1534,15
24396,2,103,2385,89,1543,14
27626,21,588,2232,518,7941,70
20619,8,981,2582,821,12748,160
3817,14,429,3492,321,5891,108
1220,4,75,3766,70,4874,5
10036,13,320,3161,249,6591,71
41207,5,310,1448,242,9025,68
43517,79,1242,948,991,21209,251
33913,14,196,1923,168,7133,28
25405,1,18,2341,15,857,3
8409,3,82,3255,55,4630,27
3521,77,3285,3498,2639,38352,646
34869,7,322,1880,248,5414,74
29338,15,525,2137,426,4327,99
29538,26,2165,2127,1559,15594,606
1695,3,135,3564,105,4058,30
7095,13,273,3346,214,10963,59
27596,4,593,2234,457,4675,136
29658,0,10,2121,9,1809,1
12256,85,2540,3046,1980,36106,560
9610,12,438,3180,334,11163,104
11579,15,527,3080,434,14165,93
11170,0,89,3101,67,4000,22
6761,8,90,3364,77,2322,13
10886,7,453,3116,370,3547,83
3723,0,11,3494,10,2010,1
3401,18,1053,3500,757,21717,296
45236,13,273,519,192,4263,81
43114,99,1809,1067,1452,14556,357
37848,68,2453,1694,1959,16788,494
28758,90,2432,2166,1760,11604,672
10893,12,119,3116,97,8953,22
14991,18,346,2854,279,5142,67
24317,8,286,2389,212,3979,74
9256,48,1989,3204,1551,14351,438
15181,3,186,2844,140,3966,46
45531,16,128,436,117,2814,11
22357,22,2563,2483,1903,19637,660
33321,5,172,1945,143,9973,29
45996,97,896,248,720,7354,176
40552,2,323,1512,257,11024,66
31202,15,404,2044,319,3240,85
44945,187,8268,625,4267,61971,4001
30950,1,184,2056,156,5151,28
18067,28,956,2703,716,11412,240
18816,21,1233,2671,941,18995,292
13840,2,141,2935,106,4775,35
45669,49,669,378,565,9970,104
40805,281,9394,1489,6021,82659,3373
9132,258,12019,3211,8828,45309,3191
7073,27,444,3347,311,15073,133
16144,12,1279,2800,1025,14335,254
8910,33,1029,3224,677,7087,352
40486,35,809,1518,597,9071,212
8296,13,286,3263,181,2701,105
2661,136,7355,3514,5667,81941,1688
21512,44,7347,2528,4469,24433,2878
21191,2,95,2546,79,2624,16
23305,19,342,2436,309,9446,33
38635,2,86,1639,63,4095,23
33954,0,31,1922,27,1469,4
7492,29,857,3324,626,10077,231
42768,7,167,1162,129,10180,38
1968,47,1145,3525,933,39796,212
29459,0,14,2131,10,1379,4
16577,7,212,2779,144,3786,68
21247,0,19,2542,15,2262,4
32685,122,2317,1971,1810,21183,507
45136,1,28,546,16,1757,12
3597,15,1582,3497,1213,8452,369
12936,12,714,3008,566,15779,148
12091,9,757,3056,578,3802,179
26902,196,9846,2272,7810,47553,2036
11794,1,66,3069,50,3212,16
1046,5,128,3816,113,10392,15
13527,10,350,2959,246,23121,104
30746,60,1512,2064,1207,10780,305
34168,10,389,1915,257,4498,132
6639,16,272,3369,202,7290,70
10471,25,1450,3140,984,9512,466
23368,150,5552,2433,4405,32735,1147
30192,47,685,2095,552,4791,133
5161,36,1046,3437,766,8605,280
37571,0,119,1714,101,4326,18
12691,14,1473,3022,1132,13123,341
15562,959,43317,2826,31556,197504,11761
18231,18,866,2696,616,9488,250
18354,14,859,2690,694,7657,165
40618,135,2817,1506,2116,26839,701
32818,19,557,1965,361,9666,196
2028,42,1158,3524,892,14629,266
18721,32,1326,2675,1059,18180,267
36105,0,100,1800,83,3280,17
38110,196,2568,1677,1851,12011,717
14039,10,523,2918,444,13076,79
29111,5,333,2149,253,6095,80
3260,15,496,3503,395,3254,101
11904,16,968,3065,763,15041,205
28723,1252,106497,2169,74756,404091,31741
36783,3,116,1764,97,7481,19
16654,21,1481,2775,1200,22245,281
20562,3,54,2584,49,3032,5
10111,2,40,3157,34,2089,6
32787,120,8968,1966,6709,41212,2259
3056,20,340,3507,267,10891,73
29252,3,199,2142,159,3666,40
14351,210,8825,2897,6509,66719,2316
30222,276,8168,2093,6134,65486,2034
35630,15,242,1836,201,4270,41
7388,3,80,3330,67,2617,13
4869,12,202,3454,168,7389,34
27109,100,3065,2264,2498,17071,567
2883,22,846,3510,643,17542,203
16952,0,86,2759,74,5827,12
41731,47,1522,1367,1131,18609,391
41068,52,1540,1464,1132,16566,408
19622,11,559,2635,413,7518,146
15795,164,24505,2815,17189,56491,7316
33104,12,516,1953,389,4532,127
2113,42,675,3523,528,13026,147
39690,10,626,1576,483,16003,143
9833,14,1165,3170,938,11978,227
18839,55,7255,2670,5476,28105,1779
1956,14,509,3526,409,23449,100
33351,4,170,1944,141,4729,29
16935,239,17452,2760,12802,108535,4650
7094,160,12436,3346,7807,82455,4629
41758,11,187,1361,143,8873,44
14814,2,185,2864,162,3295,23
28175,2,215,2201,190,3139,25
36334,5,228,1788,190,6544,38
9623,53,2399,3180,1744,20967,655
8586,12,516,3243,391,7470,125
40114,46,1326,1549,950,23785,376
6100,15,1304,3391,996,16193,308
12209,73,4008,3049,2862,55474,1146
40186,17,595,1545,432,7072,163
38858,96,3199,1626,2181,34281,1018
30708,25,949,2066,729,15232,220
36612,1,63,1773,54,3852,9
2188,29,599,3522,461,22594,138
28590,3,69,2176,50,2280,19
40617,176,4126,1506,3115,31872,1011
37816,92,4770,1697,3302,45522,1468
3555,147,4336,3498,3448,18645,888
3523,51,974,3498,722,22521,252
42326,5,127,1255,85,4889,42
13453,209,13245,2963,9071,92069,4174
1677,0,30,3566,25,1858,5
2582,162,7387,3515,5768,48282,1619
19968,12,833,2615,642,15124,191
13441,10,597,2965,486,6657,111
32067,15,1055,1998,725,8685,330
31361,44,3386,2036,2626,25700,760
18442,79,6141,2687,4335,49804,1806
14380,3,107,2894,91,17316,16
11584,7,501,3080,401,15041,100
31982,7,397,2003,319,9312,78
3047,25,2023,3507,1425,12844,598
11969,5,618,3062,466,8844,152
28031,230,21856,2209,14173,79623,7683
29170,6,198,2146,154,4740,44
11039,115,5817,3109,3835,34439,1982
25798,3,104,2322,87,2738,17
35593,459,11582,1839,8854,51276,2728
45620,2,56,406,44,2764,12
41399,141,3299,1416,2293,17015,1006
26215,2,348,2303,273,10999,75
14295,292,34750,2901,22696,133657,12054
38865,109,2119,1626,1529,22520,590
11237,125,6178,3097,4843,24836,1335
40503,74,1773,1516,1431,17567,342
8187,111,3479,3269,2222,13334,1257
30917,16,857,2058,639,6034,218
31182,1,181,2045,153,3699,28
20372,255,35568,2594,23498,118096,12070
5307,5,552,3430,420,6888,132
5079,3,383,3443,313,12467,70
13847,54,1859,2935,1336,39250,523
36664,39,1664,1771,1221,15118,443
20650,27,2127,2580,1601,16778,526
37236,11,360,1735,263,8502,97
36663,0,25,1771,20,2749,5
1032,7,117,3823,99,3496,18
43017,9,149,1097,137,5324,12
40574,9,273,1509,208,5416,65
15575,8,403,2825,280,7722,123
25609,0,881,2330,661,10988,220
35796,0,18,1823,16,1539,2
20172,243,8890,2604,6667,78920,2223
2801,14,174,3511,142,6223,32
30775,2,31,2063,26,2520,5
32985,10,600,1958,484,10647,116
25718,36,2360,2325,1880,18329,480
23360,10,449,2434,358,14014,91
22761,7,161,2463,125,6387,36
40128,8,361,1548,252,7248,109
5041,35,753,3445,599,14439,154
13998,2,41,2921,35,4637,6
30888,8,169,2059,141,5346,28
30318,68,7683,2088,5885,10800,1798
39951,8,151,1559,118,5992,33
32437,1,136,1981,107,3842,29
2429,167,5872,3517,4415,31035,1457
33270,1,62,1947,50,3322,12
24274,94,1852,2391,1347,14145,505
42162,3,75,1287,57,3733,18
28582,17,336,2176,273,5941,63
45592,17,182,416,86,3035,96
10081,30,406,3158,323,7292,83
31158,0,0,2046,0,1227,0
12328,22,736,3042,598,11632,138
40506,35,982,1516,663,7722,319
45402,10,163,470,115,2975,48
18530,87,4356,2684,3150,27855,1206
40358,4,182,1529,124,4433,58
4238,185,6818,3478,5447,119121,1371
46052,3,44,217,31,1512,13
4114,22,999,3482,823,17185,176
11841,3,145,3068,113,10965,32
24468,5,266,2382,217,3146,49
31063,438,15641,2051,11812,73890,3829
2716,6,113,3513,86,9712,27
8861,351,25926,3227,17488,111095,8438
26607,9,779,2286,466,4963,313
28942,4,205,2158,168,12720,37
13765,14,505,2940,374,5542,131
4892,21,797,3452,594,10765,203
3553,3,106,3498,86,2996,20
21989,890,29985,2501,20433,163778,9552
18728,90,9238,2675,7090,53404,2148
10475,21,976,3140,747,20960,229
45279,288,5600,503,4538,40829,1062
14904,33,864,2859,630,7666,234
3864,1,48,3491,44,3556,4
22618,3,268,2470,233,3483,35
15773,134,10059,2816,6819,47526,3240
24399,100,5723,2385,4081,38501,1642
17132,3,430,2748,299,18935,131
19042,0,105,2662,84,2439,21
14454,649,35336,2890,24642,163801,10694
13266,2,128,2979,101,4926,27
39342,3,183,1595,139,4748,44
12763,162,11703,3018,9430,49244,2273
40468,265,6200,1519,4473,36663,1727
45762,46,799,338,644,7277,155
43130,2,118,1063,87,6006,31
34381,8,381,1907,299,7029,82
1846,335,10825,3529,8190,81222,2635
9213,1,69,3206,57,1893,12
7777,86,2392,3305,1680,31429,712
9316,8,271,3200,229,3123,42
12849,3,174,3013,144,4597,30
3228,0,52,3504,37,3911,15
8803,3,162,3230,132,5291,30
11036,11,64,3109,48,4803,16
12155,58,2967,3051,2243,33216,724
35055,8,229,1871,197,4883,32
27957,420,10056,2213,7459,46922,2597
1698,3,93,3564,78,3223,15
5449,10,149,3422,127,6679,22
37834,4,95,1695,78,2722,17
40107,9,456,1549,327,5708,129
41625,0,25,1384,20,1923,5
20492,23,1682,2589,1360,35803,322
25523,8,320,2335,234,8183,86
1022,5,77,3827,66,2901,11
3371,9,610,3501,482,5666,128
25730,5,130,2325,101,2622,29
26369,35,900,2296,738,6759,162
3861,831,23922,3491,18473,127227,5449
14786,26,2893,2866,2082,19331,811
35057,7,243,1871,148,6157,95
10809,39,1789,3120,1430,19114,359
1476,2,53,3617,47,3214,6
33274,4,182,1947,157,5244,25
30087,19,447,2101,349,4909,98
29835,130,6067,2113,4841,46787,1226
32848,4,261,1963,162,5014,99
25318,50,2047,2344,1520,28837,527
36150,35,898,1797,717,25248,181
14456,4,485,2889,329,5502,156
22766,26,3063,2463,2077,30896,986
12530,15,364,3031,280,11015,84
43735,43,383,871,292,10364,91
11411,7,371,3090,276,2374,95
15265,24,1248,2840,1027,25761,221
29046,16,477,2153,335,13970,142
5135,308,5436,3438,4356,123081,1080
22021,20,2502,2499,1806,13538,696
28703,4,181,2170,158,3695,23
27441,37,814,2244,563,5189,251
19829,4,240,2623,209,2629,31
3546,4,57,3498,47,2687,10
2833,36,789,3511,609,19412,180
29650,6,462,2121,367,7444,95
44881,10,85,643,65,2796,20
15505,5,362,2829,268,9566,94
3725,169,9532,3494,6423,93984,3109
11327,121,6168,3094,4293,57385,1875
24144,6,415,2396,340,8108,75
7307,5,87,3335,76,3810,11
26867,3,75,2273,63,1761,12
28436,33,746,2186,619,17443,127
3609,145,4671,3497,3746,58754,925
2449,9,335,3517,266,18733,69
31370,114,2644,2036,2145,24232,499
36522,147,2248,1779,1764,15334,484
2815,10,254,3511,222,6435,32
37155,1,132,1741,104,4649,28
30308,11,342,2089,275,3563,67
25812,8,272,2321,198,3329,74
27684,100,9073,2229,7056,76419,2017
42809,0,76,1149,51,2173,25
11344,5,100,3093,82,3323,18
25138,0,4305,2351,3132,31422,1173
28164,88,3172,2202,2637,20459,535
19904,4,225,2619,185,3556,40
34812,33,736,1883,537,5347,199
10536,139,3270,3137,2573,77429,697
41154,46,5240,1454,4422,24439,818
39191,13,408,1605,296,5915,112
34429,6,70,1905,58,4057,12
6577,2,18,3372,16,1741,2
44939,10,170,627,115,4924,55
3404,22,601,3500,425,8819,176
26093,11,232,2309,199,4247,33
6801,10,614,3362,450,20239,164
43841,4,59,845,50,3319,9
15546,6,589,2827,450,11134,139
13957,120,68156,2924,18205,32618,49951
4405,22,681,3472,542,4585,139
22095,5,264,2494,211,2765,53
19842,5,293,2622,235,9705,58
31319,50,1422,2038,1132,9730,290
2172,65,1940,3522,1455,29212,485
29955,12,858,2107,688,10835,170
8395,92,5565,3255,4358,68064,1207
38159,82,1920,1674,1360,12104,560
21186,93,8926,2546,6720,38370,2206
32194,4,80,1991,67,4473,13
7512,6,327,3323,240,4001,87
38357,52,1083,1659,755,23368,328
39805,1,41,1570,36,4278,5
42272,7,228,1264,195,11171,33
23444,8,382,2429,281,4270,101
20420,4,307,2591,227,8548,80
45943,19,96,266,80,2096,16
29635,6,180,2122,135,3348,45
22777,33,1657,2462,1202,20730,455
39685,5,114,1576,90,6149,24
15180,3,124,2844,100,4664,24
15829,1105,114254,2814,78339,363229,35915
40153,19,443,1547,349,7242,94
37678,14,690,1708,563,16579,127
42523,10,135,1214,99,3124,36
11633,8,508,3078,406,11582,102
26831,2,35,2275,28,1440,7
31085,307,13213,2050,9272,58884,3941
11441,256,25873,3088,18666,76345,7207
45625,35,391,401,318,3855,73
31177,4,145,2045,107,4121,38
35825,5,108,1821,90,3776,18
28799,37,1162,2165,864,30547,298
15456,6,721,2832,529,8705,192
9608,19,528,3180,416,4525,112
18012,215,14433,2706,10883,67477,3550
30155,12,479,2098,402,9669,77
13026,21,1378,3002,1111,33193,267
10530,19,926,3137,715,3945,211
24805,40,2250,2367,1687,16811,563
18495,11,436,2685,354,14261,82
32348,0,41,1984,32,2442,9
4453,6,229,3470,188,9152,41
1979,21,612,3525,526,10013,86
2884,56,1969,3510,1538,33213,431
27522,19,980,2238,805,15834,175
9006,6,479,3219,379,14871,100
32602,0,52,1974,43,3097,9
12381,0,30,3039,25,2009,5
39250,30,971,1600,791,9143,180
31216,19,906,2044,665,6584,241
3602,9,299,3497,225,7805,74
3966,4,105,3488,74,8000,31
6880,29,1269,3358,914,16006,355
1735,2,76,3552,67,3232,9
33358,7,399,1944,312,6131,87
6972,85,3619,3353,2977,26971,642
37520,32,930,1717,686,9655,244
4762,13,280,3458,229,4595,51
29207,38,2797,2144,2153,27912,644
26075,189,4487,2310,3218,22647,1269
20150,34,720,2605,587,2802,133
6867,86,4030,3359,2607,16108,1423
32008,3,71,2002,63,3331,8
37470,10,261,1721,196,4485,65
24078,4666,393939,2400,242177,1054570,151762
10743,19,587,3124,485,7590,102
41404,1,18,1415,16,3819,2
21818,36,1894,2512,1435,19222,459
17085,5,387,2751,305,3423,82
4073,31,821,3484,615,7669,206
42404,26,231,1240,192,6222,39
17515,94,2448,2728,1922,15773,526
19346,55,4524,2648,3102,23412,1422
10836,183,7517,3119,5438,75800,2079
2633,26,1472,3514,1172,20376,300
19641,272,29665,2634,14962,129838,14703
13526,123,5650,2959,4317,73780,1333
41036,7,250,1470,196,5812,54
14372,24,709,2895,550,15357,159
17072,43,3480,2751,2708,27539,772
36774,2,27,1764,24,1957,3
13241,12,263,2981,198,4536,65
30337,10,177,2086,152,5476,25
39798,41,995,1570,806,11284,189
44894,69,675,639,507,11493,168
12336,41,1223,3042,961,5095,262
27145,309,5999,2261,4549,35379,1450
38426,54,932,1655,723,14945,209
24728,44,2594,2369,1887,8687,707
29961,6,235,2107,179,3497,56
2216,2,98,3521,77,3782,21
6078,6,142,3392,107,3923,35
1921,37,1096,3527,750,8857,346
8485,9,189,3250,154,6523,35
19089,618,72431,2660,50559,223627,21872
4536,76,1932,3467,1495,42507,437
18542,7,909,2683,686,10219,223
14049,8,200,2917,148,5922,52
32892,35,831,1962,594,9828,237
10202,4,284,3153,226,8469,58
1888,548,41486,3528,27193,269700,14293
1054,1,85,3815,75,3966,10
3077,51,1999,3506,1513,22917,486
5397,52,1976,3425,1308,21074,668
25266,126,7083,2347,5149,22268,1934
2051,24,253,3524,190,4316,63
5961,57,1777,3396,1353,38494,424
20844,5,173,2568,143,5193,30
39475,0,24,1588,16,4469,8
45684,4,92,375,60,3220,32
40336,1265,42165,1534,28946,122495,13219
29633,31,596,2122,466,4721,130
42983,22,404,1107,321,16591,83
6458,19,809,3377,645,18573,164
39592,15,424,1581,336,5250,88
7787,5,502,3305,337,4636,165
3020,3,99,3507,79,5362,20
24847,181,5957,2364,4494,31610,1463
24405,24,1165,2385,896,7575,269
3153,16,733,3505,574,13955,159
17125,201,11511,2748,7981,87164,3530
27309,17,532,2252,440,6584,92
12186,9,356,3050,295,8608,61
5093,0,17,3441,10,1421,7
15192,1,23,2843,16,2587,7
2131,6,102,3522,90,4964,12
38293,3,73,1664,58,3647,15
23967,1,30,2404,26,2866,4
39525,2,55,1586,46,4228,9
2505,28,1052,3516,812,14677,240
16677,553,25154,2774,19745,69865,5409
5276,337,11046,3431,8250,65460,2796
12014,3,78,3059,64,5069,14
11905,12,615,3065,488,9166,127
4487,27,676,3469,513,5263,163
20311,6,116,2597,90,10749,26
14757,0,29661,2868,8743,4221,20918
30103,2,99,2100,83,6508,16
15266,3,285,2840,221,6207,64
40504,16,218,1516,167,3139,51
6949,37,1763,3354,1326,21354,437
32013,1,38,2002,32,3707,6
8634,3,165,3241,140,7412,25
17521,13,546,2728,440,7962,106
41812,58,587,1348,417,9242,170
16079,14,445,2803,354,4626,91
19383,13,479,2646,391,5769,88
34769,10,334,1887,255,5643,79
7208,87,5329,3340,3901,56223,1428
12454,47,1677,3034,1237,17664,440
2116,20,513,3523,376,14887,137
28221,1,89,2198,73,1276,16
12409,89,3417,3037,2547,31160,870
42721,4,448,1174,286,16106,162
25361,11,610,2342,462,6715,148
28212,24,1732,2198,1482,11835,250
30922,44,1956,2057,1618,16184,338
35560,1657,69983,1842,52587,268710,17396
19245,228,9898,2653,7041,42701,2857
4355,43,2697,3474,2251,30733,446
2089,4,202,3523,154,11418,48
7028,369,10208,3350,7666,96258,2542
1825,664,60466,3530,43533,325624,16933
23484,1049,31438,2427,24419,101188,7019
28842,5,1093,2162,830,21151,263
11744,129,7629,3072,5606,68718,2023
23552,32,1249,2425,997,10480,252
31155,4,257,2046,195,5939,62
16716,9,366,2772,303,6414,63
39186,0,26,1605,18,1971,8
8844,6,211,3227,169,9304,42
40499,1,42,1516,33,2509,9
44819,6,87,660,73,2688,14
39494,0,23,1587,18,7793,5
17341,78,3027,2736,2150,15429,877
26497,1,43,2290,14,2627,29
36724,22,571,1768,478,14507,93
23671,9,502,2418,378,7341,124
13875,17,1199,2933,921,23877,278
7617,18,266,3316,237,10210,29
22065,81,2858,2497,2200,18042,658
43278,11,176,1020,130,4922,46
45089,7,109,571,69,2981,40
18469,659,53648,2686,36095,249699,17553
22928,0,51,2453,44,2610,7
2249,15,272,3521,201,5177,71
21424,423,16684,2533,12333,86965,4351
41684,0,39,1374,27,2272,12
40563,150,3437,1510,2571,19084,866
16309,15,573,2792,386,8007,187
2369,21,893,3519,684,12845,209
22961,365,26904,2452,15688,105702,11216
27418,89,1650,2245,1276,10619,374
2333,10,85,3519,67,3280,18
40924,1,29,1478,24,2318,5
13955,27,2562,2924,2073,32632,489
13290,46,1974,2978,1558,20340,416
5844,16,212,3402,170,2687,42
35530,66,1764,1843,1414,9372,350
11868,21,823,3067,521,16062,302
18505,8,611,2684,433,8333,178
25859,23,505,2320,377,4555,128
34505,22,921,1902,736,11324,185
39233,4,105,1602,80,4472,25
37744,18,341,1702,271,7281,70
23887,5,202,2409,173,4602,29
22520,141,3648,2474,2562,24332,1086
33259,1,155,1947,122,7725,33
41636,8,272,1382,208,7600,64
9064,47,1525,3215,1190,14142,335
1847,90,5327,3529,3967,42200,1360
38497,5,79,1650,60,2708,19
3660,5,297,3495,252,8149,45
35822,3,291,1821,214,4130,77
38504,36,965,1650,752,25894,213
45370,12,65,479,53,2924,12
10048,47,1008,3160,799,6012,209
7680,18,546,3312,437,6420,109
31196,73,4898,2044,3780,36241,1118
22522,7,170,2474,142,7395,28
23660,76,1515,2418,1128,15508,387
35533,22,1068,1843,794,37945,274
11665,2,141,3076,105,2260,36
3117,2036,210633,3506,97128,1054033,113505
21807,2,162,2512,131,4283,31
41929,7,421,1330,262,7346,159
32652,93,2527,1972,2066,21095,461
21899,112,3704,2507,2927,22688,777
43186,17,337,1048,245,4235,92
32502,38,903,1979,734,11995,169
16976,1111,234376,2758,147788,519179,86588
2079,21,591,3523,479,6897,112
5481,6,132,3421,99,5205,33
5807,65,1462,3404,1119,14194,343
3606,63,6884,3497,4881,34197,2003
13677,55,4402,2948,3311,38294,1091
11539,27,912,3082,702,19655,210
19315,0,130,2649,105,2797,25
5430,10,138,3423,121,6444,17
28685,5,117,2171,74,2499,43
31332,23,611,2037,487,12623,124
31384,32,1312,2035,1108,30899,204
3892,288,15043,3490,10895,96497,4148
5779,3,97,3406,71,2152,26
6907,7,110,3357,94,2713,16
35524,2,93,1844,81,5242,12
43420,33,540,975,421,11765,119
5606,7,356,3415,229,6588,127
41231,0,0,1442,0,10508,0
45677,24,236,376,161,5895,75
25287,1,71,2346,53,1582,18
40138,2,145,1548,115,4353,30
20026,3,79,2612,52,2317,27
35929,18,165,1813,126,2898,39
8245,8,182,3266,134,6776,48
27193,2,73,2259,56,1532,17
21418,5,431,2534,297,2951,134
19827,10,404,2623,340,5079,64
6301,12,568,3384,441,12449,127
34482,1,108,1903,94,10822,14
17268,15,377,2740,298,4954,79
23135,3,132,2445,111,2972,21
24859,54,1107,2364,882,12715,225
14707,13,3824,2872,2684,75192,1140
6392,4,218,3380,152,9600,66
8251,10,519,3266,423,6102,96
7387,3,73,3330,58,2953,15
44106,4,54,803,47,4861,7
17291,4,204,2739,174,6799,30
5998,5,160,3395,134,5497,26
38949,7,243,1620,181,11347,62
41862,16,209,1340,163,3159,46
4111,12,258,3482,214,6194,44
34894,50,1128,1879,906,6584,222
4808,57,1690,3456,1387,27264,303
1796,10,216,3531,174,5798,42
33615,74,2343,1934,1742,47658,601
20375,4,713,2594,602,12781,111
33564,3,61,1936,48,3010,13
9588,27,436,3182,331,11647,105
9475,188,13801,3189,10229,195271,3572
25979,1,59,2314,52,2470,7
20483,113,3177,2589,2243,24068,934
9575,1,113,3183,95,2730,18
38658,183,4439,1638,3093,25955,1346
45614,31,658,203,582,4465,76
3142,5,142,3505,115,4773,27
11432,18,388,3088,343,12017,45
11356,119,2675,3093,2065,22250,610
32124,14,352,1995,287,5808,65
3511,16,415,3498,350,13197,65
20019,97,1462,2612,1122,9693,340
45087,103,1120,574,899,8796,221
40658,7,229,1503,154,6527,75
10083,52,3250,3158,2316,31184,934
40421,1,96,1524,80,3757,16
30147,25,349,2098,277,3132,72
11716,6,187,3073,167,5886,20
9393,28,618,3194,428,8525,190
14485,28,2684,2887,2167,23621,517
9934,1043,63546,3166,44355,425400,19191
8858,7,407,3227,331,7672,76
9786,3,276,3173,236,7810,40
11832,0,44,3068,32,1395,12
6952,42,478,3354,404,7844,74
11662,7,221,3076,178,3332,43
8298,993,87443,3262,57888,155140,29555
14599,42,2849,2879,2020,22317,829
30474,8,250,2079,201,4862,49
43432,19,527,973,352,7002,175
45461,106,773,456,615,12668,158
44657,83,915,714,745,14953,170
19630,3,299,2635,238,2989,61
4183,0,68,3480,55,4000,13
31403,13,481,2034,375,5687,106
6216,45,2011,3388,1515,19952,496
36666,23,883,1770,728,9739,155
29280,10,644,2141,537,16604,107
35750,0,68,1827,50,3294,18
12239,1,55,3048,39,2592,16
37522,16,428,1717,367,8659,61
24687,22,1591,2371,1111,9347,480
35895,124,6044,1816,4609,44393,1435
1743,11,522,3549,425,8406,97
7345,5,270,3332,188,4529,82
41159,3,281,1454,218,7953,63
35326,28,606,1856,513,5837,93
32999,77,1164,1958,935,21961,229
29513,3,124,2128,99,3601,25
42788,101,1655,1155,1199,28761,456
25071,9,2672,2355,1912,9974,760
21281,29,652,2541,501,9456,151
46377,11,119,96,90,2317,29
39080,0,46,1612,38,5033,8
14348,21,1298,2897,920,10439,378
14087,0,89,2914,74,3525,15
4709,32,1129,3460,900,8245,229
37152,274,37905,1741,27157,133730,10748
15469,463,49195,2831,32224,187702,16971
10925,718,39415,3114,28592,159369,10823
36816,3,242,1761,204,6026,38
17869,110,3046,2714,2240,15258,806
18443,1,178,2687,132,7488,46
27557,5,239,2236,204,4006,35
34312,22,251,1910,195,2764,56
27376,80,2260,2247,1601,23025,659
5464,13,195,3422,164,13732,31
35614,15,220,1837,171,3420,49
12044,71,2225,3058,1661,28442,564
12338,34,1004,3042,796,22943,208
29849,2,117,2112,93,4132,24
15915,20,847,2812,679,11498,168
45889,10,133,294,74,1622,59
40859,21,526,1483,406,10166,120
35167,80,1626,1865,1327,15093,299
18057,4,108,2703,100,2499,8
29079,44,1729,2150,1291,14635,438
45748,10,172,344,134,5804,38
23656,0,30,2419,24,2270,6
4791,119,6186,3457,4811,47168,1375
38564,2,442,1645,304,5805,138
36011,10,390,1807,293,9129,97
45339,39,740,488,656,11861,84
38031,0,2777,1683,2073,20773,704
29595,35,1417,2125,1104,29353,313
31134,3,326,2047,241,4920,85
11454,2,42,3087,34,1138,8
22648,0,27,2468,22,1755,5
42300,290,5661,1260,3850,63687,1811
10642,5,197,3130,131,7368,66
21633,7,391,2521,319,15089,72
21593,28,649,2523,530,5940,119
35672,3,162,1832,140,2665,22
43040,112,2003,1090,1335,31707,668
9249,0,85,3204,56,2478,29
34754,3,101,1888,84,3441,17
6791,5,42,3363,35,3005,7
31915,12,375,2007,307,5850,68
21969,8,311,2502,274,6363,37
17349,9,242,2736,162,6759,80
44322,13,120,769,108,3386,12
39692,22,455,1576,330,10199,125
32778,4,168,1967,145,4015,23
15692,5,256,2820,211,4739,45
4553,35,679,3466,533,9993,146
10685,4,113,3127,73,2527,40
33262,22,1028,1947,786,13294,242
7515,167,6091,3323,3817,19712,2274
29213,7,145,2144,137,2313,8
15636,306,14775,2822,11192,96006,3583
31752,27,1757,2014,1377,22579,380
28423,9,196,2186,158,4256,38
16912,14,669,2761,497,12517,172
35940,4,86,1813,63,5976,23
4010,18,707,3486,398,16401,309
35323,21,827,1857,622,6787,205
3113,83,1243,3506,936,7141,307
29531,11,212,2128,177,4701,35
15253,8,356,2840,284,5580,72
13021,42,1453,3002,1011,20106,442
7493,16,417,3324,338,8454,79
31213,18,946,2044,754,14697,192
4735,12,195,3460,167,11348,28
11273,110,8185,3096,5885,127291,2300
38072,48,994,1680,765,9240,229
27662,58,2155,2230,1673,16535,482
28755,3,239,2167,186,4398,53
9414,5,185,3193,158,4396,27
30981,0,93,2055,81,3274,12
40392,2116,73200,1526,55358,229390,17842
19238,15,495,2654,395,23960,100
29738,13,441,2118,342,8809,99
42342,3,102,1252,82,6731,20
9667,26,672,3178,498,5530,174
2145,16,880,3522,703,20950,177
22067,4,549,2497,425,7599,124
8862,145,5722,3227,4166,45724,1556
3866,4,104,3491,90,5021,14
17232,5,330,2742,248,6137,82
33266,272,4382,1947,3425,28810,957
45475,9,211,453,174,3982,37
19219,7,1080,2655,457,7822,623
42910,13,292,1127,215,3190,77
40729,19,404,1497,303,7679,101
1534,7,278,3598,238,9930,40
29264,5,235,2142,163,6912,72
39089,7,131,1611,103,5423,28
6099,4,300,3391,248,6733,52
7215,13,488,3340,278,3934,210
2126,27,1120,3522,854,10690,266
5788,21,886,3406,713,5721,173
26000,20,526,2313,421,7284,105
7960,4,77,3288,68,2932,9
37823,656,14779,1696,10547,91470,4232
43704,30,489,880,367,7895,122
36548,25,813,1778,590,8764,223
10430,43,889,3143,680,13363,209
23367,64,7591,2433,5705,53019,1886
35341,0,321,1856,262,7621,59
40264,64,2757,1539,1928,29897,829
10487,1807,122119,3140,81319,215493,40800
4546,15,498,3467,416,8158,82
30084,79,1914,2101,1430,21632,484
31510,11,219,2027,179,5779,40
12788,12,378,3016,324,15792,54
20977,155,5183,2559,3726,27459,1457
20203,112,8507,2602,6093,60771,2414
11939,27,597,3063,295,6202,302
37472,28,1342,1721,1126,25466,216
4329,13,547,3475,446,28638,101
26672,60,3215,2283,2317,25441,898
5926,11,907,3398,701,6509,206
21061,19,555,2555,409,5695,146
19222,29,1190,2655,944,16951,246
40094,80,2777,1550,2088,26325,689
35462,1,117,1849,96,2438,21
1217,4,96,3766,82,2788,14
39511,58,2317,1587,1655,14041,662
45108,11,238,560,205,5153,33
40329,283,9063,1534,6192,71328,2871
2539,10,496,3516,308,5510,188
41094,7,148,1460,115,3108,33
22486,1,117,2476,104,8015,13
7297,6,99,3335,67,6430,32
13259,238,20512,2980,14911,98971,5601
6898,6,133,3357,101,7127,32
24371,0,55,2386,46,3048,9
44168,6,109,793,90,3104,19
1630,3,43,3579,40,1684,3
2150,44,1445,3522,1156,23629,289
42831,3,263,1145,204,8085,59
23735,8,264,2415,175,3836,89
5467,7,225,3422,182,4536,43
11364,9411,388841,3092,273825,772573,115016
17914,55,3928,2712,2958,24413,970
27020,158,10529,2269,7637,72141,2892
8948,14,287,3222,247,6133,40
26863,4,479,2273,404,6876,75
10101,1,75,3157,63,4054,12
36896,22,393,1757,336,5976,57
41097,52,589,1460,441,5802,148
37553,43,1196,1715,980,14095,216
10992,18,1078,3111,825,33559,253
25543,299,9643,2334,6978,55577,2665
25880,14,442,2319,343,10152,99
26791,0,94,2277,80,1382,14
7105,4,38,3346,32,2448,6
28097,1,32,2206,27,6651,5
43720,22,497,876,450,8390,47
34954,18,879,1876,702,6008,177
41746,317,6370,1362,4680,58947,1690
8197,45,2229,3269,1783,115766,446
43399,52,713,982,509,6947,204
19253,6,738,2653,588,9211,150
32799,9,187,1966,158,3947,29
15615,31,1282,2823,993,12363,289
36200,7,175,1795,139,4226,36
28809,0,1868,2164,1529,32420,339
26460,6,125,2292,100,7126,25
46135,4,56,189,45,1335,11
45668,0,29,379,18,3576,11
10242,21,900,3151,732,16643,168
8458,7,97,3252,85,8850,12
1489,15,627,3616,506,9813,121
16502,1,128,2783,111,11988,17
35705,1,56,1829,42,3693,14
3366,1,70,3501,59,3387,11
11883,17,250,3066,209,5252,41
19519,2,81,2639,68,3617,13
16477,2,248,2784,191,4309,57
37497,12,583,1719,464,15434,119
8815,1,121,3229,78,4154,43
8778,19,752,3231,565,11632,187
41870,21,1040,1339,694,24089,346
38642,75,4660,1639,3056,32726,1604
45534,117,1742,435,1302,20936,440
39750,4,223,1573,148,3993,75
36631,62,3075,1772,2312,32187,763
27861,6,88,2219,76,3724,12
36124,38,669,1799,510,6439,159
40745,23,311,1495,254,6905,57
11798,2,73,3069,62,2919,11
23306,34,2173,2436,1594,28173,579
3954,104,5775,3488,4098,57112,1677
45518,67,1197,440,1055,8558,142
9103,5,188,3213,120,5099,68
17579,1,65,2725,54,2561,11
8923,21,921,3223,720,21386,201
24370,2,105,2387,89,10583,16
25242,48,1717,2347,1380,19864,337
27170,1,46,2260,38,2255,8
21875,8,532,2508,461,16136,71
42780,1433,28420,1158,22981,317610,5439
43833,85,1049,831,843,15640,206
4179,14,143,3480,118,2753,25
26223,67,8440,2303,5886,30137,2554
3465,27,952,3499,754,15336,198
41752,10,544,1362,416,10523,128
20546,43,3151,2585,2623,17854,528
35683,20,262,1831,213,3779,49
37222,49,1142,1736,938,5186,204
3534,126,3619,3498,2047,13809,1572
7410,6,183,3329,151,9024,32
8012,3,130,3284,114,3016,16
32630,1,79,1973,66,2736,13
36659,0,72,1771,60,3998,12
6576,4,36,3372,33,2769,3
14509,78,5456,2886,3959,47605,1497
7089,61,2869,3346,1970,34534,899
31059,9,321,2051,259,4392,62
28072,0,34,2206,26,6065,8
31700,14,712,2017,515,16537,197
18339,7,887,2691,708,14383,179
42998,68,1543,1102,1086,35133,457
42028,135,2611,1315,1805,29807,806
12792,1,44,3016,40,2899,4
19925,20,1222,2618,918,10932,304
40939,45,891,1477,641,11477,250
45940,0,14,267,11,1182,3
14946,3,174,2857,111,5259,63
41009,15,357,1472,281,4979,76
27388,2,129,2246,105,3845,24
21393,2,89,2535,77,3216,12
4271,26,615,3477,503,12056,112
4937,36,281,3450,215,8232,66
41894,79,1617,1335,1241,34219,376
28486,18,1063,2183,886,8885,177
15696,2,233,2820,184,6147,49
40510,4,58,1515,45,5005,13
14427,2,101,2891,81,3256,20
32107,9,284,1996,213,11717,71
17796,9,228,2717,190,5211,38
17896,28,1580,2713,1183,24291,397
10546,4,215,3136,182,3261,33
18233,11,1177,2696,798,8495,379
37324,10,509,1730,419,6726,90
13763,21,907,2940,751,10048,156
4328,79,3659,3475,2875,11094,784
39465,0,66,1589,53,3740,13
43524,15,256,947,196,8393,60
22998,28,3609,2451,2650,17859,959
20677,17,2638,2579,2065,13280,573
27936,10,624,2214,465,11749,159
28006,22,856,2210,691,12329,165
3197,258,15370,3504,11583,186229,3787
13085,248,28265,2998,19109,95220,9156
22586,2,148,2471,122,5015,26
6876,3,154,3358,114,6910,40
22254,636,104790,2487,69253,288484,35537
4602,8,87,3464,73,3746,14
3278,7,90,3503,81,3684,9
45098,3,101,565,70,2567,31
33619,9,763,1934,599,13176,164
40980,119,1858,1474,1335,10012,523
5315,2,67,3429,46,4017,21
31733,2,227,2016,193,11798,34
44059,2,45,812,29,1858,16
11051,4,104,3109,63,4891,41
1629,15,216,3580,176,7333,40
4719,1,82,3460,60,2611,22
40569,9,1340,1510,1010,22311,330
11757,0,160364,3071,41537,2374,118827
31233,3,269,2042,198,4797,71
38886,73,1974,1624,1376,20261,598
12494,25,738,3032,606,4435,132
28327,0,98,2192,81,3609,17
37974,60,590,1686,462,6707,128
8590,36,1525,3243,1248,17741,277
24179,14,1034,2395,853,8533,181
29380,6,183,2135,151,6269,32
38837,35,536,1627,430,6472,106
11734,31,1883,3072,1437,32468,446
17517,9,1371,2728,1036,19234,335
41310,2,270,1429,216,7474,54
29285,3,319,2140,251,6579,68
41974,26,484,1323,387,9755,97
22218,12,814,2489,620,6006,194
39638,14,577,1579,445,9408,132
34232,556,31032,1914,19783,182509,11249
10352,79,2400,3146,1989,60913,411
37644,36,382,1710,295,4470,87
43066,4,64,1082,49,1566,15
17576,20,949,2725,774,6088,175
41228,81,1726,1443,1206,22488,520
39863,12,431,1566,303,6682,128
17298,24,588,2738,476,18941,112
36096,3,81,1801,75,3902,6
45670,104,1927,378,1576,9395,351
9668,3,267,3178,211,3589,56
10026,40,1475,3161,1147,11216,328
43947,148,2208,830,1551,21730,657
7739,340,16112,3309,11711,134639,4401
43724,279,3171,874,2673,27477,498
36991,0,78,1751,66,5014,12
45392,1,29,473,26,1417,3
11376,182,4553,3091,3220,43290,1333
37086,6,198,1745,163,8377,35
14836,7,357,2863,290,7518,67
24778,71,3148,2367,2262,23695,886
19060,189,6844,2662,4971,32333,1873
38157,58,2207,1674,1557,18345,650
13553,10,391,2956,290,7567,101
29349,19,1497,2136,1181,17173,316
42038,554,11673,1312,9150,96592,2523
42952,14,244,1115,164,13623,80
34616,42,3720,1896,2657,12857,1063
37070,13,345,1746,294,9187,51
12064,41,1023,3057,764,14380,259
11827,3,66,3068,45,4640,21
20099,21,823,2608,604,6884,219
35044,32,841,1871,643,9733,198
26209,2,431,2303,298,5665,133
27345,1,165,2249,135,3911,30
40989,5,141,1473,121,3627,20
29012,692,37540,2155,26293,123094,11247
30779,1,78,2063,51,7698,27
29362,10,303,2136,232,3967,71
39387,3,89,1593,71,3018,18
35207,42,1430,1863,1046,14388,384
5871,10,533,3401,438,7585,95
34768,1,307,1887,238,9658,69
45202,40,452,528,359,7354,93
14042,0,696,2918,556,4479,140
13876,39,809,2932,607,6076,202
9220,7,380,3206,245,9742,135
7821,9,172,3302,153,5799,19
12072,1,94,3057,78,6525,16
8028,65,1122,3277,782,12071,340
37812,10,702,1698,586,13087,116
3105,2,73,3506,69,2657,4
33045,6,125,1956,106,3606,19
30279,142,2508,2090,1996,16677,512
10140,415,13993,3156,10558,51687,3435
14238,4,267,2906,206,4140,61
6777,30,1313,3363,910,13136,403
23020,60,2147,2450,1643,22720,504
20813,9,513,2570,439,9078,74
5090,25,579,3442,491,10880,88
24533,42,1414,2379,1005,12053,409
31650,23,424,2019,351,5371,73
13797,15,566,2939,444,4307,122
27549,0,82,2236,69,2035,13
31238,124,3574,2042,2910,12926,664
22921,6,545,2454,475,6724,70
28692,32,2682,2170,2046,24674,636
7741,14,529,3309,421,6876,108
19220,461,21129,2655,15381,137131,5748
15642,32,2517,2822,1877,11284,640
46276,32,479,141,421,7701,58
39309,12,456,1597,368,8093,88
5342,9,188,3428,153,11016,35
28413,5,87,2187,70,3015,17
20303,495,28561,2597,20822,73501,7739
44820,17,194,660,168,6016,26
9206,6,258,3206,205,11862,53
6232,13,450,3387,356,11346,94
18622,3,184,2679,136,7511,48
34688,5,155,1891,122,2973,33
35384,54,1371,1854,1118,12078,253
29692,69,1718,2120,1301,15472,417
2034,18,792,3524,564,8844,228
18607,25,1070,2680,837,12486,233
19338,7,407,2648,316,8504,91
8322,2,82,3261,73,4422,9
25056,0,87,2355,73,7319,14
12983,208,20821,3004,15682,127222,5139
21163,11,444,2547,343,10868,101
9973,20,922,3164,714,7787,208
19724,9,1003,2629,753,10400,250
18362,7,303,2690,244,5229,59
39716,25,1353,1574,1109,26098,244
9904,0,62,3168,47,1879,15
40341,16,341,1532,263,7979,78
24218,23,728,2393,577,5954,151
14736,72,2250,2870,1738,17672,512
40142,13,344,1548,247,6775,97
29173,7,138,2146,114,4922,24
20277,36,1205,2598,927,12062,278
32980,1,44,1958,37,3414,7
28605,4,608,2175,519,4751,89
3990,1160,54393,3486,36750,193806,17643
36549,7,245,1778,206,3878,39
12112,59,2009,3054,1551,33435,458
32973,4,146,1959,123,5253,23
3084,379,11710,3506,9082,260131,2628
41744,11,160,1364,126,5848,34
4820,384,25575,3456,19161,110215,6414
4918,17,182,3450,136,6825,46
39585,54,1473,1582,1097,14605,376
32123,6,153,1995,122,6700,31
15602,41,1621,2824,1127,6397,494
37759,659,27038,1701,19599,153744,7439
14465,1,102,2889,81,3555,21
19431,32,2918,2643,2251,25020,667
12997,1346,67131,3003,49409,539677,17722
42723,254,11022,1173,7558,63138,3464
45028,69,615,600,474,4971,141
21498,33,1221,2529,826,11836,395
8822,1,35,3229,30,8173,5
44097,41,1174,797,869,10208,305
4941,28,804,3450,640,9963,164
34476,17,614,1903,512,14471,102
37166,21,651,1740,513,13088,138
30159,43,1177,2098,963,12840,214
23810,3,83,2413,71,3013,12
37263,25,669,1734,545,5869,124
30871,11,379,2059,293,4624,86
21089,152,9518,2553,7051,53882,2467
38890,30,748,1624,580,7627,168
4555,9,541,3466,393,19569,148
12307,34,1021,3044,832,6508,189
34233,11,640,1914,458,9651,182
24372,186,5973,2386,4566,59119,1407
42769,55,675,1162,533,10222,142
37707,29,471,1706,369,8459,102
21566,12,870,2525,685,8823,185
2581,95,3403,3515,2248,16958,1155
6659,2,16,3369,13,2588,3
19880,17,868,2621,680,9023,188
30409,34,682,2082,539,5912,143
34199,3884,146587,1914,103531,669737,43056
37434,42,626,1723,504,11938,122
40184,29,637,1545,493,6008,144
5306,2,32,3430,27,2187,5
28047,9,425,2208,347,13246,78
25403,3,285,2341,223,3999,62
42415,56,2016,1236,1301,10931,715
36235,83,1943,1794,1398,22982,545
46040,5,103,223,70,2325,33
32720,3,82,1969,73,2082,9
35172,12,715,1865,562,11928,153
16808,11,730,2765,588,11148,142
31111,2,120,2048,100,4272,20
41185,45,1688,1450,1100,27463,588
18471,33,1405,2686,1163,12920,242
19078,12,689,2661,597,4245,92
4853,17,378,3454,287,9056,91
41113,0,49,1458,39,3739,10
10379,31,2056,3145,1522,21665,534
26234,112,3705,2302,2630,16363,1075
25882,23,1496,2319,1138,10206,358
31107,8,161,2049,122,5231,39
34425,2,83,1905,66,1988,17
11311,1,49,3095,35,3235,14
6077,73,8866,3392,6495,33630,2371
13010,1,56,3003,41,7753,15
39473,41,1285,1588,1014,19686,271
8253,0,34,3265,32,2733,2
19141,12,1085,2659,883,9458,202
16292,14,575,2793,448,7948,127
6941,9,322,3355,221,4111,101
24670,62,1302,2371,1080,16441,222
30601,336,15933,2072,11653,77111,4280
3956,95,3342,3488,2662,31552,680
8942,25,685,3222,527,16142,158
15007,12,441,2854,328,4725,113
44929,161,2184,630,1703,17139,481
33907,16,466,1923,380,9259,86
44486,8,67,746,54,4313,13
3950,150,7401,3488,5528,60146,1873
5495,48,1410,3421,1015,9314,395
18055,16,439,2704,324,5819,115
1125,1,34,3796,30,2749,4
20905,27,1758,2563,1243,16732,515
32922,14,566,1960,428,5426,138
39800,5,94,1570,62,7819,32
12536,238,14030,3031,9757,160414,4273
17238,10,687,2741,554,5028,133
28815,1,102,2164,53,2556,49
17503,58,3389,2729,2247,37098,1142
15786,1,42,2816,37,2900,5
21214,4,148,2544,107,2751,41
33719,61,1684,1930,1310,19090,374
2435,61,6740,3517,5285,82008,1455
45258,77,815,512,656,15701,159
40769,201,6538,1492,5296,40141,1242
21579,706,39209,2524,28343,236649,10866
1477,0,38,3617,31,1657,7
37908,34,843,1690,664,12540,179
16047,14,639,2804,486,6664,153
6275,3,60,3385,52,3098,8
6974,162,5466,3353,4321,31255,1145
8620,2,243,3241,201,5520,42
3286,32,1025,3503,760,9528,265
10945,26,662,3113,487,3447,175
43484,109,1302,960,1001,13101,301
6171,6,69,3389,61,2062,8
29450,3,190,2131,145,3534,45
20575,348,13866,2584,10390,51658,3476
15038,18,321,2852,248,4495,73
41312,4,98,1429,68,2163,30
26650,3,167,2284,128,5815,39
3321,83,1527,3502,1158,33616,369
16787,7,310,2766,250,4071,60
46341,56,989,114,901,8707,88
26319,41,752,2299,577,8152,175
42357,43,850,1248,622,12555,228
21282,7,339,2541,256,7879,83
43303,1,25,967,22,2588,3
14840,37,907,2863,728,10738,179
46089,3,48,207,37,1032,11
46044,16,196,221,135,5457,61
29562,22,1223,2126,960,7559,263
13983,7,120,2922,83,8195,37
21166,43,2386,2547,1727,30044,659
9260,0,68,3203,55,4605,13
30182,14,691,2096,584,4752,107
5236,39,2452,3433,1885,14206,567
14540,3,123,2883,96,9116,27
26715,0,3705,2281,2925,18194,780
8711,1322,79866,3235,55784,188546,24082
32370,13,344,1984,268,8479,76
42647,12,287,1190,221,7396,66
21641,100,8183,2521,5102,81275,3081
10924,1,90,3115,59,3677,31
12570,17,541,3029,458,14700,83
22176,52,1883,2491,1431,24433,452
2019,84,1906,3524,1433,34606,473
19233,11,360,2654,294,3519,66
34773,47,1184,1887,983,12349,201
25560,1,44,2334,39,2430,5
40311,5,83,1536,59,3964,24
8059,0,34,3276,30,2905,4
2814,207,8332,3511,6515,91767,1817
44684,12,102,706,92,2441,10
40872,38,831,1482,633,20210,198
30346,15,642,2086,517,6027,125
27915,24,379,2215,286,3803,93
37161,71,1289,1740,1042,20314,247
13859,5,405,2934,308,12731,97
9925,2,34,3167,29,3851,5
45323,3,56,490,42,2495,14
32646,12,309,1972,255,3978,54
10393,5,184,3144,147,5047,37
24743,5,215,2368,171,4484,44
2003,2,40,3524,33,5818,7
6712,193,4984,3366,3619,62637,1365
18187,7,374,2698,279,13251,95
26769,2,95,2278,72,2738,23
31662,1,169,2019,121,7362,48
13566,5,183,2955,153,5099,30
33177,3,137,1950,109,3760,28
32771,25,791,1967,631,7361,160
43131,26,396,1063,333,12921,63
20561,0,1698,2584,1254,8055,444
46312,2,16,122,13,791,3
33670,68,1279,1932,998,15881,281
17456,67,2312,2731,1743,18147,569
16788,19,811,2766,657,13013,154
21751,3,152,2515,123,3588,29
41458,46,2350,1408,1640,24820,710
31564,2,425,2024,341,5573,84
15923,7,194,2811,151,5919,43
21077,80,4798,2554,3265,40380,1533
20498,92,3919,2588,3023,29652,896
45311,72,1253,494,898,14296,355
45249,123,1558,514,1379,16878,179
22159,64,4801,2492,3516,30730,1285
33292,35,294,1946,246,4727,48
2194,98,2322,3521,1395,12532,927
46193,106,1258,163,1112,14028,146
29010,45,2150,2155,1681,24840,469
2733,17,481,3513,399,5769,82
22855,5,252,2458,187,6187,65
42498,7,385,1219,313,6819,72
32574,7,319,1975,259,4283,60
4343,31,739,3474,441,9889,298
11146,28,1096,3102,844,21634,252
27511,2,204,2239,158,4637,46
14622,79,4442,2878,3512,39258,930
39787,13,155,1571,131,4283,24
40405,23,1255,1526,951,10231,304
21343,3,167,2538,142,2485,25
10310,13,333,3148,271,13678,62
24484,23,718,2381,589,5270,129
40403,69,1020,1526,829,10933,191
10875,9,683,3117,564,19109,119
5529,5,591,3419,329,11182,262
3608,2,69,3497,55,3199,14
11469,21,1219,3086,850,24353,369
30822,25,1554,2061,1070,16303,484
41945,258,9548,1327,6611,58992,2937
29606,37,1278,2124,1043,16824,235
22132,21,1680,2493,1273,37622,407
35557,16,410,1842,337,5296,73
3072,5,214,3506,174,8784,40
13781,14,657,2940,477,6581,180
14179,91,7623,2910,5361,61794,2262
14952,10,318,2856,276,11186,42
26651,99,2449,2284,1890,20362,559
15486,16,1091,2830,870,53359,221
43082,11,159,1077,100,3044,59
45522,50,580,439,477,5111,103
25775,1,190,2323,168,5159,22
29699,36,856,2119,600,3937,256
46014,9,349,236,181,2210,168
8044,80,2481,3277,1909,21234,572
8208,8,150,3268,97,6786,53
38960,13,335,1619,239,6742,96
22209,0,38,2489,31,2244,7
21390,4,141,2535,101,5420,40
28780,8,234,2166,201,3710,33
16369,0,0,2789,0,2904,0
26012,14,259,2312,184,6313,75
28986,19,560,2156,455,7324,105
25151,24,662,2351,550,4789,112
45361,23,419,482,312,4533,107
20523,4,30,2586,21,1800,9
22442,3,97,2479,78,2169,19
4129,7,256,3482,213,8546,43
20004,0,1061,2613,893,14751,168
15462,5,297,2832,230,5358,67
14734,6,170,2870,138,5042,32
13339,63,2985,2974,2362,33027,623
22217,9,540,2489,400,4579,140
8037,48,2019,3277,1286,28444,733
35450,24,757,1850,589,12818,168
31281,10,234,2040,165,5503,69
39096,196,10564,1611,7348,46893,3216
31313,3,148,2038,121,3642,27
25895,9,354,2318,286,4379,68
17544,2,47,2726,41,3211,6
19094,0,764,2660,571,14971,193
14772,91,5064,2867,3576,39977,1488
24185,10,748,2395,565,7802,183
45212,6,45,525,42,2153,3
36780,10,192,1764,150,9105,42
37444,23,513,1723,398,12693,115
6187,39,892,3389,672,6125,220
10437,17,496,3142,390,14763,106
12797,287,11623,3016,8527,34140,3096
31605,23,549,2022,456,30640,93
45654,24,355,386,215,8589,140
17411,428,12287,2732,8892,36067,3395
15131,39,565,2847,443,22088,122
4247,3,57,3478,48,3600,9
37381,35,701,1727,574,11103,127
41882,124,5477,1337,4022,42311,1455
25764,5,151,2324,118,8289,33
46111,0,10,200,8,858,2
14940,34,578,2857,418,6611,160
23687,127,4031,2417,3035,29613,996
39121,19,241,1609,195,4436,46
12407,2,94,3037,80,11241,14
14926,7,275,2858,212,5402,63
42416,30,823,1236,611,13873,212
6930,1,67,3356,52,3099,15
36178,7,191,1796,151,3930,40
41696,14,486,1373,335,8054,151
44915,86,1454,635,1178,17432,276
40582,64,1830,1509,1375,21339,455
32272,24,197,1988,158,3400,39
20846,35,1947,2568,1488,19633,459
18923,11,694,2667,590,4255,104
35646,2,80,1835,68,4268,12
43422,5,240,974,144,7335,96
32075,5,150,1998,109,3708,41
19118,3,262,2660,205,4969,57
15189,1,174,2843,130,7193,44
22848,197,7780,2458,5601,22552,2179
20409,31,1053,2592,861,9686,192
30073,18,823,2102,687,14358,136
16607,12,1026,2778,867,12745,159
41682,8,225,1375,177,9065,48
41926,8,398,1331,284,8346,114
43181,6,126,1049,94,3711,32
43855,5,124,844,98,3563,26
25435,18,1052,2339,843,11273,209
41487,18,586,1403,426,12076,160
19092,66,3875,2660,2842,30338,1033
24350,0,93,2387,70,2454,23
14670,1,101,2875,71,3067,30
16234,163,14999,2796,7933,57494,7066
34262,67,2430,1912,1962,18299,468
14461,10,1482,2889,1106,10353,376
23299,0,3328,2436,2218,50569,1110
6174,78,2732,3389,2101,19305,631
38274,4,241,1666,180,3821,61
19240,106,4125,2654,3142,27210,983
21463,28,1191,2531,931,10392,260
22511,4,249,2475,169,8676,80
14118,585,27088,2913,18763,103429,8325
38214,19,453,1670,344,5148,109
3786,55,2247,3493,1838,17873,409
4606,5,208,3464,153,6508,55
30499,8,127,2077,99,2747,28
20595,10,363,2583,305,14145,58
15993,3,274,2807,245,7769,29
29008,20,553,2155,384,4830,169
17234,19,742,2741,633,12455,109
45313,17,245,493,202,5309,43
27911,4,414,2215,258,3752,156
18975,5,211,2665,173,10545,38
29314,162,4436,2138,3460,25184,976
35964,3,262,1811,220,5161,42
2586,13,425,3515,331,10197,94
33125,388,10888,1952,9068,46269,1820
14344,435,26662,2897,18800,63245,7862
39019,37,1388,1616,1138,8279,250
3181,7,245,3504,194,9625,51
38087,61,1451,1680,1040,10780,411
40772,0,63,1492,52,5522,11
45263,1,19,509,13,1214,6
26329,367,13281,2299,9113,61127,4168
34354,8,279,1908,232,3175,47
17276,0,55,2739,37,2944,18
39772,11,207,1572,169,5490,38
24141,21,1057,2396,844,11739,213
6796,13,647,3362,512,13269,135
11277,27,1184,3096,856,29656,328
24316,26,621,2389,500,22416,121
18241,4,463,2695,330,9014,133
12557,27,61641,3030,19040,15518,42601
37739,7,783,1703,586,17900,197
2782,26,556,3512,399,5923,157
14307,25,1334,2900,1021,30243,313
12426,10,1577,3036,1217,15473,360
36910,16,518,1756,445,11501,73
13921,10,810,2927,660,6654,150
16906,145,6565,2761,4411,45565,2154
36010,6,191,1807,161,3554,30
13645,15,907,2950,601,13114,306
18529,158,11746,2684,8982,77348,2764
33164,3,136,1950,111,4229,25
33169,0,77,1950,69,2602,8
8174,27,993,3271,791,58733,202
28555,18,586,2178,458,7485,128
43579,275,4675,926,3775,37677,900
14058,0,1618,2916,1301,13947,317
15151,10,842,2845,645,16692,197
34690,19,500,1891,422,2899,78
38340,7,314,1661,248,8642,66
18154,7,427,2700,331,14370,96
26392,7,209,2295,172,5180,37
37652,17,574,1709,413,5355,161
28297,101,3523,2194,2818,34835,705
30450,9,203,2080,172,4437,31
5376,2,23,3426,20,2381,3
38936,1,40,1621,33,5907,7
13814,1612,111426,2937,77690,394750,33736
43457,55,1549,965,1041,16252,508
17529,3,107,2727,90,3506,17
19087,12,824,2660,644,13058,180
13556,17,1434,2956,1124,34038,310
40656,50,1977,1504,1501,28185,476
14473,14,555,2888,439,7035,116
29428,28,905,2132,703,9630,202
11772,7,229,3070,192,5209,37
42749,42,1148,1166,878,11218,270
29523,213,5954,2128,4510,24741,1444
19398,8,388,2645,311,17352,77
34697,41,3476,1891,2499,18633,977
28504,28,747,2182,609,6559,138
41823,8,255,1346,206,5831,49
19994,134,3397,2614,2501,20365,896
13644,15,1058,2951,630,6930,428
9480,10,513,3188,387,15989,126
31612,154,5543,2022,4359,44800,1184
38684,19,559,1636,427,19621,132
37662,22,781,1709,605,12007,176
45195,6,95,530,88,4200,7
11434,829,43883,3088,32568,145373,11315
7017,1,89,3350,73,4885,16
17982,1,100,2707,78,5178,22
3363,11,277,3501,228,5077,49
6775,62,825,3363,624,5546,201
32962,27,785,1959,652,6759,133
33176,11,559,1950,426,6880,133
20275,262,14707,2598,10909,88931,3798
19025,6,300,2663,235,4816,65
39215,434,8336,1603,7126,42986,1210
28353,2,287,2191,231,10477,56
19864,9,402,2621,335,12646,67
23926,116,7895,2406,6063,72543,1832
28226,9,149,2198,113,4165,36
10100,3,191,3157,130,3352,61
8426,50,1286,3254,1028,13486,258
10713,286,9302,3126,6891,44179,2411
32603,8,139,1974,112,2736,27
40000,22,470,1556,372,5810,98
45590,7,133,417,67,2241,66
29924,15,260,2108,225,4022,35
37032,33,652,1748,487,9083,165
3767,2,38,3493,34,1952,4
31560,15,1980,2024,1615,19244,365
7111,16,811,3345,656,12262,155
36205,71,2469,1795,1866,16609,603
35662,13,508,1833,428,11236,80
6361,8,280,3381,236,10341,44
40252,14,206,1540,171,8371,35
26058,1,108,2310,95,3642,13
31088,13,219,2050,200,3543,19
8685,11,343,3237,291,3591,52
21578,26,887,2524,714,11492,173
40137,3,57,1548,43,2932,14
23903,28,868,2408,699,8770,169
8671,41,2072,3238,1515,37768,557
4413,23,567,3472,446,5718,121
17151,1,259,2746,204,9502,55
31306,15,1007,2039,782,10205,225
2824,26,1343,3511,1113,18006,230
32379,1,27,1983,21,1694,6
3645,152,8613,3496,6426,40355,2187
15623,6,711,2823,537,30508,174
14948,453,33617,2857,21514,128573,12103
24439,6,397,2383,326,8567,71
45324,3,101,490,53,3292,48
40700,1,52,1499,41,3136,11
12511,2,115,3031,95,2413,20
36473,1,54,1782,37,3096,17
4952,412,27593,3449,20597,93391,6996
5979,4,468,3395,329,8010,139
15828,0,85,2814,73,2745,12
28123,9,335,2204,277,5520,58
31093,3,171,2050,146,3728,25
22570,11,1008,2471,817,19768,191
17246,16,1081,2741,817,10839,264
4143,52,1725,3482,1359,11487,366
8831,4,76,3228,66,1770,10
39536,107,3835,1585,2832,29484,1003
28345,0,55,2191,48,2422,7
28717,31,1229,2169,933,10786,296
10067,61,3164,3159,2536,42952,628
10768,623,26150,3123,20586,98725,5564
6693,3,45,3367,39,3056,6
36508,4,137,1779,99,6677,38
10485,81,13908,3140,10431,26115,3477
11103,8,231,3105,185,7831,46
38820,1,65,1628,49,2027,16
40424,22,374,1524,296,5866,78
5355,39,2796,3427,2024,49928,772
30136,41,1478,2099,1221,9119,257
7393,31,1198,3330,901,19017,297
14378,27,2787,2894,2078,28823,709
2092,36,1818,3523,1481,15619,337
28272,7,269,2195,204,3921,65
34068,10,291,1918,238,4175,53
31847,9,621,2010,445,7279,176
27066,7,211,2266,168,4070,43
9931,33,1213,3166,924,10416,289
14205,2,85,2909,73,3018,12
19362,170,12732,2647,8927,59750,3805
29642,218,16130,2122,10525,88365,5605
35061,30,736,1871,624,4933,112
21309,8,309,2540,232,7135,77
13730,43,1283,2943,1001,12794,282
26775,46,1170,2278,917,11083,253
43109,7,385,1069,248,14372,137
34336,4,141,1909,112,1926,29
12901,7,226,3010,186,3208,40
7093,9,138,3346,111,5779,27
32790,30,851,1966,678,7912,173
20515,13,1204,2587,804,8203,400
16942,70,3789,2759,2903,41099,886
40974,1,75,1475,64,3356,11
15345,42,2453,2836,1953,26144,500
3529,106,3305,3498,2598,27901,707
30683,1,221,2067,162,3807,59
26808,13,492,2276,405,5497,87
33027,6,167,1956,134,3112,33
21033,13,673,2555,530,10970,143
44233,16,214,782,157,5268,57
28922,21,254,2159,208,4106,46
15179,16,708,2844,575,5438,133
17570,11,207,2725,181,3137,26
3194,16,575,3504,453,7958,122
36967,48,4041,1752,2825,26402,1216
23678,177,5823,2417,4353,68179,1470
12758,3,174,3018,152,26973,22
20944,22,1019,2561,846,7230,173
32363,169,7290,1984,5527,39536,1763
42142,9,241,1292,195,5082,46
44880,45,292,643,241,6827,51
974,7,619,3846,501,9162,118
2578,128,9863,3515,6398,36767,3465
16694,1,108,2773,61,4431,47
23649,133,5410,2419,4231,37796,1179
6001,44,1756,3395,1400,27254,356
6003,9,209,3395,169,8721,40
7009,433,12201,3351,8230,38847,3971
30675,46,1159,2068,865,11573,294
41718,110,1046,1369,732,10634,314
30736,3,49,2065,44,1657,5
41039,246,6351,1469,4569,55723,1782
35788,14,215,1823,175,4482,40
16083,17,806,2802,631,5237,175
31343,6,153,2037,126,7683,27
8921,21,1056,3224,756,9225,300
12293,33,902,3045,709,8968,193
20251,45,2914,2599,2349,8969,565
10277,2,123,3150,93,3854,30
18209,40,1864,2697,1441,21959,423
38904,28,431,1623,366,5251,65
19501,13,567,2640,439,7960,128
9967,54,6020,3164,4570,14786,1450
31147,8,403,2047,308,5620,95
21069,21,867,2554,680,9424,187
2336,54,2488,3519,1846,44777,642
5577,4,83,3416,66,2588,17
40028,4,90,1554,73,4308,17
7657,5,186502,3314,64647,5786,121855
4681,6,312,3462,249,14587,63
2474,58,1854,3517,1204,12636,650
40384,11,291,1527,230,10683,61
20152,5,159,2605,130,4391,29
29247,38,2414,2142,1918,10381,496
16495,158,25661,2783,17197,53910,8464
41466,4,121,1406,92,3305,29
36220,1,15,1794,13,1924,2
20364,4,236,2595,195,7506,41
18465,2,214,2686,176,4430,38
41133,2,82,1456,63,4780,19
11493,53,3256,3084,2493,28991,763
1909,44,1866,3527,1299,22382,567
1678,0,37,3566,34,1668,3
24336,3,76,2388,66,5831,10
26479,0,3165,2291,2234,21294,931
7040,1,74,3348,66,2165,8
44965,15,402,619,264,6432,138
1212,2,38,3766,33,2463,5
29504,4,82,2128,66,4094,16
19388,1178,111481,2646,70808,558769,40673
37723,5,235,1704,199,3862,36
21051,1,58,2555,48,3998,10
6914,2821,117680,3357,78803,409253,38877
39695,51,1746,1575,1289,16860,457
5776,2,102,3406,75,12853,27
27786,55,2539,2222,1984,14619,555
32221,11,1009,1990,789,11484,220
30686,11,546,2067,451,5722,95
7809,18,653,3304,485,4326,168
2775,81,3642,3512,2931,34901,711
39668,58,592,1577,444,5610,148
32277,1001,48956,1988,34194,155572,14762
38873,8,199,1625,158,3528,41
2048,21,817,3524,625,17340,192
4807,60,3070,3456,2454,19825,616
45807,2,54,324,39,1192,15
31881,3,50,2008,39,2886,11
5638,32,1358,3413,962,21443,396
11329,25,878,3094,607,11764,271
46280,0,14,139,9,508,5
45840,10,124,313,108,2844,16
45896,75,605,293,480,8766,125
27030,4,50,2268,41,2241,9
29666,9,472,2121,338,11654,134
26328,86,8021,2299,4816,21155,3205
32468,2,106,1980,91,3177,15
4705,42,1140,3461,907,15601,233
14602,5,313,2879,234,6882,79
16550,17,835,2780,627,6638,208
46158,13,166,175,138,2396,28
4529,15,1258,3468,895,9547,363
33086,165,6140,1954,4458,44466,1682
11055,3,142,3108,126,4452,16
13446,62,2773,2964,2050,14301,723
38308,2,128,1663,96,4547,32
34226,2,64,1914,50,1331,14
32190,0,46,1992,35,2269,11
36922,2,33,1755,26,2462,7
33726,8,555,1930,433,7027,122
21207,34,1780,2544,1316,11274,464
42684,201,5430,1180,4130,36201,1300
14996,82,10456,2854,7757,66142,2699
42821,55,1044,1148,826,24455,218
27192,4,122,2259,114,1667,8
45440,434,7919,462,6497,41568,1422
7313,3,108,3334,94,5680,14
20458,8,964,2590,745,20616,219
4547,4,291,3467,146,4918,145
23144,44,3602,2444,2733,26352,869
5579,82,2174,3416,1705,39094,469
13908,13,1131,2928,916,6644,215
5016,105,4553,3446,3446,44074,1107
39645,20,360,1578,263,5971,97
16252,25,1314,2795,1048,6822,266
15728,21,3315,2818,2233,10385,1082
39543,25,401,1585,323,10845,78
45349,1,39,485,26,2106,13
41410,30,782,1415,553,12481,229
34163,0,0,1915,0,2447,0
3122,10,293,3506,236,10216,57
26573,0,68,2287,60,1896,8
18787,53,1556,2672,1177,24181,379
23495,9,436,2427,352,5581,84
25951,20,467,2315,382,8090,85
30967,5,68,2056,51,2427,17
12702,54,1510,3021,1091,7082,419
43638,52,700,903,584,20432,116
19105,10,748,2660,438,13991,310
34870,42,2092,1880,1547,17202,545
36110,7,264,1800,207,3378,57
26165,10,215,2306,181,3900,34
41848,0,0,1343,0,3742,0
2550,15,404,3515,315,7402,89
3172,1596,74759,3505,50436,275074,24323
40488,4,71,1517,52,2755,19
25205,1,33,2348,29,5038,4
2053,85,7243,3524,5209,32422,2034
45694,10,90,369,69,1332,21
39229,10,432,1602,329,10545,103
42876,127,6185,1136,4440,47517,1745
34644,77,1356,1893,1123,9391,233
14583,22,636,2880,522,9462,114
27083,2,76,2266,71,3400,5
22423,1,283,2480,223,3578,60
3156,5,350,3505,223,8862,127
19009,535,32536,2664,24301,155965,8235
36887,163,5557,1757,3796,20937,1761
12259,0,0,3046,0,3537,0
9765,7,276,3174,223,2826,53
45175,10,154,536,110,3287,44
40629,13,318,1505,247,15086,71
31021,2,96,2053,76,4938,20
39826,13,437,1569,324,15335,113
28778,11,221,2166,171,7074,50
7969,27,624,3287,490,9152,134
21181,6,686,2546,406,4510,280
17748,43,5341,2718,4066,22583,1275
14090,28,630,2914,477,5247,153
15100,2,30,2848,23,1948,7
28731,173,5452,2168,4202,33142,1250
19058,65,3322,2662,2581,20858,741
12495,4,88,3032,59,2717,29
8388,163,11041,3256,7143,44364,3898
18167,124,5093,2699,3699,25081,1394
5274,14,298,3431,232,8262,66
36742,0,41,1767,34,4052,7
33035,13,485,1956,407,9970,78
7711,11,622,3311,409,5812,213
14792,10,299,2866,258,4877,41
11458,671,28083,3087,22024,112701,6059
24279,337,164749,2390,114608,106134,50141
19980,0,144,2614,115,3697,29
1258,13,415,3751,353,7372,62
10700,45,1219,3127,913,29171,306
25964,2,256,2314,201,3290,55
44209,6,87,784,74,3316,13
9707,7,358,3177,308,6253,50
5173,2,77,3437,59,2626,18
30875,48,2813,2059,2173,16926,640
21589,0,153,2524,119,2691,34
2848,46,1853,3511,1327,33946,526
4127,4,126,3482,93,4527,33
20386,27,402,2594,332,5887,70
43610,18,515,912,421,8816,94
16904,22,859,2762,614,15675,245
20387,56,2157,2594,1699,13625,458
17112,4,447,2749,333,12335,114
8839,0,14,3228,11,1320,3
32518,3,122,1978,95,2591,27
45266,493,8386,507,5847,49544,2539
23161,0,57,2443,49,3306,8
1855,15,277,3528,241,15299,36
3233,9,271,3504,209,10631,62
30910,65,2277,2058,1763,29129,514
41012,468,9818,1472,7537,45275,2281
43980,17,333,825,258,9143,75
16608,23,527,2778,420,5493,107
44933,28,275,629,248,6478,27
37495,2,225,1719,191,4001,34
39129,14,592,1609,450,9560,142
27434,38,3264,2244,2575,29111,689
45778,43,502,331,434,10197,68
42600,23,609,1200,497,15709,112
18253,11,293,2695,224,2470,69
45036,6,164,595,96,4913,68
45019,21,175,603,99,2069,76
29215,3,276,2144,232,3902,44
28927,3,104,2159,93,3944,11
37852,7,225,1694,183,11055,42
38934,0,59,1621,52,3634,7
42170,26,317,1285,245,6114,72
17394,10,631,2733,475,15126,156
39307,16,555,1597,454,16059,101
37824,25,359,1696,273,8045,86
3175,6,259,3505,220,8463,39
29947,44,674,2107,551,9703,123
25484,1,119,2337,92,2675,27
42620,4,274,1196,176,4599,98
25513,13,468,2336,350,4352,118
18950,3,107,2666,78,7510,29
40223,4,106,1542,82,3996,24
46041,1,51,223,32,5459,19
34798,32,1047,1885,809,17920,238
37401,0,47,1725,37,3331,10
22987,11,524,2451,401,11962,123
18423,112,6349,2688,4835,40813,1514
31265,102,2308,2041,1794,20051,514
45432,29,298,463,239,4962,59
7275,110,5072,3337,3794,53719,1278
18404,142,6734,2689,4927,53593,1807
21990,18,2440,2501,1737,13235,703
11417,99,5966,3090,4439,81286,1527
26145,25,1120,2307,968,10266,152
41428,94,1973,1412,1502,28828,471
17185,0,74,2745,59,3404,15
17178,5,330,2745,242,8196,88
43551,26,827,935,616,10052,211
36813,56,2394,1762,1790,31884,604
18869,11,431,2668,350,6897,81
23820,15,375,2412,292,2056,83
8759,140,6161,3232,4610,48986,1551
13768,7,448,2940,359,9507,89
1963,20,397,3525,327,16233,70
24786,4,66,2367,55,3329,11
17371,12,542,2734,447,4871,95
19915,421,15040,2619,10664,106615,4376
40858,4,138,1483,114,6270,24
33830,7,703,1926,612,3397,91
42312,14,198,1257,141,4359,57
28492,68,2110,2183,1368,12436,742
4656,67,4630,3463,3030,88692,1600
2617,4,160,3514,131,3525,29
18317,51,2205,2692,1706,14591,499
14856,17,2758,2862,2175,25055,583
26009,8,467,2312,367,10019,100
30007,29,3585,2105,2582,27762,1003
29461,44,4573,2130,3628,11864,945
23906,6,264,2408,220,7310,44
35210,12,324,1863,292,5759,32
16493,93,1541,2783,1072,14680,469
18895,19,2112,2668,1685,6113,427
45280,15,209,503,171,6129,38
17195,90,21260,2744,16026,48314,5234
3579,19,340,3497,284,8659,56
31707,5,280,2016,228,6659,52
37636,39,353,1710,284,3403,69
6613,8,968,3370,785,17088,183
6359,842,47148,3381,34192,214898,12956
19426,15,738,2644,546,14372,192
6283,12,336,3385,293,4724,43
43429,40,428,973,350,10174,78
8504,3,77,3249,65,2563,12
36174,9,344,1796,278,5123,66
5393,6,151,3425,125,3880,26
5717,137,3790,3409,2998,23330,792
28173,31,1374,2201,1072,14573,302
19303,124,8266,2650,6453,14453,1813
4429,403,16558,3471,11928,54341,4630
28430,278,10370,2186,7678,65147,2692
39926,75,841,1561,598,7109,243
43766,101,1524,862,1066,23689,458
41459,9,251,1407,190,6288,61
4520,662,42682,3468,30464,174449,12218
40592,5,88,1508,71,2269,17
45733,9,126,348,109,3601,17
8319,5,34,3261,28,1898,6
7555,13,539,3320,439,10832,100
25779,4,224,2323,177,2779,47
17826,36,1418,2716,1092,8871,326
16012,12,1835,2807,1483,21802,352
2300,116,4521,3520,3575,35413,946
6671,46,1627,3368,1299,28021,328
20013,8,281,2612,207,6604,74
21737,7,517,2515,433,5849,84
18403,13,812,2689,689,8297,123
10377,0,81,3145,49,1938,32
33823,1380,51937,1926,38072,299206,13865
24895,158,826,2362,619,15180,207
5233,40,1472,3433,1174,23820,298
7822,77,3602,3302,2868,30439,734
18870,3,271,2668,214,6431,57
45303,12,165,498,126,5261,39
28785,7,174,2165,121,1551,53
41349,6,143,1424,100,7241,43
36443,14,260,1783,204,4242,56
44606,22,266,723,234,7651,32
12445,14,475,3035,381,4305,94
17455,34,1545,2731,1101,13862,444
20060,43,1853,2611,1455,10007,398
29703,0,376,2119,323,5924,53
28469,100,4849,2184,3454,29196,1395
25710,7,136,2326,118,4531,18
4678,8,121,3462,88,3653,33
14181,30,2651,2910,1798,31058,853
23029,8,189,2450,161,3965,28
10966,16,878,3112,719,8774,159
27136,34,1506,2262,1166,13979,340
38664,15,323,1638,259,4038,64
32261,92,1342,1989,1133,11662,209
25110,2,103,2352,80,4335,23
23742,56,1188,2415,951,15268,237
32800,29,576,1966,467,3138,109
26046,9,287,2311,235,4077,52
3467,16,510,3499,412,15827,98
17717,18,1233,2720,911,8135,322
20548,4,247,2585,183,5347,64
16671,35,1754,2774,1323,47530,431
27159,0,110,2261,86,2719,24
31434,12,222,2032,178,7684,44
36656,3,79,1771,66,3981,13
28899,23,1719,2160,1377,10234,342
45530,87,882,437,738,6519,144
17566,30,3467,2725,2795,35292,672
1122,7,146,3796,121,6387,25
21912,18,446,2506,359,5840,87
45002,4,45,609,27,2050,18
2574,14,377,3515,276,7043,101
45143,19,180,545,124,4646,56
39132,8,137,1609,116,5453,21
36482,10,188,1781,156,5461,32
9750,3,199,3175,150,2237,49
45950,1,27,264,19,1926,8
12220,14,493,3049,405,5568,88
35769,45,2186,1825,1719,21134,467
40450,15,613,1521,437,18535,176
23605,191,10725,2422,7585,68801,3140
23622,30,1330,2421,1078,22303,252
5597,13,297,3415,233,3425,64
45723,4,52,351,39,5116,13
2283,12,841,3520,624,18122,217
28328,13,790,2192,618,10999,172
29871,2,140,2111,111,3038,29
29030,30,1625,2153,1100,49884,525
41160,181,6775,1453,5078,37493,1697
40540,7,157,1513,124,6818,33
44869,5,43,645,31,1792,12
7479,3,111,3325,98,4732,13
32342,113,2576,1985,1876,10369,700
20524,33,1795,2586,1346,5469,449
26538,52,1286,2288,940,11595,346
6167,1,321,3389,256,8453,65
20432,432,45415,2591,29425,118313,15990
31835,223,5009,2010,3635,31208,1374
44635,0,12,721,7,1595,5
4322,38,868,3475,687,18965,181
21366,8,555,2536,430,4379,125
42217,5,104,1275,83,2839,21
25813,27,686,2321,563,11561,123
7549,52,1589,3321,1128,23653,461
15586,22,1656,2824,1267,21527,389
13014,19,901,3002,666,18241,235
21781,18,717,2513,563,7930,154
2731,1,27,3513,21,2742,6
38919,6,184,1623,131,5081,53
3896,17,391,3490,318,7939,73
23304,35,1757,2436,1325,21975,432
12762,25,1104,3018,880,24463,224
31996,3,175,2002,124,3762,51
18829,17,1967,2670,1433,9385,534
35477,33,851,1848,718,15442,133
7021,32,1467,3350,1131,21495,336
5605,2,152,3415,122,3966,30
2879,11,336,3510,281,5262,55
38955,408,14155,1620,10188,96967,3967
23672,36,4741,2418,3383,61532,1358
33639,12,373,1933,298,5323,75
14990,12,293,2854,212,6073,81
29056,3,272,2152,222,12834,50
13798,57,3750,2938,2291,107517,1459
42636,0,15,1193,13,1787,2
18430,286,12241,2687,7698,50817,4543
8578,2,100,3243,73,4510,27
28636,45,1325,2173,946,10930,379
41031,4,106,1470,88,6413,18
44936,42,333,629,247,5827,86
12466,2726,168529,3034,116173,616207,52356
27056,0,139,2267,117,5854,22
1960,12,111,3525,83,5173,28
14206,34,1324,2909,1034,13830,290
5659,36,583,3412,461,6628,122
39924,5,207,1561,159,4297,48
10543,65,3148,3136,2444,27811,704
26166,0,40,2306,36,2328,4
26789,5,372,2277,318,5501,54
10832,87,3078,3119,2385,32393,693
4655,20,583,3463,454,21822,129
32901,19,319,1961,271,4860,48
38017,28,648,1684,510,8276,138
42318,4,109,1256,83,5460,26
39248,8,173,1600,141,13935,32
27526,15,830,2238,665,10969,165
12665,28,615,3023,485,5136,130
41813,75,1898,1348,1461,40339,437
35802,7,321,1822,234,10753,87
20558,13,609,2585,488,14171,121
36899,3,90,1757,65,2741,25
35118,972,48531,1868,30956,197540,17575
43811,13,249,852,199,6466,50
32056,1,74,1999,47,5489,27
23406,126,5560,2431,4269,57033,1291
44800,5,65,667,49,2636,16
6808,10,43,3361,34,4952,9
22117,13,526,2493,401,8605,125
39093,18,463,1611,382,10213,81
16402,9,731,2787,442,11767,289
5455,12,392,3422,286,6294,106
32042,44,1867,2000,1412,20701,455
36753,14,538,1766,443,9339,95
35649,5,371,1834,297,7013,74
10135,35,1025,3156,798,23604,227
7760,2,78,3307,63,2302,15
8165,2,31,3271,28,1938,3
41832,179,2936,1345,2096,18247,840
13551,67,7084,2957,5353,82700,1731
43030,14,113,1094,105,3549,8
36263,19,431,1792,354,6944,77
2602,14,776,3515,646,40989,130
35975,5,119,1810,96,3981,23
39035,26,645,1615,504,12665,141
7295,5,349,3336,269,8507,80
36359,242,7435,1787,5350,79413,2085
18497,650,46039,2685,30365,160650,15674
42857,5,96,1142,69,4780,27
40578,168,3847,1509,2852,23429,995
9225,36,2527,3205,1882,25077,645
30071,5,293,2102,234,4517,59
25449,74,2631,2339,2081,15826,550
44629,1899,89342,721,66495,253582,22847
6617,26,651,3370,520,9248,131
7742,13,233,3309,183,10806,50
36335,3,102,1788,84,3878,18
39579,2,98,1582,85,5453,13
36269,48,1471,1791,1113,12577,358
32478,13,1182,1980,830,9290,352
25243,30,1057,2347,873,14129,184
15021,2,105,2853,89,2841,16
27314,26,728,2252,615,12871,113
2326,23,353,3519,306,6019,47
19728,5,110,2629,86,7164,24
2970,10,331,3508,252,7028,79
34531,24,788,1900,596,11104,192
6447,144,8129,3378,5432,23911,2697
45417,15,111,466,88,4041,23
10175,0,77,3154,32,4176,45
8027,2,41,3283,34,2172,7
2714,2,80,3513,52,4534,28
24068,26,755,2400,533,10504,222
32763,17,511,1968,386,8406,125
2489,18,320,3516,271,10317,49
18355,39,1124,2690,900,9160,224
34069,5,55,1918,45,6245,10
15641,27,930,2822,751,10411,179
45588,0,884,417,715,5417,169
4243,34,1310,3478,1021,9081,289
9072,19,393,3214,320,5867,73
37670,6,181,1708,156,4280,25
34841,287,5874,1882,3958,34811,1916
18539,639,63762,2683,46726,336739,17036
35573,0,37,1841,32,2575,5
4850,14,542,3455,432,8997,110
26247,70,3706,2302,3006,47080,700
17969,20,684,2708,518,7353,166
25290,19,587,2345,465,5179,122
14972,10,182,2856,145,4049,37
10608,2,185,3132,165,3599,20
14452,10,798,2890,562,29147,236
12375,29,1677,3039,1227,23861,450
28566,7,219,2177,167,2008,52
43367,2,104,992,66,4378,38
24868,26,595,2364,464,5414,131
30391,7,290,2083,204,12116,86
12750,10,366,3019,288,7749,78
26852,29,1757,2274,1328,25220,429
21318,12,1041,2539,815,25431,226
33557,11,325,1936,252,7445,73
4615,12,368,3464,291,5082,77
29382,4,168,2134,143,8516,25
45713,12,269,357,212,8525,57
25707,107,1587,2326,1190,12886,397
39264,5,174,1599,133,5546,41
8170,5,416,3271,317,5553,99
9342,1,99,3197,75,2887,24
11703,1,134,3074,91,4936,43
23207,18,851,2441,680,11933,171
12198,3,468,3050,357,14129,111
19507,10,624,2640,483,4776,141
12904,6,301,3010,253,2452,48
21041,35,1438,2555,1190,6045,248
38667,10,364,1638,199,5339,165
18324,51,3277,2692,2257,14024,1020
44245,0,19,780,16,3687,3
2111,7,134,3523,109,4852,25
14587,5,245,2880,173,8081,72
32088,12,205,1997,135,2708,70
30506,33,694,2076,557,10991,137
31478,9,208,2029,162,4442,46
45102,282,2593,562,2150,24298,443
37182,60,1044,1739,841,8593,203
20237,158,7769,2600,5213,70195,2556
16863,11,667,2763,569,5454,98
19428,14,2345,2644,1862,24354,483
19722,13,1039,2629,842,7489,197
7891,53,1984,3296,1632,27814,352
4868,413,17710,3454,13135,79594,4575
26204,22,974,2304,755,12796,219
23088,557,22035,2447,15870,136512,6165
1297,19,494,3738,402,7630,92
18164,14,250,2700,197,5858,53
8870,5,140,3226,109,2392,31
25996,337,19173,2313,11247,84102,7926
23602,7,264,2422,228,4030,36
12820,2,302,3015,249,4606,53
8489,346,9522,3249,7049,37578,2473
25867,43,1458,2319,1076,14067,382
35988,13,283,1809,232,11519,51
34776,4,221,1887,185,5288,36
10523,6,286,3138,238,4054,48
37352,68,934,1729,764,6794,170
45307,10,123,496,117,5108,6
19736,1,112,2629,88,6474,24
6191,32,1251,3388,1016,16113,235
13996,6,218,2921,173,4351,45
15850,2,46,2814,40,2503,6
3488,22,1365,3499,1134,11523,231
39032,43,636,1616,468,7513,168
11562,1,68,3081,54,1417,14
7478,0,35,3325,31,3029,4
25708,6,130,2326,81,4295,49
6413,3,124,3379,98,7035,26
9713,7,106,3177,71,3730,35
16799,5,478,2766,370,7350,108
24605,67,2432,2374,1905,20872,527
42045,20,553,1311,408,7334,145
4942,19,613,3450,470,8344,143
12181,14,667,3050,528,12979,139
22536,100,9158,2473,6159,42884,2999
23666,1437,63124,2418,43188,295202,19936
20032,7,484,2612,354,7195,130
20313,9,913,2597,681,7920,232
13924,14,689,2927,524,10783,165
2182,2217,112758,3522,76105,728605,36653
43110,8,194,1069,143,7013,51
24171,0,17636,2395,13497,68339,4139
36009,2,85,1807,70,2885,15
21680,116,7142,2518,4846,48264,2296
15411,341,27025,2834,18175,96929,8850
3275,86,3366,3503,2747,47209,619
42273,51,1643,1264,1019,14990,624
14819,32,1736,2864,1231,36862,505
33011,11,586,1957,436,14840,150
21488,4,305,2530,245,5039,60
12823,36,851,3014,634,6752,217
2707,13,327,3513,242,7479,85
31944,3,183,2005,141,6715,42
4108,92,4496,3483,3536,20798,960
40706,8,298,1499,222,8991,76
38397,68,1528,1657,1211,20559,317
9300,16,789,3201,618,7098,171
43349,22,352,999,259,5324,93
16593,75,4879,2779,3619,56286,1260
35682,12,233,1831,193,2547,40
23053,3,280,2449,234,4810,46
36276,13,1916,1791,1298,22304,618
4094,124,4801,3483,3686,34317,1115
20878,0,867,2566,642,8154,225
16344,42,1641,2790,1241,14014,400
36550,86,1978,1778,1581,18173,397
12456,8,122,3034,93,2187,29
19531,1039,60239,2639,41488,285979,18751
44527,23,324,740,263,4796,61
5107,30,441,3441,385,6249,56
10481,55,2174,3140,1583,11597,591
40844,5,107,1485,88,4179,19
10976,10,333,3112,261,3713,72
7983,57,2323,3285,1765,14840,558
25179,0,1552,2349,1172,9170,380
37630,6,214,1710,166,9849,48
3026,22,864,3507,621,5634,243
19878,5,235,2621,201,9850,34
28620,0,543,2174,416,7187,127
10255,16,962,3151,743,14064,219
10239,173,10014,3151,7682,50138,2332
8852,16,1305,3227,1014,24506,291
27500,190,9495,2240,6891,64880,2604
42351,1,35,1250,28,3079,7
36755,10,250,1766,200,2978,50
18206,86,5604,2698,4159,31348,1445
4208,1,32,3479,29,1949,3
13208,685,34942,2983,24941,351533,10001
26334,2,93,2298,85,3544,8
43567,391,5233,931,3828,54176,1405
24085,488,15160,2399,11493,56084,3667
31463,424,21034,2030,15234,127757,5800
2897,7,344,3510,254,8318,90
28935,6,145,2158,121,2452,24
11590,88,6944,3080,4817,86923,2127
37199,2,66,1737,54,2968,12
4509,10,267,3468,222,14311,45
27887,572,12440,2218,9444,68475,2996
40340,23,954,1533,743,21982,211
46379,5,94,96,70,2117,24
21123,1,228,2551,190,5756,38
3980,5,158,3487,123,3262,35
45586,29,319,418,250,5341,69
4975,33,994,3448,810,13259,184
44033,66,659,815,544,8551,115
23681,28,1478,2417,1191,17793,287
8612,30,653,3242,515,21443,138
19877,4,686,2621,509,14305,177
42992,7,161,1104,120,5746,41
33230,171,9151,1949,7133,60412,2018
35419,20,377,1852,327,6960,50
30011,6,224,2104,169,5196,55
9825,42,1188,3170,953,13728,235
33000,7,217,1958,180,3637,37
29150,0,33,2147,23,1471,10
18589,119,3938,2681,2974,20080,964
9776,22,1490,3174,1094,19690,396
6988,5,161,3352,123,3244,38
10369,96,1821,3145,1500,7170,321
2569,1,86,3515,60,4703,26
11812,8,207,3069,167,6637,40
33127,131,3258,1952,2519,25959,739
9914,144,9987,3167,7353,60479,2634
34788,9,399,1885,305,6405,94
4251,9,328,3478,206,6881,122
24084,30,972,2399,760,8653,212
45005,112,1307,607,1021,21194,286
31327,45,2072,2037,1639,9048,433
10705,1,68,3126,57,4180,11
32819,26,892,1965,682,17979,210
16378,92,4278,2788,3260,59236,1018
6888,27,365,3358,273,7007,92
34061,1,85,1918,63,2782,22
16005,1670,95878,2807,66132,233228,29746
3807,27,879,3492,661,6677,218
40063,459,9692,1551,7013,54767,2679
3338,41,570,3502,466,6059,104
12490,12,205,3033,163,3404,42
9369,3,175,3195,131,7427,44
5929,72,4244,3398,3262,27882,982
42869,23,650,1138,433,7799,217
3100,5,167,3506,140,3607,27
38624,336,21161,1640,16197,110581,4964
28316,0,450,2193,350,5807,100
32054,0,40,1999,21,2727,19
45128,13,123,549,76,4197,47
18498,4954,1427480,2685,905828,1487909,521652
37213,7,100,1737,82,3623,18
19731,60,2321,2629,1819,10437,502
20464,13,698,2590,584,9697,114
11155,10,516,3102,425,7638,91
33322,19,577,1945,473,13449,104
36653,2,79,1771,72,3358,7
20731,22,1809,2576,1328,13223,481
29045,11,550,2153,455,8407,95
32671,3,120,1971,99,2787,21
38844,95,4476,1627,3717,30317,759
2660,21,562,3514,462,10231,100
4702,24,742,3461,549,10223,193
36219,106,2323,1794,1768,22868,555
42904,52,1621,1129,1091,16700,530
29937,9,600,2107,453,17950,147
2371,8,126,3518,104,3747,22
25224,408,14886,2348,11300,85948,3586
8820,2,201,3229,149,7128,52
20667,16,803,2579,590,13076,213
7118,2,177,3345,136,4839,41
41679,7,159,1375,106,3863,53
10158,12,287629,3155,87436,5603,200193
25130,22,1969,2352,1403,12555,566
6607,13,326,3371,268,6975,58
44997,22,223,610,196,5833,27
22553,0,1815,2472,1448,17890,367
29856,0,107,2111,85,4577,22
3381,7,195,3501,163,5087,32
42211,38,663,1277,487,7335,176
5127,692,20563,3439,13531,201574,7032
21106,257,10646,2552,7345,41762,3301
11838,2,66,3068,53,2258,13
41296,83,2826,1431,2074,21480,752
33493,14,281,1938,236,2925,45
43732,13,100,872,84,2522,16
40397,12,195,1526,158,2530,37
44750,4,84,682,52,2252,32
22374,5,393,2482,333,6729,60
17206,258,11712,2744,8348,50480,3364
40353,7,154,1530,119,9915,35
43807,11,142,852,106,2527,36
30102,0,51,2100,42,4997,9
8714,173,5092,3235,3994,32670,1098
12140,28,1055,3052,882,17258,173
18941,15,874,2666,611,7136,263
14929,124,27247,2858,18695,79717,8552
10630,0,0,3131,0,4851,0
2118,49,1465,3523,1106,27348,359
25377,0,300,2342,227,6397,73
24855,0,1919,2364,1522,14501,397
29500,6,290,2128,245,8170,45
19777,213,15953,2626,11199,88432,4754
8668,11,1246,3238,910,18834,336
29584,104,3611,2125,2874,25557,737
1813,9,289,3530,213,5489,76
9757,9,82812,3175,27815,13199,54997
11801,2,116,3069,103,10172,13
5035,62,2415,3445,1914,43168,501
12580,104,16056,3029,10927,109419,5129
28573,7,320,2177,273,11728,47
43620,27,475,909,379,7481,96
34303,5,99,1911,80,2037,19
35892,98,5142,1816,3884,42540,1258
8196,9,325,3269,238,8506,87
28623,29,673,2174,496,7148,177
28668,0,3,2172,3,1606,0
30548,2,95,2074,78,7112,17
9600,4,342,3181,264,3118,78
2920,110,4402,3509,3504,76061,898
32366,9,405,1984,337,6832,68
39912,51,1302,1562,917,12022,385
9778,41,2321,3174,1668,17237,653
16640,857,28129,2776,18874,68149,9255
24498,109,2369,2380,1722,21495,647
24106,15,362,2398,279,5477,83
25978,1,21,2314,19,4514,2
46200,33,205,161,142,2787,63
13953,242,8877,2924,6400,61103,2477
2792,42,1682,3512,1420,23029,262
4023,1,49,3485,43,2674,6
24822,0,32742,2366,22368,49296,10374
11178,218,4006,3101,2972,18787,1034
2309,10,215,3520,177,8480,38
45305,62,573,497,449,4512,124
21456,28,1366,2531,1082,7785,284
6365,5,130,3381,97,3458,33
8563,8,506,3244,374,7561,132
15212,12,360,2842,268,15608,92
3644,43,3787,3496,2790,25310,997
12883,3,203,3011,171,4823,32
26825,4,218,2275,184,3336,34
46115,62,1076,198,938,6582,138
29092,1,97,2150,78,2499,19
14472,37,2832,2888,2238,16507,594
36176,4,118,1796,100,3121,18
38606,5,177,1641,143,4994,34
7682,22,605,3312,486,4679,119
3476,1,44,3499,36,1513,8
12836,19,1075,3013,839,35731,236
5999,95,3707,3395,2792,24820,915
33586,5,137,1935,109,7486,28
41351,4,98,1423,84,3113,14
42196,39,574,1280,457,8369,117
8605,4,106,3242,77,3493,29
18023,33,4266,2705,2783,27674,1483
45424,6,59,465,45,2561,14
15518,24,888,2828,673,8009,215
23417,1,256,2430,199,7264,57
17078,3,549,2751,374,11100,175
19299,0,1200,2650,908,21590,292
29320,499,21024,2137,14362,100535,6662
13948,227,6824,2925,5015,23077,1809
17552,6,210,2726,161,6571,49
20538,6,459,2586,341,7931,118
32874,1,60,1962,46,6500,14
3303,3,203,3502,173,6115,30
13565,77,6606,2955,5055,32338,1551
45444,3,27,460,19,1125,8
12276,3,43,3045,32,3125,11
12171,3,30,3051,25,2308,5
44225,62,598,782,464,9300,134
8443,1,35,3253,31,1552,4
43226,2,49,1035,42,2448,7
26868,27,673,2273,570,7042,103
33339,74,3185,1944,2487,38662,698
24896,300,20739,2362,15305,96931,5434
6752,59,2122,3365,1690,22895,432
31715,0,43,2016,35,3597,8
33394,2,65,1942,52,3457,13
16342,1,77,2790,62,5808,15
39423,0,33,1591,26,2389,7
34402,98,2646,1906,1951,13067,695
23004,8,283,2450,210,7698,73
46137,6,81,186,76,2204,5
33934,51,2131,1923,1724,16348,407
25992,10,816,2313,588,20718,228
11577,255,26079,3080,18849,117813,7230
40342,10,288,1532,235,11929,53
26878,2,321,2273,263,4295,58
44723,16,164,692,153,5715,11
41578,5,283,1392,204,6317,79
13699,303,20438,2946,15158,76250,5280
36259,2,60,1792,48,3614,12
26551,83,3349,2288,2512,20488,837
7922,5,52,3292,44,2115,8
18887,20,2767,2668,2035,14733,732
41374,17,618,1420,460,8381,158
16975,418,24262,2758,16822,148562,7440
13890,21,1012,2930,616,9754,396
22989,33,3200,2451,2279,35169,921
14710,1,49,2872,38,6454,11
6869,4,60,3359,47,2576,13
11847,13,285,3068,216,6059,69
11212,51,3766,3099,2756,38217,1010
19995,0,30,2614,25,1551,5
18579,45,1119,2682,898,9231,221
4760,2,106,3459,82,10579,24
28689,54,1409,2171,1137,8043,272
26585,72,2684,2286,1927,11979,757
22888,25,1168,2456,904,10523,264
45470,0,40,455,28,2237,12
5471,6,160,3422,127,5643,33
8828,12,873,3228,714,17653,159
34791,27,482,1885,361,3705,121
38700,9,330,1636,269,5753,61
10635,49,2093,3130,1681,13897,412
6404,7,171,3379,138,2959,33
1717,14,235,3558,195,5223,40
37305,13,308,1731,268,3016,40
9890,32,802,3168,603,17365,199
41010,66,2272,1472,1496,28548,776
40274,3,140,1538,106,4656,34
6175,6,191,3389,160,2730,31
41208,4,87,1448,58,2576,29
16272,1,120,2794,93,3096,27
26546,0,528,2288,433,4996,95
11768,3,460,3070,378,17389,82
7454,30,2067,3326,1574,29219,493
45018,260,2430,604,1937,14292,493
20638,17,794,2581,621,10054,173
36708,13,196,1769,153,2805,43
33706,9,117,1931,83,2682,34
18438,17,523,2687,376,11722,147
8115,32,1835,3274,1265,47521,570
23148,4,180,2444,146,2419,34
42353,12,252,1249,190,3888,62
24626,12,307,2373,212,2730,95
19894,29,2265,2619,1741,22367,524
37184,38,2302,1739,1751,20732,551
15047,23,493,2851,421,14577,72
45766,9,155,335,127,3582,28
4939,87,3559,3450,2838,16753,721
11439,293,11706,3088,9039,153834,2667
40815,5,58,1487,51,5153,7
40968,214,5687,1475,4186,41364,1501
38228,7,687,1669,489,14759,198
28280,16,447,2195,346,8085,101
8136,9,233,3273,178,7436,55
39134,6,166,1609,124,2902,42
23690,55,1067,2417,866,8220,201
30423,2,104,2081,81,3140,23
4690,4,181,3461,136,7828,45
46293,14,223,134,171,5047,52
42591,75,1379,1202,1000,11880,379
40624,6,81,1505,69,1167,12
12357,7,62468,3040,22149,17419,40319
20946,1,68,2561,50,5890,18
28854,37,2276,2162,1749,12422,527
15645,18,743,2822,567,10997,176
6519,0,28,3374,24,4950,4
19485,6,359,2641,264,9213,95
34924,226,11063,1877,7751,50907,3312
40841,2,59,1485,51,3404,8
36864,14,516,1758,417,21321,99
1515,3,56,3610,45,2545,11
21469,9,273,2531,211,3443,62
12266,3,428,3046,349,7719,79
14726,15,820,2871,664,23630,156
34028,21,643,1919,485,14951,158
37595,30,747,1713,548,6587,199
38619,36,1817,1641,1476,11750,341
18842,10,357,2670,292,5220,65
20165,43,2897,2605,2349,21726,548
43640,1,18,902,15,1104,3
34105,2,232,1917,186,5002,46
8429,56,3658,3254,2720,34221,938
23372,248,16026,2433,11293,67038,4733
3293,308,10000,3503,7816,115235,2184
43573,12,435,929,342,7135,93
4841,26,989,3455,691,5891,298
30665,10,522,2068,412,24471,110
7671,50,2405,3313,1954,23543,451
40633,18,316,1505,243,14537,73
5433,250,10888,3423,7935,54352,2953
4163,18,468,3481,393,4950,75
34548,8,192,1899,157,6112,35
12982,56,2637,3004,1972,20274,665
18528,12,641,2684,511,10033,130
35216,88,2493,1863,1947,29515,546
10717,169,7568,3126,5559,34702,2009
32651,104,3587,1972,2466,16592,1121
37863,132,3402,1694,2711,25912,691
27091,68,3119,2265,2165,34401,954
37257,1,57,1734,43,3332,14
2787,9,104,3512,83,3704,21
2603,28,768,3515,655,27977,113
8802,481,23243,3230,16425,89161,6818
7877,55,1791,3297,1393,10847,398
12783,3,116,3017,83,2086,33
40899,17,261,1480,191,7889,70
8147,14,263,3273,211,16563,52
14063,5,382,2916,214,8863,168
10962,24,2772,3112,2044,60123,728
35768,31,679,1825,537,7080,142
29346,1,63,2136,46,2492,17
3815,31,3479,3492,2816,26752,663
36363,3,50,1786,39,2343,11
38316,0,52,1663,40,2924,12
31679,21,1194,2018,887,27047,307
22875,3,166,2457,120,3255,46
35694,1,88,1830,74,3876,14
12742,20,648,3019,521,9264,127
23705,30,1551,2417,1098,23897,453
35225,19,784,1862,647,28300,137
29685,0,153,2120,115,2638,38
32904,3,158,1961,141,6151,17
29817,3,256,2114,214,3780,42
13425,4,103,2968,90,2869,13
14433,118,10134,2891,5109,31921,5025
10332,25,1165,3147,869,22425,296
29469,4,179,2130,146,3704,33
7352,14,342,3331,261,17733,81
31116,257,20375,2048,14748,90610,5627
21159,94,4984,2548,3162,50515,1822
17744,9,731,2719,534,2986,197
16412,6,210,2786,168,4695,42
26289,2,61,2300,52,4620,9
40681,42,761,1501,598,8757,163
41092,3,68,1461,42,9376,26
6420,71,2301,3378,1631,14943,670
21857,6,144,2510,104,2992,40
4349,3,45,3474,42,3390,3
18297,346,27352,2693,20417,116843,6935
46221,2,30,156,21,1600,9
1555,10,219,3592,179,4031,40
32061,4,251,1999,189,7231,62
15852,495,14398,2814,10110,42625,4288
7125,14,258,3344,183,9446,75
15409,0,57,2834,40,2820,17
6669,8,245,3368,203,7699,42
13134,15,754,2994,542,7263,212
4293,9,176,3476,131,5782,45
29821,0,23,2114,21,2830,2
33783,31,803,1927,556,4457,247
23273,180,10922,2438,8273,85180,2649
38433,9,211,1654,175,5569,36
34713,61,1876,1890,1403,48907,473
11571,3,179,3081,134,1668,45
29851,17,550,2112,416,8123,134
14453,73,7174,2890,4593,60743,2581
41290,4,90,1431,65,2740,25
37266,0,6,1733,4,2719,2
29108,7,334,2149,281,3980,53
26474,14,996,2291,819,21654,177
46340,2,35,115,30,1937,5
36969,8,784,1752,668,11494,116
45341,81,1055,487,833,10097,222
24327,247,11840,2388,8567,83655,3273
11094,2,137,3105,100,5273,37
29507,18,264,2128,187,1975,77
3065,24,1533,3507,1204,25435,329
37125,182,5015,1742,3667,33274,1348
41803,4,68,1352,50,7806,18
20736,78,3147,2576,2467,34991,680
42139,27,273,1292,219,3216,54
6559,0,42,3372,29,1105,13
14037,196,5205,2918,4112,58560,1093
7376,20,483,3330,358,5009,125
40239,6,172,1541,141,7535,31
42107,3,56,1300,50,7199,6
13895,1,151,2930,107,2803,44
32031,10,563,2001,453,7742,110
8775,7,342,3232,234,8906,108
32835,5,134,1964,106,3211,28
5951,5,165,3397,142,3349,23
12433,26,1782,3035,1252,30064,530
35926,4,190,1814,147,4288,43
8654,67,1811,3239,1224,19867,587
16187,13,274,2798,205,6520,69
42018,58,1760,1316,1299,14907,461
31341,886,36831,2037,25873,195180,10958
6169,4,169,3389,153,3997,16
31896,4,159,2008,134,3682,25
16389,23,807,2787,604,9714,203
39950,19,618,1559,387,19636,231
27760,7,161,2225,138,3856,23
37510,64,2022,1718,1495,18422,527
37564,1,107,1714,86,4101,21
4250,72,4007,3478,3189,50076,818
7788,7,300,3305,236,15072,64
22289,2,74,2486,56,2001,18
15144,11,391,2846,344,5497,47
34108,54,1312,1917,981,18400,331
43700,25,363,882,312,5718,51
33428,0,61,1942,52,5106,9
35074,14,350,1870,274,13258,76
22189,8,724,2491,605,9288,119
30110,10,1051,2100,804,16286,247
42267,5,358,1265,264,12030,94
24021,20,1353,2402,956,15979,397
19511,14,919,2640,713,14928,206
16049,12,326,2804,250,9158,76
16845,311,23847,2764,17230,160171,6617
22456,120,5278,2478,3720,51935,1558
10479,79,7150,3140,5327,57820,1823
42348,8,279,1251,207,14723,72
44691,21,627,704,448,8828,179
38284,171,8833,1665,6140,71180,2693
35994,46,532,1808,404,5860,128
12842,3,114,3013,93,4084,21
14862,26,803,2862,648,8465,155
3841,11,164,3491,115,5198,49
25900,25,2203,2318,1429,11723,774
20434,11,473,2591,380,9662,93
36405,2,44,1785,36,3053,8
20144,42,1305,2606,1055,13805,250
7179,10,126,3341,93,5525,33
22980,380,24147,2451,17361,116949,6786
5250,5,76,3433,62,2699,14
27098,4,142,2265,118,4813,24
27812,45,2638,2221,1851,44293,787
21965,11,759,2502,625,11138,134
13423,14,518,2968,406,13419,112
44856,3,61,648,49,1742,12
41835,202,4715,1345,3378,41631,1337
16644,4,98,2776,56,6368,42
42540,68,2158,1210,1630,40307,528
9049,14,539,3217,409,9527,130
8509,26,780,3248,597,7670,183
4315,32,651,3475,524,18533,127
4101,22,834,3483,566,10880,268
8083,9,47,3275,39,4555,8
41824,20,825,1346,644,17907,181
6041,18,667,3393,518,11491,149
39497,26,308,1587,232,6233,76
14917,237,7699,2859,5389,41749,2310
31840,2,92,2010,62,2184,30
45949,84,662,265,564,9398,98
33851,466,23649,1925,15777,186757,7872
5220,39,813,3434,653,12830,160
982,5,148,3843,118,7054,30
43920,442,8823,834,6745,51640,2078
4374,16,888,3473,655,21516,233
36810,4,211,1762,170,3040,41
3764,75,3087,3493,2333,19999,754
29781,4,107,2115,80,6929,27
11573,12,282,3081,195,18283,87
17903,159,11802,2713,8928,96101,2874
39139,0,64,1609,54,3363,10
24905,45,8561,2362,6549,6117,2012
38379,58,981,1658,819,7145,162
26973,15,831,2269,631,7379,200
6304,28,572,3384,441,5947,131
21997,100,3001,2500,2275,20094,726
12372,2,111,3039,92,4056,19
19851,18,905,2622,636,10232,269
29396,25,1604,2134,1237,14129,367
41368,19,541,1421,411,14898,130
43009,19,372,1099,251,6981,121
43787,3,166,855,152,7478,14
7064,9,262,3347,214,6263,48
22653,86,3487,2468,2849,33038,638
32264,7,213,1988,183,6413,30
15318,9,216,2837,164,1915,52
36268,19,833,1791,673,13119,160
46252,18,243,149,184,2806,59
32404,2,118,1982,98,6684,20
3678,4,66,3495,54,4138,12
44779,47,575,673,426,14087,149
41392,8,337,1418,239,4444,98
34311,10,375,1910,272,8116,103
15587,566,21068,2824,15722,122188,5346
2404,23,1219,3518,935,20125,284
27069,12,530,2266,443,8799,87
33181,3,110,1950,91,2775,19
28608,122,4282,2174,3305,26985,977
16427,23,1251,2786,1003,16718,248
35701,1,59,1830,42,3065,17
7839,8,74,3301,61,3033,13
5958,30,2076,3396,1690,52058,386
34827,0,41,1883,31,2389,10
1952,77,1831,3526,1426,23364,405
5363,85,4203,3427,3391,34444,812
14434,69,8613,2891,5766,79647,2847
30170,5,293,2097,228,9873,65
29228,4,144,2143,111,3339,33
37717,26,308,1705,189,3067,119
2240,7,100,3521,87,2982,13
13110,15,1606,2996,1208,10523,398
30969,52,5121,2056,3765,37710,1356
41015,3,246,1471,190,3866,56
37309,21,874,1731,710,10524,164
33531,2907,77042,1936,53951,265997,23091
42394,17,567,1242,422,7098,145
42036,24,332,1313,270,5427,62
16591,52,1835,2779,1511,26265,324
43756,26,192,866,154,3070,38
10164,7,178,3155,124,2157,54
6606,4,69,3371,54,2350,15
23254,317,14644,2439,10716,71284,3928
41946,21,314,1327,240,7126,74
32866,5,120,1963,66,5174,54
27743,4,198,2226,155,3537,43
21119,26,1134,2551,782,12658,352
38931,5,62,1621,50,4123,12
22515,0,77,2474,62,3420,15
33061,1,107,1955,88,3213,19
40920,3,315,1478,228,5742,87
39092,6,199,1611,164,4532,35
30384,4,107,2084,69,2412,38
25773,9,615,2323,499,14095,116
43509,4,54,951,45,2745,9
2200,34,831,3521,629,5598,202
16749,28,1908,2770,1567,17984,341
41431,26,618,1411,493,16693,125
15389,56,3973,2834,3172,37236,801
43378,1,63,987,46,3368,17
36169,62,1540,1796,1274,7076,266
10196,11,226,3153,188,7823,38
1191,14,333,3770,257,6981,76
14677,5,213,2874,153,2539,60
14747,268,16798,2869,12188,122848,4610
34948,10,520,1876,395,10104,125
2575,1,138,3515,110,4974,28
3703,34,1318,3494,1042,25906,276
36519,52,1164,1779,839,12628,325
27823,10,324,2220,264,7675,60
23362,12,173,2434,131,5615,42
24140,28,987,2397,848,24085,139
2830,1,25,3511,18,2609,7
17305,2,58,2738,26,5891,32
17499,24,612,2729,441,9515,171
45094,25,233,567,176,4822,57
26272,0,957,2301,735,15167,222
6943,5,171,3355,146,3384,25
42121,123,3909,1298,3112,53217,797
8523,111,3392,3247,2095,10394,1297
45387,5,64,474,48,2245,16
24110,0,96,2398,84,3817,12
14624,20,908,2878,731,10578,177
42533,261,6558,1212,4869,49905,1689
17593,9,287,2724,216,6979,71
39547,3,81,1584,66,3239,15
32941,20,571,1960,474,9141,97
8789,1,67,3231,48,1741,19
41704,3,187,1371,145,5117,42
23935,28,2419,2406,1879,17369,540
2234,1256,54543,3521,39381,220813,15162
6279,68,1724,3385,1404,30537,320
10315,69,3197,3148,2379,13467,818
12946,31,1005,3007,776,8997,229
3317,20,883,3502,744,7334,139
33453,20,390,1940,314,6342,76
43641,4,107,901,73,3727,34
22372,145,4201,2482,3349,37983,852
30894,2,131,2058,101,7445,30
25631,20,884,2329,650,9403,234
35242,3,102,1860,83,5713,19
40774,1768,49372,1492,32621,242701,16751
9075,7,109,3214,83,2878,26
15058,9,251,2850,199,8519,52
45570,85,2343,420,1994,14794,349
36562,20,466,1777,373,15814,93
23475,9,1066,2428,891,12752,175
17485,44,1340,2729,1063,24026,277
37914,6,213,1690,169,5592,44
22699,55,2161,2466,1630,11742,531
40157,118,5939,1547,4085,52380,1854
30273,1,61,2091,41,4065,20
31105,0,70,2049,56,1149,14
26549,11,443,2288,355,7404,88
19052,9,208,2662,153,5593,55
42317,26,725,1256,539,5424,186
43008,14,494,1099,350,15075,144
18969,27,843,2665,634,12147,209
25781,4,252,2323,195,4647,57
9412,1169,51117,3193,31697,182546,19420
21439,10,233,2532,189,4174,44
24958,32,922,2359,755,5485,167
40431,16,431,1523,313,8685,118
12100,90,3630,3055,2711,23751,919
29885,3,99,2110,78,2054,21
10300,11,253,3149,199,6392,54
17248,6,281,2741,217,3660,64
13987,1676,66221,2922,46109,148709,20112
24503,7,162,2380,130,6769,32
7698,378,23120,3311,16113,162289,7007
34083,169,7489,1918,4931,61751,2558
30142,51,2762,2098,2176,12050,586
2800,48,1094,3511,759,8912,335
17608,6,458,2723,341,6554,117
28748,283,6452,2167,5104,44801,1348
3070,9,327,3507,280,4792,47
13487,2,237,2962,198,5693,39
2047,7,234,3524,182,6291,52
38885,14,384,1624,299,7086,85
26653,90,2205,2284,1835,19337,370
9956,3,60,3165,51,4872,9
8986,4,104,3220,91,1556,13
14709,20,699,2872,560,8546,139
26343,2,1416,2298,1167,18956,249
44849,6,67,650,54,2136,13
25478,34,1337,2338,1082,17854,255
3787,102,5082,3493,3878,45766,1204
3234,67,2501,3504,2022,13126,479
44868,9,102,645,76,1853,26
11536,5550,152462,3082,113927,517496,38535
11882,2,32,3066,25,1856,7
34281,2,48,1911,42,3052,6
39168,1,84,1607,67,2744,17
33320,19,568,1945,470,7581,98
34923,8,557,1877,432,9083,125
31130,67,2070,2048,1584,17388,486
15270,78,3502,2839,2686,69339,816
38347,18,605,1660,450,10529,155
43222,8,282,1037,175,8047,107
45688,152,4629,372,3515,22849,1114
27655,14,293,2231,264,4603,29
24360,12,600,2387,483,6079,117
31821,350,14718,2011,9435,98304,5283
30772,30,1907,2063,1511,26214,396
5935,16,376,3397,305,10200,71
38298,15,436,1664,348,12928,88
1934,83,3145,3526,2354,16941,791
45997,54,1208,248,875,10631,333
30271,152,5069,2091,4002,21508,1067
24799,23,1816,2367,1428,13298,388
998,37,3048,3837,2286,28373,762
3722,81,1952,3494,1599,26020,353
7563,22,716,3320,591,14312,125
35620,14,448,1837,367,12910,81
27656,12,350,2230,281,3564,69
12146,323,11298,3052,7028,42208,4270
9423,189,8562,3192,6164,67849,2398
7985,10,249,3285,210,8304,39
40874,111,3848,1482,2818,40640,1030
41199,0,0,1449,0,3435,0
3188,11,505,3504,394,12227,111
22984,126,2801,2451,2217,13065,584
5629,286,13482,3413,10658,56065,2824
16756,9,365,2769,294,9064,71
8885,4,115,3225,91,3949,24
9646,8,421,3179,300,10915,121
42837,23,1457,1144,958,11439,499
14796,31,1175,2865,887,15499,288
9444,26,1163,3191,950,10614,213
9407,24,1356,3193,1053,15309,303
42190,106,1211,1281,897,17280,314
9350,7,237,3197,203,9465,34
6470,10,307,3376,234,10362,73
42900,10,229,1130,185,8322,44
22280,198,5795,2486,4475,56707,1320
36099,5,88,1801,70,2875,18
39961,92,3034,1558,2282,31230,752
5418,3,59,3424,43,2234,16
8626,26,533,3241,427,5127,106
12845,12,339,3013,272,9741,67
28366,7,1148,2190,922,8047,226
3778,51,1525,3493,1095,26906,430
35771,48,1309,1825,1033,9294,276
3043,8,254,3507,203,13751,51
17577,26,1219,2725,807,6678,412
38029,254,5562,1684,4308,45936,1254
13342,2,47,2973,37,2992,10
6755,2,107,3364,94,5722,13
4252,51,1052,3478,856,13301,196
20117,25,1476,2608,1124,13076,352
40307,5,154,1536,88,5323,66
37349,4,59,1729,46,2960,13
24108,0,2568,2398,1885,19011,683
3933,7,193,3489,174,18795,19
6116,49,2583,3391,1985,54537,598
36399,57,903,1785,767,12748,136
1785,6,296,3535,240,4744,56
19764,32,2712,2627,1862,17896,850
37719,54,4160,1705,3185,27045,975
15848,3,213,2814,165,10231,48
5049,15,481,3445,394,5866,87
30501,26,898,2077,712,19595,186
39348,21,2895,1595,2144,12727,751
1228,29,863,3764,708,8600,155
11290,149,6845,3095,5180,54770,1665
35650,115,4422,1834,3366,29872,1056
7933,10,567,3291,455,9372,112
30861,6,114,2059,93,7906,21
20801,21,1070,2571,873,10450,197
26928,136,7801,2271,6252,54124,1549
12552,26,941,3030,731,12953,210
44923,12,201,631,145,3515,56
19140,647,21238,2659,16000,121256,5238
36797,6,292,1763,235,4464,57
5965,20,619,3396,493,5389,126
6490,17,557,3376,455,11115,102
9562,12138,957184,3183,577702,3027924,379482
3066,2004,134060,3507,84759,513711,49301
19943,5,118,2617,104,3511,14
37691,2,43,1707,35,7311,8
45569,53,1597,420,1158,7638,439
10957,103,125417,3113,40435,36055,84982
14519,5,216,2884,167,5199,49
5497,6,158,3420,140,2318,18
45326,22,228,490,178,4191,50
12782,0,65,3017,34,3853,31
19370,7282,372111,2647,271067,1233011,101044
43076,34,415,1078,319,4018,96
41579,7,188,1392,148,7832,40
37096,344,13547,1744,8091,77219,5456
20639,9,621,2581,499,8232,122
14611,17,671,2878,572,14281,99
3695,7,263,3495,219,15945,44
22878,10,367,2457,296,5030,71
33927,0,62,1923,50,2090,12
4969,396,17014,3449,12392,79415,4622
33950,24,497,1922,381,11404,116
36314,9,186,1789,154,4430,32
32006,84,4916,2002,3951,22836,965
37415,2,103,1724,82,7266,21
40493,1,76,1517,63,7318,13
35199,0,317,1864,253,3769,64
24065,26,1689,2400,1310,8975,379
8709,11,371,3235,302,5418,69
5639,15,342,3413,252,6651,90
33412,64,1918,1942,1470,22564,448
29740,7,107,2118,93,3492,14
30878,6,540,2059,369,5533,171
45173,2,24,537,14,2678,10
26713,0,97,2281,83,2311,14
35194,49,896,1864,680,11247,216
39245,15,1017,1600,759,19184,258
41379,8,367,1420,256,3891,111
12529,1,109,3031,43,1344,66
33172,0,42,1950,39,3878,3
43568,3,149,931,116,4800,33
8904,52,2632,3225,2121,17408,511
7824,44,1115,3302,868,23524,247
32438,4,156,1981,116,3129,40
8349,1,257,3258,200,11393,57
11933,25,637,3063,435,17043,202
38573,87,2785,1644,2138,28996,647
39371,71,2621,1594,1945,19396,676
1252,2,25,3755,23,2236,2
3669,4,238,3495,205,16110,33
9964,5,507,3164,341,6092,166
41878,17,169,1338,136,2812,33
22528,27,1736,2474,1363,19112,373
27132,2,112,2262,96,1573,16
29948,411,11504,2107,9309,41690,2195
37705,3,98,1706,80,7779,18
43255,6,229,1026,189,6287,40
27862,8,641,2219,482,19917,159
17509,77,2631,2728,2006,18489,625
33193,53,1251,1950,994,8974,257
1725,4,154,3556,122,6644,32
45714,2,68,357,38,1141,30
6571,5,60,3372,48,2305,12
26718,0,103,2280,72,3236,31
25439,0,0,2339,0,2336,0
34779,8,465,1886,365,6592,100
1809,67,2275,3531,1794,18805,481
30780,2,107,2063,84,3174,23
20950,114,10213,2561,7707,54344,2506
46248,5,133,150,101,1568,32
12931,206,11170,3008,7781,70566,3389
11727,21,1216,3072,807,16869,409
40442,9,222,1522,175,3459,47
38094,9,124,1679,103,3049,21
13421,17,855,2968,654,22914,201
41369,166,4950,1421,3531,26673,1419
17646,4,59,2722,50,5565,9
20784,60,2470,2572,1994,10224,476
15670,16,788,2821,547,10605,241
8617,16,932,3241,677,6704,255
42400,1716,58864,1241,46090,191535,12774
37944,35,776,1688,605,9766,171
10447,73,2408,3142,1749,30356,659
34444,3,402,1904,320,9778,82
17955,4,307,2709,256,7093,51
11870,8,505,3066,416,15661,89
29800,7,324,2115,267,15995,57
15384,9,260,2835,202,5289,58
33649,20,276,1933,205,3688,71
3646,422,20031,3496,14736,80134,5295
17917,43,4283,2712,3072,32249,1211
2445,12,427,3517,338,5909,89
18451,20,1116,2687,856,9392,260
3323,90,5331,3502,3665,29326,1666
8417,4,96,3255,76,3539,20
11528,320,12661,3082,9355,107286,3306
10911,13,1524,3115,1011,22127,513
23984,26,283,2403,230,4125,53
37835,33,357,1695,273,3319,84
35269,44,836,1859,681,11135,155
19268,91,11040,2652,8762,41476,2278
25218,162,7860,2348,6132,39215,1728
6716,3,110,3366,94,3911,16
24056,3,190,2401,147,2830,43
6351,22,886,3381,702,21231,184
7932,46,1413,3291,997,17771,416
4483,4,91,3469,76,3933,15
3911,1,106,3489,84,3005,22
46117,1,36,197,23,1480,13
4585,3,37,3465,29,3657,8
6989,15,474,3352,378,10807,96
30091,3,400,2101,294,4485,106
8576,30,801,3244,645,26103,156
31421,9,573,2033,454,8001,119
9164,3,209,3208,162,7770,47
29593,7,434,2125,385,10269,49
9277,79,2600,3202,1992,22957,608
10350,7,318,3146,275,17852,43
32256,1,37,1989,30,2187,7
11160,35,1441,3102,1126,20283,315
25272,24,1525,2346,1178,24246,347
8603,1,60,3242,53,5831,7
15117,3,410,2847,323,9751,87
37261,39,834,1734,671,28945,163
31469,38,1599,2030,1109,18392,490
5525,6,165,3419,142,5984,23
10450,362,26671,3142,17334,255912,9337
6772,5,390,3363,308,17308,82
43046,20,277,1088,207,2821,70
28945,292,20844,2158,14838,83430,6006
30837,47,1440,2060,1091,8080,349
23795,4,267,2413,213,4142,54
3091,34,1352,3506,1025,28227,327
30069,13,227,2102,194,2173,33
12139,33,839,3052,640,13848,199
3788,27,248,3493,207,9187,41
13555,118,6021,2956,4311,15444,1710
5918,14,493,3398,368,7961,125
45194,80,1007,531,801,7630,206
16853,33,1061,2763,807,14174,254
10230,164,4365,3152,3451,69055,914
21634,27,894,2521,735,10883,159
42971,10,217,1111,173,2803,44
1567,1,37,3590,33,2004,4
44835,29,177,653,137,3002,40
8098,41,2483,3274,1953,9446,530
7798,4,197,3304,136,4343,61
43515,4,73,949,49,4189,24
6531,2,143,3374,90,3891,53
46388,3,18,91,17,1233,1
15981,56,1975,2808,1555,12066,420
3846,15,226,3491,180,10415,46
21094,25,801,2553,643,5344,158
33294,0,42,1946,35,1869,7
10087,10,130,3158,117,8551,13
37026,3,205,1749,159,7143,46
24419,1,188,2384,144,9760,44
31356,68,2005,2036,1652,17570,353
32801,1,115,1966,94,5190,21
40171,38,634,1546,486,7353,148
18515,2,142,2684,116,2671,26
41689,36,395,1374,306,6569,89
18234,55,1745,2696,1359,8234,386
14402,41,1371,2893,1085,9743,286
11416,33,1276,3090,1003,20880,273
35665,66,1752,1833,1436,16930,316
30463,4,248,2079,190,8596,58
21475,462,44771,2530,30317,188545,14454
39925,0,18,1561,16,1102,2
10245,21,459,3151,387,6405,72
8439,7,164,3253,135,6668,29
19964,7,255,2616,197,5778,58
46181,38,526,166,431,9653,95
37675,6,285,1708,233,9110,52
23633,105,1929,2420,1414,19605,515
46149,30,414,181,319,8235,95
21292,4068,270768,2540,186817,515502,83951
9360,334,11033,3196,7752,57474,3281
26707,19,720,2281,596,9548,124
10063,4,92,3159,70,2990,22
6900,31,1196,3357,951,28899,245
22152,59,4154,2492,2822,47901,1332
25413,3,586,2340,376,13176,210
6147,102,2515,3390,1798,29626,717
12928,5,248,3008,211,7182,37
8912,0,80,3224,61,4168,19
39224,34,425,1603,344,9442,81
42702,185,2969,1178,2208,34619,761
25406,13,345,2341,267,3741,78
14954,6,267,2856,223,4717,44
42938,8,227,1118,151,7238,76
4352,186,7799,3474,6026,37416,1773
30080,4,107,2101,93,6165,14
21136,2,90,2550,81,1744,9
38122,6,284,1676,219,7164,65
18047,6,342,2704,292,7044,50
4213,11,254,3479,193,5852,61
4901,89,1752,3452,1323,15910,429
33366,43,2571,1943,1757,29583,814
44742,14,152,686,138,4834,14
9482,13,686,3188,515,26648,171
17137,47,2742,2747,2003,14289,739
5842,41,2025,3402,1499,23529,526
9595,4,164,3181,121,2087,43
4768,372,29780,3458,18526,157580,11254
16164,23,3731,2799,2711,16664,1020
35776,0,14,1824,12,2666,2
38431,149,3317,1654,2670,27369,647
4065,1530,48677,3484,33626,188655,15051
34298,2,98,1911,84,2944,14
3769,2,102,3493,86,8032,16
26790,6,155,2277,134,2640,21
9367,10,483,3195,351,18634,132
38878,29,779,1625,586,11281,193
19707,6,548,2630,477,8925,71
4263,44,971,3478,767,7435,204
1412,2,39,3647,33,2818,6
3554,37,1950,3498,1509,25572,441
16617,304,15627,2777,11958,73893,3669
27976,3,380,2212,302,7381,78
41069,12,254,1464,211,4999,43
12194,40,1244,3050,974,16097,270
46338,6,199,115,143,1476,56
38679,6,148,1637,128,9382,20
3399,68,2098,3500,1585,18474,513
23328,11,460,2435,397,8698,63
42137,83,1121,1294,835,14307,286
32498,6,296,1979,233,5796,63
43370,28,485,990,406,11895,79
13094,24,1903,2997,1313,12794,590
22221,2,188,2489,164,6537,24
36696,53,1649,1769,1282,17373,367
20622,38,4010,2582,2819,33728,1191
16973,34,6227,2758,4613,20093,1614
8781,39,1068,3231,778,12458,290
13762,2,174,2940,128,3296,46
36747,10,460,1766,337,9498,123
46305,99,1556,128,1180,10688,376
39094,3,65,1611,51,3209,14
21129,6,258,2551,199,10813,59
32395,7,275,1983,191,5212,84
36746,5,140,1766,119,4401,21
8406,22,825,3255,647,16808,178
35228,3,87,1862,75,1814,12
4182,2,155,3480,135,4933,20
19023,6,233,2663,196,3386,37
43471,41,944,963,714,12931,230
10489,14,199,3139,156,2909,43
38436,402,23858,1654,17183,105539,6675
19761,6,314,2627,262,11072,52
8922,63,932,3223,708,8283,224
7176,80,4625,3341,3339,14365,1286
42811,23,450,1149,332,11086,118
2956,8,383,3509,271,3559,112
38281,2,174,1666,129,4555,45
3392,138,3386,3501,2534,31386,852
21720,50,2101,2516,1679,23529,422
26120,1,219,2308,186,11770,33
4774,153,2911,3458,2080,15771,831
13708,370,23151,2946,16356,163673,6795
42118,12,238,1298,195,5978,43
29081,548,20794,2150,15707,129018,5087
22759,36,2086,2463,1544,32053,542
18838,2,247,2670,193,3625,54
39274,64,819,1599,597,7567,222
23855,12,265,2410,219,4446,46
16868,120,9818,2763,7490,94791,2328
36283,15,715,1790,610,12743,105
23369,18,618,2433,512,14063,106
33741,90,2202,1929,1564,12164,638
15881,3,229,2813,163,11812,66
41359,34,477,1422,358,5901,119
9374,45,1740,3195,1334,23392,406
4862,12,523,3454,413,19078,110
3964,16,253,3488,191,5046,62
12906,10,647,3010,494,11108,153
39641,41,1230,1579,960,20912,270
18828,1,54,2670,42,3130,12
4443,22,556,3470,436,4866,120
4723,1,45,3460,33,8288,12
4587,12,194,3465,149,3260,45
38198,31,2225,1672,1515,25527,710
25844,82,2887,2320,2257,37802,630
28962,8,420,2157,327,12248,93
14637,26,1597,2877,1109,16162,488
12085,10,446,3056,337,3191,109
7159,2,25,3342,21,1617,4
30183,2,96,2096,83,6585,13
34059,2,88,1918,60,2646,28
14478,8,237,2888,176,4441,61
14811,35,2017,2864,1580,28035,437
16382,4,257,2788,206,3846,51
14066,11,629,2916,478,10582,151
27203,9,244,2258,200,6719,44
40203,13,421,1543,324,4840,97
41084,22,353,1462,280,4185,73
32894,11,362,1962,304,14761,58
21688,21,498,2518,400,3399,98
10448,64,4644,3142,3611,29411,1033
20357,118,5917,2595,4338,21149,1579
35535,2,90,1843,81,2846,9
27449,26,1298,2243,1062,11271,236
10525,15,628,3138,481,5820,147
21849,8,309,2510,240,17026,69
32642,12,262,1972,221,4324,41
31328,19,932,2037,790,5091,142
42614,34,378,1196,289,5659,89
12246,87,3278,3047,2525,21054,753
12764,11,231,3018,200,4386,31
26761,18,564,2278,447,12816,117
38972,41,1052,1619,767,6899,285
26506,8,186,2290,147,4421,39
12591,86,6362,3028,4556,41360,1806
35019,17,1285,1873,944,15139,341
44545,164,2253,734,1834,22313,419
31803,7,169,2012,153,2952,16
6461,0,71,3377,58,3635,13
41893,0,29,1335,23,3086,6
18353,51,2988,2690,2251,34237,737
13099,1070,40796,2997,28836,142756,11960
1272,2,26,3747,21,3028,5
4793,31,655,3457,518,5764,137
22504,66,7403,2475,4893,35452,2510
40418,9,208,1525,169,5385,39
7654,21,809,3314,637,11474,172
44180,42,700,790,580,22728,120
16033,10,168,2806,133,2368,35
35465,8,319,1849,252,6690,67
42448,66,718,1229,551,5006,167
20508,16,659,2587,525,9051,134
12151,31,863,3052,658,15706,205
29358,88,1706,2136,1385,9298,321
25160,13,432,2351,330,13529,102
14405,23,1275,2892,873,10626,402
9758,14,488,3175,389,6552,99
22930,19,584,2453,497,4774,87
13935,185,7392,2926,5742,30261,1650
35189,1,64,1864,58,3933,6
33048,2,32,1955,27,3373,5
24211,14,487,2394,394,6024,93
43602,57,547,916,359,5843,188
11691,20,1901,3074,1511,27136,390
28995,1,54,2155,47,3508,7
24230,2,152,2393,116,4771,36
9036,5,27,3218,21,1788,6
21533,29,1354,2527,1097,30532,257
35320,40,625,1857,457,8686,168
43752,11171,267549,868,175594,700196,91955
32291,14,822,1988,699,18835,123
30319,4,177,2088,148,5888,29
43217,16,457,1039,311,13777,146
40636,1,35,1505,32,2482,3
40609,8,149,1506,110,1391,39
9182,12,24,3207,21,2626,3
38010,4,280,1685,235,9206,45
23711,3,82,2416,64,8515,18
6608,19,435,3370,324,3410,111
17582,69,4682,2724,3255,19671,1427
39158,132,3962,1607,3063,33747,899
26129,25,790,2308,591,7129,199
30180,14,697,2096,571,6482,126
39381,20,607,1593,453,6046,154
28795,10,511,2165,401,6790,110
44269,88,1193,777,887,12236,306
39304,6,84,1597,71,2655,13
41503,35,1054,1401,770,21022,284
30496,1,139,2077,115,3625,24
13879,2104,78324,2931,52324,360411,26000
34371,12,823,1907,662,16236,161
12119,6,449,3054,340,4857,109
11232,141,8606,3098,6452,46657,2154
19249,6,837,2653,671,8137,166
20503,51,1279,2588,977,11217,302
9878,35,2285,3169,1709,45541,576
31026,46,1950,2052,1524,21531,426
24003,78,7007,2402,5412,49248,1595
44091,15,992,797,734,6972,258
30237,48,822,2093,680,9976,142
39784,187,3830,1572,2954,23071,876
27621,194,16631,2232,12070,48181,4561
14886,45,2351,2860,1896,31251,455
25132,21,598,2352,487,7953,111
25662,5,556,2328,444,10991,112
7608,53,1822,3317,1461,23064,361
30729,1,113,2065,96,2753,17
34460,11,278,1904,227,3086,51
11887,25,1254,3066,1022,23541,232
31714,1,55,2016,47,2742,8
16264,62,2730,2794,1909,25534,821
31626,9,395,2021,304,10301,91
35485,154,2284,1847,1770,19199,514
35235,22,1123,1861,835,8150,288
32902,3,77,1961,57,3655,20
36863,3,196,1758,169,3456,27
12943,47,1858,3007,1332,17697,526
14185,1,37,2910,29,2344,8
16024,21,562,2806,443,10904,119
40279,442,14454,1538,10626,75160,3828
23706,14,1594,2417,1188,27253,406
18546,95,4640,2683,3025,24711,1615
17993,11,951,2707,692,12899,259
7363,40,2251,3331,1804,29767,447
27178,27,595,2260,467,6777,128
5385,145,10912,3425,8251,117772,2661
4041,3,147,3485,120,8244,27
40712,132,3203,1498,2115,11512,1088
13296,33,1281,2977,1042,12393,239
8404,4,58,3255,53,2430,5
25576,21,1254,2333,973,29147,281
34043,1,82,1919,58,3068,24
2415,810,44070,3518,30725,247654,13345
45799,11,132,327,115,4223,17
45830,21,181,315,158,4387,23
2979,104,6524,3508,4784,33675,1740
5737,2,29,3408,25,1948,4
34825,2,162,1883,133,4166,29
6825,44,2651,3360,2108,27119,543
45831,78,464,315,390,8627,74
40810,16,711,1488,481,13044,230
17618,15,1263,2723,860,21037,403
33105,1,110,1953,98,5485,12
14826,1,78,2863,62,8089,16
4748,33,1770,3459,1376,59629,394
11613,34,1219,3079,835,9936,384
35444,172,7184,1850,5510,62883,1674
45863,8,130,306,107,5529,23
26196,402,8708,2304,6460,40528,2248
4704,65,1042,3461,768,12388,274
4377,19,432,3473,330,12203,102
16675,6,438,2774,311,9938,127
46242,3,19,151,12,843,7
27089,19,766,2266,641,9572,125
31292,7,574,2039,477,5464,97
21653,94,4932,2520,3654,27347,1278
13306,26,954,2976,775,6067,179
10852,298,19957,3118,14065,78944,5892
4631,140,6000,3463,4347,58046,1653
39122,3,265,1609,196,6428,69
40543,0,72,1512,56,6307,16
32516,53,930,1978,719,11641,211
10102,58,2488,3157,1936,33166,552
34917,5,498,1878,340,6843,158
29064,7,137,2152,110,6922,27
30065,12,379,2102,274,6887,105
40461,41,1109,1520,847,9444,262
14271,149,4966,2904,3385,34137,1581
25914,22,2008,2317,1553,21774,455
25627,0,0,2330,0,7704,0
34406,80,2862,1906,2137,38015,725
1822,51,8780,3530,6395,31866,2385
37746,29,2373,1702,1706,21799,667
38661,212,8470,1638,5529,34296,2941
16858,42,1727,2763,1247,28213,480
15885,271,17538,2812,13597,90419,3941
18860,10,314,2669,237,2221,77
27785,13,424,2222,332,11280,92
8744,177,5990,3234,4435,76700,1555
16074,0,87,2803,49,2529,38
30122,5,149,2099,119,2264,30
26014,1,77,2312,63,5197,14
31607,5,99,2022,83,1570,16
43879,3854,89086,843,60242,323708,28844
9822,13,907,3171,729,13115,178
46214,59,834,157,732,8135,102
2024,13,415,3524,309,7568,106
1912,38,668,3527,525,7470,143
39992,7,130,1556,93,3065,37
12205,151,4536,3049,3489,62996,1047
18335,7,380,2691,279,5698,101
25793,295,19763,2322,14627,90327,5136
38612,8,94,1641,79,4186,15
33089,389,15224,1953,12022,91758,3202
35116,9,234,1868,178,4925,56
25086,5,148,2354,124,4079,24
36087,55,1767,1801,1362,15067,405
30181,19,275,2096,217,3908,58
35900,16,256,1815,222,7142,34
46186,1,23,165,13,1200,10
27529,1,206,2237,184,4957,22
35878,5,123,1817,101,2783,22
29933,2,57,2107,50,3787,7
37330,3,197,1730,160,3687,37
17036,33,2347,2754,1747,29229,600
3152,54,2307,3505,1766,15065,541
7141,79,1151,3343,955,24173,196
12899,0,89,3010,68,2581,21
40052,0,3588,1552,2771,16609,817
15702,10,294,2819,240,10282,54
27745,47,1114,2226,870,13065,244
2102,23,351,3523,289,13224,62
36088,3,130,1801,111,5238,19
12715,61,1871,3021,1437,26346,434
37901,65,592,1691,472,7773,120
43530,5,70,943,53,2718,17
24812,33,1870,2366,1562,17852,308
20325,21,1484,2597,1209,24486,275
8437,4,210,3253,178,8495,32
33146,0,21,1951,18,2301,3
19500,9,490,2640,372,12260,118
32567,13,649,1975,500,11355,149
30266,26,761,2091,558,8133,203
18179,5,124,2699,89,5110,35
33732,20,1835,1930,1397,50431,438
43067,20,680,1082,539,11617,141
42327,2,152,1255,85,4720,67
31893,27,1569,2008,969,14144,600
42798,6,114,1152,86,5452,28
36038,2,169,1805,140,4670,29
31970,12,434,2004,347,6077,87
43897,27,196,839,151,3473,45
24986,5,236,2358,186,6634,50
10682,31,768,3128,591,9600,177
36658,8,386,1771,282,12599,104
39588,8,210,1581,162,12468,48
31317,49,1289,2038,968,8809,321
6113,7,321,3391,258,10377,63
8943,23,825,3222,623,7134,202
34400,14,783,1906,610,7517,173
11207,28,1271,3099,918,16807,353
1420,17,443,3644,387,4926,56
43179,10,435,1049,268,6426,167
40314,4,84,1535,67,6213,17
13702,74,3752,2946,2804,37139,948
18379,3,487,2690,392,7352,95
30921,16,516,2057,373,11689,143
40668,152,7813,1502,5741,40094,2072
31664,25,807,2019,576,13594,231
39769,4,71,1572,59,2870,12
41442,15,278,1410,200,5294,78
6080,78,1735,3392,1329,10895,406
19177,187,5785,2657,4126,36606,1659
20215,2,432,2602,326,7161,106
6562,21,796,3372,655,10617,141
39087,17,277,1611,197,9347,80
17493,10,181,2729,146,8415,35
3622,12,173,3496,135,6414,38
39719,1,49,1574,36,2592,13
20665,13,599,2579,473,7570,126
12274,7,431,3045,360,14835,71
38709,305,9151,1635,6350,43395,2801
39048,38,713,1614,504,5934,209
27354,7,89,2249,69,3712,20
6884,3,121,3358,108,2821,13
11303,25,448,3095,373,6040,75
19399,42,6178,2645,4548,18396,1630
44085,23,1427,797,1150,11383,277
39004,23,676,1617,489,9027,187
3750,5,31,3493,26,2070,5
22381,97,7105,2482,5522,39896,1583
14832,15,1056,2863,756,17792,300
28775,3,207,2166,166,6353,41
28240,1,157,2197,135,2126,22
13392,4,71,2970,59,3351,12
24924,95,3270,2361,2633,30049,637
25613,139,3740,2330,2713,17233,1027
2580,2,64,3515,55,5654,9
42166,15,477,1286,331,14854,146
30167,9,340,2097,275,14240,65
32568,24,344,1975,279,3493,65
37228,1,49,1736,40,5735,9
42573,133,3193,1205,1934,40540,1259
15821,1,234,2814,202,4369,32
35143,1,72,1866,61,3070,11
24027,1,226,2401,174,4255,52
29586,41,1432,2125,1207,14018,225
43480,13,723,961,548,14520,175
22050,2,66,2498,54,3219,12
36770,100,3071,1765,2433,23071,638
2396,11,232,3518,188,8172,44
39953,14,870,1559,705,6754,165
6385,4,132,3380,108,5413,24
36172,27,997,1796,868,16499,129
20877,79,3215,2566,2106,37447,1109
43552,64,1481,935,1090,22821,391
7377,149,5168,3330,4025,52754,1143
36959,20,531,1753,448,13012,83
45066,14,181,582,141,3457,40
15553,24,870,2827,697,9234,173
24717,8,1306,2369,935,6311,371
42421,17,871,1235,605,10062,266
7420,312,31629,3328,19979,254846,11650
23392,8,360,2432,281,5820,79
33398,0,0,1942,0,2359,0
39400,26,242,1592,195,3655,47
24541,216,12001,2378,7853,55184,4148
3262,18,458,3503,358,3370,100
39405,4,198,1592,163,3486,35
1915,12,290,3527,220,9009,70
23650,5,394,2419,282,6884,112
2110,9,243,3523,185,6810,58
34597,10,543,1897,409,19141,134
4811,7,68,3456,60,6174,8
29530,125,2736,2128,1854,10294,882
3079,216,8391,3506,6603,90021,1788
3255,18,401,3503,345,2668,56
10759,43,820,3123,605,7606,215
42988,13,90,1106,72,4362,18
6054,10,163,3393,127,2905,36
1815,5782,299788,3530,180056,660978,119732
4489,170,7351,3469,5270,54317,2081
43595,0,83,918,57,9883,26
37037,6,193,1748,163,14076,30
44633,17,181,721,154,2113,27
1845,110,11828,3529,8126,37808,3702
5620,55,1577,3414,1138,38900,439
33883,1,276,1924,199,3799,77
3403,20,1006,3500,840,17712,166
37590,2,51,1713,46,1619,5
38803,81,3318,1629,2643,13432,675
7140,2,46,3343,34,2888,12
31687,25,463,2017,370,9995,93
45203,14,167,528,105,4286,62
39107,244,11700,1610,8983,85274,2717
44528,87,1648,739,1116,21106,532
10139,8,296,3156,250,2971,46
19897,9,336,2619,262,7763,74
6435,3,73,3378,60,4934,13
31014,6,255,2054,189,8215,66
17418,11,387,2732,311,3818,76
41018,10,230,1471,177,6436,53
25917,15,497,2317,368,5586,129
8216,18,630,3268,465,8898,165
8158,79,103731,3272,37350,16560,66381
41252,6,134,1438,112,6634,22
23478,7,137,2427,108,2886,29
42442,19,336,1231,238,4496,98
3455,51,3676,3499,2722,50962,954
38510,1,90,1649,67,6683,23
37888,12,198,1692,158,5741,40
31206,4,218,2044,171,2574,47
42920,4,28,1124,24,3871,4
34805,4,253,1884,211,7512,42
29016,25,1194,2154,983,15982,211
19582,18,849,2637,620,5908,229
44671,443,6412,711,4758,37167,1654
19984,36,1707,2614,1320,12807,387
19164,41,1659,2657,1300,28094,359
32472,3,112,1980,77,3385,35
34783,0,48,1886,44,3584,4
26452,7,393,2292,290,9696,103
6475,15,514,3376,449,8867,65
28094,21,834,2206,671,14078,163
18390,464,61485,2689,35684,321747,25801
40309,51,1602,1536,1080,14208,522
39204,2,56,1604,43,4272,13
32803,15,241,1966,198,4120,43
10040,18,450,3160,371,6766,79
44746,23,229,684,160,4300,69
32662,170,7709,1972,5287,43998,2422
12722,366,23897,3020,17133,160784,6764
24441,51,1250,2383,990,13493,260
27421,214,7379,2245,5316,35446,2063
31334,5,202,2037,164,7732,38
10835,56,4122,3119,2933,32124,1189
16360,1322,144057,2789,108476,322372,35581
40332,47,1068,1534,823,11525,245
41288,3,284,1433,227,7096,57
21204,2,228,2545,180,7502,48
11544,116,13423,3081,6623,63614,6800
12910,125,6069,3009,4466,36752,1603
36738,25,805,1767,590,21535,215
35721,0,75,1828,66,3208,9
3588,41,1681,3497,1246,18835,435
16957,77,2562,2759,1914,17000,648
26579,6,432,2287,346,17676,86
38064,209,3126,1681,2473,30278,653
27856,78,1089,2219,801,6526,288
31603,16,2002,2023,1422,19805,580
13469,34,1841,2962,1564,21750,277
2147,33,998,3522,745,16945,253
18613,61,6965,2680,4826,27214,2139
40642,39,2013,1504,1635,17615,378
24508,33,2008,2380,1465,15728,543
2936,15,571,3509,483,5090,88
31318,17,593,2038,469,4438,124
5343,3,23,3428,20,1564,3
12747,18,1124,3019,784,13804,340
38715,20,492,1635,356,5530,136
13304,7,458,2977,347,7750,111
21540,5,489,2526,342,10051,147
40876,221,4370,1482,3139,33819,1231
28441,5,177,2186,145,4388,32
34399,357,14318,1906,10319,98375,3999
34741,14,606,1889,486,6922,120
38990,12,349,1618,238,8323,111
12149,387,18098,3052,13942,76862,4156
37968,17,459,1686,358,6368,101
32328,1,371,1986,297,10519,74
9897,78,1394,3168,1113,13941,281
22326,315,9889,2484,7724,50726,2165
3178,21,682,3505,506,25755,176
10402,10,479,3144,332,18385,147
3170,33,1602,3505,1161,20997,441
29306,36,465,2139,366,3765,99
27130,131,6148,2262,4691,60800,1457
45649,9,124,389,93,4231,31
21632,2,140,2521,96,4311,44
44704,39,388,699,306,6491,82
41055,2,52,1466,42,2885,10
31811,23,1241,2012,1003,12727,238
42592,63,1652,1201,1250,25913,402
29395,9,310,2134,260,5128,50
35571,3,250,1841,182,4797,68
46120,1,17,197,14,577,3
21329,9,557,2538,423,6515,134
3033,3,166,3507,117,3859,49
33328,50,936,1945,762,10073,174
4166,20,524,3481,428,10719,96
24897,262,23880,2362,17131,81698,6749
14127,160,4207,2912,3107,34073,1100
12713,24,865,3021,677,4336,188
41132,7,305,1456,178,8909,127
24016,128,13094,2402,9522,49494,3572
36514,4,97,1779,83,4744,14
25911,8,579,2317,463,6856,116
36464,0,31,1782,24,3465,7
25785,5,268,2323,211,2530,57
33926,19,2036,1923,1494,18224,542
8742,9,497,3234,378,9578,119
39427,5,81,1591,63,6487,18
28446,33,1391,2185,1021,10330,370
41479,204,5028,1405,3519,38036,1509
16032,36,2510,2806,2055,6646,455
3449,28,2254,3500,1827,40112,427
28360,8,542,2190,461,2698,81
39513,3,52,1586,39,3863,13
30957,12,913,2056,724,7483,189
36867,4,70,1758,56,2569,14
2650,9,190,3514,157,4907,33
35930,2,25,1813,21,3425,4
33977,30,1318,1921,1055,5674,263
40902,10,700,1480,519,23348,181
41400,4,207,1416,96,10819,111
30526,52,1255,2075,980,9704,275
6724,7,281,3366,204,3855,77
24679,0,1050,2371,837,9057,213
14527,131,9751,2884,7662,77108,2089
36222,5,474,1794,379,8762,95
7522,47,1981,3322,1453,21045,528
3375,48,1375,3501,1077,10550,298
40983,81,1928,1474,1387,18758,541
26710,14,413,2281,310,3706,103
31297,6,142,2039,111,3494,31
17109,3,73,2749,62,6921,11
2441,16,543,3517,453,8626,90
36055,118,2876,1804,2079,41608,797
43382,3,40,987,32,2064,8
7825,173,8550,3302,6414,54699,2136
1110,5,223,3799,179,5006,44
32717,5,176,1969,159,4704,17
36901,26,781,1756,637,18118,144
41602,11,325,1387,246,7680,79
19775,0,84,2626,57,2748,27
42583,7,325,1203,220,6576,105
10689,12,276,3127,239,16740,37
35188,1,63,1864,50,3179,13
38203,19,606,1671,411,5995,195
7189,20,2251,3341,1554,46647,697
45801,41,299,326,225,4386,74
22806,1,205,2461,159,2274,46
16358,10,574,2789,476,6715,98
5487,571,66910,3421,47758,129620,19152
21241,6,302,2542,250,7339,52
3128,26,1699,3506,1298,35656,401
43616,7,201,909,187,7559,14
16224,0,141,2796,113,3328,28
35232,23,542,1861,415,7880,127
34219,187,7082,1914,5317,33736,1765
23616,26,570,2421,443,2706,127
31750,31,865,2014,717,12946,148
955,1,101,3851,80,5667,21
32285,0,25,1988,20,1809,5
7429,18,244,3327,189,5401,55
29722,1,81,2118,67,1976,14
4724,2,95,3460,76,5986,19
36609,90,1611,1773,1288,7826,323
35359,32,360,1855,278,3853,82
13758,19,38486,2940,13562,10576,24924
6282,2,157,3385,124,2903,33
32361,10,323,1984,273,6619,50
12527,5,108,3031,81,2821,27
18150,5,244,2700,186,7334,58
13410,4,172,2968,134,5041,38
22899,10,480,2455,406,6377,74
20416,21,943,2592,750,12531,193
38189,11,262,1672,192,6519,70
7468,2,37,3326,32,4292,5
12268,35,1634,3046,1256,36594,378
4954,252,15574,3449,11065,36988,4509
36557,3,85,1777,73,3134,12
12047,48,2285,3058,1679,24743,606
4827,4,354,3456,283,15455,71
46140,49,611,186,538,11458,73
31465,62,3716,2030,2500,46245,1216
27636,55,2757,2232,2000,18503,757
32140,3,92,1994,75,3545,17
42883,27,866,1134,646,10496,220
28029,61,3893,2209,2989,60803,904
6224,6,58,3387,50,2824,8
39545,4,142,1584,113,7725,29
25600,16,707,2331,535,5020,172
6764,31,2630,3364,2004,23916,626
24280,1,47,2390,43,5243,4
22311,7,500,2485,418,11086,82
30276,21,1944,2091,1519,7517,425
30568,532,38728,2073,27798,100865,10930
37005,9,199,1750,155,5055,44
6554,34,1682,3372,974,21556,708
30992,5,267,2055,193,3598,74
34851,5,310,1881,221,4846,89
2721,36,652,3513,488,16819,164
15792,0,389,2815,302,5016,87
14985,53,3447,2855,2428,17588,1019
20082,145,9459,2609,6562,51366,2897
11608,13,607,3079,478,15391,129
30645,21,737,2069,580,7452,157
31433,12,725,2032,598,11566,127
42218,168,4389,1274,3163,92790,1226
4951,106,2990,3449,2213,24473,777
14753,23,796,2868,630,12349,166
40545,104,1111,1512,912,69949,199
17017,51,3704,2755,2368,33902,1336
31011,3,58,2054,49,1779,9
44722,74,587,692,535,15158,52
19179,24,1820,2657,1416,21312,404
45259,20,752,511,619,8211,133
13277,179,10685,2979,8775,72235,1910
35928,0,35,1813,29,1812,6
38547,9,165,1646,136,12995,29
6654,3,35,3369,31,4640,4
8281,27,1075,3264,765,16069,310
8425,30,1285,3254,1043,6576,242
21414,6,168,2534,120,1982,48
19045,0,28,2662,22,1111,6
3471,264,19495,3499,14850,136160,4645
31539,22,525,2025,438,17697,87
21878,47,1702,2508,1329,11922,373
45621,6,62,402,37,2873,25
1880,11,288,3528,238,8182,50
9051,301,13395,3217,9874,58884,3521
42102,1,101,1300,87,4545,14
23080,538,15502,2447,10518,65861,4984
45909,165,1665,288,1357,19751,308
8049,221,20684,3276,15785,101167,4899
23188,39,2395,2442,1883,17091,512
10311,10,458,3148,366,7931,92
15326,20,686,2836,570,14426,116
7087,13,270,3346,226,11116,44
34006,5,161,1920,115,8011,46
26104,12,293,2309,250,4486,43
14075,7,606,2915,502,15652,104
24509,143,5962,2380,4116,25969,1846
5916,38,782,3398,639,17504,143
41430,7,243,1412,170,7101,73
12245,247,17181,3047,11233,110963,5948
19570,7,461,2637,371,10115,90
46249,52,759,149,595,7352,164
45883,2,17,297,6,1082,11
12217,3,13,3049,10,1571,3
2751,53,1493,3512,1187,19985,306
25579,98,3070,2332,2417,42474,653
21876,6,619,2508,510,9713,109
27603,10,552,2234,455,8975,97
28468,17,443,2184,355,2897,88
19562,5,129,2638,104,7083,25
31234,35,2199,2042,1634,17618,565
15637,302,15909,2822,11206,123797,4703
5401,3,79,3424,62,5423,17
13365,0,21,2972,18,1868,3
30245,19,893,2092,727,9171,166
3530,28,711,3498,589,7595,122
30541,44,879,2075,674,12890,205
9880,11,244,3168,201,5894,43
24081,0,1951,2399,1501,16654,450
28065,82,2360,2207,1701,31955,659
18858,66,5451,2669,3996,25317,1455
19050,3,101,2662,83,1725,18
24160,21,480,2396,395,2560,85
10064,55,1405,3159,1081,14272,324
34115,6,339,1916,252,4267,87
33361,12,310,1944,238,4970,72
14552,5,242,2883,161,12110,81
14639,44,1817,2876,1391,15180,426
7025,9,267,3350,201,3928,66
23899,13,853,2408,708,15686,145
22771,67,4484,2462,3292,24353,1192
3595,695,27672,3497,19294,186298,8378
23790,7,245,2413,204,7439,41
29556,6,126,2126,104,3016,22
20765,8,393,2574,300,12757,93
3452,53,1826,3500,1400,28876,426
10834,11,1134,3119,891,16141,243
12061,97,3775,3057,2719,22585,1056
16859,3,239,2763,197,3912,42
25339,24,716,2343,542,4376,174
30495,2,138,2077,106,3949,32
37585,0,44,1713,36,2134,8
21245,0,512,2542,311,11582,201
40399,18,412,1526,321,4756,91
17143,53,1685,2747,1270,12876,415
39705,24,806,1575,622,8839,184
14423,2,79,2891,68,7302,11
19314,18,678,2649,577,25608,101
25286,3,165,2346,132,4331,33
40331,57,2299,1534,1652,23493,647
13350,450,47845,2973,31891,203671,15954
30716,0,66,2066,56,4655,10
6721,2,96,3366,82,1904,14
16263,18,1066,2794,806,21906,260
37323,3,114,1730,92,3901,22
5314,25,785,3429,642,16130,143
43256,6,161,1026,108,5422,53
13257,23,76179,2980,21863,25274,54316
24050,28,666,2401,585,7071,81
11626,5,288,3078,207,4867,81
38325,19,463,1662,351,9349,112
41925,96,2055,1331,1545,30328,510
3174,4,160,3505,130,2310,30
21243,12,573,2542,462,7371,111
33014,0,31,1957,25,1792,6
11414,42,1037,3090,818,10535,219
2083,82,1901,3523,1520,42595,381
23356,167,6066,2434,4555,56123,1511
8798,252,12931,3230,8837,76201,4094
29510,2,82,2128,66,4640,16
22638,32,595,2469,491,16995,104
36688,28,839,1770,684,9267,155
7896,5,126,3295,106,6398,20
29945,1,65,2107,47,2767,18
30936,17,406,2057,308,4326,98
20322,6,297,2597,245,10042,52
36693,47,1419,1769,1042,9132,377
7815,36,1046,3303,757,6884,289
4452,10,239,3470,207,6241,32
16020,493,20531,2806,14764,55289,5767
36023,41,594,1807,500,9106,94
8394,102,7166,3256,5470,28167,1696
35759,20,630,1826,513,13762,117
19332,9,1241,2649,920,11357,321
26978,0,0,2269,0,34854,0
21444,27,1285,2532,1052,18652,233
20332,432,16467,2597,13050,53781,3417
13020,49,1514,3002,1117,14593,397
32622,46,1428,1973,1025,12719,403
4600,274,30375,3465,20323,102027,10052
33861,14,379,1925,309,4024,70
32544,8,659,1977,466,11484,193
18806,878,81642,2671,58182,294927,23460
36844,654,15536,1759,11310,66948,4226
27048,7,523,2267,389,4880,134
25696,6,356,2326,303,3524,53
11169,925,47783,3101,33796,118862,13987
14273,23,1349,2904,1142,15841,207
8610,8,412,3242,325,14571,87
39140,26,835,1609,654,7639,181
8894,5,233,3225,206,3500,27
25679,37,2488,2327,1912,16625,576
29429,87,4258,2132,3133,21551,1125
18987,31,2006,2665,1544,15865,462
18691,31,1649,2676,1346,18689,303
12317,28,1679,3043,1225,19041,454
42383,68,1794,1244,1339,28841,455
43534,18,403,941,301,8556,102
2680,1,95,3514,77,4054,18
29796,22,770,2115,647,13965,123
26330,1,55,2298,51,2580,4
43915,14,223,835,166,4076,57
15700,1,554,2819,433,6893,121
41292,7,326,1431,249,6276,77
25933,38,2861,2316,2261,20357,600
37286,3,295,1732,248,6228,47
6656,7,52,3369,46,3144,6
13378,28,3244,2971,2254,51633,990
38153,0,43,1674,35,3741,8
30075,0,175,2101,138,3986,37
5047,15,349,3445,294,10855,55
32158,17,336,1993,272,7392,64
37479,26,1266,1720,987,14027,279
21562,649,24217,2525,18833,81278,5384
38868,34,895,1625,730,8188,165
33233,13,258,1948,220,4755,38
29691,4,68,2120,62,4444,6
2769,23,421,3512,356,6473,65
3158,13,474,3505,380,20829,94
5080,3,23,3443,21,2338,2
5665,12,275,3411,226,4957,49
25626,2,92,2330,77,2967,15
41122,78,549,1457,428,5467,121
8203,37,868,3268,635,12075,233
11606,16,325,3079,251,6201,74
17642,14,962,2722,752,5048,210
31483,13,437,2029,337,7750,100
14224,7,226,2907,177,4665,49
13337,174,10343,2974,7206,34071,3137
18131,352,19023,2701,13989,136715,5034
19752,12,274,2628,227,3960,47
28172,11,277,2201,235,7080,42
10104,45,811,3157,601,7502,210
21355,15,547,2537,417,15863,130
1816,3,121,3530,99,17578,22
43676,154,3066,891,2530,28645,536
18191,3,94,2698,76,3570,18
3510,12,405,3498,330,9119,75
2719,1,27,3513,22,4405,5
12152,17,288,3052,252,3638,36
12229,1,53,3048,41,7719,12
21583,11,454,2524,342,5178,112
28901,3,185,2160,144,3722,41
35740,1,41,1827,33,6016,8
17110,25,1889,2749,1462,24676,427
8680,57,1539,3237,1131,14367,408
23686,4,454,2417,343,8410,111
43770,25,569,860,499,9095,70
14777,5,706,2867,558,18788,148
6411,85,3117,3379,2421,64073,696
41556,8,117,1395,89,3927,28
35668,3,352,1832,274,11766,78
8845,14,1333,3227,1014,34553,319
36301,3,244,1790,203,5516,41
32253,5,321,1989,265,6410,56
23599,77,4960,2422,3704,43516,1256
42439,21,944,1231,598,5820,346
2940,10,457,3509,348,13764,109
23724,9,422,2416,305,7923,117
23487,366,18174,2427,13892,142860,4282
45767,38,683,335,547,6975,136
8380,35,1878,3256,1464,39400,414
41413,64,1678,1414,1211,17263,467
26426,7,257,2293,220,8616,37
42885,6,137,1133,109,7323,28
26735,79,2982,2280,2272,30269,710
2529,51,1627,3516,1151,12667,476
21425,28,713,2533,545,5448,168
14220,36,1146,2908,936,11732,210
2728,3,38,3513,28,4200,10
26569,0,74,2287,65,1829,9
2448,1,19,3517,14,3618,5
35757,43,1128,1826,835,10296,293
7912,9,199,3293,165,4441,34
9754,92,14386,3175,10464,50263,3922
45916,6,107,285,87,1315,20
24607,5,532,2374,390,5642,142
11496,14,439,3084,319,6209,120
30156,8,195,2098,169,6844,26
32240,26,518,1989,413,8879,105
27599,17,513,2234,415,4397,98
3240,47,1694,3503,1391,10611,303
13731,3,73,2943,59,6505,14
19959,33,1780,2616,1396,28604,384
22939,49,2999,2453,2289,17756,710
44888,39,324,642,242,4472,82
45321,7,77,492,52,3254,25
37841,2,191,1695,107,4515,84
14336,237,15874,2898,9533,76337,6341
38404,10,247,1657,201,5416,46
17811,199,22715,2716,14994,71961,7721
17621,488,99175,2723,66617,142578,32558
29864,4,74,2111,57,1903,17
19101,72,2879,2660,2198,45238,681
6723,6,185,3366,153,5182,32
30730,44,1463,2065,1025,8066,438
12990,14,686,3003,555,9450,131
9692,8,278,3177,215,4702,63
44777,10,109,674,79,2705,30
36052,47,5219,1804,3677,17539,1542
12995,12,503,3003,438,9568,65
2142,12,380,3522,318,12448,62
8565,26,502,3244,430,10470,72
4874,38,667,3453,563,11958,104
18503,7,461,2684,389,8666,72
9044,23,773,3217,575,25082,198
39671,23,203,1577,144,3290,59
10980,178,13063,3112,10057,47025,3006
36277,47,1536,1791,1181,14868,355
3137,24,1035,3505,817,9853,218
3285,25,758,3503,563,11472,195
10042,19,334,3160,271,6276,63
24668,25,501,2371,328,6784,173
18000,111,2817,2706,2167,10451,650
31580,6,193,2023,155,3353,38
11799,3,81,3069,71,4477,10
21326,1,72,2538,59,8584,13
28021,6,293,2210,238,5357,55
12697,2,259,3022,159,4582,100
2376,75,3188,3518,2377,49534,811
28204,31,1230,2199,983,18306,247
26695,0,61,2281,53,4880,8
32775,184,19441,1967,14040,86387,5401
23817,10,230,2412,183,6701,47
15920,7,259,2811,213,5471,46
46389,61,2066,90,1724,9573,342
31713,0,57,2016,39,4048,18
40958,2,153,1476,120,5334,33
34216,29,764,1914,578,5359,186
10301,11,589,3149,418,11069,171
26190,0,156,2306,110,7570,46
24427,9,227,2384,165,11870,62
38355,1,29,1659,24,2793,5
2599,14,258,3515,194,5777,64
22197,171,7628,2490,5563,36105,2065
4267,66,4143,3477,2872,28191,1271
15243,83,5265,2841,4032,35961,1233
23472,38,2130,2428,1622,22093,508
38067,24,857,1680,629,27284,228
8787,6,149,3231,106,6816,43
2434,5,408,3517,319,19231,89
35248,0,391,1860,311,4558,80
33064,130,3015,1955,2382,17057,633
45484,22,278,450,200,5284,78
34606,2,71,1896,62,3689,9
37682,4,167,1708,140,3422,27
37543,79,2737,1716,1855,26709,882
20449,6,168,2590,128,3101,40
16820,9,515,2765,431,6585,84
2512,107,3040,3516,2109,25276,931
16831,6,1141,2765,895,49196,246
44614,62,2717,722,1860,20611,857
7743,10,266,3309,216,13929,50
29487,3,240,2129,205,8108,35
4132,185,7187,3482,5374,68087,1813
15191,85,7014,2843,5364,45021,1650
16746,591,38389,2770,24874,174758,13515
32025,0,69,2001,46,2408,23
8327,12,130,3260,114,3645,16
19348,10,233,2648,189,3697,44
3123,10,232,3506,175,3825,57
33327,4,163,1945,134,3782,29
32693,5,228,1970,182,4989,46
29670,3,280,2121,211,6447,69
4154,3,20,3481,17,2046,3
42082,6,259,1303,173,4077,86
2059,43,1702,3523,1374,47526,328
27119,1,147,2263,127,5107,20
6402,12,420,3379,311,14444,109
2386,49,2388,3518,1933,37471,455
13160,110,2284,2985,1823,24059,461
30046,58,1847,2103,1459,21801,388
17650,12,714,2722,552,6906,162
3003,10,247,3508,201,6672,46
15278,1681,138904,2839,96416,315386,42488
11280,5149,338989,3095,202647,939446,136342
23274,1,165,2438,142,5288,23
16810,4,268,2765,220,4940,48
15255,23,516,2840,395,4808,121
22395,1,303,2481,249,4405,54
17626,71,1522,2723,1182,25594,340
6690,122,4728,3367,3761,28890,967
7271,55,4328,3337,3220,86582,1108
30948,48,966,2057,798,18429,168
29126,762,28709,2148,21080,123933,7629
5654,73,7804,3412,5794,179468,2010
11116,18,667,3104,495,17918,172
38600,11,681,1642,479,24966,202
46336,50,852,115,568,18090,284
25984,8,214,2314,178,4063,36
22004,43,1804,2500,1469,19509,335
28931,27,1283,2158,976,7097,307
43355,22,624,998,437,8505,187
17213,10,302,2743,236,5511,66
45088,80,811,572,592,11194,219
28872,11,385,2161,282,5314,103
6847,12,353,3360,288,4291,65
3166,14,354,3505,301,15029,53
23775,21,1196,2414,955,14829,241
7169,14,291,3342,222,5293,69
36337,26,695,1788,549,6489,146
2758,67,2232,3512,1697,36553,535
11471,32,2334,3086,1866,19964,468
22165,0,74,2492,49,5008,25
46238,1,9,151,8,549,1
31295,8,191,2039,157,3675,34
4218,3,104,3479,86,2235,18
19374,3,326,2647,247,5325,79
7752,28,698,3308,523,8798,175
18343,7,572,2691,458,4491,114
5121,26,1039,3440,819,15025,220
11030,0,48,3109,39,2398,9
45851,60,774,308,585,12514,189
25695,215,14468,2326,10695,63689,3773
35969,1984,50664,1811,34500,250625,16164
5191,46,940,3436,719,7514,221
7874,19,435,3297,328,5264,107
15306,8,508,2837,413,13021,95
7914,153,7205,3293,5092,29973,2113
2261,0,30,3520,24,1810,6
24244,7,252,2392,216,2315,36
19495,5,505,2640,408,19128,97
4158,146,7396,3481,4648,35708,2748
37087,456,14902,1745,11171,106375,3731
30819,0,24,2061,22,1673,2
39885,2,190,1564,130,3534,60
45593,1,43,416,26,1837,17
16140,9,467,2800,366,6586,101
25565,0,646,2333,476,9953,170
13124,10,437,2995,266,7063,171
13479,31,1498,2962,1199,9892,299
31065,13,296,2051,231,4028,65
12856,7,574,3012,417,6083,157
32998,9,214,1958,175,4718,39
42759,17,902,1163,604,9928,298
15310,137,5913,2837,4324,32684,1589
31832,1,47,2010,37,3984,10
36432,11,342,1784,268,7271,74
35112,13,120,1868,102,2717,18
45995,10,163,248,129,2191,34
5060,9,137,3444,113,3526,24
17562,557,22652,2726,17468,61175,5184
19156,194,9369,2658,6492,50125,2877
14084,21,1244,2914,968,16355,276
42833,5,574,1145,287,8815,287
7986,2,188,3285,125,9671,63
39120,35,902,1609,640,8061,262
12010,28,407,3059,310,9526,97
15111,109,5503,2848,4151,57827,1352
19774,7,354,2626,295,5886,59
1869,273,11182,3528,7532,45998,3650
15682,10,516,2820,413,7354,103
33057,9,196,1955,176,5839,20
15133,19,1214,2847,1015,32587,199
17191,50,5581,2744,3767,21659,1814
41050,362,5893,1467,4678,38635,1215
44776,13,307,674,215,6135,92
35714,27,898,1829,729,6095,169
2992,175,10919,3508,7048,82390,3871
24049,11,485,2401,425,6056,60
8893,27,1536,3225,1068,28818,468
34183,58,2751,1915,2053,23212,698
21799,24,892,2512,727,15750,165
43786,88,2007,855,1470,19399,537
6372,77,2997,3380,2329,23283,668
15847,60,3862,2814,2648,26902,1214
18633,3,72,2679,61,2800,11
5048,40,1026,3445,778,14519,248
2494,16,245,3516,205,4706,40
22441,4,81,2479,59,1617,22
11704,20,696,3073,539,21387,157
35540,1,74,1842,60,2773,14
6004,11,240,3394,194,10039,46
41723,152,3878,1368,2913,47600,965
4130,25,593,3482,472,8716,121
33121,0,37,1952,29,2049,8
22408,41,2154,2480,1698,10389,456
37139,12,403,1742,328,10918,75
42316,40,814,1257,609,13839,205
1013,1,7,3832,5,1808,2
39343,1,124,1595,87,3055,37
23320,55,5443,2436,3785,28729,1658
21864,21,1519,2509,1141,13501,378
5959,13,518,3396,414,5035,104
4657,26,150356,3463,55547,4817,94809
25680,0,37,2327,31,1104,6
26044,4,135,2311,110,4459,25
46303,33,706,129,620,6881,86
6483,12,369,3376,299,10615,70
6018,6,248,3394,98,2611,150
7902,504,58118,3295,37960,234681,20158
12531,1,86,3031,46,1372,40
43485,42,1076,959,731,10482,345
16431,27,1715,2786,1339,26666,376
8579,26,707,3243,611,8957,96
4622,645,41745,3464,27224,238040,14521
41450,156,3119,1409,2387,12251,732
39756,1026,37285,1573,25880,265333,11405
6010,7,208,3394,163,2025,45
40995,9,146,1473,111,4882,35
30363,1,55,2085,40,2495,15
45699,33,373,368,274,5968,99
7408,49,1053,3329,875,18296,178
19693,21,1076,2632,773,20197,303
20246,0,95,2599,78,4279,17
35062,2,125,1871,107,4278,18
18287,27,1836,2694,1435,15263,401
11897,25,592,3065,453,3756,139
6318,109,5121,3383,4033,54640,1088
25438,7,120,2339,102,2880,18
19387,726,77972,2646,50752,180973,27220
3259,14,497,3503,412,3547,85
28484,2,76,2183,65,3185,11
4173,0,8,3480,7,1535,1
39978,15,619,1557,467,11731,152
27761,10,241,2225,204,5776,37
3087,15,1088,3506,861,24298,227
4188,30,1321,3480,1039,24717,282
16091,74,5920,2802,4323,46250,1597
7282,1,101,3336,89,3108,12
42682,30,428,1181,362,3968,66
36047,5,156,1805,141,14354,15
9142,3,89,3210,74,2832,15
13944,70,5562,2925,4231,35552,1331
25858,0,80,2320,67,3172,13
21537,8,632,2527,520,8217,112
19804,61,3599,2625,2489,27555,1110
19833,11,509,2623,403,13474,106
11701,5,216,3074,160,7621,56
34808,7,324,1884,248,5107,76
46025,30,316,234,245,4587,71
40985,5,259,1474,199,4731,60
46329,16,137,119,119,3723,18
19389,19,696,2646,527,15703,169
2797,35,995,3511,781,13355,214
4596,133,3820,3465,3031,29015,789
35816,3,137,1821,111,3717,26
1216,3,79,3766,73,1978,6
22793,51,1287,2462,922,6100,365
43277,38,361,1020,249,6285,112
6278,6,134,3385,108,2952,26
18801,325,13169,2672,9692,44937,3477
11540,19,409,3081,343,15911,66
18138,83,4230,2701,2826,23521,1404
41694,51,1043,1373,821,8883,222
13980,7,877,2922,673,22271,204
12067,44,1165,3057,867,14379,298
18531,7,350,2684,263,7416,87
34035,2,66,1919,56,2824,10
25687,1,152,2327,105,2988,47
21995,2,127,2500,108,5474,19
43451,84,1171,969,857,7931,314
18114,0,95,2701,79,2382,16
45760,134,1399,338,1169,12736,230
37603,48,1180,1712,880,19076,300
17247,98,4218,2741,3091,40025,1127
4261,6,88,3478,71,4573,17
4055,18,746,3484,569,14732,177
30956,18,670,2056,539,7848,131
26371,0,47,2296,43,2207,4
15348,53,3734,2836,3004,38354,730
42379,10,440,1244,322,8424,118
2444,11,372,3517,301,6310,71
20778,207,10906,2573,8089,38750,2817
34227,1,162,1914,116,4428,46
6474,18,365,3376,292,5912,73
43135,5,257,1061,182,10275,75
25177,11,599,2350,467,8772,132
5177,6,350,3437,296,8703,54
11908,20,885,3065,712,8715,173
1552,3,155,3593,131,4700,24
15315,20,2241,2837,1764,14055,477
10228,1,32,3152,25,1655,7
4688,39,712,3461,548,13618,164
40598,2,72,1508,51,2939,21
45975,1,40,255,27,762,13
19747,8,363,2628,293,15076,70
23322,66,2255,2435,1675,29154,580
33179,50,1770,1950,1434,24074,336
23450,8,417,2429,281,3435,136
8434,20,1405,3254,1016,22145,389
13926,5,335,2927,240,8555,95
40726,2,56,1497,44,4755,12
21976,1,95,2501,76,11422,19
12609,20,849,3027,651,5972,198
2540,32,860,3516,704,21216,156
34241,43,697,1913,576,6608,121
35949,15,139,1812,118,3696,21
40057,24,394,1552,301,7371,93
15072,2,143,2850,112,3074,31
7931,118,5914,3291,4327,42292,1587
32024,1,46,2001,40,3130,6
21307,53,1845,2540,1344,18572,501
29182,5,213,2146,171,3919,42
5133,13,400,3439,288,13795,112
5670,4,66,3411,52,4966,14
44643,22,398,721,289,6342,109
9481,8,223,3188,168,8843,55
17852,2,270,2715,182,4301,88
28670,0,85,2172,70,3060,15
5564,6,162,3417,144,4500,18
41453,1,195,1408,156,4560,39
35278,64,2118,1858,1538,23163,580
43618,26,263,909,224,6259,39
23713,2,211,2416,140,5906,71
14705,44,2376,2872,1789,24215,587
38906,20,555,1623,422,9031,133
8408,16,276,3255,220,6700,56
19046,3,234,2662,165,1889,69
39570,1,170,1583,136,3707,34
13439,25,600,2965,492,8066,108
20792,3,330,2571,255,4086,75
7403,21,1124,3329,926,18456,198
1986,6,97,3525,87,3081,10
18751,19,724,2674,608,6505,116
39230,16,742,1602,492,13271,250
11025,312,32084,3109,22924,208923,9160
16637,125,5471,2776,4067,41307,1404
33090,1,223,1953,181,4023,42
11057,5,96821,3108,29163,2319,67658
29603,17,978,2125,774,23804,204
26285,11,405,2300,300,2797,105
10943,20,1319,3114,1046,16576,273
41531,20,207,1399,170,4242,37
8035,177,4362,3277,3493,13621,869
35113,9,134,1868,114,3140,20
19819,16,927,2623,761,27601,166
35303,5,133,1857,112,5163,21
40066,0,1276,1551,913,22277,363
5954,81,6869,3396,5081,23700,1788
27901,16,525,2216,443,11421,82
4542,7,79,3467,65,5643,14
36661,17,779,1771,580,6225,199
946,20,966,3853,802,6643,164
21609,6,730,2522,536,12467,194
23813,29,1657,2413,1347,15301,310
3561,10,530,3497,373,9466,157
39909,277,9348,1562,6572,48574,2776
6016,1,68,3394,63,6087,5
40818,60,1496,1487,1095,19824,401
12521,3,114,3031,99,2743,15
32018,1,151,2001,100,5847,51
19759,374,25563,2627,18965,135439,6598
20244,2,81,2599,62,3271,19
8785,17,871,3231,682,25061,189
41739,289,5439,1365,4034,61617,1405
25057,0,12,2355,11,3769,1
25923,10,299,2316,246,6718,53
22247,57,2512,2487,2021,24036,491
20456,40,1949,2590,1491,20958,458
42594,40,940,1201,706,10326,234
34867,30,437,1880,365,5519,72
26800,36,1092,2276,847,17876,245
34516,45,1586,1901,930,9320,656
43690,60,1251,884,931,27912,320
16015,11,365,2806,272,3426,93
16780,12,334,2767,294,5634,40
32476,9,296,1980,246,5189,50
41536,6,240,1398,184,6184,56
10078,100,3901,3158,3094,29992,807
20112,260,16901,2608,10124,96525,6777
4075,13,349,3484,278,5774,71
38434,13,373,1654,287,6112,86
43694,21,194,883,148,5617,46
16447,58,2575,2785,2094,21632,481
26200,794,39905,2304,28774,125059,11131
34939,99,1459,1877,1164,9512,295
16407,43,1511,2786,1188,11834,323
21715,9,232,2516,185,5451,47
36699,8,533,1769,399,8096,134
5103,13,208,3441,157,2515,51
34943,1,301,1877,226,15223,75
12975,12,514,3004,427,8573,87
32405,748,15174,1982,11561,73634,3613
17924,72,3482,2711,2751,67110,731
38983,1,45,1618,38,3334,7
44215,14,208,775,154,3302,54
27180,0,26,2260,20,4383,6
15735,34,1504,2818,1237,8048,267
36979,7,202,1751,155,4015,47
41402,16,584,1416,432,10489,152
35161,3,69,1865,63,3416,6
4321,1,102,3475,87,12346,15
5744,27,718,3408,516,21732,202
18822,36,2827,2670,2324,22244,503
28255,28,1209,2196,938,8532,271
11394,5,361,3091,285,13280,76
20395,18,923,2593,726,9266,197
38629,18,428,1640,366,8142,62
17537,11,508,2727,414,5074,94
5859,55,997,3401,787,7129,210
7828,19,233,3302,196,9280,37
40882,447,6316,1481,4925,45690,1391
20976,5,262,2560,201,6213,61
7013,118,8182,3351,6095,54523,2087
24640,13,397,2372,325,5704,72
8795,52,649,3230,514,6915,135
18837,4,336,2670,254,5130,82
30010,1,43,2104,39,1883,4
21071,3,210,2554,166,5678,44
25572,9,162,2333,130,4980,32
18904,12,466,2667,331,5965,135
11211,205,11695,3099,7698,60242,3997
18338,24,2374,2691,1785,17409,589
25700,4,445,2326,377,7912,68
6164,11,390,3389,325,9026,65
16982,3,174,2757,125,3085,49
15423,8,276,2833,225,12142,51
18227,174,13387,2696,9909,80940,3478
12327,4,117,3043,84,5942,33
24091,184,9044,2399,6393,64516,2651
13286,10,781,2978,642,10436,139
15776,66,6927,2816,5138,25728,1789
25372,428,17087,2342,12418,65449,4669
14267,85,1943,2904,1516,14708,427
41825,13,384,1346,334,3829,50
31488,98,6035,2028,4394,56921,1641
14033,33,2938,2919,2110,10317,828
26772,85,2695,2278,1965,14183,730
10095,12,322,3158,275,26694,47
5634,5,392,3413,293,10938,99
16354,89,4503,2789,3389,31935,1114
22069,30,587,2496,479,5767,108
10114,6,218,3157,124,2111,94
14770,3,139,2867,117,5302,22
4061,76,1824,3484,1396,12067,428
32069,3,168,1998,110,9123,58
15414,191,9954,2834,7090,25312,2864
34526,73,1715,1900,1354,10332,361
18593,17,281,2681,211,3351,70
4350,73,1884,3474,1452,13313,432
45968,6,71,258,53,1377,18
38656,1,33,1638,26,2400,7
44900,8,174,638,100,3768,74
25561,53,895,2334,708,9033,187
13954,16,1952,2924,1365,7092,587
24795,76,5303,2367,3839,31964,1464
39193,98,3392,1605,2320,15118,1072
10427,7,219,3143,148,4277,71
23641,18,484,2420,375,7668,109
6928,22,821,3356,596,8021,225
30402,13,517,2083,402,7671,115
32669,0,22,1971,18,4992,4
10155,94,3847,3155,2958,52051,889
45103,34,683,562,573,7767,110
31797,25,566,2012,440,8558,126
11698,727,27447,3074,19824,160810,7623
17181,583,26864,2745,18879,110573,7985
42023,0,44,1316,31,5816,13
39747,21,1065,1573,779,13607,286
30404,98,1673,2083,1280,11030,393
993,5,227,3838,181,9227,46
8030,2,22,3277,17,4433,5
37353,7,131,1729,102,5046,29
31994,556,25352,2003,18233,154181,7119
24294,3,346,2389,290,3514,56
39955,19,236,1559,190,5606,46
42661,6,74,1186,67,2826,7
25732,11,600,2325,497,4909,103
8834,29,789,3228,609,7195,180
37382,1116,24239,1727,18793,147519,5446
43250,2,74,1028,52,2123,22
34538,2,76,1899,63,2885,13
44205,39,555,785,385,6593,170
18536,19,881,2684,669,13327,212
39501,3,80,1587,68,7785,12
31858,13,1956,2009,1361,5761,595
45716,126,1475,356,1238,13146,237
45735,16,155,347,132,2301,23
3177,27,643,3505,397,5451,246
25677,31,1343,2327,1050,19543,293
41991,13,349,1320,275,13639,74
41732,92,4952,1366,3661,28132,1291
23921,10,527,2407,424,8726,103
29994,100,3192,2105,2450,26251,742
13632,125,10728,2952,8280,43709,2448
39740,4,122,1574,100,6300,22
18344,3,326,2691,250,7418,76
42030,2,122,1315,91,5162,31
40233,10,923,1541,658,14386,265
28576,6,427,2177,330,8118,97
19410,3,253,2644,210,13318,43
35867,0,129,1818,98,6801,31
28039,5,200,2208,143,13532,57
46197,21,556,162,387,6763,169
21956,20,940,2503,724,16372,216
17876,17,708,2714,506,35262,202
29322,48,2265,2137,1624,18697,641
36333,2,61,1788,48,3207,13
36951,10,271,1753,241,10382,30
27712,0,3553,2227,2820,44866,733
37750,5,161,1702,127,3916,34
31400,46,2138,2034,1733,18079,405
26545,6,314,2288,233,5734,81
34273,0,37,1912,32,7715,5
27973,52,1948,2212,1573,18968,375
16602,62,1992,2778,1526,21523,466
46216,0,9,157,7,590,2
14028,13,626,2919,475,8768,151
7113,2,507,3345,397,12849,110
30140,60,1991,2098,1457,20910,534
39269,2,186,1599,158,5326,28
39934,6,179,1560,144,5219,35
43749,9,229,868,190,8603,39
21047,5,246,2555,197,7817,49
46324,0,4,119,4,848,0
34269,3,29,1912,22,1309,7
13791,15,336,2939,215,5740,121
31039,17,491,2052,377,6897,114
23027,17,655,2450,503,3976,152
18074,32,2676,2703,1884,31371,792
21465,5,273,2531,227,3506,46
13432,86,2759,2967,2091,35320,668
45469,2,22,455,18,1253,4
31187,2,198,2044,158,4900,40
38703,2,224,1635,183,6062,41
20166,362,23979,2605,16542,85128,7437
12076,1,61,3057,45,2346,16
42381,258,6904,1244,5412,48614,1492
32121,12,303,1995,225,4529,78
12364,3,167,3040,128,3347,39
38006,29,648,1685,538,11122,110
26458,4,506,2292,347,6622,159
4316,17,197,3475,144,4360,53
2430,19,371,3517,306,29391,65
5534,85,2571,3419,2064,12228,507
34958,31,807,1876,653,22590,154
3766,5,75,3493,65,3580,10
32345,24,591,1985,474,10330,117
15250,58,1022,2840,845,13294,177
39725,5,105,1574,92,2931,13
10297,13,315,3149,244,9772,71
25672,3,126,2327,102,3870,24
22167,105,13208,2492,9255,58405,3953
23570,93,12987,2423,8479,46099,4508
35985,67,521,1809,422,5052,99
30281,30,552,2090,451,2839,101
2481,77,2863,3516,2090,26204,773
11721,246,8052,3072,5409,43636,2643
15526,6,298,2828,236,6018,62
23796,14,297,2413,224,10508,73
10621,92,5007,3132,3752,73498,1255
1801,21,485,3531,310,8881,175
8786,115,3439,3231,2550,23434,889
22261,9,272,2487,213,7348,59
39678,4,141,1576,97,6752,44
4514,4,138,3468,113,1942,25
6329,63,1540,3382,1208,25612,332
2488,2,39,3516,29,3713,10
4917,83,1159,3451,910,34545,249
31562,18,483,2024,341,3640,142
32592,2,186,1974,150,4118,36
45777,26,390,331,276,2747,114
32863,6,326,1963,259,5008,67
45693,13,70,369,55,1790,15
3803,7,135,3492,113,6948,22
19914,2,89,2619,77,2071,12
32974,1,51,1959,36,2395,15
14507,15,1104,2886,778,18048,326
2472,11,189,3517,152,10077,37
40527,70,2153,1514,1602,19044,551
42758,19,407,1163,292,5361,115
38107,2,64,1677,53,8073,11
10933,77,3188,3114,2475,34676,713
35904,5,137,1815,109,3405,28
14043,221,36083,2918,25788,155335,10295
6962,32,1135,3353,936,10197,199
4273,176,15473,3477,10914,101990,4559
6335,40,2763,3382,2042,26056,721
40277,1,16,1538,14,1633,2
34112,23,535,1916,439,5928,96
22612,79,2801,2470,2019,23066,782
19794,12,217,2625,108,8465,109
28684,4,219,2171,170,3166,49
19166,1,162,2657,127,2309,35
40425,16,428,1524,306,8214,122
39848,22,620,1567,461,9032,159
37116,10,170,1743,150,5737,20
30226,0,33,2093,26,2410,7
21002,47,1472,2557,1170,18715,302
39173,23,1269,1606,951,12236,318
15209,2,122,2842,93,3327,29
37405,6,110,1725,82,2943,28
1621,7,363,3582,295,7891,68
30635,96,3287,2070,2629,22071,658
16351,1,93,2789,80,2072,13
37313,3,103,1730,74,4535,29
8830,19,609,3228,410,6360,199
7920,117,3737,3292,2899,22981,838
38673,4,362,1638,275,6948,87
5098,343,14404,3441,10898,57852,3506
39046,58,1876,1615,1422,20765,454
19633,10,631,2635,481,10001,150
37890,34,1377,1692,1080,21176,297
30250,2,36,2092,32,3022,4
35309,1,160,1857,135,4656,25
36567,129,5216,1777,3951,45615,1265
20328,354,14690,2597,9986,64141,4704
40162,6,60,1546,43,4289,17
41852,57,2162,1343,1617,23337,545
11474,653,27013,3086,18030,95433,8983
2160,74,2333,3522,1869,17023,464
46154,5,190,180,135,2603,55
36601,224,7075,1774,5477,42185,1598
1726,1,70,3555,55,3604,15
12551,278,14622,3030,10826,116934,3796
22210,19,901,2489,657,14165,244
37374,106,2395,1727,1761,13099,634
8568,12,101,3244,79,6567,22
37146,4,106,1741,92,4668,14
23950,20,407,2405,336,6917,71
43329,5,168,1006,153,4402,15
37360,13,1147,1728,906,5781,241
11348,4,219,3093,158,7894,61
16308,1752,116937,2792,71253,574221,45684
34309,3,150,1910,128,5709,22
3975,220,4040,3487,3186,75747,854
36013,9,451,1807,372,3009,79
12611,116,5397,3027,4172,64472,1225
35291,46,473,1858,374,4165,99
29125,12,121,2148,99,3775,22
4715,27,299,3460,239,15977,60
27879,44,971,2218,783,9839,188
40371,8,170,1528,142,4713,28
31077,1,138,2050,123,5391,15
42366,12,615,1247,391,11686,224
4481,192,8098,3469,6024,28783,2074
24754,67,2109,2368,1557,12227,552
14704,57,3973,2872,2822,23055,1151
30862,32,2380,2059,1759,13447,621
30261,57,1523,2092,1141,13155,382
40266,43,1735,1538,1326,20528,409
43624,1,34,908,28,2475,6
44653,7,161,717,134,3662,27
15169,65,2395,2844,1735,16091,660
31898,9,303,2008,251,8089,52
38365,136,7778,1659,5149,49608,2629
32975,10,294,1959,249,8306,45
9881,92,4115,3168,2941,28375,1174
43419,1,58,975,49,3420,9
10634,44,2233,3131,1701,20817,532
23378,1,130,2432,99,5869,31
8104,239,10474,3274,6956,60990,3518
36260,64,2645,1792,1811,16182,834
5861,1920,94132,3401,63434,244655,30698
5366,24,1032,3426,750,15179,282
23802,4,174,2413,146,3968,28
37391,27,396,1726,310,8804,86
41708,38,1094,1370,814,23288,280
2446,379,14581,3517,10791,172402,3790
15288,7,321,2838,273,18267,48
13988,56,2734,2922,2217,27106,517
36839,3,230,1759,203,6039,27
2949,39,1046,3509,846,24706,200
12351,33,1384,3041,999,8089,385
12716,3,236,3021,198,12766,38
14879,32,1815,2861,1419,17074,396
26519,5,83,2289,64,4966,19
22774,48,1404,2462,1063,10871,341
12491,30,1051,3033,844,10046,207
3015,12,512,3508,427,4984,85
24899,12,1001,2362,748,17309,253
44019,11,97,819,73,1373,24
45602,5,59,414,42,2301,17
3714,13,250,3494,199,5104,51
37558,35,964,1715,692,17907,272
35570,151,10928,1841,8729,64248,2199
20232,352,16091,2600,12398,104860,3693
42765,71,1022,1162,903,20879,119
31928,3,104,2006,84,8147,20
8580,12,309,3243,236,7219,73
6647,98,1624,3369,1320,26592,304
8897,385,24686,3225,17130,142288,7556
40567,5,121,1510,89,3375,32
38626,10,393,1640,321,11211,72
2370,36,787,3519,639,18292,148
19377,22,1241,2647,885,7406,356
2462,35,1109,3517,780,15317,329
30206,16,318,2094,275,4752,43
10535,5,169,3137,137,4940,32
40400,12,363,1526,292,6193,71
16517,97,4486,2782,3482,35825,1004
23915,1,104,2408,93,2873,11
5485,8,209,3421,177,9827,32
42696,22,198,1178,149,3686,49
42673,23,596,1184,476,16747,120
3816,96,6308,3492,4825,35381,1483
15330,6,252,2836,208,7771,44
32419,6,233,1982,168,9610,65
44917,15,153,631,116,2564,37
8751,5,72,3233,60,2394,12
35333,1688,65679,1856,45247,286327,20432
40041,19,795,1553,533,8365,262
35731,22,548,1828,440,16909,108
32148,2,125,1994,109,2955,16
33315,41,1203,1946,966,12562,237
42902,218,4308,1129,3396,39195,912
2451,9,389,3517,290,8649,99
13795,26,1718,2939,1333,12765,385
25065,12,215,2355,179,3799,36
20433,16,660,2591,440,7507,220
10866,7,523,3118,434,10621,89
38036,42,413,1683,319,3931,94
42459,38,710,1227,551,16305,159
33168,28,1211,1950,988,16436,223
29448,46,1138,2131,818,17436,320
37514,30,946,1718,663,15471,283
14941,59,2535,2857,1899,24666,636
13679,44,1106,2948,847,27074,259
12396,37,1099,3038,863,29306,236
30335,1,160,2087,122,4205,38
38944,42,1283,1621,1030,24554,253
18522,154,6894,2684,5287,52947,1607
16812,28,1080,2765,810,11114,270
19385,6,327,2646,249,9880,78
12509,15,369,3031,311,2920,58
15190,7,171,2843,126,2434,45
19345,25,929,2648,735,9400,194
29119,2,28,2149,23,2287,5
43319,7,117,1009,104,6264,13
9549,12,215,3184,171,5647,44
23442,3,289,2429,233,10994,56
15485,0,135,2831,107,5206,28
33548,5,587,1936,485,23202,102
45629,40,779,398,629,8893,150
24758,5,243,2368,197,4847,46
19404,14,615,2645,481,6530,134
30219,13,692,2094,563,13350,129
30405,32,1343,2083,1018,14642,325
25661,0,138,2328,111,3503,27
9254,44,1175,3204,976,17865,199
16161,3,250,2799,195,3436,55
27804,10,360,2221,263,3013,97
37699,6,225,1706,163,5837,62
12991,43,1982,3003,1656,9272,326
28946,9,483,2158,413,3936,70
2862,16,361,3510,272,10010,89
6872,21,616,3359,465,12415,151
26897,9,264,2272,222,2726,42
44896,245,2807,639,2397,21366,410
35170,21,254,1865,223,4303,31
21097,12,579,2553,470,9193,109
28672,0,18,2172,16,1449,2
42335,4,109,1253,76,3167,33
8805,28,1027,3229,834,8547,193
4415,11,301,3472,250,3202,51
43984,119,1092,825,857,11488,235
11426,3,142,3089,100,4717,42
5462,1,191,3422,151,6165,40
5165,3,78,3437,65,6825,13
18961,38,1270,2665,988,12155,282
9002,6,125,3219,103,3880,22
18560,33,2243,2683,1452,16922,791
38472,5,360,1652,294,2756,66
13701,32,1864,2946,1308,26480,556
40444,16,386,1521,290,10290,96
4167,650,51254,3481,38559,185769,12695
29776,37,894,2115,675,8795,219
44585,507,6318,727,5093,42232,1225
25452,12,997,2339,818,42250,179
19706,8,287,2631,222,15340,65
37437,2,304,1723,220,6817,84
8415,5,163,3255,124,5564,39
3357,8,269345,3501,95304,8227,174041
22610,1,49,2470,36,1665,13
29146,3,118,2147,92,2022,26
32362,6,295,1984,235,5702,60
28032,7,306,2209,270,11982,36
9779,32,1053,3174,795,11962,258
25770,32,2347,2323,1675,13940,672
38057,10,350,1681,280,5152,70
36610,9,106,1773,89,4005,17
45234,32,241,519,181,4507,60
38778,123,1165,1631,960,11416,205
16755,31,1107,2769,775,6710,332
9745,32,2016,3175,1528,17235,488
19402,16,952,2645,800,14402,152
24118,124,10799,2398,8463,40160,2336
42435,49,986,1232,750,6507,236
20653,5,267,2580,226,5234,41
6870,590,19905,3359,15279,163077,4626
10749,38,2284,3124,1781,31443,503
3823,14,529,3492,442,10200,87
13782,64,1599,2940,1253,11147,346
36435,109,4414,1784,3375,43755,1039
13406,2,23,2969,17,1877,6
42852,106,2239,1142,1321,9828,918
35534,20,576,1843,450,3661,126
8515,14,547,3248,264,5299,283
44744,114,1618,685,1241,11457,377
33427,6,432,1942,350,7562,82
16738,149,9671,2770,6362,54558,3309
2675,1,23,3514,21,2415,2
36756,17,382,1766,320,4947,62
20040,22,915,2611,604,4942,311
43687,1,118,885,88,3985,30
26951,6,127,2269,119,3981,8
35856,45,582,1819,469,9954,113
34991,15,1046,1874,804,13904,242
13771,55,3898,2940,2685,49433,1213
31960,1,62,2005,50,4880,12
11554,3,118,3081,92,2035,26
8659,12,269,3238,231,3343,38
19536,110,4859,2639,3561,26802,1298
15163,43,1393,2844,1085,16401,308
37886,12,412,1692,313,5644,99
36083,14,241,1802,193,4226,48
4161,50,1875,3481,1383,17376,492
7727,7,221,3310,176,9341,45
46225,0,49,155,47,1616,2
5923,15,340,3398,160,4030,180
4284,45,2623,3476,1713,29018,910
35615,50,2717,1837,1990,15518,727
39780,14,351,1572,274,8526,77
10949,9,179,3113,141,4374,38
45902,22,193,291,140,3290,53
45289,4,65,500,46,2570,19
23236,28,1132,2440,877,12923,255
7058,0,95,3348,69,7362,26
22877,70,4142,2457,2705,34883,1437
3186,5,348,3504,257,8785,91
26763,70,2902,2278,1908,35659,994
11076,4,123,3107,91,5550,32
37817,9,240,1697,200,12017,40
42814,14,173,1149,137,3985,36
15588,6,185,2824,146,3851,39
17622,4,207,2723,155,5254,52
4641,28,421,3463,332,11560,89
10188,82,2282,3154,1717,10588,565
30060,91,3431,2102,2675,35060,756
24243,9,243,2392,182,5406,61
19600,12,802,2636,632,3338,170
4178,148,7500,3480,5868,34326,1632
8453,83,3839,3252,3046,18968,793
38229,26,882,1669,719,8917,163
6569,5,50,3372,39,3250,11
36257,8,251,1793,216,5511,35
15259,5,158,2840,143,5740,15
38061,1096,33269,1681,25793,96719,7476
11657,2,102205,3076,26519,7672,75686
36710,1,55,1768,48,2643,7
16656,408,36605,2775,25108,165363,11497
35342,50,5215,1856,3949,20001,1266
18070,89,7918,2703,5067,56281,2851
15896,7,379,2812,282,6770,97
12137,1,90,3053,75,4215,15
35177,3,186,1864,142,13908,44
26279,5,222,2301,170,3303,52
26793,11,307,2277,253,10973,54
13343,2,70,2973,60,4694,10
31303,127,4498,2039,3428,39145,1070
2358,17,372,3519,295,24241,77
5745,157,7043,3407,5237,94909,1806
28907,3,105,2160,88,5819,17
34708,12,290,1890,208,6508,82
4843,98,3015,3455,2224,46325,791
2055,1841,56857,3524,39900,280108,16957
20321,2,208,2597,169,4925,39
19027,297,27556,2663,19032,164830,8524
31802,2,94,2012,71,3623,23
23783,1393,86432,2414,62936,188972,23496
28392,0,131,2188,88,2396,43
6125,2,153,3391,132,4443,21
45764,27,243,337,213,3640,30
4037,7,110,3485,92,5315,18
37907,4,150,1690,124,4251,26
44249,133,1791,778,1382,24202,409
43612,7009,175236,911,137288,893505,37948
14765,75,4745,2868,3768,19199,977
23058,12,685,2448,572,9755,113
30259,5,201,2092,146,3931,55
1973,40,860,3525,741,19572,119
13506,157,11652,2960,8141,82315,3511
2060,110,5091,3523,4081,43192,1010
35547,21,799,1842,670,13017,129
18931,137,7906,2667,5757,36087,2149
5081,10,63,3443,48,3075,15
14916,43,3420,2859,2530,28546,890
9312,12,426,3200,334,9451,92
44764,14,210,680,135,2723,75
42716,7,229,1175,169,6019,60
25963,37,3179,2315,2575,21399,604
20544,26,922,2585,760,10741,162
19784,2,106,2625,90,3447,16
22032,39,3851,2498,2926,18005,925
44898,64,777,639,541,12302,236
4484,104,3992,3469,2718,21220,1274
38117,20,272,1676,219,4968,53
29872,13,1042,2110,834,9611,208
42975,102,1505,1110,1133,8608,372
16479,38,1431,2784,1092,15262,339
38317,9,543,1663,415,9054,128
11105,726,53278,3105,38514,192219,14764
42537,62,1081,1211,828,22554,253
45027,33,302,600,209,4917,93
2772,1,188,3512,151,4265,37
39493,0,194,1587,150,3872,44
18479,38,1102,2685,896,8153,206
7253,157,4440,3338,3154,46615,1286
42083,24,876,1303,671,21149,205
28475,2,59,2184,49,3038,10
1109,7,150,3799,114,5099,36
26492,6,319,2291,267,5007,52
41661,5,217,1378,140,11383,77
29816,0,0,2114,0,1976,0
19173,3,168,2657,144,3399,24
28633,3,103,2173,84,5837,19
30052,9,744,2102,570,7246,174
28587,12,293,2176,208,5562,85
38226,5,113,1669,92,3467,21
21862,644,13232,2509,10167,51647,3065
17549,23,828,2726,640,7774,188
29854,5,603,2112,483,7610,120
4227,3,74,3479,61,3216,13
7604,27,660,3317,545,16755,115
32166,10,705,1993,537,11622,168
8288,105,5109,3263,4014,49621,1095
33738,248,16230,1929,10972,83838,5258
13065,9,383,2999,295,13906,88
30792,18,493,2062,373,8265,120
33729,2,147,1930,119,5835,28
21385,8,307,2535,231,4405,76
7091,5,193,3346,158,4339,35
19494,8,281,2640,204,4371,77
17386,8,257,2733,192,4595,65
13724,19,462,2944,370,4983,92
18429,71,2019,2687,1515,16018,504
7612,51,3396,3317,2373,29448,1023
21570,12,426,2525,352,4309,74
35572,59,536,1841,426,5215,110
4669,25,2601,3462,1950,52872,651
13518,49,3741,2959,2913,34863,828
43388,4,189,984,136,4889,53
37315,29,732,1730,519,6359,213
32827,0,181,1964,145,6982,36
9617,3,258,3180,219,4904,39
42843,82,1982,1143,1439,41991,543
44021,54,864,818,548,5635,316
45510,4,39,444,38,2474,1
38098,39,1884,1679,1363,10130,521
4385,110,2481,3473,1886,14123,595
12042,6,69,3058,57,1932,12
30916,66,1173,2058,967,18704,206
36193,0,101,1795,74,4098,27
43187,7,161,1048,119,4056,42
5903,14,330,3399,238,11525,92
45109,34,345,560,254,4442,91
33305,13,1286,1946,1065,7685,221
38599,41,1481,1642,1162,11802,319
40254,0,79,1539,65,8620,14
28150,29,952,2203,741,12309,211
18796,6,452,2672,321,9093,131
28772,3,155,2166,132,3696,23
24393,6,205,2385,169,5518,36
40703,28,761,1499,587,14158,174
32132,12,266,1995,203,10615,63
22384,100,4660,2481,3223,43865,1437
9042,2,97,3217,76,2818,21
15815,2,250,2815,213,4555,37
10211,34,1107,3152,884,13430,223
2315,18,360,3520,310,20842,50
19281,9,576,2651,429,5942,147
43986,18,260,825,176,5859,84
14069,6,135,2916,100,3762,35
46043,18,229,221,155,4216,74
39808,263,6374,1569,4890,48575,1484
45083,92,1019,574,836,14404,183
27739,215,8771,2226,6847,48491,1924
6357,23,143255,3381,50898,8355,92357
45692,11,158,371,115,3091,43
42051,128,2729,1311,1961,15316,768
32566,0,155,1975,122,6041,33
44669,27,506,711,408,16167,98
37106,13,438,1744,354,7331,84
29592,9,321,2125,240,3763,81
35955,4,77,1812,63,3980,14
38800,607,27449,1629,19348,121941,8101
31703,2,44,2017,37,2265,7
20471,63,3763,2590,2735,23933,1028
32924,3,77,1960,64,3128,13
15167,40,1723,2844,1368,13727,355
35316,33,466,1857,356,4298,110
6593,12,290,3371,214,7839,76
18761,95,16448,2673,11555,211071,4893
15761,2,107,2817,73,2914,34
38183,61,2537,1673,1947,30610,590
41249,6,310,1439,228,14681,82
17299,4,279,2738,238,6685,41
46328,1,57,119,44,1297,13
10950,4,121,3113,97,6489,24
14683,60,2518,2874,1944,21643,574
6830,37,1607,3360,1304,36287,303
12599,83,3322,3028,2527,27173,795
6050,5,270,3393,226,2781,44
18286,0,82,2694,60,3113,22
1777,5,239,3538,186,4702,53
36158,87,952,1797,733,6947,219
20827,42,2149,2569,1711,23272,438
12505,39,1167,3031,798,35347,369
27045,61,2476,2267,1833,26615,643
43336,76,2160,1003,1431,15192,729
7173,9,215,3341,162,4835,53
43636,16,189,904,158,4997,31
26388,5,323,2295,268,6539,55
16209,0,175,2797,133,2513,42
37034,79,4400,1748,3507,41812,893
36048,32,1614,1804,1249,17180,365
7072,11,1011,3347,781,10083,230
31431,285,11329,2032,8072,44655,3257
8287,14,482,3263,378,7336,104
10252,19,677,3151,534,15479,143
5358,29,429,3427,369,8407,60
19687,42,970,2632,779,7856,191
10380,953,24785,3145,17979,197878,6806
19497,7,508,2640,391,7209,117
25427,0,798,2340,600,11009,198
30430,1,25,2081,21,1508,4
18305,6014,358432,2693,245450,1078000,112982
12972,0,164,3005,135,3676,29
32243,14,448,1989,282,5388,166
40537,45,1258,1513,987,27496,271
6060,1,138,3393,121,3333,17
32398,5,166,1983,135,4670,31
42388,20,778,1244,520,4926,258
30451,0,60,2080,43,3362,17
44277,4,104,777,88,6302,16
27829,2,124,2220,96,2609,28
42605,9,176,1199,131,3168,45
33829,7,262,1926,232,2950,30
27128,27,840,2262,662,6020,178
6963,17,428,3353,364,15571,64
2629,7,211,3514,178,11714,33
37700,55,1195,1706,918,12490,277
4279,20,427,3477,333,4792,94
31154,0,73,2047,64,3064,9
40923,109,2985,1478,2258,29742,727
31587,76,2882,2023,2077,32745,805
45371,5,83,479,56,3539,27
1860,11,381,3528,299,11869,82
35746,59,1275,1827,981,14242,294
25527,331,11456,2335,7887,62470,3569
2855,14,327,3511,251,8926,76
19296,9,252,2651,188,4773,64
31242,12,824,2042,638,11048,186
40150,28,752,1547,594,17541,158
20724,8,226,2576,180,10214,46
23170,65,3455,2443,2801,22288,654
18812,65,8641,2671,5957,40752,2684
24962,10,409,2359,305,3896,104
3024,6,296,3507,198,12153,98
2117,11,472,3523,355,4562,117
38043,47,1417,1682,1012,23491,405
7480,6,138,3325,114,3079,24
33376,54,3582,1943,2659,40215,923
42991,61,1326,1104,984,13942,342
18566,95,2482,2682,1695,24448,787
39618,8,406,1580,327,11111,79
43654,0,11,897,11,2207,0
17011,55,1931,2756,1538,8238,393
15591,122,4536,2824,3187,51751,1349
1471,2,27,3618,20,1926,7
45565,5,71,421,32,1148,39
41477,65,857,1405,688,9142,169
2678,47,3344,3514,2616,27251,728
28472,22,2264,2184,1726,11438,538
45384,4,39,476,26,1821,13
25886,1,149,2318,121,5124,28
19688,2,315,2632,259,6107,56
4921,65,1390,3450,1086,30402,304
35101,40,605,1869,502,8200,103
2677,6,232,3514,185,5569,47
31340,872,39435,2037,29265,280520,10170
37021,0,21,1749,15,1976,6
9303,24,438,3201,340,5673,98
4567,18,1571,3466,1166,25451,405
28688,70,2436,2171,1909,26070,527
19596,12,1658,2636,1280,24627,378
4754,176,6992,3459,4966,59636,2026
31684,18,335,2018,275,4663,60
27409,4,434,2246,365,8300,69
4707,3,26,3461,21,2103,5
7464,9,432,3326,310,3806,122
31339,10,889,2037,803,5883,86
32191,117,5143,1992,3559,47775,1584
39583,0,52,1582,43,4856,9
20995,1,73,2558,61,2565,12
19447,42,2331,2642,1543,12110,788
16794,4,174,2766,139,2964,35
5891,25,950,3400,710,8274,240
45010,1,22,606,11,2130,11
25652,89,2739,2328,2116,38200,623
13087,40,1510,2998,995,31872,515
20678,1,27,2579,22,3721,5
27660,0,1296,2230,1005,15179,291
3300,10,436,3502,365,9514,71
6033,3,95,3393,74,6140,21
11730,11,606,3072,453,11382,153
37194,26,987,1737,737,20869,250
14324,20,1812,2899,1323,19288,489
31311,8,428,2038,358,8517,70
24807,185,8208,2367,5587,69947,2621
34003,4,258,1920,209,4980,49
3934,1243,65274,3489,47125,270938,18149
6657,12,236936,3369,80519,4932,156417
45434,3,65,463,42,2096,23
35054,8,323,1871,271,6812,52
31757,312,11386,2014,7763,34949,3623
2606,2,66,3514,53,3390,13
11871,43,977,3066,772,11473,205
40513,0,0,1515,0,3932,0
32104,1,105,1996,69,3937,36
17479,385,30802,2730,20449,140472,10353
45725,4,124,350,103,3065,21
37402,8,152,1725,112,6043,40
33372,3,70,1943,65,5378,5
2767,29,400,3512,340,15428,60
28963,101,4094,2157,2900,39179,1194
44861,27,163,646,146,2624,17
4438,65,1725,3471,1308,11411,417
19041,3,313,2662,234,2986,79
2245,80,1431,3521,1128,10012,303
11609,4,289,3079,190,8623,99
10889,9,433,3116,367,11680,66
6634,17,785,3369,612,13239,173
45134,7,60,547,44,1933,16
6545,74,2004,3373,1538,45020,466
17312,6,153,2738,127,4424,26
37069,14,332,1746,258,4438,74
31439,2,375,2032,291,7046,84
3469,27,611,3499,507,6971,104
44702,81,1165,700,834,8241,331
34256,15,1300,1912,990,14215,310
19309,15,771,2650,611,9524,160
46258,6,43,147,41,2309,2
1099,5,208,3802,159,4716,49
35801,5,165,1822,132,4963,33
15335,56,4790,2836,3332,33958,1458
43021,21,323,1096,236,15850,87
23155,2,349,2444,285,11767,64
28363,0,141,2190,107,3315,34
41300,20,1455,1430,1052,24696,403
11435,11,162,3088,130,15538,32
38630,2,126,1640,91,5026,35
16529,5,150,2781,114,4124,36
11788,155,5642,3069,4395,68175,1247
25285,3,176,2346,136,6911,40
43408,5,194,978,138,4364,56
42927,143,6265,1122,4792,28730,1473
39217,3,81,1603,62,8389,19
18299,5,361,2693,304,6023,57
2270,19,610,3520,494,18637,116
16875,50,3234,2763,2436,21360,798
44111,0,40,802,27,1944,13
11445,16,1075,3087,831,14769,244
42928,263,3740,1121,3000,21299,740
25313,30,518,2344,418,10703,100
33380,0,171,1943,120,4868,51
19304,93,5807,2650,4112,55420,1695
9555,21,850,3184,637,13856,213
31486,6,364,2028,295,6503,69
8304,5,173,3262,132,7467,41
12855,10,191,3012,155,2015,36
19053,14,393,2662,311,5294,82
25876,320,5822,2319,4665,60125,1157
34624,15,450,1895,357,8088,93
16958,32,2036,2759,1589,25416,447
36545,215,6072,1778,4662,40602,1410
25723,2,245,2325,190,3335,55
12255,42,2696,3046,1947,31646,749
38845,78,2138,1627,1581,29478,557
23216,1,155,2440,126,7031,29
34467,1,16,1904,15,2475,1
31179,61,4426,2045,3424,23935,1002
36188,1,134,1795,101,4157,33
45742,9,76,346,71,2477,5
35340,35,2187,1856,1701,18496,486
14937,12,541,2857,386,5831,155
18679,8,508,2677,412,6040,96
42323,27,1286,1255,910,14690,376
39773,8,140,1572,112,5060,28
40759,13,274,1493,230,5144,44
2671,2,52,3514,42,2468,10
27280,16,588,2254,492,8080,96
46206,2,58,159,48,3625,10
43931,26,348,832,263,3151,85
8791,16,892,3230,661,6646,231
21979,12,622,2501,482,4114,140
15604,14,659,2823,476,5646,183
45348,15,163,485,122,5369,41
32952,35,1073,1960,814,8719,259
14950,33,1603,2857,1172,15544,431
7257,468,237706,3338,82154,131052,155552
5721,14,362,3408,274,5793,88
37940,8,209,1688,169,3916,40
32500,398,15488,1979,11473,105250,4015
13590,19,2945,2954,1791,13442,1154
29485,23,448,2129,316,5759,132
20762,192,11877,2574,6540,57317,5337
34765,0,167,1887,136,2741,31
32089,10,701,1997,523,9568,178
1936,3,122,3526,87,8327,35
32692,51,2184,1970,1715,14159,469
24850,1402,100451,2364,71518,401095,28933
36234,39,1218,1794,941,10685,277
37424,19,465,1724,358,9032,107
29615,5,63,2124,48,2060,15
37815,3,78,1697,65,7662,13
45802,90,985,325,839,9674,146
40487,17,388,1517,312,7359,76
44053,8,133,812,93,3346,40
24067,20,654,2400,519,8232,135
32564,1,133,1975,106,3736,27
39504,764,44160,1587,32120,175095,12040
3055,48,2592,3507,2055,50541,537
34700,10,355,1890,285,8701,70
45374,8,239,478,136,3950,103
30863,4,106,2059,63,3350,43
4699,42,1177,3461,858,7553,319
1442,10,453,3642,348,6710,105
3425,15,173,3500,135,5737,38
8097,35,940,3274,734,15265,206
39498,14,251,1587,207,8086,44
40807,17,798,1488,572,10468,226
20467,8,299,2590,239,5238,60
39736,128,1907,1574,1426,13625,481
31440,8,321,2032,251,9376,70
11535,15,349,3082,279,2909,70
2626,9,192,3514,153,4373,39
25382,3,187,2341,152,3259,35
30274,15,496,2091,416,13454,80
27817,9,367,2221,313,5144,54
19470,164,8325,2641,5793,44402,2532
18268,59,2830,2694,2078,16857,752
8474,8,144,3251,125,2724,19
11456,0,100,3087,77,7149,23
10851,8,102,3118,85,4654,17
13171,125,9535,2984,6852,65809,2683
21637,553,35565,2521,25206,185724,10359
18735,219,17515,2674,11792,118438,5723
35458,0,183,1849,148,9150,35
27776,1,50,2223,44,2546,6
8324,10,520,3261,371,27374,149
15932,100,3107,2811,2361,13481,746
18664,68,3238,2677,2274,32134,964
15557,20,362,2827,287,6575,75
6221,16,326,3387,253,3807,73
34881,14,906,1880,712,8289,194
26069,11,471,2310,403,22472,68
15655,1,64,2822,47,3349,17
46102,19,261,203,207,7614,54
35289,88,901,1858,713,8726,188
37478,8,231,1720,178,4201,53
26026,1,179,2312,149,6011,30
11363,3,98,3092,77,2008,21
25782,64,4449,2323,3309,20323,1140
44971,2,68,617,47,2250,21
22802,17,775,2461,496,5574,279
42694,43,680,1179,513,16365,167
30355,265,19976,2086,13423,67780,6553
31593,10,558,2023,447,15843,111
36385,0,64,1786,55,2373,9
45675,8,71,376,54,3306,17
18841,0,108,2670,87,3449,21
8561,27,1267,3245,909,13122,358
7260,15,431,3338,329,4482,102
2941,7,244,3509,197,10194,47
9291,17,667,3202,517,14033,150
40571,3,112,1509,74,1353,38
41889,30,364,1336,286,8711,78
16031,28,1304,2806,974,17542,330
7471,386,16634,3326,11936,157316,4698
11854,2,66,3067,56,1900,10
8478,178,4053,3250,3235,30414,818
45110,8,127,559,85,4007,42
29020,7,294,2154,239,3995,55
9735,3,117,3175,83,4271,34
4225,31,428,3479,346,5105,82
29929,0,47,2108,37,2727,10
6784,35,1631,3363,1247,24182,384
38092,27,1493,1679,1141,23937,352
40550,37,852,1512,676,14679,176
3134,95,3281,3505,2610,38101,671
10022,4,137,3162,101,3682,36
8285,63,1911,3263,1448,9735,463
28045,11,536,2208,453,9139,83
15098,12,536,2849,443,8236,93
5169,10,676,3437,540,10269,136
6778,104,7435,3363,5123,58693,2312
8051,29,571,3276,416,6209,155
21202,36,894,2545,678,8522,216
11069,2,79,3107,70,2243,9
5726,17,976,3408,747,8073,229
9145,4,163,3210,135,4812,28
17843,206,7714,2715,5684,26930,2030
39326,1,60,1596,42,2132,18
1971,25,417,3525,310,9358,107
15506,1,77,2829,64,1751,13
39050,59,957,1614,787,59292,170
20755,11,707,2575,556,5020,151
10716,5,96,3126,71,5128,25
32793,19,1152,1966,785,18570,367
9919,7,170,3167,146,3317,24
1831,10,138,3529,118,4667,20
16474,14,531,2784,371,10162,160
4893,79,2868,3452,2196,11914,672
36703,41,1778,1769,1221,24881,557
28916,98,6880,2160,5170,17090,1710
36641,1,34,1772,28,5654,6
2467,29,594,3517,503,67930,91
30177,3,48,2096,43,4878,5
38693,7,110,1636,90,2100,20
30452,10,511,2080,410,14251,101
24633,4,156,2373,134,1962,22
24628,6,212,2373,187,9577,25
42923,85,1225,1123,928,21441,297
40746,49,1764,1495,1404,28319,360
22703,3,0,2466,0,13346,0
28191,0,182,2200,130,1879,52
16114,3,75,2801,64,1412,11
24054,0,62,2401,52,2167,10
34376,28,701,1907,549,4129,152
26634,1439,38674,2285,29930,184056,8744
26785,237,7704,2277,5937,58545,1767
39707,10,255,1575,191,8614,64
19414,5,410,2644,302,21434,108
10348,13,221,3146,177,4114,44
1257,22,25977,3751,6032,22130,19945
38917,19,188,1623,146,3286,42
39572,4,73,1583,59,4867,14
42189,47,1053,1281,785,22370,268
6505,92,3264,3375,2468,31634,796
3342,57,1839,3502,1441,36764,398
11828,2,61,3068,44,2036,17
44828,265,3395,657,2766,34675,629
17153,16,1377,2746,1157,15525,220
43660,171,2155,895,1750,16924,405
12778,17,587,3017,477,24354,110
29183,3,179,2146,151,29612,28
16025,19,627,2806,525,7716,102
2135,24,399,3522,308,10351,91
24300,10,179,2389,145,2413,34
31246,51,1952,2042,1540,17869,412
32049,3,153,1999,111,4012,42
9889,47,1820,3168,1443,34080,377
24858,2,143,2364,120,4732,23
35265,444,17391,1859,13192,125759,4199
45155,0,120,542,71,3255,49
21155,0,120,2548,99,2254,21
29886,3,222,2110,127,5225,95
33242,14,3130,1948,2021,8835,1109
28855,2,149,2162,124,4794,25
16423,4,192,2786,158,7046,34
10210,62,3334,3152,2276,18318,1058
2623,99,3173,3514,2488,40521,685
11056,749,26764,3108,19324,145550,7440
14411,40,1038,2892,766,19812,272
37640,5,217,1710,174,4855,43
33379,5,107,1943,85,2405,22
9586,6,153,3182,109,6988,44
42889,80,1993,1132,1350,18644,643
4828,86,2739,3456,2036,24058,703
6506,9,215,3375,186,4990,29
28167,3,131,2201,112,1910,19
28223,3011,156571,2198,123008,578499,33563
4570,5,318,3466,244,7100,74
13327,56,4447,2975,3283,32963,1164
12101,1,146,3055,118,9126,28
2424,45,2221,3518,1790,18294,431
22503,177,15069,2475,12040,79575,3029
39335,16,184,1596,135,3221,49
7975,4,225,3287,188,9956,37
9810,7,231,3171,191,21881,40
35066,6,179,1870,133,3311,46
6058,2,60,3393,51,3359,9
37081,16,324,1745,242,7463,82
8618,6,197,3241,153,5392,44
17652,6,184,2721,142,5300,42
17498,43,2057,2729,1590,21814,467
25323,9,203,2344,156,4072,47
22488,1,70,2476,45,1857,25
39704,10,683,1575,491,11208,192
15891,105,4349,2812,3466,44918,883
7348,16,357,3332,278,4090,79
27235,555,61267,2256,43959,261407,17308
4746,19,422,3459,339,8210,83
18447,0,44,2687,38,3244,6
3145,5,172,3505,136,13561,36
43665,48,565,894,463,7233,102
7840,28,920,3301,742,20837,178
40272,2,46,1538,36,4022,10
9820,333,16312,3171,12877,67099,3435
1944,31,859,3526,668,27835,191
9706,3,62,3177,49,6734,13
7849,51,1349,3300,1114,18324,235
21358,5,101,2536,88,2288,13
38260,8,266,1667,225,4900,41
9490,11,330,3187,265,5443,65
6166,0,61,3389,52,1716,9
40663,9,385,1502,265,10661,120
42771,84,966,1161,689,6949,277
27353,23,375,2249,308,4790,67
17029,16,550,2754,384,16896,166
9516,3,102,3186,72,4399,30
28310,51,565,2193,471,4905,94
36113,15,677,1800,559,8483,118
37211,2,48,1737,40,3934,8
28712,111,2088,2170,1503,13594,585
25616,68,1769,2330,1279,14480,490
43366,11,104,992,83,2559,21
35655,8,221,1834,164,3233,57
8309,1,50,3262,42,3840,8
25887,2,216,2318,187,4677,29
8345,3,64,3259,46,4310,18
19879,391,23696,2621,16157,103282,7539
7037,631,25019,3349,17108,95685,7911
32333,3,257,1985,210,4123,47
20774,28,620,2573,497,9251,123
13512,18,640,2960,461,21753,179
26648,0,8639,2284,6697,66883,1942
11312,31,1102,3095,911,10494,191
40595,12,282,1508,230,6058,52
37135,58,2084,1742,1574,13090,510
14853,129,3576,2862,2636,23025,940
5512,11,260,3420,214,2325,46
25891,1,49,2318,47,2051,2
39135,175,3310,1609,2426,15090,884
4539,4241,169157,3467,113368,643432,55789
16599,26,1558,2779,1147,35726,411
8173,6,72,3271,53,4999,19
3199,20,492,3504,382,21623,110
28650,494,18140,2172,11056,92710,7084
35273,74,2072,1859,1663,27278,409
25469,14,255,2338,217,2355,38
29916,287,18145,2108,12690,67203,5455
24398,2,62,2385,46,1814,16
38830,9,474,1628,371,3912,103
10451,121,5129,3142,3246,26900,1883
23881,1,122,2409,100,4438,22
9970,58,4303,3164,3217,58115,1086
26582,11,663,2287,520,7503,143
9545,46,1251,3185,898,6650,353
29778,32,735,2115,568,21363,167
41577,19,479,1393,354,9419,125
3212,43,1478,3504,1138,44257,340
18817,8,367,2671,267,15040,100
26842,55,2240,2274,1711,27349,529
18274,10,666,2694,523,9646,143
14582,62,4586,2880,3354,25370,1232
34193,29,998,1915,774,8053,224
20132,1,283,2607,216,6360,67
18298,38,1201,2693,959,22118,242
42894,145,10072,1130,7403,36353,2669
45992,67,597,248,468,6370,129
5146,99,2334,3438,1824,24790,510
34026,52,1380,1919,1118,19859,262
40326,20,965,1534,723,8248,242
32157,20,902,1993,706,11241,196
37713,9,265,1705,223,7132,42
12506,3,60,3031,50,2341,10
3915,8,374,3489,300,5058,74
36715,182,7892,1768,5265,49305,2627
42128,5,108,1296,86,3526,22
17900,3,172,2713,97,1848,75
37526,6,467,1717,337,3203,130
2023,24,834,3524,685,7541,149
2643,9,97,3514,66,4373,31
3917,4,407,3489,338,9623,69
9952,777,31653,3165,22387,114486,9266
11413,18,795,3090,636,17218,159
8868,12,336,3226,270,19947,66
7531,793,42758,3322,29828,235904,12930
33439,2,102,1941,66,4204,36
26503,5,473,2290,315,4240,158
10860,2,122,3118,94,3529,28
7677,60,3102,3313,2430,25894,672
43385,16,362,985,227,8500,135
12376,27,903,3039,691,30158,212
10142,91,2034,3156,1415,23299,619
18604,20,542,2680,437,9611,105
40653,26,428,1504,340,6828,88
2901,4,231,3510,181,19022,50
34234,11,542,1914,429,5758,113
14766,42,2255,2868,1688,20967,567
32710,200,3866,1970,3153,35359,713
13866,6,360,2933,270,10867,90
3858,10,462,3491,315,11739,147
25668,11,488,2327,393,5683,95
33821,55,1792,1926,1120,31164,672
4356,10,378,3474,335,8279,43
16743,18,922,2770,720,6816,202
38147,66,1852,1674,1499,17925,353
39495,81,1264,1587,967,12638,297
13640,137,2668,2951,2104,18448,564
29129,82,3109,2148,2066,40845,1043
36209,0,108,1795,72,3419,36
30884,15,418,2059,302,3705,116
6387,12,394,3380,302,8292,92
15676,5,340,2821,281,3550,59
15684,4,171,2820,149,3675,22
14616,48,2607,2878,1920,9726,687
33143,12,583,1951,489,11909,94
18043,7,590,2704,446,14027,144
16965,12,641,2758,421,15812,220
31966,3,246,2004,207,6107,39
14902,19,815,2859,622,13649,193
41779,56,2020,1357,1535,22051,485
19982,15,345,2614,293,4755,52
20506,23,625,2588,472,5562,153
26781,27,716,2277,558,8347,158
21855,3,175,2510,142,3125,33
13395,202,19128,2970,11144,124045,7984
6572,8,119,3372,102,5967,17
6591,5,125,3371,108,3543,17
38369,34,4076,1659,3247,13900,829
27821,5,329,2220,266,3147,63
38236,27,531,1668,423,8037,108
34951,0,91,1876,81,3332,10
42276,2,102,1263,72,3581,30
45873,29,490,302,366,6804,124
42171,13,496,1285,377,9937,119
31264,38,1345,2041,1110,11531,235
40190,1366,59549,1545,37197,190501,22352
8214,45,2035,3268,1655,17506,380
35374,15,608,1855,466,11413,142
30664,8,213,2068,168,7283,45
19217,2,164,2655,140,3498,24
17059,22,1464,2752,1221,17713,243
20759,9,579,2574,417,8424,162
27328,6,329,2251,247,3730,82
11954,368,11520,3062,8488,110861,3032
44615,10,171,723,107,7542,64
35261,58,1253,1859,985,12219,268
17159,11,646,2746,450,6010,196
35259,54,1259,1859,1020,19107,239
1793,63,3053,3531,2477,33334,576
23319,14,351,2436,293,2743,58
7474,58,4964,3325,3873,71121,1091
34875,23,807,1880,650,8806,157
46016,7,137,236,80,3143,57
27719,21,1217,2227,1023,9465,194
44986,81,1317,613,1006,11642,311
16277,3,262,2794,189,9139,73
26047,177,6358,2311,4703,36426,1655
22122,28,1723,2493,1292,14953,431
37575,3,81,1713,69,2145,12
25274,20,692,2346,578,4776,114
36086,2,56,1801,44,2147,12
4845,39,1402,3455,1061,27846,341
34177,9,487,1915,382,6984,105
33184,11,179,1950,144,5972,35
25931,5,575,2316,465,13469,110
20051,66,1265,2611,926,8354,339
45148,2,46,543,26,2769,20
33225,1,25,1949,20,4547,5
36409,27,847,1785,614,10518,233
21783,2,368,2513,276,6563,92
35115,51,952,1868,717,7821,235
36595,65,1723,1775,1222,23245,501
8397,291,8354,3255,6468,43544,1886
11551,1,52,3081,44,2403,8
8813,5,118,3229,95,8371,23
21835,4,217,2511,168,13672,49
15701,574,44506,2819,29225,168763,15281
44299,14,116,773,87,3424,29
5429,117,3038,3423,2191,11699,847
3266,42,1124,3503,927,24257,197
17873,20,1130,2714,780,9047,350
44134,23,173,800,144,11289,29
45989,2,15,250,14,879,1
43142,4,108,1059,63,3201,45
3058,12,375,3507,282,5842,93
37763,6,753,1701,582,13131,171
45449,28,371,458,287,7582,84
5018,37,689,3446,511,11930,178
30037,38,764,2103,595,6140,169
5267,74,1971,3431,1515,45347,456
21146,15,691,2549,535,9083,156
4506,8,198,3468,165,4936,33
43995,2,61,824,49,3232,12
26101,111,6908,2309,4973,45551,1935
44332,5,80,767,52,4498,28
5822,26,605,3403,437,9324,168
3232,86,3399,3504,2632,31891,767
33154,11,321,1951,257,7292,64
24686,168,8064,2371,6392,46825,1672
38186,0,21,1672,13,3732,8
28115,3,316,2205,275,7444,41
27866,159,5220,2219,3749,28963,1471
26683,2,81,2282,69,6548,12
11158,24,162161,3102,43332,16727,118829
19843,94,5764,2622,4578,41585,1186
44808,2,97,665,61,3182,36
11372,8,394,3092,295,6627,99
29236,4,309,2143,244,4399,65
2822,38,1342,3511,957,32464,385
27366,9,276,2248,199,3439,77
27490,16,598,2240,451,4786,147
45547,24,323,428,227,2992,96
10519,6,250,3138,196,3646,54
37043,10,234,1747,200,6231,34
7904,3,65,3294,55,4149,10
24602,36,1176,2374,873,5299,303
2328,134,7535,3519,4527,31793,3008
22565,33,1035,2472,883,14745,152
26783,111,1646,2277,1243,12452,403
46165,2,35,173,32,876,3
45853,128,1401,307,977,6958,424
11161,15,372,3101,272,13727,100
5287,32,407,3430,343,5713,64
42969,43,555,1112,393,7557,162
42799,25,887,1150,665,11363,222
36761,0,31,1765,26,3723,5
8722,149,10154,3235,7518,83900,2636
2615,19,1016,3514,782,8393,234
41250,41,1389,1439,1099,13356,290
5441,37,1284,3423,1019,12000,265
23237,77,6504,2440,4638,36697,1866
7182,2,66,3341,55,3256,11
44914,2,26,635,19,2699,7
29973,17,1115,2106,867,17575,248
33987,21,628,1921,507,13544,121
42058,5,469,1309,363,16349,106
4979,120,3334,3448,2669,32348,665
8771,314,17767,3232,12512,109448,5255
46357,1,32,108,21,778,11
8223,29,612,3267,487,20348,125
40654,15,387,1504,293,3459,94
5988,4,55,3395,48,2797,7
31967,3,142,2004,119,4635,23
39216,3,186,1603,148,7093,38
29224,8,270,2144,204,6484,66
3496,6,234,3499,192,4653,42
19631,30,886,2635,665,10726,221
36947,15,325,1754,256,8583,69
9258,137,8750,3204,6625,40068,2125
40025,2,77,1554,60,3050,17
26753,0,23,2279,21,1249,2
32281,46,1003,1988,669,11682,334
32215,2,156,1991,132,5467,24
16151,1,129,2799,100,3885,29
2786,21,402,3512,286,5037,116
2486,19,487,3516,415,8696,72
16016,58,4186,2806,2893,24287,1293
41081,2,36,1462,22,2242,14
19282,85,3605,2651,2651,20196,954
23643,24,1037,2419,804,9424,233
25965,1,158,2314,134,6218,24
3674,51,2865,3495,2438,34237,427
15634,12,465,2822,368,6523,97
45849,5,79,309,55,1479,24
43758,132,1526,866,1252,13869,274
13809,1,74,2938,57,3848,17
45183,245,1651,534,1394,17026,257
23402,9,950,2431,721,12742,229
43922,7,98,833,76,3789,22
18444,23,1542,2687,1135,11094,407
45438,0,15,462,11,792,4
21588,0,54,2524,44,2324,10
20893,0,129,2564,104,8507,25
43113,15,295,1068,205,4233,90
13558,29,2034,2956,1600,32641,434
35464,377,12102,1849,9616,83670,2486
43459,77,1312,966,965,27607,347
21881,182,5408,2508,4242,23743,1166
29377,24,1105,2135,879,27378,226
29488,10,361,2129,314,9844,47
38348,2,173,1660,136,3829,37
1211,5,144,3766,115,5998,29
12443,276,16979,3035,12189,79280,4790
13889,46,1558,2930,1213,10527,345
42002,8,507,1318,345,5171,162
2522,75,1367,3516,999,11041,368
21340,11,633,2538,502,6839,131
18068,20,1259,2703,936,14783,323
32222,86,2190,1990,1618,15912,572
30324,4,282,2087,222,4566,60
34755,30,778,1888,638,11555,140
19532,4,228,2639,171,3482,57
33878,3,84,1924,70,2208,14
6543,51,2150,3373,1733,49111,417
36032,41,1046,1806,852,14972,194
20818,57,2887,2570,2301,19491,586
23809,10,430,2413,342,4055,88
7538,8,368,3321,266,11725,102
7673,6,169,3313,139,8361,30
16129,26,1076,2800,816,7744,260
36056,7,224,1803,191,7759,33
31222,18,421,2043,347,5417,74
26327,24,617,2299,510,7257,107
9888,6,238,3168,183,11619,55
15013,33,3152,2853,2244,16782,908
44901,29,363,637,281,3548,82
36791,2,68,1763,45,2688,23
18183,4,132,2698,96,3598,36
18983,4,366,2665,304,10043,62
33174,7,327,1950,287,3999,40
44729,122,3124,690,2286,38084,838
29361,127,4632,2136,3580,48665,1052
38585,780,31331,1643,21988,122183,9343
44964,190,1862,620,1574,18966,288
16795,99,25720,2766,18274,93637,7446
39991,2,96,1556,71,3890,25
12054,15,501,3058,400,7817,101
9405,73,2981,3193,2393,22448,588
29287,19,633,2140,506,18153,127
23985,5,318,2403,270,11366,48
34545,8,386,1899,293,8204,93
3182,20,529,3504,344,13836,185
36906,20,423,1756,309,6545,114
10231,9,350,3152,268,6407,82
42478,5,128,1222,104,3021,24
35826,2,76,1821,63,4326,13
29205,35,444,2144,345,6326,99
24310,65,3843,2389,2997,19571,846
3873,4,176,3490,156,4838,20
8150,16,756,3273,624,11777,132
41078,2,246,1463,196,12688,50
22185,588,30223,2491,21695,158761,8528
12504,76,4812,3032,3280,42072,1532
6887,74,1100,3358,830,8429,270
46185,11,108,165,92,1769,16
32527,30,683,1978,512,6777,171
38995,16,875,1618,612,7432,263
14199,208,10115,2909,7186,88286,2929
33621,30,592,1934,499,10859,93
17257,15,1211,2740,847,13207,364
3854,25,697,3491,534,35578,163
32020,8,403,2001,307,11729,96
29629,10,419,2123,355,10720,64
33019,13,285,1956,221,5321,64
5585,1,17,3416,15,3137,2
10778,17,233,3122,203,4447,30
18602,76,7110,2680,5273,50156,1837
19926,42,3475,2618,2496,39072,979
19293,31,2745,2651,1991,36491,754
22864,0,49,2458,36,2282,13
4725,6,134,3460,100,5057,34
18170,6,439,2699,337,7609,102
5027,64,1363,3445,1031,28804,332
31416,16,457,2033,364,13186,93
41768,2,89,1359,78,2195,11
37587,300,9817,1713,7743,79259,2074
28786,1,242,2165,177,3209,65
28354,39,1562,2191,1249,10701,313
43064,20,209,1083,163,3518,46
37720,5,179,1705,149,8385,30
43191,11,302,1047,226,8284,76
8851,1,71,3227,59,4875,12
36431,58,1266,1784,947,9572,319
11489,12,587,3085,494,14220,93
31600,142,11290,2023,8093,87387,3197
27284,0,60,2253,53,7315,7
42598,32,1037,1201,793,15114,244
36679,95,3248,1770,2606,22222,642
17716,49,3673,2720,2706,43274,967
23832,2,163,2411,128,3934,35
12652,10,504,3024,417,11273,87
14048,83,3041,2917,2453,52517,588
35048,32,931,1871,738,10018,193
2537,201,11234,3516,8395,54138,2839
45537,2,51,434,31,2598,20
37335,10,545,1729,381,18710,164
29376,6,397,2135,338,5070,59
14172,23,1561,2911,1170,18563,391
15116,130,3496,2847,2598,15314,898
43554,4,68,935,65,4829,3
39420,112,1500,1591,1194,16137,306
34792,519,9602,1885,6812,48809,2790
18709,74,2169,2676,1692,20597,477
40621,51,1236,1506,966,17492,270
2343,9,219,3519,137,7576,82
12154,1,93,3052,73,7490,20
13669,41,841,2949,643,8246,198
40635,19,344,1505,273,5779,71
29575,8,644,2125,522,7784,122
33637,60,1237,1933,975,9204,262
44365,18,543,762,380,15104,163
41703,10,151,1371,107,2806,44
27551,1,23,2236,19,1025,4
3516,58,3043,3498,2436,42321,607
20128,4,237,2607,176,4549,61
9650,103,8305,3179,6069,85372,2236
12414,1,82,3036,69,2666,13
29710,68,3203,2119,2321,18307,882
20708,43,1998,2577,1559,15210,439
13884,460,32316,2931,22895,160714,9421
15333,7,220,2836,168,4359,52
6658,6,52,3369,41,5219,11
22174,17,386,2491,309,6185,77
33786,7,513,1927,395,7715,118
29014,28,559,2154,438,6984,121
28752,13,208,2167,175,5295,33
32563,4,273,1975,219,10332,54
9655,1945,170124,3178,105257,840799,64867
35337,1,34,1856,30,2406,4
27687,38,1229,2229,1004,7675,225
5224,19,430,3434,352,17196,78
2932,1,82,3509,64,4470,18
5876,15,578,3401,420,5973,158
30143,1,67,2098,57,4908,10
30735,20,500,2065,422,7224,78
44951,403,4935,623,4252,26934,683
13408,12,632,2969,442,13916,190
39663,7,103,1577,77,5629,26
42958,5,129,1114,97,4607,32
11537,10,171,3082,142,5003,29
11108,398,24062,3105,17515,227544,6547
39676,3,31,1577,29,6775,2
10090,197,11675,3158,8939,61769,2736
39472,1,42,1588,37,5084,5
7749,18,798,3308,597,20740,201
8506,16,225,3249,170,6369,55
26331,1,97,2298,79,8325,18
5931,12,434,3398,337,9447,97
14065,642,42544,2916,31217,224833,11327
41710,13,437,1370,331,12769,106
37751,14,699,1702,544,11354,155
43716,55,643,877,568,11990,75
29077,8,391,2150,277,3818,114
16259,113,3794,2794,2776,21675,1018
15809,23,1283,2815,964,18003,319
30800,9,813,2062,624,20972,189
27668,3,58,2230,47,2791,11
11919,8,609,3064,505,21830,104
8698,495,15123,3236,9692,96092,5431
44730,44,500,690,419,10383,81
8540,8,291,3246,232,8946,59
4902,99,2603,3451,1980,43071,623
31777,4,198,2013,141,7817,57
12196,48,2287,3050,1699,23017,588
10466,126,4124,3140,3284,31345,840
39409,14,274,1592,223,5434,51
4823,5,108,3456,90,3020,18
3089,0,30,3506,28,2673,2
10628,18,282,3131,209,3731,73
14001,20,597,2921,444,8671,153
19996,1,79,2614,65,3182,14
8900,3,174,3225,136,6561,38
30154,18,416,2098,323,6567,93
10198,30,2620,3153,1817,28353,803
20637,409,27431,2581,20525,127586,6906
10059,12,1728,3159,1294,36532,434
14384,32,1220,2894,930,16816,290
40023,18,346,1554,231,6650,115
22963,4,165,2452,135,4736,30
44572,2,67,730,49,2954,18
22052,16,435,2498,346,7324,89
20213,49,9913,2602,7370,20706,2543
35522,25,667,1844,549,10739,118
5996,2,424,3395,318,18930,106
46190,9,87,164,74,2449,13
16916,5,215,2761,174,4587,41
33542,36,1043,1936,778,7994,265
41101,9,433,1460,345,5778,88
37681,4,111,1708,82,5348,29
34130,128,1952,1916,1460,14673,492
45262,11,249,509,218,6677,31
29035,102,4737,2153,3525,25672,1212
21994,6,224,2500,154,4255,70
41153,32,560,1454,386,12394,174
4382,49,1033,3473,766,7069,267
32673,19,779,1971,600,11949,179
7343,1124,73623,3332,50701,456211,22922
21916,6,458,2506,352,10434,106
14002,13,567,2921,462,10450,105
4825,16,341,3456,229,8544,112
2012,23,798,3524,514,9712,284
32688,13,600,1971,426,14140,174
17041,6,146,2753,114,5614,32
6324,48,2320,3383,1797,15975,523
3795,213,6927,3493,5507,174704,1420
2597,17,308,3515,241,4412,67
29512,44,1138,2128,918,15358,220
5223,22,860,3434,687,9321,173
9104,0,94,3213,78,3052,16
22355,10,290,2483,230,4010,60
13223,32,972,2982,750,11799,222
12853,7,955,3012,776,26572,179
4764,107,2195,3458,1632,43977,563
34110,96,1280,1917,1021,10937,259
19665,63,2603,2633,1993,12488,610
41321,34,1235,1428,871,23995,364
33988,2,75,1921,63,3191,12
7599,46,1362,3317,1070,11779,292
37238,3,270,1735,211,18935,59
26776,2,36,2278,35,3437,1
26525,0,115,2289,93,3482,22
32308,44,2296,1987,1556,19675,740
11059,66,4398,3108,3443,59697,955
15381,30,1144,2835,838,8205,306
15971,8,216,2809,163,13580,53
13508,5,279,2960,230,4789,49
34587,23,552,1897,389,6950,163
22697,56,3750,2466,2481,34579,1269
15146,64,1492,2845,1160,9360,332
6996,372,20159,3352,14278,112070,5881
30919,75,1686,2058,1397,24164,289
19615,2,37,2635,32,3347,5
16048,10,381,2804,288,6255,93
19939,165,20829,2618,14023,82650,6806
5701,2129,90063,3409,62121,334183,27942
15744,16,502,2817,385,10276,117
6403,294,16529,3379,12123,87080,4406
25117,271,12067,2352,9249,106711,2818
28581,44,1854,2176,1450,33749,404
12392,21,985,3038,820,12269,165
2520,302,13582,3516,9929,82509,3653
20689,9,422,2578,342,4105,80
3206,29,1821,3504,1458,9275,363
4686,16,455,3462,373,10978,82
21575,11,655,2524,499,7306,156
2029,28,1156,3524,897,21181,259
21145,8,337,2549,271,7544,66
25186,0,12,2349,10,1274,2
43648,122,2666,899,1986,21177,680
19499,19,472,2640,350,6356,122
42903,4,63,1129,55,7304,8
46062,6,45,215,37,1277,8
5255,30,742,3432,551,5770,191
41140,20,460,1455,331,11672,129
10504,3,410,3139,315,6104,95
12815,28,604,3015,509,25325,95
24184,5,87,2395,69,3438,18
5166,35,488,3437,373,4358,115
42997,59,1486,1102,1028,8940,458
15663,27,690,2821,542,4666,148
28010,37,1865,2210,1461,11585,404
11137,10,235,3103,197,5865,38
15178,2,100,2844,83,11937,17
19057,12,557,2662,451,17734,106
9456,50,1879,3190,1361,15298,518
21629,34,1190,2521,981,12110,209
36177,96,4439,1796,3510,41670,929
32873,2,107,1962,71,2902,36
40949,6,104,1476,87,5479,17
34253,3,300,1912,219,13136,81
7597,70,1401,3317,1118,23398,283
35202,86,4673,1864,3520,25956,1153
31181,4,117,2045,88,2938,29
23992,115,6776,2403,5077,36259,1699
6916,5,637,3357,466,16432,171
29545,12,1047,2127,780,37545,267
13880,149,7575,2931,5364,66264,2211
3710,59,2404,3494,1742,16771,662
40964,329,12814,1475,8487,93229,4327
42484,72,897,1222,708,41533,189
39797,0,26,1570,22,2632,4
10930,4,173,3114,128,7806,45
21495,39,1780,2529,1359,16969,421
8094,3,29,3275,23,1952,6
16934,12,943,2760,729,15123,214
37414,2,26,1725,19,2437,7
22825,4,67,2460,55,2114,12
37090,0,36,1744,28,2745,8
9392,37,468,3194,374,4774,94
21294,0,244,2540,183,6823,61
22979,11,454,2451,360,4778,94
27428,40,1470,2245,1202,13002,268
2853,41,2590,3511,2103,34976,487
32392,3,68,1983,56,1837,12
46241,27,211,151,186,3863,25
39979,130,7386,1557,5011,53306,2375
16297,37,3802,2793,2735,18252,1067
41691,0,0,1374,0,2250,0
17486,29,2579,2729,1933,26248,646
39538,64,4643,1585,3564,16999,1079
21542,59,1465,2526,1163,15959,302
21643,98,5354,2521,3935,31507,1419
14564,11,320,2881,272,5382,48
22894,167,5552,2456,4205,26626,1347
26005,2,319,2313,242,7638,77
2487,143,4068,3516,3299,51709,769
43666,72,1273,894,1044,11622,229
37598,5,201,1712,145,4604,56
9433,19,1325,3192,838,25956,487
25326,52,1363,2344,1045,17025,318
43495,114,1235,956,925,13019,310
9119,67,2650,3212,2100,27836,550
34333,4,105,1909,88,8129,17
13871,19,1382,2933,1052,17439,330
11075,19,993,3107,774,14638,219
15060,36,1383,2850,1014,10585,369
46001,13,132,246,98,1603,34
22364,50,3179,2483,2303,29569,876
45870,29,263,305,198,2256,65
31949,1,139,2005,113,5754,26
8106,29,426,3274,337,4305,89
2631,145,3754,3514,3053,21303,701
35703,1,50,1830,42,6326,8
11172,63,6115,3101,4518,92937,1597
24475,216,10596,2381,7936,69870,2660
42604,19,490,1199,366,6859,124
4599,2,39,3465,33,1522,6
4537,7,115,3467,64,1911,51
6396,95,2773,3379,2114,27606,659
23704,0,49,2417,38,3471,11
8167,9,266,3271,204,5556,62
27341,20,1225,2250,948,23068,277
7892,10,298,3296,235,13159,63
25642,213,20960,2329,16822,67876,4138
45817,47,1068,320,885,8401,183
36170,2,382,1796,304,6585,78
30400,12,1139,2083,894,25045,245
9720,30,926,3176,725,26683,201
35915,0,15,1814,12,1959,3
45657,5,140,385,79,5087,61
34667,11,585,1892,472,12611,113
12900,17,270,3010,225,11750,45
11288,6,297,3095,238,18785,59
31028,36,1293,2052,943,24729,350
9948,123,4852,3165,3605,32116,1247
43442,131,1515,971,1183,8585,332
3001,5,110,3508,88,8027,22
40235,14,333,1541,276,5288,57
34959,10,436,1876,298,7171,138
45378,224,2637,478,2208,21382,429
16078,74,2542,2803,1976,53790,566
12018,92,2780,3059,2242,43097,538
9102,6,111,3213,99,3355,12
32738,89,3802,1969,2833,25118,969
43776,14,238,857,168,5372,70
17929,120,5612,2711,4437,56566,1175
20929,87,4694,2562,3170,35948,1524
21422,7,918,2534,678,16014,240
2466,138,5588,3517,2740,33911,2848
2701,11,302,3513,251,8823,51
2544,14,201,3516,171,5750,30
45791,154,2456,329,2093,22871,363
15566,94,8010,2825,5971,41911,2039
15937,8,514,2811,399,6736,115
20772,25,2898,2573,2309,30457,589
43937,1,47,831,29,1179,18
26728,6,124,2280,106,8512,18
36795,49,1161,1763,886,13072,275
22125,6,242,2493,186,12294,56
25581,0,79,2332,74,2246,5
6707,112,2587,3367,1767,28639,820
2483,23,724,3516,582,8666,142
25175,6,194,2350,162,5837,32
36917,34,456,1755,349,7941,107
30988,32,1454,2055,1159,16308,295
36309,55,1295,1789,923,14592,372
1893,31,1177,3527,912,24448,265
22509,52,2316,2475,1753,23402,563
5722,116,2404,3408,1774,43924,630
43282,34,883,1019,604,15338,279
45423,34,443,466,377,10710,66
16606,5,175,2778,136,4191,39
21140,77,1564,2550,1256,11021,308
2187,13,280,3522,241,7518,39
45398,25,370,471,202,4352,168
9391,8,236,3194,200,11247,36
18776,17,434,2672,347,6688,87
39923,81,2242,1561,1571,20499,671
27993,5,121,2211,105,3104,16
8365,0,21,3258,18,1127,3
31911,3,120,2007,89,2448,31
4201,29,1428,3479,1133,16634,295
9916,121,4376,3167,3252,26857,1124
13329,503,127568,2974,95748,163000,31820
35263,143,3291,1859,2297,17178,994
14806,42,1530,2864,1099,21882,431
18883,8,287,2668,226,2725,61
19350,2,370,2648,168,5374,202
21687,357,11311,2518,8291,60944,3020
30933,80,3016,2057,2138,32503,878
2313,37,1041,3520,858,36497,183
21313,38,1575,2539,1164,29376,411
18712,222,13343,2675,10475,79686,2868
43956,215,4524,830,3949,36395,575
17147,1013,42496,2747,29232,119090,13264
41910,5,389,1333,296,11014,93
16265,8,1483,2794,1189,23002,294
30094,273,30305,2100,18970,140918,11335
22991,6,296,2451,211,3770,85
33760,17,317,1928,272,9370,45
45351,11,90,485,66,2091,24
41808,2,122,1350,90,4695,32
45379,25,505,478,368,8495,137
4212,28,593,3479,476,8935,117
20058,112,12713,2611,8739,39191,3974
23580,27,754,2423,574,5915,180
19755,58,3674,2627,2839,29032,835
19779,10,406,2626,306,4099,100
35505,12,599,1846,461,11850,138
22614,17,950,2470,765,20466,185
32052,4,175,1999,109,4770,66
10675,2,138,3128,104,3075,34
20526,149,3699,2586,2770,20470,929
39265,22,733,1599,556,9895,177
18581,67,2261,2682,1702,15814,559
35752,24,590,1827,489,22130,101
22094,37,942,2494,739,5759,203
28283,14,591,2195,461,5375,130
15413,35,1175,2834,954,5692,221
8119,6,268,3274,212,7543,56
14083,3,101,2915,76,4260,25
2799,1015,57863,3511,38961,215898,18902
17193,10,504,2744,376,8006,128
19683,30,1573,2632,1231,12920,342
43331,203,2789,1005,2068,14799,721
16657,213,15510,2775,10098,136971,5412
34659,71,1750,1893,1410,19449,340
32752,0,0,1968,0,19123,0
12436,15,543,3035,433,7937,110
16255,105,5127,2795,3821,45761,1306
29325,6,80,2137,66,2361,14
1919,32,1580,3527,1087,17038,493
43339,95,2311,1002,1806,24651,505
9485,4,82,3188,66,5104,16
26643,461,11895,2284,9499,51396,2396
6991,9,461,3352,351,8286,110
29242,19,495,2143,348,4909,147
41331,38,1200,1426,907,19622,293
20955,4,204,2561,169,6698,35
43376,8,248,988,153,3519,95
14779,6,138,2867,106,2832,32
22105,18,932,2494,666,6202,266
3857,65,215518,3491,80678,17495,134840
34421,0,118,1905,91,5986,27
6419,52,1565,3378,1267,18583,298
16893,4,152,2762,124,2565,28
19990,13,469,2614,348,7240,121
42517,0,0,1215,0,2500,0
43393,2,31,983,24,4439,7
15617,879,138891,2823,91898,422984,46993
7171,3,165,3341,134,4830,31
23634,19,533,2420,411,6016,122
36838,2,105,1759,90,3798,15
8335,19,284,3260,216,6724,68
14367,22,625,2895,494,9407,131
43387,33,1162,985,742,19400,420
5511,10,259,3420,143,5495,116
10477,6,87,3140,69,1711,18
27830,2,86,2220,69,3257,17
7984,7,171,3285,117,2809,54
33092,49,1520,1953,1224,35532,296
1478,0,69,3617,57,3121,12
37306,6,226,1731,204,6581,22
34789,5,190,1885,152,4988,38
36592,625,23769,1775,18047,174781,5722
41998,14,480,1319,340,16106,140
21470,19,708,2531,557,6488,151
34356,0,81,1908,58,3481,23
35396,81,2788,1853,2154,37451,634
23359,26,2420,2434,1830,14313,590
34576,99,4154,1898,3020,24952,1134
41343,10,303,1425,253,8860,50
28281,74,2470,2195,1807,18270,663
3577,86,3655,3497,2932,45959,723
43655,51,669,897,591,8902,78
2541,108,8977,3516,6744,36288,2233
25235,26,1205,2347,985,12042,220
38483,17,622,1651,461,12434,161
16458,3,111,2785,93,6019,18
4369,31,1029,3473,781,22228,248
40910,14,550,1479,434,12706,116
17217,9,1209,2743,872,15031,337
33054,430,35763,1955,27181,144324,8582
4973,11,718,3448,580,15805,138
15087,1,130,2849,102,4129,28
16460,65,1922,2784,1491,13554,431
7636,196,5782,3315,4199,86661,1583
32743,121,1910,1969,1403,10330,507
32677,71,3208,1971,2498,17622,710
38843,26,762,1627,538,7084,224
34409,0,17,1905,15,1954,2
3742,91,4128,3494,3075,32765,1053
26561,1,66,2287,57,2302,9
41645,86,916,1380,712,11074,204
9346,3,94,3197,79,4120,15
20163,250,20804,2605,14097,94130,6707
31151,56,1083,2047,910,20406,173
45624,39,438,401,323,4924,115
39319,27,605,1596,416,8107,189
45218,39,781,523,509,6823,272
19442,3,225,2643,155,3770,70
11070,5,102,3107,78,2939,24
44017,4,90,819,58,2835,32
23167,2,109,2443,93,5403,16
2115,84,1798,3523,1268,10107,530
32620,2,66,1973,54,2881,12
11040,3,128,3109,109,3444,19
43697,4,95,882,51,3010,44
29144,33,1887,2148,1439,20652,448
28512,34,1947,2181,1508,15103,439
14104,11,466,2914,377,7576,89
37842,1160,31112,1695,24684,155442,6428
34508,67,1748,1901,1301,16307,447
17220,10,1771,2743,1286,15976,485
27296,8,585,2252,480,8256,105
2246,1025,54092,3521,38788,209229,15304
12596,27,1053,3028,857,7983,196
43738,32,381,871,333,12608,48
11282,6,216,3095,174,6134,42
13716,3,734,2945,503,15091,231
22249,38,844,2487,652,6564,192
46000,131,1414,247,1171,14623,243
30194,9,370,2095,277,11433,93
33124,16,715,1952,589,9946,126
33522,3,219,1937,177,6094,42
28677,72,5479,2171,4580,21718,899
38204,1477,102889,1671,72813,285664,30076
35313,41,478,1857,379,4175,99
12487,49,1645,3033,1327,17188,318
25347,25,713,2343,557,6658,156
3253,25,670,3503,555,3593,115
9040,19,516,3217,429,6855,87
30721,10,720,2065,564,8845,156
30100,16,290,2100,232,7570,58
39849,27,419,1567,342,13149,77
4578,44,1739,3465,1310,12620,429
10849,19,1535,3119,1217,9871,318
21944,119,4046,2504,3103,16391,943
7893,8,34,3295,27,2786,7
39776,55,1067,1572,874,21192,193
6711,96,2077,3366,1376,22868,701
42522,2,47,1214,34,1771,13
6300,28,1212,3384,899,29189,313
5649,12,337,3412,283,18037,54
24555,10,328,2377,265,7636,63
34718,60,1329,1890,1086,12554,243
10544,2603,183129,3136,116679,1083865,66450
4399,40,547,3472,425,16202,122
35800,48,758,1822,560,8226,198
44152,3,61,797,42,2940,19
34383,109,3940,1907,3001,45778,939
5572,107,3166,3417,2495,39758,671
4070,26,456,3484,354,7699,102
5206,56,2017,3435,1650,32051,367
10403,628,32999,3144,23747,90160,9252
5333,49,2150,3428,1566,32194,584
39916,13,727,1561,521,11197,206
9927,12,871,3166,674,13700,197
39448,22,873,1590,630,12777,243
28599,3,149,2175,124,3139,25
19686,79,2335,2632,1715,21720,620
19647,6,201,2633,175,3992,26
29620,0,76,2123,59,3578,17
13127,18,695,2995,515,10771,180
4645,64,1355,3463,1013,27096,342
19861,83,4552,2621,3441,21982,1111
17155,9,196,2746,157,10482,39
19133,574,55231,2659,40889,277358,14342
41384,0,46,1419,37,1560,9
20541,1,147,2586,124,4080,23
40669,7,204,1502,147,5728,57
26629,10,403,2285,319,5855,84
6649,2,52,3369,44,4881,8
3141,10,362,3505,297,4418,65
9664,10,449,3178,300,7507,149
43728,244,3102,873,2460,14396,642
18972,11,421,2665,308,4357,113
6249,313,22204,3386,15760,101121,6444
32914,55,1865,1961,1456,21710,409
17079,6,540,2751,446,6472,94
30776,23,466,2063,355,4364,111
11979,25,707,3061,561,4040,146
29202,1,99,2145,88,2740,11
45587,0,58,418,50,3529,8
45824,88,872,317,717,9881,155
14346,315,7014,2897,5548,37791,1466
19175,25,1906,2657,1521,18786,385
36090,3,217,1801,152,5450,65
38898,30,722,1623,570,7796,152
42774,84,1401,1160,1100,11864,301
27947,73,1597,2213,1247,13137,350
43290,20,307,1017,249,12061,58
29154,82,2152,2147,1657,11449,495
42760,106,2541,1163,2021,21928,520
27185,25,332,2259,265,4013,67
35287,18,491,1858,386,4279,105
37004,254,17377,1750,13789,71366,3588
32928,2,440,1960,345,7652,95
36538,3,50,1778,42,1335,8
5301,14,242,3430,195,7261,47
8571,7,945,3244,714,8601,231
26709,128,6561,2281,4836,39459,1725
8776,5,136,3232,112,3488,24
30817,6,81,2061,74,3495,7
30446,37,1754,2080,1222,18787,532
38491,8,218,1651,179,4986,39
17946,13,580,2710,438,5144,142
38102,16,581,1678,443,9662,138
8956,2,61,3221,42,2522,19
41521,2,37,1400,30,1465,7
24980,0,2115,2358,1481,21639,634
11644,25,3199,3077,2255,25260,944
28071,8,562,2206,437,7407,125
4270,3,201,3477,135,2846,66
23852,83,2358,2410,1784,27861,574
19011,29,1292,2664,940,16388,352
8381,9,390,3256,321,16658,69
42826,87,2103,1148,1432,16809,671
6469,11,354,3376,294,7934,60
37503,210,6388,1718,5143,60253,1245
18254,1,105,2695,88,2177,17
29042,25,2643,2153,1775,14946,868
20919,4,171,2563,143,5165,28
18123,7,197,2701,166,2774,31
18597,3,167,2681,138,11976,29
4962,13,550,3449,402,16820,148
23624,11,266,2421,218,4584,48
29978,30,981,2106,751,12731,230
10174,15,664,3154,491,12905,173
32868,0,154,1963,128,7827,26
34481,0,735,1903,561,14024,174
43486,2,65,959,49,2165,16
5168,0,70,3437,58,4060,12
24707,56,1833,2369,1394,20192,439
35084,16,299,1870,252,4929,47
42411,302,5036,1238,3808,49330,1228
2069,1038,48473,3523,34202,189730,14271
36097,19,423,1801,311,4801,112
3955,194,6271,3488,5036,31970,1235
32411,16,246,1982,176,5381,70
20698,331,15170,2577,9764,35223,5406
45076,12,154,579,115,4086,39
43247,7,157,1029,149,10614,8
1194,18,852,3769,698,16524,154
13448,85,5222,2964,3899,18308,1323
42875,29,479,1136,362,5002,117
18854,3,311,2669,195,1979,116
38337,8,170,1661,137,5083,33
12663,51,4085,3023,2919,42865,1166
16121,161,7484,2800,5537,60917,1947
41123,10,163,1457,129,4405,34
20615,5,115,2582,100,6509,15
37690,27,256,1707,211,3983,45
20560,2,570,2584,433,7602,137
16866,32,1659,2763,1254,5889,405
31346,25,904,2037,731,12208,173
14964,4,123,2856,109,5208,14
24848,123,8974,2364,6235,52249,2739
23302,3,277,2436,219,3358,58
35536,1,63,1843,49,3529,14
6504,0,36,3375,30,2763,6
15841,281,9392,2814,6199,68165,3193
8619,18,530,3241,434,23346,96
34743,91,2278,1888,1729,24816,549
14420,32,1054,2892,824,13005,230
25223,760,50442,2348,33829,231942,16613
7991,24,596,3284,443,8516,153
1870,13,217,3528,189,8395,28
27541,16,656,2237,533,20539,123
18312,10,271,2693,226,6167,45
44985,224,1910,613,1274,17903,636
18143,2,61,2700,55,3418,6
9336,29,1153,3198,811,6140,342
19292,1,106,2651,64,3025,42
5408,1,20,3424,16,3979,4
43717,38,243,877,193,2963,50
31058,6,154,2051,120,6825,34
30597,1,195,2072,162,5547,33
43244,38,676,1029,560,15141,116
17355,79,46607,2735,35009,52592,11598
39150,0,36,1607,25,1790,11
4436,59,1844,3471,1339,16921,505
30587,4,239,2073,193,4958,46
25926,58,3229,2316,2562,32719,667
12992,4,272,3003,191,5336,81
11783,220,11979,3069,8995,148194,2984
32259,53,3809,1989,2890,27820,919
26413,26,1279,2294,1082,8472,197
39580,4,171,1582,134,3788,37
18071,164,10585,2703,7528,52381,3057
25115,17,604,2352,462,13312,142
32880,2,254,1962,193,4495,61
38343,12,421,1660,338,9225,83
30998,4,199,2054,151,7953,48
35700,0,16,1830,14,3092,2
14813,2,330,2864,236,11605,94
39137,11,375,1609,232,3914,143
27939,2,81,2214,73,7758,8
27497,6,270,2240,215,5770,55
39356,3,208,1595,154,3776,54
42226,8,246,1273,196,4994,50
36027,9,326,1806,263,7550,63
21700,11,640,2517,493,8766,147
38350,124,5983,1660,4471,23216,1512
10670,235,9859,3128,6198,47158,3661
36073,1,43,1802,35,4659,8
17320,3,72,2738,58,6991,14
38364,7,150,1659,119,3445,31
25312,66,2188,2344,1658,17453,530
38856,88,2044,1626,1447,10226,597
10953,4,79,3113,66,9828,13
31086,5,210,2050,168,3560,42
40637,12,524,1505,364,4675,160
36576,26,256,1776,201,3752,55
2021,2,33,3524,28,4676,5
12814,3,344,3015,287,22406,57
11741,82,2067,3072,1658,32039,409
14720,591,24783,2871,19433,84497,5350
7829,31,928,3302,752,11588,176
41135,10,111,1456,88,4546,23
11981,55,2473,3061,1943,58287,530
13976,10,506,2922,391,4067,115
8726,1,62,3234,50,1538,12
11610,39,2125,3079,1577,26355,548
3413,7,154,3500,109,6178,45
32578,6,302,1975,244,4859,58
29178,15,337,2146,262,4732,75
32306,2,219,1987,184,2490,35
44711,2,132,695,83,4039,49
32192,2,164,1992,133,9892,31
43077,30,1067,1078,761,15579,306
15294,662,33170,2838,21494,116563,11676
23862,43,1977,2410,1636,22490,341
38342,5,168,1660,138,3147,30
28303,40,1700,2194,1204,17226,496
21577,27,1557,2524,1168,14940,389
42493,361,6582,1220,4905,40223,1677
12776,5,879,3017,652,14869,227
34542,1,52,1899,45,2145,7
40836,1,49,1485,36,3896,13
5426,7,326,3423,252,7449,74
11129,47,3707,3104,2896,25621,811
33881,31,999,1924,722,8596,277
25460,0,155,2338,118,2993,37
41461,51,583,1407,444,7239,139
39179,11,264,1606,225,4973,39
30993,19,514,2055,451,7581,63
20716,66,2457,2576,1822,19890,635
15625,22,1245,2823,880,17748,365
43092,51,1856,1073,1251,24382,605
10003,23,497,3163,415,6719,82
25989,76,2422,2313,1868,13754,554
12387,0,30,3039,23,1255,7
32629,2,84,1973,64,2100,20
3243,2,118,3503,100,4102,18
3110,36,1000,3506,762,13044,238
45152,36,329,543,226,4614,103
25971,107,7322,2314,5592,43691,1730
31261,55,2407,2041,1912,38964,495
23578,62,8585,2423,6264,68754,2321
8903,9,567,3225,372,6477,195
28086,2,35,2206,30,3431,5
9351,7,882,3196,651,18839,231
27372,83,3030,2248,2351,32511,679
23761,33,1908,2415,1462,34072,446
17581,1,116,2724,99,10223,17
39593,19,517,1581,391,8751,126
19546,48,1298,2639,932,7330,366
28305,58,1289,2193,1009,6616,280
32509,8,411,1978,331,4118,80
12954,5,217,3007,171,5594,46
41405,6,149,1415,113,7754,36
43105,15,231,1070,164,2734,67
4371,6,186,3473,151,10834,35
18142,1,31,2700,27,4272,4
9001,15,398,3219,319,4489,79
44998,63,823,609,703,13143,120
20641,130,3555,2581,2667,22525,888
8730,0,20,3234,17,1381,3
17245,4,210,2741,161,8276,49
29404,5,484,2134,407,6491,77
18777,151,8111,2672,5693,25749,2418
23501,1,145,2427,117,9427,28
8471,9,318,3251,259,5791,59
16921,4,321,2760,228,3557,93
23558,305,15285,2424,11111,80987,4174
25539,0,73,2335,61,2206,12
5543,14,640,3418,518,15040,122
43139,50,835,1060,601,9989,234
26320,1,89,2299,66,4300,23
19452,144,8890,2642,6487,53274,2403
23380,13,449,2432,367,9478,82
7079,286,12378,3347,8934,66180,3444
43550,78,1342,935,1096,24049,246
45428,8,157,464,110,3908,47
33402,0,14,1942,12,1335,2
27321,1,75,2251,60,2222,15
45197,335,4408,529,3811,33825,597
17322,23,534,2738,433,4138,101
12465,0,35,3034,26,2032,9
41182,32,1282,1450,969,6941,313
12343,6,243,3041,179,4565,64
10734,4,394,3124,321,10786,73
39200,43,988,1604,775,10355,213
8130,10,466,3273,363,8896,103
42878,12,105,1136,88,3308,17
24105,40,2799,2398,2251,16564,548
1107,1,80,3800,68,5617,12
36773,83,4856,1764,3852,26984,1004
19231,3,351,2654,261,11253,90
23960,36,1566,2405,1237,11136,329
42084,13,573,1303,412,11238,161
45521,231,2441,439,1955,16849,486
37747,64,585,1702,442,5221,143
17451,46,1222,2731,932,9745,290
30302,43,1303,2089,954,7064,349
31782,7,551,2013,451,9573,100
39053,3,51,1614,38,3384,13
30529,13,723,2075,581,7505,142
30235,13,456,2093,325,8335,131
39895,9,273,1563,218,8312,55
8260,9,1128,3265,832,13888,296
20842,1,199,2569,162,3184,37
5762,3,219,3407,165,4619,54
3794,69,6060,3493,4509,30117,1551
36870,3,235,1758,172,5158,63
16108,17,2650,2801,1786,37773,864
2685,138,3912,3513,3110,32011,802
10373,20,598,3145,507,11435,91
17259,3,358,2740,293,9945,65
3515,6,388,3498,325,51172,63
3941,1,224,3489,179,5721,45
17179,55,1397,2745,1061,12594,336
30672,0,44,2068,39,2661,5
11971,3,129,3061,108,3827,21
19360,21,1023,2648,863,4493,160
31374,0,0,2035,0,3744,0
2388,14,577,3518,478,16468,99
38775,47,1029,1631,796,10849,233
6625,34,2091,3370,1342,15501,749
44883,16,158,643,108,3005,50
32721,7,244,1969,203,9766,41
13624,0,6436,2953,4531,93544,1905
7374,44,924,3330,758,4974,166
43659,21,325,895,278,8259,47
9123,57,2638,3212,1827,12578,811
38827,0,11,1628,9,1697,2
16883,57,2091,2762,1626,17291,465
16849,42,3060,2764,2227,22433,833
15458,10,674,2832,494,9520,180
26777,28,747,2278,599,13857,148
18909,33,1173,2667,890,6255,283
38737,6,198,1634,168,6224,30
30517,16,414,2076,338,4709,76
19038,343,18170,2662,13044,42145,5126
9339,1,42,3198,35,1767,7
21018,7,282,2556,231,2526,51
20421,0,190,2591,132,2695,58
27392,16,363,2246,313,6400,50
10306,14,258,3149,218,4312,40
6550,20,348,3372,284,4365,64
37007,2,181,1750,154,4322,27
27016,2,167,2269,128,4125,39
10769,13,386,3123,261,9654,125
26747,11,897,2279,695,17810,202
20201,4,433,2602,313,3433,120
11262,38,1217,3096,890,9053,327
15156,18,1078,2845,793,12733,285
29160,22,600,2147,448,5135,152
41903,42,874,1334,674,8681,200
42445,9,193,1230,148,5076,45
45196,61,857,529,645,8630,212
6244,806,45893,3386,32461,145904,13432
23430,5,130,2430,98,2974,32
22023,20,638,2499,502,14535,136
9128,4,170,3211,120,13743,50
42574,119,1611,1205,1013,18075,598
6400,49,882,3379,697,11367,185
20196,2,130,2603,94,2883,36
2929,1,156,3509,118,4725,38
15244,1,432,2841,361,7257,71
26630,0,45,2285,7,3488,38
39775,2,113,1572,82,2881,31
7615,26,880,3316,713,4771,167
13294,26,1722,2977,1484,18274,238
3672,1,101,3495,75,2982,26
35823,1,108,1821,90,3358,18
15069,4,92,2850,74,9136,18
6248,8,258,3386,204,4741,54
10724,3408,167306,3125,94431,355551,72875
45899,15,232,293,166,3400,66
40496,89,1518,1516,1169,15852,349
43592,4,29,920,22,5955,7
12987,16,746,3004,599,7731,147
40321,11,370,1535,307,4785,63
44670,9,151,711,112,5730,39
29106,320,18033,2149,12641,122826,5392
22809,169,8310,2460,5843,95275,2467
22365,122,5855,2482,4022,43330,1833
24771,33,1216,2368,996,6755,220
4253,40,854,3478,713,19608,141
3498,1,13,3499,10,2009,3
39325,21,330,1596,255,3700,75
17332,1,89,2737,41,5406,48
9801,26,421,3172,328,9138,93
22455,1,0,2478,0,5762,0
39771,40,1042,1572,792,10412,250
21950,86,2954,2504,2260,24558,694
42385,176,4917,1244,3664,24723,1253
5553,29,714,3418,601,8345,113
18599,235,10802,2681,7553,92469,3249
7026,15,735,3350,364,5156,371
22549,46,528,2472,401,5385,127
38965,15,619,1619,460,8905,159
32535,21,589,1977,449,13842,140
2962,19,448,3509,352,8547,96
19541,3,178,2639,143,4628,35
10516,4,58,3138,47,3631,11
11063,13,359,3108,277,3633,82
28317,49,873,2193,716,15827,157
30953,0,0,2056,0,4088,0
28793,6,274,2165,228,8890,46
45813,57,465,321,382,6471,83
7940,12,364,3290,269,9678,95
41090,615,15928,1461,11017,134200,4911
25062,200,12291,2355,9057,87406,3234
25034,64,546,2356,422,25669,124
32921,22,1586,1960,1272,18389,314
28388,114,7212,2189,5549,44230,1663
45755,7,73,341,64,3095,9
7605,4,119,3317,98,2552,21
30574,13,214,2073,186,3296,28
20658,10,1028,2580,562,9526,466
15285,18,616,2839,469,5053,147
18574,195,14090,2682,11149,97237,2941
13764,2,134,2940,114,2488,20
2224,15,301,3521,239,12581,62
6516,3,93,3374,80,3564,13
2875,110,2982,3510,2162,22830,820
22415,2,155,2480,129,4737,26
43523,448,6761,947,5222,46440,1539
43630,22,329,906,282,14835,47
12204,10,303,3049,252,9053,51
10470,51,2843,3140,2166,58328,677
40296,152,5806,1537,4523,43576,1283
16811,17,1059,2765,867,8627,192
30643,0,11,2070,10,1405,1
14280,1123,115587,2904,76525,255324,39062
45383,51,1347,476,920,6890,427
31424,157,3849,2033,3060,39268,789
9189,4,106,3207,88,3507,18
25304,54,1234,2345,958,9174,276
19227,1,39,2655,31,3909,8
35027,58,3731,1873,2874,27265,857
43914,7,98,835,82,1921,16
3383,17,755,3501,568,14107,187
5981,3,49,3395,42,3081,7
13952,137,5120,2925,3959,36489,1161
38768,6,227,1631,187,4314,40
34921,0,130,1878,111,4760,19
29104,12,449,2150,373,2229,76
15290,31,520,2838,397,7871,123
5405,2,57,3424,44,3789,13
22318,30,2803,2485,2096,26599,707
23553,0,35,2424,17,1930,18
2857,393,240097,3511,87724,81351,152373
41195,11,234,1449,168,5948,66
4222,5,97,3479,86,5019,11
22657,0,5026,2468,3858,46685,1168
39320,3,70,1596,42,3452,28
34441,0,56,1904,48,1718,8
23263,6,416,2438,296,4605,120
7423,58,1626,3328,1224,39145,402
16464,0,134,2784,103,5412,31
37282,67,677,1732,517,7877,160
28444,8,217,2185,172,5695,45
9309,13,388,3200,329,5461,59
30673,33,835,2068,688,8295,147
40627,296,4749,1505,3513,39840,1236
9301,9,211,3201,156,5756,55
18168,12,365,2699,269,13225,96
12981,44,1170,3004,912,7606,258
3088,13,1527,3506,1174,31272,353
37740,24,1672,1703,1354,17311,318
9675,9,288,3178,224,7137,64
9109,1,63,3212,29,2495,34
15904,42,2500,2812,1915,28772,585
1911,10,348,3527,270,9328,78
33198,70,2736,1949,2152,57717,584
4302,30,578,3476,513,9611,65
24470,0,347,2382,284,7164,63
2899,2,156,3510,127,14841,29
3745,3,284,3493,221,6081,63
17405,30,594,2732,451,22935,143
37329,111,2035,1730,1432,59261,603
31448,41,1697,2031,1327,8412,370
7541,20,586,3321,484,4027,102
15754,0,48,2817,41,3668,7
5527,0,113,3419,86,6502,27
6291,11,375,3384,308,7635,67
39457,78,1575,1589,1203,21912,372
11615,9,709,3079,607,7127,102
8292,23,693,3263,532,9301,161
8233,7,128,3267,82,2530,46
10021,7,144,3162,123,4291,21
9221,7,132,3206,98,2439,34
9140,41,888,3210,694,15647,194
13201,25,1301,2983,1039,35917,262
23730,1,86,2416,75,2176,11
26423,0,15963,2293,12660,85978,3303
25367,78,1245,2342,950,15263,295
15710,0,1431,2819,1048,12445,383
14222,18,689,2908,529,7822,160
19846,11,824,2622,618,7787,206
7360,95,2914,3331,2312,40824,602
34267,0,420,1912,335,8687,85
19116,39,1599,2660,1250,8712,349
42905,16,308,1129,222,5198,86
25777,66,4063,2323,3232,25344,831
41465,4,274,1406,190,4020,84
2709,9,428,3513,325,10447,103
5930,129,10394,3398,7546,87426,2848
5740,12,286,3408,154,5143,132
30581,4,166,2073,143,5634,23
16645,373,28768,2776,20476,159409,8292
26195,4,185,2304,168,5136,17
37858,10,375,1694,314,3650,61
11150,3,150,3102,119,3959,31
44664,4,83,712,58,2526,25
11517,16,494,3083,405,20656,89
4153,66,1724,3481,1322,35172,402
29672,32,4491,2121,3574,22210,917
6837,15,846,3360,633,15737,213
12135,4,129,3053,95,4627,34
28734,28,1662,2168,1246,29133,416
21079,2,73,2554,61,6952,12
2613,9,651,3514,497,21347,154
28909,2,178,2160,146,3311,32
25232,804,21588,2348,17321,77049,4267
22046,7,790,2498,623,30231,167
18628,5,176,2679,124,1799,52
18134,0,29,2701,19,2868,10
43038,3,46,1091,43,3762,3
28273,43,1220,2195,910,15918,310
11498,99,3415,3084,2616,31656,799
33399,10,260,1942,225,7636,35
29412,32,610,2133,474,5695,136
32178,2,116,1992,93,5359,23
39527,0,0,1585,0,3899,0
12537,3,56,3031,44,1609,12
11222,74,2324,3098,1785,36817,539
9871,5,242,3169,208,5549,34
34790,8,1546,1885,995,10736,551
6186,35,1533,3389,1092,15474,441
16847,77,4899,2764,3216,41537,1683
30897,1,51,2058,49,2680,2
16459,2947,395049,2784,226581,1040155,168468
27029,748,17694,2268,12744,65481,4950
41773,1,24,1358,18,5313,6
36194,12,272,1795,236,4285,36
43632,84,1179,904,974,21876,205
17793,100,6350,2717,4166,25634,2184
20632,0,2643,2581,2022,45860,621
41695,65,2274,1373,1722,23374,552
10818,13,401,3120,305,6193,96
30202,7,263,2095,222,5635,41
17713,4,350,2720,271,4043,79
16107,12,998,2801,732,8147,266
34717,7,277,1890,210,5882,67
34025,75,4796,1919,3072,41131,1724
1871,42,2202,3528,1701,26995,501
45429,1,8,464,5,1166,3
15474,88,3679,2831,2654,24284,1025
29815,48,1785,2114,1330,21788,455
20757,6,189,2574,146,10366,43
39845,5,187,1567,136,5320,51
29654,11,217,2121,170,5742,47
24825,1,113,2366,98,2981,15
13513,49,3247,2960,2677,18488,570
19265,78,3403,2652,2590,22701,813
39929,9,305,1561,250,5346,55
17641,10,3014,2722,1985,35310,1029
43730,21,201,872,186,9265,15
2241,15,345,3521,291,20748,54
41740,53,2342,1365,1564,16243,778
41451,7,175,1408,135,2257,40
30619,14,411,2071,342,8203,69
15415,29,1307,2834,982,6274,325
34297,11,464,1911,384,3356,80
14715,89,7901,2871,5697,56398,2204
12934,6,128,3008,104,3875,24
41639,123,1271,1381,929,14178,342
12746,5,100,3019,74,9984,26
41866,154,3943,1340,2981,48585,962
26007,18,811,2312,660,5433,151
34407,120,3877,1906,3186,30565,691
6053,18,268,3393,196,5228,72
20377,17,569,2594,460,4968,109
8312,3,297,3261,234,5814,63
15942,208,16301,2810,10686,41366,5615
2266,3,31,3520,20,4656,11
21553,10,585,2526,486,6691,99
29109,2,174,2149,131,7167,43
19652,3,114,2633,94,3040,20
23779,48,1958,2414,1517,39200,441
17367,7,258,2735,215,13527,43
9829,204,36274,3170,23956,72356,12318
21785,84,2541,2513,1912,18160,629
35834,2,118,1820,105,4325,13
14579,4,143,2880,120,19495,23
38090,137,7508,1679,5641,38850,1867
24666,4,544,2372,411,14001,133
45800,21,300,326,267,3218,33
28243,38,910,2197,726,6098,184
16985,39,2428,2757,1879,24551,549
3035,5,142,3507,112,5463,30
35280,28,632,1858,514,7211,118
45661,19,265,385,200,3394,65
34052,0,62,1918,44,4409,18
7399,12,408,3329,305,3915,103
19392,166,4969,2646,3958,28855,1011
26216,59,1681,2303,1270,17102,411
45797,47,552,327,419,4450,133
10134,72,1419,3156,1037,24017,382
45396,49,387,471,323,6948,64
2534,3,49,3516,38,5570,11
30442,33,1751,2080,1131,15450,620
2669,5,127,3514,93,4911,34
2698,4,101,3513,70,4732,31
19611,17,669,2635,519,5736,150
15726,14,1511,2818,1110,16793,401
11591,13,973,3080,770,12061,203
7419,30,1114,3328,819,12720,295
44417,2,55,757,38,2306,17
42521,0,17,1214,14,1756,3
40130,198,4767,1548,3616,36227,1151
35131,23,470,1867,390,7079,80
40762,355,5090,1493,3942,28935,1148
38269,30,813,1666,648,9241,165
35907,89,2503,1815,2011,20875,492
26205,7,525,2303,404,5279,121
13451,1,404,2964,295,7308,109
31936,7,450,2006,366,8671,84
1856,10,140,3528,114,7312,26
7588,3,131,3318,98,4514,33
9348,27,2065,3197,1659,13323,406
31291,35,3407,2039,2425,31162,982
9016,31,1278,3219,1070,20037,208
39425,33,708,1591,545,11705,163
8637,15,147,3240,115,5185,32
39308,1,80,1597,60,3228,20
5067,184,4526,3443,3071,29878,1455
19590,5,209,2636,160,7858,49
32982,5,227,1958,184,5796,43
5537,20,569,3418,443,12365,126
36091,29,1621,1801,1218,14170,403
2803,20,871,3511,711,13089,160
24325,14,756,2388,555,7435,201
5865,4,62,3401,49,2538,13
18330,90,6871,2692,4904,51677,1967
5521,304,25059,3419,17830,102594,7229
19395,18,560,2645,350,4047,210
21747,3,869,2515,631,17005,238
2391,17,478,3518,376,8040,102
18625,200,17636,2679,13355,111103,4281
37312,0,33,1730,25,4540,8
3140,22,743,3505,625,8052,118
9905,0,21,3168,15,1938,6
28440,1,212,2186,165,5929,47
30061,11,240,2102,193,5713,47
37909,224,3837,1690,3031,25256,806
29546,10,316,2127,272,5143,44
34650,121,2074,1893,1544,15561,530
8756,3,28,3233,22,1510,6
30349,2,118,2086,97,11291,21
26457,76,882,2292,709,5794,173
43692,9,107,884,81,2385,26
38601,11,640,1642,514,8099,126
33101,21,804,1953,646,9123,158
23824,33,699,2412,479,6972,220
46327,3,18,119,17,832,1
39282,81,1297,1598,946,8873,351
18519,4,215,2684,189,1821,26
38849,18,788,1626,631,7087,157
8937,4,113,3222,84,3366,29
9503,38,1672,3187,1247,20932,425
32376,284,15144,1983,10538,100974,4606
9637,5,209,3179,168,4829,41
3735,19,666,3494,499,16813,167
22786,33,800,2462,624,3631,176
16932,414,39266,2760,27016,271770,12250
19893,15,550,2619,444,14955,106
18677,407,71454,2677,52017,127456,19437
1910,57,1305,3527,1077,28557,228
24307,50,4427,2389,3348,47898,1079
35855,1,105,1819,82,4649,23
26288,37,883,2300,599,7614,284
5795,1,83,3405,67,4312,16
45316,11,326,493,169,3854,157
7049,4,105,3348,86,2288,19
9771,12,561,3174,371,5608,190
2199,24,567,3521,402,7049,165
12315,1,105,3043,82,5739,23
45174,13,218,536,174,4310,44
22889,8,227,2456,181,6493,46
42175,7,300,1284,247,13163,53
23377,24,796,2432,571,4086,225
2937,116,3058,3509,2167,19397,891
18692,12,974,2676,686,4131,288
33056,5,263,1955,216,4050,47
36984,7,412,1751,289,8157,123
34341,11,466,1909,384,11874,82
4712,51,1292,3460,1056,37680,236
41131,2,89,1456,65,2545,24
5316,5,221,3429,193,4497,28
32213,4,388,1991,265,5583,123
4229,70,2557,3479,1994,15258,563
10113,21,1346,3157,1078,26872,268
38375,1515,66801,1658,46815,216837,19986
42367,36,378,1246,264,4619,114
14497,200,11008,2886,7995,45373,3013
34250,58,1187,1913,980,7842,207
44079,90,3378,797,2531,10275,847
39591,363,5126,1581,3728,29677,1398
13468,18,1686,2963,1279,27205,407
14555,56,2216,2882,1802,28914,414
27026,15,891,2268,694,14145,197
6180,13,518,3389,443,11291,75
6660,41,1299,3369,1014,13506,285
39635,553,8718,1579,6092,38208,2626
43516,3,41,949,26,4053,15
43011,2,43,1098,37,3007,6
12549,3,88,3031,57,7725,31
33413,20,1038,1942,815,13937,223
18840,14,1177,2670,815,7101,362
10115,35,1307,3157,981,26781,326
26252,65,2973,2302,2503,35368,470
39566,6,164,1583,138,10999,26
37128,2,114,1742,96,4396,18
38270,128,2288,1666,1762,16455,526
21010,0,2984,2557,2405,59576,579
28229,7,423,2198,297,7098,126
12909,89,2114,3009,1764,7585,350
37018,15,552,1749,444,10287,108
18340,95,2908,2691,2390,13689,518
27618,4,319,2233,247,8736,72
19945,8,764,2617,582,10682,182
3747,17,626,3493,492,15233,134
42019,40,1159,1316,788,6402,371
19487,175,4137,2641,3084,16083,1053
15806,4,105,2815,79,1617,26
5863,63,2029,3401,1710,16319,319
17911,70,2773,2712,2200,25353,573
1924,11,437,3527,338,15428,99
30554,0,27,2074,23,7346,4
6123,10,498,3391,399,12810,99
19331,421,31200,2649,23189,98798,8011
31215,42,804,2044,620,6942,184
33767,298,11201,1928,8694,81767,2507
42648,187,3295,1190,2481,14632,814
26804,3,118,2276,99,1561,19
26711,0,27,2281,25,3352,2
2432,32,784,3517,642,19824,142
41454,168,3675,1408,2819,24853,856
38412,6,139,1656,111,3664,28
22815,59,2694,2460,1795,26076,899
5019,396,14709,3446,10545,147158,4164
22434,14,628,2479,476,9701,152
43079,157,4211,1077,2979,34798,1232
4779,13,465,3458,354,4515,111
8062,11,1555,3276,839,11325,716
39353,15,241,1595,184,4118,57
43712,121,1786,878,1579,12229,207
24684,25,1260,2371,964,9618,296
40591,10,143,1508,104,1456,39
39280,77,1963,1598,1555,13787,408
27550,0,30,2236,27,1015,3
26669,2,194,2283,158,8131,36
2982,8,305,3508,239,6831,66
4495,49,1736,3469,1256,15965,480
4430,7,247,3471,182,5597,65
29680,138,3356,2120,2320,20323,1036
21125,287,22626,2551,17004,103230,5622
24207,73,2488,2394,1928,30156,560
33135,0,92,1951,77,5213,15
1561,6,57,3591,51,2646,6
22356,102,2928,2483,2284,28918,644
15363,5,205,2835,164,4564,41
6030,3,47,3394,43,1541,4
29922,6,110,2108,89,2661,21
25530,151,6579,2335,4376,72982,2203
5170,184,5539,3437,3864,27417,1675
34563,1,67,1898,54,2843,13
26724,83,8322,2280,6009,58798,2313
26884,7,294,2272,239,5829,55
15697,787,33831,2820,22911,129752,10920
8573,11,419,3244,352,13678,67
24235,2,78,2393,60,4144,18
32135,60,1246,1995,878,11814,368
6002,145,6894,3395,4867,78205,2027
23765,4,122,2414,93,5981,29
38319,7,135,1663,106,3492,29
29225,4,320,2143,256,7271,64
25810,0,37,2321,32,1456,5
10223,1293,59245,3152,42271,224706,16974
37057,20,534,1746,398,10028,136
7722,28,546,3310,420,9041,126
40143,39,990,1548,770,12451,220
6688,7,197,3367,160,2460,37
20932,0,45,2562,41,2094,4
8616,13,406,3242,351,15125,55
27289,8,612,2253,498,7115,114
6983,46,662,3352,485,7133,177
17345,1448,51309,2736,39384,132327,11925
25217,10,478,2348,392,5902,86
25124,3,142,2352,101,2342,41
22595,408,25228,2471,16166,161056,9062
13802,22,795,2938,672,13801,123
8850,24,1381,3227,1108,33041,273
4576,38,1282,3465,1058,11938,224
18993,2,510,2664,402,7827,108
40381,16,1424,1527,943,18143,481
25988,6,435,2313,380,4497,55
35517,12,230,1845,193,4674,37
2185,35,1167,3522,903,18459,264
41106,15,200,1459,159,3904,41
24677,77,2838,2371,2174,14664,664
31308,48,722,2038,582,14198,140
33971,31,1182,1921,925,16584,257
7981,11,241,3286,181,6366,60
24783,3,593,2367,490,8153,103
6553,196,7791,3372,5452,64030,2339
9347,8,164,3197,138,3528,26
10183,248,11640,3154,7494,74449,4146
30338,22,422,2086,317,5735,105
15667,7,319,2821,251,5611,68
9884,6,46,3168,39,2977,7
1214,2,95,3766,86,4768,9
24292,10,240,2390,186,2732,54
32424,322,7196,1982,5706,33764,1490
16439,18,403,2785,310,10741,93
32820,0,30,1965,27,1832,3
31493,12,442,2028,361,5539,81
40189,8,374,1545,256,6100,118
20567,28,2994,2584,2145,28726,849
45815,16,134,321,112,2596,22
4805,1033,63218,3457,43421,233832,19797
19097,7,320,2660,250,7658,70
26583,2,149,2287,130,3683,19
36993,10,201,1751,162,2660,39
23541,41,3646,2425,2865,20262,781
8969,5,175,3220,130,3193,45
24467,9,331,2382,269,7481,62
39960,14,202,1558,169,3639,33
31404,39,1906,2034,1456,18264,450
6993,8,410,3352,311,4750,99
36570,0,0,1777,0,1653,0
2925,48,1481,3509,1221,17613,260
35249,24,728,1860,563,9470,165
46230,5,64,154,42,1170,22
12942,1,52,3008,44,2833,8
41811,68,989,1349,716,12835,273
40828,2,80,1486,63,6056,17
4400,41,1973,3472,1535,25176,438
5305,16,376,3430,309,7436,67
6389,42,1336,3380,1040,59927,296
5392,379,11598,3425,9093,50673,2505
16649,3,87,2776,67,2221,20
3771,24,846,3493,696,11672,150
20021,5,120,2612,79,2962,41
14676,335,16543,2875,12048,66791,4495
35070,59,1435,1870,1133,9542,302
41553,117,2222,1396,1686,26771,536
34623,55,1294,1895,953,12384,341
10804,8,400,3121,321,5996,79
16163,3,152,2799,134,6265,18
13856,15,1304,2934,727,16048,577
2856,23,926,3511,771,18781,155
33705,24,1506,1931,1126,26342,380
11624,3,154,3078,107,7221,47
46126,27,342,193,248,5490,94
31013,5,312,2054,226,4675,86
6682,15,594,3367,438,9041,156
30659,78,4097,2068,3127,29526,970
43656,36,389,893,343,6664,46
27240,4,100,2256,83,2582,17
2735,4,113,3513,91,4792,22
28334,2,251,2192,194,7138,57
1459,6,56,3623,48,2363,8
42065,35,526,1308,389,12836,137
20400,11,463,2593,377,5862,86
35943,50,453,1813,348,4073,105
32442,5,422,1981,303,4216,119
3701,47,2303,3494,1692,51053,611
43465,21,601,965,443,10471,158
25617,22,664,2330,548,10657,116
13680,35,1415,2948,1115,27542,300
31139,11,303,2047,237,8184,66
13078,114,5463,2999,4092,38788,1371
29034,5,261,2153,221,4394,40
12709,118,4056,3021,3057,32370,999
15683,9,199,2820,175,3874,24
1655,0,21,3571,18,1590,3
4083,21,995,3484,780,14431,215
29694,13,514,2119,418,6329,96
31610,391,39333,2022,24808,176898,14525
21454,26,1013,2531,878,15098,135
40877,96,2115,1482,1549,27733,566
36250,77,2027,1793,1358,19322,669
26701,1,69,2281,61,1500,8
34509,31,655,1901,543,5910,112
3876,15,351,3490,297,4439,54
21174,13,1761,2547,1415,18979,346
19280,23,1653,2651,1123,16263,530
18295,9,425,2693,370,4799,55
45886,24,125,296,97,2496,28
14878,4,357,2861,296,12402,61
44736,20,173,688,155,5653,18
28710,4,223,2170,181,10165,42
33263,14,363,1947,293,5831,70
4781,151,4990,3458,3639,70812,1351
8591,6,140,3243,110,2151,30
38441,24,597,1654,372,4443,225
34266,25,1243,1912,895,16409,348
7772,21,268,3306,205,14610,63
2843,6,608,3511,498,9401,110
2088,12,466,3523,324,5780,142
8421,10,364,3255,283,13428,81
1805,206,5449,3531,4350,57345,1099
9429,39,1912,3192,1583,28899,329
40572,3,152,1509,117,2573,35
38899,22,1764,1623,1334,12064,430
1059,6,222,3814,182,10645,40
7781,41,1655,3305,1252,12440,403
7505,11,662,3323,534,6567,128
34770,106,1057,1887,781,9181,276
35618,10,206,1837,179,15040,27
38104,85,2173,1678,1542,14218,631
20520,14,526,2587,416,10979,110
3040,8,297,3507,249,8479,48
10412,8,399,3144,329,11714,70
39999,212,4844,1556,3539,39215,1305
42827,7,105,1147,84,9508,21
42504,93,2057,1217,1416,18465,641
30934,249,7798,2057,5966,70074,1832
37781,4,362,1700,268,17156,94
17962,11,524,2709,407,4815,117
42945,7,177,1116,139,4381,38
10345,279,25000,3146,18740,84335,6260
39930,16,443,1560,360,7978,83
20101,85,15257,2608,11044,50507,4213
16311,10,298,2792,221,12155,77
28390,10,561,2188,406,9488,155
14685,0,0,2874,0,6180,0
36451,15,300,1783,265,8328,35
1218,5,44,3766,36,3329,8
8951,2,291,3221,238,12182,53
42298,7,165,1260,116,3597,49
39487,370,7034,1588,5415,32266,1619
29661,5,297,2121,249,19114,48
5766,14,808,3407,472,11958,336
33293,0,34,1946,29,9063,5
9652,1,74,3178,60,4665,14
25692,16,362,2327,297,5805,65
13812,140,7173,2938,5533,105723,1640
19862,34,995,2621,733,9905,262
6726,21,766,3366,628,30069,138
8516,6,170,3248,110,10323,60
42699,31,710,1178,529,8017,181
34742,4,144,1888,114,5174,30
34067,4,264,1918,228,5749,36
40247,10,195,1540,124,2743,71
5480,1367,123222,3421,81349,507040,41873
8329,20,396,3260,332,5751,64
11512,47,2237,3083,1711,70491,526
39442,1,45,1590,40,4180,5
30032,0,20,2104,15,4561,5
4053,25,638,3485,496,7746,142
44878,45,561,643,436,7250,125
19605,121,6277,2636,4858,58065,1419
32435,29,1521,1981,1252,10638,269
20073,12,269,2610,201,7023,68
40152,3,197,1547,142,3587,55
13163,13,656,2985,506,7973,150
2439,14,372,3517,209,8683,163
14535,31,1596,2884,1234,15456,362
30859,158,6436,2059,4591,47526,1845
37727,20,561,1704,453,9960,108
22100,20,320,2494,251,3832,69
25420,0,64,2340,56,3056,8
18648,52,2277,2678,1772,25482,505
12559,14,501,3029,398,9643,103
7948,14,685,3289,554,34708,131
17172,39,1160,2745,869,11252,291
10974,123,7108,3112,5457,35869,1651
36860,5,193,1758,154,2165,39
34638,27,851,1894,716,13450,135
18688,168,12657,2676,9289,80540,3368
30723,55,3167,2065,2451,12716,716
14298,2,201,2901,142,3885,59
43814,90,2676,851,2025,25193,651
11733,29,4007,3072,3005,27401,1002
18121,8,431,2701,360,3901,71
27447,2,85,2243,72,3001,13
40089,1,174,1550,96,6833,78
10680,9,109,3128,75,2005,34
14793,9,206,2866,162,3814,44
6939,8,163,3355,136,3114,27
20410,37,668,2592,539,4957,129
19792,89,5549,2625,4228,32780,1321
12016,332,50705,3059,35871,164306,14834
28356,106,3007,2190,2275,21967,732
2501,26,1421,3516,1121,20661,300
26644,171,14979,2284,10945,85056,4034
5099,19,914,3441,676,6197,238
14547,11,335,2883,275,7353,60
42339,207,5018,1252,3559,81304,1459
7217,1,77,3340,64,3875,13
37368,2461,340474,1727,164789,889046,175685
3656,20,673,3495,533,9141,140
32283,1,50,1988,41,2675,9
23828,11,848,2411,572,4817,276
24324,0,68,2388,54,2470,14
18527,5,182,2684,161,2410,21
6406,258,11206,3379,8283,79215,2923
16417,324,19748,2786,12796,159207,6952
17978,65,4565,2708,3405,44831,1160
40345,5,196,1532,150,4910,46
10016,20,842,3162,662,8537,180
28839,4,70,2163,58,2252,12
12185,10,252,3050,201,6056,51
32552,56,3812,1976,2895,30962,917
22066,154,8165,2497,6023,35538,2142
1999,291,10471,3524,8003,65984,2468
13734,4,200,2943,153,7990,47
9630,3,89,3180,74,4520,15
37102,16,653,1744,486,14641,167
12258,69,2336,3046,1773,64128,563
41347,0,97,1424,74,4069,23
21368,88,9537,2536,5850,42051,3687
1488,10,246,3616,210,4987,36
24881,46,3735,2363,2844,30974,891
20555,147,4515,2585,3396,30516,1119
39288,328,15257,1598,11306,80524,3951
42803,9,157,1150,120,4082,37
3450,11,166,3500,145,8186,21
38631,4,165,1639,110,5878,55
33314,24,1389,1946,1045,15661,344
7730,16,1290,3309,1010,20036,280
38608,22,749,1641,568,13037,181
4700,57,3363,3461,2706,17733,657
6770,258,6059,3363,4449,62744,1610
30187,2,74,2095,66,8841,8
28057,8,341,2207,243,4838,98
40856,55,1677,1483,1162,15582,515
20489,17,4137,2589,3052,56512,1085
26952,2,67,2269,54,2086,13
7906,11,167,3294,141,4471,26
17944,9,265,2710,218,9673,47
24346,7,321,2387,252,8855,69
39847,91,2271,1567,1625,19155,646
41124,12,280,1457,209,5133,71
27715,6,191,2227,158,2003,33
21100,23,2353,2553,1686,14881,667
7709,18,483,3311,392,16066,91
37948,22,575,1688,416,8944,159
13092,1098,62481,2997,39851,170970,22630
26641,20,629,2284,500,5810,129
22430,0,11,2480,10,1964,1
12199,20,1434,3050,1136,4811,298
10622,121,6124,3132,4673,50768,1451
19454,0,49,2642,38,3286,11
12588,1452,136868,3028,106065,412892,30803
8038,28,278,3277,237,5025,41
38099,32,2589,1679,1948,19066,641
41863,36,308,1340,223,4258,85
38219,17,371,1670,292,4698,79
19197,7,262,2656,211,3499,51
16076,1,28,2803,26,3088,2
24347,5,409,2387,311,5875,98
34874,3,380,1880,332,8425,48
25300,14,698,2345,581,5066,117
7789,1,47,3305,41,2907,6
23644,7,319,2419,266,13066,53
42740,5,112,1167,82,3763,30
37768,17,983,1701,697,9309,286
6751,15,359,3365,294,8600,65
7835,0,70,3301,45,2314,25
38840,203,6788,1627,4808,46298,1980
17054,79,8435,2752,6426,42457,2009
31382,32,2267,2035,1733,15933,534
18218,5,100,2697,85,3938,15
40551,8,205,1512,159,4219,46
11817,20,931,3069,694,7043,237
22425,19,706,2480,582,17412,124
5094,4,81,3441,72,3957,9
3650,5,218,3496,155,4942,63
36964,1,78,1752,70,7034,8
20651,14,445,2580,321,16623,124
29301,56,1583,2139,1259,5476,324
40026,1,58,1554,46,2930,12
8733,66,3707,3234,2716,35756,991
37158,2,134,1740,104,7196,30
30582,21,662,2073,561,8244,101
33956,9,181,1922,132,3051,49
37180,2,36,1739,35,1026,1
30009,27,1149,2104,955,15368,194
15157,15,14120,2845,5285,12347,8835
44766,150,1709,679,1444,20261,265
4545,16,377,3467,299,10544,78
6997,234,14291,3352,9283,59776,5008
26493,22,442,2291,355,3217,87
23183,4,483,2443,378,12287,105
19093,21,828,2660,670,11818,158
10494,24,1067,3139,893,18805,174
40351,1,38,1530,34,1820,4
40790,13,215,1491,170,2340,45
11032,19,292,3109,215,2925,77
19922,6,614,2618,471,6353,143
5765,10,210,3407,168,4288,42
45768,16,260,335,214,2900,46
34032,1,396,1919,312,4937,84
45858,113,2776,279,2235,15131,541
40871,32,644,1482,472,7650,172
23451,1,31,2429,25,2220,6
20390,8,226,2594,176,7249,50
33364,24,926,1943,691,12295,235
35993,5,172,1809,145,2669,27
44105,2,24,803,15,1540,9
39890,3,174,1563,150,7221,24
27864,12,264,2219,199,2886,65
3919,1,217,3489,162,6602,55
21560,48,1989,2526,1698,23420,291
14239,63,3886,2906,3014,31767,872
2662,6,160,3514,136,6052,24
43601,50,876,916,707,20895,169
44093,48,1474,797,1050,8414,424
15905,15,1415,2812,1074,14176,341
18476,5,206,2686,154,3858,52
14768,20,854,2867,673,7815,181
17810,55,3881,2716,2968,29786,913
2259,1,23,3520,20,2221,3
14056,9,272,2917,219,3984,53
45864,126,1959,279,1513,11720,446
9794,19,506,3172,405,5551,101
8129,7,115,3273,92,3556,23
41819,1,68,1347,54,3206,14
30980,92,2702,2055,2066,34432,636
21980,452,22158,2501,17128,146087,5030
11336,7,99,3094,77,4776,22
18210,56,2653,2697,1886,18960,767
7109,91,5010,3345,3739,45602,1271
43410,16,162,978,130,5990,32
42870,260,5318,1138,3979,34012,1339
6889,19,254,3358,196,4273,58
12512,1,89,3031,67,1297,22
12179,11,1583,3050,1203,17731,380
8222,14,402,3267,294,16054,108
23153,787,239696,2444,165443,318514,74253
40206,31,947,1543,649,7144,298
3213,15,257,3504,216,3295,41
3159,1,27,3505,20,2637,7
35251,3,77,1860,65,5331,12
45331,0,1395,489,1145,9095,250
3776,21,491,3493,330,8745,161
18852,46,2168,2669,1650,21094,518
35354,4,82,1855,71,2025,11
45892,125,1382,294,1072,10958,310
18275,173,6642,2694,4708,33989,1934
24384,19,907,2386,725,5519,182
38120,6,245,1676,203,4640,42
35944,65,2411,1813,1855,30871,556
16296,58,9127,2793,6689,105115,2438
27389,28,1314,2246,908,20860,406
30964,100,2506,2056,1887,17600,619
26812,48,2614,2276,1911,23805,703
19918,4,236,2618,162,14497,74
27204,31,1710,2258,1290,22687,420
1827,32,555,3530,439,13763,116
30660,0,38,2068,28,1774,10
33047,10,299,1955,222,5514,77
30042,0,18,2103,15,2069,3
35192,36,820,1864,606,3720,214
33770,2,136,1928,98,4761,38
18949,1,119,2666,95,2725,24
29525,3,209,2128,170,6236,39
45942,4,111,266,60,2847,51
34895,14,296,1879,222,6892,74
41892,3,102,1335,79,5313,23
7558,3,209,3320,168,5582,41
11555,1,46,3081,39,1960,7
17314,5,220,2738,200,5927,20
34464,19,455,1904,361,12646,94
32951,3,191,1960,135,7374,56
9389,22,618,3194,456,21385,162
46286,23,305,138,263,5350,42
35709,1,50,1829,42,4409,8
37508,8,279,1718,229,7395,50
31476,24,830,2029,682,15577,148
38181,0,106,1673,76,8868,30
22518,63,2931,2474,2202,17872,729
14800,58,2689,2864,2026,28066,663
19646,5,414,2634,311,10845,103
19912,0,57,2619,44,2105,13
12260,26,1527,3046,1055,35575,472
4112,29,767,3482,611,13584,156
2528,103,4816,3516,3717,97878,1099
30504,64,3313,2076,2380,27554,933
24737,8,473,2368,364,4744,109
40647,2,63,1504,44,1549,19
30417,33,1392,2082,1068,21096,324
8132,8,267,3273,181,11840,86
27110,237,12878,2264,9206,98773,3672
21703,10,454,2517,332,5906,122
5088,31,553,3442,400,10754,153
16618,4,349,2777,268,6273,81
2098,17,339,3523,271,5565,68
7966,17,353,3287,302,5812,51
31535,29,583,2026,471,7284,112
27646,18,486,2231,376,5861,110
23657,30,727,2419,548,4957,179
37518,7,433,1717,283,8158,150
28394,1,64,2188,59,4881,5
10538,18,774,3137,683,32914,91
12089,0,0,3056,0,2606,0
30732,67,1371,2065,1128,14182,243
44388,6,66,759,46,2702,20
39860,16,829,1566,631,11116,198
7465,12,398,3326,293,6466,105
17454,10,621,2731,483,10091,138
42810,5,146,1149,110,4263,36
37859,5,70,1694,63,2349,7
32423,13,860,1982,654,20411,206
31490,69,3356,2028,2376,29735,980
25408,6,635,2341,481,11274,154
46232,34,697,154,575,7697,122
11845,2,49,3068,41,1381,8
2471,9,218,3517,187,6752,31
36414,89,4429,1784,3136,41727,1293
17788,9,339,2718,245,12364,94
15619,3019,191171,2823,114701,787126,76470
8127,1,9,3273,7,1183,2
14022,10,317,2919,250,19174,67
11510,55,1202,3083,926,12119,276
17602,1,559,2724,463,17296,96
27450,23,528,2243,413,12339,115
1062,4,76,3814,67,3444,9
14409,98,2528,2892,1864,21851,664
38360,3,121,1659,94,7277,27
20317,10,707,2597,587,18854,120
16487,4,73,2783,58,7016,15
43308,84,1544,1011,1146,16660,398
8806,10,400,3229,316,12105,84
38591,62,1743,1643,1376,30056,367
5452,61,2929,3422,2153,42167,776
9331,15,486,3198,385,9357,101
16214,22,1969,2797,1532,11904,437
29571,3,102,2126,87,2132,15
15166,49,1779,2844,1380,10795,399
42247,13,424,1269,302,5881,122
42824,88,1396,1148,1097,15867,299
24314,0,162,2389,128,3069,34
40011,2,121,1555,88,4524,33
34862,24,638,1881,544,30966,94
30783,28,521,2063,410,5920,111
42640,232,3645,1192,2672,30418,973
27147,103,2085,2261,1543,14437,542
13300,22,605,2977,437,7197,168
22521,1,64,2474,55,2472,9
2518,1529,89983,3516,54703,468988,35280
35602,247,6373,1838,4269,47919,2104
45192,5,80,531,41,2963,39
16979,1,103,2758,83,3966,20
26290,2,30,2300,26,1291,4
39021,9,248,1616,185,7933,63
36189,22,500,1795,360,11800,140
35363,62,593,1855,478,4495,115
33932,5,214,1923,158,9928,56
43391,1,77,984,46,4754,31
25939,1,148,2316,115,5648,33
8691,8,188,3236,142,3476,46
39486,42,1203,1588,893,17795,310
4019,20,768,3486,637,23744,131
11531,118,3836,3082,2818,19818,1018
34660,13,326,1893,259,7110,67
5403,368,15713,3424,12411,100477,3302
41685,80,2021,1374,1618,29218,403
37487,153,3049,1719,2176,24304,873
7152,42,2487,3342,1869,41719,618
37728,94,862,1704,679,7981,183
42807,3,107,1149,82,6451,25
39358,1,86,1595,63,6195,23
26509,1,91,2290,77,6707,14
29882,34,1665,2110,1306,18913,359
31779,0,79,2013,68,2153,11
17360,194,4293,2735,3166,16407,1127
45333,16,165,489,152,2209,13
5943,29,733,3397,583,21686,150
29475,6,1356,2130,680,11737,676
12960,21,708,3006,606,6839,102
2373,60,1690,3518,1365,20221,325
19944,5,360,2617,307,13612,53
11430,19,3361,3089,1654,21887,1707
4239,45,1345,3478,1048,19202,297
28414,1,111,2187,92,3792,19
21763,48,1631,2514,1355,12828,276
39127,11,243,1609,194,6016,49
18675,38,1866,2677,1469,18912,397
32318,12,610,1986,455,7607,155
23556,4,0,2424,0,2901,0
9492,10,234,3187,179,3750,55
37932,1,192,1689,159,7105,33
22145,1,90,2493,73,7951,17
17927,35,1974,2711,1510,20801,464
6497,3,63,3375,52,2423,11
5171,9,202,3437,174,5092,28
24313,28,657,2389,534,10096,123
33249,78,3009,1948,2244,25789,765
14355,14,491,2896,359,10186,132
17199,13,908,2744,733,11689,175
43566,39,534,931,424,3873,110
14369,24,650,2895,529,8622,121
13743,29,1124,2942,909,20621,215
3209,360,19713,3504,12817,102635,6896
6062,6,74,3392,56,3782,18
29489,16,201,2129,172,4164,29
4718,33,1145,3460,876,7741,269
32162,21,1743,1993,1351,18472,392
5640,17,433,3412,344,4528,89
43202,5,202,1044,150,4493,52
6673,3,112,3368,90,2173,22
16721,63,5958,2772,4563,39506,1395
42285,57,1814,1262,1387,22023,427
28878,15,342,2161,283,5761,59
38665,6,256,1638,207,3193,49
45552,27,686,426,522,10279,164
14347,139,5171,2897,3404,22994,1767
34038,1,134,1919,102,3185,32
7361,31,622,3331,478,8589,144
31588,23,1581,2023,1297,17375,284
17941,5,255,2710,199,3839,56
42976,40,630,1110,446,7007,184
21719,26,912,2516,670,7813,242
1669,5,65,3567,51,4391,14
8412,17,384,3255,327,5785,57
45393,54,706,473,558,9305,148
29689,14,207,2120,177,5281,30
9866,69,1588,3169,1151,29943,437
45418,11,79,466,67,4814,12
14714,1457,54982,2871,40255,261732,14727
11154,41,1656,3102,1270,14380,386
16664,14,553,2775,448,7993,105
45739,5,67,346,59,1948,8
45181,3,24,534,10,2004,14
4810,59,1882,3456,1273,9019,609
6288,29,666,3384,521,7525,145
6735,45,2031,3365,1343,15366,688
42254,1,134,1267,110,9675,24
34451,5,171,1904,135,4719,36
35986,18,574,1809,469,10899,105
28985,0,54,2156,41,2812,13
24535,6,297,2379,212,4247,85
32919,0,125,1960,101,4322,24
25250,17,600,2347,478,6572,122
37829,13,391,1696,304,8209,87
15788,1,96,2815,67,6863,29
13585,38,1350,2955,1113,26526,237
4727,501,12621,3460,9407,51153,3214
9159,286,25584,3209,12561,125513,13023
44756,4,87,681,58,3346,29
17270,16,801,2740,629,9957,172
15597,25,808,2824,595,7743,213
10672,23,1324,3128,941,27638,383
9279,88,5829,3202,4267,33015,1562
25512,28,569,2336,425,4504,144
17285,38,2312,2739,1730,25349,582
41982,8,325,1322,240,11130,85
19977,3,96,2614,83,5421,13
39198,2,143,1604,107,4423,36
13310,0,32,2976,27,6268,5
45961,30,386,260,325,10659,61
43340,142,1699,1002,1277,17007,422
42589,6,60,1202,46,4470,14
7850,17,389,3300,323,5423,66
35338,5,303,1856,241,4624,62
8642,5,107,3240,78,2302,29
34071,5,47,1918,41,4720,6
39688,6,269,1576,226,5318,43
35983,11,595,1810,488,12116,107
41419,36,476,1414,353,5538,123
42228,3,101,1273,78,4052,23
42551,17,182,1209,137,3466,45
38303,3,135,1664,101,4261,34
5208,83,2839,3434,2348,14299,491
8342,2,83,3259,74,3119,9
12866,112,5257,3011,3847,43547,1410
7269,238,10250,3337,7404,54840,2846
25536,40,998,2335,751,12544,247
28197,92,2898,2199,2087,23571,811
38921,60,1622,1622,1098,18844,524
28465,11,418,2184,324,11617,94
37540,34,598,1716,479,11801,119
23204,54,1501,2441,1201,9508,300
18823,17,1628,2670,1288,18677,340
19020,3,95,2663,83,3617,12
40785,25,826,1491,532,13617,294
18238,33,2197,2696,1534,11350,663
42338,16,186,1253,131,3295,55
40846,5,106,1484,78,3770,28
12651,2,58,3024,53,1551,5
21678,58,4620,2518,3328,22668,1292
6935,30,601,3356,447,10042,154
44924,8,385,631,277,4158,108
33390,21,484,1942,372,3725,112
14560,286,23235,2882,15663,93085,7572
33446,2,123,1940,97,7974,26
8440,1258,88982,3253,58034,616525,30948
8859,3,108,3227,87,4389,21
3989,142,3677,3486,2731,34705,946
35604,3,22,1838,21,3819,1
15427,246,15309,2833,11583,77550,3726
38798,21,322,1630,263,2622,59
6105,6,215,3391,146,4857,69
16843,542,31018,2764,20798,154106,10220
25265,20,563,2347,385,7425,178
45794,34,345,329,267,4199,78
24462,52,1591,2382,1127,11308,464
14370,94,5719,2895,3461,36224,2258
28594,26,1364,2175,1113,18859,251
5580,77,3326,3416,2465,57073,861
14669,249,11283,2875,8157,47952,3126
25615,173,10677,2330,7502,52438,3175
38055,39,555,1682,438,6578,117
26915,120,2468,2271,1978,13911,490
1611,23,1183,3583,984,13303,199
31271,17,619,2040,484,7283,135
42773,40,508,1160,367,5563,141
4086,7,110,3483,92,4788,18
44843,16,288,651,211,8090,77
46161,22,279,174,237,2288,42
33173,13,409,1950,347,5143,62
29102,42,1916,2150,1466,12298,450
28949,26,3255,2158,2364,29111,891
21335,110,5118,2538,3858,37430,1260
27896,20,2445,2217,1871,21523,574
24479,41,1625,2381,1280,13187,345
29059,4,95,2152,78,3333,17
15242,21,1049,2841,821,5855,228
10839,11,1336,3119,1005,14064,331
24382,274,18108,2386,12132,76476,5976
42425,7,393,1234,289,9684,104
15220,12,810,2842,654,9807,156
43548,117,2690,937,2042,31589,648
45779,4,88,331,80,2848,8
8572,8,784,3244,638,6215,146
44568,123,1798,731,1559,14136,239
23106,11,698,2446,540,8285,158
33661,0,43,1932,34,6589,9
4081,14,277,3484,205,6501,72
22982,174,9795,2451,7366,78726,2429
29785,9,149,2115,116,4355,33
20091,31,1985,2609,1667,17050,318
27698,3,116,2228,97,4048,19
25505,31,579,2336,481,7103,98
11406,17,922,3090,614,17137,308
45312,2,28,493,18,2743,10
9941,3,327,3166,265,8473,62
17458,16,1117,2731,813,8369,304
9647,2,130,3179,110,2757,20
8549,67,1415,3245,1187,8341,228
28431,1,184,2186,144,14915,40
3376,9,95,3501,84,4186,11
44425,80,750,756,563,10554,187
36107,31,637,1800,503,6040,134
45876,21,440,301,324,7064,116
37973,14,137,1686,112,5001,25
26949,7,551,2270,439,8985,112
3013,80,2897,3508,2226,42533,671
4003,6,116,3486,96,3334,20
11972,0,80,3061,67,2002,13
25209,25,1177,2348,868,14883,309
43452,9,193,968,145,4799,48
4068,56,973,3484,800,20413,173
1901,22,1392,3527,997,10783,395
11052,1,63,3109,47,3015,16
22645,12,1197,2468,948,22748,249
26304,5,466,2299,345,12589,121
10970,17,666,3112,530,16235,136
22109,165,9013,2494,6697,64194,2316
13828,32,987,2936,796,5776,191
39468,12,170,1589,129,2400,41
13225,6,94,2982,67,2209,27
23209,0,16,2441,10,3286,6
2645,4,70,3514,48,2060,22
17525,281,15285,2727,11297,56567,3988
4462,34,822,3470,667,15126,155
12913,56,2374,3009,1635,21437,739
27165,16,637,2261,481,18921,156
25150,396,19838,2351,14107,100301,5731
30158,4,133,2098,122,8535,11
20002,3,238,2613,176,2518,62
13043,15,505,3000,412,16649,93
28714,129,4399,2170,3423,34723,976
34634,18,903,1894,628,14134,275
16410,20,1108,2786,836,6077,272
38016,50,1568,1684,1183,18576,385
45626,1,14,400,8,1035,6
19637,69,2304,2634,1814,11757,490
12147,5,195,3052,149,4849,46
22239,83,1628,2488,1305,17999,323
26955,15,392,2269,333,4939,59
11476,3,225,3086,175,8659,50
38114,17,685,1677,505,10557,180
6346,133,6327,3382,4530,73894,1797
2465,7,253,3517,188,9376,65
15048,3,119,2851,97,4453,22
26228,24,1182,2303,947,14098,235
26024,15,796,2312,609,7100,187
21048,8,239,2555,179,8744,60
2377,39,1344,3518,1179,16086,165
6882,15,463,3358,347,9366,116
36669,2,111,1770,92,2923,19
8566,6,292,3244,186,13723,106
41885,6,235,1337,208,4527,27
43271,13,126,1022,94,3415,32
31143,293,12823,2047,9534,62094,3289
17068,3,202,2751,177,6449,25
40075,0,106,1551,78,3383,28
3432,41,924,3500,750,18412,174
21139,56,2224,2550,1725,15437,499
34698,3,91,1891,72,3581,19
19004,41,1922,2664,1512,20857,410
18532,28,1517,2684,1138,19819,379
28918,44,2202,2159,1702,33430,500
11246,7,3300,3097,2460,18094,840
31772,18,400,2014,330,7232,70
19108,3,175,2660,116,3776,59
35090,85,4388,1869,2984,41943,1404
15282,41,2964,2839,2031,35466,933
5899,17,289,3399,242,9309,47
5174,21,1304,3437,1060,12400,244
14357,1,46219,2896,15499,6460,30720
21102,100,2471,2552,1782,13244,689
10712,48,1394,3126,964,21909,430
46104,117,3367,202,2709,20681,658
38039,67,3391,1683,2444,24130,947
23535,15,1264,2425,912,16594,352
15539,1,65,2828,50,3286,15
39651,3,127,1578,97,4174,30
6252,197,6747,3386,5305,34893,1442
45656,17,254,386,202,7191,52
3164,1,27,3505,21,2665,6
33443,2,89,1940,63,2266,26
14982,619,46321,2855,29995,152853,16326
32701,6,421,1970,314,3955,107
36676,4,131,1770,106,5764,25
30361,2,80,2085,64,2631,16
22568,1,88,2471,74,2025,14
21697,12,265,2517,239,6130,26
26537,0,67,2288,57,1865,10
34581,2,483,1898,395,8121,88
4324,52,1465,3475,1153,19652,312
5850,10,680,3402,546,14101,134
45744,193,2452,345,2067,19941,385
44608,172,2402,723,2078,25171,324
16690,55,6670,2773,4970,37124,1700
43081,14,297,1077,229,11552,68
11756,4,95,3071,83,1726,12
17266,4,148,2740,124,2432,24
39903,3,261,1562,180,4563,81
13951,9,414,2925,346,8572,68
40257,2,32,1539,28,2792,4
45591,87,650,417,576,7432,74
3445,10,1155,3500,800,21330,355
16867,11,588,2763,477,5163,111
33756,55,1454,1928,1077,13109,377
3920,2,44,3489,37,3317,7
41260,23,715,1437,548,21179,167
28129,7,360,2204,279,9857,81
41588,6,116,1390,85,5857,31
7302,1,29,3335,22,2563,7
6840,3,74,3360,62,4095,12
40182,20,515,1545,372,6784,143
7281,2,117,3336,92,1597,25
10688,62,2826,3127,2019,42870,807
28165,3,45,2201,40,3843,5
20834,0,163,2569,141,3774,22
27290,0,1339,2253,766,6910,573
43012,1,22,1098,21,2117,1
4711,3,86,3460,66,2343,20
34042,11,394,1919,320,25608,74
36381,1,125,1786,98,5968,27
45299,176,2369,498,1856,23258,513
19208,57,1144,2655,935,11067,209
3524,7,406,3498,334,19987,72
11516,2,40,3083,33,3108,7
39006,51,1437,1617,1133,16625,304
42675,70,1523,1184,1219,13477,304
5692,60,3423,3409,2364,19703,1059
2379,16,767,3518,629,9981,138
17440,44,1890,2731,1539,11693,351
41735,52,466,1366,329,12220,137
9740,5,177,3175,150,2370,27
45214,423,6101,511,4867,34934,1234
41623,8,349,1384,246,9238,103
26144,5,361,2307,295,10776,66
41423,63,821,1413,666,7913,155
28306,16,493,2193,372,4996,121
15943,160,5429,2810,4125,86814,1304
32725,103,2146,1969,1738,15856,408
36012,11,482,1807,374,8708,108
22869,318,7940,2457,5635,56063,2305
29610,3,58,2124,51,6069,7
15834,23,1318,2814,1003,7696,315
28237,18,796,2197,657,12810,139
38362,146,4337,1659,3162,19141,1175
16221,0,66,2796,47,3610,19
16915,45,2767,2761,2076,12306,691
3993,7,164,3486,135,7625,29
6862,8,79,3359,58,10311,21
19031,35,1205,2663,945,25999,260
38645,11,368,1639,311,9570,57
29605,2,137,2124,119,3229,18
6173,66,1976,3389,1556,21134,420
45403,32,813,467,641,11625,172
33885,0,152,1924,121,4385,31
39022,2,73,1616,56,1589,17
9202,5,252,3206,169,8459,83
39782,88,1952,1572,1515,19944,437
16700,59,5055,2773,3544,36718,1511
12869,221,23418,3011,13975,103705,9443
44710,62,468,695,344,6447,124
23071,0,25,2448,19,2575,6
6070,4,64,3392,51,2211,13
24289,2,101,2390,80,6036,21
25267,154,5326,2347,3949,28664,1377
33691,15,541,1931,424,18886,117
27411,9,430,2245,336,4982,94
1469,2,45,3618,36,1744,9
43034,10,249,1092,221,6623,28
5321,49,1411,3429,1088,26194,323
26143,149,2182,2307,1718,19100,464
13637,245,16503,2951,11326,127886,5177
36202,3,123,1795,103,3668,20
37677,210,6852,1708,5166,48902,1686
38440,3,81,1654,68,2621,13
12386,4,88,3039,69,3582,19
12350,25,1263,3041,1000,9638,263
23055,42,1143,2448,922,14290,221
1950,2941,143011,3526,96847,550582,46164
3012,36,790,3508,620,21634,170
13215,23,599,2982,478,10394,121
36627,0,329,1772,264,7837,65
27323,0,75,2251,64,2366,11
17457,5,276,2731,221,4661,55
17015,98,8533,2755,6257,57552,2276
35004,62,3101,1874,2368,22258,733
43309,82,1906,1011,1472,21858,434
2954,110,3454,3509,2747,99646,707
9857,162,161115,3169,59870,105979,101245
10909,3,30,3115,26,3340,4
36344,0,5,1787,4,3311,1
39291,10,269,1598,228,8723,41
2506,130,5768,3516,4482,75760,1286
5179,4,126,3436,110,3251,16
28826,7,257,2163,212,6942,45
35181,20,596,1864,478,9015,118
43600,6,105,917,85,3750,20
20832,14,426,2569,352,3977,74
16317,22,1149,2792,855,10883,294
28537,915,56207,2179,38709,149330,17498
1962,611,29764,3525,20254,189685,9510
24550,3,92,2378,81,3031,11
33340,14,587,1944,484,15308,103
24212,27,781,2394,648,5102,133
44980,13,168,615,119,3124,49
10227,5,175,3152,144,2703,31
34091,26,420,1917,354,9028,66
36985,7,273,1751,207,7857,66
6742,2,278,3365,158,4711,120
2214,378,10181,3521,7795,48637,2386
27926,41,970,2215,823,8949,147
20393,69,1354,2593,1084,7707,270
28742,202,8306,2168,6315,26902,1991
27751,45,1497,2225,1109,22742,388
23261,65,1580,2438,1215,12382,365
5991,10,152,3395,128,5238,24
42764,13,147,1163,122,4024,25
10257,430,184213,3150,60668,71044,123545
27964,24,801,2212,605,7042,196
33951,37,1676,1922,1282,28896,394
34549,4,54,1899,47,2612,7
19472,17,1016,2641,824,10494,192
15618,8,414,2823,366,8577,48
28719,14,1023,2169,797,14898,226
33013,5,144,1957,127,4027,17
23418,0,54,2430,47,2319,7
4755,19,575,3459,445,14910,130
41697,40,1661,1373,1200,19494,461
17043,7,725,2753,540,9997,185
46153,11,181,180,158,1814,23
28898,36,1515,2160,1167,7709,348
17256,31,1348,2740,1003,18898,345
27054,1,131,2267,109,3664,22
28595,3,128,2175,109,2780,19
46262,21,283,146,249,5623,34
20090,1,106,2609,84,3834,22
17983,23,2509,2707,1980,30375,529
36123,1,104,1799,76,3234,28
9194,19,1114,3207,933,12401,181
4839,280,12711,3455,8960,117226,3751
34671,66,2803,1892,2030,28733,773
5042,8,32,3445,23,3182,9
18702,9,301,2676,232,3446,69
16566,56,2864,2780,2153,33120,711
26159,0,47,2306,39,2085,8
7820,30,1642,3303,1265,82200,377
19376,0,704,2647,551,12658,153
28524,3,58,2180,49,5097,9
3690,1,37,3495,27,5899,10
22413,23,900,2480,682,9544,218
32165,23,627,1993,449,17700,178
5668,12,163,3411,97,6241,66
32120,17,888,1995,668,10712,220
24792,25,1243,2367,901,15588,342
40853,193,6720,1484,4616,85936,2104
45666,792,19467,380,12129,79209,7338
45118,0,36,553,24,1396,12
27680,18,473,2229,401,10731,72
37631,10,417,1710,323,17490,94
45869,24,297,301,231,8024,66
32995,4,135,1958,105,4307,30
8960,37,1020,3221,825,19165,195
11223,100,9270,3098,5184,61335,4086
2647,4,203,3514,178,3491,25
13331,54,2160,2974,1639,25427,521
3244,381,37019,3503,25017,152310,12002
22548,5,289,2473,224,11284,65
32949,2,110,1960,86,2706,24
43196,2,251,1045,176,4684,75
31071,1,96,2051,75,1599,21
42754,11,204,1165,180,3865,24
45441,55,568,462,429,6020,139
35378,9,717,1854,591,10363,126
21266,0,32,2541,24,1112,8
35346,88,837,1855,615,6549,222
45973,3,46,256,36,1884,10
37033,142,3630,1748,2406,48901,1224
7650,0,23,3314,21,2560,2
7082,4,133,3347,99,5659,34
24894,123,8773,2362,7164,34045,1609
11351,571,43753,3093,32541,172834,11212
45244,2,32,518,17,2485,15
33739,143,3507,1929,2550,24724,957
32931,4,97,1960,67,2985,30
1073,6,116,3811,102,4427,14
2041,245,10206,3524,7085,50319,3121
42963,19,630,1113,440,17947,190
26218,152,3883,2303,3172,21096,711
18899,1,212,2667,151,3843,61
10472,10,1388,3140,1049,6131,339
3692,12,386,3495,298,4335,88
32926,136,4372,1960,3529,22883,843
33717,6,381,1930,327,6099,54
23082,7,461,2447,362,8421,99
28791,2,110,2165,87,5924,23
36634,5,98,1772,85,3083,13
44841,45,458,652,357,4717,101
46183,0,33,166,12,1130,21
36322,13,348,1789,269,6534,79
26137,2,206,2308,164,2823,42
2508,74,2702,3516,2157,17366,545
35562,0,63,1842,52,3915,11
8763,37,2017,3232,1655,20831,362
17260,12,798,2740,608,6049,190
27278,0,570,2254,410,5640,160
19593,14,766,2636,634,9496,132
40042,3,132,1553,103,2795,29
6233,17,1069,3387,820,8515,249
2779,361,20495,3512,15834,103942,4661
44846,57,485,651,338,8415,147
30275,22,585,2091,493,12107,92
12004,10,483,3059,370,8064,113
8877,65,2023,3226,1535,11561,488
38657,60,703,1638,547,5971,156
10812,248,15233,3120,11161,57186,4072
33033,73,1094,1956,819,12073,275
3519,10,520,3498,388,11559,132
18623,6,142,2679,129,11862,13
4466,136,2454,3470,1809,49709,645
23998,101,7649,2403,5896,37207,1753
12483,36,1293,3033,1020,13362,273
30127,6,99,2099,94,1739,5
3414,8,229,3500,166,4893,63
14305,7,394,2901,271,14232,123
13113,29,2761,2996,2010,30826,751
43447,9,287,969,211,9219,76
22854,29,731,2458,568,11762,163
24387,19,901,2385,732,8198,169
2011,63,1510,3524,1039,9439,471
24299,0,2616,2389,2006,22012,610
29470,2,104,2130,85,2433,19
29970,5,565,2106,416,9950,149
44455,90,1222,751,913,20256,309
12341,2,68,3042,56,4128,12
12212,39,1103,3049,859,13009,244
16424,138,9065,2786,6915,43887,2150
42804,18,175,1150,125,3694,50
12868,9,302,3011,225,4820,77
15340,100,5555,2836,3918,25086,1637
15251,461,19449,2840,13105,109893,6344
41064,79,3521,1465,2567,31157,954
43762,194,2394,863,1916,22570,478
21955,11,459,2503,382,7724,77
16860,16,582,2763,463,4533,119
22379,22,1843,2482,1370,12796,473
32373,2,379,1983,300,4765,79
34727,1,76,1890,63,2575,13
20447,0,56,2590,50,2372,6
36225,6,173,1794,123,2731,50
7485,0,88,3325,77,4706,11
31883,15,267,2008,230,3535,37
9052,4,224,3216,182,6605,42
41244,36,854,1440,628,11187,226
1452,3,58,3631,49,3981,9
20871,7,508,2567,398,21705,110
20789,22,717,2571,541,5344,176
7101,2,103,3346,87,3387,16
22211,9,456,2489,371,4897,85
7697,9,218,3311,146,5800,72
15018,9,292,2853,249,6547,43
8630,31,2015,3241,1599,44693,416
33343,0,57,1944,48,2584,9
2609,10,526,3514,413,14821,113
10329,43,649,3147,492,10423,157
35942,31,496,1813,417,5457,79
28558,70,3591,2177,2744,21431,847
14754,44,2331,2868,1778,25432,553
18365,7,210,2690,166,10533,44
32150,87,5495,1994,4161,30485,1334
44108,179,2391,802,1462,21018,929
39647,6,101,1578,68,2357,33
3500,749,31083,3499,23319,98696,7764
35561,1,58,1842,51,3952,7
41741,39,557,1365,414,13787,143
41332,3,100,1426,80,2448,20
2169,235,11991,3522,8193,38439,3798
7573,20,425,3319,353,14210,72
22346,6,384,2483,312,7190,72
3062,25,899,3507,746,20199,153
35349,58,489,1855,390,4729,99
28090,11,1006,2206,763,24120,243
5598,75,1659,3415,1307,28898,352
15239,4,152,2841,123,5628,29
11627,125,4486,3078,3530,66361,956
5686,0,19,3410,15,2660,4
4102,8,344,3483,268,11485,76
4838,12,301,3455,218,4943,83
34448,4,138,1904,108,2216,30
18545,22,1036,2683,812,17027,224
2247,34,1576,3521,1202,16124,374
40573,70,1709,1509,1258,12131,451
6560,7,161,3372,136,12086,25
14550,40,1795,2883,1413,18588,382
39219,14,523,1603,384,15712,139
20265,69,2400,2598,1872,9929,528
4703,1082,42551,3461,28766,211636,13785
4038,1,64,3485,47,2190,17
41922,108,2753,1331,1935,31757,818
15783,1,65,2816,57,3214,8
18195,12,578,2698,412,7747,166
12864,14,849,3012,639,10817,210
45540,22,255,433,222,6288,33
19529,891,88627,2639,58516,373563,30111
8411,3,190,3255,146,3267,44
4497,6,373,3469,228,6316,145
28588,1,50,2176,36,2588,14
9625,1,147,3180,112,2941,35
2761,7,119,3512,98,2683,21
10172,89,6087,3155,4249,39362,1838
29311,16,608,2138,444,5046,164
13947,45,4837,2925,3713,36521,1124
14197,22,691,2909,537,9043,154
26221,31,1480,2303,1114,17164,366
9404,44,954,3193,749,9355,205
15134,42,3993,2847,3107,22726,886
31773,1511,57849,2013,43166,228165,14683
36865,3,169,1758,122,3375,47
15092,2,82,2849,67,3894,15
11732,82,4847,3072,3649,54851,1198
42629,18,870,1194,555,10982,315
7487,497,17583,3325,13141,97959,4442
28591,6,111,2176,97,2593,14
41715,48,873,1369,640,10548,233
41720,2,37,1369,35,2498,2
4747,35,1514,3459,1050,23907,464
30253,1,51,2092,46,1879,5
42593,37,766,1201,553,17026,213
43968,11,151,829,104,1973,47
44995,5,39,610,36,2513,3
42922,61,1737,1123,1181,10492,556
43675,15,176,891,121,4081,55
25437,2,164,2339,149,2853,15
24107,11,518,2398,426,8234,92
10201,12,201,3153,162,3883,39
14266,89,2206,2904,1728,13721,478
21913,61,1622,2506,1274,4695,348
36101,142,3465,1800,2687,27005,778
40362,4,539,1529,399,8395,140
18065,210,11104,2703,8003,37354,3101
44422,16,129,756,100,3976,29
16500,1417,185899,2783,116930,421859,68969
18025,2,139,2705,118,2658,21
39505,4,93,1587,76,7752,17
14304,315,21439,2901,15078,122048,6361
1098,4,99,3802,90,5191,9
19644,6,141,2634,107,8464,34
18185,1039,114033,2698,71256,208295,42777
33037,426,29333,1956,20652,138928,8681
42495,238,5608,1220,4067,39036,1541
9995,11,236,3163,174,12450,62
15561,21,689,2826,565,5908,124
5647,122,11204,3412,8080,69486,3124
5685,19,409,3410,322,14666,87
34155,113,9668,1916,7398,53278,2270
34239,2,52,1913,43,3384,9
6061,0,35,3393,26,4227,9
7579,6,181,3318,157,5450,24
22330,483,30474,2484,23017,153744,7457
10681,33,1208,3128,969,18426,239
42711,1,118,1176,97,8162,21
41751,49,1292,1362,988,20473,304
37633,42,414,1710,313,4126,101
10626,25,670,3131,528,14557,142
41869,113,2273,1339,1648,18841,625
11892,436,13054,3065,8955,76832,4099
13826,9,697,2937,553,15898,144
35257,47,847,1859,657,8435,190
7416,56,3264,3328,2198,35356,1066
6043,1,210,3393,184,2463,26
40109,262,7505,1549,5324,43908,2181
7624,77,4329,3316,3295,31278,1034
32767,1,46,1967,35,1879,11
46251,52,682,149,602,10415,80
39757,4,64,1573,55,1767,9
28050,84,1087,2208,816,7002,271
23178,351,31389,2443,20732,106817,10657
14774,44,3426,2867,2498,36278,928
13929,50,3454,2926,2600,33133,854
45641,18,336,394,253,5517,83
24828,4,109,2366,95,5952,14
7178,8,156,3341,124,5910,32
34037,3,105,1919,88,3336,17
40517,6,306,1515,228,6087,78
23722,1,69,2416,64,2452,5
29721,10,412,2118,339,16849,73
41558,122,1411,1395,969,15076,442
36950,6,202,1753,166,9032,36
28788,0,123,2165,93,4609,30
42608,0,0,1198,0,2096,0
45664,0,134,383,83,2698,51
20481,10,671,2589,515,13158,156
45772,33,254,333,210,5127,44
5945,12,186,3397,133,5547,53
20078,13,290,2609,239,3800,51
42979,5,173,1108,128,7626,45
34072,80,2162,1918,1562,15166,600
8857,0,73204,3227,25092,2111,48112
19159,0,91,2658,76,5148,15
45564,372,4991,422,4208,34895,783
24411,11,591,2384,406,14498,185
29863,14,408,2111,326,8232,82
31812,1,156,2011,112,4105,44
7489,10,366,3324,221,5411,145
42897,7,185,1130,133,4766,52
2513,1,37,3516,30,4798,7
41412,4,70,1415,51,4736,19
42887,8,113,1132,74,3130,39
26291,810,71654,2300,41677,242934,29977
12423,5,104,3036,89,3092,15
15353,429,21716,2836,16069,118418,5647
44783,5,136,672,82,3095,54
31824,49,1861,2011,1261,22237,600
13939,51,1730,2926,1215,13907,515
24544,30,4788,2378,3534,21502,1254
28548,140,3631,2178,2880,28373,751
28883,76,4590,2161,3410,32072,1180
35546,182,7279,1842,5256,54402,2023
4431,9862,652270,3471,327046,2298636,325224
985,46,2405,3841,1874,23648,531
28466,8,474,2184,387,13526,87
7228,124,6814,3339,4802,56078,2012
33653,22,553,1933,379,5943,174
16852,5,154,2763,117,4052,37
20787,24,903,2572,693,9369,210
1622,25,1770,3581,1337,19046,433
45627,52,417,400,375,5736,42
5151,14,126,3438,85,3073,41
42278,9,204,1263,163,5521,41
7339,11,636,3332,519,9570,117
1713,4,175,3558,142,4128,33
24688,15,662,2371,517,6884,145
3724,1,33,3494,25,2567,8
29208,18,620,2144,488,10453,132
31122,4,98,2048,89,4623,9
31575,58,1755,2024,1306,18065,449
9977,7,336,3164,254,2898,82
9313,7,53,3200,42,4212,11
23959,6,811,2405,666,14852,145
37756,46,3288,1702,2420,21813,868
34888,45,6824,1879,5280,30195,1544
21170,84,5111,2547,3997,40710,1114
39967,4,121,1558,106,5486,15
5006,19,329,3447,260,6296,69
31307,43,1050,2038,833,20832,217
15125,83,5090,2847,3456,44608,1634
10671,110,5811,3128,4450,31301,1361
19342,43,975,2648,777,7717,198
43861,18,272,844,220,5707,52
45566,50,729,421,339,5806,390
5280,1,64,3431,50,4427,14
36939,1459,67233,1754,46923,291553,20310
13400,11,173,2969,134,3086,39
6370,29,1336,3380,1106,19593,230
15921,24,1003,2811,786,16249,217
11695,2,68,3074,57,3025,11
44437,125,1658,753,1264,18995,394
23469,2,0,2428,0,2633,0
3983,86,2903,3486,2246,12241,657
45082,13,218,575,162,4242,56
31494,117,7804,2028,5898,42331,1906
7196,85,5966,3340,4451,26732,1515
42066,22,307,1308,242,7844,65
8768,23,419,3232,342,13436,77
39919,36,1320,1561,797,19463,523
999,2,50,3837,40,3450,10
32077,1,103,1998,53,2623,50
45558,16,217,423,139,2496,78
30258,61,1540,2092,1324,31697,216
30085,18,340,2101,276,5846,64
10199,3,157,3153,112,4465,45
43073,62,1150,1079,783,9092,367
43311,12,338,1010,227,10167,111
4583,38,1420,3465,1131,13046,289
22512,1,53,2474,31,3807,22
27298,18,910,2252,704,19021,206
26848,93,3243,2274,2642,19229,601
38605,36,912,1641,715,9883,197
22025,23,1714,2498,1399,19242,315
11650,1,24,3077,19,4698,5
34703,4,110,1890,84,2471,26
15136,58,2427,2846,1909,22590,518
26909,2,164,2271,134,2039,30
37062,1,84,1746,61,2988,23
26861,2,140,2273,122,14698,18
46130,7,150,190,102,2066,48
37399,9,312,1725,262,6042,50
9166,22,1109,3208,891,15657,218
27230,45,2824,2256,2230,17470,594
40933,8,465,1477,333,11715,132
38891,103,2731,1624,1838,26152,893
33665,0,115,1932,92,3169,23
32460,7,204,1980,174,3589,30
7325,4,134,3333,106,4686,28
45594,16,233,415,164,4569,69
23569,3,155,2423,122,5047,33
2924,1,392,3509,312,24013,80
42146,63,1946,1292,1504,35588,442
21935,2,115,2505,92,4547,23
28481,23,1430,2183,1022,12657,408
11620,9,282,3078,219,5350,63
2043,21,362,3524,301,7003,61
42229,104,5482,1273,4610,14278,872
36004,121,4797,1808,3826,22097,971
30088,93,2792,2101,2301,15001,491
44071,5,99,810,69,3342,30
46033,2,74,228,44,3577,30
25833,37,1557,2321,1213,25051,344
40445,171,4086,1521,3034,22675,1052
41414,10,222,1414,169,2669,53
13671,2,96,2949,78,4383,18
43095,9,114,1072,97,3714,17
7544,13,244,3321,155,9439,89
37970,7,241,1686,180,5124,61
5003,66,1935,3447,1550,21885,385
3080,56,1191,3506,930,11510,261
3205,17,636,3504,475,6470,161
15736,8,256,2818,195,6591,61
22846,742,29920,2458,22819,155791,7101
4579,61,1288,3465,957,15759,331
4815,18,440,3456,346,4256,94
32185,0,21,1992,18,1475,3
26099,12,1483,2309,1157,5778,326
4437,7,230,3471,163,4208,67
23614,60,1094,2421,835,12041,259
41912,5,382,1333,225,8466,157
6355,3,226,3381,183,8856,43
42362,2,77,1247,57,5925,20
9276,264,13710,3202,9887,63102,3823
43093,9,153,1072,116,2479,37
13217,6,195,2982,149,4762,46
31506,25,694,2027,546,6681,148
22933,3,266,2453,219,5047,47
4294,43,1962,3476,1481,23820,481
30360,0,58,2085,49,3652,9
8773,551,39562,3232,26984,155076,12578
38135,208,7035,1675,5070,59060,1965
22150,10,578,2492,447,8111,131
9264,22,554,3203,422,17014,132
33855,5,159,1925,136,9559,23
25531,44,824,2335,613,8336,211
38544,10,287,1646,245,7970,42
6600,8,475,3371,333,5523,142
4518,13,154,3468,105,4983,49
24947,0,10,2359,8,3220,2
24432,59,2024,2383,1454,12900,570
29919,17,1543,2108,1315,13551,228
6908,16,159,3357,133,4552,26
39478,0,26,1588,21,1501,5
42626,17,688,1195,458,7758,230
27932,101,5625,2214,4291,51848,1334
42587,27,987,1202,722,8953,265
33055,1,118,1955,75,3985,43
33517,3,68,1937,59,2502,9
22908,0,42,2455,34,3374,8
16862,24,1409,2763,1075,6129,334
28084,2,128,2206,110,7479,18
22662,8,416,2468,323,4066,93
27683,48,1431,2229,1139,14332,292
20926,6,277,2562,225,4964,52
40795,6,122,1490,86,2809,36
2016,145,3743,3524,2701,25923,1042
42925,7,231,1122,161,7133,70
2163,36,1405,3522,1115,11710,290
39571,29,648,1583,502,19076,146
7184,1,21,3341,14,1865,7
46223,33,710,156,602,7190,108
2865,9,351,3510,303,5990,48
45780,5,44,331,36,1955,8
3715,16,710,3494,571,35621,139
22904,574,41953,2455,29779,187206,12174
6319,54,1154,3383,895,34816,259
42292,10,440,1261,313,7185,127
11238,118,8345,3097,6112,58616,2233
27426,2,57,2245,48,2144,9
24890,87,1638,2363,1204,9919,434
23784,0,113,2414,97,10965,16
35126,18,1071,1867,881,19206,190
42999,18,340,1102,251,11913,89
28329,56,1638,2192,1350,14678,288
9282,80,2817,3202,1778,30600,1039
18749,42,1916,2674,1486,25862,430
36649,134,7031,1771,5239,43409,1792
28559,11,305,2177,244,4561,61
16861,44,2214,2763,1621,9454,593
31411,4,126,2033,104,3162,22
30059,26,2642,2102,1764,23691,878
42742,43,1031,1166,759,9898,272
4219,8,260,3479,186,5147,74
16865,23,1330,2763,953,8885,377
31884,5,384,2008,332,7302,52
14248,67,3158,2906,2504,33904,654
6517,74,2093,3374,1613,27666,480
21055,170,7508,2555,5194,28947,2314
42548,4,130,1209,100,2889,30
35685,7,103,1831,89,3814,14
2785,11,391,3512,228,12106,163
3731,499,38104,3494,27787,172672,10317
34569,35,1707,1898,1418,33553,289
1882,137,3932,3528,3208,36792,724
20250,4,370,2599,287,9579,83
28753,73,2156,2167,1681,30396,475
13332,1,207,2974,171,5128,36
31172,6,159,2045,131,3424,28
31754,101,3103,2014,2341,32642,762
5541,30,949,3418,793,39807,156
8729,1,259,3234,220,7561,39
29263,88,1642,2142,1223,11100,419
17311,3,126,2738,96,7441,30
13985,129,8855,2922,6352,160044,2503
43564,13,164,931,118,5601,46
36814,559,7787,1762,6110,30331,1677
39764,8,230,1573,181,6220,49
16003,17,786,2807,666,6728,120
43288,0,30,696,22,880,8
28800,0,33,2165,29,1822,4
33771,46,2001,1928,1375,26660,626
18474,40,3178,2686,2293,49377,885
43588,21,320,923,244,3258,76
43249,0,11,1028,7,1721,4
2125,6,113,3522,95,6521,18
22964,13,298,2452,237,4755,61
24656,31,1250,2372,985,16719,265
15819,37,2471,2815,1845,19792,626
2260,50,1476,3520,1116,15728,360
45238,40,565,519,464,7956,101
19609,44,2134,2636,1617,22239,517
31820,52,1490,2011,1182,7018,308
40083,0,417,1550,269,3547,148
39906,71,1508,1562,1141,23728,367
1877,13,513,3528,379,19847,134
10877,5,435,3117,356,12173,79
41668,274,10375,1377,7057,83976,3318
34355,222,7263,1908,5345,38263,1918
22121,7,193,2493,155,5172,38
6779,262,8194,3363,6222,87487,1972
31815,5,152,2011,120,7327,32
45912,3,33,286,27,1654,6
30145,12,250,2098,191,5736,59
33996,791,17581,1920,13477,74485,4104
3060,27,1052,3507,859,18466,193
9538,7,320,3185,252,7172,68
15030,111,12931,2852,9206,63836,3725
32947,76,930,1960,735,8481,195
31845,2,137,2010,102,2721,35
42535,23,627,1212,407,7210,220
4882,11,309,3453,248,4900,61
11690,16,1046,3074,839,6092,207
14523,54,3093,2884,2452,33031,641
42577,17,1642,1204,1220,17554,422
34541,4,436,1899,363,25260,73
40333,17,540,1534,392,13702,148
35234,98,5897,1861,4314,31076,1583
35049,16,605,1871,483,9917,122
3700,1886,95645,3494,67212,324433,28433
6265,8,67,3385,47,6440,20
25094,6,221,2353,178,2703,43
7078,5,517,3347,394,7577,123
14953,0,288,2856,206,2437,82
4757,22,252950,3459,84484,6085,168466
43027,10,490,1096,340,9581,150
22235,22,1157,2488,927,15419,230
2431,52,1165,3517,860,12232,305
24549,20,1695,2378,1351,12645,344
25997,7,191,2313,146,1929,45
25011,5,260,2357,214,6727,46
11642,4,210,3077,186,6318,24
15798,0,0,2815,0,1892,0
27632,9,190,2232,159,4902,31
13501,44,2858,2961,2184,33229,674
45456,6,101,457,72,3118,29
21305,151,11070,2540,7262,56741,3808
18212,46,3146,2697,2013,17248,1133
14781,19,682,2866,473,12384,209
2682,18,491,3514,360,10365,131
3925,47,844,3489,646,9779,198
23800,2,195,2413,168,5546,27
4379,12,208,3473,161,6038,47
20635,4,391,2581,325,5508,66
7229,56,2173,3339,1735,11283,438
3544,22,639,3498,523,10620,116
7050,23,587,3348,413,11586,174
38588,39,1370,1643,1132,14447,238
29966,9,458,2106,386,6323,72
6431,2,49,3378,42,1557,7
36694,11,220,1769,181,5088,39
9344,17,470,3197,359,10951,111
27870,13,257,2219,209,3764,48
15716,10,736,2819,583,8264,153
19788,104,6586,2625,4347,68260,2239
11337,53,4891,3094,3304,34910,1587
31061,1,131,2051,97,3333,34
5144,46,1263,3438,844,19872,419
43048,72,777,1088,619,14255,158
7717,97,2028,3310,1642,22500,386
6129,2,193,3391,148,6548,45
7083,0,60,3347,51,3285,9
31544,8,569,2025,446,7401,123
5300,12,107,3430,81,3184,26
34684,4,197,1891,155,4460,42
46364,2,73,104,48,1526,25
39636,77,1768,1579,1309,14102,459
9262,54,909,3203,793,16700,116
7126,1,50,3344,41,3520,9
39209,20,205,1604,166,3803,39
17818,125,4446,2716,3438,42256,1008
44771,7,177,676,116,3488,61
13823,32,1131,2937,872,20884,259
8887,14,396,3225,342,4436,54
15678,8,341,2821,290,2924,51
28706,147,7733,2170,5396,33170,2337
39163,53,873,1607,633,7905,240
5389,4,155,3425,133,11086,22
38476,2,189,1652,151,6913,38
30590,6,144,2072,104,4346,40
39276,30,843,1599,683,10826,160
5939,82,2670,3397,2125,25593,545
43464,151,2422,965,1873,25330,549
16312,52,3216,2792,2387,49774,829
10723,2,61,3125,55,3077,6
7952,52,1560,3289,1149,18034,411
26442,13,204,2293,129,5279,75
29194,5,207,2145,162,3969,45
36529,1,27,1779,23,1832,4
10842,119,28460,3119,19273,122126,9187
26295,7,423,2300,319,6682,104
2368,7,229,3519,187,3972,42
7051,7,303,3348,228,8667,75
16643,11,229,2776,190,6608,39
5934,11,328,3398,270,4582,58
14117,28,664,2913,517,9186,147
31720,32,1017,2016,788,8576,229
29735,182,4910,2118,3989,23634,921
2554,100,2190,3515,1786,21734,404
2457,15,480497,3517,143761,8788,336736
6472,262,9435,3376,6918,45515,2517
43838,5,53,845,40,2632,13
19098,7,392,2660,306,9644,86
20411,3,194,2592,126,5556,68
36952,14,517,1753,448,13158,69
17925,61,3472,2711,2448,34132,1024
27358,1,48,2249,45,2103,3
24030,4,111,2401,92,2021,19
25073,44,2116,2355,1666,8342,450
35890,24,1355,1816,1082,9311,273
20142,4,159,2606,128,3157,31
14623,9,281,2878,232,12349,49
30280,49,1083,2090,856,6923,227
18819,9,357,2671,294,7736,63
41538,70,693,1398,557,7614,136
1731,2,75,3553,54,3204,21
44979,16,166,615,155,3681,11
15957,9,1633,2809,1131,19384,502
9749,3,170,3175,131,3638,39
42469,2,241,1225,182,6666,59
3661,14,387,3495,327,12246,60
6143,11,797,3390,633,12452,164
2874,170,8514,3510,6532,62034,1982
10302,22,568,3149,423,13790,145
36240,38,829,1794,665,10298,164
21314,15,727,2539,522,7255,205
11343,24,675,3093,535,7520,140
4666,189,8139,3462,5944,48277,2195
21800,20,918,2512,714,2254,204
41700,112,2392,1371,1801,17434,591
3801,415,33409,3492,24242,198401,9167
35034,10,282,1872,218,5200,64
23361,46,806,2434,611,6748,195
23210,4,466,2441,361,4379,105
1885,191,7734,3528,5629,63916,2105
1844,505,30061,3529,20404,81306,9657
6588,105,3150,3371,2403,50816,747
4515,5,125,3468,102,3661,23
14521,138,5532,2884,4112,40723,1420
1985,69,3945,3525,2934,59722,1011
42481,4,197,1222,137,8842,60
19859,0,142,2621,109,3181,33
28873,5,343,2161,281,8291,62
22646,0,19,2468,17,1641,2
27555,5,129,2236,96,6505,33
16430,139,4966,2786,3782,30931,1184
14393,30,2436,2893,1780,26486,656
12772,34,832,3017,661,13163,171
11220,15,365,3098,285,7814,80
43061,5,165,1083,103,4459,62
31221,2,446,2043,334,7027,112
24594,4,100,2375,78,2471,22
6604,1,127,3371,103,3051,24
35860,2,74,1819,56,4477,18
28250,5,155,2196,130,2827,25
37165,50,2141,1740,1594,28303,547
15519,59,3374,2828,2342,15487,1032
13961,1,98,2924,84,3110,14
27889,4,198,2217,157,1767,41
32791,9,438,1966,314,3276,124
17805,4,164,2717,123,3737,41
21565,87,1211,2525,961,11382,250
46266,0,7,145,6,554,1
17140,0,67,2747,51,2505,16
39292,29,961,1598,702,11609,259
45342,136,1306,487,1096,13514,210
16494,30,1475,2783,1115,15312,360
30570,2,242,2073,179,3469,63
4575,4,107,3465,94,1889,13
27241,1,116,2256,79,4356,37
11819,3,106,3068,54,4647,52
13651,24,1334,2950,1073,19074,261
29057,4,234,2152,195,4146,39
29989,10,545,2105,408,11351,137
24089,4,166,2399,146,2247,20
3720,104,2600,3494,1818,39738,782
45492,253,4829,448,3913,46289,916
45991,3,57,249,44,2121,13
29190,2,155,2146,133,6872,22
32206,2,148,1991,118,4391,30
36953,54,915,1753,708,9948,207
30137,4,244,2099,190,5606,54
9928,21,426,3166,334,14304,92
39097,7,134,1611,105,6803,29
1799,148,9190,3531,6802,50747,2388
9769,2486,131524,3174,86264,676525,45260
7517,1,76,3322,69,2532,7
3127,48,1761,3506,1285,13028,476
30903,4,207,2058,168,3420,39
27600,17,276,2234,205,3095,71
5407,3,33,3424,29,1953,4
42862,12,384,1140,283,7901,101
43313,29,350,1010,240,5327,110
9807,89,6001,3171,4681,48741,1320
35894,381,11454,1816,8308,49824,3146
45974,49,883,256,745,11648,138
38245,0,28,1667,19,2747,9
11670,9,453,3075,353,13744,100
11993,3,136,3060,109,4190,27
39195,14,349,1605,268,6143,81
38546,199,3926,1646,3117,14200,809
43431,26,549,973,434,12928,115
43300,94,1489,1013,1106,28849,383
9305,2,120,3201,97,2820,23
44360,143,2639,762,2160,21225,479
23612,51,1611,2421,1274,11541,337
3346,98,3913,3502,2812,23848,1101
6259,8,486,3386,346,5052,140
5851,6,183,3402,103,2883,80
23518,33,4868,2426,3609,36255,1259
20391,1,82,2594,64,1990,18
42274,4,62,1263,57,2739,5
15488,17,1070,2830,788,7783,282
34550,14,281,1899,214,4181,67
43615,11,125,910,104,5950,21
2926,27,793,3509,630,7401,163
6362,9,358,3381,266,6255,92
5520,11,116,3419,100,4716,16
42820,2,185,1148,133,5238,52
15222,3,122,2841,97,3448,25
2403,79,3560,3518,2747,35614,813
4878,14,133,3453,108,2982,25
8181,85,2689,3270,2129,21827,560
9502,7,290,3187,246,4448,44
43584,45,634,924,553,10596,81
22581,10,584,2471,453,8661,131
39355,18,377,1595,303,6127,74
29331,8,1234,2137,920,13108,314
39881,7,145,1564,101,3258,44
33533,89,1777,1936,1374,11288,403
34568,8,340,1898,281,4411,59
7270,4,189,3337,143,4078,46
33591,6,182,1935,148,4873,34
7844,23,781,3300,593,34510,188
37000,1,85,1750,73,3397,12
29840,19,546,2113,459,5375,87
14688,17,882,2874,659,12408,223
41429,34,1570,1412,1197,7349,373
34051,21,391,1918,303,5812,88
4092,16,1247,3483,1005,30095,242
6515,10,703,3374,537,10256,166
5297,246,20108,3430,13794,70061,6314
7841,5,276,3301,210,3220,66
9803,0,43,3172,33,2117,10
7728,8,273,3310,183,3947,90
3420,38,953,3500,794,10146,159
33512,13,482,1937,383,10788,99
30327,99,1676,2087,1248,10142,428
33984,21,1269,1921,1041,10117,228
32759,2,88,1968,64,3613,24
15097,142,6141,2849,4390,37602,1751
23084,1,42,2447,37,3303,5
25667,1,88,2327,74,3766,14
19594,87,6180,2636,4653,16047,1527
1043,3,97,3819,85,7673,12
46224,0,14,155,8,1123,6
27631,23,953,2232,762,8209,191
34902,44,1914,1879,1512,16537,402
26206,7,171,2303,144,2903,27
45421,25,215,466,169,4233,46
31671,82,2877,2018,2289,17903,588
2033,29,365,3524,279,5525,86
45737,2,53,346,45,1784,8
34182,109,4148,1915,3199,19453,949
12329,3,70,3042,63,4743,7
19856,0,137,2622,97,2415,40
41373,106,2200,1420,1495,14206,705
43496,237,7137,955,5553,39880,1584
9743,14,444,3175,359,12874,85
39873,15,643,1565,493,12823,150
32769,2,73,1967,67,6056,6
26105,29,1679,2309,1391,19395,288
29401,12,387,2134,316,9747,71
7312,19,785,3334,624,12623,161
46151,0,5,181,4,721,1
23880,7,178,2409,145,3672,33
3090,23,360,3506,284,5027,76
7160,0,93,3342,68,4350,25
4007,4,39,3486,36,3270,3
41376,53,577,1420,447,9340,130
34368,25,800,1908,566,7811,234
9792,139,6270,3172,4581,48084,1689
15369,40,1738,2835,1386,10288,352
10486,19,1423,3140,1079,24792,344
44822,37,513,660,394,6209,119
5241,21,144,3433,117,4501,27
32983,4,247,1958,212,8280,35
16747,196,4974,2770,3716,19279,1258
3288,5,399,3503,329,5328,70
42148,25,492,1291,365,14517,127
15490,39,1819,2830,1356,19211,463
37811,43,1835,1698,1300,21653,535
6619,6,131,3370,102,3855,29
36726,31,433,1768,343,6929,90
8058,3,131,3276,103,5306,28
37197,957,17142,1737,13654,87528,3488
2988,44,3725,3508,2915,17356,810
35795,1,162,1823,138,4716,24
37418,31,426,1724,324,4383,102
42956,6,426,1114,308,6350,118
44475,42,336,749,236,4141,100
26082,28,733,2309,579,10245,154
42651,3,119,1189,78,3310,41
3160,77,2301,3505,1814,34864,487
11392,21,528,3091,368,3160,160
23640,16,711,2420,521,13289,190
36803,33,1406,1762,1069,13681,337
27364,11,273,2248,206,5042,67
13237,422,15041,2981,10785,91683,4256
43532,77,898,943,634,11623,264
39298,10,431,1597,334,7527,97
13778,30,895,2940,696,9802,199
37794,1126,34461,1699,25944,153036,8517
9763,46,1140,3174,917,11509,223
18076,16,634,2703,454,9077,180
2276,0,48,3520,37,3261,11
42302,146,3015,1260,2078,43218,937
30367,29,1539,2085,1324,6133,215
28274,114,3556,2195,2708,25874,848
19599,0,47,2636,45,1915,2
25297,30,916,2345,759,11024,157
39313,32,548,1597,383,7456,165
5703,132,3065,3409,2240,21369,825
29409,20,1481,2134,1084,29384,397
8356,167,1950,3258,1563,53950,387
2985,12,344,3508,266,3279,78
12158,15,90451,3051,23723,11736,66728
18477,101,6802,2686,4899,59633,1903
12781,17,512,3017,380,7344,132
12957,19,86109,3006,28425,8480,57684
20247,2,48,2599,40,1805,8
15044,0,220,2851,190,6179,30
25321,7,143,2344,123,4094,20
1889,118,4556,3528,3518,61498,1038
30287,11,729,2090,617,9362,112
29709,14,458,2119,350,5486,108
22543,2,0,2473,0,10502,0
15698,9,556,2820,439,9830,117
5711,0,54,3409,40,1902,14
7252,0,12,3338,10,2398,2
1628,2,85,3580,77,3853,8
44844,17,152,651,105,3028,47
33491,1,41,1938,34,2594,7
6762,55,1195,3364,953,7380,242
37989,37,2440,1685,1740,14281,700
4923,165,4894,3450,3590,79162,1304
45355,15,233,484,119,3837,114
40917,15,425,1479,337,17862,88
15579,343,19945,2825,14350,83220,5595
36175,12,266,1796,222,10607,44
20161,69,2569,2605,1965,24566,604
29289,16,375,2140,296,5544,79
45020,60,673,603,460,10013,213
29754,3,380,2117,297,9979,83
46169,25,259,171,184,3859,75
30865,8,368,2059,255,5590,113
43351,171,4246,999,3196,41940,1050
25738,9,892,2324,713,9336,179
33804,40,1178,1926,984,11155,194
24379,1,99,2386,69,2257,30
10529,1,64,3137,50,2721,14
35725,0,54,1828,45,4663,9
20766,16,1665,2574,1149,10277,516
31489,14,424,2028,371,5418,53
43883,54,421,842,349,7062,72
41475,59,1304,1405,954,27517,350
3049,29,1516,3507,1173,10352,343
41838,128,4124,1344,2879,44842,1245
6349,5,161,3381,134,3071,27
15800,7,585,2815,467,7595,118
20559,11,407,2584,300,15391,107
19574,5,319,2637,252,3651,67
4496,1,87,3469,70,4340,17
39880,6,290,1564,242,11569,48
36796,19,391,1763,302,4952,89
21534,33,1153,2527,918,7786,235
22929,14,373,2453,305,4719,68
20618,2,732,2582,576,9066,156
13283,125,8512,2978,6398,97716,2114
15717,2,273,2819,200,10503,73
33643,10,314,1933,275,4564,39
8060,10,71,3276,51,4611,20
36349,49,900,1787,689,9886,211
27563,26,608,2236,467,4408,141
17984,190,5997,2707,3969,22487,2028
30741,12,510,2064,397,3483,113
21794,155,10748,2513,8070,53669,2678
2504,5,231,3516,211,9898,20
41628,92,3153,1384,2305,24600,848
7988,59,4367,3285,3317,31943,1050
10935,944,47863,3114,33958,411585,13905
30492,29,1070,2078,821,9204,249
38068,54,1286,1680,1082,14864,204
30989,4,445,2055,389,14438,56
29808,360,16811,2114,11863,66400,4948
17706,408,17527,2720,13372,54842,4155
31706,5,325,2017,251,8558,74
24526,10,322,2379,283,5350,39
21856,295,28757,2510,20611,96096,8146
38408,10,255,1656,221,5610,34
32970,51,1436,1959,1173,35511,263
6960,1485,79191,3353,50629,495272,28562
28832,60,1152,2163,936,7191,216
38959,32,599,1619,495,7345,104
42601,1,101,1200,75,7625,26
33941,3,178,1923,126,6221,52
30648,1,39,2069,36,7921,3
22344,40,1102,2483,854,7378,248
15401,11,493,2834,384,9233,109
2713,2,74,3513,61,8110,13
25102,21,603,2353,497,13672,106
19218,9,595,2655,471,7853,124
45708,4,67,360,54,2407,13
41676,13,159,1375,112,2995,47
37971,7,217,1686,165,9951,52
30714,22,376,2066,300,4404,76
27371,9,558,2248,426,7459,132
4580,3,100,3465,81,4576,19
11982,7,167,3061,136,3799,31
34737,1,36,1889,28,1408,8
40692,58,1393,1500,1074,13893,319
10368,37,2041,3145,1583,24976,458
10148,12,917,3155,684,12233,233
4965,7,122,3449,107,6231,15
2442,5,661,3517,565,8956,96
23793,22,668,2413,537,11938,131
45188,1,17,532,8,1586,9
41693,54,1101,1374,790,12920,311
33245,3,99,1948,84,3165,15
41552,65,644,1396,490,6930,154
23750,14,395,2415,285,5843,110
36822,22,1441,1760,1152,13295,289
27337,26,1346,2250,1078,23170,268
18159,3,242,2700,189,2929,53
5374,4,718,3426,524,10739,194
43279,46,637,1020,489,16826,148
37036,8,488,1748,403,8676,85
41157,14,209,1454,159,3122,50
2722,7,108,3513,84,7463,24
15909,52,2453,2812,1948,22377,505
9835,135,4363,3170,3326,39084,1037
34987,64,3013,1875,2358,17439,655
37783,4,147,1700,117,3595,30
27675,218,4460,2229,3203,40282,1257
20320,21,1046,2597,821,24437,225
33803,0,23,1926,21,1899,2
34613,113,2455,1896,1994,26613,461
29155,11,481,2147,407,11690,74
36317,9,274,1789,222,4838,52
13732,5,213,2943,169,4223,44
28987,25,1392,2156,1052,9581,340
45932,10,230,273,141,5107,89
26596,0,33,2286,28,1587,5
18181,8,416,2699,338,3944,78
41139,13,431,1455,294,4516,137
2524,58,1167,3516,983,15265,184
40284,14,2030,1537,1528,18682,502
3111,36,4091,3506,3020,29449,1071
5258,16,751,3432,294,8084,457
38267,2,104,1666,78,3721,26
11260,203,7467,3096,5872,43649,1595
17061,9,225,2752,191,8313,34
32505,47,1183,1978,925,13009,258
43607,11,178,913,149,7414,29
3865,6,189,3491,154,20821,35
9084,53,2356,3214,1838,24946,518
8227,137,4062,3267,3064,23301,998
20480,3,442,2589,370,6576,72
5383,301,9272,3425,7272,66246,2000
5567,1,19,3417,16,2113,3
37784,3,86,1700,69,3537,17
30299,2,31,2089,27,1638,4
4582,491,21035,3465,14122,133653,6913
2349,6,165,3519,118,7892,47
42989,26,601,1106,436,11889,165
40886,35,996,1481,787,10243,209
34000,13,226,1920,181,3493,45
25983,3,501,2314,398,28017,103
5696,5,480,3409,242,3313,238
13345,67,6418,2973,4989,12353,1429
11836,13,586,3068,435,7160,151
27609,0,118,2233,89,2122,29
11792,1,85,3069,62,4881,23
6347,16,284,3381,224,5337,60
22591,51,1323,2471,961,7249,362
39451,11,355,1590,255,6189,100
45595,4,115,415,59,1838,56
28536,3,145,2179,120,3757,25
41181,42,1500,1450,1114,19152,386
15897,16,541,2812,408,9612,133
27854,1,203,2219,155,5111,48
2166,7,300,3522,211,18020,89
19806,19,778,2625,637,13728,141
32755,6,416,1968,329,9156,87
43428,92,2289,973,1536,15286,753
39406,2,112,1592,90,3879,22
6442,4,40,3378,33,4351,7
35094,12,648,1869,498,10409,150
25673,1,65,2327,49,4534,16
45043,727,12876,593,9730,84300,3146
14731,23,2707,2870,2067,19584,640
2998,5,258,3508,216,6737,42
42049,15,511,1311,401,9643,110
22134,70,7905,2493,4725,65167,3180
42746,38,758,1166,614,17817,144
36485,31,704,1781,550,14970,154
30704,6,145,2066,124,2236,21
45499,0,93,447,62,1355,31
23547,22,1051,2425,577,18317,474
22787,708,41565,2462,26426,243456,15139
15153,9,235,2845,178,5194,57
11467,30,882,3086,713,15439,169
7043,9,617,3348,508,11809,109
23239,4,91,2440,74,2232,17
16103,16,1693,2801,1255,15403,438
14988,4,138,2855,118,5863,20
30025,1,242,2104,203,9929,39
2704,8,186,3513,143,5978,43
7372,52,2146,3331,1547,50315,599
25916,5,416,2317,351,7984,65
17474,3,130,2730,113,2945,17
8880,85,3750,3226,2599,28585,1151
6087,4,96,3392,66,2387,30
31337,72,1404,2037,1079,10270,325
35871,16,429,1818,326,6516,103
2120,2,78,3523,63,3269,15
45503,16,261,446,193,5734,68
8800,10,117,3230,84,1647,33
39103,7,146,1610,119,4194,27
16418,54,3236,2786,2294,20574,942
32214,1,63,1991,53,5272,10
8441,368,15777,3253,11200,70422,4577
1892,18,1634,3527,1304,15781,330
5346,6,118,3428,97,2732,21
27382,4,65,2247,53,2821,12
44667,28,262,712,229,6955,33
11165,550,23556,3101,18331,79178,5225
24838,0,2086,2365,1572,24289,514
4564,12,442,3466,219,5182,223
18934,1,254,2667,208,7176,46
29926,33,2651,2108,1885,10574,766
7080,298,12512,3347,9111,172717,3401
30623,14,532,2071,393,11396,139
32705,30,2116,1970,1584,23684,532
8186,2,104,3269,83,2941,21
16059,0,221,2804,160,5434,61
36976,16,601,1752,476,16682,125
23468,23,612,2428,497,13310,115
18350,31,837,2691,572,6612,265
23946,120,5185,2405,3604,23193,1581
33009,10,319,1957,269,4792,50
18407,114,6806,2689,4965,21703,1841
37651,9,254,1709,203,7501,51
32297,6,183,1987,149,4085,34
28924,104,10056,2159,6842,30243,3214
41901,4,247,1334,193,5561,54
41954,222,6868,1326,4979,62580,1889
26505,7,444,2290,347,13036,97
9440,11,156,3191,131,9711,25
10295,55,2208,3149,1444,13983,764
35376,23,778,1855,656,12221,122
7765,29,669,3307,544,12809,125
25555,32,582,2334,437,5680,145
18080,7,474,2703,405,5426,69
32606,0,29,1974,21,1291,8
3959,7,323,3488,222,4307,101
32956,6,181,1959,146,5520,35
14120,6,1153,2913,947,20371,206
30343,2,132,2086,93,2375,39
7099,98,6080,3346,4021,20363,2059
7185,5,139,3341,91,4076,48
29794,102,2321,2115,1702,11994,619
20355,1,130,2595,107,10606,23
41215,30,535,1446,396,9597,139
20079,31,2055,2609,1642,31730,413
5793,62,1605,3405,1216,21265,389
951,3,126,3852,96,3941,30
23002,22,655,2451,512,9560,143
26910,4,147,2271,118,2109,29
39470,0,39,1588,33,3771,6
37878,77,677,1692,510,6002,167
46350,25,495,111,441,3755,54
15856,3,193,2813,152,6317,41
2917,107,4280,3509,3236,24764,1044
43626,0,22,907,16,2102,6
29723,0,57,2118,52,4395,5
45920,12,181,282,135,5746,46
6250,6,388,3386,304,6484,84
9266,16,509,3203,404,5574,105
3027,1864,101673,3507,64015,503137,37658
23443,3,194,2429,159,11234,35
45644,7,78,392,57,4248,21
6942,45,1757,3355,998,37837,759
32963,1,24,1959,18,3645,6
37064,31,1438,1746,1063,12765,375
15970,131,7662,2809,6002,24108,1660
23792,9,324,2413,254,3604,70
15894,2,232,2812,144,2684,88
27701,37,939,2228,705,9610,234
41103,36,676,1460,479,3423,197
34158,46,1026,1916,780,17083,246
34377,26,459,1907,381,6123,78
28186,127,4756,2200,3432,30560,1324
13848,65,4715,2935,3470,37833,1245
1939,33,589,3526,478,23234,111
11712,1,19,3073,12,2648,7
15477,13,765,2831,608,16505,157
22367,7,374,2482,298,6522,76
43525,40,299,945,248,6384,51
25459,0,1059,2338,798,15584,261
40773,17,761,1492,565,11567,196
26498,43,9673,2290,7924,14042,1749
19942,17,688,2617,564,4547,124
8652,8,366,3239,265,5931,101
6886,444,18423,3358,13717,171816,4706
15115,19,356,2847,277,7481,79
38115,4,133,1677,91,4265,42
25331,128,5961,2343,4547,45880,1414
32337,4,260,1985,223,5350,37
2805,56,1442,3511,1098,17769,344
43531,63,1107,943,871,22111,236
38058,35,430,1681,334,5018,96
42275,8,215,1263,162,3772,53
26025,3,156,2312,133,3744,23
21138,14,297,2550,245,7511,52
45306,31,336,496,280,11258,56
4446,3,49,3470,37,3909,12
9246,11,216,3204,170,6068,46
32483,5,321,1979,254,4770,67
3586,136,2553,3497,1904,26896,649
16136,23,929,2800,739,9381,190
32831,7,303,1964,206,5044,97
21467,16,443,2531,362,5726,81
6973,3,497,3353,371,13485,126
6138,6,357,3390,288,5779,69
15805,0,8025,2815,6264,61431,1761
1974,13,358,3525,293,12633,65
43007,11,433,1099,292,10383,141
33915,3,547,1923,444,5732,103
3336,10,231,3502,171,17822,60
12621,70,2809,3026,2228,24084,581
12493,0,26,3032,22,1553,4
8623,21,300,3241,223,13708,77
27726,2,48,2227,34,1521,14
20599,7,249,2583,189,3543,60
7625,50,1172,3316,964,8282,208
26096,9,951,2309,771,8627,180
9499,46,1394,3187,1119,18908,275
8703,10,143,3236,121,2557,22
10527,227,8143,3137,6247,46375,1896
34284,12,489,1911,415,3673,74
39879,6,89,1564,72,2621,17
31758,28,660,2014,510,15572,150
8542,6,243,3246,181,3447,62
39136,8,265,1609,200,7877,65
31149,3,67,2047,60,2105,7
9534,1564,85316,3186,56787,305550,28529
3016,127,7624,3508,5689,55695,1935
45338,2,27,488,19,2249,8
40530,257,9286,1514,6554,57252,2732
9200,19,237,3206,191,8378,46
2456,6,209,3517,142,24597,67
40755,0,79,1494,43,10331,36
6454,137,5685,3377,4259,34636,1426
36081,18,642,1802,493,10624,149
17300,304,9156,2738,6863,44865,2293
1803,77,1981,3531,1466,38117,515
45563,15,200,423,172,1743,28
37378,24,767,1727,618,20495,149
1774,3,68,3538,58,2159,10
13192,24,1649,2984,1330,21026,319
5140,78,1635,3438,1306,10580,329
31854,35,2622,2009,1901,38050,721
15998,150,46894,2807,32637,96803,14257
40070,0,71,1551,56,2994,15
10910,62,1814,3115,1414,27987,400
13665,5,143,2949,120,8060,23
42368,9,216,1246,173,6367,43
5160,7,161,3437,133,9672,28
28330,10,167,2192,147,3722,20
39106,26,916,1610,617,16945,299
19002,28,610,2664,436,5762,174
19048,0,42,2662,39,2136,3
44405,8,53,757,36,1800,17
8483,3,121,3250,77,2354,44
9696,5,100,3177,81,2102,19
40549,883,24679,1512,18861,110079,5818
16559,6,654,2780,510,9337,144
22948,2,198,2453,156,2743,42
5239,39,1767,3433,1371,22140,396
16822,13,1413,2765,1058,21705,355
37722,8,163,1704,136,8297,27
2040,99,3355,3524,2751,22712,604
42153,24,813,1289,557,9398,256
2308,213,16132,3520,11713,75568,4419
22718,5,235,2465,183,8146,52
42103,4,99,1300,82,2595,17
35762,208,9148,1826,6815,60711,2333
6484,5,129,3376,85,6656,44
18843,6,297,2670,233,4010,64
34497,1,179,1902,142,3712,37
28073,1,40,2206,29,4863,11
30958,2,127,2056,95,2596,32
46162,111,2289,174,1679,11499,610
4778,1,47,3458,43,2594,4
17639,5,184,2722,154,1910,30
34758,29,1022,1888,820,11586,202
12678,7,400,3023,322,19286,78
40526,172,4055,1514,3072,23674,983
45652,8,117,388,98,4704,19
44943,13,189,625,157,2585,32
32850,2,117,1963,88,4858,29
12497,1,110,3032,89,3731,21
17273,0,60,2740,53,2827,7
8743,6,101,3234,91,2984,10
20584,51,1352,2583,1011,11842,341
5131,26,1295,3439,976,8824,319
25481,0,514,2337,393,8718,121
12784,52,4873,3017,3698,55025,1175
17762,1,205,2718,148,2474,57
42670,4,76,1185,53,2439,23
37250,3,259,1734,191,6460,68
15733,1,142,2818,122,5141,20
27351,62,1248,2249,1014,10740,234
46202,2,55,160,30,1279,25
35621,1,115,1837,89,2744,26
33359,4,213,1944,190,11637,23
35696,229,15145,1830,11673,45262,3472
19585,79,2901,2637,2156,13314,745
8022,3,78,3284,65,2838,13
7244,21,645,3339,501,12678,144
24623,200,9295,2373,7076,73116,2219
14021,0,157,2919,112,9407,45
31641,8,205,2020,169,6503,36
37085,5,197,1745,164,3981,33
43765,2,83,862,50,2820,33
35832,9,432,1820,356,8198,76
16567,79,1972,2779,1535,23971,437
17906,6,610,2712,482,19635,128
7546,25,2980,3321,2147,61809,833
4404,33,646,3472,518,10164,128
20123,26,1525,2607,1267,28154,258
37012,0,29,1750,24,1919,5
15511,551,24366,2829,18798,73431,5568
34474,161,2574,1903,2068,17745,506
44044,9,174,814,123,9165,51
19205,0,60,2655,49,4579,11
2461,7,238,3517,154,9048,84
5814,54,5624,3404,3750,39750,1874
17006,151,11981,2756,9624,63553,2357
18128,187,8158,2701,6374,60166,1784
12272,23,951,3045,751,24056,200
40761,209,4644,1493,3590,51067,1054
33523,56,3811,1937,2883,39097,928
14764,22,576,2868,449,8621,127
2037,2845,142082,3524,86502,410303,55580
37449,53,1171,1722,951,13516,220
30811,4,213,2061,181,6530,32
44481,8,82,747,64,2459,18
7954,2,206,3288,159,8699,47
14742,1,48,2870,41,3210,7
17145,15,749,2747,616,22950,133
21831,13,419,2511,359,5193,60
9448,33,634,3191,502,12252,132
3658,31,991,3495,818,19737,173
22102,4,89,2494,70,3800,19
18694,6,485,2676,380,4932,105
27988,158,15458,2211,10951,89931,4507
29276,4,84,2141,67,2441,17
14810,103,2988,2864,2259,14252,729
38609,19,742,1641,517,5013,225
27102,5,125,2265,104,7988,21
13278,6,231,2979,191,4850,40
42413,17,411,1238,287,9294,124
43025,20,195,1096,139,3515,56
46101,7,76,203,52,1430,24
37680,9,222,1708,174,9782,48
33452,6,223,1940,165,6655,58
40335,22,849,1534,637,14906,212
2870,15,497,3510,418,5768,79
45278,2,33,504,20,1593,13
24302,19,524,2389,409,5931,115
12675,176,7369,3023,5811,20766,1558
36971,1,51,1752,37,2830,14
37721,50,1078,1704,774,13735,304
8752,12,435,3233,351,7604,84
6969,19,487,3353,350,7911,137
11867,2,58,3067,47,10118,11
41984,2,147,1321,108,5258,39
12523,1,73,3031,35,1267,38
40004,30,724,1555,549,8928,175
19355,42,6314,2648,4685,73134,1629
27427,128,6751,2245,4713,45211,2038
24834,138,6157,2365,4471,50851,1686
45186,9,124,532,95,4078,29
6924,68,2484,3356,1807,32504,677
31804,139,3226,2012,2232,21165,994
8084,46,1243,3275,938,28423,305
10775,90,2571,3123,1958,31568,613
6585,1,23,3371,21,3079,2
4940,84,5150,3450,3882,32510,1268
37897,62,2883,1691,2203,42783,680
16302,2,98,2792,87,4269,11
13760,206,9705,2940,7170,60832,2535
24566,4,381,2376,266,5448,115
9345,13,764,3197,583,12147,181
7688,8,176,3312,131,2722,45
9095,7,232,3213,174,5268,58
15791,3,140,2815,108,2743,32
30212,5,114,2094,97,2235,17
19587,1,50,2636,46,5461,4
1610,31,1627,3583,1328,22910,299
27982,3,81,2212,68,2206,13
36856,5,123,1758,87,2723,36
3005,213,5731,3508,4217,50403,1514
37887,57,2290,1692,1809,33892,481
34537,20,1465,1900,1156,9328,309
29210,45,853,2144,699,3173,154
42354,8,259,1249,184,3740,75
24286,18,1955,2390,1491,6033,464
34480,3,80,1903,67,3008,13
24047,0,42,2401,33,1649,9
7097,0,38,3346,32,1741,6
7273,9,336,3337,264,4558,72
40213,19,748,1543,597,13646,151
6028,2,71,3394,66,1782,5
27480,14,483,2241,315,5588,168
26611,50,2631,2285,2107,25042,524
6093,43,1489,3391,1080,14283,409
19081,32,1701,2661,1245,11410,456
29281,3,142,2141,131,5511,11
16346,31,2413,2790,1849,13830,564
22012,58,2662,2500,2066,11224,596
28216,3,131,2198,103,2282,28
26835,0,47,2275,38,2816,9
26940,15,607,2270,416,6932,191
2889,73,3347,3510,2582,23179,765
15108,4,204,2848,166,6510,38
36560,37,1867,1777,1520,14298,347
5123,17,433,3440,324,4736,109
29690,42,4440,2120,3304,30078,1136
38575,9,250,1644,210,5655,40
27160,96,6458,2261,4317,44955,2141
9886,40,825,3168,601,8851,224
17219,18,1094,2743,937,16473,157
14421,6,308,2892,221,4537,87
43383,25,474,986,316,6003,158
20080,128,6882,2609,5344,63190,1538
6486,742,73495,3376,43466,388157,30029
36246,94,2848,1793,2244,16279,604
2696,8,1675,3513,1257,16577,418
45561,13,249,423,170,3062,79
32972,3,171,1959,147,5072,24
22600,28,900,2470,663,8717,237
29566,36,1510,2126,1204,12499,306
5251,135,4196,3432,3315,34699,881
9594,0,155,3181,112,3143,43
6434,52,3512,3378,2868,27185,644
43733,13,240,872,132,4812,108
36419,10,747,1784,547,10320,200
5217,446,30602,3434,22331,114062,8271
18752,365,20104,2674,13671,109940,6433
16498,9,464,2783,359,6964,105
45208,109,1261,527,1027,10049,234
27149,208,5966,2261,4240,31767,1726
18117,9,309,2701,250,8264,59
13613,16,1426,2953,965,11558,461
8297,9,263,3262,209,3873,54
39562,2,51,1583,40,2308,11
8965,2,104,3220,79,4520,25
31459,8,324,2030,265,7157,59
15324,61,3960,2837,3192,16973,768
32354,27,1556,1984,1058,28223,498
9473,13,790,3189,581,7811,209
5848,8,364,3402,271,8769,93
17478,11,171,2730,145,2703,26
11459,125,3755,3086,2679,17769,1076
26682,3,183,2282,131,4648,52
3086,6,152,3506,113,11686,39
5661,16,487,3411,358,5006,129
35710,4,57,1829,49,2719,8
25112,9,628,2352,483,12287,145
26158,0,286,2306,224,4064,62
17594,14,1433,2724,1010,12132,423
36198,22,921,1795,703,10631,218
19063,11,865,2662,679,10484,186
35514,118,2722,1845,2165,32157,557
17833,21,1336,2715,1044,17177,292
30497,15,227,2077,188,5217,39
9146,12,478,3210,355,5241,123
45144,4,43,544,27,1532,16
26148,8,493,2307,413,5414,80
36058,29,520,1803,427,5639,93
28455,3,59,2185,52,2963,7
26300,10,144,2299,111,5419,33
9746,246,5407,3175,4006,20638,1401
42872,1,65,1137,41,2737,24
2551,19,464,3515,307,4111,157
6692,8,308,3367,231,11338,77
3855,18,1006,3491,722,8548,284
37902,11,519,1691,415,4193,104
43262,15,244,1024,176,7510,68
12556,459,20162,3030,14284,78874,5878
3921,80,1851,3489,1429,24940,422
7455,124,3910,3326,3011,67250,899
41401,20,382,1416,283,7735,99
3384,1116,68173,3501,46788,468396,21385
26464,2,75,2292,63,2391,12
37183,36,1172,1739,912,7541,260
15533,0,5706,2828,4610,49163,1096
24691,3,89,2370,68,3464,21
6967,278,32177,3353,20344,240714,11833
21059,81,4645,2555,3630,30795,1015
22044,11,965,2498,712,14169,253
24187,4,521,2395,419,7135,102
22885,11,1441,2457,1146,12921,295
10870,445,21565,3118,14206,131882,7359
8151,11,222,3272,187,10629,35
35413,17,458,1852,365,3292,93
32118,92,3419,1995,2684,26243,735
21391,34,2146,2535,1558,20071,588
30351,23,368,2086,267,3383,101
40446,203,7951,1521,5843,50280,2108
17333,101,5447,2737,3903,61475,1544
21500,28,2092,2529,1427,18921,665
3183,1,99,3504,76,4706,23
32267,88,2035,1988,1601,14069,434
34656,7,342,1893,287,6782,55
21301,4,344,2540,273,3550,71
5420,6,152,3424,132,3996,20
9666,4,0,3178,0,15807,0
39828,0,19,1568,18,2653,1
5631,17,604,3413,473,11695,131
35574,38,1004,1841,845,11394,159
35331,3,151,1856,121,4852,30
29131,19,617,2148,465,7780,152
36378,110,2612,1786,2022,27142,590
33395,24,717,1942,543,7287,174
29063,7,247,2152,197,6718,50
17402,33,1945,2733,1479,11841,466
16761,14,747,2769,623,10059,124
29041,15,661,2153,542,8639,119
16201,26,656,2798,532,11198,124
9442,116,4173,3191,3324,23791,849
36989,8,260,1751,215,5776,45
22580,23,1057,2471,856,6856,201
23142,2,66,2444,49,6231,17
20253,4,119,2599,106,2792,13
8519,4,81,3247,64,2479,17
9295,22,791,3201,632,7482,159
35578,38,1891,1840,1466,17202,425
42581,41,2008,1203,1501,29144,507
27368,35,1755,2248,1423,10906,332
27209,78,3094,2258,2335,9678,759
7676,243,10744,3313,7721,91336,3023
15307,14,509,2837,399,7630,110
3394,231,9797,3501,6859,36664,2938
39922,1,136,1561,104,3199,32
16324,98,2827,2791,1989,10665,838
26022,12,259,2312,205,2728,54
5068,18,229,3443,153,11043,76
36266,1,38,1791,29,8093,9
10610,59,3562,3132,2864,41212,698
38777,117,3422,1631,2669,14209,753
7060,129,5014,3347,3742,17712,1272
46024,6,90,234,50,2880,40
30214,40,1493,2094,1084,19840,409
29275,19,401,2141,305,6514,96
9809,187,13034,3171,8418,95094,4616
45489,12,154,449,140,3756,14
17497,639,20582,2729,13387,67743,7195
31786,22,851,2013,673,7677,178
30909,4,142,2058,115,4119,27
31780,6,394,2013,324,3712,70
9363,352,14077,3196,10407,92791,3670
44685,267,3277,706,2462,18277,815
29527,204,9816,2128,7513,76768,2303
39927,40,1719,1561,1306,17542,413
45123,187,2630,551,1611,12840,1019
45488,40,983,449,761,7594,222
41489,91,1981,1403,1514,24366,467
26936,5,129,2270,107,2753,22
7908,4,37,3294,33,2242,4
6533,4,187,3374,151,2447,36
2943,67,2201,3509,1797,87151,404
3398,12,366,3500,289,8212,77
22116,8,106,2493,91,2188,15
13550,21,827,2957,627,5804,200
20378,3,188,2594,144,3757,44
28956,11,451,2157,361,4826,90
4305,23,513,3476,349,8562,164
46323,1,11,119,8,562,3
13204,37,812,2983,578,6814,234
16367,68,5620,2789,4217,26969,1403
20645,1,45,2581,39,1636,6
35688,98,3697,1831,2763,16632,934
19288,68,4106,2651,3174,33632,932
22124,0,0,2493,0,74780,0
32007,2,115,2002,88,6156,27
20737,0,101,2576,69,2693,32
24882,32,81,2363,55,4865,26
34420,3,74,1905,54,5000,20
28184,4,661,2200,554,9240,107
19974,1155,70308,2615,45013,323578,25295
2129,20,803,3522,667,7410,136
42672,0,174,1184,129,8017,45
42713,28,456,1176,360,7657,96
15135,2,72,2846,58,3476,14
39555,1,74,1584,61,3832,13
7128,56,1204,3344,946,15531,258
36919,29,451,1755,349,7012,102
31195,2,122,2044,101,2243,21
36390,3,92,1785,64,5678,28
38333,3,73,1662,60,3798,13
30602,3,95,2072,69,3080,26
9582,10,387,3182,311,14012,76
39946,63,2621,1559,1970,20923,651
21073,3,396,2554,312,4962,84
12273,1,71,3045,56,1933,15
41295,63,1273,1431,990,15022,283
26813,8,219,2276,170,8086,49
2593,14,328,3515,245,6590,83
22348,23,1165,2483,890,9098,275
45138,136,979,546,752,12043,227
27505,3,191,2239,144,4489,47
20105,86,2049,2608,1565,13480,484
17635,8,186,2722,149,3334,37
8636,64,2731,3240,2168,22948,563
7905,7,195,3294,163,5963,32
46334,9,119,116,105,2035,14
21803,6,223,2512,180,3138,43
41272,24,1012,1435,726,25903,286
34392,7,170,1906,149,4710,21
15747,65,2599,2817,2046,9408,553
39627,67,1866,1579,1437,10150,429
6546,12,440,3373,384,11037,56
16316,687,29241,2792,22190,125412,7051
37704,25,246,1706,185,3303,61
28348,0,53,2191,48,2729,5
18669,612,21962,2677,14985,93457,6977
26282,2,127,2300,104,4145,23
30489,171,4694,2078,3649,27308,1045
44200,9,126,787,83,3767,43
28718,229,13946,2169,9998,102680,3948
26397,6,254,2294,189,5195,65
27223,3,200,2257,158,4523,42
14167,59,2376,2912,1874,26045,502
43158,18,533,1054,379,8982,154
43317,13,413,1009,310,6347,103
12614,1,87,3026,77,9636,10
42622,7,345,1195,245,7039,100
23044,70,3440,2449,2095,31533,1345
42569,7,203,1206,146,4326,57
35417,53,512,1852,408,4016,104
4231,11,313,3479,237,4533,76
10153,52,1284,3155,1057,8729,227
32293,48,1530,1988,1226,16612,304
20473,10,297,2589,228,10743,69
38291,96,3391,1665,2543,37839,848
41807,139,3262,1351,2224,36859,1038
8819,78,2889,3229,2187,17342,702
4311,632,27349,3475,19213,212422,8136
33680,5,162,1932,139,7882,23
6710,121,5738,3366,4321,51806,1417
10184,1,71,3154,54,5165,17
6948,47,1721,3354,1200,11858,521
4953,3,42,3449,23,4424,19
25759,432,30095,2324,22686,120362,7409
24443,1007,111831,2383,72283,315774,39548
24362,2,207,2387,173,9040,34
37881,3,33,1692,27,1964,6
44706,26,460,698,389,16001,71
22661,14,922,2468,649,9396,273
34816,64,1807,1883,1361,28335,446
40867,143,7518,1482,5470,79247,2048
5415,4,113,3424,84,4644,29
18985,21,1217,2665,950,22432,267
40191,6,170,1544,125,1984,45
7574,3,31,3319,25,1964,6
28803,8,145,2164,118,2191,27
3937,7,433,3489,247,4920,186
14029,38,1904,2919,1494,23528,410
13316,8,316,2975,250,10710,66
35680,3,139,1831,106,3836,33
23604,82,2000,2422,1468,23323,532
14928,61,3096,2858,2528,28556,568
32636,34,1601,1973,1171,17355,430
35190,2,133,1864,98,11313,35
12234,184,7030,3048,5358,60952,1672
40232,9,215,1541,170,3698,45
21441,136,16607,2532,11770,79816,4837
7819,7043,451578,3303,272223,1222823,179355
27682,9,424,2229,336,5497,88
6073,49,1779,3392,1242,10904,537
12525,1,38,3031,27,1416,11
44892,0,13,640,12,2005,1
11415,457,20588,3090,14477,79515,6111
40401,37,1870,1526,1407,11839,463
41474,47,802,1405,560,5508,242
32853,3,216,1963,178,5735,38
40984,3,94,1474,79,3155,15
38141,182,4674,1675,3795,34288,879
4347,24,472,3474,366,15760,106
38729,7,148,1634,106,3766,42
19247,119,4560,2653,3149,40761,1411
3936,3,218,3489,182,4298,36
11767,2,89,3070,76,9068,13
22429,127,9570,2480,6776,71185,2794
12133,3,88,3053,72,2159,16
32840,59,4532,1964,3380,45045,1152
23582,94,3474,2422,2597,39145,877
24601,2,369,2374,275,5735,94
18665,4,337,2677,276,11617,61
23141,40,1082,2444,847,5138,235
29381,43,3648,2135,2753,32313,895
20363,30,1206,2595,867,10356,339
25123,54,1560,2352,1139,7808,421
19190,6,389,2656,291,13707,98
28103,70,1160,2205,944,9532,216
27028,5,214,2268,175,3989,39
10289,102,4782,3149,3356,27796,1426
22720,88,3654,2465,2909,26103,745
42140,89,1974,1292,1275,21885,699
39070,5,118,1612,93,2825,25
12002,91,3728,3060,2836,13394,892
13422,60,1949,2968,1644,14041,305
8080,83,2829,3276,2251,28043,578
4317,54,2321,3475,1939,25204,382
43988,6,165,825,141,3963,24
31314,48,1942,2038,1537,7455,405
12408,2,170,3037,139,3318,31
1684,0,28,3565,22,1703,6
2858,26,974,3511,763,9015,211
19730,21,2811,2629,2212,26303,599
4280,9,398,3477,306,8770,92
4858,8,101,3454,78,3584,23
18792,16,806,2672,647,10395,159
14898,11,263,2860,199,4542,64
21429,59,6726,2533,4843,36207,1883
39576,8,376,1582,311,6690,65
37314,0,83,1730,60,4595,23
8570,4,186,3244,135,7912,51
29890,3,420,2109,332,12988,88
14237,48,2094,2906,1634,13930,460
2873,6,214,3510,173,5029,41
10973,12,463,3112,369,7326,94
41798,47,1006,1352,772,18772,234
32621,5,364,1973,278,4992,86
24338,38,3186,2388,1986,10781,1200
13198,10,551,2983,463,6545,88
30519,183,2281,2075,1575,14888,706
13850,7,173,2934,128,6272,45
21378,6,115,2536,90,3807,25
36022,17,352,1807,288,8598,64
20676,24,883,2579,666,17461,217
2096,41,1656,3523,1190,10041,466
17847,3,119,2715,103,3144,16
28806,0,38,2164,31,3533,7
10539,151,8665,3137,6690,44896,1975
14830,392,20772,2863,13946,130793,6826
23714,1,333,2416,282,3184,51
16044,7,559,2804,459,6610,100
23554,29,1494,2424,1204,15677,290
20347,3,253,2596,202,3894,51
2568,1,50,3515,20,3822,30
36764,39,1077,1765,774,14523,303
6103,2,154,3391,132,3436,22
3704,75,3566,3494,2706,30871,860
2384,26,1118,3518,832,17992,286
20055,1,138,2611,115,2812,23
30850,4,144,2060,117,2646,27
36401,9,211,1785,189,3070,22
24321,4,192,2389,155,4155,37
2718,23,413,3513,313,6572,100
42607,0,18,1198,11,1254,7
17597,197,10443,2724,7544,64836,2899
43916,31,289,834,233,5225,56
42994,3,193,1103,131,6101,62
17878,60,2454,2714,1856,31972,598
2414,2,122,3518,99,3854,23
5691,12,404,3410,339,4842,65
35272,393,49842,1859,35236,155885,14606
26869,7,172,2273,148,3296,24
40709,24,605,1499,427,9948,178
17965,142,10219,2709,7512,97799,2707
38743,51,1749,1633,1271,20347,478
3757,26,264993,3493,91987,27441,173006
11140,1,182,3103,130,6401,52
10480,12,926,3140,706,42361,220
16290,14,1348,2793,1068,12583,280
31258,23,920,2041,754,15450,166
4785,5,133,3458,104,2758,29
37206,1,114,1737,99,2787,15
43549,276,7172,936,5607,72818,1565
30313,90,2407,2088,1748,15629,659
1929,8,115,3526,93,8512,22
18724,19,929,2675,662,10628,267
2919,7,315,3509,248,15675,67
2778,12,399,3512,325,31663,74
11848,375,28041,3068,18142,129104,9899
23908,29,1414,2408,1138,9069,276
12230,15,798,3048,643,6046,155
36495,18,1185,1780,759,59070,426
41048,215,5619,1467,4073,51558,1546
5608,41,1567,3415,1078,16601,489
10122,6,148,3157,114,2636,34
39398,6,239,1592,168,5488,71
12528,10,361,3031,271,5381,90
18160,166,12656,2700,9477,34324,3179
42970,9,212,1111,147,9315,65
10520,27,483,3138,381,3907,102
37921,1,35,1689,28,2606,7
9165,74,2310,3208,1763,14687,547
32201,1,91,1991,82,5436,9
27365,22,1267,2248,964,7830,303
38447,39,820,1653,615,7789,205
29159,15,1083,2147,847,12448,236
36580,6,163,1776,139,9028,24
13863,18,305,2933,251,4320,54
29609,101,1576,2124,1304,21124,272
14739,91,2609,2870,2068,11855,541
11617,179,8097,3078,6173,100489,1924
31289,1,118,2039,93,3363,25
27197,29,2959,2258,2268,25362,691
29892,5,180,2109,147,5264,33
3997,9,488,3486,365,9604,123
10316,4,45,3148,38,2014,7
13472,3,44,2962,38,4772,6
43332,4,57,1005,40,2133,17
23454,28,629,2429,524,5924,105
8846,11,341,3227,255,3338,86
8205,55,1935,3268,1592,31457,343
45017,22,316,604,223,4219,93
16021,36,2140,2806,1656,27558,484
3501,7,300,3499,221,4693,79
18621,6,264,2679,215,5964,49
10254,120,3648,3151,2639,18977,1009
34386,10,733,1907,572,10824,161
24539,11,341,2378,274,4599,67
26381,12,854,2295,710,18075,144
7191,20,333,3341,286,2856,47
31578,16,271,2024,212,3732,59
22749,0,57,2464,40,2905,17
44853,12,207,649,136,8593,71
26719,283,18969,2280,13602,143836,5367
33481,2,273,1939,212,7944,61
11455,85,6695,3087,5103,41570,1592
42618,6,201,1196,161,5592,40
9273,11,477,3203,352,28682,125
17663,1,79,2721,63,5588,16
40207,1,43,1543,35,4440,8
32908,1,119,1961,82,8655,37
22563,10,404,2472,319,7753,85
12057,0,80429,3058,21797,3394,58632
12878,37,2498,3011,1836,14386,662
39175,0,42,1606,36,2605,6
10706,9,309,3126,250,11675,59
11985,1,23,3061,19,1581,4
41093,28,801,1461,650,16812,151
46196,2,43,162,31,1517,12
22238,23,895,2488,736,7732,159
27101,57,4311,2265,2998,30348,1313
13788,11,294,2939,246,7596,48
41294,59,1333,1431,1060,13257,273
39733,142,4005,1574,2951,24327,1054
11895,46,3686,3065,2783,14471,903
20525,130,3494,2586,2673,14804,821
19847,1199,45700,2622,32548,169471,13152
10679,14,506,3128,401,8585,105
23184,11,931,2443,714,12793,217
29779,14,742,2115,611,6092,131
44845,2,71,651,50,2194,21
23608,8,465,2421,342,10692,123
16842,6,149,2764,120,2917,29
36749,1,139,1766,108,2632,31
19244,13,440,2653,319,6206,121
3958,234,19984,3488,13699,87580,6285
4217,42,1605,3479,1196,29716,409
18606,16,563,2680,458,14922,105
36573,2,113,1776,88,4037,25
11964,15,460,3062,317,15095,143
31744,42,1136,2015,874,13968,262
21009,13,508,2557,397,9196,111
41456,29,588,1408,456,9512,132
26849,136,6134,2274,4812,34623,1322
25636,5,778,2329,595,19873,183
32783,21,294,1967,234,3801,60
5292,3,88,3430,63,10122,25
27825,381,10995,2220,8293,27934,2702
3785,85,5009,3493,3887,37874,1122
45290,26,322,500,265,6355,57
35970,0,18,1811,16,3771,2
38034,1,58,1683,47,4479,11
41340,23,548,1425,437,7386,111
26786,93,7334,2277,5690,54588,1644
46030,49,309,232,265,4859,44
20502,1,109,2588,84,4751,25
41830,2,77,1345,64,3256,13
29176,6,347,2146,290,5622,57
21662,17,414,2519,324,2879,90
6219,1,53,3388,40,2416,13
27728,7,300,2227,227,3397,73
13514,18,634,2960,500,20711,134
10855,136,4113,3118,3222,61536,891
37825,2320,118774,1696,82422,384439,36352
45053,2,46,589,36,1746,10
39467,5,200,1589,139,3346,61
44261,3,117,768,85,4277,32
6251,24,553,3386,398,6929,155
20532,8,480,2586,418,8918,62
27099,99,1833,2265,1460,9836,373
14735,10,390,2870,281,7116,109
12803,44,4999,3016,3839,46837,1160
20719,52,6008,2576,4746,29273,1262
16110,5,201,2801,164,2961,37
21603,60,2142,2523,1622,14439,520
21217,39,1831,2543,1416,12656,415
4248,31,1008,3478,852,13065,156
5601,8,241,3415,199,10910,42
42502,21,296,1218,212,7380,84
23993,5,428,2403,327,8066,101
28233,8,149,2197,132,3547,17
6696,570,26484,3367,18940,138605,7544
26667,81,3150,2283,2363,22350,787
7580,18,275,3318,223,6000,52
17568,9,288,2725,222,3632,66
21410,149,12809,2534,9560,64080,3249
15494,108,7659,2830,5512,38627,2147
7543,13,143,3321,123,2859,20
25122,18,224,2352,169,3102,55
29326,33,1026,2137,772,9939,254
44544,5,77,735,71,4495,6
9359,0,83,3196,72,3096,11
37220,3,274,1736,192,3506,82
28307,58,3165,2193,2470,18560,695
35360,265,20046,1855,13224,95429,6822
2347,124,4029,3519,2817,16179,1212
33253,6,379,1948,310,8477,69
13945,13,498,2925,327,9934,171
24096,3,291,2399,249,4811,42
36258,0,56,1792,39,6414,17
5352,5,215,3427,179,4127,36
4465,7,173,3470,124,5150,49
40981,1,61,1474,51,5248,10
3059,34,611,3507,435,6395,176
9741,17,986,3175,772,20024,214
32452,83,3309,1981,2605,27180,704
12999,39,1494,3003,1138,28257,356
24135,6,363,2397,299,4842,64
2548,4,206,3515,175,3770,31
16584,0,96,2779,76,6510,20
9114,100,3535,3212,2570,11473,965
40327,28,1030,1534,828,12352,202
17628,7,558,2722,403,3098,155
2108,11,227,3523,183,8169,44
8973,2,78,3220,59,4427,19
24340,32,1590,2388,1232,15167,358
29578,117,7276,2125,4985,45829,2291
30575,8,269,2073,213,5335,56
7157,3,253710,3342,74231,5973,179479
15448,26,1614,2832,1238,10533,376
8878,2,40,3226,30,2013,10
40952,1,172,1476,131,4459,41
1900,1,50,3527,42,6352,8
5110,12,544,3440,439,14571,105
3106,7,267,3506,215,5257,52
8261,499,19839,3265,13904,133032,5935
18490,4,71,2685,62,5964,9
17739,2,58,2719,46,1889,12
32937,5,172,1960,138,5268,34
10790,45,1947,3122,1405,42232,542
15482,22,1385,2831,1105,7949,280
15984,2,538,2808,429,8912,109
40639,3,271,1504,206,7169,65
35843,103,6374,1820,4444,50259,1930
7203,8,131,3340,101,3173,30
17049,1,162,2752,131,10453,31
26312,31,1787,2299,1331,23764,456
45846,19,542,310,447,5989,95
4932,13,792,3450,626,6698,166
40105,7,311,1549,237,8345,74
10244,2,187,3151,141,6316,46
23748,29,1118,2415,888,12568,230
20655,34,1720,2580,1171,15576,549
9151,285,7876,3209,5964,27916,1912
6874,61,2909,3359,1944,25039,965
18834,29,1143,2670,887,9196,256
37701,43,1545,1706,1259,8159,286
43360,127,2324,996,1926,27691,398
6977,463,21894,3353,14509,147472,7385
8587,47,1476,3243,1101,12221,375
7886,31,799,3296,652,14202,147
46127,44,652,193,570,5867,82
32969,330,14804,1959,11301,89856,3503
18104,3,265,2702,217,3575,48
41557,6,223,1395,175,9820,48
5348,3,77,3428,45,6370,32
10887,4,97,3116,73,3600,24
2090,6,232,3523,167,7305,65
4822,66,1459,3456,1100,22805,359
9304,8,593,3201,485,6188,108
36264,14,314,1792,268,2060,46
11557,8,84029,3081,28242,4760,55787
8583,23,1224,3243,985,12769,239
24445,18,730,2383,587,12378,143
5672,58,1461,3411,1118,20721,343
34680,24,427,1892,317,3958,110
37791,4,63,1699,53,4010,10
16782,3,187,2767,152,6415,35
38217,3,126,1670,100,4061,26
13232,173,10512,2982,7959,103421,2553
45596,19,346,415,261,5779,85
8613,206,8170,3242,5452,74118,2718
17167,213,39773,2745,25533,106871,14240
937,12,329,3855,267,8607,62
16864,11,229,2763,171,4997,58
36852,308,13238,1758,10012,93241,3226
6873,4,406,3359,363,7849,43
46066,1,60,212,46,1094,14
32048,50,1204,1999,905,8704,299
36713,10,178,1768,134,6804,44
4663,6,291,3462,241,6106,50
27593,8,162,2234,131,7869,31
12898,112,4225,3010,3190,57048,1035
4737,5,154,3459,109,4037,45
6555,11,299,3372,246,23375,53
40833,43,1542,1486,1087,15273,455
22058,20,3011,2497,2447,6977,564
34547,24,1780,1899,1292,28365,488
5336,25,919,3428,638,13350,281
8469,10,481,3251,339,4774,142
22297,21,774,2485,644,7289,130
22499,55,2561,2475,2063,39912,498
16683,2,47,2773,40,4491,7
30304,467,16190,2089,11446,105677,4744
35718,0,53,1828,47,5248,6
35296,60,1274,1858,987,7641,287
16898,2,99,2762,83,4250,16
38614,64,1895,1641,1456,26433,439
8220,45,656,3268,516,11751,140
30105,22,2480,2100,1795,12660,685
19112,3,54,2660,39,2876,15
32764,0,66,1968,46,3116,20
13900,1,124,2929,102,5161,22
5432,167,9817,3423,7365,90482,2452
19482,27,1223,2641,947,16006,276
28865,0,42,2161,32,2646,10
19135,56,6465,2659,4756,39349,1709
39983,16,625,1557,490,25533,135
27963,32,841,2212,662,8609,179
5571,29,571,3417,421,7813,150
29714,1,57,2119,49,3974,8
3842,16,245,3491,179,4338,66
2845,20,985,3511,798,12959,187
27638,813,16471,2232,11899,54316,4572
14253,31,1584,2905,1127,30452,457
4581,288,9788,3465,7796,84912,1992
4999,97,2289,3447,1902,15978,387
25399,51,2249,2341,1708,24721,541
17574,3,218,2725,156,4437,62
7884,37,3099,3296,2308,38263,791
12332,15,554,3042,420,3961,134
39488,0,27,1587,23,1585,4
30937,3,56,2057,43,1808,13
29836,6,240,2113,200,2967,40
14089,3,146,2914,126,4981,20
33240,8,540,1948,454,9182,86
3257,44,268866,3503,90091,8778,178775
38361,15,530,1659,383,8047,147
12299,90,7854,3044,5573,70385,2281
13252,5,427,2980,303,6833,124
17337,28,1858,2737,1254,15692,604
9953,2,78,3165,62,1447,16
4254,208,8291,3478,6088,132839,2203
23545,62,2405,2425,1830,11523,575
38747,19,2503,1633,1633,16110,870
32386,3,202,1983,168,4339,34
19866,16,298,2621,253,3058,45
42662,8,70,1186,60,2882,10
25233,47,1688,2347,1353,18989,335
24518,43,983,2379,747,7109,236
21745,7,156,2515,136,3279,20
5627,77,2639,3413,2149,34528,490
3171,14,398,3505,320,18306,78
20031,6,67,2612,59,2660,8
17253,58,2200,2740,1668,21278,532
34986,19,363,1875,304,6620,59
24113,4,126,2398,101,3835,25
30333,11,292,2087,253,7962,39
28745,88,4476,2167,3256,21287,1220
14606,0,65,2879,44,4176,21
18616,312,13985,2680,9390,85972,4595
27344,134,5809,2250,4176,48525,1633
41791,9,329,1354,285,12795,44
37441,13,347,1723,276,14425,71
13588,59,4500,2954,3367,18226,1133
14258,11,674,2905,541,22692,133
33998,2408,144758,1920,102451,396767,42307
10499,63,1883,3139,1345,18377,538
25026,5,40,2357,32,2058,8
5940,19,340,3397,265,5024,75
21671,8,196,2519,160,12079,36
8827,6,78,3228,65,8253,13
5839,0,56,3402,46,2178,10
35223,30,982,1862,788,6820,194
24705,23,844,2369,676,6609,168
18072,532,23376,2703,17231,97390,6145
42210,21,525,1277,432,11289,93
8435,293,8916,3254,6591,42364,2325
10556,11,192,3136,151,7376,41
21665,3,46,2519,40,2231,6
10105,6,276,3157,217,3634,59
14604,4,79,2879,56,4065,23
14712,39,1345,2871,1012,9440,333
2753,5,292,3512,242,5216,50
16708,72,6268,2772,4462,38249,1806
19457,669,62365,2642,42981,233632,19384
20436,23,932,2591,701,9238,231
35888,1,90,1816,79,4274,11
5065,176,5592,3444,4020,24303,1572
14020,32,2658,2919,2018,49631,640
4528,16,203,3468,175,4377,28
5993,5,200,3395,166,11318,34
40346,6,127,1532,96,4357,31
36983,2,43,1751,40,5604,3
28033,10,1007,2209,709,5712,298
43096,6,134,1072,92,3182,42
29564,80,2681,2126,2233,28409,448
9161,12,827,3209,690,6682,137
43059,29,464,1084,326,7822,138
41719,94,852,1369,589,22356,263
38728,16,235,1634,190,3689,45
34726,47,1443,1890,1135,15088,308
1810,48,1413,3531,1102,16370,311
45502,25,213,447,164,3836,49
15763,1,68,2817,58,2831,10
2607,125,5240,3514,4148,45100,1092
31827,57,3712,2010,2826,23067,886
11177,35,2043,3101,1488,54483,555
19853,4,146,2622,124,4121,22
44882,17,120,643,99,2271,21
14808,173,18610,2864,13852,147629,4758
6423,14,469,3378,374,8535,95
10503,10,290,3139,232,6564,58
15065,9,235,2850,201,5722,34
34687,2,96,1891,84,2889,12
20190,17,527,2603,420,7973,107
39871,60,1039,1565,837,7980,202
40459,6,221,1520,177,14588,44
34735,1450,45899,1889,32730,205317,13169
14907,9,174,2859,148,2973,26
27319,0,13828,2251,10701,88577,3127
26599,11,544,2286,453,10223,91
21274,68,7122,2541,5415,41031,1707
2789,2,62,3512,47,4194,15
35254,6,142,1860,119,4855,23
28037,927,40478,2209,23740,265699,16738
3418,27,1079,3500,765,5462,314
8535,8,378,3246,298,15006,80
44592,1,9,726,7,1556,2
20397,18,703,2593,581,10725,122
31064,37,760,2051,634,9526,126
32504,24,537,1978,351,7161,186
7100,17,412,3346,323,5907,89
14529,8,199,2884,169,6923,30
43047,242,8501,1088,6538,70121,1963
24444,87,4696,2383,3404,63595,1292
39681,177,9635,1576,7172,40289,2463
1517,8,275,3606,239,7033,36
23842,1,34,2411,22,3703,12
1945,63,1048,3526,785,10663,263
5227,5,137,3433,100,4482,37
39154,15,434,1607,290,6978,144
1009,22,1430,3834,1132,21905,298
7693,92,1789,3311,1306,13823,483
37502,9,338,1718,299,2703,39
3988,131,9374,3486,6934,69983,2440
3451,25,608,3500,482,16432,126
31460,13,333,2030,296,8384,37
25355,13,326,2343,259,8318,67
31981,336,7682,2003,5473,47963,2209
20041,29,553,2611,440,5601,113
44034,8,93,815,76,2536,17
41857,4,99,1342,85,2803,14
28355,17,2201,2191,1697,25688,504
5540,7,435,3418,307,4822,128
27908,10,1377,2216,1126,18989,251
37421,9,365,1724,256,3835,109
33042,14,311,1956,239,5592,72
15284,1,139,2839,111,4199,28
3464,175,6295,3499,4756,49581,1539
21595,32,2947,2523,2215,55585,732
8823,104,4989,3229,3894,40581,1095
31273,136,5788,2040,4721,28216,1067
31456,7,168,2030,135,4045,33
20381,29,1301,2594,1050,15382,251
7365,52,1686,3331,1269,28229,417
12348,15,766,3041,605,12519,161
15105,8,756,2848,593,15966,163
22276,17,1083,2486,793,12143,290
23667,157,6508,2418,4731,44331,1777
38753,0,173,1633,138,5885,35
29644,15,755,2122,601,18410,154
11711,13,565,3073,417,12174,148
42660,17,645,1186,440,7556,205
39843,569,33958,1567,24132,138449,9826
3435,15,1032,3500,735,14879,297
23905,43,5941,2408,3204,22815,2737
31009,7,291,2054,230,6639,61
20098,38,5730,2609,4027,45046,1703
21064,18,793,2555,634,5036,159
11869,5,610,3067,527,11454,83
37596,3123,100317,1713,58227,273353,42090
30633,1,29,2070,26,1970,3
13865,46,3114,2933,2169,12116,945
22898,9,369,2456,291,8550,78
7791,373,14649,3305,10847,68992,3802
25765,12,224,2323,166,3122,58
6290,3,190,3384,142,5556,48
37964,66,2392,1687,2011,31254,381
30039,4,108,2103,86,2958,22
13906,63,4907,2928,3261,37500,1646
29520,3,291,2128,229,2413,62
14235,19,428,2906,342,8314,86
8085,46,1102,3275,866,22698,236
16270,6,365,2794,296,4643,69
15558,0,129,2826,102,4295,27
36968,24,542,1752,423,6089,119
41171,101,3222,1452,2411,19892,811
29282,8,334,2141,265,4201,69
14046,59,3332,2918,2651,44367,681
38466,938,15437,1652,11780,62564,3657
1823,20,4590,3530,3619,20829,971
15849,2,155,2814,103,5686,52
37622,3,272,1710,214,7735,58
8043,801,70687,3277,46665,418007,24022
23801,2,35,2413,31,4568,4
9756,15,433,3175,333,3528,100
31692,308,19618,2017,12502,147839,7116
21486,12,490,2530,378,8938,112
39482,6,142,1588,119,8435,23
7213,8,111,3340,88,5160,23
21361,61,2381,2536,1637,11820,744
33460,4,138,1940,105,2768,33
40885,2,59,1481,52,3096,7
15517,95,7590,2829,5783,74793,1807
24915,481,14185,2361,9898,64204,4287
26627,4,90,2285,81,2316,9
32837,20,1468,1964,1181,18872,287
9377,2,115,3195,84,2786,31
9014,24,491,3219,380,7709,111
43669,0,21,893,17,1823,4
11961,7,369,3062,290,7495,79
33836,52,1512,1925,1240,23668,272
10888,5,116,3116,73,5393,43
45001,27,294,609,165,4952,129
24381,36,1497,2386,1123,16687,374
45495,17,258,447,178,5928,80
35961,65,1114,1811,839,9850,275
18649,0,0,2678,0,1236,0
9959,2,315,3164,234,3047,81
23332,12,941,2435,679,6156,262
2921,74,1225,3509,969,12387,256
15691,18,1363,2820,1043,13291,320
19003,4,340,2664,288,3089,52
21679,6,672,2518,543,6804,129
14594,6,321,2879,238,6424,83
39506,0,45,1587,38,2522,7
31068,0,50,2051,41,2153,9
9428,4,87,3192,75,3788,12
34195,34,1183,1915,885,13492,298
40221,0,76,1542,49,4487,27
28089,35,973,2206,731,7157,242
38553,13,575,1645,451,6643,124
26406,61,3981,2294,3021,19718,960
18034,19,1448,2704,1217,7045,231
14918,567,24437,2859,17067,73831,7370
44753,2,60,681,28,2362,32
15461,48,3110,2832,2456,28674,654
4080,6,155,3484,118,9597,37
16509,8,185,2782,132,5462,53
33589,58,1521,1935,1179,8674,342
2091,41,2160,3523,1570,16952,590
14870,83,6264,2861,4695,64632,1569
4479,108,5517,3469,3907,23241,1610
44197,96,1193,787,972,14533,221
15481,4,907,2831,771,14986,136
7968,6,294,3287,253,2188,41
43223,8,197,1037,129,3031,68
35549,2,207,1842,165,5556,42
18663,1,63,2677,55,1700,8
7232,60,1574,3339,1175,11551,399
38252,83,3680,1667,2598,32915,1082
30511,50,1172,2076,934,21721,238
3364,82,3673,3501,2843,22857,830
20514,61,1917,2587,1518,7799,399
37192,42,553,1738,415,5875,138
43005,19,260,1100,182,3887,78
7096,1,175,3346,147,12289,28
21764,0,100,2514,84,4213,16
4933,8,149,3450,118,3718,31
34723,51,550,1890,418,5239,132
24308,17,564,2389,446,6690,118
7183,5,66,3341,54,2399,12
26885,4,156,2272,115,4597,41
29044,0,145,2153,119,3078,26
40888,64,1194,1481,874,6975,320
43726,81,1227,873,962,20888,265
12355,13,534,3041,424,16877,110
15276,3,49,2839,41,4662,8
23416,0,103,2430,81,9412,22
39275,6,199,1599,145,9342,54
6297,9,468,3384,289,7977,179
6529,3,42,3374,35,1628,7
8782,56,1242,3231,989,13826,253
42286,4,135,1262,108,5822,27
38324,1,39,1662,34,3157,5
5413,14,212,3424,182,12077,30
12828,97,5177,3014,3761,27416,1416
41883,2,230,1337,160,6998,70
33579,1,137,1935,113,3309,24
32133,15,494,1995,372,4346,122
8696,42,1195,3236,982,27429,213
1445,0,22,3642,20,1765,2
14992,5,186,2854,139,3230,47
13851,3,120,2934,95,3316,25
20496,31,1974,2588,1522,14333,452
17477,115,13426,2730,9401,55688,4025
26057,7,304,2310,264,5088,40
15193,12,433,2843,352,5204,81
5874,35,168,3401,135,12664,33
36488,33,850,1781,670,11405,180
44932,14,167,630,152,4168,15
36995,14,343,1750,291,8008,52
46072,1,53,210,41,2030,12
36868,9,92,1758,65,2502,27
7837,196,5208,3301,3867,58202,1341
46059,15,117,215,95,2154,22
29552,3,119,2126,93,2805,26
10281,27,1130,3150,855,6788,275
35424,2,147,1851,115,6028,32
10542,14,794,3136,590,11291,204
34886,10,1092,1879,860,9331,232
21926,30,725,2505,585,4498,140
37850,425,12345,1694,8476,93169,3869
43118,6,204,1066,124,2387,80
38734,107,1817,1634,1236,32460,581
8902,17,622,3225,489,8314,133
19618,1,125,2635,98,2582,27
20299,1,225,2597,190,2364,35
39728,6,129,1574,116,3483,13
35753,103,4111,1827,3206,38000,905
40918,20,626,1479,477,11742,149
27207,43,1445,2258,1110,14262,335
19718,23,819,2630,590,7297,229
20485,60,3038,2589,2127,21484,911
33635,41,911,1933,664,13597,247
6449,7,188,3378,152,10399,36
7332,65,1646,3333,1257,22813,389
13363,0,35,2972,30,2012,5
22634,20,823,2470,586,21155,237
25868,2,86,2319,72,2196,14
16772,76,5891,2768,4689,43739,1202
16576,11,371,2779,275,4730,96
36638,25,2024,1772,1581,11805,443
34225,5,471,1914,373,5184,98
30821,2,504,2061,388,21594,116
33846,17,782,1925,639,10553,143
36229,0,49,1794,42,2427,7
30955,4,200,2056,149,5185,51
4982,8,344,3448,284,6879,60
10322,0,26,3147,22,1697,4
7703,859,32454,3311,24215,107438,8239
4372,78,2351,3473,1749,15591,602
35456,6,377,1850,278,10000,99
8821,5,263,3229,176,6668,87
36270,220,6983,1791,5327,48505,1656
2417,26,663,3518,565,21489,98
18345,4,542,2691,404,9345,138
31760,77,1250,2014,921,7635,329
2768,10,243,3512,178,3451,65
3444,2,23,3500,20,2409,3
22947,10,393,2453,289,5661,104
31991,93,2164,2003,1550,13623,614
17308,3,61,2738,40,4437,21
27404,1,52,2246,46,2522,6
27738,117,10216,2226,7393,62821,2823
3697,0,27,3494,24,2566,3
36336,129,8610,1788,6769,32884,1841
45646,186,10362,391,6576,65376,3786
29356,31,652,2136,502,10240,150
36709,26,1194,1768,897,12322,297
2872,2,75,3510,60,7588,15
4168,1,47,3481,41,2311,6
41447,182,2907,1409,2075,17770,832
44797,12,135,668,99,5071,36
42886,73,2251,1133,1721,21479,530
43639,41,678,902,546,9409,132
18553,66,2076,2683,1663,22016,413
23834,135,59410,2411,40284,95039,19126
42489,47,1144,1221,839,19590,305
14316,106,4671,2899,3543,28554,1128
40615,22,885,1506,688,12218,197
7616,5,231,3316,198,6575,33
21883,1,192,2508,151,3264,41
34933,19,324,1877,247,4896,77
32231,2,149,1990,127,2930,22
35434,456,12189,1851,8944,93096,3245
13444,143,5947,2964,4129,55102,1818
30578,33,1214,2073,942,5914,272
12924,3,199,3009,165,5179,34
29165,1,86,2147,76,3903,10
37359,0,0,1728,0,5449,0
29782,2,55,2115,48,5166,7
14975,33,1620,2855,1260,18132,360
43477,38,434,961,350,9613,84
18250,12,499,2695,368,4073,131
21227,218,12227,2543,8750,55129,3477
37435,1,39,1723,31,3787,8
45187,0,40,532,30,1862,10
35934,2,56,1813,48,2781,8
1843,606,19372,3529,11351,76089,8021
22294,11,261,2485,222,4363,39
6491,28,540,3375,439,9513,101
5180,28,493,3436,403,12586,90
40943,76,2310,1477,1620,16811,690
22585,4,296,2471,241,4735,55
36185,10,220,1796,167,11292,53
12036,46,2010,3059,1564,8374,446
2070,42,1639,3523,1363,31468,276
43934,9,106,832,91,3158,15
16453,2,63,2785,54,3439,9
26937,3,263,2270,215,6074,48
29750,30,1602,2117,1321,8772,281
2810,11,209,3511,173,5830,36
9645,52,2927,3179,2376,22726,551
42108,20,458,1300,380,12391,78
9717,33,1349,3177,971,11907,378
45253,94,1227,513,1004,9271,223
3859,1,46,3491,40,2097,6
9716,5,134,3177,110,10721,24
29218,6,833,2144,537,7343,296
1313,1,208,3727,171,4412,37
20301,7,666,2597,540,16794,126
7023,21,355,3350,306,5633,49
7272,6,118,3337,100,2136,18
36629,60,660,1772,501,6074,159
25809,1,81,2321,62,1718,19
27068,0,276,2266,199,4722,77
43820,9,111,849,93,4574,18
34065,3,166,1918,127,3426,39
30357,67,1632,2086,1204,11039,428
21597,9,298,2523,225,7718,73
42330,5,130,1254,103,8039,27
2454,60,2629,3517,2084,37268,545
39373,21,878,1594,617,16797,261
17837,48,2722,2715,2017,12381,705
8548,9,451,3245,332,4793,119
42293,4,44,1261,35,2855,9
41590,30,1642,1389,1169,31366,473
38185,1,77,1673,65,4208,12
44460,54,797,751,576,10218,221
35793,0,20,1823,16,1473,4
14417,125,4757,2892,3438,49205,1319
39469,10,1164,1589,829,13124,335
6574,10,113,3372,96,7213,17
11145,36,1354,3103,976,12264,378
39337,1,58,1596,48,3691,10
9311,22,1189,3200,1009,9933,180
20670,388,28073,2579,19783,175010,8290
44296,1,75,775,58,2231,17
37961,4,126,1687,98,3181,28
19949,87,5820,2617,3898,41504,1922
12813,6,237,3015,192,8350,45
9615,5,136,3180,113,8302,23
43321,15,344,1008,274,6005,70
44942,15,318,626,276,5898,42
19373,153,7462,2647,5052,72449,2410
3265,3,95,3503,81,5182,14
21550,3,121,2526,87,2031,34
12673,26,1429,3023,1135,18857,294
31270,5,175,2040,147,5889,28
32035,10,287,2001,210,14489,77
17088,64,2007,2751,1452,22664,555
21888,7,301,2507,233,3490,68
3730,141,8770,3494,6736,104370,2034
15807,2,91,2815,65,5556,26
1480,0,12,3617,10,1505,2
1694,15,416,3564,330,5600,86
35679,86,1688,1831,1260,18984,428
19558,7,430,2638,325,7074,105
4330,48,1206,3475,895,33620,311
34909,5,143,1878,118,3993,25
34564,20,362,1898,263,4091,99
31848,32,889,2010,702,9703,187
33206,6,138,1949,113,2931,25
18184,303,22049,2698,15923,138948,6126
15749,3,918,2817,624,14104,294
45427,71,945,464,771,19097,174
4590,95,2613,3465,1996,16165,617
1639,1,56,3576,48,1613,8
45643,43,556,391,338,7044,218
8246,7,385,3266,267,7452,118
10444,30,1343,3142,1082,13707,261
2774,23,401,3512,356,7906,45
42160,29,676,1288,441,15617,235
3150,111,3518,3505,2647,34621,871
40878,23,435,1481,342,13081,93
16670,7,112,2774,96,2022,16
3832,31,1080,3492,832,12071,248
40059,8,131,1552,97,1943,34
22687,4,274,2466,200,2752,74
38478,6,326,1652,269,10477,57
30782,6,400,2063,285,11538,115
6299,11,603,3384,457,14492,146
8161,28,1420,3272,1109,15437,311
32097,6,260,1996,189,3444,71
38413,135,4035,1656,2962,21725,1073
34937,18,700,1877,563,17073,137
11949,62,3047,3063,2205,51238,842
44046,71,886,814,709,46411,177
8707,53,968,3235,775,12280,193
13696,3,262,2947,203,4998,59
11083,28,630,3107,480,4361,150
22295,27,1689,2485,1162,15359,527
21074,74,2777,2554,2229,47781,548
9721,46,1208,3176,980,39323,228
40415,295,7387,1525,5210,37775,2177
37483,12,599,1720,475,19894,124
45127,77,1471,550,1050,14696,421
32762,1,20,1968,18,2150,2
16291,108,7734,2793,5434,125720,2300
34490,6,218,1902,180,11741,38
45731,4,52,348,30,1854,22
3385,59,3424,3501,2299,13382,1125
27725,1,126,2227,109,4354,17
28817,43,1118,2164,858,18014,260
6883,12,246,3358,180,3477,66
22361,8,166,2483,125,2457,41
42747,78,555,1166,419,7676,136
37883,80,1289,1692,957,8486,332
18122,7,277,2701,213,4622,64
11261,747,52132,3096,36241,150492,15891
19184,2,131,2656,109,15457,22
6230,32,569,3387,478,5060,91
9892,9,164,3168,143,4535,21
29038,141,3974,2153,3203,30800,771
23174,7,432,2443,322,8549,110
24692,2,164,2370,127,2239,37
34850,6,134,1881,108,3002,26
22214,39,874,2489,698,10768,176
42055,0,44,1310,28,5400,16
11629,53,2838,3078,2265,29125,573
7358,17,622,3331,455,11828,167
42692,44,1173,1179,912,21869,261
12667,10,505,3023,386,14329,119
34627,14,304,1895,236,7308,68
30408,7,223,2082,183,5384,40
26700,40,1453,2281,1162,9351,291
33912,7,177,1923,145,4602,32
6827,17,345,3360,250,21851,95
11720,18,509,3072,398,3186,111
21302,9,389,2540,293,4960,96
7285,137,6204,3336,4567,55764,1637
3780,6,57,3493,48,6595,9
30530,17,609,2075,493,11778,116
24866,20,523,2364,428,3149,95
24514,2,199,2380,159,4691,40
22047,0,86,2498,69,2538,17
6642,6,268,3369,191,5410,77
36987,90,3406,1751,2390,25318,1016
24902,35,1478,2362,1257,20499,221
35073,10,458,1870,385,5118,73
7166,257,6575,3342,5184,158018,1391
23534,35,1676,2425,1161,20016,515
28626,42,2282,2174,1753,16751,529
37431,1,43,1723,39,2881,4
45553,130,1383,426,1010,10832,373
35455,44,459,1850,359,4478,100
33794,5,226,1927,187,3478,39
11875,34,1773,3066,1324,13933,449
40230,266,9522,1541,7064,64128,2458
35002,0,49,1874,39,1961,10
36018,92,4444,1807,3152,42078,1292
15198,3,351,2843,275,7150,76
40771,37,681,1492,479,7798,202
37643,2,45,1710,39,4313,6
1126,4,244,3796,209,5798,35
11918,20,789,3064,606,8527,183
31890,3,78,2008,65,1921,13
23102,32,7068,2446,5326,82341,1742
31874,0,138,2009,116,2948,22
15271,8,517,2839,419,8858,98
4694,3,397,3461,328,6473,69
20592,2,59,2583,48,2194,11
21229,7,114,2543,89,2132,25
33583,13,701,1935,593,6771,108
35241,8,178,1860,136,3051,42
5228,13,288,3433,227,6569,61
24647,298,11969,2372,8840,51338,3129
9563,17,742,3183,597,9634,145
37567,5,504,1714,434,11442,70
33475,478,7540,1939,5529,30247,2011
15527,6,139,2828,120,3289,19
31212,26,595,2044,448,6405,147
2218,6,114,3521,86,3100,28
18092,25,705,2702,566,6227,139
38146,16,666,1675,532,10007,134
3774,933,31778,3493,23137,138562,8641
10496,2,235,3139,181,8339,54
46163,51,907,173,743,7294,164
15430,4,307,2833,243,4992,64
7076,6,174,3347,151,10437,23
8918,5,99,3224,87,2149,12
42586,206,5483,1202,4146,27075,1337
1791,23,416,3532,342,7758,74
41378,15,347,1420,237,6161,110
35197,44,768,1864,632,5493,136
42829,14,331,1145,230,7900,101
20715,58,5014,2576,3808,32867,1206
24246,34,1831,2392,1386,21322,445
9113,32,1640,3212,1265,14492,375
1933,222,11428,3526,8022,66985,3406
37813,38,2229,1697,1559,21831,670
25453,0,400,2339,329,13551,71
33994,95,2562,1920,1962,12561,600
44066,103,2010,811,1613,17522,397
11054,153,24490,3108,14522,185854,9968
4020,17,400,3486,276,22245,124
39259,2,59,1600,40,2473,19
45242,161,1616,518,1246,14395,370
43072,367,6179,1079,4700,43457,1479
42744,46,434,1166,339,6557,95
31810,7,139,2012,119,3949,20
23621,22,734,2421,585,11255,149
30161,1,55,2098,47,2743,8
38257,106,4933,1667,3051,45551,1882
38256,54,1170,1667,988,10015,182
40178,0,28,1545,21,2848,7
44946,86,880,624,751,11620,129
2000,20,1067,3524,832,11800,235
43437,31,335,972,273,4146,62
18356,5,82,2690,70,3607,12
43051,43,409,1087,333,6559,76
19660,19,1450,2633,1064,16158,386
4036,165,6871,3485,4650,84253,2221
4209,52,1271,3479,963,20850,308
18714,7,272,2675,212,3812,60
43088,16,265,1074,201,4016,64
16887,15,1189,2762,931,10302,258
25619,0,67,2330,63,5372,4
29265,38,795,2142,625,8370,170
20897,12,900,2564,754,26176,146
6953,49,5860,3354,3939,89057,1921
14477,179,9595,2888,6449,52785,3146
35025,148,5113,1873,3845,42535,1268
12810,11,355,3015,286,6224,69
25854,2,37,2320,28,2172,9
21306,84,3837,2540,2829,41004,1008
41583,17,684,1390,483,10107,201
22313,8,305,2485,257,4193,48
45058,46,606,587,500,10452,106
45309,0,52,495,25,1503,27
43779,27,330,857,268,5536,62
31008,10,144,2054,115,2576,29
2674,6,141,3514,117,6813,24
40039,10,207,1553,157,3168,50
39524,2,75,1586,39,3330,36
15463,1,59,2832,48,7758,11
38902,95,1507,1623,1180,13309,327
2688,4,58,3513,47,2177,11
17512,1,44,2728,31,2306,13
20324,20,1590,2597,1263,26018,327
21056,3,149,2555,101,5522,48
9567,5,160,3183,124,4996,36
28522,5,192,2180,157,7792,35
40576,41,781,1509,560,5007,221
4021,4,283,3485,226,6804,57
28337,20,915,2191,705,10956,210
9644,20,1031,3179,803,14685,228
27171,123,2238,2260,1647,10860,591
36280,3,82,1791,63,6359,19
30677,51,2118,2067,1644,50061,474
38738,47,1455,1633,1128,16621,327
5695,118,3169,3409,1901,9267,1268
38980,298,11345,1618,6882,38647,4463
44070,3,31,811,21,1588,10
36161,17,417,1797,316,3759,101
31709,21,542,2016,431,8551,111
41175,1,38,1451,28,1473,10
22881,15,632,2457,499,7405,133
18863,15,542,2669,436,5034,106
24608,3,197,2374,160,5382,37
12980,129,12241,3004,9501,70049,2740
29716,4,137,2119,104,7345,33
10869,5,255,3118,211,7472,44
35089,0,40,1869,37,2307,3
41271,123,1450,1435,981,13473,469
4905,144,6357,3451,4591,42802,1766
43087,18,322,1074,258,8248,64
10718,66,3625,3126,2832,28958,793
33753,2,84,1929,61,3253,23
28711,135,2861,2170,2255,15020,606
2788,7,92,3512,81,4178,11
26625,44,1697,2285,1296,13293,401
2903,9,157,3510,131,4288,26
8934,12,306,3223,232,6234,74
29577,2,129,2125,116,3118,13
16420,8,266,2786,226,3381,40
28419,1,37,2187,32,3245,5
14557,15,42664,2882,12077,6459,30587
11864,17,770,3067,599,12587,171
13994,58,1992,2921,1426,12879,566
27950,0,156,2213,129,2831,27
7930,306,10300,3291,7239,72684,3061
13673,57,2182,2948,1576,14014,606
21663,0,114,2519,92,2333,22
39415,316,3902,1591,3076,25256,826
33034,2,70,1956,53,3193,17
26515,28,1540,2289,968,11258,572
38009,19,527,1685,444,5595,83
40366,18,693,1528,472,12892,221
46209,0,12,158,8,2139,4
4008,4,82,3486,72,2286,10
25748,51,1094,2324,819,8158,275
39569,5,281,1583,222,6451,59
21925,156,7084,2505,5017,59107,2067
23741,12,535,2415,381,5505,154
7341,238,7081,3332,4932,37172,2149
40832,81,1862,1486,1467,25271,395
27482,2,348,2241,252,4745,96
32927,15,301,1960,246,2715,55
23162,126,2028,2443,1659,15356,369
31823,3,141,2011,104,3394,37
29477,2,90,2130,79,2976,11
8502,100,6012,3249,4707,77814,1305
33110,81,2769,1953,2180,14462,589
26895,2,133,2272,97,8500,36
15168,199,8368,2844,5675,33895,2693
42399,65,2600,1242,1937,27644,663
31368,2,64,2036,55,3924,9
12949,1,82,3007,46,2325,36
32580,3,192,1975,169,4037,23
3365,12,196,3501,165,4070,31
8228,25,1406,3267,1066,16232,340
5247,8,195,3433,151,5144,44
13747,38,2291,2942,1679,49656,612
13387,15,727,2970,611,10033,116
18334,0,441,2692,295,2559,146
45130,13,149,549,119,2263,30
42596,12,400,1201,308,7674,92
35978,230,24816,1810,18921,100790,5895
15088,79,5156,2849,3695,46225,1461
33241,14,748,1948,597,10331,151
19095,14,558,2660,426,10491,132
8835,12,141,3228,119,3448,22
39981,35,861,1557,649,9722,212
14969,35,1230,2856,906,19473,324
24853,35,2090,2364,1603,30939,487
26043,2,352,2311,219,2631,133
4420,36,1177,3471,909,34035,268
20693,267,12906,2578,9322,102440,3584
1806,29,594,3531,485,8353,109
14959,1,41,2856,33,2322,8
5941,1,31,3397,26,1993,5
19715,34,3944,2630,2873,31780,1071
30771,81,2700,2063,2204,14284,496
24163,1,107,2396,89,5130,18
43002,16,349,1100,206,5916,143
8498,87,2663,3249,1923,48796,740
39899,7,138,1563,109,6219,29
15376,33,675,2835,565,12208,110
42520,1,129,1214,86,2394,43
45063,22,277,582,241,6117,36
35863,20,1682,1819,1027,16280,655
25095,28,867,2353,690,13041,177
6448,146,7820,3378,5263,20636,2557
4113,2,61,3482,51,4045,10
24309,0,4624,2389,3482,24897,1142
9767,43,1539,3174,1073,11667,466
18846,621,36526,2669,26896,163757,9630
25884,2,163,2319,125,2618,38
7190,314,15400,3341,11273,55013,4127
45347,3,43,486,36,1348,7
35708,0,65,1829,52,4808,13
11319,4,246,3094,205,6178,41
37552,0,53,1715,40,2381,13
26416,2,135,2294,108,4161,27
37233,1,219,1735,183,6333,36
7761,9,180,3307,142,2443,38
24989,162,5626,2358,4012,59121,1614
19445,165,10479,2642,7548,33666,2931
17487,29,1736,2729,1349,55227,387
15164,78,3555,2844,2879,25679,676
12753,12,227,3019,181,4165,46
12354,1,54,3041,44,3163,10
16087,71,3386,2802,1860,16187,1526
5302,111,3232,3430,2465,35017,767
10954,96,2394,3113,1828,45979,566
42633,25,434,1194,330,11654,104
13610,36,1986,2953,1622,34176,364
35651,1,31,1834,29,2967,2
32512,304,11904,1978,7251,81850,4653
37685,8,94,1707,76,1750,18
39284,17,1067,1598,818,12987,249
3971,15,321,3487,261,5431,60
31220,3,87,2043,74,3282,13
27201,9,778,2258,580,9871,198
13180,25,1591,2984,1205,24167,386
7970,2,117,3287,76,4503,41
20402,7,553,2593,440,11612,113
17849,4,116,2715,91,5885,25
5353,11,249,3427,191,12520,58
38669,22,337,1638,271,14620,66
9638,0,85,3179,67,4884,18
11934,16,692,3063,545,15670,147
3685,29,1728,3495,1299,32545,429
31668,350,20252,2018,14625,79042,5627
43490,160,4419,957,3901,27152,518
17099,1,537,2750,382,11706,155
19869,5,247,2621,191,5842,56
36966,266,3875,1752,2924,23334,951
29250,65,2946,2142,2132,26609,814
18494,28,1505,2685,1123,11437,382
40263,17,394,1539,316,7445,78
26891,6,557,2272,486,6664,71
23091,0,759,2447,546,4988,213
20362,3,405,2595,313,10818,92
45178,7,118,534,80,2617,38
18670,7,645,2677,411,5811,234
7310,3,121,3334,98,3488,23
30374,16,426,2084,333,4028,93
10927,9,350,3114,273,8938,77
28009,31,437,2210,369,4971,68
38259,9,705,1667,526,12006,179
13287,13,1307,2978,971,8943,336
10061,11,240,3159,184,5419,56
29483,9,986,2129,740,18484,246
29763,9,253,2116,205,8233,48
39526,3,186,1586,154,5516,32
20518,2,67,2587,55,5727,12
21905,20,933,2507,729,10158,204
11998,226,11061,3060,7746,76544,3315
38774,35,793,1631,667,9664,126
29548,4,252,2127,208,3677,44
28474,2,82,2184,47,3182,35
34015,11,369,1920,306,8699,63
35869,8,401,1818,331,5806,70
42455,2,111,1227,64,5517,47
7533,36,867,3322,601,6902,266
41540,12,136,1397,111,7213,25
18605,19,1372,2680,1081,17163,291
29601,29,1633,2125,1206,18685,427
18753,0,103,2674,85,5710,18
40909,136,3445,1479,2594,28460,851
37408,17,353,1725,288,5189,65
42993,7,215,1104,167,11704,48
26350,1,159,2297,134,2539,25
10415,9,535,3143,415,7565,120
9651,3,57,3179,38,6693,19
35504,7,287,1846,225,7008,62
9099,1,26,3213,22,1302,4
17743,338,25005,2719,16416,126922,8589
24076,1,154,2400,132,8290,22
15236,40,2852,2841,2080,42053,772
6795,232,9031,3362,6331,46329,2700
7326,51,2089,3333,1707,22801,382
28288,599,26214,2195,17181,156429,9033
39921,2,134,1561,103,3319,31
17583,99,8092,2724,5116,43742,2976
31636,153,4580,2020,3485,24437,1095
30615,13,625,2071,434,9176,191
14569,155,5214,2881,4121,26707,1093
20419,31,2541,2591,2086,20225,455
30336,63,2059,2087,1506,21447,553
26702,0,18794,2281,13619,88243,5175
36834,14,280,1760,217,5312,63
34699,2,83,1891,69,2776,14
21530,27,1288,2527,961,12274,327
10897,4,57,3116,52,3553,5
35758,4,201,1826,175,3626,26
21513,5,278,2528,208,6420,70
7320,2,111,3334,82,2299,29
45343,208,3665,487,3082,26583,583
8950,94,6428,3221,4424,30095,2004
44807,77,1086,665,961,13114,125
43790,40,321,853,262,6539,59
1833,16,277,3529,223,6584,54
36930,4,176,1755,149,7821,27
4338,47,1465,3474,1230,23660,235
38646,6,207,1639,156,11201,51
15374,21,2584,2835,1972,12647,612
43091,10,90,1073,79,4753,11
11581,359,15071,3080,10832,46022,4239
45139,28,298,546,169,5274,129
15974,10,497,2809,402,5176,95
44791,66,534,671,393,15480,141
24342,42,2119,2388,1484,15243,635
39630,13,495,1579,375,10902,120
29147,2,197,2147,172,4651,25
28928,9,1124,2159,725,9758,399
4118,94,4820,3482,3826,67646,994
38247,10,336,1667,242,7130,94
2944,41,1133,3509,879,32111,254
32417,24,823,1982,655,17719,168
10560,2,71,3135,63,1569,8
31241,8,98,2042,90,5140,8
29783,3,126,2115,100,3886,26
21546,720,67030,2526,44416,266396,22614
45925,66,1042,279,817,5629,225
10868,2,82,3118,65,1981,17
32594,58,4468,1974,2829,14246,1639
19429,34,1582,2643,1213,25754,369
28975,339,11048,2156,8314,53943,2734
44950,10,132,623,113,2787,19
43078,25,637,1078,450,7727,187
11839,3,189,3068,159,12555,30
9737,12,445,3175,266,9180,179
44521,0,20,742,15,1882,5
44229,47,381,782,312,5599,69
16105,20,1045,2801,826,8662,219
4714,146,4473,3460,3292,31045,1181
9169,253,15161,3208,10907,90902,4254
24590,0,10783,2375,8173,37892,2610
31219,3,209,2043,150,3331,59
11028,8,233,3109,150,11571,83
7407,4,128,3329,111,2393,17
35935,12,329,1813,272,5969,57
17163,14,740,2746,550,10797,190
20224,84,3351,2601,2701,24208,650
34512,20,697,1901,520,9257,177
26116,88,6286,2308,4432,35756,1854
29569,630,16982,2126,11828,87186,5154
28012,55,1058,2210,852,9758,206
22551,43,8272,2472,5519,12920,2753
8116,9,213,3274,144,4449,69
35902,8,486,1815,404,9399,82
41539,205,6310,1397,4771,34755,1539
34465,266,9169,1904,6614,44657,2555
32462,2,144,1980,121,13545,23
16927,37,1175,2760,914,22381,261
27930,2,80,2214,66,2205,14
8644,25,856,3240,644,10651,212
9238,84,1450,3205,1106,36984,344
46316,4,84,121,69,3145,15
33614,31,1365,1934,905,14482,460
35153,2,115,1865,95,1962,20
9676,19,1436,3178,952,19724,484
24700,10,231,2370,176,6917,55
31304,20,1483,2039,1093,15905,390
29420,16,827,2133,676,5834,151
8039,35,807,3277,640,30242,167
31629,8,398,2021,301,3671,97
15084,13,799,2849,624,11334,175
40533,17,560,1514,434,16244,126
16729,2,314,2771,253,10929,61
29052,5,51,2152,43,5188,8
38942,7,450,1621,346,15323,104
23803,65,1780,2413,1308,14303,472
17998,12,703,2706,560,5874,143
42634,34,355,1194,278,7705,77
33299,213,17822,1946,12479,100109,5343
35345,21,395,1856,288,7137,107
18618,5,228,2680,182,12052,46
46302,3,41,129,37,1596,4
1858,44,1321,3528,1098,15988,223
38888,16,334,1624,247,3377,87
37975,0,24,1686,17,2911,7
41850,21,1213,1343,908,29110,305
17352,6,166,2736,132,10837,34
3872,4,94,3490,68,4432,26
11826,2,98,3068,78,7463,20
40982,21,791,1474,599,9252,192
31726,3,67,2016,56,3346,11
3907,2,164,3489,131,5199,33
39548,1,45,1584,32,2805,13
40696,2,83,1500,61,2327,22
31995,11,278,2003,229,4082,49
18341,15,261,2691,210,3113,51
19889,14,597,2620,428,8021,169
43775,31,385,858,297,5104,88
17769,1,64,2718,49,1608,15
39113,125,2460,1610,1929,20972,531
33094,0,13,1953,10,2525,3
13881,35,3369,2931,2177,14342,1192
43283,15,682,1019,449,14515,233
33331,7,188,1945,131,6090,57
2295,2,48,3520,39,3943,9
13057,31,48712,3000,17750,17451,30962
6296,35,2182,3384,1519,25625,663
12316,34,959,3043,833,12911,126
31920,0,36,2007,28,1588,8
3341,13,606,3502,416,8568,190
3041,21,585,3507,419,7673,166
7681,18,357,3312,296,10649,61
46270,1,8,143,8,1124,0
14759,19,1139,2868,882,47258,257
2959,0,71,3509,61,6713,10
32427,73,6502,1982,4949,18599,1553
35717,8,178,1828,137,3075,41
16520,102,4291,2782,3266,22559,1025
6445,15,606,3378,450,10114,156
40177,0,0,1545,0,6794,0
15813,3,640,2815,479,9829,161
9827,22,1133,3170,759,10710,374
15213,8,181,2842,151,8487,30
3386,13,365,3501,306,4704,59
6875,343,15570,3359,11107,124014,4463
17001,9,499,2756,365,8037,134
8595,44,4701,3243,3228,29292,1473
35064,6,238,1871,182,8870,56
4313,18,469,3475,374,15718,95
8232,2,48,3267,37,4834,11
42186,8,572,1282,385,11311,187
16715,4,230,2772,195,11324,35
21124,12,706,2551,566,21854,140
19446,1,150,2642,125,4005,25
16145,70,3223,2800,2519,39629,704
14240,7,780,2906,482,6469,298
43635,22,360,904,259,14513,101
21929,8,320,2505,272,2669,48
26633,10,899,2285,668,7112,231
31771,21,396,2014,314,25691,82
7647,84,6424,3314,4676,51665,1748
32145,25,2452,1994,1950,29759,502
13735,43,1243,2943,972,13222,271
21695,17,490,2517,364,3279,126
20457,49,3356,2590,2579,22911,777
17644,117,10815,2722,7189,41902,3626
43695,1199,24158,882,18188,130857,5970
2556,599,30800,3515,23140,149693,7660
25299,5,504,2345,405,5446,99
26171,1,188,2306,139,3687,49
5704,487,24495,3409,16990,114579,7505
28369,8,365,2190,298,5455,67
37731,20,2006,1704,1612,10816,394
37088,1602,37091,1744,27821,217411,9270
2201,8,435,3521,350,11107,85
25535,16,283,2335,240,4362,43
24690,5,294,2371,221,10963,73
21242,0,23,2542,19,1314,4
40058,10,142,1552,104,2424,38
42850,45,528,1143,365,10144,163
15256,4041,440454,2840,289221,1458658,151233
46278,6,46,140,37,898,9
3224,33,1183,3504,914,8728,269
38539,11,345,1647,253,8469,92
44362,30,572,762,465,11972,107
7226,37,1981,3340,1531,9410,450
36579,6,207,1776,171,6554,36
45276,7,90,505,77,2260,13
3373,19,650,3501,525,10572,125
46138,17,245,187,193,3889,52
4637,7,109,3463,88,2451,21
18636,6,683,2679,574,9541,109
3466,42,495,3499,424,20205,71
46356,36,718,108,524,10291,194
23073,75,1709,2448,1187,10541,522
43168,2,84,1051,56,2531,28
37270,68,1425,1733,1092,13018,333
13577,9,838,2955,546,11720,292
28822,10,436,2163,369,3577,67
44794,23,200,669,180,5335,20
6680,669,78852,3367,50746,202536,28106
24844,5,276,2365,234,3453,42
28312,24,1273,2193,962,17429,311
25787,26,512,2322,421,7373,91
7596,34,660,3317,540,5628,120
16815,452,29944,2765,22039,142689,7905
38790,2,105,1630,92,3177,13
7154,34,940,3342,720,8332,220
21117,9,744,2552,618,11561,126
39778,7,225,1572,182,7722,43
19966,4,338,2616,240,7581,98
40944,22,438,1477,345,5628,93
45286,20,154,501,135,7471,19
45532,59,996,436,616,8042,380
42485,9,229,1221,175,4919,54
33003,1086,35051,1957,26072,176404,8979
11759,0,97,3071,78,4167,19
27827,2,62,2220,49,3762,13
38847,3,370,1627,302,14325,68
14124,0,129,2913,102,3312,27
32920,1,181,1960,142,3930,39
9753,28,1475,3175,1103,13687,372
7576,122,4117,3319,3108,45547,1009
30077,3,204,2101,158,10535,46
10647,39,1896,3130,1421,39652,475
4146,124,6229,3482,4443,33462,1786
35415,3,153,1852,115,5236,38
25689,0,9927,2327,7352,38895,2575
22158,17,650,2492,535,6613,115
5349,16,516,3428,396,14471,120
43347,22,279,1001,206,5056,73
20986,1,90,2559,78,4704,12
29272,2,53,2141,47,3465,6
35154,2,178,1865,127,3537,51
36142,2,106,1798,69,5324,37
17895,52,1671,2713,1370,13303,301
44804,8,82,665,61,4238,21
30738,28,970,2065,762,19891,208
20974,8,363,2560,291,4789,72
3772,54,1812,3493,1353,23607,459
33167,6,153,1950,95,4246,58
34983,4,63,1875,54,2406,9
5746,352,15010,3407,10555,120696,4455
5658,0,60,3412,53,2737,7
43962,171,3289,830,2425,36908,864
28810,9,230,2164,195,4346,35
6142,6,83,3390,63,2767,20
26067,411,38964,2310,28042,154082,10922
12469,76,6697,3033,4559,53139,2138
43605,24,482,913,387,16316,95
23849,30,1628,2411,1241,11311,387
39761,66,2299,1573,1813,16341,486
20170,16,2402,2604,1867,41205,535
25573,28,835,2333,642,9076,193
32571,17,789,1975,667,3599,122
9087,1,77,3214,49,2586,28
4099,35,776,3483,633,9970,143
35960,423,20955,1811,16408,63818,4547
23970,75,2129,2404,1740,17336,389
26626,3,134,2285,115,5370,19
44218,72,1150,783,771,26397,379
30886,10,266,2059,212,7082,54
40088,1,57,1550,41,2613,16
14246,35,1408,2906,1088,25239,320
3718,83,5603,3494,4235,56842,1368
12360,13,678,3040,543,22207,135
14989,14,294,2854,230,3441,64
14614,36,1272,2878,1029,43876,243
17501,26,861,2729,631,21058,230
35747,0,110,1827,87,4548,23
39338,54,800,1596,664,8661,136
40303,0,30,1537,26,3099,4
24512,15,421,2380,331,6737,90
44060,18,252,811,170,4083,82
39054,3,68,1614,62,2923,6
40055,77,1867,1552,1415,16708,452
32289,6,130,1988,109,4879,21
41095,155,3421,1460,2566,37078,855
39051,217,9821,1614,6566,67671,3255
32080,33,1760,1997,1294,17323,466
37009,3,200,1750,169,6275,31
28435,5,116,2186,103,8194,13
23093,1,70,2446,61,2019,9
30923,2,142,2057,119,7459,23
37956,2,69,1687,56,3821,13
2945,8,168,3509,141,8463,27
37580,33,974,1713,807,7925,167
11874,523,31637,3066,20089,199650,11548
4956,1,157,3449,124,3243,33
25187,8,546,2349,428,8617,118
6079,2,67,3392,54,2249,13
9447,45,906,3191,727,37248,179
19801,51,2441,2625,1863,33895,578
30767,4,104,2063,75,3603,29
46028,243,7362,232,5165,35476,2197
1794,25,717,3531,568,10083,149
38928,123,2327,1622,1857,20517,470
13393,56,2579,2970,2113,33937,466
39258,41,1333,1600,1028,14075,305
8811,40,2783,3229,1951,24506,832
26476,3,305,2291,260,12103,45
20329,7,389,2597,308,8851,81
19378,23,799,2647,637,11138,162
4176,20,688,3480,542,9694,146
7174,1,142,3341,107,9442,35
32586,3,92,1975,76,4175,16
7800,143,6811,3304,4759,37600,2052
40426,5,282,1524,214,2995,68
12859,1325,61749,3012,42881,169536,18868
6446,181,8692,3378,5742,40242,2950
15174,2,34,2844,28,3684,6
26518,4,131,2289,117,3091,14
36975,364,10564,1752,7997,92694,2567
43415,11,313,976,214,5484,99
1674,2,52,3566,47,1810,5
9013,35,1261,3219,994,27225,267
2030,15,2044,3524,1496,12673,548
28293,30,1837,2194,1264,12911,573
34552,16,314,1899,236,5090,78
26490,545,20969,2291,14735,168934,6234
30789,1,67,2063,53,3895,14
30682,24,823,2067,673,9037,150
38569,0,37,1644,28,4069,9
26296,5,347,2300,295,3434,52
3845,5,298,3491,243,11196,55
25721,144,16499,2325,11641,63573,4858
34637,115,1813,1894,1470,18697,343
8958,743,35013,3221,25318,152942,9695
16233,111,8653,2796,6309,70063,2344
34710,2,28,1890,22,1968,6
7264,20,417,3337,335,8484,82
6094,42,898,3391,680,21760,218
30431,8,161,2081,124,3278,37
4955,651,34409,3449,25473,91210,8936
28011,2,52,2210,45,4113,7
27917,265,11626,2215,8581,85838,3045
19106,4,240,2660,195,8807,45
16462,10,667,2784,493,14012,174
3380,5,269,3501,221,5030,48
38940,4,83,1621,65,3220,18
22199,1,79,2490,58,2644,21
37562,5,173,1715,126,9654,47
27195,3,119,2259,105,1840,14
42387,4,333,1244,238,7623,95
12187,20,898,3050,670,10939,228
15936,9,929,2811,767,7568,162
36833,26,667,1760,490,10405,177
23268,522,24839,2438,17789,140336,7050
43890,10,199,840,163,6247,36
29663,7,232,2121,188,3754,44
36662,0,28,1771,24,3603,4
18567,36,870,2682,691,16422,179
30132,300,30653,2099,21859,82245,8794
21362,1,89,2536,80,3219,9
22203,6,230,2490,169,3527,61
18994,7,271,2664,175,2562,96
13636,8,176,2951,147,4586,29
12939,491,29511,3008,20295,113473,9216
29590,35,1028,2125,885,13750,143
37839,53,897,1695,679,8163,218
9497,47,1110,3187,883,17890,227
41176,1,20,1451,17,3933,3
1444,1,35,3642,28,2521,7
11018,4,107,3110,84,3338,23
40360,9,182,1529,149,5943,33
25417,3,230,2340,190,5921,40
18488,8,329,2685,236,4203,93
2816,10,670,3511,538,12179,132
21234,15,377,2542,291,3330,86
6323,3,103,3383,79,4191,24
5603,10,381,3415,243,4417,138
2579,272,12882,3515,10029,72528,2853
34106,15,214,1917,183,3864,31
18926,2,81,2667,68,2422,13
4983,65,1632,3448,1257,11045,375
7497,29,388,3324,288,5848,100
12861,5,122,3012,89,2322,33
3688,30,2296,3495,986,26698,1310
14000,93,9115,2921,6829,43519,2286
32336,16,346,1985,277,4731,69
21945,144,6462,2504,4584,36159,1878
40851,43,1490,1484,1169,24826,321
8533,22,856,3246,698,11898,158
33254,3,212,1948,174,6869,38
44382,15,210,760,150,6327,60
40959,88,2247,1475,1597,18864,650
15120,19,526,2847,400,5770,126
23572,9,311,2423,260,5619,51
10541,7,157,3137,125,6334,32
11773,12,816,3070,621,11057,195
6432,17,428,3378,316,5904,112
37773,43,933,1701,786,14174,147
2525,22,691,3516,568,20388,123
38515,47,1994,1649,1448,28850,546
42972,12,116,1111,75,3239,41
32691,24,1008,1970,811,13584,197
6229,4,119,3387,78,2121,41
6241,21,701,3387,545,8267,156
26436,16,949,2293,777,7764,172
6266,4,60,3385,49,3538,11
36515,36,1012,1779,720,7172,292
42930,16,565,1120,418,10019,147
9984,39,1037,3163,805,29974,232
32323,7,217,1986,178,6282,39
33759,2,100,1928,83,5601,17
45745,14,263,345,183,3577,80
41017,37,842,1471,533,11100,309
9641,56,2521,3179,1777,47868,744
39963,5,201,1558,156,4417,45
28757,0,44,2167,37,1818,7
12544,1,102,3031,65,1779,37
37276,6,264,1733,225,7055,39
34806,12,408,1884,328,5984,80
23762,0,347,2415,254,3201,93
33151,35,441,1951,354,6759,87
23132,15,809,2445,607,17341,202
35391,51,454,1854,365,5800,89
18176,5,186,2699,149,5862,37
19758,8,243,2627,200,5606,43
31102,12,397,2049,307,5384,90
10738,118,8862,3124,6529,36224,2333
40056,9,256,1552,208,4874,48
6747,0,63,3365,50,2763,13
28396,2,84,2188,68,1671,16
27369,1,73,2248,57,2255,16
11519,10,356,3083,273,16099,83
11233,1,133,3098,100,7077,33
25688,3,304,2327,255,12493,49
9536,31,2300,3185,1876,14038,424
25568,60,1874,2333,1410,13898,464
2657,12,273104,3514,88164,14839,184940
41888,13,319,1336,256,7788,63
39675,12,174,1577,148,4135,26
43978,21,706,828,498,8030,208
29307,50,1072,2139,850,6862,222
24438,11,423,2383,368,5144,55
32029,15,437,2001,328,3926,109
17047,5,176,2753,142,9040,34
39987,2,92,1556,76,3336,16
39272,4,117,1599,88,5052,29
40238,51,809,1541,616,5259,193
3574,113,9945,3497,7297,162912,2648
21649,3,64,2520,49,4450,15
4264,4,349,3478,255,4038,94
16276,16,527,2794,423,5142,104
36805,4,106,1762,92,5194,14
6931,1,24,3356,18,1686,6
9371,5,425,3195,317,14583,108
43301,350,6644,1013,5003,68227,1641
21028,7,112,2556,94,4535,18
31597,4,63,2023,55,2268,8
31979,32,1530,2003,1139,11109,391
17052,10,375,2752,317,4684,58
33690,71,2104,1931,1554,11228,550
46009,2,48,240,36,2085,12
21551,6,253,2526,202,13455,51
9509,36,1097,3187,859,22698,238
29806,82,5188,2114,3931,28293,1257
45651,12,115,388,98,5381,17
6731,30,1197,3365,923,18225,274
5578,68,3440,3416,2653,48829,787
7018,43,1990,3350,1589,7147,401
21365,118,3987,2536,2896,23339,1091
7961,7,203,3288,169,5177,34
18269,25,1634,2694,1231,12580,403
23007,12,462,2450,348,5985,114
42241,1,27,1270,24,3089,3
6897,14,626,3358,526,12411,100
39185,34,667,1605,557,7617,110
8046,19,281,3277,233,6401,48
12173,51,1194,3051,855,5506,339
14548,21,995,2883,761,10677,234
24752,6,469,2368,349,10763,120
35828,2,112,1821,82,4230,30
12257,17,59507,3046,17618,13806,41889
2365,300,19254,3519,14723,134001,4531
17960,135,5852,2709,4488,38275,1364
41205,9,253,1448,201,6012,52
31721,3,57,2016,51,2948,6
32129,9,570,1995,386,5110,184
36121,4,80,1799,64,4526,16
24276,18,1863,2390,1347,20516,516
46208,1,47,158,30,633,17
27797,120,2689,2222,1931,17978,758
27375,0,32,2247,30,1167,2
13870,19,719,2933,551,7114,168
40357,19,569,1529,424,8179,145
32986,16,776,1958,612,19682,164
2473,151,5264,3517,4060,59193,1204
2128,2,55,3522,46,4912,9
33995,207,5768,1920,4420,39072,1348
43924,66,1296,833,896,34035,400
19167,12,596,2657,454,6573,142
19473,206,7996,2641,5675,27464,2321
9842,37,2862,3170,2028,31176,834
31569,50,3091,2024,2348,26040,743
33468,5,241,1939,188,2974,53
4469,46,1503,3470,1136,32813,367
3601,5,330,3497,254,5796,76
46167,15,204,171,182,3798,22
38918,28,255,1623,194,3381,61
20208,13,745,2602,592,9455,153
45520,276,3490,440,2769,15262,721
27476,102,3573,2241,2416,28068,1157
31732,24,1065,2016,766,9602,299
36179,1,81,1796,72,1783,9
41667,28,661,1377,494,18610,167
29329,19,511,2137,401,8701,110
17269,15,418,2740,355,4829,63
27706,31,834,2228,646,8207,188
17315,12,632,2738,483,14560,149
6320,158,13194,3383,8225,126391,4969
17203,7,774,2744,554,25273,220
32859,12,1807,1963,1526,5458,281
32979,21,562,1958,432,12573,130
30962,28,809,2056,679,5457,130
41611,32,1414,1386,1082,12002,332
45270,8,395,506,298,7305,97
12003,55,2108,3060,1613,14547,495
15968,21,2021,2809,1533,31735,488
14769,8,1002,2867,730,35735,272
40660,131,2278,1503,1633,31899,645
24367,42,812,2387,639,5498,173
27635,12,1073,2232,863,17599,210
15380,18,904,2835,768,12903,136
8379,9,503,3256,402,19749,101
30790,65,4585,2062,3660,47222,925
43210,63,1525,1042,1090,13273,435
46383,2,15,94,14,1808,1
16111,9,303,2801,247,5697,56
28814,51,5827,2164,4206,80548,1621
34628,13,738,1895,555,12353,183
28234,3,97,2197,74,4007,23
2094,8,383,3523,287,6369,96
3302,6,148,3502,112,7415,36
5269,2,95,3431,69,5943,26
38617,135,4118,1641,2991,41638,1127
2632,18,402,3514,287,4141,115
13212,21,718,2983,598,28515,120
27348,8,239,2249,191,4276,48
46091,130,3287,206,2727,22386,560
39802,4,282,1570,234,6916,48
35596,1,30,1838,24,1936,6
9302,16,535,3201,462,15665,73
2975,8,343,3508,279,7095,64
13629,4,4,2952,4,8235,0
35999,13,260,1808,219,9965,41
4777,6,302,3458,243,3352,59
31743,1,63,2015,50,2441,13
16713,81,4109,2772,3406,13701,703
5051,640,11777,3444,8909,185753,2868
41144,4,41,1455,35,1999,6
38707,19,669,1635,557,6361,112
27200,294,12753,2258,9889,105522,2864
24120,0,140,2398,110,5141,30
7855,15,676,3299,484,5016,192
25601,19,1058,2331,884,15661,174
42898,10,304,1130,221,6964,83
40386,440,21106,1527,14194,130435,6912
44114,92,1992,802,1468,15994,524
24510,29,1435,2380,1055,13491,380
28014,7,343,2210,260,6031,83
4696,2,13,3461,11,1905,2
33513,16,405,1937,324,11400,81
13157,6,81037,2985,20445,4967,60592
39838,20,283,1568,228,7456,55
10465,21,603,3140,474,6363,129
45033,558,5994,596,4398,37447,1596
18360,86,2791,2690,2120,15852,671
15694,13,715,2820,521,17209,194
10235,5,156,3151,119,5290,37
5838,28,623,3402,442,5224,181
5370,14,289,3426,230,4319,59
26594,0,66,2286,57,2711,9
15049,7,533,2851,417,13120,116
4913,17,448,3451,378,7273,70
15898,8,307,2812,218,6237,89
8452,48,1930,3253,1600,22766,330
26033,30,758,2311,616,16100,142
40634,3,205,1505,151,5800,54
7451,97,6210,3326,4540,43958,1670
26353,68,4249,2296,3307,32941,942
31581,12,274,2023,230,3582,44
34565,23,459,1898,373,7313,86
12870,131,5032,3011,3455,38188,1577
25329,12,511,2343,414,12813,97
37013,194,15037,1750,11194,94621,3843
35610,154,3846,1837,2679,30667,1167
22031,18,1098,2498,836,8117,262
7939,5,114,3290,97,3335,17
36265,0,44,1791,37,1881,7
34685,30,1018,1891,747,10419,271
3599,16,540,3497,422,16273,118
4834,5,122,3455,79,6035,43
30427,59,2305,2081,1686,25789,619
10152,1,74,3155,64,2326,10
7846,1,55,3300,46,2410,9
36524,23,296,1779,235,3295,61
44873,11,143,645,90,4348,53
42094,11,402,1302,318,8917,84
33681,26,634,1932,519,7552,115
9116,4,172,3212,113,2357,59
35785,86,1373,1823,1104,16734,269
3320,164,10007,3502,7265,71290,2742
45736,17,101,346,81,2718,20
3203,27,711,3504,578,10786,133
43591,66,1274,920,985,23337,289
33991,36,756,1920,595,6805,161
44077,31,395,808,289,10018,106
31630,21,552,2021,461,8945,91
28434,3,107,2186,91,6317,16
44434,5,87,754,48,5845,39
13467,109,3215,2963,2501,19519,714
15351,155,10441,2836,6990,85228,3451
5479,29,777,3421,614,15694,163
16065,28,1147,2803,897,13534,250
5101,2,159,3441,111,12376,48
8758,55,3865,3232,2697,24151,1168
30111,9,863,2100,708,10445,155
32558,1,124,1976,95,5493,29
32584,2,190,1975,146,3283,44
12517,3,124,3031,89,1130,35
3311,959,36482,3502,23753,154744,12729
9775,10,318,3174,259,12643,59
16037,61,4393,2805,3207,31555,1186
6009,6,240,3394,185,3200,55
28951,17,1379,2157,1128,7471,251
42819,38,557,1148,455,8881,102
7757,148,158457,3308,54848,29717,103609
21573,2,203,2524,163,2638,40
23523,105,2194,2426,1672,14785,522
45665,61,684,380,585,15818,99
5438,23,726,3423,532,22152,194
40864,41,1184,1483,888,16384,296
29086,62,1124,2150,906,10732,218
14436,39,1485,2891,1238,29533,247
9467,5,124,3189,100,3303,24
36808,20,476,1762,375,8974,101
45541,3,47,433,37,955,10
20291,13,358,2597,294,8838,64
39354,36,1942,1595,1443,33833,499
10814,8,358,3120,292,10088,66
39550,758,30407,1584,14750,189724,15657
43348,11,254,1001,194,15920,60
31251,4,566,2042,430,8884,136
7771,78,2915,3306,2168,51594,747
3045,11,461,3507,385,12583,76
43574,78,817,929,650,11731,167
8727,4,163,3234,134,4417,29
24483,81,3242,2381,2355,18110,887
41345,2,136,1424,110,2623,26
41527,48,1268,1399,920,10009,348
20984,40,661,2559,481,7249,180
35774,37,2023,1824,1655,20212,368
31675,4,134,2018,118,2795,16
24521,4,167,2379,122,3582,45
19172,1281,119335,2657,80955,423288,38380
36821,5,86,1761,71,3016,15
40514,6,277,1515,196,5900,81
32218,2,123,1990,102,6524,21
4359,40,901,3473,705,5722,196
42882,3,63,1134,52,3554,11
4740,4,57,3459,42,2764,15
11331,19,577,3094,469,3017,108
20334,5,337,2596,258,5077,79
6408,9,804,3379,607,8325,197
33957,59,1069,1922,863,15206,206
25909,182,13599,2317,9516,69269,4083
44899,43,489,638,354,5632,135
37565,14,311,1714,201,4211,110
39340,7,220,1595,158,7927,62
7004,3,401,3351,337,16124,64
45079,1,36,578,19,2033,17
23514,0,100,2426,76,3182,24
37068,21,610,1746,492,6258,118
26871,2,206,2273,177,7172,29
6090,9,226,3392,174,2586,52
24305,120,7362,2389,5813,30925,1549
14910,3,103,2859,77,2860,26
25204,156,4294,2348,3424,40276,870
23835,0,68,2411,60,2107,8
15218,14,255,2842,214,3788,41
21620,1,108,2522,69,2106,39
29627,6,182,2123,147,4148,35
17344,16,409,2736,337,4605,72
7299,3,149,3335,124,5369,25
39604,10,464,1580,377,6770,87
7135,1,33,3344,22,1762,11
8658,14,1388,3238,1002,6485,386
17829,3,154,2716,124,8234,30
21788,1,125,2513,102,4816,23
22028,12,373,2498,323,11267,50
8865,3,160,3226,123,3064,37
44928,7,114,630,75,2836,39
39020,142,5399,1616,4134,30794,1265
43590,92,1900,921,1498,29817,402
8455,135,7498,3252,5576,59296,1922
20039,7,619,2611,452,9352,167
14538,2,53,2884,40,2836,13
36745,13,427,1766,325,8148,102
23505,36,1281,2426,974,17867,307
26764,27,1640,2278,1327,24894,313
19602,35,1865,2636,1421,11286,444
34217,27,1246,1914,958,11822,288
11977,28,850,3061,627,20990,223
36954,535,32176,1753,24196,178344,7980
4753,19,282,3459,218,8013,64
14692,96,6535,2873,4483,46120,2052
4047,140,3742,3485,2952,24184,790
4638,10,344,3463,284,4406,60
45046,32,325,592,218,5879,107
42937,2,17,1118,13,1956,4
25308,23,315,2345,262,6139,53
6314,4,149,3383,107,2452,42
15112,61,3888,2848,2754,27243,1134
13509,88,2426,2960,1756,16204,670
5431,40,1637,3423,1378,23661,259
5378,4,85,3426,55,2311,30
32092,10,378,1997,297,8399,81
24361,11,315,2387,243,3217,72
46119,10,165,197,112,2570,53
19183,4,648,2657,514,16408,134
45878,28,755,279,573,6393,182
26649,4,197,2284,171,5119,26
43449,154,3073,969,2434,32541,639
2555,6,260,3515,194,3824,66
18008,23,1473,2706,973,33945,500
16620,9,676,2777,538,12381,138
26512,11,409,2289,341,5083,68
24565,108,3939,2377,3159,32105,780
4358,5,330,3474,275,17023,55
28043,0,42,2208,35,2181,7
14760,44,2083,2868,1553,23629,530
7866,20,597,3298,460,10609,137
31443,8,381,2031,319,7250,62
19818,14,615,2623,508,17051,107
32855,469,14468,1963,11041,99806,3427
2847,41,1447,3511,953,12565,494
39421,0,10,1591,8,2082,2
29432,101,1585,2132,1165,10198,420
16725,10,625,2771,528,8131,97
46049,5,84,219,61,1804,23
39491,0,113,1587,93,2720,20
16806,149,5758,2766,3867,48980,1891
42794,3,80,1153,59,4185,21
18332,12,798,2692,579,6296,219
10552,66,2144,3136,1723,31192,421
5515,3,899,3420,711,13080,188
39587,8,237,1581,192,4813,45
40101,1,46,1550,36,2985,10
44415,66,858,757,640,9843,218
45156,151,1609,542,1261,18075,348
46345,2,67,112,53,1043,14
31042,15,367,2052,270,5271,97
24111,2,194,2398,156,5530,38
16592,0,73,2779,61,4798,12
43468,4,160,964,115,4697,45
40316,1,177,1535,98,4766,79
26418,13,374,2294,294,3563,80
16544,1183,114593,2780,86158,240226,28435
6478,88,3311,3376,2551,26462,760
18384,84,5380,2690,4043,36595,1337
38477,24,364,1652,309,3199,55
39496,6,422,1587,320,8927,102
6912,7,211,3357,173,4259,38
10027,16,843,3161,568,16913,275
3076,7,133,3506,112,8091,21
11507,68,7563,3084,5577,43776,1986
39091,31,793,1611,628,17739,165
12291,73,2904,3045,2228,68821,676
38366,66,3930,1659,3000,19582,930
8029,10,271,3277,213,3434,58
40830,176,4239,1486,3131,39193,1108
33683,184,6496,1932,4816,32055,1680
20459,2712,196815,2590,122745,458593,74070
18537,5,708,2684,507,9244,201
16519,1,61,2782,53,2831,8
44683,18,463,706,206,7720,257
25717,15,625,2325,523,5747,102
13723,19,991,2944,791,11245,200
21516,30,2081,2527,1270,32862,811
2572,3,152,3515,129,7022,23
29327,23,708,2137,534,5728,174
7033,59,717,3349,513,6144,204
36329,1,32,1788,27,2270,5
46296,5,146,133,126,3475,20
29496,1,57,2129,49,2264,8
41992,3,261,1320,192,11292,69
45490,350,4814,449,3591,35257,1223
7163,99,5331,3342,3609,38299,1722
4403,55,1505,3472,1167,16452,338
26414,35,1184,2294,995,6355,189
30749,15,687,2064,577,16754,110
36316,29,1606,1789,1308,22230,298
27422,1,61,2245,49,1863,12
10355,128,3177,3146,2521,55332,656
43444,57,940,970,780,19799,160
43561,4,62,933,53,4909,9
31688,36,1088,2017,893,9982,195
27853,10,409,2219,326,9009,83
2894,3,102,3510,84,9396,18
4341,43,807,3474,610,13459,197
14921,72,5320,2858,3654,29996,1666
28520,232,17323,2180,12842,73108,4481
1879,94,4213,3528,3047,25876,1166
5153,46,2371,3438,1832,24915,539
19830,0,416,2623,324,7525,92
7700,118,3463,3311,2648,36691,815
40631,12,274,1505,211,3262,63
5085,14,394,3443,319,11492,75
16243,6,221,2795,195,11774,26
35335,41,2163,1856,1777,19840,386
26904,61,4135,2271,2810,39867,1325
37351,5,277,1729,233,5748,44
33178,2,78,1950,63,1982,15
9949,339,21345,3165,15744,104990,5601
41655,39,932,1379,690,10965,242
2397,16,713,3518,563,25377,150
1441,5,258,3642,206,7836,52
21016,2,76,2556,64,4086,12
38620,3,166,1640,135,6595,31
8123,8,209,3274,85,6279,124
43617,19,290,909,203,8047,87
8153,2,180,3272,113,7639,67
43286,22,442,1017,345,5529,97
21731,10,1123,2516,878,18853,245
45746,24,264,345,196,2591,68
22816,38,1536,2460,1117,23359,419
2367,9,125,3519,95,6879,30
7810,84,1702,3303,1135,29290,567
38289,29,613,1665,421,6443,192
8884,42,665,3226,509,7569,156
46213,1,7,157,5,983,2
11397,4,117,3090,90,2547,27
6068,10,459,3392,307,4225,152
45217,2,31,523,18,1710,13
6236,4,283,3387,235,4461,48
34539,16,406,1899,339,7815,67
5033,17,379,3445,294,6524,85
37770,20,344,1701,267,6525,77
38085,26,983,1680,752,8400,231
32997,15,689,1958,540,13302,149
1923,50,3728,3527,2931,36790,797
6371,84,1939,3380,1451,16726,488
19656,3,345,2633,256,6444,89
19393,14,587,2646,450,13423,137
38263,22,885,1667,700,14301,185
4866,6,48,3454,39,2656,9
12301,9,378,3044,320,15226,58
20528,111,4491,2586,3316,34154,1175
2329,64,3130,3519,2315,28886,815
5007,31,770,3447,573,16639,197
22865,7,172,2458,146,2322,26
17539,0,279,2726,234,5761,45
11152,28,1522,3102,1198,29899,324
17768,0,168,2718,132,3051,36
18203,342,16172,2698,11984,108836,4188
27639,8,432,2232,325,12019,107
46114,0,46,198,42,1121,4
34452,0,0,1904,0,6784,0
21063,28,1137,2555,910,16583,227
32598,4,147,1974,116,6517,31
32718,63,1748,1969,1370,11118,378
33700,37,1114,1931,846,15029,268
18252,8,472,2695,394,3066,78
25025,22,1982,2357,1346,10595,636
14791,5,309,2866,259,4211,50
40541,5,162,1513,124,2464,38
31822,197,7683,2011,5457,60782,2226
19339,29,1578,2648,1170,13253,408
34664,101,1096,1892,833,11237,263
8987,2,135,3220,111,8941,24
42333,12,182,1254,142,6827,40
33482,183,3987,1939,3149,28446,838
13822,2,76,2937,67,9259,9
29706,0,135,2119,113,6697,22
15356,37,3992,2835,3016,25156,976
1673,7,204,3566,169,7099,35
10652,2,37,3130,29,1550,8
37648,7,339,1709,280,4698,59
36358,13,547,1787,430,8850,117
17907,98,4690,2712,3590,58460,1100
1045,8,173,3816,146,5178,27
3416,65,2611,3500,2018,21644,593
39182,1,138,1606,102,4644,36
18418,64,5258,2688,3250,34182,2008
19489,77,6194,2640,4639,29113,1555
34712,18,292,1890,223,2976,69
31017,58,1446,2053,1149,20684,297
3923,6,253,3489,199,9958,54
4074,37,3055,3484,2311,22275,744
45825,4,53,317,42,1892,11
14014,23,1610,2919,1249,26671,361
3099,5,217,3506,178,8947,39
20049,106,15885,2611,12074,54595,3811
38050,5,187,1682,148,4445,39
40202,14,155,1543,127,4920,28
20664,2,98,2579,86,4210,12
7274,7,57,3337,48,2511,9
1118,1,59,3797,54,5685,5
29036,13,468,2153,372,10747,96
19535,14,1137,2639,903,17634,234
14460,98,3503,2889,2695,25290,808
30768,27,673,2063,492,7661,181
7913,5,152,3293,121,5577,31
5193,17,200,3435,161,5621,39
15907,27,843,2812,629,8358,214
37132,75,1488,1742,1045,43869,443
5890,71,1270,3400,1024,10350,246
26309,3,409,2299,310,8895,99
24643,70,5741,2372,4320,46675,1421
31529,13,431,2026,346,6963,85
10162,132,5489,3155,3879,41020,1610
22884,153,6304,2457,4467,33574,1837
37655,593,9773,1709,7705,54971,2068
11635,17,457,3077,374,7655,83
14998,2,105,2854,87,3360,18
27196,4,324,2259,274,2523,50
19302,15,874,2650,648,7625,226
24025,0,577,2402,474,6884,103
19016,27,2732,2663,2026,9871,706
43764,201,2614,863,2169,29832,445
28478,52,2848,2184,2239,20214,609
45759,14,231,339,194,3185,37
7052,86,2307,3348,1748,12818,559
19817,14,1088,2623,895,30098,193
31958,45,1328,2005,954,13689,374
16562,10,408,2780,344,3609,64
3571,3,100,3497,85,4036,15
16197,6,166,2798,134,3726,32
24809,11,278,2366,227,3932,51
9619,8,137,3180,117,3746,20
33884,1,67,1924,58,2691,9
34157,74,1780,1916,1308,11085,472
2495,216,9328,3516,7206,60076,2122
1894,56,1682,3527,1262,11380,420
26050,4,72,2311,60,1782,12
22463,17,382,2477,330,3271,52
36608,59,2963,1773,2460,38462,503
6760,3,65,3364,54,1976,11
10421,9,129,3143,112,2434,17
21452,3,189,2531,150,3035,39
26568,12,470,2287,376,7159,94
46299,5,76,131,49,1325,27
20379,21,650,2594,515,4981,135
18658,6,270,2677,221,5634,49
41389,3,75,1418,57,2308,18
39721,0,77,1574,60,5386,17
45320,232,2426,492,2027,24749,399
5632,54,1424,3413,1076,17977,348
44651,65,581,718,487,7478,94
28991,5,326,2155,253,13949,73
10696,0,19,3127,14,2932,5
14333,37,887,2898,722,6609,165
27231,28,665,2256,536,7437,129
34146,20,520,1916,398,4027,122
45399,16,367,470,309,11740,58
949,12,272,3853,234,4323,38
37529,167,3650,1717,2765,33268,885
9458,3,85,3190,50,4849,35
41563,35,1480,1395,1116,15500,364
27762,4,331,2225,251,13465,80
31768,15,371,2014,248,4420,123
35230,1169,43838,1861,37018,212178,6820
7175,4,52,3341,44,3109,8
4938,3,46,3450,38,2270,8
15280,4,1289,2839,873,15899,416
14512,8,938,2885,710,13214,228
22155,36,2444,2492,1882,15485,562
3592,31,493,3497,381,13452,112
35635,142,11856,1836,8691,62723,3165
10565,44,2379,3135,1838,27452,541
27893,7,219,2217,193,5382,26
6518,0,74,3374,63,3398,11
45947,13,235,265,154,3739,81
6957,56,297253,3354,81133,26748,216120
44003,2,41,823,32,2235,9
25415,37,1653,2340,1257,16601,396
42911,21,176,1126,169,5500,7
33796,83,2921,1927,2112,34098,809
23353,228,17219,2434,13020,91905,4199
36541,0,32,1778,23,1986,9
17505,6,205,2728,156,4322,49
30204,10,344,2095,311,15644,33
23231,11,1001,2440,792,7762,209
37466,22,744,1721,580,11155,164
26133,85,4859,2308,3765,51467,1094
17409,3,673,2732,526,10345,147
40022,13,275,1554,231,5059,44
41344,17,154,1425,132,3442,22
32915,23,1360,1961,961,16084,399
45544,0,35,431,32,2115,3
40427,24,262,1523,208,7163,54
27763,27,1273,2224,1082,10991,191
5517,16,928,3420,734,8945,194
11166,6,142,3101,122,8872,20
1446,2,45,3638,34,2671,11
4950,12,670,3449,455,7477,215
15055,0,121,2850,112,3972,9
28496,25,964,2183,663,19250,301
22925,233,15671,2454,10982,154268,4689
6038,13,615,3393,487,7081,128
15614,122,2587,2823,1968,26107,619
4592,24,447,3465,381,15598,66
12000,11,315,3060,241,6794,74
7400,31,1237,3329,967,16296,270
12684,131,13194,3022,9159,83086,4035
5372,8,297,3426,205,7112,92
2263,1,21,3520,20,3674,1
22054,4,237,2498,192,8821,45
11443,37,3783,3088,3001,31628,782
5266,36,1322,3431,1041,29533,281
35247,5,80,1860,66,2555,14
9094,18,480,3213,373,37372,107
23752,12,399,2415,316,6632,83
7784,2,72,3305,55,1968,17
9939,30,730,3166,506,5809,224
46333,11,159,117,121,2388,38
17229,202,13952,2742,10375,88832,3577
27869,2,70,2219,56,3012,14
35018,8,279,1873,232,6491,47
3513,3,145,3498,116,2649,29
32844,26,769,1963,611,13130,158
6430,284,19886,3378,15710,68722,4176
4133,3,50,3482,42,3402,8
45642,325,4528,392,3785,41111,743
22629,4,70,2470,61,3184,9
8032,27,469,3277,379,10679,90
21727,11,344,2516,265,6016,79
5576,69,1751,3416,1407,36244,344
15066,13,1012,2850,831,17715,181
10821,6,211,3120,153,10487,58
21851,24,1160,2510,969,25690,191
43161,1,57,1054,46,3947,11
25834,0,39,2321,35,1777,4
5277,230,5061,3431,3850,17429,1211
20212,155,19534,2602,14285,63484,5249
46307,53,643,128,567,8623,76
9701,9,344,3177,251,5041,93
19459,8,319,2642,254,5297,65
3888,103,3434,3490,2529,19097,905
45700,1,31,366,25,2655,6
2923,4,163,3509,127,6876,36
23186,6,568,2442,468,15381,100
7448,3,66,3327,60,3123,6
15509,367,24563,2829,17946,130374,6617
30712,39,880,2066,708,9331,172
19591,227,14919,2636,9083,75511,5836
25230,0,1174,2348,955,10889,219
24864,75,3141,2364,2372,25279,769
2610,6,108,3514,88,4284,20
29834,41,1000,2113,736,8595,264
42558,1,115,1208,81,7653,34
2139,13,380,3522,319,14189,61
42835,15,167,1145,137,6958,30
46301,40,363,130,319,4859,44
44737,329,3450,688,2804,16318,646
36894,1,18,1757,16,2994,2
39012,24,849,1617,634,9466,215
32503,1,244,1978,194,11391,50
19606,3,76,2636,54,2157,22
40389,180,2986,1527,2348,17545,638
3115,27,2492,3506,1234,61637,1258
40597,5,429,1508,328,10660,101
31248,5,147,2042,123,4871,24
5933,11,1164,3398,812,16958,352
3746,17,324,3493,255,3617,69
30685,373,21639,2067,15943,132082,5696
37474,28,422,1721,351,3682,71
3325,4,124,3502,95,3053,29
45808,6,66,324,45,2346,21
8676,96,1768,3237,1334,17429,434
22542,3,149,2473,97,2557,52
40975,221,5865,1474,4359,45531,1506
13942,30,1314,2925,1033,18172,281
15228,6,86,2841,73,4265,13
24086,15,687,2399,543,15827,144
5460,26,363,3422,288,7005,75
17859,9,949,2714,763,16071,186
35931,0,12,1813,10,1929,2
16189,3,127,2798,86,3284,41
38182,4,46,1673,39,2112,7
2521,9,239,3516,198,6029,41
12167,33,1472,3051,1072,36237,400
1886,112,2634,3528,1603,21585,1031
24832,64,2984,2365,2182,26446,802
36434,27,1357,1784,1109,15821,248
16442,618,34086,2785,24648,235366,9438
6440,28,592,3378,475,4129,117
11011,1,90,3110,74,4947,16
32785,2,88,1967,76,5715,12
1828,8,103,3530,84,8609,19
39157,15,450,1607,365,11975,85
3487,145,9501,3499,6482,49997,3019
29122,4,259,2148,222,4875,37
34360,10,169,1908,141,3265,28
39202,122,4597,1604,3468,55023,1129
46342,4,87,111,71,1584,16
16063,9,899,2803,680,32924,219
12661,32,2231,3024,1774,18714,457
14407,7,573,2892,425,17844,148
15119,5,142,2847,108,2212,34
3037,100,7092,3507,5467,32238,1625
14500,5,253,2886,210,6274,43
16181,11,1398,2798,1190,31595,208
10985,156,3237,3111,2511,21532,726
36114,8,333,1800,264,4466,69
3943,9,459,3488,367,25526,92
22037,2,132,2498,113,4861,19
21631,33,593,2521,459,6817,134
41938,28,349,1329,251,6990,98
46195,164,4874,162,3750,19208,1124
21068,16,926,2554,733,10658,193
32208,15,813,1991,637,14248,176
32446,9,341,1981,274,4909,67
38052,13,368,1682,301,14350,67
15705,3,264,2819,200,3050,64
10752,7,234,3123,180,3972,54
34936,2,52,1877,45,3629,7
2823,49,1050,3511,896,16732,154
25087,7,312,2354,252,7857,60
4626,7,144,3464,117,4255,27
2477,12,245,3517,199,12016,46
44298,10,78,773,60,2512,18
30473,13,520,2079,439,9612,81
12183,50,2041,3050,1679,16752,362
25832,7,1123,2321,797,10552,326
6344,16,1087,3382,820,6249,267
27116,2,123,2264,105,2935,18
41966,28,359,1323,267,9602,92
11677,29,1672,3075,1313,39809,359
30577,160,3110,2073,2530,25777,580
15395,66,3785,2834,2724,23140,1061
39062,57,1420,1613,1108,9875,312
29149,20,467,2147,363,5372,104
18014,5,358,2706,275,5426,83
27308,40,3145,2252,2521,17890,624
44968,9,104,618,77,2792,27
31282,36,601,2040,461,6780,140
20053,2692,257865,2611,182233,552360,75632
34164,508,16188,1915,11144,108830,5044
24263,54,3053,2392,2123,29372,930
23140,124,5120,2444,3667,27498,1453
6602,16,461,3371,338,6182,123
41209,17,1034,1447,740,7911,294
2152,55,1278,3522,1045,19924,233
2008,663,45370,3524,32840,199733,12530
31453,16,536,2031,435,5284,101
36217,12,861,1794,641,8864,220
28974,9,175,2156,138,2705,37
31965,5,236,2004,195,11233,41
27413,9,245,2245,189,3457,56
39110,0,25,1610,20,2537,5
42426,32,615,1234,450,8352,165
20572,735,43117,2584,30224,162390,12893
41800,26,377,1352,267,8628,110
1779,5,153,3537,128,3025,25
13438,5,91,2966,64,3346,27
2670,5,304,3514,263,6798,41
42001,22,543,1318,388,15728,155
31315,8,183,2038,147,9938,36
2044,99,4199,3524,3342,30817,857
5516,71,2300,3420,1775,38398,525
4304,26,644,3476,503,8197,141
45776,0,48,331,31,1291,17
36981,238,9076,1751,7069,72052,2007
36970,6,212,1752,174,4969,38
42915,18,408,1125,332,9285,76
2706,515,34048,3513,21791,142446,12257
23821,60,2535,2412,1886,30091,649
9136,3,156,3211,118,4814,38
44672,17,242,710,196,6457,46
4456,0,48,3470,35,1940,13
30172,6,180,2096,127,2839,53
30853,2,111,2060,88,12335,23
39322,78,2630,1596,2017,14551,613
28151,324,14318,2203,10921,66708,3397
43470,52,1023,964,846,22541,177
38952,8,299,1620,230,8542,69
25852,0,40,2320,36,1222,4
38320,6,193,1662,158,5095,35
11755,742,74926,3071,50200,299634,24726
31096,211,7756,2050,6236,48582,1520
32508,229,3533,1978,2823,17363,710
36697,0,118,1769,92,7393,26
22916,92,6401,2455,4562,36954,1839
22845,11,651,2458,392,4340,259
22063,44,1886,2497,1313,9074,573
45137,8,93,546,73,2192,20
15322,11,1483,2837,1173,15649,310
23919,3,70,2408,64,3829,6
35502,0,27,1846,21,3259,6
17770,1,106,2718,89,6069,17
9583,37,711,3182,568,9208,143
45637,26,278,395,220,5983,58
7593,221,5836,3318,4615,41200,1221
5436,3,20,3423,17,2540,3
39507,24,999,1587,785,12424,214
18013,72,4974,2706,3314,45100,1660
10853,10,206,3118,158,7794,48
45752,10,145,342,106,2723,39
21116,1,26,2552,24,1484,2
15468,33,956,2831,722,12064,234
8810,17,421,3229,354,16740,67
38797,1,44,1630,31,1980,13
42559,0,0,1208,0,5933,0
46194,0,10,163,6,999,4
15385,12,623,2834,462,8037,161
21528,34,1385,2527,1024,8901,361
9011,18,1143,3219,697,24386,446
11702,14,848,3074,626,32275,222
19029,4,210,2663,169,5649,41
15150,825,66971,2845,43072,355330,23899
35252,110,1420,1860,1172,14998,248
23062,119,3399,2448,2548,18666,851
46218,0,13,156,6,694,7
39474,152,2431,1588,1995,19705,436
22843,338,18068,2459,12340,114562,5728
21869,12,622,2509,477,11344,145
30781,9,474,2063,407,7503,67
35324,231,4719,1856,3621,17218,1098
32375,26,1115,1983,801,14368,314
44760,2,41,680,20,1174,21
15377,9,375,2835,332,4487,43
3728,14,571,3494,483,7238,88
14339,464,50820,2897,34271,177767,16549
40915,8,129,1479,99,6308,30
46287,13,235,137,211,3998,24
38754,2,179,1632,132,4096,47
11784,61,3367,3069,2247,23442,1120
8457,10,113560,3252,39680,14202,73880
21673,75,3977,2518,3022,28532,955
45171,4,34,537,21,1812,13
30243,57,2656,2092,2028,20696,628
29039,7,378,2153,281,6254,97
39882,6,139,1564,113,4856,26
15375,34,4009,2835,3213,7277,796
11164,608,23280,3101,18431,73739,4849
4394,353,16372,3472,12468,180078,3904
18543,8,293,2683,231,6059,62
42136,15,438,1295,354,4629,84
31214,49,3582,2044,2533,18907,1049
14412,1,106,2892,78,4544,28
32063,15,1022,1998,656,16961,366
6384,43,2186,3380,1552,35346,634
13357,60,87683,2973,25278,58857,62405
34495,0,69,1902,63,2640,6
11321,3,379,3094,302,9931,77
31986,2,81,2003,69,3222,12
38548,8,314,1646,241,8763,73
4120,73,1559,3482,1231,16038,328
4667,17,488,3462,354,8365,134
22644,6,383,2468,284,6220,99
2211,132,8301,3521,5905,35586,2396
16465,12,332,2784,256,4113,76
2447,48,988,3517,796,8457,192
2507,264,10865,3516,8486,87129,2379
41652,165,5514,1379,3813,45064,1701
7385,135,7381,3330,5304,48716,2077
37496,2,124,1719,88,2566,36
23040,10,111,2450,86,1760,25
36686,62,1810,1770,1421,16173,389
28278,23,417,2195,347,10201,70
27990,96,3420,2211,2340,21765,1080
28563,70,2164,2177,1324,20991,840
43546,64,918,938,767,17139,151
13098,73,2988,2997,2174,31867,814
21099,0,432,2553,369,10764,63
42693,39,413,1179,320,6718,93
36199,422,23405,1795,16327,108418,7078
4948,3,40,3449,33,2985,7
10760,39,712,3123,532,3723,180
36492,249,3126,1780,2406,21169,720
33199,109,5968,1949,4638,56286,1330
14077,23,1537,2915,1254,20545,283
34668,30,349,1892,281,4872,68
17538,3,220,2726,178,6982,42
41224,17,396,1444,313,7908,83
15492,54,1061,2830,834,6228,227
8209,287,16698,3268,9351,37646,7347
37993,1,111,1685,96,3863,15
38814,25,678,1629,535,14055,143
18696,21,1500,2676,1047,20466,453
2986,4,285,3508,197,4166,88
29724,2,105,2118,91,8741,14
32808,41,872,1965,655,10928,217
26929,97,4907,2271,3309,42030,1598
38299,30,2058,1664,1503,23850,555
14261,11,328,2904,269,4096,59
38769,5,88,1631,72,3418,16
45527,12,141,439,125,3159,16
30207,2,97,2094,75,8404,22
9129,31,422,3211,330,4544,92
5562,50,653,3417,537,6991,116
4232,21,934,3479,741,25297,193
37952,12568,301255,1687,209276,852944,91979
41816,16,343,1347,248,4804,95
21724,272,19459,2516,13045,143570,6414
20175,1,142,2604,121,7447,21
25335,20,1205,2343,955,7972,250
16014,102,3229,2807,2368,16499,861
31876,5,116,2009,97,10016,19
1427,55,2107,3644,1610,24328,497
38216,5,250,1670,199,7675,51
18629,5,350,2679,273,4775,77
38191,11,196,1672,139,7653,57
42767,6,166,1162,126,7669,40
24787,11,311,2367,241,5773,70
2863,45,1003,3510,801,21739,202
27519,269,14237,2238,10376,56975,3861
12066,1,173,3057,144,4604,29
6985,20,271,3352,194,5175,77
27339,1,178,2250,142,1824,36
7870,31,1556,3298,1157,17895,399
1797,319,11098,3531,8170,51242,2928
31388,1,124,2034,94,5062,30
23526,241,12821,2426,9850,81666,2971
43844,7,156,845,112,4488,44
6672,3,151,3368,125,5883,26
8013,5,122,3284,106,1623,16
8755,22,675,3233,511,8983,164
12250,40,2487,3047,1753,45170,734
33442,5,442,1940,334,9444,108
4676,237,3832,3462,2897,32363,935
9441,53,907,3191,702,8376,205
24125,18,896,2397,747,6672,149
27228,5,347,2257,267,5202,80
13187,11,719,2984,577,12929,142
25433,15,479,2339,397,10890,82
3335,18,423,3502,338,15675,85
15939,98,2218,2810,1686,10041,532
19423,59,2915,2644,1960,10788,955
4040,156,8839,3485,6254,44906,2585
40192,8,133,1544,102,3390,31
8289,13,582,3263,478,15474,104
11912,2,94,3064,82,3850,12
36578,4,105,1776,92,3493,13
32265,115,2831,1988,2186,17408,645
3607,16,357,3497,294,4603,63
37423,22,379,1724,325,8753,54
18115,0,119,2701,101,4672,18
18016,10,537,2705,463,5823,74
4187,1,83,3480,46,1783,37
29083,20,532,2150,408,5332,124
35670,11,153,1832,124,5024,29
20776,18,846,2573,671,10190,175
37676,46,1719,1708,1304,12336,415
6076,113,7134,3392,5320,140702,1814
5676,1,66,3411,58,3320,8
4664,3,107,3462,86,3287,21
43603,229,3768,912,3228,31697,540
17093,4,275,2750,237,4681,38
14290,15,280,2902,201,6460,79
27260,298,6001,2254,4419,29973,1582
15925,9,470,2811,370,7364,100
3528,24,644,3498,522,24492,122
22373,7,496,2482,380,3766,116
31037,17,689,2052,552,6036,137
30382,5,136,2084,110,2288,26
3092,1,23,3506,21,2228,2
2930,29,1256,3509,1013,12700,243
18435,8,663,2687,404,4945,259
36352,3,85,1787,71,3134,14
5091,39,1072,3442,846,28798,226
2469,24,389,3517,312,4945,77
39026,5,107,1616,95,3479,12
16977,60,2316,2758,1867,21351,449
17535,2,116,2727,77,6817,39
21369,0,58,2536,50,2054,8
2571,28,561,3515,448,8674,113
28812,4,213,2164,175,5157,38
35267,0,626,1859,503,18133,123
41522,2,202,1400,151,5497,51
42441,39,503,1231,364,7983,139
7642,12,320,3315,258,8581,62
25567,80,2298,2333,1719,24761,579
34734,87,878,1889,671,8455,207
41995,165,4903,1320,3233,40969,1670
14498,145,5066,2886,3897,38689,1169
24530,18,610,2379,488,5396,122
5159,32,1341,3437,987,7761,354
19701,106,4263,2631,3188,14715,1075
21157,3,115,2548,104,3240,11
14797,17,438,2865,342,6280,96
40380,91,2003,1527,1434,39084,569
25281,0,58,2346,51,2566,7
5243,308,10672,3433,7852,65872,2820
29271,3,92,2141,73,1979,19
19335,6,333,2649,232,4689,101
22866,12,390,2458,317,6216,73
4751,9,557,3459,393,5257,164
43106,121,2076,1070,1539,23324,537
4996,2,133,3447,106,4616,27
22329,50,1677,2484,1382,10380,295
35200,4,155,1864,118,11061,37
22906,187,6731,2455,4910,37581,1821
37877,57,740,1692,530,6697,210
16950,316,19721,2759,14232,44202,5489
13909,8,566,2928,439,9676,127
15165,49,4366,2844,2781,24407,1585
27945,7996,382629,2213,188859,1025153,193770
3569,6,280,3497,217,9423,63
26857,11,441,2274,362,10567,79
16688,66,3046,2773,2153,18782,893
37634,60,724,1710,563,10228,161
41868,37,647,1340,486,9355,161
31057,9,534,2051,436,11937,98
5404,3,271,3424,221,15175,50
41872,21,451,1339,378,21095,73
6590,36,939,3371,700,10664,239
26301,25,1636,2299,1337,14745,299
31977,1,53,2004,41,4277,12
1723,11,250,3556,203,5559,47
9126,641,27282,3212,20477,246903,6805
12510,27,655,3031,524,7940,131
9643,33,1187,3179,762,8627,425
37055,10,488,1746,361,7238,127
46164,7,181,173,162,4241,19
28156,11,398,2202,329,8787,69
33679,8,447,1932,375,8381,72
44762,50,1035,680,761,13215,274
7452,207,5013,3326,3561,28857,1452
30242,6,333,2092,270,4778,63
32507,2,240,1978,180,4237,60
18361,1,81,2690,65,2782,16
19496,101,4766,2640,3638,31379,1128
4042,11,417,3485,313,8592,104
8052,5,265,3276,192,3120,73
29032,2,176,2153,153,4287,23
18466,15,1808,2686,1332,16412,476
45790,16,208,329,154,4389,54
40783,133,3054,1492,2487,25244,567
28518,135,8284,2180,6124,64956,2160
8407,51,2824,3255,2273,37970,551
8656,31,950,3239,783,9888,167
46184,12,150,165,126,3474,24
27460,8,627,2242,492,4101,135
17945,6,700,2710,561,26602,139
18526,64,2377,2684,1890,26515,487
40887,2,336,1481,236,7095,100
36030,6,294,1806,228,9977,66
19768,0,624,2626,457,12744,167
40707,29,1210,1499,808,18773,402
45758,8,100,339,89,1573,11
3812,12,293,3492,246,2996,47
15573,7,358,2825,261,9500,97
11686,6,176,3074,111,2435,65
36587,0,94,1775,83,3524,11
11956,21,644,3062,534,8763,110
16800,7,758,2766,600,13921,158
23114,69,2556,2445,1741,17739,815
38422,10,340,1655,270,8615,70
17997,0,601,2706,469,17340,132
27199,18,644,2258,514,7027,130
29946,2,138,2107,110,1578,28
5502,21,433,3420,319,12456,114
35551,3309,144628,1842,91402,503872,53226
12659,249,84469,3024,29753,120455,54716
13443,111,11145,2965,8459,40207,2686
12177,0,37,3051,19,1626,18
10432,5,76,3142,65,2594,11
7180,16,1909,3341,1524,47221,385
2747,577,26070,3512,18577,218351,7493
1819,92,2553,3530,1993,21659,560
26725,60,2330,2280,1785,18626,545
2511,24,2050,3516,1671,44823,379
17013,244,12718,2755,9854,65184,2864
27590,287,13816,2234,9873,80980,3943
32496,6,106,1979,81,2430,25
39100,11,369,1611,272,5886,97
4865,65,2256,3454,1728,15455,528
25221,16,947,2348,760,16030,187
1209,8,345,3766,304,11562,41
12031,98,17116,3059,11845,78047,5271
14259,298,7052,2905,5089,41970,1963
33349,3,109,1944,91,9305,18
41711,73,2132,1370,1676,20564,456
6922,18,202,3356,165,5073,37
22001,17,876,2500,650,11391,226
39727,7,128,1574,115,2830,13
45765,262,4247,331,3242,19107,1005
39962,38,651,1558,505,6799,146
6668,43,1050,3368,781,12094,269
26400,20,515,2294,421,10624,94
22569,12,380,2471,311,13294,69
14278,17,817,2904,657,19176,160
38038,0,543,1683,425,8228,118
7245,8,129,3339,113,2297,16
11323,71,2862,3094,2262,20009,600
36477,2,132,1782,96,9723,36
10540,46,1578,3137,1227,13909,351
35616,19,546,1837,447,9907,99
16219,53,3723,2797,2937,19214,786
26317,1,26,2299,24,2340,2
14906,109,3350,2859,2395,16275,955
15899,15,827,2812,590,15109,237
38255,70,1554,1667,1252,11759,302
31582,14,430,2023,347,4748,83
38568,1,111,1644,86,3771,25
8753,5,54,3233,44,2967,10
33352,159,5747,1944,4510,43504,1237
38586,6,238,1643,180,4429,58
27295,10,755,2252,608,9190,147
40168,5,116,1546,86,2147,30
13831,37,1859,2936,1448,14643,411
15959,39,7270,2809,5402,34686,1868
36232,21,551,1794,436,2912,115
18190,4,77,2698,62,3886,15
3847,8,233,3491,163,6597,70
25343,37,1119,2343,897,6835,222
42948,358,5272,1116,4013,45377,1259
24635,8,446,2373,380,5316,66
7129,9,178,3344,128,7569,50
3675,1,112,3495,84,1826,28
24136,8,321,2397,269,10294,52
12444,11,1016,3035,841,24650,175
7611,87,3499,3317,2683,22897,816
8863,130,11272,3227,8209,88768,3063
9911,3,170,3167,139,2272,31
45204,5,39,528,26,2756,13
32690,330,12846,1970,9770,89214,3076
10748,24,1998,3124,1359,16829,639
43165,65,695,1053,513,13669,182
10895,97,2457,3116,1931,38857,526
29911,81,4754,2108,3444,36227,1310
30521,211,5203,2075,3944,46887,1259
14775,0,1417,2867,1054,26458,363
18996,29,3728,2664,2598,27322,1130
6787,23,560,3363,429,6779,131
14330,25,1227,2898,994,11887,233
2658,4,169,3514,140,7513,29
22978,5,418,2451,299,8873,119
15770,30,1150,2816,883,18414,267
3570,274,11746,3497,8654,56681,3092
37507,21,707,1718,590,11549,117
8267,46,972,3265,765,28752,207
38475,183,13464,1652,9971,62406,3493
36716,5,472,1768,396,8538,76
18054,1125,28747,2704,22112,134526,6635
29304,20,569,2139,449,6020,120
24558,9,624,2377,504,14010,120
24937,12,268,2360,188,17301,80
17397,12,1073,2733,790,7087,283
44713,822,19552,694,15226,76711,4326
19162,0,142,2658,65,3426,77
6798,174,4829,3362,3602,37211,1227
40416,269,6287,1525,4683,34405,1604
32884,15,411,1962,308,6504,103
22684,10,1028,2467,872,4839,156
31188,2,36,2044,32,2949,4
23173,49,1819,2443,1342,6999,477
18257,163,9264,2695,6425,70938,2839
12837,2,517,3013,402,14298,115
37417,2,50,1724,43,2173,7
3834,174,17448,3491,12633,61417,4815
29509,25,1184,2128,945,29938,239
23808,0,9161,2413,7115,57552,2046
21623,4,308,2521,244,4178,64
38755,1,99,1632,81,5494,18
3068,40,1490,3507,1102,25506,388
11530,16,287,3082,220,2963,67
28910,1,255,2160,211,4840,44
13039,16,397,3001,332,8940,65
41496,21,1049,1402,742,17079,307
38330,31,6311,1662,4942,8230,1369
33627,109,3206,1934,2379,19106,827
26160,4,158,2306,133,5616,25
2452,18,214,3517,183,9177,31
15560,12,897,2826,690,6431,207
25817,37,1715,2321,1275,11616,440
34518,6,280,1901,241,5011,39
39901,1,45,1562,36,4027,9
13335,2,138,2974,113,3276,25
2734,489,32181,3513,22549,150404,9632
25724,1,70,2325,63,4277,7
46360,71,995,107,880,10094,115
21130,14,1982,2551,1266,16035,716
29421,0,75,2133,58,2937,17
31040,3,62,2052,53,4054,9
20346,54,4299,2596,3246,26620,1053
40027,11,439,1554,329,10617,110
21817,2,78,2512,58,2317,20
38527,19,1344,1648,1010,12519,334
36106,23,391,1800,329,7791,62
13107,44,2027,2996,1534,24808,493
9806,0,54,3171,44,3680,10
40794,8,415,1490,287,9169,128
14353,0,157,2897,131,4804,26
16578,4,338,2779,262,10723,76
40931,9,122,1478,98,3796,24
12320,5,186,3043,147,3764,39
33367,6,228,1943,183,6112,45
6489,1,15,3376,11,3298,4
21973,4,160,2502,139,9337,21
45963,21,211,260,160,2553,51
19124,287,16467,2659,12468,102025,3999
23152,2,114,2444,81,4295,33
45998,41,755,247,602,9166,153
7937,15,251,3290,193,4466,58
29292,28,1200,2140,962,7306,238
26673,21,628,2283,463,5187,165
18382,4,547,2690,369,8589,178
15412,6445,344495,2834,231909,1042700,112586
5995,2,70,3395,58,3149,12
44501,1145,17745,744,14945,82839,2800
32143,5,249,1994,192,3945,57
15781,3759,134685,2816,96394,375176,38291
39730,46,813,1574,623,9307,190
20713,1060,77978,2576,59103,379874,18875
38462,18,700,1652,541,7148,159
15014,44,1098,2853,880,9465,218
33431,28,761,1941,448,6921,313
24208,43,2481,2394,1953,18332,528
29339,3,298,2136,218,5023,80
39432,16,432,1591,316,6624,116
8270,46,1274,3264,1017,11985,257
26038,343,24300,2311,17650,93495,6650
45635,0,1128,397,984,12100,144
12668,17,338,3023,254,5255,84
21075,11,1530,2554,1266,18258,264
33787,48,1376,1927,1051,9661,325
41665,17,792,1377,596,16093,196
43265,8,229,1024,173,5535,56
12197,3,225,3050,165,10274,60
25157,0,43,2351,29,3566,14
41777,57,925,1358,719,8524,206
5727,179,8966,3408,6570,74166,2396
42420,41,1140,1235,826,10412,314
40626,5,86,1505,69,1775,17
29745,0,126,2118,100,2846,26
23757,132,4117,2415,2846,26030,1271
35821,6,181,1821,155,3251,26
36881,3,143,1757,117,2030,26
9289,7,190,3202,162,10631,28
7637,94,3949,3315,2817,31471,1132
18024,1,64,2705,55,4183,9
25610,17,1503,2330,1202,9320,301
38506,7,417,1650,333,3094,84
8513,58,1566,3248,1109,27801,457
8242,5,117,3266,108,4384,9
29944,17,424,2107,339,7472,85
23181,334,14891,2443,11013,44792,3878
38074,13,317,1680,238,6134,79
29860,9,1193,2111,1028,7137,165
4494,43,1282,3469,931,15967,351
42037,401,8891,1313,6323,82111,2568
25470,17,453,2338,364,4903,89
34860,12,636,1881,500,11206,136
30603,506,33854,2072,24874,200766,8980
19892,73,3272,2620,2456,13348,816
19789,17,512,2625,401,6703,111
8495,25,1169,3249,837,11039,332
34240,3,77,1913,59,2300,18
39314,8,304,1597,253,9989,51
28379,371,18193,2189,13496,96193,4697
35370,18,1075,1855,852,10973,223
8488,21,367,3249,305,13361,62
2281,3,43,3520,35,3568,8
8929,17,508,3223,424,8005,84
12120,29,1568,3054,1299,22352,269
24290,3,234,2390,170,3932,64
30760,53,1871,2064,1404,23975,467
42212,178,2842,1277,2108,35925,734
10581,5,338,3134,269,5068,69
39302,57,1507,1597,1188,9951,319
23448,6,366,2429,249,4708,117
43469,34,621,961,512,14036,109
14817,24,1572,2864,1108,19720,464
30877,58,4082,2059,3386,25601,696
4729,20,850,3460,670,14158,180
9088,51,1849,3214,1472,12309,377
43199,3,190,1044,110,4748,80
27425,190,9394,2245,7110,40795,2284
8265,30,1317,3265,1097,23681,220
8809,5,533,3229,456,24540,77
18521,1,148,2684,115,3555,33
19138,42,1733,2659,1326,27924,407
21350,7,566,2537,461,13802,105
42674,37,878,1184,695,13889,183
7572,243,6538,3319,5036,41887,1502
27759,12,428,2225,349,6550,79
19262,268,19990,2652,14472,101616,5518
5953,6,180,3396,133,5016,47
28693,1,141,2170,120,7129,21
20642,110,3051,2581,2368,10857,683
22636,1,82,2469,75,2439,7
31980,38,2786,2003,2154,5738,632
43606,0,18,913,14,2896,4
18153,6,305,2700,249,5690,56
45478,22,145,452,123,4443,22
15890,10,486,2812,387,6730,99
3932,54,5997,3489,4331,26220,1666
31624,46,1005,2021,797,9272,208
43273,92,2945,1021,2017,26709,928
19967,3,250,2615,218,4055,32
22183,3,110,2491,90,5711,20
40699,252,5959,1499,4556,44243,1403
4138,31,868,3482,685,16598,183
2178,207,7519,3522,5580,90639,1939
5117,34,919,3440,700,15429,219
45988,4,52,250,37,1206,15
14627,1,51,2878,38,2634,13
6896,1,91,3358,67,9591,24
41005,552,11556,1472,8773,50197,2783
16854,51,2736,2763,2154,41183,582
38627,4,151,1640,123,6108,28
23390,13,345,2432,283,3690,62
10294,31,1544,3149,1153,13355,391
9724,118,6315,3176,4588,49746,1727
4031,7,402,3485,302,5011,100
4165,200,9413,3481,7498,43770,1915
27332,26,682,2251,508,5465,174
41881,33,566,1337,391,16162,175
23536,0,32,2425,27,8042,5
6733,21,440,3365,328,6630,112
24180,25,696,2395,540,8891,156
45372,38,520,479,377,6059,143
25052,25,639,2356,438,7386,201
39011,10,482,1617,337,15933,145
23098,2,113,2446,80,3279,33
40524,9,412,1515,294,5712,118
30048,47,1483,2103,1097,14701,386
33707,9,182,1931,148,3217,34
14180,5,263,2910,182,7935,81
9058,92,5391,3216,3899,27386,1492
9471,0,148,3189,117,2774,31
35176,3,77,1864,62,2832,15
18798,3,69,2672,60,4632,9
27034,17,374,2268,319,5444,55
23466,4,69,2428,58,3089,11
18278,27,757,2694,575,5121,182
9918,20,424,3167,337,15968,87
33077,3,76,1954,66,2954,10
17026,15,461,2754,361,6488,100
13500,80,4761,2961,3630,39047,1131
32365,45,809,1984,640,10541,169
37519,2,232,1717,201,12281,31
45895,235,3469,293,2714,15510,755
19419,104,5059,2644,3009,35008,2050
6280,60,1805,3385,1412,20421,393
31150,13,393,2047,322,12015,71
29533,6,319,2128,234,4366,85
16546,29,3520,2780,2198,17418,1322
10850,0,33,3118,27,2893,6
23972,1,65,2404,58,2814,7
33166,25,803,1950,677,13898,126
13447,13,687,2964,546,9331,141
3225,39,1410,3504,975,8778,435
19883,10,407,2620,324,4945,83
17113,85,1656,2749,1255,18526,401
11428,0,81,3089,53,3030,28
10284,7,258,3149,179,3512,79
9893,8,574,3168,458,13865,116
42957,1,68,1114,48,2443,20
45210,36,272,527,195,3418,77
43171,3,149,1050,92,4226,57
20452,19,1529,2590,1232,16420,297
28304,42,1549,2193,1190,12338,359
9559,3,91,3184,78,2737,13
3623,20,380,3496,300,9051,80
12232,7,236,3048,188,3787,48
23924,63,3137,2407,2275,36196,862
40281,7,166,1538,137,2517,29
21999,425,11116,2500,9094,50949,2022
23283,1,45,2438,41,2890,4
28296,7,394,2194,293,4938,101
21839,21,720,2511,575,8849,145
16469,1,52,2784,42,6803,10
41042,194,4520,1468,3402,27751,1118
41842,3,143,1344,101,10585,42
2532,2,29,3516,27,3554,2
17254,79,3367,2740,2502,22264,865
20323,12,621,2597,509,24901,112
18955,8,937,2666,661,6405,276
40528,7,158,1514,105,6711,53
20468,23,661,2590,519,13612,142
27798,0,174,2222,138,5994,36
29199,122,4703,2145,3541,36198,1162
25788,16,339,2322,272,5052,67
4523,18,771,3468,571,18308,200
5454,16,400,3422,300,10220,100
37711,11,267,1705,212,9532,55
5867,28,832,3401,628,6759,204
36080,47,1671,1802,1206,19019,465
10728,126,4758,3125,3712,53836,1046
5362,4,82,3427,69,5395,13
39665,30,1389,1577,1085,10780,304
3838,16,589,3491,396,5732,193
30135,5,320,2099,249,4481,71
43576,12,121,928,96,4810,25
21647,4,105,2520,82,5668,23
30406,14,367,2082,312,13617,55
29071,4,212,2151,179,5195,33
20350,5,249,2596,204,6333,45
13249,51,1524,2980,1110,21726,414
18948,5,169,2666,129,2578,40
38804,0,36,1629,23,4872,13
45411,21,170,467,137,5082,33
38490,33,1153,1651,879,14588,274
25666,10,384,2327,304,5964,80
26564,0,157,2287,140,3342,17
45606,12,386,413,335,9005,51
30491,22,926,2078,678,10950,248
46173,3,44,170,33,1907,11
3103,5,77,3506,61,2413,16
43304,412,9679,1012,6682,66822,2997
9267,8,208,3203,152,12180,56
4652,32,505,3463,411,9041,94
7267,18,797,3337,643,16796,154
12857,127,51424,3012,22929,70817,28495
11483,384,27780,3085,17789,141585,9991
2628,9,372,3514,283,5464,89
18482,8,495,2685,393,5831,102
10686,2,66,3127,51,3096,15
3992,16,356,3486,216,9782,140
2164,8,174,3522,134,5683,40
9092,137,6500,3213,4861,47893,1639
16399,86,7852,2787,5369,46350,2483
5716,18,558,3409,492,7555,66
9470,4,327,3189,242,8405,85
29386,103,3694,2134,2793,21320,901
31571,6,102,2024,88,3448,14
25137,82,4757,2351,3803,48051,954
4198,36,1320,3480,1016,32177,304
23655,3,47,2419,38,18989,9
34166,2,89,1915,78,3281,11
14163,67,3004,2912,2454,12348,550
19844,1,131,2622,111,9905,20
43439,6,146,968,81,2722,65
38764,8,271,1632,201,6266,70
8231,7,63,3267,54,6101,9
17585,10,458,2724,363,12872,95
19577,3,312,2637,264,3730,48
26872,7,629,2273,477,10879,152
21832,0,481,2511,319,3289,162
28895,6,437,2160,359,9212,78
23825,0,173,2412,145,5713,28
17624,311,26116,2723,18064,126090,8052
36449,0,29,1783,21,4656,8
16156,12,575,2799,437,5931,138
3082,38,1460,3506,1211,15250,249
37097,5,275,1744,225,8156,50
42638,9,158,1193,119,5616,39
5546,33,758,3418,585,8957,173
28076,23,1157,2206,936,19632,221
42466,6,168,1226,95,5818,73
24614,286,5634,2374,4411,29566,1223
33963,142,7674,1922,5465,45887,2209
19109,62,4103,2660,3214,29499,889
5450,2,59,3422,42,3532,17
22446,963,39568,2479,29722,146967,9846
19150,142,7070,2658,4924,91116,2146
3431,3,34,3500,31,4810,3
15371,3,156,2835,133,4527,23
10827,6,128,3120,108,5250,20
16305,28,2711,2792,2073,19325,638
29905,51,1265,2109,984,14161,281
35196,5,349,1864,288,7149,61
38176,1,68,1673,58,3725,10
14957,64,20005,2856,7970,16525,12035
42557,6,145,1208,109,3491,36
32984,4,145,1958,111,3260,34
11236,9,145,3098,115,3291,30
4998,4,42,3447,37,1635,5
46283,0,13,138,12,1250,1
44148,11,111,797,88,7929,23
39485,26,1214,1588,851,10294,363
36065,14,676,1803,560,15152,116
35253,5,137,1860,114,4259,23
26098,35,815,2309,654,8168,161
15952,133,8438,2810,6784,33799,1654
18315,8,296,2692,245,5378,51
28628,66,3375,2174,2562,26393,813
15860,14,440,2813,344,6967,96
44138,8,130,799,83,3782,47
45281,152,2988,498,2261,33331,727
3702,123,5779,3494,4401,50431,1378
41843,32,756,1344,554,13207,202
18441,30,2305,2687,1374,23957,931
18701,1,67,2676,54,2232,13
32238,55,2292,1989,1749,12639,543
39449,86,1499,1590,1186,17889,313
11449,1316,114554,3087,71532,418689,43022
30321,4,141,2087,104,9334,37
3438,7,333,3500,262,9046,71
2618,16,485,3514,377,16951,108
24022,18,2134,2402,1575,20589,559
8670,2,103,3238,87,2515,16
17763,6,499,2718,408,16275,91
7308,42,1428,3335,1093,8999,335
44661,5,76,714,43,1427,33
37131,31,571,1742,474,11387,97
22647,10,847,2468,651,6671,196
42734,36,633,1170,439,8704,194
36365,803,27724,1786,21188,155445,6536
43041,14,533,1090,361,11790,172
33483,4,153,1939,103,3471,50
45131,25,212,549,144,3671,68
20882,5,208,2565,154,2683,54
43585,16,285,924,200,4935,85
38048,9,623,1682,502,9725,121
4814,52,2638,3456,1941,37706,697
17722,6,184,2720,142,2488,42
40355,5,227,1530,184,6545,43
35410,9,425,1853,363,12890,62
38273,94,3047,1666,2267,26145,780
27733,1,54,2226,45,1767,9
10944,4,61,3113,50,2251,11
3214,2,71,3504,50,6000,21
20342,66,4067,2596,2659,17622,1408
36927,9,280,1755,227,12816,53
36854,989,44838,1758,30481,226378,14357
44977,7,85,616,57,1878,28
35598,18,309,1838,254,2967,55
29089,1,41,2150,37,1626,4
10030,432,15866,3161,10882,52560,4984
41930,28,349,1330,273,6535,76
22493,55,3427,2476,2485,28094,942
45580,0,83,418,73,2003,10
15711,0,1363,2819,988,10250,375
43460,185,1700,966,1247,10218,453
20547,10,286,2585,238,8308,48
43644,17,908,900,735,7759,173
34470,1,39,1903,29,3115,10
45100,8,167,564,148,7429,19
15576,5,221,2825,155,6548,66
18612,1,113,2680,89,1881,24
40843,8,88,1485,66,3263,22
17243,41,865,2741,688,13735,177
30421,7,392,2082,310,9398,82
14551,1,35,2883,28,3337,7
22694,36,2484,2466,1986,27336,498
40464,14,245,1520,160,4419,85
44089,289,14050,797,9351,64102,4699
25726,0,56,2325,50,3216,6
18832,6,485,2670,395,4873,90
42408,4,363,1239,262,6651,101
11518,11,516,3083,374,12433,142
40269,36,1106,1538,840,15290,266
35264,30,1157,1859,921,13333,236
45994,11,99,248,87,2109,12
1840,1786,108860,3529,66933,320667,41927
36412,1,109,1784,90,4431,19
36046,15,196,1805,174,1592,22
8694,10,308,3236,241,3167,67
28959,29,1010,2157,653,11213,357
45829,10,73,315,71,2884,2
15057,153,26379,2850,11374,26964,15005
38371,8,186,1659,148,4216,38
9554,4,89,3184,74,4350,15
4558,7,278,3466,189,2891,89
4005,52,1359,3486,1072,14621,287
42510,137,1862,1216,1321,17085,541
35720,49,2396,1828,1826,20236,570
10193,59,1805,3153,1290,36233,515
28499,19,1201,2182,811,22925,390
1661,8,253,3570,196,8967,57
37827,0,119,1696,87,2555,32
7551,0,103,3321,88,3204,15
15500,144,5874,2830,3942,23030,1932
45650,52,801,388,689,7337,112
13452,73,2288,2964,1821,30843,467
28302,13,460,2194,325,6496,135
30012,60,2266,2104,1883,15869,383
42219,91,1867,1274,1304,12689,563
9695,2,85,3177,56,8431,29
20084,73,1496,2609,1117,13464,379
35487,432,10396,1847,7597,61381,2799
1838,57,1273,3529,1021,16062,252
13430,16,742,2967,608,27086,134
35075,5,175,1870,139,5493,36
39874,841,31232,1565,22822,186478,8410
30013,20,636,2104,522,7293,114
45209,278,2639,527,2163,22415,476
5789,55,1199,3406,935,7860,264
31907,3,167,2007,119,8701,48
26609,38,1131,2286,883,18932,248
22043,17,771,2498,594,15966,177
19568,19,1116,2637,865,31318,251
22291,43,1177,2485,847,13516,330
26602,10,791,2286,577,10284,214
41543,71,3098,1397,2301,22075,797
36990,1,108,1751,97,3359,11
33510,15,434,1937,360,7084,74
17003,106,4977,2756,3724,29707,1253
7030,0,13,3349,10,1831,3
29589,546,11848,2125,9233,58342,2615
45513,78,690,443,529,13445,161
46080,0,34,208,18,2532,16
5219,14,636,3434,506,10724,130
36306,1,66,1790,48,3564,18
21345,18,726,2538,600,4087,126
5913,24,432,3399,360,9643,72
39438,7,105,1590,86,5031,19
19690,3,123,2632,92,6036,31
11463,17,1422,3086,1111,15662,311
4186,801,39229,3480,26836,110260,12393
11333,103,4587,3094,3426,35246,1161
36530,4,81,1778,73,3842,8
29923,6,103,2108,82,2459,21
19537,0,76,2639,53,3849,23
44652,5,186,718,156,4251,30
13832,29,696,2936,551,13688,145
21250,11,328,2542,272,10768,56
10132,14,1120,3156,838,30024,282
12312,11,89,3043,72,4632,17
7373,11,598,3330,490,8134,108
31000,51,2713,2054,2005,32852,708
13536,704,26087,2958,18522,82275,7565
28207,19,1345,2199,1075,8675,270
34122,23,1704,1916,1302,16465,402
38933,0,19,1621,17,6109,2
3948,27,785,3488,607,10260,178
11708,1,172,3073,136,6837,36
12092,14,743,3056,604,11210,139
13159,6,174,2985,149,7152,25
1563,2,55,3590,45,1971,10
27782,19,1236,2223,1030,22806,206
21446,20,641,2532,525,6895,116
37576,2,248,1713,185,8804,63
13245,3,137,2981,108,3553,29
41445,5,117,1409,102,2954,15
25725,34,1128,2325,915,7688,213
13783,883,33791,2940,22718,84128,11073
9240,9,339,3205,271,10750,68
35097,416,24425,1869,18657,96127,5768
32038,0,0,2001,0,9674,0
40228,107,2196,1541,1647,14570,549
3839,7,185,3491,123,7657,62
33772,5,156,1928,132,2387,24
29845,10,862,2113,689,9633,173
7395,68,2041,3329,1478,16478,563
18454,2,173,2687,121,4965,52
22240,0,743,2488,582,10840,161
4713,23,584,3460,436,19385,148
12773,2,126,3017,101,2298,25
26770,21,647,2278,500,7827,147
37044,25,651,1747,490,8640,161
37461,3,129,1722,105,6401,24
20487,45,3741,2589,2868,17690,873
13774,6,370,2940,300,8553,70
34781,142,6315,1886,4706,55990,1609
6523,31,1032,3374,759,5853,273
27628,14,463,2232,366,9405,97
12920,1,59,3009,44,2235,15
37170,8,316,1740,171,8062,145
16391,23,1217,2787,996,13012,221
39758,52,748,1573,580,7796,168
29617,12,342,2123,298,12573,44
29021,7,676,2154,533,13141,143
43887,44,295,841,244,4754,51
31464,644,13556,2030,9676,48236,3880
10666,50,1673,3129,1211,16670,462
15336,363,17898,2836,12661,84527,5237
31543,14,258,2025,222,4769,36
29392,14,2375,2134,1707,34090,668
17799,5,272,2717,206,5362,66
28078,7,252,2206,200,3741,52
2393,27,1019,3518,782,22322,237
35634,2,150,1836,110,3643,40
29524,1,258,2128,210,7159,48
19365,0,144,2647,109,2116,35
36611,0,196,1773,153,4151,43
4903,32,1894,3451,1543,6474,351
6854,1702,74575,3359,53921,229051,20654
26257,8,286,2301,203,5340,83
10787,1,66,3122,54,3442,12
20124,1,84,2607,69,2796,15
45271,235,2454,506,2033,23521,421
23128,5,470,2445,385,5608,85
43213,3,146,1041,107,7284,39
14592,43,2144,2880,1630,33155,514
8599,6,302,3243,267,10285,35
18550,227,10001,2683,7480,111377,2521
27843,13,675,2220,542,5482,133
4223,12,369,3479,297,6229,72
8405,246,9670,3255,7389,81684,2281
16735,9,229,2771,198,4026,31
21264,8,435,2541,365,4304,70
16416,10,635,2786,483,12875,152
46358,35,383,108,329,6082,54
11852,14,593,3067,475,8633,118
9712,8,117,3177,72,6271,45
23238,6,241,2440,202,2993,39
33346,202,19064,1944,12949,92744,6115
3061,48,956,3507,689,11875,267
32514,10,718,1978,579,13137,139
31391,11,374,2034,318,7176,56
28473,17,395,2184,325,2279,70
43693,5,150,884,99,2905,51
31056,4,226,2051,182,10033,44
34047,10,428,1919,312,5219,116
30227,2,96,2093,77,1958,19
38297,10,194,1664,159,4247,35
7518,7,332,3322,300,5316,32
21941,0,6691,2504,5001,43791,1690
43197,243,4860,1045,3687,43049,1173
2717,8,118,3513,100,18600,18
14724,0,644,2871,518,25614,126
2736,19,1358,3513,1112,14740,246
27730,346,14246,2226,10371,102306,3875
37442,63,1526,1723,1158,9516,368
17760,5,221,2718,169,4064,52
16943,278,25813,2759,18593,129914,7220
36731,10,643,1768,415,6796,228
15709,0,3662,2819,2825,17398,837
20530,80,2526,2586,1894,11385,632
7007,4,262,3351,220,7795,42
4572,24,726,3465,617,7619,109
2020,5,77,3524,69,4155,8
15033,0,916,2852,702,4147,214
44862,201,2428,646,1917,15420,511
36564,0,114,1777,99,2652,15
7287,13,403,3336,288,4182,115
44476,26,403,748,277,6727,126
37326,1,83,1730,71,4368,12
31395,3,114,2034,85,3146,29
29598,59,2370,2125,1754,24142,616
45160,1,38,540,20,2941,18
14649,45,3006,2876,2203,17191,803
41383,4,149,1419,111,3893,38
7133,3,82,3344,55,1935,27
19264,49,3523,2652,2746,28833,777
5331,46,2297,3428,1887,23043,410
9552,24,378,3184,269,5005,109
46272,66,1615,142,1098,17465,517
42034,5,80,1313,67,3682,13
31800,10,456,2012,272,7715,184
26339,35,693,2298,537,12633,156
28134,78,3906,2204,2752,22215,1154
5015,12,296,3446,249,10232,47
43894,3,35,839,30,1633,5
34085,22,383,1918,305,4147,78
38706,34,1113,1635,811,6234,302
28569,4,244,2177,201,14901,43
34319,4,159,1910,116,4528,43
30228,0,44,2093,36,1560,8
36776,4,157,1764,115,6304,42
35093,3,453,1869,349,7559,104
7525,82,4186,3322,3279,70027,907
15917,3,540,2812,460,33419,80
41396,41,1050,1418,773,28007,277
41019,227,6010,1471,4335,51003,1675
41040,111,4497,1469,2925,40460,1572
34313,16,261,1910,196,3273,65
12049,113,4936,3058,3760,25161,1176
40649,82,2273,1504,1694,16131,579
2061,8,337,3523,255,24642,82
16438,6,248,2785,210,4160,38
12399,3,146,3038,118,2571,28
12573,17,584,3029,461,5707,123
43849,11,96,845,76,2244,20
42951,0,50,1115,36,2556,14
21331,11,512,2538,389,8746,123
16457,284,15528,2785,10425,79535,5103
33924,2,574,1923,431,13006,143
11656,75,3701,3076,2774,36789,927
6511,13,836,3374,634,7603,202
23794,1,116,2413,93,5806,23
39768,0,0,1572,0,4962,0
15436,66,4363,2833,3324,38988,1039
24634,98,7996,2373,5793,44961,2203
16626,0,1177,2777,877,17206,300
37734,11,427,1704,319,4338,108
24835,65,5895,2365,4553,75730,1342
21027,17,461,2556,359,9511,102
32149,1,49,1994,35,2719,14
45211,17,180,525,112,2604,68
14673,125,4833,2875,3599,26787,1234
30296,2,287,2090,223,5526,64
4524,10,106,3468,75,7772,31
25871,532,61856,2319,43741,205976,18115
26459,0,29,2292,25,1602,4
43269,6,334,1022,205,3272,129
4720,3,108,3460,88,3087,20
20388,37,1248,2594,974,17452,274
3821,685,38356,3492,25788,285960,12568
23455,12,512,2429,352,10304,160
2846,64,1210,3511,985,18264,225
4543,129,5383,3467,4133,55758,1250
33002,2,135,1957,66,4225,69
5561,32,1381,3417,1068,10744,313
10323,6,156,3147,118,4361,38
32761,0,24,1968,18,2021,6
8524,12,482,3247,410,12128,72
14015,18,1408,2919,1150,21226,258
28041,1,148,2208,106,6795,42
35569,9,349,1841,279,5613,70
14615,0,158,2878,131,23524,27
2549,25,951,3515,671,8988,280
34176,16,210,1915,170,2162,40
13263,10,273,2980,193,12321,80
2364,44,2169,3519,1660,17079,509
42966,22,220,1113,168,9535,52
18149,11,511,2700,401,8487,110
38172,29,369,1673,281,4884,88
14467,1,74,2889,61,3589,13
16426,86,6130,2786,4117,33626,2013
43421,85,1705,974,1383,24634,322
33419,125,5550,1942,3819,48316,1731
7378,10,115,3330,71,6163,44
10458,18,2587,3141,1994,11884,593
34380,28,554,1907,453,4523,101
19381,7,227,2647,169,9682,58
9181,120,4038,3207,3157,29336,881
3961,478,15912,3488,12110,152903,3802
18588,1,125,2681,107,1974,18
16829,4,152,2765,133,2243,19
38842,94,7688,1627,5806,57008,1882
31161,0,37,2046,32,2145,5
25972,0,655,2314,506,8182,149
3734,3,241,3494,186,12331,55
12331,688,47212,3042,29549,111019,17663
3356,3,86,3501,57,3707,29
6895,88,3184,3358,2551,19104,633
19848,43,2255,2622,1745,52572,510
10817,11,113,3120,90,4709,23
26287,0,180,2300,145,6978,35
18049,6,421,2704,294,8437,127
38427,104,3270,1655,2511,14728,759
20351,24,488,2596,407,3937,81
32176,1,99,1992,75,4434,24
31950,14,617,2005,490,7834,127
38796,35,501,1630,426,14611,75
3976,85,4044,3487,2975,57789,1069
15313,24,1313,2837,1080,7343,233
28915,23,773,2160,605,8957,168
40072,0,212,1551,156,3384,56
33737,17,603,1929,483,5559,120
19148,23,451,2658,382,5037,69
31082,170,2859,2050,2178,16146,681
37151,4,165,1741,129,12152,36
25475,14,334,2338,264,4922,70
35956,55,2610,1812,2135,33006,475
18148,77,3778,2700,2784,28416,994
23318,7,293,2436,240,10451,53
8657,78,124638,3239,35360,19369,89278
35808,28,1189,1822,951,15618,238
39622,59,2028,1580,1576,26697,452
25389,189,7612,2341,5888,80206,1724
36561,287,8182,1777,6290,38735,1892
43117,347,12964,1066,7285,85197,5679
11265,217,6690,3096,5020,81382,1670
16769,50,2548,2768,1833,18996,715
38290,6,293,1665,257,7644,36
13483,107,3461,2962,2716,48388,745
6971,22,795,3353,596,13773,199
40816,55,1605,1487,1173,17804,432
22338,53,2479,2484,1880,17024,599
40035,33,832,1553,635,14092,197
7556,7,240,3320,202,5921,38
22631,12,707,2470,497,8456,210
27792,6,500,2222,396,6593,104
34212,4,136,1914,111,8037,25
39928,79,1483,1561,1178,15689,305
42280,23,607,1263,467,7236,140
20437,9,495,2591,379,5009,116
12826,4,58,3014,49,2404,9
7481,56,2990,3325,2386,19955,604
12319,55,1673,3043,1212,10619,461
31666,244,10983,2019,7689,73670,3294
18879,10,395,2668,294,2930,101
22079,2,329,2496,230,7778,99
7631,11,141,3315,121,3545,20
20120,40,2334,2607,1735,14933,599
32242,5,97,1989,82,3801,15
7565,3,43,3320,39,2867,4
43056,9,149,1086,112,3843,37
27357,96,13633,2249,10171,58460,3462
36430,50,1237,1784,891,15633,346
42929,218,2798,1121,2110,22859,688
30572,3,132,2073,98,3819,34
31649,51,776,2019,607,6986,169
9402,2,142,3193,113,5295,29
16061,16,706,2804,587,7828,119
41680,12,361,1375,291,6535,70
4192,682,32506,3480,22563,76485,9943
2395,53,1699,3518,1384,29723,315
31104,2,198,2049,144,2989,54
35675,154,2592,1832,1752,16129,840
44673,70,1064,709,798,9164,266
43427,12,124,974,98,2310,26
41865,11,370,1340,303,11922,67
46178,3,68,167,35,1603,33
35713,31,1591,1829,1252,15274,339
4885,188,3690,3452,2763,56739,927
30229,52,1434,2093,1203,19377,231
9218,193,10899,3206,7514,31869,3385
5963,157,4539,3396,3500,21283,1039
10147,88,4506,3156,3515,39364,991
36660,26,870,1771,591,4802,279
7529,3,43,3322,39,1450,4
44699,28,267,701,224,6334,43
41025,29,498,1471,373,9061,125
8371,10,243,3257,194,8067,49
37592,14,356,1713,271,6385,85
19917,54,5336,2618,4085,49260,1251
5417,7,317,3424,227,8271,90
16196,50,6127,2798,4482,35696,1645
45872,21,365,302,258,4883,107
31224,24,632,2043,519,4110,113
16757,86,1881,2769,1444,13321,437
9626,5,273,3180,218,6692,55
3462,140,4882,3499,3836,44054,1046
36034,2,55,1806,45,3754,10
37620,4,130,1711,106,5483,24
28265,3,83,2196,66,4113,17
13030,9,154,3002,132,12848,22
18015,12,453,2705,378,6153,75
27784,3,133,2223,107,3185,26
36505,0,31,1780,25,2379,6
27023,123,3039,2268,2388,15071,651
16844,1,138,2764,116,3982,22
22049,1,32,2498,29,1619,3
13009,125,6377,3003,5142,22176,1235
25690,30,1399,2327,1103,18148,296
1961,12,331,3525,262,9005,69
31062,32,1416,2051,1099,10653,317
12761,92,4835,3018,3632,41385,1203
8278,4,96,3264,72,3398,24
21017,3,466,2556,353,5793,113
3639,2,32,3496,25,3401,7
15215,6,214,2842,138,5179,76
6839,8,120,3360,94,2855,26
2122,2,373,3522,283,16702,90
24119,68,2344,2398,1851,30714,493
33051,13,445,1955,346,13417,99
7181,4,66,3341,52,2388,14
2450,21,654,3517,505,20660,149
5684,689,29419,3410,20848,108778,8571
4499,30,834,3469,640,12564,194
28648,2,130,2173,106,3838,24
39815,30,2206,1569,1661,12213,545
11569,5,347,3081,260,2588,87
25384,0,24,2341,18,2173,6
36120,3,181,1799,144,3465,37
25500,21,2940,2336,2111,21500,829
9341,35,1299,3197,901,12105,398
26975,14,261,2269,213,6534,48
11673,9,225,3075,170,5409,55
13360,312,12430,2972,9369,63419,3061
39701,49,1800,1575,1439,30201,361
40862,48,889,1483,625,17798,264
23301,13,396,2436,328,6359,68
35146,4,46,1866,39,3181,7
27440,18,1370,2244,1054,22366,316
2114,320,8647,3523,6387,48935,2260
15922,13,435,2811,328,3629,107
45336,25,691,488,566,3795,125
12410,0,33,3037,26,2691,7
14078,21,681,2915,487,9265,194
30353,4,115,2086,89,4606,26
20068,48,1095,2610,797,13373,298
43997,48,826,823,741,14977,85
7750,31,378,3308,313,4915,65
14920,243,6846,2858,5390,35799,1456
21226,113,9445,2543,6503,42512,2942
8757,80,86917,3232,31554,16998,55363
11315,8,201,3095,171,3518,30
29528,4,102,2128,77,2663,25
3890,3,202,3490,149,7498,53
30472,13,580,2079,444,5800,136
23208,7800,351925,2441,225505,874777,126420
26635,39,1018,2285,770,18317,248
4789,132,10112,3457,7677,77883,2435
9781,76,7219,3173,5725,34138,1494
43323,3,67,1008,44,2244,23
44385,6,162,760,108,6367,54
43302,22,487,1013,319,5019,168
12365,827,29152,3040,20218,141651,8934
25333,136,7351,2343,4938,45600,2413
23192,188,9272,2442,6684,55533,2588
14209,2,265,2909,209,7719,56
35526,21,468,1844,368,6520,100
16361,5,236,2789,161,4288,75
12077,97,4430,3057,3536,25650,894
43677,15,307,890,250,9622,57
16565,19,597,2780,400,4794,197
37450,13,351,1722,275,6027,76
11575,1,101,3080,82,6890,19
6605,5,61,3371,46,2341,15
11451,660,54213,3087,34515,176960,19698
41390,82,2477,1418,1856,34435,621
12314,20,1426,3043,1006,20930,420
40251,2,97,1540,75,7434,22
1456,2,66,3625,54,2311,12
1196,4,117,3769,93,5670,24
12933,36,1240,3008,893,15848,347
32676,78,1605,1971,1255,14437,350
19071,3,48,2661,41,4161,7
24375,7,505,2386,384,5735,121
25584,6,446,2332,358,8705,88
4340,115,4787,3474,3584,63055,1203
9460,114,3134,3190,2178,14990,956
17649,3,129,2722,107,3750,22
21877,36,3897,2508,2841,41076,1056
33432,9,470,1941,393,5952,77
44687,12,222,705,143,3820,79
33338,45,1802,1944,1463,13498,339
24002,0,216,2402,170,3282,46
4277,91,2817,3477,2075,16896,742
26411,2,132,2294,85,3690,47
6261,7,324,3386,256,6824,68
8991,250,11154,3219,8123,103839,3031
36732,0,32,1768,27,2655,5
31547,40,835,2025,674,7933,161
11994,64,3365,3060,2484,20530,881
28007,19,509,2210,437,6189,72
9491,5,87,3187,62,1818,25
35885,3,114,1817,91,2924,23
26370,3,113,2296,84,3213,29
26201,241,16411,2304,12492,81933,3919
45934,4,121,271,60,2946,61
6936,37,599,3355,462,8098,137
7583,5,205,3318,165,6166,40
26383,14,1115,2295,846,15023,269
20076,31,1017,2610,836,18379,181
13243,6,104,2981,81,3121,23
29312,38,1078,2138,813,12791,265
1937,165,6503,3526,5067,59598,1436
44659,212,1958,714,1593,13987,365
15975,4,225,2809,185,5558,40
31131,24,1037,2048,791,13227,246
39648,15,618,1578,458,9616,160
15537,35,1391,2828,1021,16869,370
41134,27,577,1456,424,6890,153
34449,143,7357,1904,5738,58125,1619
32722,21,555,1969,410,11507,145
24087,145,8679,2399,6509,66291,2170
30395,20,1030,2083,824,12214,206
37513,148,4379,1718,3086,42081,1293
25458,0,70,2338,52,3566,18
11133,17,1115,3104,817,19550,298
41029,29,583,1470,385,4507,198
16334,2,322,2791,175,4960,147
44038,9,284,815,187,4726,97
40868,12,689,1482,480,9417,209
9283,5,125,3202,110,5507,15
40064,1,83,1551,63,1736,20
20216,9,333,2601,270,4611,63
42147,52,937,1291,679,19880,258
31574,23,646,2024,517,15185,129
45122,84,494,551,338,8639,156
25203,0,2154,2348,1615,11256,539
30860,158,3736,2059,2913,20820,823
38452,21,859,1653,710,12016,149
18770,50,2707,2673,2075,14801,632
13309,176,12847,2976,9311,83233,3536
34001,2,162,1920,137,3025,25
44100,6,139,787,98,3825,41
4525,16,1212,3468,892,11073,320
13132,15,377,2995,283,4674,94
5708,48,1760,3409,1287,8044,473
26085,29,2106,2309,1498,14738,608
36929,1,357,1755,284,7084,73
46177,1,27,168,19,1162,8
10780,81,2145,3122,1713,44797,432
44782,16,166,673,134,2282,32
24622,55,1181,2373,882,4676,299
42866,6,58,1139,49,3488,9
25783,1,274,2323,237,14732,37
5636,5,376,3413,301,10937,75
27208,50,1691,2258,1309,16368,382
45052,16,247,589,193,4617,54
38884,32,932,1624,729,9933,203
42864,26,193,1139,152,4636,41
8163,106,3866,3271,3185,27507,681
40265,10,253,1538,189,5685,64
5215,23,576,3434,479,12262,97
19998,23,513,2614,399,7587,114
37847,54,1707,1694,1390,20555,317
45678,6,83,375,55,4307,28
2077,19,433,3523,320,6247,113
18249,68,1805,2695,1276,20968,529
9307,43,2812,3200,2147,31428,665
27394,163,6003,2246,4471,39477,1532
24173,7,299,2395,236,3751,63
1867,14,859,3528,697,26989,162
23942,12,460,2405,384,21426,76
20864,11,618,2567,505,8025,113
10873,45,2078,3117,1611,33675,467
33450,38,666,1940,513,8114,153
25376,0,38,2342,35,1634,3
25747,408,13916,2324,9724,73057,4192
3526,7,151,3498,134,3035,17
38096,6,207,1679,172,6174,35
18585,41,1163,2682,942,11239,221
46179,20,130,167,103,1893,27
13238,10,483,2981,309,6437,174
35945,28,591,1813,514,11599,77
4309,7,145,3475,113,7848,32
6652,8,133,3369,104,4255,29
1987,54,2203,3525,1623,16897,580
38154,14,233,1674,199,5050,34
45823,3,153,318,108,1759,45
9008,2,126,3219,98,6394,28
45460,29,290,456,253,5770,37
33028,4,166,1956,140,5040,26
41524,24,999,1400,758,17126,241
23502,1,81,2427,49,2937,32
30770,2,197,2063,148,3734,49
27633,1,62,2232,54,1927,8
3752,6,341,3493,278,6302,63
3676,18,313,3495,266,4715,47
16446,3,114,2785,89,2264,25
36775,20,636,1764,504,7704,132
36527,841,34388,1779,26372,201893,8016
40167,1,29,1546,26,5877,3
28008,9,217,2210,194,2949,23
34534,53,1697,1900,1248,26003,449
27888,3,149,2217,110,4490,39
41854,51,465,1343,357,6602,108
9942,11,433,3166,330,4105,103
19437,6,419,2643,258,6130,161
23896,4,287,2408,220,5120,67
34499,11,518,1902,417,6467,101
16871,175,13683,2763,9920,110893,3763
2726,105,9004,3513,3592,56864,5412
15334,57,2066,2836,1365,10082,701
42649,477,7450,1190,5077,37349,2373
18922,8,445,2667,344,10116,101
25257,23,707,2347,501,5561,206
27343,67,10983,2250,8515,13345,2468
39461,161,3603,1589,2796,18998,807
40619,8,172,1506,137,4112,35
12056,2,134,3058,97,3256,37
11925,10,489,3063,404,8553,85
15011,114,9961,2853,7563,50537,2398
17701,43,6578,2720,4902,48804,1676
40158,45,834,1547,630,10022,204
15475,7,222,2831,177,6211,45
9580,28,848,3182,628,13551,220
22412,503,22072,2480,14973,113969,7099
22590,2,34,2471,29,2770,5
35884,11,572,1817,430,12442,142
32633,7,235,1973,167,6503,68
5689,25,579,3410,428,9235,151
36305,20,331,1790,246,4927,85
5030,24,546,3445,403,19414,143
24143,117,3620,2396,2704,20359,916
21541,29,1119,2526,839,17615,280
40518,4,205,1515,159,6949,46
6255,24,1276,3386,1013,14095,263
17030,13,747,2754,603,14883,144
42422,10,329,1235,218,8856,111
19340,24,1310,2648,1047,17968,263
17558,94,3026,2726,2374,43464,652
6137,62,1941,3391,1301,20577,640
39190,15,621,1605,511,4254,110
13295,9,404,2977,338,6683,66
8832,2,26,3228,24,1504,2
28762,55,2831,2166,2117,41445,714
30114,87,2728,2099,2203,15930,525
17571,68,5044,2725,3653,18948,1391
15188,8,114,2843,95,3241,19
4387,1515,109314,3473,74292,331468,35022
10468,3,63,3140,54,3106,9
5138,823,39791,3438,27966,151619,11825
15640,19,841,2822,674,7306,167
33713,95,2014,1930,1517,11408,497
25624,5,331,2330,283,6039,48
12404,44,1931,3037,1506,22421,425
34595,1,260,1897,210,5688,50
31712,2,154,2016,132,6140,22
13426,40,3381,2968,2554,30202,827
19464,27,5097,2642,3597,22288,1500
41146,0,87,1455,67,4143,20
22191,0,26729,2491,19221,143979,7508
36457,20,550,1783,437,13087,113
17421,6,549,2732,434,6207,115
23383,0,157,2432,135,5362,22
45436,9,117,463,75,1873,42
39586,24,361,1582,298,6135,63
32287,0,18,1988,16,1881,2
41460,13,245,1407,187,5158,58
1662,5,152,3569,130,4057,22
43679,3,50,889,43,2419,7
6052,5,64,3393,52,1856,12
36624,32,567,1772,462,9170,105
34679,6,160,1892,129,6982,31
12438,14,445,3035,346,12148,99
12911,10,119,3009,87,8744,32
10807,69,3966,3120,2859,32595,1107
19490,36,1115,2640,841,8307,274
30959,11,344,2056,258,3940,86
25840,2,73,2320,48,2891,25
6976,36,1898,3353,1370,18579,528
7319,340,16651,3334,11696,49473,4955
33239,3,365,1948,306,8988,59
16662,96,10528,2775,7733,43844,2795
16069,9,478,2803,352,6462,126
45857,22,605,279,506,4570,99
21120,154,8845,2551,6244,48119,2601
39677,6,162,1576,139,3581,23
24130,31,1585,2397,1165,16496,420
5078,7,335,3443,256,3379,79
45948,550,7413,265,6051,46084,1362
23628,314,5928,2420,4735,23364,1193
25171,66,2177,2350,1690,8025,487
36089,17,709,1801,543,15917,166
45844,6,76,311,50,2407,26
18001,20,508,2706,359,4562,149
45734,5,69,347,48,3290,21
28119,1,97,2205,86,2291,11
42748,34,2532,1166,1888,18181,644
43505,62,1039,952,819,12429,220
13715,3,225,2945,188,14435,37
11200,0,63,3099,47,2578,16
25714,386,8022,2326,6129,24889,1893
15082,20,569,2849,445,13123,124
6902,4,199,3357,161,5922,38
7790,12,325,3305,242,4598,83
28550,17,897,2178,644,27024,253
12827,6,451,3014,376,9711,75
6274,4,96,3385,77,4933,19
13244,1,34,2981,26,1661,8
3550,20,681,3498,561,14444,120
44994,1,26,610,17,3338,9
8122,12,311,3274,235,2690,76
18619,100,8494,2679,6434,39323,2060
8155,12,168,3272,144,4115,24
36835,33,1298,1759,1069,14798,229
36957,1,119,1753,89,5422,30
45560,11,119,423,103,3399,16
22602,78,2289,2470,1678,20170,611
18320,23,1137,2692,900,31045,237
3733,34,1387,3494,1050,9757,337
25591,130,4598,2332,3178,23010,1420
30191,22,1175,2095,899,12280,276
5375,4,53,3426,38,4610,15
43372,21,434,990,340,7755,94
27474,59,1463,2241,1065,9951,398
21957,148,6885,2503,4966,23208,1919
32234,1,23,1989,20,2651,3
43715,58,1085,877,842,17953,243
43547,17,332,937,230,7047,102
3052,31,933,3507,723,8111,210
38196,83,2514,1672,1868,27603,646
22810,1594,67775,2460,47965,289467,19810
9419,8,239,3193,196,8356,43
39625,5,111,1579,95,9561,16
4281,2,71,3477,57,6747,14
34720,8,153,1890,117,2827,36
13142,2,140,2994,122,6941,18
44728,189,2171,691,1785,34200,386
20771,177,4306,2573,3103,25988,1203
29574,2,126,2125,104,6951,22
45822,54,862,318,704,14604,158
26368,9,829,2296,650,16946,179
45126,117,965,549,837,8476,128
32021,21,780,2001,528,10819,252
5125,55,3067,3440,2418,27672,649
22672,6,215,2467,190,5147,25
12966,15,949,3006,687,24871,262
27117,1,64,2264,60,2805,4
19125,39,1266,2659,1053,13315,213
31735,11,234,2015,165,5150,69
27105,5,173,2265,145,10444,28
8259,1,11,3265,8,1754,3
43108,22,650,1069,485,16005,165
16817,56,2676,2765,1988,14621,688
23709,30,1024,2416,794,9805,230
13603,26,1755,2953,1282,12381,473
11361,0,28,3092,22,1072,6
4442,10,370,3471,291,8526,79
13672,110,3948,2949,2771,14492,1177
30604,163,5396,2072,4068,28866,1328
32270,8,250,1988,203,3817,47
14958,52,4686,2856,3515,52824,1171
25653,5,226,2328,177,5449,49
26886,1,101,2272,82,2643,19
3378,21,381,3501,309,10111,72
38517,76,2040,1649,1511,26566,529
20465,3,270,2590,230,5007,40
45579,0,67,418,54,2060,13
28018,0,41,2210,33,2877,8
26269,18,641,2301,523,3702,118
38913,11,228,1623,174,3342,54
43597,14,201,918,166,4651,35
9687,2,82,3178,72,3779,10
46053,5,54,217,35,875,19
39887,50,1044,1563,861,16561,183
33273,526,31666,1947,21565,170931,10101
38701,15,356,1635,284,5162,72
20921,5,187,2562,164,2572,23
38246,6,135,1667,106,3702,29
39599,7,359,1581,272,8076,87
1988,42,1878,3525,1468,17206,410
3497,0,57,3499,49,2026,8
25273,3,303,2346,245,9026,58
16434,99,9338,2786,6958,49435,2380
3558,16,440,3497,334,23451,106
20843,0,1093,2569,828,10287,265
16733,7,671,2771,447,9655,224
9192,7,219,3207,191,5621,28
3559,0,165,3497,126,8823,39
14247,12,201,2906,168,3290,33
9432,46,1681,3192,1218,20105,463
17841,3,197,2715,165,7908,32
4392,14,153,3472,126,5826,27
29795,75,4847,2115,3587,43819,1260
17863,301,16649,2714,12684,110896,3965
36617,44,2301,1773,1724,24560,577
13604,114,8346,2953,5670,60771,2676
17034,548,31573,2754,22236,109531,9337
12522,1,0,3031,0,2308,0
45223,1,21,522,14,1669,7
21375,13,499,2536,414,3028,85
44966,6,103,618,65,3059,38
15609,38,659,2823,463,5788,196
6492,272,14814,3375,9728,143524,5086
22678,96,3230,2467,2431,39917,799
26741,0,57,2279,45,4379,12
19301,36,959,2650,751,9106,208
39377,48,1633,1594,1276,19051,357
20867,202,10338,2567,6440,121663,3898
10763,18142,937968,3123,495493,2767700,442475
6042,1,38,3393,32,2978,6
17627,2,82,2722,61,4830,21
20126,4,295,2607,217,6359,78
25005,7,908,2358,763,12457,145
31531,9,151,2026,114,2122,37
40589,4,71,1508,57,1598,14
21746,45,4459,2515,3309,23363,1150
5971,22,539,3396,404,11007,135
25118,9,270,2352,172,8578,98
5566,31,535,3417,417,15168,118
13780,19,853,2940,556,9739,297
4608,11,128,3464,113,4677,15
22392,147,6827,2481,5509,33794,1318
38903,10,484,1623,384,6204,100
34008,16,851,1920,633,14257,218
8911,30,633,3224,485,9901,148
35868,123,4564,1818,3524,28720,1040
43183,37,570,1049,464,10444,106
10070,5,114,3159,94,4588,20
30707,2754,250791,2066,153380,760820,97411
33404,72,2812,1942,2170,14145,642
4687,208,8223,3462,6474,98759,1749
19809,136,8858,2624,6232,57750,2626
1222,4,90,3765,81,4012,9
23500,1,12,2427,10,1327,2
29493,1,109,2129,88,2621,21
36620,2,138,1773,112,3612,26
1903,90,3098,3527,2219,35309,879
27329,1126,36608,2251,25367,256221,11241
43858,36,258,844,222,4483,36
39417,39,583,1591,457,13131,126
45199,49,675,529,394,9793,281
7422,2,55,3328,40,2356,15
24711,118,4725,2369,3587,48067,1138
19542,1,183,2639,149,4436,34
30841,282,11798,2060,8602,72830,3196
12843,8,234,3013,192,12711,42
10509,8,98,3138,86,4172,12
34966,3,139,1876,111,4089,28
26362,63,3453,2296,2648,26082,805
16673,49,2683,2774,2157,26331,526
29790,1073,27744,2115,23229,124904,4515
35334,14,347,1856,262,6080,85
10141,134,5038,3156,3806,40607,1232
43493,20,520,831,333,3581,187
28276,22,945,2195,787,29556,158
13385,137,7948,2970,5515,44595,2433
2663,3,81,3514,64,2343,17
44172,4,76,792,46,4648,30
36743,41,749,1767,564,29442,185
40003,13,411,1555,312,8211,99
43622,11,98,909,70,3137,28
42487,21,1476,1221,1020,18140,456
10318,100,1651,3148,1247,37119,404
11749,123,20452,3071,15409,99132,5043
7450,10,293,3326,234,6082,59
38225,2,318,1669,249,11186,69
22168,6,440,2492,305,3652,135
34782,0,83,1886,66,4761,17
34953,33,1615,1876,1187,16911,428
28257,3,277,2196,237,5458,40
40159,11,323,1546,245,6543,78
42813,97,2037,1149,1618,37314,419
42380,6,88,1244,66,2349,22
45420,121,1729,466,1275,16896,454
40675,1,94,1501,80,3275,14
42179,74,2709,1284,2123,37058,586
45687,10,137,372,97,3197,40
23642,0,62,2419,49,4840,13
35142,2,45,1866,36,3630,9
45224,13,276,522,233,6215,43
35711,7,185,1829,137,4218,48
35285,8,327,1858,272,10227,55
26407,4,145,2294,127,2462,18
5781,103,1698,3406,1286,38207,412
26824,16,636,2275,541,8433,95
45035,6,67,596,54,2270,13
26807,50,2035,2276,1583,38293,452
15464,12,1185,2832,934,7480,251
26106,1,60,2309,44,2165,16
25055,49,2488,2355,1817,18700,671
9167,14,610,3208,509,26759,101
27521,316,6292,2238,4554,20722,1738
29720,2,251,2118,194,5025,57
7619,214,8403,3316,6039,71737,2364
12367,608,46138,3040,32810,116874,13328
35471,51,857,1848,696,11675,161
33588,27,762,1935,600,4331,162
32858,56,1869,1963,1365,25137,504
42260,14,417,1267,340,12125,77
969,15,480,3847,397,6691,83
5021,16,547,3446,386,7920,161
24175,0,94,2395,73,3151,21
33549,4,387,1936,326,5640,61
41626,3,389,1384,314,6748,75
45297,210,2211,499,1766,16180,445
39318,0,24,1596,19,2805,5
27649,15,647,2231,427,11157,220
11402,183,3409,3090,2683,87109,726
20500,9,427,2588,342,4315,85
9403,92,3114,3193,2066,11971,1048
21682,4,378,2518,307,6216,71
16258,9,417,2794,357,3428,60
2014,15,449,3524,383,11344,66
32698,52,2084,1970,1652,17520,432
16168,20,725,2799,541,8416,184
10947,415,17236,3113,12933,55869,4303
22229,400,26326,2488,18508,135008,7818
33625,1,19,1934,12,2045,7
45631,2,38,398,24,1345,14
33704,7,270,1931,203,11447,67
18285,96,4912,2694,3594,20220,1318
45283,3,113,503,84,1992,29
45272,18,85,505,64,2289,21
27381,25,989,2247,772,14308,217
43649,21,349,899,241,4291,108
27114,2,199,2264,163,3607,36
45230,200,2125,521,1783,29482,342
31029,164,5560,2052,4492,40912,1068
42615,11,360,1196,276,10087,84
7396,52,948,3329,704,9644,244
36321,147,1825,1789,1488,15384,337
30508,1,67,2076,53,3330,14
13833,0,103,2936,65,5519,38
33466,17,285,1939,242,4158,43
20674,29,760,2579,518,6252,242
18224,13,1186,2697,966,19859,220
2035,6,123,3524,94,8422,29
11915,11,399,3064,324,7434,75
7976,11,63,3286,50,5981,13
37127,24,608,1742,491,14622,117
23085,14,743,2447,614,6679,129
39858,9,349,1566,253,6063,96
32559,18,889,1976,691,9375,198
32753,296,13888,1968,10281,99325,3607
15719,5,474,2819,399,18664,75
7236,2,109,3339,94,3754,15
46099,154,2302,204,1857,11788,445
12519,2,134,3031,88,1262,46
26694,12,606,2281,492,9260,114
3874,26,646,3490,531,6697,115
21808,8,370,2512,293,7853,77
13019,10,647,3002,490,6353,157
16940,12,453,2759,344,4427,109
17488,25,847,2729,607,6507,240
11955,4,232,3062,189,7061,43
44351,94,1987,764,1609,19177,378
19749,89,3729,2628,2860,29196,869
7755,16,495,3308,403,7761,92
32339,2,142,1985,79,3901,63
38686,5,188,1636,131,3548,57
4534,51,1713,3467,1309,15204,404
22650,9,779,2468,587,8363,192
26510,616,12208,2290,8857,39087,3351
26470,3,105,2292,95,3269,10
15438,90,8230,2833,5987,42112,2243
2691,1242,56751,3513,38097,203104,18654
8982,2,71,3220,49,1422,22
24606,529,14617,2374,10207,59865,4410
1984,24,917,3525,709,5793,208
32869,0,16,1962,12,2114,4
45545,191,3038,430,2413,9335,625
25946,102,4250,2315,3581,17569,669
36331,38,1341,1788,1034,12906,307
5724,0,23,3408,20,6287,3
40602,2,174,1507,135,8880,39
31586,2,77,2023,62,6691,15
10390,7,66,3144,54,1441,12
14176,52,2808,2911,1931,16731,877
2914,32,833,3509,582,10387,251
12114,254,6231,3054,4483,20706,1748
8998,2,80,3219,55,2768,25
34296,0,43,1911,35,2294,8
11651,27,2324,3077,1466,49054,858
32026,5,120,2001,84,3061,36
12130,35,1483,3053,1154,16313,329
36075,562,12962,1802,10050,51309,2912
5984,30,2358,3395,1897,23911,461
38133,6,372,1675,271,5871,101
7193,0,116,3341,101,5288,15
32830,120,6713,1964,5309,25610,1404
22305,60,2596,2485,1995,16210,601
40765,12,243,1493,190,5442,53
6013,8,224,3394,180,2360,44
3281,214,7054,3503,5243,27562,1811
16695,5,182,2773,141,3961,41
28459,17,790,2185,613,8183,177
15858,15,638,2813,529,8963,109
12251,53,1504,3046,1145,9367,359
45659,4,33,385,29,1574,4
6135,6,107,3391,94,3743,13
35587,73,797,1839,623,7361,174
32459,14,242,1980,194,4519,48
5359,2,29,3427,19,2561,10
7349,4,61,3332,47,2605,14
36254,4,121,1793,106,4174,15
41826,18,549,1346,441,17668,108
9340,1,104,3198,83,4237,21
18348,2,91,2691,70,3998,21
24455,28,933,2383,741,15195,192
30830,7,135,2061,119,1964,16
33308,23,350,1946,251,6657,99
39267,47,1430,1599,969,19446,461
43284,26,1261,1018,992,20979,269
40465,2,79,1520,67,3811,12
34883,69,2359,1880,1888,22404,471
19443,93,4230,2643,3310,18382,920
45284,28,229,502,199,5689,30
40145,65,1584,1548,1191,20466,393
1633,4,194,3578,147,18491,47
3885,23,934,3490,758,21853,176
7106,93,2936,3346,2125,40471,811
44739,8,121,687,90,2173,31
14893,20,1448,2860,1158,14131,290
17733,0,94,2719,75,4070,19
13790,7,201,2939,163,4376,38
37377,1313,117087,1727,67615,376735,49472
43268,180,3600,1023,2698,21355,902
22751,417,17463,2464,12017,64206,5446
22945,11,390,2453,319,9203,71
7830,215,11264,3302,8220,84423,3044
34828,23,302,1883,241,3474,61
25643,19,558,2329,462,6970,96
20373,77,3939,2594,3003,18815,936
36125,88,5637,1799,4367,34830,1270
17838,58,2370,2715,1804,19283,566
30002,43,2570,2105,1948,26579,622
40244,3,400,1540,292,9309,108
43134,72,2257,1062,1639,18608,618
6313,10,101,3383,74,8458,27
29688,546,29971,2120,21363,131671,8608
35922,2,250,1814,200,8276,50
10017,80,3244,3162,2525,46372,719
20396,14,597,2593,503,19301,94
10425,46,1417,3143,1116,37316,301
34109,106,4114,1917,3156,15181,958
39251,28,1036,1600,717,11304,319
4137,26,1105,3482,832,20214,273
21189,4,180,2546,149,11703,31
38593,17,319,1643,232,15750,87
14255,97,1911,2905,1370,16280,541
18743,1,151,2674,118,3377,33
11707,55,1567,3073,1182,32829,385
15045,8,857,2851,652,8325,205
5014,22,578,3446,480,8450,98
39002,22,580,1617,492,10460,88
11765,5,109,3070,80,4585,29
25558,318,10598,2334,6836,84498,3762
20218,1210,68778,2601,50771,170683,18007
18661,3,429,2677,190,3402,239
20851,9,487,2568,366,10104,121
18848,71,1479,2669,1113,11388,366
8124,8,182,3274,141,4844,41
37294,3,248,1731,210,13867,38
45491,40,419,448,309,4861,110
22411,7,416,2480,319,7474,97
45481,3,46,451,32,3208,14
16281,9,343,2794,280,6792,63
5600,0,91,3415,68,2618,23
29518,0,0,2128,0,12023,0
43542,5,103,939,85,5625,18
2321,74,2897,3519,2065,42535,832
9876,2,106,3169,90,4880,16
35952,41,513,1812,408,5460,105
41096,91,2675,1460,2137,28847,538
31836,1,116,2010,84,3641,32
14999,1596,109334,2854,74217,679310,35117
5507,2,86,3420,77,2011,9
8905,1,35,3225,18,1079,17
17189,959,137770,2744,96689,273511,41081
12117,4,274,3054,220,4234,54
23049,26,798,2449,571,5689,227
25982,14,645,2314,477,10828,168
45517,216,3629,441,2864,30908,765
10404,45,1004,3144,812,40851,192
20138,17,1649,2606,1235,10432,414
14361,6,168,2896,134,5190,34
41955,31,925,1326,726,18782,199
16470,8,598,2784,488,7847,110
28704,106,1629,2170,1217,11715,412
44185,3,40,788,31,1761,9
35351,9,480,1855,346,5948,134
41032,3,93,1470,71,4822,22
14272,11,261,2904,198,4939,63
43305,125,2175,1012,1792,35802,383
12817,4,537,3015,431,7897,106
40869,3,222,1482,161,7995,61
12055,26,842,3058,648,9005,194
26575,7,121,2287,99,3307,22
42184,115,2219,1283,1494,18704,725
14480,2,110,2888,97,4937,13
26670,289,21196,2283,15243,102648,5953
4886,3,34,3452,26,1476,8
36736,67,2327,1767,1883,14309,444
25471,0,76,2338,62,1817,14
33257,82,1754,1948,1357,10444,397
40364,64,3171,1529,2395,32169,776
2809,32,882,3511,745,18434,137
33746,3,119,1929,90,3557,29
26054,0,0,2310,0,1880,0
987,4,87,3841,74,3377,13
21490,13,857,2530,698,10065,159
12841,52,5436,3013,3798,46635,1638
13311,8,424,2976,325,35388,99
34815,13,671,1883,534,13465,137
4088,5,137,3483,109,7047,28
3345,701,39737,3502,29260,116708,10477
3726,52,1702,3494,1082,11252,620
17686,3,107,2721,92,3388,15
13240,7,249,2981,189,5916,60
7014,16,660,3351,506,16966,154
10545,3,158,3136,120,3808,38
41887,6,373,1337,311,5399,62
32989,2,80,1958,68,3564,12
44600,14,122,725,116,7002,6
40509,121,3394,1515,2386,35661,1008
38543,62,3376,1646,2537,21221,839
8336,12,483,3260,374,7174,109
7725,20,458,3310,368,8335,90
33215,0,29,1949,25,6534,4
24448,895,41245,2383,30001,106879,11244
30444,5,255,2080,190,3941,65
23845,1,63,2411,57,2706,6
3151,10,172,3505,130,10372,42
27414,58,9135,2245,7225,44592,1910
43369,94,2151,988,1544,30365,607
35401,16,932,1853,688,12409,244
41759,5,133,1360,108,4587,25
1369,4,125,3690,102,10573,23
40903,225,5049,1480,3579,36509,1470
37406,5,211,1725,159,5898,52
14091,4,188,2914,145,3899,43
41234,30,885,1442,660,16908,225
28527,3,575,2180,460,16756,115
46015,3,53,236,42,2328,11
31873,9,274,2009,219,4001,55
27516,8,314,2239,237,2717,77
22732,13,993,2464,652,10684,341
10848,12,188,3119,161,3468,27
8366,166,9443,3258,7252,54192,2191
31173,23,1712,2045,1390,10850,322
36243,48,1798,1793,1459,15118,339
5281,8,53,3431,40,2876,13
45711,78,817,358,717,13619,100
42450,14,614,1229,439,8011,175
28187,2,308,2200,216,3703,92
30617,15,302,2071,247,5393,55
27929,0,490,2215,390,13088,100
35271,248,11755,1859,8457,68946,3298
42306,61,1706,1258,1255,22428,451
5817,2,175,3404,104,3271,71
27257,2,66,2255,56,2965,10
34878,75,2220,1880,1765,21657,455
30901,492,12125,2058,8714,68595,3411
15076,22,1013,2849,800,9378,213
5337,101,2506,3428,1932,81580,574
35490,3,55,1847,40,5312,15
2502,148,2532,3516,2107,21793,425
28897,4,502,2160,385,11160,117
8600,6,273,3243,214,4088,59
2699,39,1243,3513,961,15379,282
45921,9,192,281,103,3181,89
4680,19,370,3462,311,3436,59
35239,4,256,1860,213,6524,43
5279,4,71,3431,52,4742,19
45167,0,7,538,5,1065,2
9747,2,163,3175,120,5876,43
24965,0,14,2359,13,1494,1
8438,33,770,3253,548,18589,222
14629,15,1930,2877,1313,13432,617
25767,4,172,2323,119,2049,53
14728,13,479,2871,399,18219,80
14318,40,2995,2899,2402,23401,593
46107,1,9,200,7,971,2
5837,12,207,3402,154,2599,53
28880,4,105,2161,89,3385,16
41815,7,238,1348,161,5964,77
10401,6,85,3144,73,4776,12
41104,2,30,1459,20,4220,10
20610,22,253,2582,214,3199,39
26364,26,1012,2296,787,5705,225
42085,128,2612,1303,1759,39713,853
27689,27,629,2229,478,10059,151
24553,1,296,2377,236,5570,60
33232,3,148,1949,122,3118,26
10594,14,206,3133,171,5830,35
19126,5,829,2659,640,11453,189
46139,31,376,186,350,6055,26
6623,908,35705,3370,25341,216255,10364
35187,44,1918,1864,1374,21548,544
15041,90,6448,2852,4314,45625,2134
10902,29,1315,3116,915,6095,400
15867,3,77,2813,61,3050,16
15275,51,1795,2839,1341,15525,454
14899,30,1355,2860,1052,16702,303
38974,4,164,1619,124,4342,40
45177,50,1047,535,796,8096,251
9327,184,8885,3198,6949,113396,1936
25116,8,230,2352,194,4051,36
33646,7,562,1933,433,9472,129
11777,15,418,3069,298,4569,120
16147,0,74,2799,60,3047,14
5288,1088,57837,3430,39037,314853,18800
20466,58,2369,2590,1754,31558,615
12516,3,114,3031,81,1477,33
19642,25,514,2634,400,6901,114
22817,10,1106,2460,812,8414,294
14932,37,1826,2858,1394,28128,432
39689,18,303,1576,245,9954,58
40469,91,2263,1519,1665,40112,598
10830,37,1289,3119,934,18423,355
31694,6,285,2017,223,5995,62
8927,546,23267,3223,17825,74310,5442
8256,1276,29145,3265,20111,244378,9034
2202,110,3252,3521,2519,29012,733
43935,18,124,831,97,2412,27
5020,25,634,3446,450,17156,184
27805,62,2923,2221,2069,49409,854
33221,39,1727,1949,1292,23924,435
34670,32,330,1892,265,4175,65
8604,2,94,3242,81,6618,13
40330,256,7851,1534,5263,63419,2588
19929,64,4288,2618,2860,38689,1428
31990,9,308,2003,222,9837,86
36908,15,316,1756,249,6006,67
37420,251,7960,1724,5818,49923,2142
2902,64,3270,3510,2447,36422,823
38542,110,2640,1646,2091,27855,549
17187,0,75,2745,70,2315,5
24898,0,50,2362,41,2307,9
26696,2,151,2281,84,5580,67
19214,6,360,2655,295,4555,65
25532,10,476,2335,402,7734,74
45786,0,27,331,15,1717,12
25727,15,500,2325,409,5784,91
17901,1,224,2713,150,3095,74
39499,18,352,1587,269,5831,83
2401,16,401,3518,319,18871,82
37267,11,365,1733,283,3085,82
10411,4,212,3144,172,6597,40
36760,12,402,1765,294,15203,108
11945,36,669,3063,546,8744,123
12393,6,133,3038,107,5392,26
6008,25,1667,3394,1356,12516,311
43224,430,8984,1037,6425,48165,2559
17353,5,327,2736,278,3910,49
25135,44,1003,2351,726,14084,277
26603,5,652,2286,522,16911,130
37954,5,235,1687,194,8759,41
33495,6,223,1938,184,4240,39
40378,83,2014,1528,1547,19501,467
5059,7,266,3444,216,15792,50
23111,50,2378,2445,1736,25007,642
42770,82,3201,1161,2334,38433,867
18868,0,70,2669,61,3183,9
13281,28,615,2978,444,8414,171
16170,17,1361,2799,1005,33282,356
6240,5,176,3387,151,4281,25
10796,6,129,3121,103,5861,26
43062,24,193,1083,163,3013,30
30997,3,51,2054,39,4304,12
32280,13,505,1988,415,11407,90
45084,106,976,574,725,8718,251
3525,4,229,3498,196,28553,33
15612,22,4059,2823,3032,68872,1027
3393,2,68,3501,56,3072,12
3576,7,851,3497,644,17398,207
32965,6,178,1959,132,5159,46
12447,36,1476,3035,1239,22000,237
14729,4,354,2871,291,9620,63
44516,11,123,742,79,3794,44
39698,1,69,1575,51,2678,18
18225,8,359,2697,287,10782,72
14315,262,21352,2900,15814,114293,5538
43463,56,1140,964,879,24213,261
21664,63,2363,2519,1854,21747,509
32741,7,518,1969,420,7999,98
34126,3,90,1916,74,2230,16
12568,29,807,3029,604,6276,203
15512,6,80,2829,63,4000,17
12277,6,580,3045,432,5425,148
22862,2,221,2458,192,5305,29
9280,56,2110,3202,1380,31210,730
10490,43,2120,3139,1490,29721,630
43434,63,1406,972,1103,22484,303
39718,78,2141,1574,1775,29127,366
11710,21,568,3073,429,10913,139
45740,112,2300,346,1716,17500,584
13428,30,1514,2967,1078,22057,436
2762,4,71,3512,62,2686,9
23590,246,18849,2422,13201,99409,5648
7695,26,737,3311,596,14512,141
9606,34,733,3181,560,11625,173
35697,3,89,1830,74,10568,15
40205,43,490,1543,375,7993,115
42818,3,200,1149,132,3307,68
45114,125,1478,556,1299,11576,179
10212,3,95,3152,84,2828,11
16955,1,117,2759,89,13507,28
35927,11,418,1814,335,10011,83
10820,33,604,3120,451,5521,153
3942,18,580,3489,360,28992,220
16220,105,8562,2797,5803,49302,2759
37332,38,1962,1730,1512,22030,450
8226,3,47,3267,36,3396,11
18277,2,206,2694,169,2578,37
19206,2,169,2655,131,7210,38
32319,0,39,1986,37,2079,2
7754,22,680,3308,564,13013,116
45257,6,65,512,51,1775,14
5975,57,1288,3396,1036,13068,252
34899,107,8192,1879,6033,61596,2159
45774,9,93,332,80,2597,13
4586,12,364,3465,308,4426,56
10932,106,3018,3114,2336,48903,682
1964,27,1517,3525,1153,15705,364
45965,14,101,259,77,2724,24
10761,37,673,3123,512,4342,161
24794,35,1573,2367,1175,22322,398
2378,10,87,3518,75,3888,12
36206,5,201,1795,165,3198,36
19571,7,572,2637,433,7204,139
44201,0,33,786,23,4253,10
29054,1,24,2152,21,2402,3
19043,1,40,2662,31,1273,9
41965,53,1559,1324,1213,39307,346
6913,17,403,3357,316,7565,87
14939,277,16255,2857,11728,95970,4527
25418,9,585,2340,479,7662,106
41598,13,189,1387,144,4831,45
40970,7,185,1475,151,4595,34
16680,8,560,2774,434,6641,126
27156,44,1283,2261,1050,11635,233
13907,208,13302,2928,8935,79863,4367
21474,9,358,2530,304,8149,54
42111,4,103,1300,78,3247,25
35110,1,25,1868,22,4921,3
26341,45,1773,2298,1362,15380,411
8490,229,23545,3249,16668,57310,6877
1836,166,8500,3529,6385,38183,2115
45828,13,221,316,144,4458,77
12558,24,1579,3030,1231,13717,348
23940,2,105,2405,90,2627,15
29700,11,275,2119,232,5312,43
27727,25,1042,2227,760,8825,282
3456,44,1229,3499,906,18301,323
5128,19,387,3439,329,10919,58
40875,0,49,1482,32,3531,17
17985,3,154,2707,123,5500,31
4432,1414,98384,3471,68951,396455,29433
10349,16,124,3146,105,8086,19
3687,31,3451,3495,2761,81273,690
46382,3,30,95,20,1451,10
35545,12,261,1842,223,5338,38
16385,1,184,2788,140,5510,44
28655,31,1011,2172,699,18282,312
43253,92,1537,1026,1261,21269,276
30255,8,129,2092,109,6054,20
39376,4,56,1594,37,3089,19
13986,24,2050,2922,1567,16335,483
6561,5,104,3372,74,3215,30
28534,203,15736,2179,11748,71994,3988
5422,6,121,3424,102,4469,19
44886,21,173,642,140,3354,33
17802,0,70,2717,52,5077,18
5252,66,2616,3432,1940,50683,676
28311,92,8335,2193,6417,22508,1918
42688,10,242,1179,168,10588,74
27787,6,494,2222,414,9798,80
11616,72,2488,3079,1945,15328,543
27852,76,2632,2219,2055,14806,577
13963,50,1375,2923,1113,7243,262
12798,159,11005,3016,7918,84549,3087
20065,63,4458,2610,3458,40838,1000
7098,1,86,3346,67,2488,19
9318,3,41,3199,29,2088,12
2896,4,189,3510,158,7299,31
38824,1,36,1628,30,1589,6
38610,1,45,1641,41,4267,4
6258,18,195,3386,169,5652,26
23901,65,1461,2408,1113,6697,348
9997,19,565,3163,475,6891,90
2909,549,20150,3510,15022,109328,5128
30629,6,105,2070,85,2555,20
4603,63,1426,3464,1061,28918,365
32154,2,82,1994,70,5249,12
5492,25,1182,3421,953,6957,229
37101,8,459,1744,359,8530,100
25910,14,626,2317,501,12794,125
34533,12,521,1900,392,5794,129
33031,2,207,1956,170,2493,37
39760,2,137,1573,112,3376,25
2523,10,205,3516,153,4421,52
37716,0,472,1705,360,12734,112
11134,4,154,3104,111,2606,43
29499,41,1736,2128,1316,14612,420
40735,8,429,1496,269,5169,160
2638,5,98,3514,71,9550,27
10445,7,394,3142,288,18358,106
27148,158,2978,2261,2263,16877,715
17050,114,5156,2752,3406,18897,1750
4457,80,224660,3470,76524,48346,148136
6564,5,162,3372,119,2760,43
32454,7,408,1981,314,4489,94
33802,58,836,1926,677,8535,159
22592,6,366,2471,268,14796,98
9004,27,1087,3219,850,18447,237
34641,2,90,1893,68,2397,22
45960,145,2356,260,1948,26048,408
7110,491,22609,3345,15948,147833,6661
24782,2,99,2367,71,5284,28
19215,7,339,2655,267,3323,72
39255,2166,60890,1600,41587,277034,19303
12563,3,192,3029,154,10059,38
19581,17,1074,2637,797,13040,277
13282,13,339,2978,235,5660,104
8628,254,7812,3241,5959,73720,1853
19198,7,409,2656,309,9820,100
41476,8,146,1405,109,5285,37
2380,9,330,3518,287,11045,43
5058,12,191,3444,140,3344,51
29130,2,217,2148,195,4570,22
3249,15,626,3503,487,3545,139
14463,17,583,2889,474,17749,109
30911,1,116,2058,99,9107,17
20991,11,907,2558,762,13390,145
41082,4,236,1462,176,4407,60
6231,10,340,3387,269,35539,71
41302,7,337,1430,252,8648,85
39363,2,208,1594,166,7184,42
26659,1,221,2284,175,2132,46
40946,0,21,1476,15,2113,6
23371,183,18115,2433,13474,81700,4641
37777,8,269,1700,211,13407,58
14626,27,2119,2878,1667,21632,452
35017,4,168,1873,124,8317,44
24740,3,109,2368,75,3524,34
7971,26,647,3287,515,12244,132
8779,12,458,3231,359,12942,99
1651,3,0,3572,0,4730,0
37569,12,367,1714,273,4014,94
27858,2,59,2219,47,2571,12
17932,12,442,2711,363,7956,79
36195,103,1231,1795,972,21244,259
31941,1,28,2006,22,1643,6
29907,5,222,2109,188,3506,34
21111,100,3604,2552,2761,27109,843
28970,2,167,2156,137,5838,30
4732,5,214,3460,185,5487,29
21269,1,66,2541,60,1468,6
32317,15,686,1986,512,7986,174
40705,49,1062,1499,794,13735,268
13786,286,23952,2939,17059,134734,6893
19320,10,871,2649,669,11707,202
21386,83,7060,2535,5017,38900,2043
31795,79,2297,2012,1809,21522,488
17230,29,1423,2742,1062,24544,361
4478,19,750,3469,632,30023,118
24625,11,1744,2373,1339,14817,405
8679,7,249,3237,172,2337,77
35813,77,7397,1822,5597,16774,1800
35262,25,380,1859,304,6877,76
20519,1,109,2587,92,3422,17
8473,75,6250,3251,4779,57604,1471
14425,285,13916,2891,9634,93236,4282
43044,16,241,1089,175,4553,66
40305,1,34,1537,31,4101,3
6228,19,587,3387,403,10555,184
35831,2,54,1821,44,2871,10
11198,0,248,3099,197,4025,51
45385,65,1154,475,853,13670,301
44655,255,3039,715,2595,18381,444
19406,36,2521,2645,2015,12260,506
18861,177,8924,2669,6747,82320,2177
15843,5,610,2814,459,25325,151
42320,161,7913,1256,5708,43196,2205
29718,16,584,2118,472,6887,112
37480,32,591,1720,454,8798,137
9597,21,687,3181,527,18305,160
29209,1,90,2144,71,4591,19
42728,50,1635,1172,1167,11030,468
4620,33,943,3464,790,11286,153
13647,3,236,2950,179,4642,57
4731,2,45,3460,37,8614,8
28737,2,20,2168,15,1791,5
18541,17,601,2683,463,13077,138
25317,3,208,2344,173,5995,35
36960,9,293,1752,238,3903,55
40835,29,833,1486,609,13775,224
15508,402,29279,2829,22087,157774,7192
9069,3,654,3215,507,10199,147
20497,23,835,2588,704,7229,131
4411,37,876,3472,671,9187,205
7482,21,154,3325,124,6786,30
45990,81,756,249,618,6015,138
3270,8,174,3503,134,8995,40
19583,7,425,2637,334,9889,91
26074,4,281,2310,234,6274,47
9640,4,132,3179,107,3830,25
26438,141,11374,2293,8637,56375,2737
7706,241,15338,3311,11305,94533,4033
39710,6,256,1575,193,5821,63
10764,11,255,3123,210,2670,45
6548,66,2317,3373,1814,18248,503
7070,110,10776,3347,6387,38192,4389
11274,4,148,3096,118,9471,30
7949,26,1002,3289,799,9335,203
25144,0,183,2351,153,3862,30
40214,34,1464,1543,1156,18967,308
12484,26,1405,3033,1100,13960,305
8385,156,5017,3256,3946,64280,1071
35491,7,167,1847,143,5839,24
29188,19,794,2146,626,11764,168
4912,12,514,3451,419,6731,95
33678,10,701,1932,543,8051,158
23529,7,549,2426,426,8197,123
32205,6,80,1991,69,3137,11
24210,1,429,2394,368,13842,61
28092,16,3255,2206,2468,15247,787
8648,0,56,3240,42,1848,14
2250,25,489,3521,387,9791,102
17891,3,136,2713,110,2868,26
27882,130,1948,2218,1458,10535,490
11221,72,1792,3098,1467,37481,325
39278,37,963,1599,741,12796,222
23355,42,2033,2434,1622,8870,411
16669,4,197,2774,148,2517,49
11751,41,1627,3071,1290,33835,337
28262,29,1150,2196,885,16413,265
40764,21,597,1493,450,6989,147
4919,46,761,3450,634,16072,127
25385,9,289,2341,229,4728,60
13968,44,2914,2923,2149,32576,765
37599,7,566,1712,410,14071,156
30288,301,14107,2090,10083,110099,4024
43725,14,244,874,183,4792,61
8446,3,83,3253,63,6122,20
13767,7,261,2940,220,3537,41
41226,11,692,1444,433,11036,259
9661,43,1515,3178,1191,17272,324
4689,8,546,3461,401,13115,145
25614,4,48,2330,41,2449,7
2656,11,156,3514,113,10031,43
37512,7,363,1718,292,4418,71
23205,0,1454,2441,1104,14957,350
43127,12,231,1064,183,6810,48
13516,41,1391,2959,1080,13276,311
42097,23,232,1301,181,5173,51
41766,15,301,1359,219,11555,82
33106,6,174,1953,135,4422,39
5340,10,276,3428,200,11405,76
28124,30,6713,2204,5563,23089,1150
5641,25,1857,3412,1375,31463,482
38802,1,73,1629,55,2461,18
25436,98,2040,2339,1610,10928,430
27721,23,1967,2227,1560,10207,407
37403,11,251,1725,167,4359,84
13654,2,24,2950,21,4615,3
32299,102,3575,1987,2798,31795,777
2141,58,2468,3522,1961,25991,507
13319,8,153,2975,104,3635,49
45439,155,1800,462,1552,21848,248
22042,93,1774,2498,1313,7890,461
23760,32,2483,2415,1985,20911,498
39642,386,7164,1579,5738,37788,1426
2353,18,440,3519,280,16580,160
9041,3,98,3217,80,3596,18
40382,36,1076,1527,864,10004,212
8645,4,65,3240,53,8060,12
12371,6,333,3039,263,5156,70
33582,28,725,1935,589,7467,136
45904,2,14,290,13,2402,1
8243,16,373,3266,273,9032,100
5754,4,443,3407,333,11967,110
1941,79,1746,3526,1474,22003,272
11509,0,88,3084,72,2023,16
8690,17,652,3236,559,12966,93
35379,23,1663,1854,1247,10014,416
29141,5,194,2148,156,7543,38
26558,0,63,2287,53,2110,10
9766,2,52,3174,41,2912,11
24718,0,39,2369,36,3198,3
35857,0,23,1819,21,2274,2
43619,107,1447,909,1198,15758,249
45697,7,162,368,102,2488,60
29120,268,6855,2149,5287,47920,1568
4461,75,912,3470,765,23407,147
35171,12,623,1865,520,10555,103
32316,4,572,1986,479,5820,93
14503,13,682,2886,535,14345,147
13617,33,1175,2953,904,28457,271
11461,31,1120,3086,827,18202,293
37586,59,2159,1713,1623,12933,536
31112,20,583,2048,469,6713,114
25201,49,3537,2348,2605,32077,932
43627,2,21,907,16,1227,5
38984,68,2019,1618,1559,21019,460
13739,10,297,2942,223,6724,74
22223,2,91,2489,59,3492,32
35789,65,1291,1823,990,8406,301
18914,102,6503,2667,4941,26272,1562
2179,50,2104,3522,1613,22451,491
24654,2,0,2372,0,3135,0
15139,79,4136,2846,3082,30167,1054
41705,46,1778,1370,1345,16668,433
5780,7,106,3406,71,4032,35
30390,14,571,2083,476,1899,95
19729,2,238,2629,205,4795,33
20720,8,669,2576,519,6550,150
28174,75,739,2201,574,5928,165
3315,15,1635,3502,1280,21643,355
27802,3,208,2221,176,6096,32
31083,8,261,2050,223,6408,38
6946,56,2226,3355,1602,29554,624
8007,11,373,3284,296,6534,77
25314,465,8507,2344,6466,29181,2041
20469,0,142,2590,100,6072,42
31932,12,357,2006,265,8159,92
2614,14,193,3514,151,3580,42
38332,73,2834,1662,2192,17925,642
18110,9,533,2701,423,6300,110
25949,29,1543,2315,1161,7769,382
5086,31,664,3443,537,6172,127
35777,1,26,1824,22,2284,4
37581,11,317,1713,228,14435,89
29454,11,245,2131,186,4801,59
27027,5,399,2268,295,9421,104
43698,21,354,882,272,6662,82
27514,1,36,2239,34,2519,2
5635,5,118,3413,88,2465,30
11806,14,520,3069,412,7551,108
25860,8,372,2320,292,12740,80
35636,18,1034,1836,740,13949,294
45068,19,187,582,135,5065,52
15206,19,1289,2843,947,17339,342
42701,13,177,1178,135,2592,42
22363,32,1837,2483,1391,22052,446
24496,10,350,2380,250,3942,100
17361,17,765,2735,633,14586,132
2254,7,365,3521,313,19798,52
14506,298,25799,2886,19743,114386,6056
30586,29,1175,2073,920,12658,255
26229,17,457,2303,372,7221,85
11314,42,884,3095,707,4246,177
35958,21,1149,1811,883,8590,266
43166,448,9849,1053,7107,63950,2742
46243,144,2482,150,2027,19668,455
34511,14,503,1901,426,8269,77
33462,369,6368,1939,4932,28557,1436
45727,20,183,349,165,3888,18
6234,5,248,3387,171,9837,77
44537,150,2344,728,1823,15651,521
12965,79,1942,3006,1345,45478,597
45474,10,85,453,70,2221,15
36903,412,14023,1756,9027,105041,4996
24651,0,33,2372,30,3501,3
4417,52,1387,3472,1106,39658,281
14783,31,526,2866,404,5618,122
12398,2,219,3038,179,13592,40
29704,77,1783,2119,1278,30062,505
9025,4,49,3218,38,2255,11
23079,20,824,2447,662,13840,162
3215,61,1045,3504,847,11057,198
9097,43,1148,3213,939,19388,209
40283,97,2545,1537,1929,19992,616
5968,10,578,3396,362,12997,216
32305,5,74,1987,60,1858,14
34332,3,60,1909,46,2119,14
23851,11,240,2410,180,4833,60
41007,155,4273,1472,2627,78118,1646
16638,1,153,2776,119,2327,34
38088,22,492,1679,393,14785,99
3777,22,600,3493,465,9728,135
20764,6,356,2574,266,9921,90
3587,27,1140,3497,835,16391,305
4976,2,53,3448,45,3985,8
14177,0,50,2911,37,2559,13
10384,24,1277,3145,762,21366,515
8428,13,792,3254,632,9237,160
16034,8,363,2805,293,6684,70
41809,2,53,1350,45,2945,8
29074,16,2163,2151,1601,19204,562
10726,107,2298,3125,1745,47215,553
12881,4,409,3011,327,8514,82
6592,37,635,3371,476,15634,159
32696,19,447,1970,385,3622,62
3290,309,18542,3503,13339,88818,5203
14376,30,855,2895,633,5534,222
41189,39,685,1450,504,7956,181
12461,11,718,3034,564,6094,154
7054,541,23043,3348,17159,81019,5884
7832,46,2722,3301,2144,21221,578
19961,5,254,2616,198,6904,56
18017,4,374,2705,299,5950,75
24587,140,4722,2375,3553,41979,1169
42131,153,1921,1296,1488,16662,433
11374,2,55,3092,44,3305,11
34608,0,72,1896,45,4755,27
5163,25,1281,3437,1015,35991,266
16791,8,405,2766,300,3026,105
11457,74,77128,3087,31799,56321,45329
28070,57,1350,2206,1105,8170,245
45386,11,132,475,104,2477,28
5619,22,373,3414,298,15512,75
44239,5,55,781,40,3453,15
36227,4,159,1794,127,2553,32
33577,0,21,1935,20,1678,1
34692,28,905,1891,746,10097,159
28564,4,325,2177,276,4028,49
1859,48,1386,3528,1117,22484,269
37790,79,1607,1699,1127,14047,480
36469,1,212,1782,177,6621,35
38883,3,203,1624,148,6200,55
2119,658,21841,3523,16842,116432,4999
13838,519,23080,2935,17533,114698,5547
7503,45,1146,3324,885,12249,261
41817,13,455,1347,300,4954,155
33040,4,77,1956,60,2563,17
41468,3,37,1406,37,1507,0
14620,4,65,2878,53,3693,12
33901,31,743,1924,567,9231,176
30899,4,139,2058,114,3805,25
12080,46,1241,3056,944,18726,297
45213,3,46,524,28,1936,18
45728,1,24,349,19,1637,5
3000,23,341,3508,257,7773,84
3486,0,14,3499,12,1862,2
14874,3,179,2861,147,3711,32
13012,1650,82293,3003,52881,220664,29412
21167,17,572,2547,468,5075,104
45814,5,62,321,39,1841,23
41085,73,4364,1462,3263,21361,1101
35648,4,130,1834,112,4760,18
18704,40,2539,2676,2077,15695,462
14260,19,706,2904,499,17592,207
33407,175,6905,1942,5154,46379,1751
19860,38,725,2621,587,5769,138
39480,4,284,1588,230,5916,54
30162,37,1611,2098,1162,8452,449
3289,38,1192,3503,915,40902,277
33271,2,68,1947,57,2862,11
39299,58,1662,1597,1184,18556,478
45369,25,210,479,172,4141,38
32198,20,1077,1991,828,14086,249
37247,4,182,1735,141,4005,41
6722,27,723,3366,632,9389,91
17338,122,5492,2737,3881,37894,1611
6651,4,48,3369,42,2453,6
25064,17,82,2355,75,9197,7
20973,135,12700,2560,9371,62060,3329
46220,12,208,156,159,1602,49
32182,14,439,1992,351,5560,88
30031,9,375,2104,319,9253,56
15177,22,926,2844,774,4867,152
17784,1734,170777,2718,109045,525356,61732
17801,18,818,2717,637,5265,181
33368,19,425,1943,338,5128,87
35158,110,5541,1865,4167,74669,1374
19432,31,1409,2643,1135,17160,274
41839,277,9263,1344,6624,70218,2639
35921,90,1864,1814,1398,13081,466
27433,11,357,2245,277,2749,80
34046,2,94,1919,82,2604,12
34120,18,462,1916,378,6446,84
39422,228,2879,1591,2227,21776,652
2519,15,612,3516,466,16323,146
43782,48,626,857,498,5758,128
2317,9,162,3519,139,8209,23
16945,4,0,2759,0,18079,0
40037,614,19365,1553,14544,118238,4821
41844,15,288,1344,245,10213,43
10305,62,3143,3149,2416,23086,727
6720,2,124,3366,107,2819,17
17126,11,335,2748,286,3939,49
35298,5,178,1858,154,1848,24
18453,9,724,2687,568,7974,156
16653,150,9821,2775,7285,57287,2536
44529,239,2505,737,2126,36961,379
23012,1,57,2450,51,1928,6
7207,77,4486,3340,3281,13652,1205
28511,21,497,2181,369,5445,128
28515,26,475,2181,337,5874,138
17228,13,409,2742,355,11430,54
12221,62,2387,3049,1721,23114,666
8663,19,0,3238,0,34384,0
15416,16,809,2834,575,9026,234
42590,9,355,1202,238,9007,117
32861,10,648,1963,477,11568,171
35548,3,166,1842,124,3579,42
27053,2,160,2267,123,6911,37
37764,5,117,1701,90,2543,27
36596,16,467,1775,381,14525,86
38287,6,213,1665,178,5465,35
17252,12,606,2741,482,13066,124
18458,1,98,2687,69,2452,29
4215,38,2450,3479,1856,24635,594
14041,45,2616,2918,1995,11837,621
31331,115,4080,2037,3221,32434,859
2304,4,133,3520,110,5434,23
5196,22,601,3435,511,5903,90
41918,16,663,1332,472,10266,191
2690,3,132,3513,102,3933,30
3143,7,102,3505,83,7409,19
9574,36,1727,3183,1365,8910,362
45431,9,110,463,98,5864,12
32553,80,1610,1976,1321,16133,289
42454,28,1033,1228,697,15950,336
18261,0,185,2695,132,3288,53
46047,4,78,219,61,1928,17
27799,14,584,2221,478,3858,106
42165,58,1416,1286,985,23655,431
13407,4,131,2969,98,2224,33
14837,47,3982,2863,3205,20290,777
17977,12,335,2708,282,5688,53
38292,23,1128,1665,778,12674,350
21813,34,1500,2512,1188,16234,312
14230,10,486,2907,373,7716,113
27075,82,4935,2266,3547,40779,1388
25362,29,1326,2342,1037,11397,289
8090,49,777,3275,613,11081,164
25839,146,3269,2320,2440,24869,829
10805,3,160,3121,130,10642,30
38056,1,148,1682,113,6237,35
37465,33,806,1721,597,11815,209
19272,28,640,2652,489,4560,151
14082,1,150,2915,107,3541,43
21735,4,584,2516,447,12787,137
31594,2,56,2023,45,2655,11
20195,13,628,2603,488,2998,140
31801,271,8868,2012,6567,54108,2301
17909,616,90787,2712,57995,224848,32792
36478,20,801,1781,617,4994,184
19201,164,12122,2656,9247,75624,2875
14980,17,956,2855,762,12230,194
42194,37,1308,1280,1004,16650,304
29653,12,453,2121,362,4003,91
22773,1,210,2462,182,7401,28
40372,19,465,1528,338,8070,127
7112,24,906,3345,656,5249,250
38390,10,488,1657,396,8008,92
27324,3,188,2251,137,5975,51
27205,28,1373,2258,1084,9870,289
26774,15,202,2278,162,3660,40
19435,55,1054,2643,790,7866,264
1259,3,44,3750,39,2747,5
7066,8,493,3347,389,4815,104
39017,42,5409,1616,4433,24796,976
32160,30,2239,1993,1812,23013,427
41266,12,255,1436,187,7192,68
5907,39,1053,3399,739,36193,314
1898,75,3583,3527,2836,21442,747
31471,10,252,2029,214,7433,38
3291,16,964,3503,655,28402,309
7889,18,641,3296,544,7723,97
7977,50,1389,3286,1055,20805,334
43353,32,726,998,536,13166,190
5200,63,1202,3435,932,24040,270
14809,30,678,2864,535,9951,143
9160,31,1245,3209,957,22087,288
16404,4,542,2786,461,5230,81
35166,22,457,1865,303,4521,154
32199,13,338,1991,219,8497,119
31673,26,875,2018,676,17664,199
40154,21,684,1547,486,7854,198
8978,2,41,3220,30,4072,11
5351,10,128,3427,100,3030,28
45572,23,306,364,179,4761,127
20576,35,1788,2584,1375,25905,413
9604,1,30,3181,25,1667,5
18266,24,892,2694,707,22663,185
39795,91,1807,1570,1344,19456,463
8338,4,105,3259,84,3199,21
17327,51,2428,2737,1852,20023,576
13186,92,4356,2984,3449,50458,907
36636,1,38,1772,34,2754,4
38815,1,148,1628,122,3123,26
1562,1,67,3590,58,2821,9
34335,3,170,1909,144,8353,26
26839,33,848,2275,651,7261,197
7589,37,1331,3318,1002,20240,329
15051,53,2596,2851,1673,15773,923
41683,102,867,1375,693,13329,174
37551,2,215,1715,184,4246,31
42884,2,35,1134,25,2806,10
2189,17,292,3522,190,9846,102
41355,10,244,1423,175,5668,69
15808,2,60,2815,45,3513,15
45500,6,61,447,40,2162,21
37210,2,87,1737,45,5437,42
31520,21,1081,2026,887,8316,194
10106,1,49,3157,38,2687,11
5710,1,46,3409,37,8169,9
17033,25,1148,2754,884,12725,264
4346,2,140,3474,107,2416,33
27872,42,959,2219,574,9983,385
9969,13476,493648,3164,357406,1180875,136242
17745,2,142,2719,123,2154,19
38244,8,244,1668,209,5113,35
20825,41,1988,2569,1596,38246,392
6480,112,7869,3376,5917,58778,1952
37459,4,250,1722,208,5848,42
44990,13,147,610,131,3146,16
31038,11,629,2052,517,6757,112
19762,5,94,2627,81,11786,13
42625,1,180,1195,138,6085,42
20623,105,2782,2582,2145,38026,637
44087,125,9084,797,6605,26668,2479
45539,44,420,434,283,5483,137
10121,63,2053,3157,1506,10884,547
30078,2,168,2101,124,6384,44
20954,35,1340,2561,1050,14773,290
42953,1,179,1115,121,6436,58
39819,10,352,1569,252,5224,100
11068,115,12818,3107,9178,42716,3640
22539,2,58,2473,48,2344,10
25557,36,1120,2334,893,11440,227
15601,25,806,2824,590,4157,216
25483,5,376,2337,303,7378,73
28696,1,164,2170,143,7502,21
6457,56,128429,3377,46555,33039,81874
27717,7,165,2227,139,4994,26
42698,7,206,1178,154,8578,52
35343,201,5269,1856,3495,38653,1774
44700,36,589,701,450,13501,139
36689,12,253,1770,193,4753,60
22156,36,2408,2492,1861,24158,547
15581,332,28122,2825,17922,167328,10200
15548,14,668,2827,530,18374,138
8383,120,5322,3256,4243,74398,1079
6514,3,57,3374,45,2305,12
42040,6,409,1312,280,7338,129
17705,15,760,2720,606,12528,154
16633,216,11119,2777,8329,84063,2790
5242,1,123,3433,97,4592,26
12201,4,68,3050,52,3890,16
23823,4,301,2412,227,5618,74
46234,8,61,153,47,1094,14
36014,3,124,1807,97,2547,27
20510,20,946,2587,763,12086,183
12032,98,6799,3059,4884,23387,1915
2741,13,341,3513,260,6466,81
16132,7,412,2800,340,3210,72
40820,8,157,1487,127,4526,30
7833,7,135,3301,111,5507,24
41774,257,10716,1358,8076,63112,2640
11227,1,20,3098,17,3324,3
13172,4,276,2984,211,13370,65
34525,527,44650,1900,30363,169874,14287
42158,1,119,1289,91,5063,28
20643,168,2626,2581,1998,15386,628
30090,2,74,2101,62,2090,12
35525,11,476,1844,378,17823,98
39416,18,246,1591,196,5489,50
1954,99,4798,3526,3686,31853,1112
29526,66,3332,2128,2616,25923,716
36892,49,817,1757,663,10603,154
41128,1,40,1456,30,4839,10
21384,59,2630,2535,1859,39885,771
20967,3,77,2560,63,1844,14
42044,2,114,1312,77,5295,37
46387,26,246,91,209,4338,37
39896,51,1891,1563,1324,22269,567
11778,2053,96368,3069,64256,406947,32112
18845,5,367,2669,284,6317,83
14303,7,790,2901,701,22065,89
13165,23,412,2985,322,7233,90
44879,17,291,643,236,4851,55
37669,1,138,1708,101,11494,37
11748,10,492,3071,398,7677,94
7581,32,1416,3318,1012,16916,404
25113,120,6680,2352,4605,43372,2075
10756,34,3263,3123,2448,38050,815
36637,44,1413,1772,1152,12332,261
15596,13,408,2824,362,3643,46
8749,4,186,3233,149,5353,37
8627,44,653,3241,508,7814,145
42817,26,563,1149,390,6425,173
11199,11,582,3099,462,10828,120
10018,1,55,3162,47,3369,8
9406,37,2042,3193,1610,17462,432
13176,26,954,2984,712,4281,242
42091,6,151,1303,103,3521,48
21626,33,1613,2521,1240,11086,373
5888,40,864,3400,684,7259,180
37124,15,734,1743,571,27038,163
3226,21,391,3504,304,8094,87
27794,18,1215,2222,902,9915,313
34592,7,228,1897,175,4353,53
38144,35,664,1675,527,8984,137
14983,331,14366,2855,9864,59628,4502
35882,17,448,1817,351,7418,97
15620,38,4052,2823,3126,32635,926
1826,1298,43791,3530,28066,124538,15725
40369,3,126,1528,106,3438,20
11605,10,498,3079,422,12437,76
42919,22,406,1124,253,4565,153
17384,16,1270,2734,900,18383,370
25252,1,46,2347,37,2216,9
11487,51,5120,3085,3999,38031,1121
33795,2,76,1927,64,2382,12
34125,71,3482,1916,2543,21745,939
6903,22,615,3357,495,6441,120
29172,115,6748,2146,5305,38151,1443
38596,20,606,1642,425,5572,181
24943,30,1111,2360,858,19281,253
22337,8,374,2484,305,15593,69
30753,0,138,2064,110,6121,28
25282,23,559,2346,458,9753,101
14097,12,613,2914,502,9984,111
36468,16,455,1782,357,12361,98
21339,56,4468,2538,3094,37362,1374
35817,103,2880,1821,2077,32981,803
36002,130,3303,1808,2634,26745,669
19079,4,143,2661,100,5292,43
24967,0,68,2359,49,4972,19
24403,50,2359,2385,1843,28890,516
31164,14,302,2046,238,5271,64
22451,11,1390,2478,1064,21819,326
37616,2,176,1711,140,10273,36
4661,2,48,3462,34,2407,14
14371,19,638,2895,527,10183,111
26020,213,7927,2312,6071,80398,1856
26469,7,596,2292,485,8045,111
21085,7,436,2553,359,8237,77
4033,14,282,3485,237,4623,45
12532,1,49,3031,32,1586,17
29080,27,2162,2150,1653,14876,509
10150,490,24871,3155,17659,140552,7212
37712,1,139,1705,120,5784,19
43711,90,1404,878,1058,25072,346
9912,20,644,3167,490,19461,154
16322,46,1655,2791,1283,18196,372
37697,4,417,1707,322,5909,95
18802,14,859,2671,665,6994,194
12462,1,19,3034,17,2445,2
25462,249,12300,2338,9144,43116,3156
25127,1,59,2352,48,2622,11
32340,0,58,1985,48,3091,10
10969,17,703,3112,559,5785,144
10907,39,721,3115,583,12917,138
44063,6,68,811,49,3040,19
45487,15,204,449,133,3322,71
8964,576,24605,3220,16968,288038,7637
26562,8,590,2287,455,6906,135
17892,11,1154,2713,908,15404,246
24811,28,978,2366,790,13009,188
13712,0,73,2945,60,2868,13
28657,6,992,2172,762,7610,230
21767,42,2710,2514,1870,15825,840
16073,3,248,2803,182,9443,66
42877,11,206,1136,171,6472,35
20793,1,75,2571,53,2432,22
39734,8,451,1574,296,15395,155
25686,1,134,2327,104,7235,30
11042,9,316,3109,265,4609,51
23530,387,22889,2425,16134,162437,6755
31763,1,40,2014,33,2549,7
38385,13,181,1658,120,3734,61
33972,3,96,1921,80,7980,16
9653,65,4904,3178,3479,39784,1425
32624,61,1120,1973,845,5985,275
41488,6,142,1403,121,3822,21
18161,1,90,2700,67,5144,23
13358,52,3087,2972,2314,63093,773
13825,24,1920,2937,1447,20325,473
32414,7,373,1982,304,2208,69
33128,22,463,1952,370,6017,93
37188,32,663,1739,471,7203,192
14827,11,280,2863,214,19133,66
4022,0,53,3485,30,2304,23
11894,8,244,3065,196,6866,48
32315,4,105,1986,92,4306,13
43938,50,414,831,328,5843,86
35306,68,2154,1857,1551,19863,603
6981,832,53394,3352,35705,170259,17689
15863,8,1258,2813,996,18056,262
43571,51,1067,929,834,16555,233
6456,6,741,3377,611,13475,130
14256,2,81,2905,66,6234,15
3121,9,427,3506,289,30661,138
19158,19,455,2658,361,9594,94
32138,7,117,1995,91,5133,26
14051,143,9063,2917,6684,57807,2379
35765,3,164,1825,112,6495,52
30983,16,618,2055,475,8051,143
25646,41,1833,2328,1463,15409,370
8649,64,2157,3240,1669,18146,488
19579,29,2090,2637,1610,20934,480
29136,16,549,2148,440,7592,109
13643,3,166,2951,124,4058,42
21902,4,63,2507,51,3435,12
42934,0,24,1119,17,2380,7
28181,49,1660,2200,1252,23560,408
45146,276,2668,544,2074,15797,594
18464,40,1069,2686,876,16369,193
5421,143,9660,3424,7076,61997,2584
45498,7,71,447,46,1965,25
30188,40,788,2095,598,6742,190
28178,7,1200,2201,949,17541,251
25676,39,2785,2327,2104,13740,681
30196,1,123,2095,106,8350,17
11270,6,197,3096,163,9358,34
5592,26,1430,3416,1145,41643,285
19695,165,6804,2631,5174,70065,1630
41618,10,793,1385,576,10666,217
29220,13,579,2144,434,21063,145
4332,2,220,3475,160,10788,60
27510,4,132,2239,91,3339,41
17996,1,192,2707,155,4026,37
42467,66,1269,1225,976,23386,293
42386,2,109,1244,82,7200,27
28521,145,2016,2180,1453,10846,563
4601,3,180,3465,134,4389,46
44178,48,550,791,462,11308,88
32367,22,465,1984,297,5694,168
42056,8,308,1310,222,6280,86
40306,20,440,1537,350,9876,90
20505,0,84,2588,69,2492,15
45884,23,170,294,139,2839,31
33068,23,1683,1954,1322,27730,361
32313,5,121,1986,95,3471,26
22202,2,35,2490,32,2216,3
46188,0,14,164,10,971,4
2232,18,910,3521,737,10867,173
42423,136,3379,1235,2404,14234,975
36590,4,97,1775,84,5364,13
31776,1,92,2013,81,4342,11
7137,13,191,3344,151,4874,40
18222,7,292,2697,230,6136,62
9424,1063,52342,3192,36137,161733,16205
31609,8,221,2022,175,6067,46
21696,28,1834,2517,1258,10325,576
33171,11,245,1950,198,7103,47
6039,21,662,3393,529,6292,133
11341,37,633,3094,516,3237,117
4887,29,478,3452,329,5993,149
2543,5,154,3516,124,4413,30
15996,0,36,2807,29,2938,7
16421,4,556,2786,441,4481,115
4245,11,213,3478,171,7708,42
19334,0,34,2649,19,2103,15
13398,424,21582,2969,14864,113059,6718
5531,9,275,3419,218,7806,57
39982,2,55,1557,38,2310,17
2881,11,237,3510,189,6329,48
4323,50,1579,3475,1199,32548,380
45009,74,1536,606,1052,16540,484
24936,1700,100601,2360,75807,1000106,24794
19654,9,213,2633,169,2306,44
4159,18,235,3481,195,7172,40
9286,5,220,3202,174,6505,46
34121,5,322,1916,229,5421,93
9252,342,34092,3204,23225,147642,10867
8121,0,13,3274,11,902,2
24044,81,7743,2401,5918,50474,1825
45730,1,14,348,9,1776,5
20810,38,1651,2570,1249,16049,402
35923,2,37,1814,33,3395,4
45749,1626,44927,344,36361,329925,8566
5559,21,840,3417,592,10070,248
2938,53,2151,3509,1627,15957,524
40236,18,377,1541,265,8205,112
31335,0,35,2037,28,3094,7
19127,0,1080,2659,812,15133,268
28912,879,38628,2160,20987,211128,17641
5949,6,226,3397,179,4609,47
41028,2,56,1470,39,1968,17
11368,134,4523,3092,3552,23660,971
27951,0,0,2213,0,15911,0
11464,167,4330,3086,3271,54041,1059
16660,5,369,2775,308,6359,61
22147,0,0,2493,0,28775,0
25208,61,2121,2348,1587,25189,534
39410,4,93,1592,77,4487,16
31240,1181,63532,2042,41871,242662,21661
13139,42,1954,2994,1501,20880,453
8723,13,418,3235,347,18070,71
21717,19,474,2516,379,4098,95
4658,8,481,3462,363,6153,118
17211,11,359,2743,280,4285,79
9379,94,4671,3195,3251,30806,1420
31583,25,472,2023,396,3833,76
5176,48,2326,3437,1741,70258,585
26094,7,232,2309,189,1723,43
21246,15,418,2542,371,5318,47
5111,12,645,3440,485,8460,160
2392,122,2912,3518,2285,44459,627
30027,17,1035,2104,780,15096,255
41940,87,1436,1329,1108,17670,328
19069,4,123,2661,102,1779,21
11465,9,417,3086,320,5533,97
9579,25,1155,3183,890,13186,265
37498,10,450,1719,365,8574,85
9330,1,82,3198,74,1791,8
32239,15,233,1989,174,3123,59
44848,32,356,650,234,10412,122
11142,121,5734,3103,4330,43247,1404
28040,6,248,2208,205,3406,43
21963,1,150,2502,121,5141,29
24070,28,1360,2400,1060,14574,300
33269,94,3949,1947,3079,33760,870
3900,9,150,3490,107,3772,43
3852,407,13771,3491,10606,92525,3165
36569,1,29,1777,21,4323,8
42524,14,188,1214,144,3870,44
22887,14,1809,2456,1357,53022,452
43769,30,273,860,247,6064,26
7120,7,152,3345,135,12742,17
32458,22,607,1980,471,9834,136
8601,7,280,3243,221,14231,59
38836,2,103,1627,85,2324,18
6263,21,854,3386,684,13326,170
27548,21,867,2236,650,7112,217
35575,1,52,1841,44,3966,8
40752,285,5362,1494,3860,36921,1502
40892,30,888,1480,642,10697,246
11967,39,2072,3062,1563,24345,509
6832,13,315,3360,271,8028,44
9288,15,593,3202,446,5869,147
26907,8,210,2271,168,8382,42
40429,11,237,1523,175,5598,62
16571,27,1496,2779,1137,13413,359
1671,68,3338,3567,2340,28223,998
16240,19,889,2796,626,7670,263
15130,35,1803,2847,1453,25350,350
31935,19,513,2006,418,14402,95
39830,122,4278,1568,3264,22284,1014
37606,4,106,1712,84,5998,22
2635,14,434,3514,342,5336,92
4397,85,3462,3472,2524,31821,938
25042,0,36,2356,30,1445,6
5584,21,850,3416,640,9823,210
44625,8,170,721,157,5658,13
38595,2,101,1643,68,7312,33
29640,85,5754,2122,4368,30265,1386
27820,2,74,2221,61,2549,13
37253,63,712,1734,548,11751,164
25841,57,2492,2320,1933,22578,559
3252,14,706,3503,570,4041,136
35741,21,336,1827,274,4658,62
8277,423,14628,3264,10480,71024,4148
5118,1114,50166,3440,23429,98539,26737
42099,0,83,1301,56,5799,27
10967,37,692,3112,548,12527,144
2207,18,727,3521,567,12270,160
12418,27,662,3036,539,16383,123
7942,60,1587,3290,1215,15654,372
43406,52,598,979,426,7582,172
41233,8,366,1442,284,11635,82
43057,8,188,1085,125,3742,63
19409,103,2436,2644,2012,21955,424
45809,4,56,323,35,2206,21
12639,3,94,3025,82,2641,12
2697,1,55,3513,42,3930,13
39404,124,2138,1592,1594,12282,544
34361,11,174,1908,143,2938,31
33140,0,43,1951,39,3571,4
38261,1,113,1667,99,4539,14
36943,69,1317,1754,1092,17067,225
21706,8,210,2517,170,3646,40
19420,9,665,2644,552,6068,113
11173,55,2074,3101,1611,39203,463
18027,8,598,2705,501,7871,97
1789,11,830,3533,675,10754,155
12297,19,519,3044,402,17605,117
36836,0,0,1759,0,44784,0
43402,3,54,981,39,1397,15
16330,184,7605,2791,5202,53593,2403
29823,78,3029,2114,2376,19018,653
17289,2,169,2739,152,4457,17
36224,154,2297,1794,1909,20408,388
29390,2,114,2134,93,3017,21
20097,34,1224,2609,913,9880,311
45719,18,506,354,389,8728,117
45533,108,1849,436,1505,24903,344
5188,6,363,3436,290,8941,73
46346,5,87,111,79,1911,8
41003,83,3128,1472,2424,30168,704
35553,0,129,1842,106,4588,23
11423,6,537,3089,405,8801,132
25479,0,98,2337,78,3903,20
33618,146,2905,1934,2284,22302,621
5637,13,629,3413,466,6873,163
20046,118,6119,2611,4596,33839,1523
33191,236,6297,1950,5037,39824,1260
27469,26,610,2242,372,5719,238
7003,0,16,3351,15,1147,1
41745,29,664,1363,515,6377,149
13885,41,3624,2931,2838,29436,786
3242,11,611,3503,287,11114,324
27387,1,42,2246,36,8070,6
15563,39,2735,2826,1977,8022,758
16235,107,6944,2796,5507,62697,1437
18855,15,1289,2669,948,9214,341
29093,4,101,2150,88,2464,13
20127,16,592,2607,509,7799,83
3755,18,216,3493,174,5908,42
19932,8,261,2618,202,5770,59
7151,7,544,3342,406,8641,138
42224,39,1211,1274,916,13126,295
31638,89,7238,2020,5064,52628,2174
11709,8,334,3073,268,4569,66
6725,24,628,3366,469,14459,159
11365,2,105,3092,76,1362,29
39028,20,1890,1616,1443,15228,447
32378,26,550,1983,427,7082,123
25504,0,306,2336,226,3976,80
17135,47,1560,2748,1189,10656,371
41206,15,376,1448,289,6786,87
15419,26,1226,2833,961,15768,265
4155,3,14,3481,13,1931,1
29110,2,147,2149,121,6609,26
2771,48,1512,3512,1155,10737,357
4039,22,1914,3485,1187,26380,727
36061,0,53,1803,42,2308,11
31927,39,2175,2006,1652,21249,523
1267,4,135,3748,115,5164,20
4162,11,141,3481,103,6472,38
5069,24,1093,3443,845,6501,248
14365,8,114,2896,82,6632,32
32244,12,316,1989,257,4125,59
44676,12029,338741,700,239801,1294496,98940
13394,67,1521,2970,1171,25669,350
45121,33,314,552,239,6010,75
30086,19,1073,2101,800,10207,273
16118,55,2027,2801,1544,14869,483
5741,27,494,3408,390,14532,104
30035,50,1728,2103,1295,12775,433
26899,127,4863,2272,3745,27289,1118
45015,14,154,604,118,3147,36
16823,56,4072,2765,3256,17916,816
33871,120,10107,1924,7291,17010,2816
18595,1091,73449,2681,53022,158518,20427
6202,2,58,3388,47,2564,11
19905,60,1962,2619,1560,8614,402
8221,21,624,3268,516,12425,108
34968,24,693,1875,569,8354,124
4927,275,14568,3450,10598,75596,3970
40542,0,4421,1512,3241,30726,1180
6964,133,4685,3353,3533,42039,1152
44203,15,222,785,181,4728,41
39959,240,7845,1558,5749,56864,2096
29980,6,192,2106,164,3195,28
42154,3,105,1289,78,4866,27
43270,118,2567,1022,2080,34216,487
41301,10,548,1430,425,16276,123
33547,2,629,1936,484,24016,145
20607,2,176,2582,144,5638,32
26570,4,308,2287,239,9092,69
12723,8,729,3020,600,10502,129
17940,48,3592,2710,2615,40687,977
2831,24,496,3511,407,18269,89
45796,10,81,329,70,4038,11
1991,160,5027,3525,3713,38410,1314
37533,19,423,1716,346,13649,77
32122,50,2233,1995,1298,18117,935
2517,11,137,3516,113,9564,24
39151,5,153,1607,115,7041,38
3651,5,130,3496,107,3563,23
46144,9,135,183,110,2991,25
25178,59,2074,2349,1597,10035,477
42073,254,4881,1306,3599,27239,1282
29625,10,328,2123,284,3475,44
36566,112,2331,1777,1856,17862,475
5147,84,2485,3438,1913,17417,572
43341,67,1424,1002,1119,23282,305
9139,628,29409,3210,21026,98272,8383
25198,1,59,2349,48,2138,11
4890,404,21407,3452,15632,115793,5775
19567,4,539,2638,399,11560,140
30117,23,1142,2099,987,25751,155
23288,3,80,2437,60,1836,20
32520,4,130,1978,115,4630,15
10424,402,29719,3143,19558,102288,10161
34586,65,1302,1897,993,28267,309
2679,52,1712,3514,1339,33082,373
18051,14,872,2704,710,22670,162
1829,92,3930,3529,2933,27389,997
38622,40,3330,1640,2774,21586,556
11446,53,1911,3087,1518,18579,393
38742,0,49,1633,35,1955,14
43750,15,236,868,207,4224,29
25105,0,10,2353,10,5030,0
45751,12,69,342,55,3100,14
12480,8,403,3033,305,4307,98
32694,3,82,1970,58,2379,24
14201,7,169,2909,133,3603,36
12174,79,4456,3051,3284,37445,1172
28675,17,1077,2171,796,11571,281
3179,88,3919,3505,2868,35815,1051
20767,31,701,2573,579,7505,122
42554,32,1051,1208,666,19160,385
17413,148,3778,2732,2812,20093,966
13524,28,883,2959,666,5253,217
42939,15,543,1118,375,7880,168
19267,38,2300,2652,1790,20012,510
38896,44,1253,1624,960,7772,293
23732,18,740,2415,547,7642,193
30826,7,225,2061,193,4169,32
26856,20,2251,2274,1694,21037,557
15397,12,417,2834,339,10353,78
8061,1,54,3276,46,2152,8
22290,12,972,2485,754,18700,218
7156,9,313,3342,263,10000,50
20918,5,288,2563,242,2166,46
43050,138,1701,1088,1479,28187,222
46321,1,50,120,38,1075,12
28277,28,1566,2195,1228,29676,338
25855,1,39,2320,33,3194,6
26939,21,3192,2270,2522,22061,670
5586,2,98,3416,80,3123,18
15845,55,1823,2814,1348,20369,475
31208,49,994,2044,809,6816,185
26919,5,289,2271,216,3721,73
28333,174,4738,2192,3624,29040,1114
34967,12,228,1876,189,3124,39
12262,3,149,3046,119,3223,30
18221,55,1290,2697,936,8002,354
44963,17,277,620,174,4122,103
36618,321,4987,1773,3852,26347,1135
23574,12,722,2423,564,9661,158
30742,5,160,2064,142,4089,18
26311,12,503,2299,382,5063,121
15630,36,2846,2822,2089,21397,757
16999,28,507,2757,386,3974,121
25496,5,283,2337,219,6888,64
4562,7,390,3466,189,5248,201
42264,63,1274,1266,889,26925,385
25054,0,8,2355,7,5173,1
7582,48,1246,3318,972,12250,274
14314,97,4709,2900,3763,69599,946
22639,19,802,2469,615,6428,187
4260,12,280,3478,225,11449,55
6322,33,1303,3383,879,9030,424
10091,5,101,3158,82,3958,19
27453,8,212,2243,172,9072,40
18189,0,167,2698,127,4934,40
14198,29,640,2909,497,4199,143
5924,3,102,3398,85,2747,17
4470,5,275,3470,172,10248,103
44076,169,3009,810,2163,24100,846
17060,28,1630,2752,1236,24830,394
25902,37,3360,2318,2447,55955,913
19916,6,420,2619,334,12071,86
32826,10,363,1964,300,3972,63
18538,12,651,2683,552,12687,99
28227,4,101,2198,79,4335,22
28051,9,1985,2208,1654,15157,331
35998,6,268,1808,228,4737,40
41385,2,34,1419,24,3378,10
32455,159,4484,1981,3306,25414,1178
20522,1,106,2587,90,2111,16
28377,4,433,2189,357,11647,76
32886,57,5785,1962,4537,15476,1248
16492,1,70,2783,53,2252,17
3737,63,1423,3494,1101,6347,322
41407,6,183,1415,149,4538,34
46077,84,1852,205,1565,11723,287
13761,9,310,2940,266,4040,44
6702,18,412,3367,336,8132,76
41024,2,143,1471,113,5424,30
28824,49,4868,2163,4016,28929,852
34136,22,416,1916,337,7090,79
38286,0,108,1665,91,2385,17
9017,5,435,3219,316,7985,119
6388,2,82,3380,69,2508,13
26758,21,539,2279,425,12139,114
4752,67,2012,3459,1465,14908,547
4468,25,1331,3470,1143,8974,188
18765,17,378,2673,303,8305,75
1996,6,126,3525,107,4133,19
27592,13,475,2234,361,5550,114
4134,5,101,3482,76,7378,25
2215,177,9301,3521,7023,49431,2278
41088,28,621,1462,451,6193,170
4677,25,487,3462,368,9938,119
43461,8,105,831,67,1627,38
42964,20,532,1113,371,18173,161
23366,73,3328,2433,2474,13752,854
13930,10,267,2926,230,2473,37
11810,2,123,3069,100,5618,23
15628,26,1350,2823,1084,11646,266
16839,14,681,2764,541,11549,140
43239,343,6353,1031,4955,42185,1398
33640,13,551,1933,330,6518,221
24548,20,903,2378,653,10765,250
41529,19,240,1399,191,3350,49
40740,3,378,1496,269,6235,109
1699,3,74,3564,66,3456,8
44902,85,800,637,633,10432,167
27753,14,440,2225,352,6153,88
3093,21,1930,3506,1474,21663,456
25645,9,823,2328,663,14981,160
33194,2,133,1950,113,3930,20
1499,6,79,3615,68,3344,11
36253,7,211,1793,178,4333,33
11911,1110,61675,3064,44150,165675,17525
35544,27,1075,1842,875,10265,200
3624,4,82,3496,61,3651,21
10905,24,866,3115,628,6751,238
4552,87,1352,3467,1092,15603,260
41480,2,49,1405,39,1888,10
2045,6,249,3524,191,28423,58
41184,17,979,1450,732,21693,247
36141,3,220,1798,173,3877,47
20913,45,697,2563,507,10797,190
41649,1,47,1379,38,2869,9
33793,25,2455,1927,1882,20695,573
6339,2,71,3382,40,3756,31
26351,17,840,2297,670,13157,170
21237,88,6654,2542,5020,45717,1634
3069,12,304,3507,223,5519,81
44658,5,182,714,140,6886,42
28546,41,1987,2178,1623,21748,364
12777,9,548,3017,422,11112,126
3292,318,16109,3503,11662,156375,4447
8403,61,1623,3255,1193,14376,430
40546,208,4422,1512,3323,28816,1099
1948,65,2255,3526,1483,11450,772
23873,21,529,2409,387,5989,142
16882,115,7791,2762,5547,48093,2244
7398,7,311,3329,247,4000,64
44870,2,67,645,56,4658,11
12093,28,832,3056,604,11779,228
41127,2,16,1456,13,2627,3
1818,7,476,3530,402,6723,74
40485,20,788,1518,553,13602,235
46237,4,37,152,35,881,2
27650,78,5346,2231,4269,29760,1077
41346,80,3840,1424,2908,26737,932
6260,0,59,3386,40,3131,19
1565,1,35,3590,33,1888,2
7034,149,5061,3349,3811,58046,1250
22443,4,242,2479,177,8922,65
31865,1,28,2009,23,2454,5
12009,10,819,3059,673,61967,146
32640,11,231,1972,194,4500,37
41530,80,1307,1399,920,15080,387
6730,1026,66899,3366,46070,350064,20829
20691,109,3514,2578,2544,15903,970
38111,14,241,1677,189,5040,52
36565,18,507,1777,420,21215,87
5330,5,52,3428,51,5244,1
35492,33,871,1847,661,8488,210
19202,2,139,2656,109,3103,30
46354,5,37,109,25,691,12
34585,36,524,1897,422,7348,102
3273,144,7762,3503,5395,98258,2367
41492,21,309,1403,229,5448,80
6846,40,1916,3360,1505,16879,411
17250,66,4684,2741,3839,45993,845
24295,3,113,2389,92,5500,21
17018,222,22385,2755,13839,78550,8546
37589,26,466,1713,402,12277,64
43100,341,4186,1071,3410,36585,776
43651,56,1216,899,891,10237,325
16134,15,459,2800,353,4840,106
30134,29,1757,2099,1370,23217,387
19122,15,429,2659,331,5773,98
33576,11,130,1935,114,2080,16
21185,5,262,2546,195,6604,67
24260,12,520,2392,438,10119,82
37851,50,728,1694,551,8650,177
41221,168,4209,1445,3116,44969,1093
10599,3,61,3133,47,3529,14
24745,27,1886,2368,1428,33656,458
45978,5,110,253,67,2489,43
37426,28,446,1723,347,8228,99
3998,10,568,3486,460,5997,108
23300,0,15,2436,11,2472,4
21180,18,833,2546,724,4365,109
22264,4,256,2487,209,4183,47
21440,24,2264,2532,1806,21690,458
11958,23,1182,3062,783,15587,399
19313,81,2696,2649,2054,34301,642
42452,1,54,1229,39,7074,15
34631,63,2806,1895,2097,37143,709
41961,77,682,1324,513,9609,169
1899,17,469,3527,376,17078,93
8807,7,288,3229,241,7045,47
43488,4,45,958,39,6321,6
8454,0,70,3252,58,7582,12
31386,1,86,2035,69,3419,17
4569,18,2725,3466,2091,20048,634
26751,9,571,2279,473,7414,98
2694,24,1383,3513,1055,26879,328
26496,52,3125,2290,2245,18365,880
17502,0,2275,2729,1643,44713,632
32230,5,201,1990,169,3758,32
39964,78,2587,1558,1985,36970,602
2103,881,25682,3523,18144,79350,7538
4531,0,2,3468,1,818,1
16432,48,1672,2786,1214,16192,458
21168,35,4043,2547,3072,34984,971
40722,109,2451,1498,1725,23131,726
19508,2,509,2640,388,7707,121
12225,1,137,3049,106,4505,31
7943,18,379,3290,321,8358,58
24471,0,476,2382,362,5729,114
37045,1,90,1747,71,2780,19
23682,0,93,2417,59,3019,34
1315,7,420,3727,317,16333,103
10288,19,975,3149,614,8876,361
11159,3,140,3102,83,2956,57
3361,133,5716,3501,4193,37811,1523
25022,57,3685,2357,2878,36254,807
1479,7,263,3617,203,2745,60
46274,13,135,141,102,1575,33
15888,15,560,2812,393,8121,167
34555,6,230,1899,180,4019,50
4380,17,470,3473,348,11576,122
14166,0,145,2912,112,4164,33
10378,4,463,3145,359,20696,104
12228,7,135,3048,116,7204,19
20603,65,3553,2583,2708,24253,845
7645,3,219,3314,176,8666,43
19086,548,46506,2660,31133,241737,15373
24722,26,1504,2369,1220,21266,284
3914,22,794,3489,630,11955,164
44920,1,30,631,23,2197,7
45193,22,124,531,104,3466,20
8068,14,123,3276,104,5291,19
39867,4,209,1565,142,4629,67
6354,15,326,3381,258,8344,68
9950,5,366,3165,284,10520,82
15400,7,233,2834,165,4668,68
40169,2,83,1546,67,3653,16
7753,9,351,3308,288,11679,63
34414,24,977,1905,726,7387,251
32103,12,334,1996,260,6034,74
41535,4,367,1398,276,10128,91
39521,98,3645,1586,2824,20163,821
28143,7,666,2203,494,3910,172
25658,32,804,2328,638,6344,166
38514,41,662,1649,517,7058,145
1233,3,93,3763,73,3391,20
18022,12,883,2705,618,15721,265
15895,2,131,2812,103,2911,28
5675,8,445,3411,342,8731,103
39118,4,105,1610,89,2952,16
19022,531,33503,2663,24001,181646,9502
36902,73,1255,1756,969,9582,286
961,2,213,3850,186,6589,27
43709,25,479,878,346,6934,133
45298,15,118,499,89,1534,29
42412,52,1757,1238,1268,16221,489
8468,13,257,3251,208,4247,49
35178,3,312,1864,233,6572,79
34416,11,262,1905,210,7882,52
7909,55,2343,3294,1781,27190,562
6063,3,92,3392,75,2594,17
33486,34,449,1938,354,4382,95
15297,60,3134,2838,2457,24573,677
37692,64,466,1707,352,4791,114
14642,109,5004,2876,3802,39676,1202
11472,13,630,3086,492,11843,138
30494,6,215,2077,175,4110,40
9972,17,507,3164,405,4977,102
5827,4,175,3403,132,4843,43
34928,78,3918,1877,2812,62281,1106
22861,10,608,2458,468,3150,140
32750,81,3394,1968,2533,15007,861
43586,11,210,923,171,4616,39
24751,15,229,2368,194,4087,35
10131,15,588,3156,425,5488,163
25883,211,7842,2319,5335,57078,2507
45952,2,49,263,41,1366,8
39218,96,3902,1603,2993,22271,909
14386,546,62610,2894,41200,308386,21410
5475,648,20068,3421,15474,64326,4594
1535,3,26,3598,22,1677,4
14605,0,421,2879,328,5903,93
2708,34,1269,3513,872,7772,397
45067,18,190,582,175,3983,15
11740,29,383,3072,281,5074,102
8833,24,907,3228,685,4125,222
27934,2,128,2214,111,5913,17
38121,44,2759,1676,1905,35785,854
9568,26,801,3183,612,10553,189
15460,24,4468,2832,3130,13906,1338
28111,2,75,2205,57,3993,18
30440,3,50,2080,41,2021,9
23627,40,876,2420,702,5188,174
34619,41,829,1895,623,5451,206
19258,16,520,2652,413,7419,107
16027,2,152,2806,118,3810,34
45239,2,48,519,32,1563,16
30294,13,446,2090,366,10049,80
28059,9,156,2207,121,4429,35
20659,7,366,2580,291,7200,75
38756,174,4314,1632,3416,34292,898
5427,5,112,3423,86,7804,26
7731,72,1932,3309,1065,6453,867
18686,18,1016,2676,798,9467,218
30260,319,14554,2092,10447,48027,4107
23797,23,600,2413,464,6227,136
19216,10,682,2655,556,10790,126
2604,24,734,3515,601,11356,133
41086,103,1030,1462,728,11433,302
39631,17,552,1579,449,8654,103
41776,6,143,1358,102,10465,41
24969,0,22,2359,20,16761,2
28763,392,12569,2166,10059,45940,2510
29998,7,769,2105,578,14390,191
6158,4,230,3390,194,7754,36
8024,50,1767,3283,1389,20317,378
35925,7,114,1814,87,2331,27
5119,66,4405,3440,3484,40111,921
24701,459,29470,2370,22648,73587,6822
35279,41,1198,1858,930,6176,268
36692,4,295,1769,227,4224,68
37200,6,58,1737,50,2630,8
15914,228,8270,2812,5873,36672,2397
38152,6,250,1674,193,7219,57
36355,2,36,1787,29,1860,7
43536,44,674,941,563,18494,111
42225,7,254,1274,171,4382,83
22262,82,3622,2487,2729,42962,893
34473,10,342,1903,269,6895,73
33574,522,6679,1935,5332,24178,1347
46257,0,51,147,21,875,30
11666,103,6496,3076,4544,23635,1952
9183,3,81,3207,65,6177,16
45071,911,14082,580,11241,71796,2841
42149,205,4537,1291,3325,23953,1212
35155,50,725,1865,538,5111,187
27923,16,573,2215,461,10284,112
9459,3,212,3190,173,5111,39
30533,5,130,2075,110,2365,20
18509,26,941,2684,735,6812,206
10741,3,194,3124,153,3367,41
9180,9,472,3207,381,12340,91
18778,6,431,2672,335,19978,96
6904,19,483,3357,391,11190,92
36690,33,675,1770,575,17854,100
2808,318,12851,3511,9716,61047,3135
33718,3,128,1930,109,4300,19
7431,68,2336,3327,1682,22093,654
19147,5,143,2658,123,3166,20
46187,33,453,165,388,4226,65
27956,0,45,2213,40,2603,5
44897,14,250,639,234,5397,16
11226,9,619,3098,536,7393,83
9564,55,2713,3183,2028,20957,685
12013,10,316,3059,251,4183,65
25704,184,6327,2326,4765,43163,1562
9314,11,222,3200,163,4556,59
45761,25,297,338,242,4253,55
46222,2,41,156,29,1635,12
14589,107,8339,2880,6123,63033,2216
25489,10,234,2337,189,5631,45
20947,32,990,2561,761,9706,229
20948,6,409,2561,325,10347,84
20177,26,3826,2604,2878,54240,948
6338,43,1205,3382,945,25560,260
24580,69,2049,2376,1561,12952,488
20751,3,282,2575,236,5947,46
30599,146,7248,2072,5572,48581,1676
29802,2,766,2115,567,9496,199
34854,9,784,1881,658,21607,126
13916,11,591,2928,509,4694,82
44931,14,139,630,111,4609,28
9265,10,877,3203,685,18571,192
24204,1,50,2394,38,1797,12
28896,6,327,2160,258,6709,69
15725,2,307,2818,214,7964,93
27144,74,1772,2262,1365,17542,407
17123,0,7809,2748,5868,39833,1941
17119,27,989,2748,780,6711,209
7694,964,42871,3311,29822,143947,13049
2832,4,184,3511,161,10061,23
41555,1,102,1395,70,4288,32
40370,21,878,1528,665,11250,213
37611,34,2501,1711,1915,20879,586
17306,1,45,2738,40,3749,5
46240,1,34,151,21,1116,13
37375,25,924,1727,765,15948,159
10710,6,176,3126,139,14310,37
14671,41,4191,2875,2843,26695,1348
16013,2,156,2807,120,4638,36
14556,131,3707,2882,2634,31056,1073
41891,4,189,1335,155,6633,34
21360,3,132,2536,112,3796,20
18552,23,759,2683,599,19065,160
20109,156,6092,2608,4187,19316,1905
30551,0,86,2074,65,4070,21
8396,6,146,3255,111,4034,35
23937,1,173,2406,135,3905,38
36517,3,374,1779,294,3231,80
2408,19,1495,3518,1232,10355,263
40484,60,1266,1518,917,7892,349
15892,10,377,2812,288,6088,89
9239,2,157,3205,127,5807,30
7713,13,442,3311,370,7919,72
2804,203,6471,3511,5062,25612,1409
28978,6,482,2156,365,6831,117
13100,109,5321,2996,3742,66838,1579
22598,72,4701,2471,3727,40838,974
33248,733,12351,1948,8639,43977,3712
6269,4,39,3385,27,1624,12
19576,18,1444,2637,1061,9375,383
11752,3,108,3071,87,4211,21
20920,14,857,2562,701,10509,156
19520,463,19198,2639,14315,45637,4883
16947,60,2714,2759,2090,16609,624
7243,5,335,3339,250,6309,85
16668,285,12993,2774,9296,68246,3697
24129,2,109,2397,75,3007,34
33260,48,3167,1947,2263,22056,904
23726,39,2286,2416,1818,25097,468
40590,4,78,1508,62,1621,16
40659,177,5410,1503,3961,51701,1449
26844,31,601,2274,463,18149,138
16285,54,3432,2793,2688,26254,744
16974,15,966,2758,777,9163,189
5290,22,772,3430,575,7264,197
20513,11,379,2587,341,3567,38
31010,12,517,2054,395,6748,122
7826,7,539,3302,451,8030,88
26313,41,1090,2299,799,11154,291
7092,7,104,3346,95,3932,9
26593,0,78,2286,70,3763,8
14820,9,349,2864,272,4698,77
19241,16,700,2654,540,16628,160
11234,20,917,3098,714,13462,203
25603,2,123,2331,95,6552,28
33826,5,244,1926,198,6258,46
43375,11,185,988,143,7354,42
38326,18,369,1662,285,5297,84
26628,8,315,2285,254,4292,61
12214,38,1180,3049,990,13491,190
5470,24,557,3422,471,12042,86
39085,36,716,1612,561,8640,155
20728,45,1481,2576,1093,11439,388
1462,5,133,3622,115,2794,18
30808,3,72,2062,58,2770,14
15916,3,292,2812,221,7803,71
35275,6,165,1859,134,3618,31
23482,1,34,2427,30,4295,4
4806,52,1302,3456,1094,24082,208
22236,37,1301,2488,1081,12764,220
13308,26,515,2976,421,10445,94
6494,4,50,3375,42,1874,8
36408,27,632,1785,515,6691,117
5547,30,980,3418,746,18724,234
45628,70,592,399,482,6356,110
40990,23,659,1473,505,9600,154
41607,18,730,1386,555,9157,175
33791,2,172,1927,133,5353,39
38279,112,2185,1666,1678,16949,507
42851,3,140,1142,131,9177,9
12794,11,259,3016,203,2818,56
28941,12,495,2158,406,5848,89
39155,19,613,1607,460,7258,153
42685,0,0,1180,0,4074,0
27176,14,382,2260,316,2286,66
23404,248,15394,2431,11197,45840,4197
36537,55,723,1778,550,5992,173
17559,4,235,2726,207,5868,28
43235,148,3625,1032,2325,20219,1300
12486,78,2156,3033,1663,15529,493
16773,49,1932,2768,1426,15818,506
16141,99,2655,2800,2125,39594,530
9590,0,57,3182,49,1877,8
37385,519,16845,1726,13987,105164,2858
7262,76,2106,3338,1660,36817,446
14329,19,845,2898,696,4411,149
6048,6,212,3393,152,9435,60
34925,16,457,1877,342,6946,115
14265,648,23187,2904,16625,85210,6562
13720,144,7211,2944,5214,56562,1997
14413,32,3884,2892,2952,69953,932
25936,6,458,2316,367,9318,91
35388,9,143,1854,119,6514,24
40965,3,65,1475,55,8724,10
38484,11,379,1651,273,7664,106
27722,11,887,2227,749,4809,138
30870,77,3155,2059,2275,16507,880
14031,16,388,2919,300,6860,88
40383,4,68,1527,61,2104,7
30835,2,62,2060,51,2055,11
22011,3,193,2500,157,11064,36
38463,42,1106,1652,843,11757,263
5329,16,1738,3428,1330,27219,408
35392,2,103,1854,96,3110,7
1744,1,116,3549,94,5940,22
21457,10,468,2531,353,8833,115
19040,26,1055,2662,839,3898,216
33743,22,616,1929,488,4970,128
37129,2,103,1742,86,8603,17
24453,631,28616,2383,20240,139169,8376
28412,1,40,2187,34,1950,6
36074,22,342,1802,270,5597,72
33280,43,1511,1947,1209,8893,302
4418,31,687,3471,533,9598,154
15373,14,1312,2835,1081,3213,231
19757,170,9035,2627,7034,93717,2001
11574,7,606,3081,488,18422,118
38295,12,632,1664,496,11230,136
43083,11,348,1077,228,7984,120
6975,66,1671,3353,1369,17662,302
11909,64,2739,3065,2138,18996,601
16777,12,666,2767,498,13077,168
11139,19,1004,3103,796,33883,208
30246,3,92,2092,79,4800,13
6218,7,237,3388,165,7380,72
12941,22,728,3008,548,4462,180
44679,44,443,707,358,5516,85
45172,19,128,537,101,1977,27
3793,0,29,3493,23,3130,6
3818,33,807,3492,650,9577,157
4787,28,883,3457,676,7856,207
36139,361,9219,1798,7451,45400,1768
32001,25,952,2002,699,14888,253
34796,14,183,1885,149,4249,34
46152,0,13,181,10,517,3
17162,42,3402,2746,2554,46788,848
12090,173,11401,3056,8069,90502,3332
20734,0,35029,2576,23161,359296,11868
3862,114,2833,3491,2146,29872,687
45770,0,134,334,95,2347,39
19065,2,221,2661,199,10323,22
43611,0,15,911,12,1993,3
14784,309,19514,2866,13742,89577,5772
30151,36,1008,2098,760,16200,248
11526,32,1010,3082,780,13923,230
33812,9,172,1926,132,2918,40
20358,120,7219,2595,5356,39213,1863
13892,217,5710,2930,4470,33080,1240
17690,32,1113,2721,790,8730,323
23987,4,139,2403,102,1810,37
22748,10,413,2464,298,7355,115
36348,29,397,1787,324,5301,73
28554,45,1597,2178,1080,12035,517
32324,9,463,1986,344,7148,119
8318,4,441,3261,360,6588,81
7330,12,670,3333,497,8023,173
6944,230,12099,3355,8244,72414,3855
10419,15,0,3143,0,51185,0
41537,34,771,1398,589,9365,182
27690,104,4266,2229,3587,24000,679
46306,0,20,128,17,667,3
33078,4,315,1954,246,7446,69
4348,186,11248,3474,8922,54060,2326
22481,4,262,2476,206,5496,56
11253,4,103,3097,77,2617,26
13285,134,7350,2978,5123,42410,2227
35674,22,677,1832,548,9821,129
15750,1,70,2817,55,4193,15
12161,208,9981,3051,7278,115749,2703
38238,17,449,1668,371,7982,78
9453,22,800,3190,618,6485,182
32217,43,2512,1990,1878,22166,634
25621,22,680,2330,510,5188,170
14750,51,4145,2869,3148,26972,997
27711,119,5505,2227,4133,56611,1372
28457,3,169,2185,140,12183,29
15317,609,30417,2837,20479,92914,9938
46322,0,2,120,2,626,0
11106,5,49,3105,40,3164,9
37433,4,207,1723,163,5797,44
29085,3,70,2150,56,1514,14
2222,41,1007,3521,840,11384,167
24593,21,314,2375,250,12600,64
8311,114,4755,3261,3708,53156,1047
4565,239,18858,3466,12860,120053,5998
40478,6,102,1518,84,3770,18
22370,71,4423,2482,3319,35358,1104
41904,104,1016,1334,786,12123,230
9368,4,134,3195,108,4248,26
16813,10,312,2765,243,5811,69
2980,10,481,3508,391,18708,90
28242,19,376,2197,276,8399,100
10065,166,5089,3159,3644,57972,1445
22831,1,126,2459,100,3325,26
19903,9,153,2619,113,4147,40
2410,6,141,3518,116,10637,25
37163,9,402,1740,334,8245,68
46023,145,1752,235,1434,12405,318
26478,155,5076,2291,3806,42704,1270
22654,12,312,2468,251,9523,61
29095,9,296,2150,223,3723,73
31627,39,901,2021,696,5834,205
40945,107,3400,1476,2497,46226,903
17968,7,158,2708,125,3349,33
39717,7,165,1574,140,4409,25
39667,3,112,1577,84,10897,28
14708,2,201,2872,145,11303,56
3202,10,308,3504,216,11197,92
5443,37,1082,3423,881,14812,201
32128,131,3492,1995,2681,20937,811
25509,57,2803,2336,1989,30357,814
5790,26,1088,3406,826,7677,262
45898,25,200,293,163,4382,37
16992,4,205,2757,157,2245,48
3309,50,1279,3502,1015,12445,264
40962,19,286,1475,211,4525,75
33277,2,81,1947,57,2785,24
43238,61,1463,1031,1157,11574,306
21996,33,2360,2500,1784,18367,576
14200,693,41842,2909,27182,125368,14660
37181,1,33,1739,29,1058,4
2209,1,79,3521,68,5369,11
2965,14,503,3508,379,10020,124
38469,39,899,1652,714,9821,185
38081,95,2159,1680,1764,13168,395
24127,0,3385,2397,2368,41068,1017
34040,5,170,1919,137,3396,33
45357,82,1617,483,1084,15465,533
38744,19,717,1633,455,9342,262
42444,3,138,1230,95,5996,43
41169,262,5518,1452,3910,48641,1608
6150,204,16808,3390,10533,47548,6275
45732,3,60,348,33,1489,27
1509,2,46,3612,41,4525,5
7808,1457,99605,3304,65631,311416,33974
29899,21,1152,2109,888,9717,264
14608,17,732,2878,538,8942,194
32782,117,4099,1967,3123,31592,976
26266,0,3303,2301,2611,35757,692
11953,9,390,3063,307,4430,83
23271,12,557,2438,456,9824,101
41178,3,198,1451,120,5151,78
11907,32,1720,3065,1271,14973,449
3433,1,31,3500,24,3786,7
29963,60,1106,2107,866,11974,240
31532,7,144,2026,107,3495,37
19474,9,879,2641,692,11683,187
13563,21,1331,2955,998,9036,333
2807,33,1407,3511,1098,14899,309
20118,2,196,2608,153,4039,43
8962,311,16365,3221,12248,97292,4117
4228,21,933,3479,771,10599,162
42029,1,100,1315,69,6711,31
41651,62,763,1379,590,9901,173
11176,255,8991,3101,6541,114415,2450
23829,48,2776,2411,2110,17457,666
39713,9,173,1575,128,4062,45
39687,13,266,1576,215,4663,51
10534,13,935,3137,729,36972,206
26645,12,514,2284,435,6942,79
33020,4,135,1956,106,2820,29
8704,21,545,3236,440,10146,105
14881,42,2378,2860,1785,29838,593
40826,180,4524,1486,3306,47348,1218
27361,19,2209,2248,1709,49154,500
5656,32,834,3412,700,13434,134
40857,13,212,1483,169,5183,43
7928,3,98,3291,82,3835,16
40045,45,760,1552,602,6208,158
45686,12,49,372,39,1345,10
6925,42,2795,3356,2132,30417,663
24589,459,18425,2375,13405,58845,5020
40409,171,6391,1526,3295,26080,3096
13015,33,1992,3002,1274,18297,718
16914,22,1624,2761,1303,16987,321
7447,50,2186,3327,1496,17021,690
18571,270,10229,2682,7709,46959,2520
45795,4,40,329,37,1462,3
11771,165,6435,3070,4596,83493,1839
37903,87,2053,1691,1615,17395,438
42518,10,394,1214,287,12068,107
20383,79,3802,2594,2868,21362,934
34260,9,243,1912,195,3409,48
43318,16,481,1009,331,13501,150
17516,320,11624,2728,8438,47874,3186
16097,0,35,2801,28,2925,7
30951,23,438,2056,348,10541,90
17632,3,237,2722,180,10238,57
9111,62,915,3212,703,10359,212
43789,5,76,853,53,2923,23
39294,14,397,1598,319,10184,78
36045,81,2256,1805,1735,42579,521
9530,23,593,3186,493,5948,100
17615,9,825,2723,646,10840,179
12468,8,857,3034,689,7406,168
39413,415,14970,1591,10873,93018,4097
5318,28,535,3429,391,17231,144
30139,1,110,2098,91,2919,19
9421,26,808,3192,578,12107,230
45483,308,7257,451,5262,55726,1995
42664,27,204,1185,136,4212,68
42188,148,3780,1281,3204,39075,576
21322,0,382,2539,322,2473,60
43394,17,513,983,285,10077,228
28947,3,93,2158,70,2590,23
29908,57,1621,2109,1330,11960,291
33490,19,511,1938,399,4520,112
41217,12,197,1446,162,5363,35
6364,2,58,3381,44,1839,14
23927,214,9091,2406,6761,55084,2330
38792,198,21931,1630,15157,57776,6774
13247,1,61,2981,56,6672,5
26933,17,288,2270,231,4436,57
5263,22,2299,3432,1728,17746,571
2776,16,453,3512,389,11608,64
22387,3,134,2481,107,1887,27
8874,8,77,3226,54,2030,23
6951,5,203,3354,139,3630,64
17589,22,532,2724,409,3898,123
7795,5,133,3304,92,7039,41
4987,70,1642,3448,1182,8997,460
5617,6,115,3414,84,3310,31
39189,42,910,1605,688,10073,222
40842,2,62,1485,51,2427,11
17956,14,417,2709,346,8051,71
31522,2,219,2026,165,7066,54
16870,10,1060,2763,813,16031,247
41987,69,2802,1320,2243,14675,559
9138,2,143,3211,107,3472,36
25327,10,234,2344,177,7175,57
35307,5,93,1857,82,2253,11
17368,0,57,2734,29,3662,28
4988,103,4162,3448,3084,13979,1078
4861,14,585,3454,478,17041,107
22154,8,182,2492,142,3732,40
45319,22,348,492,221,4387,127
12170,15,1534,3051,1150,20013,384
7862,17,401,3298,323,8645,78
38735,146,5824,1634,4130,28730,1694
14451,1213,87218,2890,61272,228844,25946
26122,4,154,2308,129,6120,25
15675,313,23453,2821,16384,264139,7069
39361,21,380,1594,268,5415,112
3902,12,440,3490,346,16396,94
5952,41,821,3397,653,18603,168
12648,3,161,3024,134,7154,27
21149,19,2346,2548,1718,17396,628
6270,60,1472,3385,1180,24397,292
24569,10,465,2376,351,5391,114
13573,354,20588,2955,14513,153956,6075
24132,165,8078,2397,5924,62730,2154
18590,582,54076,2681,40360,331579,13716
19976,40,2351,2614,1865,20892,486
41348,166,3405,1424,2660,20594,745
8393,94,5003,3256,3768,59011,1235
34519,1,54,1901,44,3105,10
32171,0,0,1993,0,4917,0
42531,4,118,1213,89,3609,29
4327,1,72,3475,42,1701,30
7663,185,7488,3313,5129,41980,2359
23139,6,170,2444,142,8892,28
25904,113,8266,2317,6050,61481,2216
6950,18,692,3354,482,12853,210
7919,3,206,3292,170,2427,36
34173,21,1137,1915,736,8730,401
39144,36,651,1608,520,7184,131
9688,0,131,3177,109,5686,22
7458,10,79,3326,66,6245,13
27625,10,1003,2232,762,4007,241
8015,15,458,3284,187,5032,271
29152,19,1202,2147,930,18092,272
12540,1,26,3031,22,1179,4
22970,7,210,2452,161,4907,49
43380,5,184,987,125,2976,59
3837,2,144,3491,90,3334,54
28160,2,65,2202,48,2170,17
28458,16,402,2185,322,5389,80
12719,19,840,3020,641,6672,199
27462,14,622,2242,431,7915,191
27553,37,1426,2236,1031,13594,395
34535,2,132,1900,99,3027,33
9186,2,47,3207,39,1878,8
4931,3,32,3450,25,1440,7
4593,5,194,3465,136,8745,58
45362,3,129,482,59,3913,70
43065,114,3747,1082,2610,55326,1137
28387,8,290,2189,216,13732,74
24598,6,288,2374,256,5917,32
30758,7,285,2064,230,3354,55
3779,129,4599,3493,3615,70093,984
37801,11,198,1698,158,3939,40
28863,369,14824,2161,9770,101141,5054
45611,18,577,411,365,4345,212
6317,12,483,3383,389,18081,94
42812,58,1636,1149,1150,12335,486
45288,78,1504,501,1104,30278,400
42705,6,173,1177,113,6024,60
24821,8,375,2366,327,3193,48
1957,6,579133,3526,152509,13550,426624
13017,732,27033,3002,19219,180304,7814
46191,2,60,164,46,975,14
35042,16,501,1872,380,7819,121
8120,5,158,3274,119,1966,39
16306,51,1814,2792,1387,16281,427
5493,32,603,3421,483,11680,120
43430,18,316,973,276,8115,40
43637,18,238,903,186,6923,52
13674,0,496,2948,367,7757,129
3250,14,506,3503,420,3088,86
3421,31,1675,3500,1318,12835,357
40929,24,941,1478,679,9281,262
6316,49,1746,3383,1411,25988,335
36001,2,275,1808,216,9566,59
4964,12,151,3449,112,8358,39
46284,0,18,138,11,1488,7
40497,11,233,1516,185,5132,48
9951,14,1253,3165,928,17484,325
37072,21,911,1746,717,9689,194
20249,53,1367,2599,1065,11272,302
5398,25,794,3425,632,17881,162
26335,1,35,2298,29,1906,6
23166,19,1173,2443,932,11356,241
33464,1,69,1939,61,4717,8
31032,1,32,2052,28,3161,4
42112,5,93,1300,72,5468,21
30671,1,35,2068,26,5716,9
30848,87,2396,2060,1863,22586,533
45468,2,88,455,41,1906,47
36489,9,629,1781,540,6352,89
4310,22,1643,3475,1169,18620,474
20556,20,650,2585,518,10720,132
45406,0,17,469,13,1225,4
41594,37,509,1389,412,19869,97
1916,11,471,3527,372,6878,99
2010,1,23,3524,19,1917,4
20141,56,2124,2606,1647,27839,477
4014,6,48,3486,41,4141,7
19617,6,247,2635,176,4938,71
16293,15,1220,2793,963,22000,257
45273,19,250,505,197,6515,53
38218,6,508,1670,408,4419,100
38315,15,521,1663,417,7446,104
43739,9,103,870,81,4425,22
34342,1,24,1909,19,4549,5
14403,1,111,2893,82,4207,29
29474,3,149,2130,122,3130,27
39208,69,3511,1604,2702,19043,809
12463,3,186,3034,141,4005,45
14250,63,1821,2906,1382,18457,439
19367,19,386,2647,278,3876,108
28501,24,859,2182,677,12622,182
12718,517,36605,3020,22789,294710,13816
37779,8,214,1700,171,3551,43
36471,0,295,1782,232,5782,63
29132,6,535,2148,378,6569,157
28589,17,399,2176,299,4090,100
30109,4,272,2100,207,6028,65
14297,3,148,2901,95,3369,53
11683,5,350,3075,250,24099,100
5673,47,2988,3411,2375,35554,613
42899,9,608,1130,420,9825,188
5868,59,1568,3401,1239,17336,329
43777,38,838,857,658,13324,180
38770,0,32,1631,30,2930,2
27161,10,331,2261,288,9037,43
39998,0,63,1556,49,4690,14
24214,1,89,2393,79,5398,10
5800,18,1541,3405,1096,17910,445
28433,7,95,2186,78,3211,17
19278,23,825,2651,658,31265,167
35897,124,7179,1816,5545,87992,1634
42109,7,192,1300,136,4957,56
17573,179,10968,2725,7430,72120,3538
21493,19,1653,2530,1361,12667,292
22268,132,7049,2486,5357,41717,1692
19627,155,6535,2635,5175,53908,1360
17887,7,380,2713,312,6291,68
44701,29,349,701,250,5012,99
5108,32,3135,3441,1533,22102,1602
28730,410,19443,2168,13309,106293,6134
3974,67,1627,3487,1258,10759,369
13177,14,502,2984,414,5316,88
14934,6,334,2858,265,4376,69
41775,11,180,1358,137,4992,43
21568,0,37116,2525,27718,167272,9398
35475,9,1007,1848,734,11086,273
34230,149,6210,1914,4507,44671,1703
18693,111,15214,2676,10864,89139,4350
21820,15,285,2511,242,8440,43
5472,17,647,3422,503,19230,144
35666,16,353,1833,282,4556,71
38184,5,237,1673,189,9078,48
37022,7,240,1749,200,10027,40
26911,23,1195,2271,955,18162,240
20964,14,663,2560,498,11076,165
8184,167,5031,3270,3885,38561,1146
29115,1,79,2149,64,2923,15
34771,2,70,1887,54,2769,16
7246,10,234,3339,193,7477,41
17170,2,210,2745,163,6973,47
41915,90,4012,1332,2790,34548,1222
6443,4,121,3378,97,3628,24
11366,214,16254,3092,12003,56534,4251
7301,12,166,3335,126,5231,40
25962,12,472,2315,367,6952,105
29536,0,51,2127,47,2936,4
37828,14,432,1696,342,6649,90
36502,11,160,1780,128,3255,32
17464,206,7012,2730,5012,49504,2000
29931,505,14554,2108,10336,69942,4218
36370,1255,29281,1786,20850,135171,8431
42238,14,232,1270,172,8482,60
15574,5,217,2825,176,5273,41
10299,197,15266,3149,11130,144797,4136
8341,13,155,3259,119,3324,36
6670,40,1486,3368,798,15253,688
27892,3,205,2217,155,5745,50
44810,106,2378,664,1790,25023,588
40927,4,225,1478,164,6315,61
27954,301,15580,2213,12028,99757,3552
37223,14,452,1736,386,12037,66
44941,24,154,626,141,6319,13
36364,127,5952,1786,3948,55526,2004
28034,2,75,2209,58,3334,17
40625,5,98,1505,82,2562,16
45976,1,43,254,30,2255,13
10226,8,326,3152,244,4413,82
40731,328,5442,1497,4476,39172,966
5172,118,2773,3437,2159,22509,614
2854,20,1527,3511,1206,23102,321
45695,8,171,368,129,3241,42
22734,38,2299,2464,1850,23203,449
28232,8,175,2197,129,11388,46
46203,3,51,160,35,789,16
23982,0,22,2404,15,2584,7
44976,48,408,616,305,4290,103
4860,7,163,3454,137,4008,26
5648,24,669,3412,525,15432,144
27602,50,1347,2234,1082,23475,265
35946,4,111,1812,96,5457,15
37561,10,467,1715,384,7329,83
19067,66,2523,2661,1907,14268,616
20687,9,189,2578,146,5551,43
28510,29,638,2181,532,11775,106
20361,5,80,2595,70,2153,10
43182,107,1983,1049,1325,14470,658
46281,11,88,139,75,1589,13
20606,37,1976,2582,1480,12817,496
15764,2,109,2817,63,3401,46
38643,18,707,1639,539,7158,168
11371,13,551,3092,406,15712,145
21721,315,15791,2516,11660,66994,4131
19662,28,880,2633,657,21323,223
13279,20,1071,2979,839,10422,232
5797,27,733,3405,568,9651,165
3477,139,9062,3499,6958,28986,2104
6611,625,30543,3370,19599,124774,10944
4698,5,197,3461,144,2838,53
16043,7,264,2805,223,4312,41
29508,91,3605,2128,2994,25755,611
14294,14,1044,2902,759,33879,285
28629,5,729,2173,568,12246,161
4721,135,5716,3460,3998,121564,1718
3751,8,448,3493,362,6851,86
43102,17,498,1071,312,6213,186
17846,8,178,2715,143,3707,35
12413,3,68,3037,59,2518,9
39997,22,688,1556,522,12623,166
35211,31,830,1863,654,12897,176
42617,2,23,1196,19,2326,4
39837,8,148,1568,104,5336,44
18671,0,133,2677,96,3238,37
15229,0,35,2841,29,2849,6
41614,17,621,1386,446,12717,175
29169,2,125,2147,100,2283,25
9455,35,771,3190,600,5934,171
3472,4,34,3499,27,2900,7
3610,10,247,3496,186,4633,61
42576,27,348,1205,213,3787,135
3868,340,20460,3490,15027,95377,5433
10068,72,4118,3159,3158,49548,960
35903,2,33,1815,29,4380,4
5095,152,8420,3441,6424,32264,1996
45096,505,13072,567,10814,40306,2258
23539,2,47,2425,38,6323,9
20589,3,371,2583,317,6559,54
11442,29,1655,3088,1358,21951,297
14834,745,55232,2863,37629,222832,17603
33521,24,894,1937,689,5113,205
3533,9,206,3498,167,6174,39
29563,1,63,2126,49,3876,14
34994,1,319,1874,252,8729,67
8790,25,1272,3230,1088,28982,184
41066,5,392,1465,284,15359,108
13255,62,2395,2980,1773,27003,622
28876,33,2877,2161,2388,31005,489
32292,14,409,1988,333,13478,76
23145,6,287,2444,229,10949,58
11974,36,1601,3061,1057,15269,544
9037,187,12416,3217,8057,85932,4359
15910,30,3349,2812,2536,22985,813
26409,20,453,2294,346,4115,107
27125,323,5833,2263,4038,36029,1795
22834,225,5746,2459,4400,29875,1346
26704,388,113046,2281,78233,218031,34813
16387,223,23200,2787,15598,62477,7602
17115,0,25,2749,19,2078,6
33569,16,439,1936,339,6730,100
27876,0,0,2218,0,1835,0
5679,8,190,3411,147,4857,43
13066,39,1182,2999,943,7164,239
15605,18,999,2823,747,7753,252
24603,5,102,2374,83,3982,19
9816,6,226,3171,166,8062,60
33250,8,119,1948,103,3797,16
18006,10,607,2706,482,6047,125
25499,6,286,2336,244,3960,42
7927,24,585,3291,443,8985,142
24304,20,437,2389,306,2845,131
26233,24,891,2303,659,6326,232
18035,12,554,2704,438,6833,116
46013,1,79,237,65,2530,14
24619,11,376,2373,285,4865,91
11880,401,20488,3066,15116,210101,5372
27558,89,1681,2236,1284,11054,397
33211,11,413,1949,328,6915,85
32923,0,0,1960,0,18395,0
39629,1,64,1579,56,12382,8
24283,14,342,2390,272,4802,70
3804,38,872,3492,673,11988,199
3617,10,290,3496,226,5854,64
32179,4,33,1992,30,3806,3
18422,1,129,2688,101,3605,28
5447,8,273,3422,200,4316,73
15650,2,41,2822,35,2304,6
31444,5,287,2031,197,13880,90
41080,191,6075,1462,4511,42405,1564
9814,2,103,3171,75,2432,28
7897,18,588,3295,466,4873,122
41327,26,725,1427,537,13725,188
3367,204,9723,3501,6822,64591,2901
36486,67,1499,1781,1043,9346,456
39612,3,62,1580,49,5152,13
3493,0,41,3499,22,2870,19
36115,6,469,1799,370,5088,99
46277,9,146,141,118,2846,28
25750,1,140,2324,104,2756,36
39359,20,396,1594,300,4145,96
38200,179,4777,1672,3455,42413,1322
41688,189,2990,1374,2115,39496,875
4351,70,3068,3474,2323,45353,745
38346,5,105,1660,91,4209,14
1590,14,215,3586,174,7826,41
17340,10,501,2736,389,15120,112
3819,12,565,3492,423,9785,142
28882,17,399,2161,339,3440,60
23039,11,396,2450,311,4139,85
35508,15,202,1845,167,2956,35
38323,5,215,1662,172,4812,43
26001,38,4163,2313,2904,40854,1259
43502,9,110,952,87,2431,23
29992,4,114,2105,91,3229,23
36020,21,396,1807,328,6323,68
34375,3,452,1907,349,15715,103
37966,3,127,1686,95,3813,32
35609,5,865,1838,642,8275,223
43153,9,211,1056,145,2456,66
12696,5,192,3022,162,4583,30
3575,236,12099,3497,9080,79868,3019
33138,2,34,1951,29,2322,5
12132,42,1572,3053,1264,12057,308
29267,6,381,2141,281,4315,100
7873,4,77,3297,59,4651,18
20100,9,424,2608,336,5239,88
34672,0,42,1892,33,2654,9
41109,59,1021,1459,753,9991,268
37912,6,86,1690,71,5954,15
34640,1,64,1893,51,5101,13
29430,8,136,2132,112,5672,24
3173,1,159,3505,125,4461,34
36036,0,28,1806,25,2106,3
3427,68,2747,3500,2104,38267,643
1993,25,657,3525,553,36309,104
35246,242,7807,1860,5588,84177,2219
10811,829,40638,3120,27715,103149,12923
23130,14,1477,2445,1035,4878,442
18793,0,362,2672,281,9744,81
44978,228,2391,615,1933,31982,458
5361,26,717,3427,543,11900,174
30834,6,231,2060,193,4473,38
38492,6,213,1651,175,8170,38
45501,6,192,447,104,3246,88
39047,43,1018,1614,827,13689,191
10438,18,763,3142,651,9064,112
25786,16,509,2322,409,4045,100
41896,0,101,1335,81,2811,20
40441,82,2650,1522,1880,22216,770
22715,117,3383,2465,2499,27046,884
17930,13,505,2711,422,8054,83
26264,2,451,2301,314,4736,137
9727,132,5557,3176,4185,39238,1372
29186,15,582,2146,491,6659,91
27177,0,49,2260,41,961,8
17359,11,1373,2735,1026,50802,347
15392,79,3782,2834,2794,11694,988
33658,4,64,1932,56,3446,8
3211,17,547,3504,439,18473,108
40555,327,6338,1511,4512,21658,1826
41921,3,147,1332,132,18319,15
14713,25,703,2871,548,9950,155
3204,20,804,3504,577,5497,227
7747,3,297,3308,229,13763,68
34123,2,42,1916,33,2221,9
20952,57,2139,2561,1559,75003,580
28497,18,427,2182,284,5268,143
33647,3,93,1933,76,2982,17
23000,27,1048,2451,819,16454,229
7284,54,2511,3336,1717,11172,794
41656,27,959,1379,685,20071,274
26011,30,1007,2312,758,16099,249
7568,140,5413,3319,4145,53640,1268
10673,14,541,3128,432,3699,109
43207,16,255,1043,186,4759,69
12871,7,493,3011,407,10390,86
21062,92,5379,2555,3519,31402,1860
19077,1,167,2661,133,6100,34
44732,71,1115,689,968,10704,147
31964,9,747,2004,573,10833,174
28349,7,344,2191,227,3087,117
33075,209,11122,1954,8532,61978,2590
9188,9,635,3207,521,11634,114
10442,3,155,3142,121,6370,34
9021,0,32,3218,28,2014,4
2440,6,100,3517,83,4256,17
2538,15,493,3516,394,7724,99
17382,370,15288,2734,11392,96448,3896
14390,57,2001,2893,1631,19192,370
23021,9,725,2450,515,8912,210
30092,8,310,2101,253,8748,57
40038,1,29,1553,23,2673,6
25003,0,2307,2358,1823,27656,484
40632,0,125,1505,81,2235,44
35387,76,806,1854,653,7374,153
19790,0,0,2625,0,1451,0
45913,2,79,285,54,1056,25
17647,13,418,2722,318,11951,100
17694,7,3273,2721,2558,54608,715
17351,0,65,2736,55,4066,10
8677,294,13492,3237,9914,78710,3578
26192,42,681,2304,549,8289,132
9963,20,1101,3164,861,11900,240
18207,315,15014,2697,9756,113504,5258
37304,18,207,1731,148,9204,59
10828,20,1764,3120,1373,24197,391
7131,19,240,3344,160,5591,80
21043,13,328,2555,266,3800,62
44128,57,483,800,339,3505,144
39169,5,141,1607,114,3943,27
25628,2,120,2329,105,2469,15
28091,14,675,2206,533,9287,142
45078,7,93,578,68,2838,25
15964,7,341,2809,222,6675,119
2165,17,230,3522,176,8690,54
3659,13,177,3495,126,4663,51
29585,29,2206,2125,1668,23626,538
16273,28,1887,2794,1461,53484,426
31458,8,421,2030,335,5655,86
16506,14,1264,2782,982,13885,282
2330,487,15904,3519,10977,231177,4927
36683,2,48,1770,41,5293,7
16195,2,128,2798,105,2910,23
17330,542,21536,2737,16936,57058,4600
20517,90,7075,2587,4113,33613,2962
16967,41,1663,2758,1331,11970,332
35322,72,853,1857,646,6834,207
2576,8,239,3515,186,9282,53
10014,31,1895,3162,1519,33778,376
21885,5,252,2507,215,2965,37
40566,95,2025,1510,1535,11682,490
20326,2,197,2597,154,3707,43
29632,24,983,2122,798,10434,185
45573,15,188,420,157,2705,31
17294,6,346,2739,263,2486,83
16226,39,1074,2796,848,8533,226
29015,17,535,2154,474,11234,61
1114,14,572,3799,460,7951,112
42178,102,2685,1284,1970,45536,715
20184,200,11633,2603,8331,59841,3302
18399,9,879,2689,735,4939,144
17492,189,9709,2729,7001,57958,2708
37160,7,216,1740,181,5649,35
14596,276,14338,2879,10174,31925,4164
9592,11,316,3181,234,4764,82
33114,153,7626,1952,5505,61709,2121
40166,55,1512,1546,1133,19250,379
5860,11,189,3401,160,5266,29
8467,5,94,3251,66,2481,28
41905,19,369,1334,316,8493,53
41633,4,279,1383,200,7852,79
15827,0,221,2814,185,4927,36
41767,7,187,1359,154,4542,33
12880,15,776,3011,650,7712,126
15950,2,249,2810,186,3774,63
22300,2,125,2485,82,3134,43
2438,25,835,3517,556,9397,279
3447,19,522,3500,365,22827,157
42706,3,145,1177,103,4992,42
19957,5,149,2616,126,4501,23
37931,8,533,1689,407,6935,126
6655,5,53,3369,42,2618,11
8389,19,970,3256,694,16318,276
7856,3,85,3299,60,3627,25
42123,71,576,1297,420,6390,156
21240,3,199,2542,156,3459,43
32627,666,34709,1973,25751,181775,8958
20906,5,262,2563,199,6034,63
27752,91,3907,2225,2917,12778,990
24861,38,1324,2364,1096,15465,228
34944,5,383,1877,301,7533,82
22973,4,363,2452,254,8702,109
19270,14,1180,2652,644,5919,536
32032,2,101,2001,75,5958,26
3641,54,1276,3496,983,18471,293
27665,36,1608,2230,1232,10348,376
37370,11,177,1727,142,4993,35
9234,45,1616,3205,1373,14023,243
38407,12,347,1657,276,7764,71
18523,1,148,2684,138,2977,10
32654,39,508,1972,377,4862,131
37126,7,170,1742,133,6073,37
31146,11,237,2047,197,10528,40
15158,6,55,2845,48,5173,7
2134,44,1050,3522,793,27819,257
23958,6,103,2405,88,2367,15
22729,8,1345,2465,965,13789,380
13081,52,2065,2998,1626,35740,439
35850,18,427,1819,319,4130,108
27064,157,12821,2266,8822,47822,3999
36328,50,1526,1788,1185,12578,341
23874,11,376,2409,270,7944,106
44677,296,4055,709,3108,20449,947
32945,191,7509,1960,5738,59040,1771
45866,14,111,306,88,3686,23
22704,0,82,2466,64,1556,18
43063,25,526,1083,365,6624,161
24983,1,101,2358,81,3281,20
8091,4,101,3275,79,2835,22
31296,26,562,2039,479,17102,83
45524,61,549,439,454,7956,95
41951,0,0,1326,0,5386,0
14935,20,692,2858,552,14885,140
33087,41,718,1953,584,12311,134
16518,91,2999,2782,2279,28740,720
44289,7,107,776,93,3449,14
15127,2,93,2847,71,3329,22
39948,74,2303,1559,1740,23133,563
26114,41,1872,2308,1504,12209,368
45388,59,706,474,602,7011,104
5334,29,923,3428,766,8804,157
38911,23,395,1623,311,4298,84
32296,16,473,1987,356,23090,117
16441,228,8800,2785,5874,36951,2926
42373,1,45,1246,28,4713,17
45505,70,1070,446,771,8584,299
19589,2034,161793,2636,119735,475671,42058
25669,30,681,2327,515,13136,166
12213,15,603,3049,430,6946,173
10398,20,467,3144,367,10594,100
43685,64,531,886,485,16205,46
15247,27,2622,2840,1962,44710,660
39201,20,715,1604,584,14135,131
40889,13,442,1481,337,4233,105
29954,7,253,2107,207,11532,46
42151,34,560,1290,430,5979,130
12704,2,308,3021,228,7948,80
23246,17,559,2439,453,9233,106
39567,11,651,1583,490,14517,161
7346,6,327,3332,189,3158,138
44009,37,258,820,205,4474,53
43926,4,72,832,65,3166,7
22380,11,1151,2482,901,7945,250
39211,118,2978,1604,2195,28362,783
37693,8,269,1707,179,10259,90
42823,4,136,1148,96,7426,40
34932,6,246,1877,204,3750,42
17171,3,289,2745,222,3704,67
7935,25,1323,3291,990,15681,333
22143,36,1412,2493,1177,12822,235
8597,0,39,3243,37,2913,2
6703,4,120,3367,103,4382,17
36643,20,641,1771,512,7576,129
40914,37,1344,1479,1005,9510,339
11843,31,1123,3068,693,12526,430
42534,2,91,1212,66,5134,25
30364,49,2083,2085,1612,16272,471
31730,0,187,2016,149,5627,38
39247,7,315,1600,233,6351,82
42098,37,461,1301,357,7118,104
41648,0,26,1380,20,2422,6
14335,11,254,2898,189,4188,65
11563,2,74,3081,58,1581,16
6321,85,6661,3383,4642,56053,2019
6816,17,892,3361,631,17717,261
18635,22,566,2679,434,6561,132
5902,1205,60758,3399,36097,318120,24661
15536,7,723,2828,556,12782,167
18768,38,2634,2673,2190,12103,444
20211,4,303,2602,233,6074,70
46198,11,283,162,170,1975,113
43689,36,243,884,211,3732,32
16536,12,912,2781,698,9551,214
18757,28,3120,2673,2197,19958,923
38540,111,2638,1646,1944,15744,694
17746,1,72,2718,54,1419,18
12607,0,128,3027,92,6737,36
37388,0,52,1726,38,3657,14
38623,22,628,1640,505,12876,123
43458,8,147,967,127,6109,20
5004,0,142,3447,103,2547,39
21532,17,1009,2527,822,5590,187
11598,1615,66098,3080,42392,406617,23706
7008,12,295,3351,230,11300,65
45113,11,105,557,89,4227,16
9324,186,7769,3199,5652,52281,2117
16202,154,13662,2798,9720,60928,3942
3067,5,101,3507,88,5227,13
28728,1,14,2169,12,883,2
33609,1,23,1934,20,2361,3
46353,0,103,110,57,2369,46
36925,13,344,1755,285,6943,59
41121,25,936,1457,694,15815,242
38424,14,656,1655,481,15200,175
32137,22,1193,1995,825,8062,368
6685,1,84,3367,76,1867,8
9457,9,109797,3190,38148,16564,71649
40643,14,418,1504,308,6337,110
9204,8,147,3206,103,3214,44
20289,3,362,2597,290,6417,72
18849,3,251,2669,193,5453,58
35707,5,321,1829,267,10568,54
38958,25,695,1619,509,5143,186
28200,17,1324,2199,971,7904,353
32912,3,62,1961,56,1852,6
42270,2,81,1265,62,3788,19
16900,941,60318,2762,36778,229210,23540
42505,19,296,1217,225,5445,71
3527,2,101,3498,88,3517,13
25577,0,67,2333,61,16398,6
42456,283,6847,1227,5017,41515,1830
28669,4,204,2172,183,6983,21
28249,51,3221,2196,2474,36528,747
40473,138,4328,1519,3239,22189,1089
30994,14,338,2055,283,3927,55
25506,0,67,2336,60,1815,7
37260,6,162,1734,124,2829,38
46092,1,23,206,19,696,4
38227,1,98,1669,87,3349,11
45955,20,441,262,281,6089,160
12442,48,1432,3035,1257,10925,175
10330,92,3027,3147,2362,22083,665
5707,2,56,3409,41,1649,15
7331,8,63,3333,55,5302,8
34150,12,375,1916,285,6420,90
45811,2,64,323,50,1341,14
26731,8,348,2280,290,4699,58
41360,1,24,1422,19,1568,5
13843,6,340,2935,247,6634,93
2723,48,2829,3513,2015,37190,814
10168,2167,159294,3155,96684,1179278,62610
40036,222,6697,1553,4734,44770,1963
15797,11,806,2815,579,5975,227
36079,14,973,1802,776,20175,197
28903,58,3963,2160,3029,14131,934
7286,40,2484,3336,1565,15544,919
22599,5,243,2470,203,3698,40
29853,118,3112,2112,2297,45180,815
26175,39,719,2306,542,5428,177
21221,9,567,2543,447,5661,120
25762,7,413,2324,281,7133,132
26003,4,194,2313,137,2637,57
2203,271,11003,3521,8227,70224,2776
46314,0,28,121,16,1100,12
43541,13,328,939,252,6703,76
20318,5,329,2597,272,9088,57
19049,6,380,2662,299,3384,81
37541,17,289,1716,225,5859,64
11497,43,2171,3084,1722,19420,449
17687,53,1434,2721,1135,20915,299
3422,29,1953,3500,1468,25542,485
27874,0,115,2218,100,3791,15
20717,47,1704,2576,1271,10419,433
11239,22,981,3097,735,15240,246
43761,3,80,864,74,3442,6
19246,142,8934,2653,6782,73051,2152
13209,2,124,2983,77,3448,47
4419,56,1605,3471,1310,12517,295
18578,3,122,2682,99,6571,23
44717,9,180,693,134,2356,46
42954,14,219,1115,150,4085,69
3916,19,107,3489,101,14246,6
33734,23,999,1929,799,11930,200
27342,5,140,2250,117,5778,23
2143,154,4675,3522,3705,37998,970
11095,6,246,3105,169,7502,77
21215,1,56,2544,45,4303,11
36540,2,26,1778,23,2109,3
14437,38,2010,2891,1572,25061,438
22421,20,811,2480,630,15518,181
7664,5,224,3313,184,3225,40
39726,5,140,1574,117,3521,23
3994,110,2506,3486,1725,17396,781
20242,0,49,2599,35,2389,14
7306,16,271,3335,227,6189,44
20241,38,1192,2599,876,17547,316
10079,248,11787,3158,9173,38558,2614
34890,142,2532,1879,2005,17958,527
44809,8,65,665,53,1992,12
18713,4,209,2675,113,1695,96
30740,6,138,2064,119,5130,19
36021,3,42,1807,30,3165,12
31280,42,1819,2040,1390,12267,429
20000,90,2924,2613,2265,25037,659
41409,48,1502,1415,1086,14439,416
3912,55,2014,3489,1410,33392,604
40020,7,234,1554,174,6480,60
20455,21,780,2590,595,6511,185
3120,2,65,3506,54,3191,11
26293,13,226,2300,182,4158,44
41427,5,268,1412,201,4339,67
19188,74,4769,2656,3684,50025,1085
2793,10,316,3512,230,11167,86
15644,1,123,2822,100,10003,23
21084,2,180,2553,148,4507,32
2180,21,459,3522,358,11537,101
38377,87,2945,1658,2114,24083,831
33159,0,60,1950,47,1989,13
42069,173,3324,1307,2532,29190,792
18245,8,318,2695,242,4928,76
25845,33,1025,2320,837,9505,188
12305,8,252,3044,175,8241,77
43773,101,1558,859,1343,23788,215
39809,3,109,1569,69,7700,40
6101,11,369,3391,274,5707,95
14068,10,712,2916,489,5649,223
7710,4,137,3311,105,1695,32
33189,29,567,1950,472,4635,95
8526,49,1220,3247,972,23656,248
17954,8,423,2709,362,4746,61
27077,8,1169,2266,940,11643,229
3748,7,187,3493,147,7653,40
29930,7,891,2108,676,7834,215
38714,2,82,1635,64,5172,18
28819,16,569,2163,438,8262,131
27237,38,1353,2256,1066,17069,287
20760,3,197,2574,159,7392,38
37015,22,635,1749,525,15407,110
44660,486,7209,714,5508,31102,1701
17074,38,1867,2751,1310,15602,557
26323,6,176,2299,139,4124,37
27186,12,328,2259,233,11583,95
31452,27,728,2031,563,9364,165
12791,40,1522,3016,1166,24632,356
23888,8,343,2409,275,5579,68
33773,6,148,1928,123,8015,25
6466,9,170,3377,137,3557,33
2407,7,289,3518,202,12431,87
19796,670,32109,2625,21984,234272,10125
12755,26,575,3019,448,11428,127
37566,1,46,1714,38,2277,8
39810,3,100,1569,73,4669,27
20428,9,638,2591,450,9213,188
43911,20,688,836,472,8499,216
9633,4,66,3179,59,5598,7
41446,9,158,1409,128,6514,30
42678,27,410,1182,266,4608,144
30449,1,45,2080,37,2478,8
36963,319,9571,1752,6771,85826,2800
16284,22,755,2793,590,33464,165
32255,5,131,1989,103,2851,28
9071,45,1379,3215,1080,13704,299
30535,1,195,2075,161,5641,34
4150,15,501,3481,403,10546,98
43513,9,214,950,155,4089,59
34721,62,725,1890,544,7071,181
17920,0,149,2711,114,6532,35
38302,1,64,1664,52,4503,12
23645,34,1671,2419,1302,20066,369
23573,558,18222,2423,14659,58655,3563
41548,6,411,1396,293,7776,118
38062,22,401,1681,329,6356,72
16345,5,151,2790,133,9838,18
25966,8,1715,2314,1201,24670,514
3830,173,8668,3492,6840,44329,1828
41528,93,1656,1399,1102,11697,554
12074,129,4666,3057,3419,23809,1247
13710,45,2207,2945,1703,35187,504
40343,346,5159,1532,4040,29644,1119
33406,97,4662,1942,3663,33693,999
20881,42,1156,2566,856,7531,300
18232,1,53,2696,43,3787,10
12422,76,2833,3036,2223,25508,610
39623,27,668,1580,489,5657,179
26217,68,2672,2303,2067,15303,605
25145,33,3114,2351,2257,22466,857
3254,17,438,3503,376,2805,62
22719,39,1976,2465,1497,33071,479
34144,4,706,1916,475,17565,231
23057,73,1249,2448,1005,6644,244
35077,5,107,1870,91,2273,16
21650,6,705,2520,543,8246,162
5812,18,283,3404,247,3203,36
19626,36,1060,2635,741,6876,319
21271,2,64,2541,54,1258,10
40930,35,4335,1478,3387,23052,948
28239,9,400,2197,327,9428,73
32889,2,107,1962,86,4160,21
34249,1,106,1913,87,3131,19
34404,5,235,1906,199,5535,36
35629,5,219,1836,129,4293,90
26896,38,604,2272,479,7122,125
38358,5,112,1659,89,3374,23
5522,76,4905,3419,3539,45076,1366
45890,49,404,294,344,5114,60
16623,8,749,2777,593,8206,156
38414,41,953,1656,665,6102,288
18484,2,139,2685,119,4829,20
22711,1,85,2465,68,2724,17
37584,0,136,1713,114,4878,22
21377,7,418,2536,355,2632,63
10314,13,527,3148,433,17812,94
24982,6,271,2358,203,11881,68
14400,6,106,2893,79,6939,27
15613,6,352,2823,248,10263,104
21971,33,5383,2502,4012,11641,1371
40174,23,598,1545,433,9077,165
28797,9,221,2165,174,1989,47
28697,4,131,2170,69,2858,62
7139,6,104,3343,86,3824,18
34073,6,127,1918,95,3565,32
30022,0,65,2104,56,2547,9
45753,2,103,342,56,2641,47
3848,14,1046,3491,863,9650,183
19895,26,1220,2619,946,21094,274
34178,6,164,1915,117,3746,47
5106,15,528,3441,414,15865,114
32169,22,538,1993,435,13015,103
9715,6,803,3177,669,12877,134
39801,286,19048,1570,13796,89630,5252
46219,1,18,133,14,978,4
44542,492,9240,735,7132,80290,2108
10847,11,830,3119,657,12245,173
7691,14,777,3311,648,11932,129
43877,18,281,843,215,7450,66
5411,34,1568,3424,1196,32811,372
13050,153,37839,3000,26520,72542,11319
30447,8,305,2080,265,2573,40
22226,442,20548,2488,13403,125210,7145
9578,1,25,3183,19,993,6
38724,5,125,1634,99,7396,26
20633,77,1441,2581,1041,11805,400
12892,39,1673,3011,1244,26844,429
20385,3,147,2594,131,2954,16
19628,4093,264094,2635,189417,756928,74677
29686,0,91,2120,78,4370,13
12284,107,6887,3045,4855,56274,2032
991,9,228,3839,192,7313,36
24201,8,155,2394,137,5182,18
1676,0,26,3566,23,1650,3
27546,36,1492,2237,1127,9459,365
15305,16,512,2837,368,5972,144
25881,15,677,2319,567,7756,110
5519,21,1226,3419,831,10639,395
4949,158,8077,3449,6032,67353,2045
41937,20,303,1329,243,8162,60
45706,7,93,361,66,4194,27
41919,1,91,1332,80,4681,11
31584,8,501,2023,391,5606,110
40209,78,1259,1543,938,17414,321
7594,20,652,3318,524,16880,128
45056,231,1994,588,1633,11772,361
29379,1,62,2135,54,4523,8
42732,22,594,1171,452,12384,142
27397,19,661,2246,548,17856,113
45141,71,1186,545,878,6654,308
11427,94,4191,3089,2982,22010,1209
27340,0,10,2250,10,1756,0
27835,0,63,2220,43,4522,20
5152,319,13223,3438,8346,77212,4877
34079,188,7238,1918,5551,40276,1687
41425,22,1036,1412,746,7776,290
41021,0,23,1471,20,1527,3
2781,97,2990,3512,2312,31053,678
11885,98,5202,3066,4018,54435,1184
9248,4,48,3204,35,2278,13
9310,158,9823,3200,7731,53007,2092
41632,22,807,1383,542,18435,265
27157,1,54,2261,44,2403,10
29631,1,156,2122,109,2211,47
12938,12,913,3008,765,8347,148
45380,172,4713,478,3725,24784,988
41165,55,1394,1453,1057,12226,337
10762,190,10107,3123,7427,74521,2680
1878,25,606,3528,518,8638,88
11717,42,3329,3073,2452,42171,877
34794,0,145,1885,113,5077,32
3805,119,6728,3492,5405,46701,1323
31546,14,220,2025,169,3956,51
9784,9,244,3173,200,8055,44
6369,69,3414,3380,2428,31193,986
31556,60,2195,2025,1769,23413,426
5536,15,176,3418,131,7462,45
18575,12,321,2682,244,4644,77
3503,8,362,3499,290,7972,72
18954,8,450,2666,376,4496,74
16231,24,1392,2796,1099,22834,293
30076,48,2555,2101,1991,22079,564
33674,169,7957,1932,5936,64136,2021
16528,21,3126,2781,2296,25278,830
15801,26,1374,2815,996,14853,378
18814,5,228,2671,178,10165,50
24669,7,543,2371,405,18405,138
32019,8,130,2001,110,4839,20
34744,263,4801,1888,3639,22910,1162
13830,14,1011,2936,773,18476,238
20709,0,82,2577,74,2532,8
15354,11,417,2836,344,9948,73
10413,22,545,3143,401,11828,144
14510,32,2616,2885,1691,21481,925
37091,4,71,1744,56,3032,15
38807,0,625,1629,495,14449,130
6994,44,1333,3352,1043,17561,290
20198,4,103,2603,67,8402,36
16463,13,571,2784,475,8004,96
20007,14,700,2613,539,7080,161
7329,15,835,3333,376,8872,459
29148,10,253,2147,200,4434,53
7586,15,563,3318,408,3603,155
40051,26,914,1552,653,8742,261
29719,50,724,2118,555,10012,169
9410,7,145,3193,122,6936,23
39715,23,403,1574,314,5885,89
14342,175,5175,2897,3700,29871,1475
2817,1,137,3511,71,5305,66
1917,7,230,3527,191,11167,39
42501,46,1342,1218,968,27614,374
12629,8,405,3025,354,18962,51
2840,8,558,3511,452,17969,106
34536,71,1591,1900,1283,9350,308
31069,0,104,2051,80,4551,24
29712,7,137,2119,114,6411,23
12391,5,90,3039,77,3972,13
19401,16,370,2645,249,7786,121
3305,5,141,3502,118,4731,23
4018,2,176,3486,138,4845,38
41223,80,3094,1444,1496,33059,1598
39694,10,302,1576,228,5320,74
17858,51,2100,2714,1659,7971,441
26213,0,692,2303,549,18081,143
1268,3,78,3748,62,3101,16
43157,57,550,1055,442,8638,108
39040,119,3493,1615,2654,20064,839
36228,3,141,1794,105,2665,36
13169,193,6482,2984,4802,55163,1680
19307,81,3668,2650,2874,27627,794
9384,32,567,3194,354,3502,213
43440,21,236,971,181,4760,55
3563,14,501,3497,430,12151,71
28982,49,1528,2156,1171,14576,357
7355,5,138,3331,106,4377,32
28371,2,74,2189,57,4824,17
33682,38,749,1932,612,6151,137
4425,12,159,3471,132,8572,27
36728,2,22,1768,18,3129,4
24454,3,82,2383,69,2123,13
8963,7,270,3221,207,6166,63
8291,43,838,3263,638,25280,200
25164,12,1556,2350,1159,41448,397
8760,7,226,3232,183,3645,43
30902,18,393,2058,296,8239,97
42361,24,1600,1248,1139,14846,461
26637,0,445,2285,372,6238,73
40098,32,561,1550,460,7446,101
23860,15,1272,2410,1051,11990,221
43653,83,1361,898,1192,17041,169
11561,8,386,3081,279,3794,107
18434,400,10557,2687,7408,25962,3149
18436,14,586,2687,447,8543,139
25101,274,12168,2353,10194,93078,1974
7069,30,845,3347,601,10675,244
34766,367,19412,1887,14053,88302,5359
41257,35,789,1437,599,14885,190
29310,3,71,2138,53,2116,18
34530,0,73,1900,58,2092,15
42345,13,300,1251,213,10087,87
7675,118,4783,3313,3769,36842,1014
37549,27,633,1715,444,14865,189
33488,22,842,1938,654,9074,188
12976,7,464,3004,339,10505,125
3410,66,6954,3500,5067,34851,1887
33043,0,61,1956,50,4455,11
20295,2,151,2597,129,4329,22
24268,16,491,2391,390,6476,101
39379,6,121,1593,104,4011,17
31205,6,135,2044,111,11799,24
45107,4,50,560,38,2809,12
13093,246,12809,2997,8943,46529,3866
39834,29,538,1568,446,13611,92
28027,117,5229,2209,3491,49075,1738
30528,15,908,2075,699,5909,209
22667,0,8105,2467,5995,46767,2110
21549,8,306,2526,231,2531,75
25763,11,314,2324,248,4429,66
12585,77,4236,3028,3364,86882,872
46118,106,3006,197,2559,20078,447
23413,19,572,2431,458,4185,114
36806,3,126,1762,102,4171,24
25791,0,23,2322,18,3618,5
37538,3,172,1716,147,3462,25
19224,51,1583,2655,1187,7468,396
37524,0,75,1717,50,5129,25
35591,2,35,1839,32,4171,3
30072,7,1234,2102,908,9017,326
9917,2,105,3167,74,5212,31
38461,24,383,1652,304,6417,79
8724,48,1339,3234,946,12759,393
20125,1061,65192,2607,44497,337514,20695
25311,6,474,2345,377,4626,97
17439,74,1660,2731,1276,9100,384
36186,11,534,1796,396,5728,138
28934,1,124,2158,103,3997,21
17188,12,1467,2745,1102,12052,365
39875,3,115,1565,80,7134,35
37452,27,1254,1722,1032,18570,222
13258,15,1036,2980,788,11186,248
12071,12,985,3057,623,19533,362
36920,11,1589,1755,1193,14028,396
21415,13,436,2534,362,14627,74
45261,19,116,448,96,2245,20
40940,191,4845,1477,3391,31701,1454
31791,20,459,2012,366,5216,93
25641,2,90,2329,77,3025,13
19776,1,31,2626,24,3287,7
41449,109,2987,1409,2134,26100,853
12363,66,1780,3040,1246,12715,534
26461,35,2030,2292,1364,9640,666
43780,5,115,857,97,5363,18
13002,131,4734,3003,3587,41536,1147
35974,19,290,1810,222,3746,68
16954,3,81,2759,66,3556,15
39933,62,2137,1560,1654,27553,483
11067,4,124,3107,104,5877,20
43004,149,2123,1100,1607,22523,516
27610,71,1323,2233,1012,14492,311
13821,10,250,2937,201,16153,49
35274,10,124,1859,109,4260,15
3627,24,343,3496,264,5309,79
43084,36,741,1075,509,14592,232
7314,0,34,3334,27,3074,7
23149,56,749,2444,604,5812,145
35520,4,158,1845,127,7077,31
45248,42,441,515,376,7261,65
20314,13,464,2597,375,13191,89
30722,8,416,2065,354,5652,62
19441,15,595,2643,431,8635,164
18186,35,1832,2698,1439,36405,393
15775,42,1456,2816,1126,25593,330
17631,45,4295,2722,3237,30416,1058
43103,83,1508,1071,1073,25161,435
42845,15,791,1143,484,10720,307
34172,4,207,1915,149,3175,58
18113,51,3938,2701,3081,21105,857
36668,0,49,1770,40,3221,9
34593,5,119,1897,90,3884,29
19407,64,2694,2645,2100,22481,594
9106,6,215,3212,182,13911,33
45409,8,61,468,49,2128,12
30241,24,1332,2092,1128,15250,204
3760,89,5593,3493,4028,66892,1565
15592,6,257,2824,173,6797,84
41895,13,482,1335,379,7456,103
1430,21,681,3644,574,11484,107
19371,22,832,2647,666,11485,166
29833,10,297,2113,257,8095,40
25031,10,262,2357,213,5426,49
15126,31,1239,2847,1001,11824,238
41672,8,182,1376,122,3890,60
2256,49,1450,3521,1158,35247,292
37735,19,299,1704,227,8566,72
15314,24,792,2837,606,14198,186
26730,0,41,2280,37,2585,4
7344,147,4662,3332,3382,42021,1280
4189,641,26867,3480,18764,63042,8103
5023,21,683,3446,429,11218,254
8266,27,444,3265,370,11310,74
44337,3062,61790,766,46034,224035,15756
39101,11,557,1611,429,12833,128
3132,2,45,3505,38,2240,7
45163,17,179,539,139,3584,40
27566,0,152,2235,139,1445,13
33660,3,226,1932,190,6680,36
24194,2593,95940,2394,61537,445041,34403
37265,130,3669,1733,2676,20954,993
27667,139,9426,2230,6980,76122,2446
7006,70,1998,3351,1529,38846,469
42266,22,891,1265,756,13417,135
10086,77,1300,3158,1015,13491,285
33946,37,559,1922,453,6512,106
43757,27,359,866,223,9465,136
17182,14,848,2745,623,9412,225
16396,363,65411,2787,41668,130318,23743
40015,1,77,1555,57,3642,20
44754,26,129,681,120,4331,9
32522,48,1566,1978,1207,19566,359
4623,4,253,3464,193,11113,60
43848,2,52,845,37,7221,15
16588,6,233,2779,187,2709,46
16035,13,920,2805,675,15899,245
8574,300,8767,3244,6930,44462,1837
35510,14,182,1845,154,5492,28
3454,27,994,3500,795,15601,199
45526,0,16,439,11,1483,5
18415,26,1807,2688,1444,18156,363
43374,13,216,988,173,6332,43
37350,16,478,1729,360,4938,118
40743,42,986,1496,793,21808,193
21655,12,759,2519,628,14090,131
16473,0,33,2784,22,1526,11
42783,294,7013,1157,5359,60897,1654
7475,18,690,3325,553,17138,137
33867,2,79,1924,62,2175,17
42658,132,1835,1187,1471,13742,364
2994,27,1186,3508,980,18069,206
19554,1,143,2638,109,6106,34
32593,10,581,1974,486,7736,95
15524,47,3099,2828,2454,30499,645
10292,144,7901,3149,5678,28648,2223
2273,43,1133,3520,840,13509,293
2820,10,506,3511,413,7055,93
43565,7,70,931,55,3578,15
25249,9,522,2347,405,12983,117
43129,156,4343,1063,3082,21599,1261
36415,20,299,1784,245,6087,54
3448,16,859,3500,624,14542,235
24019,0,951,2402,769,18659,182
31983,5,314,2003,250,5248,64
42714,43,590,1176,422,8247,168
28244,29,1336,2197,971,18643,365
6081,93,4024,3392,3004,22686,1020
44921,15,330,631,269,5671,61
45477,8,140,452,122,3971,18
36598,0,102,1774,90,3327,12
28145,0,72,2203,57,4119,15
43354,29,710,998,503,7528,207
2013,15,199,3524,155,10957,44
40407,12,473,1526,370,5256,103
26536,0,672,2288,521,12412,151
35669,306,15184,1832,11311,106004,3873
6242,2,42,3387,35,3057,7
38710,2,130,1635,114,9300,16
2485,28,1004,3516,851,11045,153
23461,14,252,2428,199,5360,53
40881,22,463,1481,370,6807,93
40955,7,318,1476,220,6074,98
42464,1,57,1226,35,4437,22
20971,0,26,2560,22,1369,4
19054,33,1787,2662,1434,7554,353
6923,84,4527,3356,3459,39942,1068
33235,8,221,1948,150,6227,71
14815,1,123,2864,101,3320,22
16472,59,1589,2784,1244,22276,345
1627,7,137,3580,117,2382,20
10043,1,138,3160,117,4825,21
12956,23,1519,3006,1179,11612,340
11640,2,141,3077,119,2963,22
40679,19,309,1501,240,6045,69
9185,436,19616,3207,14604,187687,5012
11850,11,247,3068,208,5938,39
7042,26,918,3348,694,7067,224
23441,10,291,2429,233,5002,58
9669,11,724,3178,477,4250,247
16778,31,2160,2767,1775,15223,385
35760,44,782,1826,578,6468,204
6938,4,281,3355,234,5837,47
38874,3,117,1625,96,3935,21
3663,0,30,3495,24,1851,6
23129,7,649,2445,505,5269,144
20354,84,4297,2595,3011,38096,1286
4554,23,717,3466,569,16298,148
2584,21,962,3515,680,17791,282
43138,6,215,1060,150,2591,65
25588,433,25863,2332,16803,98438,9060
42015,128,3362,1317,2365,31157,997
23579,5,209,2423,161,5345,48
19294,25,1360,2651,1084,15966,276
34887,9,300,1879,252,10226,48
21585,7,256,2524,216,4420,40
2398,220,11971,3518,8805,80071,3166
7359,27,832,3331,690,10304,142
45548,14,378,428,251,9247,127
9488,21,1120,3188,863,16711,257
1742,3,205,3550,168,4024,37
35603,79,3240,1838,2594,21216,646
32152,12,666,1994,520,5619,146
16991,3,346,2757,265,6697,81
23083,2,153,2447,120,2238,33
4093,32,1164,3483,931,11889,233
21008,267,6203,2557,4497,29536,1706
38266,18,607,1666,471,7520,136
17557,316,11842,2726,8520,54349,3322
11308,272,9812,3095,7792,69586,2020
43450,94,1916,969,1524,27316,392
26107,6,354,2309,258,5005,96
34385,254,9720,1907,7167,56819,2553
40855,4,72,1483,63,3401,9
27251,10,487,2255,416,6484,71
36425,15,237,1784,188,4469,49
4616,31,551,3464,392,13944,159
32416,5,87,1982,72,4381,15
12829,8,234,3014,204,4759,30
41443,72,986,1410,729,9453,257
41469,27,761,1406,580,7247,181
45900,13,232,292,205,6089,27
15004,2,300,2854,236,3512,64
39126,21,316,1609,255,5997,61
36633,18,226,1772,171,3527,55
13697,75,5960,2947,4322,46620,1638
42370,17,581,1246,454,11555,127
38525,17,447,1648,310,9360,137
10434,4,133,3142,95,5804,38
7534,20,476,3321,362,8893,114
40683,32,870,1501,754,14401,116
16841,30,1709,2764,1242,13275,467
40110,73,2749,1549,2111,26837,638
45247,42,391,516,284,5907,107
7729,27,760,3309,628,45644,132
32707,23,713,1970,557,10084,156
45365,11,95,481,70,2041,25
37600,2,73,1712,61,6568,12
1966,7,160,3525,119,10255,41
8206,7,240,3268,186,12117,54
45576,294,6816,419,4659,27295,2157
29940,5,127,2107,104,2107,23
44440,59,863,753,647,9215,216
2301,6,194,3520,140,6610,54
14275,31,1008,2904,830,7241,178
17118,607,42396,2748,25427,226636,16969
37894,420,17539,1691,12968,97419,4571
17764,2,391,2718,269,3299,122
29222,24,1066,2144,866,17824,200
24537,7,524,2378,399,4702,125
18244,161,14950,2695,11017,68932,3933
27578,15,369,2235,321,6258,48
8331,12,382,3260,305,4746,77
24247,4,485,2392,394,9412,91
34337,1,96,1909,76,11007,20
22527,3,84,2474,64,2230,20
25193,5,278,2349,214,4735,64
13726,0,22,2943,16,2948,6
31807,0,40,2012,33,3022,7
16807,224,19216,2765,12274,73874,6942
44174,5,121,791,89,3164,32
28211,1,26,2198,21,4378,5
27152,12,480,2261,414,6223,66
39746,8,275,1573,207,4678,68
22257,0,41325,2487,30173,154734,11152
11521,11,1173,3083,1029,6277,144
17091,13,667,2750,524,11118,143
3009,30,908,3508,713,13402,195
11855,1,65,3067,44,1592,21
16513,8135,886189,2782,637832,2593379,248357
17980,155,5759,2708,4507,46534,1252
44793,23,316,669,229,3078,87
958,6,272,3850,231,9925,41
34872,15,467,1880,392,7804,75
10655,129,4372,3129,3388,27837,984
45032,74,878,597,770,12694,108
29912,41,4122,2108,3346,24770,776
9179,0,135,3207,105,4256,30
15706,12,820,2819,622,3512,198
23717,44,1085,2416,828,11872,257
6806,9,273,3362,231,9421,42
26798,99,2438,2276,1958,34509,480
18032,3,341,2705,288,7120,53
32352,1,17,1984,15,2673,2
5799,230,7036,3405,5183,68724,1853
13013,182,8718,3003,6785,112389,1933
40661,6,68,1503,57,3973,11
18169,16,889,2699,719,6908,170
10071,2,71,3159,59,3387,12
13773,4,171,2940,142,2774,29
29257,17,422,2142,337,7639,85
6821,29,714,3361,572,9266,142
23384,130,5095,2432,3748,33091,1347
1207,13,419,3766,354,4382,65
14971,5,205,2856,182,3346,23
30099,21,1439,2100,1121,11771,318
13353,54,1213,2973,905,37029,308
41801,68,1309,1352,1087,18965,222
40436,172,2176,1522,1657,13532,519
3349,5,129,3502,111,3788,18
16499,197,12795,2783,10009,64696,2786
27115,8,311,2264,268,3542,43
32538,3,189,1977,138,10107,51
8689,4,75,3236,66,9723,9
32232,15,171,1990,139,3046,32
5914,6,214,3399,176,5603,38
11495,8526,419725,3084,240854,1111870,178871
34897,18,569,1879,447,5383,122
18916,1,130,2667,107,2382,23
2062,27,633,3523,513,12863,120
18882,3,214,2668,157,2781,57
37296,1,17,1731,16,9728,1
10532,49,1459,3137,1100,9797,359
2644,11,410,3514,341,16362,69
23171,1,275,2443,222,5168,53
19638,3,79,2634,69,1892,10
21975,1,65,2501,56,1973,9
4025,88,12219,3485,7034,63561,5185
43785,58,764,855,589,11749,175
42405,28,491,1240,387,8678,104
18439,19,925,2687,632,14753,293
9498,1865,90618,3187,65516,181143,25102
41571,100,2365,1394,1669,24582,696
6745,2,51,3365,38,1831,13
19612,0,556,2635,412,8503,144
19333,28,1966,2649,1427,24868,539
26647,29,709,2284,584,13983,125
25533,10,569,2335,441,6782,128
35429,141,1506,1851,1197,10311,309
43650,2,15,899,12,1548,3
36554,124,3381,1778,2471,29788,910
32051,0,51,1999,24,5704,27
25952,25,1735,2315,1362,24381,373
44129,270,4867,800,3197,25662,1670
14158,40,3807,2912,2576,23343,1231
41617,24,555,1385,424,10872,131
45793,1,29,329,21,1704,8
10739,16277,679642,3124,474154,1367398,205488
29780,9,259,2115,202,4496,57
33626,868,37266,1934,26869,206139,10397
46192,90,1797,163,1616,13741,181
16901,29,1731,2762,1297,9568,434
3765,10,265,3493,214,6606,51
12156,4,40,3051,34,3273,6
27291,26,225,2253,185,3578,40
5230,103,4540,3433,3721,30603,819
9605,50,2482,3181,1819,37254,663
33175,32,543,1950,426,4694,117
25537,0,60,2335,46,2311,14
31723,0,40,2016,34,3007,6
3116,4,113,3506,95,4425,18
17731,10,476,2719,365,11499,111
14471,124,4102,2889,3022,20770,1080
6756,11,90,3364,79,3711,11
8981,4,200,3220,164,9224,36
12340,29,1375,3042,1054,19041,321
44144,24,267,798,221,7509,46
42119,19,683,1298,489,9046,194
3167,30,632,3505,485,21894,147
19803,8,263,2625,213,4202,50
32779,10,303,1967,257,9459,46
3761,1,117,3493,100,5400,17
10605,11,539,3132,429,16322,110
15435,9,168,2833,134,9034,34
26526,4,156,2289,116,2922,40
12200,3,249,3050,207,12941,42
46121,5,48,195,33,1128,15
6253,34,906,3386,723,8914,183
20001,44,799,2613,653,7790,146
12496,75,7188,3032,4992,53305,2196
39564,6,432,1583,328,6684,104
41564,31,373,1395,267,5759,106
8621,108,2719,3241,2039,17347,680
6631,447,27214,3370,19025,145575,8189
35853,12,298,1819,251,10421,47
25050,148,4635,2356,3520,40274,1115
39236,78,3145,1602,1875,37950,1270
23885,4,104,2409,86,2984,18
28593,72,2444,2176,1928,23799,516
6295,28,1273,3384,897,15547,376
4563,1,31,3466,23,2181,8
33657,13,398,1932,328,10192,70
15311,139,6337,2837,4502,15607,1835
42176,0,0,1284,0,1634,0
40211,146,6023,1543,4790,39555,1233
28194,4,297,2199,243,10050,54
17358,42,1183,2735,878,11802,305
4610,13,151,3464,114,12799,37
8373,9,117,3257,80,2129,37
3518,61,2609,3498,1956,26648,653
31230,4,353,2043,283,6249,70
32611,17,705,1973,559,16713,146
39116,15,390,1610,305,6246,85
39075,4,98,1612,77,2965,21
15585,17,960,2824,746,12976,214
6126,4,120,3391,106,3628,14
36828,4,124,1760,100,5074,24
45906,1,27,290,21,1615,6
10009,17,706,3162,564,8318,142
33573,50,1049,1935,851,18803,198
43151,12,286,1056,203,7218,83
35040,25,730,1872,598,9825,132
9621,5,277,3180,215,4243,62
26164,0,265,2306,203,7263,62
21376,91,5156,2536,3843,37439,1313
10291,87,2546,3149,1979,23965,567
14854,5,388,2862,308,8577,80
19030,300,5985,2663,4486,24873,1499
29333,77,4287,2137,3457,24868,830
17090,40,896,2750,656,6783,240
24256,17,498,2392,418,4960,80
40123,0,0,1549,0,2381,0
44774,3,50,674,42,2098,8
27559,14,1161,2236,904,20300,257
3007,16,357,3508,293,13020,64
4857,8,257320,3454,87136,4480,170184
42644,963,23551,1191,15579,105877,7972
45233,2,50,519,38,1315,12
11676,69,2846,3075,2289,24036,557
41324,153,1875,1427,1320,15855,555
38531,13,458,1647,349,13602,109
2138,3,63,3522,56,3316,7
46082,3,70,208,59,1382,11
10755,13,340,3123,285,3509,55
4541,31,1795,3467,1356,14105,439
25228,138,3414,2348,2603,34151,811
43760,0,55,865,40,4546,15
18666,26,5625,2677,3678,55965,1947
42544,5,93,1209,71,7552,22
41724,142,3788,1368,2820,28340,968
40894,0,33,1480,27,4686,6
26348,57,10359,2297,7422,52911,2937
42295,5,249,1260,189,2943,60
35480,16,447,1848,344,10634,103
30560,14,328,2074,254,5481,74
11842,1,71,3068,53,3618,18
37209,74,1251,1737,1003,8863,248
28120,6,774,2204,561,7659,213
28771,1,89,2166,75,3145,14
36092,314,18439,1801,13745,105012,4694
14119,243,24485,2913,17920,128782,6565
42623,7,143,1195,125,5172,18
32966,9,888,1959,655,8911,233
3312,16,301,3502,248,5134,53
2482,36,1170,3516,870,8722,300
2627,20,485,3514,414,8957,71
5158,64,2045,3437,1434,37960,611
2416,7,410,3518,341,18869,69
15403,7,132,2834,108,4322,24
2960,16,1210,3509,800,27758,410
31274,17,1091,2040,848,15574,243
8536,3,83,3246,55,2903,28
12180,34,1275,3050,1001,10057,274
36547,4,165,1778,129,3742,36
33026,137,21766,1956,17183,73216,4583
13941,342,26024,2926,17942,149147,8082
39489,1,25,1587,20,1671,5
15498,12,460,2830,396,10030,64
5881,88,4413,3401,2973,38795,1440
15886,0,451,2812,350,8394,101
4224,2,103,3479,64,3958,39
38893,8,192,1624,154,3839,38
5510,9,304,3420,256,6824,48
45455,8,102,458,82,4325,20
38403,2,120,1657,90,3808,30
44725,8,80,691,51,2827,29
23853,33,865,2410,636,8999,229
14092,68,4127,2914,2911,48694,1216
19073,1,262,2661,195,6456,67
36848,6,353,1758,293,9906,60
37930,75,2724,1689,2043,19035,681
36886,23,310,1757,246,4696,64
40502,42,1163,1516,939,17556,224
45176,2,22,536,16,2407,6
4361,49,1641,3473,1293,18087,348
18144,0,95,2700,82,2794,13
8545,11,580,3246,423,9240,157
42496,23,845,1220,606,11987,239
46067,11,157,211,118,2357,39
27443,0,96,2243,72,2854,24
25515,8,449,2336,380,4019,69
26055,453,23192,2310,16507,70795,6685
22635,29,1591,2469,1160,27515,431
20628,75,2309,2581,1618,9584,691
22369,14,457,2482,367,5428,90
43112,21,480,1068,348,10335,132
36494,16,220,1780,186,5637,34
10062,11,207,3159,176,4005,31
28765,552,16121,2166,12142,117217,3979
25348,14,1155,2343,939,11475,216
28182,20,385,2200,311,3310,74
5526,1,57,3419,47,5120,10
26444,26,527,2292,449,7357,78
13533,27,1140,2958,893,23378,247
39523,6,158,1586,119,5636,39
19907,14,621,2619,496,8628,125
30460,51,2427,2079,1994,21496,433
14938,9,281,2857,233,5040,48
24964,6,464,2359,372,9300,92
39558,0,98,1584,53,3894,45
33463,31,501,1939,417,6377,84
36681,0,49,1770,35,1982,14
31748,424,12353,2014,8760,68401,3593
21602,6,293,2523,226,29718,67
24942,4,155,2360,127,3423,28
5872,20,272,3401,212,18188,60
37937,4,105,1688,70,3659,35
4148,23,666,3481,521,14346,145
19102,27,708,2660,589,9136,119
2291,99,3993,3520,3159,28491,834
5570,3276,142670,3417,93613,498509,49057
22472,7,230,2477,186,8063,44
31186,11,200,2044,160,4059,40
38670,16,488,1638,392,11425,96
9012,3,264,3219,199,6453,65
21359,19,609,2536,496,7824,113
7288,47,2042,3336,1602,41090,440
14486,6,130,2887,67,9257,63
16704,902,21241,2773,15384,91401,5857
36108,1,92,1800,80,4632,12
24889,70,3351,2363,2590,42923,761
17902,30,1686,2713,1450,19427,236
42129,286,6718,1296,4816,56372,1902
30858,9,251,2059,206,4246,45
33595,68,1548,1935,1250,10254,298
10528,14,501,3137,384,10036,117
2464,2,66,3517,60,4064,6
30900,29,3269,2058,2327,15513,942
8892,63,2835,3225,2251,27603,584
12369,22,1592,3039,1061,15278,531
33291,49,1478,1946,1188,23647,290
43178,15,357,1049,226,4357,131
25606,44,2851,2330,2232,16536,619
7132,57,3957,3344,2521,30549,1436
3180,2,47,3505,31,2952,16
27301,57,13066,2252,10680,42223,2386
27035,10,777,2268,591,8725,186
12800,0,165,3016,124,3902,41
2085,11,356,3523,255,39467,101
16247,713,42811,2795,28867,74119,13944
9946,12,578,3165,429,8562,149
33096,1,136,1953,106,6686,30
23256,8,0,2439,0,37917,0
22111,145,8241,2494,6343,60495,1898
12538,1,59,3031,35,1204,24
14574,757,62737,2881,45418,278849,17319
42079,31,1107,1304,853,19006,254
6987,15,182,3352,130,3666,52
4339,11,127,3474,101,4666,26
17042,345,23026,2753,16527,90720,6499
13493,43,3718,2961,2938,47933,780
41114,45,612,1458,501,6588,111
34840,7,204,1882,156,6648,48
32959,4,79,1959,65,2746,14
31751,22,1900,2014,1340,16408,560
2795,8,359,3511,283,8437,76
18199,24,2311,2698,1832,33759,479
18667,1,82,2677,65,2493,17
37387,154,2861,1726,1971,21312,890
26850,0,1895,2274,1514,27189,381
13164,7,581,2985,444,9940,137
40823,225,9067,1487,6215,51215,2852
28284,0,70,2195,65,1905,5
14053,1,42,2917,34,2603,8
12121,195,7098,3054,5660,81021,1438
21918,4,197,2506,152,4974,45
19919,2,65,2618,61,1529,4
25915,0,69,2317,52,2908,17
43037,109,2366,1091,1769,31235,597
41259,89,3170,1437,2365,20158,805
2421,7,339,3518,285,5297,54
43714,32,187,878,163,2746,24
4611,439,11510,3464,8487,45242,3023
41834,7,257,1345,201,11329,56
43287,288,5222,1017,3989,40291,1233
41659,3,182,1379,134,5444,48
11171,0,51,3101,37,4172,14
42612,16,607,1197,418,10058,189
13457,14,65941,2963,16520,7348,49421
31665,9,891,2019,717,12835,174
13189,21,1114,2984,889,26191,225
26037,14,571,2311,419,7343,152
31191,0,124,2044,91,2586,33
46255,3,74,148,54,1179,20
9420,31,2093,3192,1654,26480,439
7603,252,8615,3317,6640,50128,1975
35702,55,1688,1830,1353,13239,335
34801,0,120,1885,106,6743,14
26477,35,1061,2291,856,19118,205
21983,28,792,2501,632,14583,160
10217,218,13342,3152,9709,87546,3633
24652,2,49,2372,37,2231,12
15760,5,325,2817,270,4872,55
42167,33,994,1286,772,9271,222
24724,31,789,2369,649,8594,140
12134,532,43845,3053,28602,244841,15243
25346,100,2164,2343,1546,10032,618
34696,3,99,1891,67,2233,32
23659,1,66,2418,56,3627,10
4867,4,118,3454,102,6544,16
5148,6,185,3438,159,17854,26
5256,121,4391,3432,3448,47728,943
39559,61,1134,1584,895,12119,239
3002,4377,222205,3508,136989,569283,85216
38283,5,211,1665,137,5880,74
29827,270,12463,2113,9506,61918,2957
14876,6,743,2861,557,15381,186
26806,7,275,2276,227,8321,48
22317,4,278,2485,221,6333,57
40641,1,50,1504,40,2349,10
24609,15,961,2374,770,11903,191
19863,4,507,2621,368,11599,139
28936,7,320,2158,218,3364,102
43498,22,579,954,401,13855,178
45612,27,454,411,307,6910,147
32891,1,149,1962,128,3091,21
22886,8,707,2456,574,7059,133
33819,25,1563,1926,1071,20382,492
45859,179,2735,279,2079,24975,656
41394,65,1661,1418,1264,24837,397
38380,1,62,1658,52,2705,10
18892,1,171,2668,120,7356,51
944,8,530,3854,432,12923,98
42602,51,1677,1199,1310,34095,367
44741,90,1070,686,905,11117,165
22633,8,333,2470,271,5304,62
43719,15,93,876,80,2391,13
3395,13,477,3501,394,16072,83
11335,0,25,3094,14,2917,11
39254,11,207,1600,149,4890,58
2686,52,3801,3513,2793,44514,1008
13649,18,876,2950,716,24903,160
16929,16,753,2760,556,12271,197
6871,54,3731,3359,2900,29685,831
20627,5,491,2581,399,5986,92
38853,45,2775,1626,2059,25171,716
33422,3,120,1942,90,2269,30
26723,245,9938,2280,7141,52087,2797
35355,160,4463,1855,3671,20233,792
5327,10,288,3429,230,11807,58
13694,106,9726,2947,6008,76857,3718
3732,0,12,3494,9,2264,3
15530,12,659,2828,569,8367,90
42907,3,86,1128,60,6088,26
45465,13,156,455,78,4024,78
10595,49,1245,3133,1052,41372,193
14520,12,335,2884,250,3826,85
26220,1512,60028,2303,41953,228513,18075
9070,50,2108,3215,1647,27541,461
35420,104,1216,1852,929,13635,287
40593,229,6283,1508,4762,37553,1521
44761,4,43,680,31,2353,12
23035,7,268,2450,226,7734,42
12741,61,2852,3019,2301,25337,551
10841,20,1698,3119,1023,11039,675
19822,592,26905,2623,19419,164672,7486
15025,74,4088,2853,3197,14279,891
5386,6,195,3425,160,4873,35
11520,4,157,3083,126,8386,31
34082,191,2824,1918,2232,26538,592
21487,15,425,2530,352,3951,73
15410,5,700,2834,608,9350,92
17431,113,5627,2732,4308,35881,1319
22926,12,688,2454,442,5837,246
34141,44,1940,1916,1522,16728,418
32587,6,158,1975,137,3757,21
5757,69,88509,3407,35293,15227,53216
28238,1,62,2197,48,2934,14
12430,39,2395,3035,1829,22362,566
5202,4,62,3435,52,3427,10
12034,11,780,3059,548,4119,232
29214,419,83956,2144,51318,306317,32638
34388,5,167,1907,133,4357,34
34901,10,422,1879,349,9707,73
19169,0,47,2657,40,4676,7
11796,3,193,3069,158,11800,35
30376,1,105,2084,78,4372,27
5919,33,1080,3398,824,8012,256
37191,1,155,1738,121,6731,34
41441,34,672,1410,497,5242,175
10740,178,6956,3124,5233,57748,1723
27163,14,427,2261,340,21734,87
43557,4,49,933,39,2376,10
38101,83,3124,1678,2412,17748,712
17019,61,4236,2755,3265,16720,971
27046,30,819,2267,621,6837,198
37610,3,127,1711,101,4170,26
45397,1,16,471,12,1261,4
13033,409,14414,3002,10400,77341,4014
12342,4,315,3042,251,13463,64
37153,119,2988,1741,2389,24130,599
46282,7,180,139,117,4455,63
23680,32,957,2417,805,9169,152
25545,11,383,2334,309,6588,74
38370,15,578,1659,445,5418,133
29411,0,181,2133,146,4199,35
45353,114,881,484,732,6704,149
22006,5,251,2500,212,4207,39
17205,9,240,2744,188,6798,52
37936,39,2167,1688,1644,27515,523
24240,12,383,2393,257,5785,126
19468,317,21092,2642,15032,114249,6060
4609,13,410,3464,319,16799,91
14469,73,6059,2889,4887,44698,1172
21352,12,766,2537,551,13069,215
45410,16,427,467,325,5896,102
23576,27,521,2423,346,4072,175
26168,43,1435,2306,1137,12967,298
3762,8,306,3493,256,7271,50
32734,21,616,1969,474,11748,142
6728,6,128,3366,86,4235,42
30315,30,1740,2088,1315,21631,425
7412,180,5303,3329,4040,45518,1263
25651,5,127,2328,108,2507,19
12533,1,56,3031,39,1286,17
36518,18,704,1779,530,11468,174
12296,6,449,3044,383,7352,66
37290,31,846,1732,648,8854,198
31602,0,37,2023,30,1743,7
37641,7,292,1710,243,6643,49
16963,49,1813,2758,1313,18029,500
44890,7,92,641,64,3861,28
15343,85,5717,2836,4669,59972,1048
15085,27,999,2849,767,11623,232
1798,73,1424,3531,1127,28484,297
32865,83,4670,1963,3474,43261,1196
4071,3,74,3484,58,2155,16
42462,32,735,1226,664,13742,71
41391,44,471,1418,352,6877,119
28432,266,8301,2186,6204,40590,2097
45168,3,43,538,20,2692,23
45542,2,21,432,18,1275,3
15245,1151,78937,2841,53839,194687,25098
16590,9,503,2779,416,6254,87
6643,41,1675,3369,1227,18064,448
27671,52,2373,2230,1873,7669,500
6767,1,68,3364,57,2966,11
45132,2,22,548,16,1536,6
33784,1,69,1927,55,4343,14
17958,150,10453,2709,7727,53569,2726
34261,6,118,1912,91,4661,27
2838,41,1358,3511,1067,20537,291
13325,4,214,2975,166,8651,48
6168,10,411,3389,346,5632,65
45843,6,59,312,40,3994,19
16937,352,35300,2759,23158,190420,12142
11921,11,211,3064,153,4671,58
6502,13,300,3375,244,3927,56
23949,41,4390,2405,3151,20276,1239
23980,38,1253,2404,912,10061,341
20479,25,727,2589,606,15239,121
14311,6,233,2900,195,12291,38
26528,2,183,2289,146,10113,37
43582,3,34,924,31,2573,3
4490,126,4763,3469,3621,34414,1142
24018,0,5848,2402,4333,38671,1515
3107,0,16,3506,11,1467,5
18570,20,1042,2682,846,23017,196
37833,73,1560,1695,1275,22962,285
3582,12,401,3497,325,7321,76
6416,111,3634,3379,2670,25666,964
23904,22,1320,2408,1063,5705,257
45838,6,71,314,65,2974,6
20640,40,4325,2581,3151,33352,1174
22496,77,7717,2475,5772,92194,1945
26298,0,143,2300,118,3233,25
16604,2,66,2778,54,2836,12
24663,10,609,2372,460,8014,149
22850,20,749,2458,604,10155,145
19044,0,36,2662,28,1352,8
2046,8,262,3524,227,25129,35
17007,5,653,2756,461,4579,192
15263,1,81,2840,62,3181,19
17524,56,2615,2727,1895,12719,720
23388,81,3758,2432,2960,24044,798
30310,16,373,2088,325,8529,48
14943,162,10972,2857,8286,91019,2686
43990,33,289,825,209,4853,80
16949,5,197,2759,173,5402,24
12641,337,17808,3025,12790,155927,5018
35442,11,330,1850,291,2272,39
12646,50,1585,3024,1251,51765,334
4057,176,297513,3484,94330,66117,203183
26586,10,150,2286,111,2924,39
45977,2,97,254,72,1701,25
15040,2,154,2852,131,10752,23
2849,40,692,3511,512,19639,180
7967,6,95,3287,89,2365,6
24960,0,2168,2359,1564,3629,604
38388,88,2148,1658,1758,16113,390
45437,0,19,463,14,1854,5
20887,21,2034,2565,1492,30076,542
6262,742,19738,3386,14154,80171,5584
44095,61,2735,797,2003,11837,732
29145,0,18,2147,15,1949,3
17331,13,639,2737,462,3276,177
27158,2,68,2261,59,2407,9
4077,45,2175,3484,1713,29874,462
31598,3,56,2023,44,2377,12
8702,50,1913,3236,1398,22436,515
18171,3,148,2699,126,2273,22
14285,26,2195,2902,1672,35543,523
37390,25,711,1726,556,6619,155
45426,22,294,464,244,6708,50
15081,50,1125,2849,934,10020,191
35611,2,81,1837,57,2491,24
37960,28,514,1687,411,5474,103
24729,64,1697,2369,1338,11296,359
32415,0,22,1982,12,1441,10
11113,358,28073,3104,21300,167589,6773
12950,18,280,3007,229,3963,51
18030,0,62,2705,52,2931,10
11191,33,822,3100,650,7439,172
15516,11,566,2829,408,8369,158
19252,4,133,2653,113,3514,20
14839,71,3382,2863,2481,27634,901
31103,5,100,2049,86,2786,14
38277,136,2394,1666,1950,29480,444
22501,156,8284,2475,5564,66205,2720
22781,7,228,2462,176,3963,52
28796,23,1207,2165,831,15335,376
19962,34,1940,2616,1510,30123,430
34255,4,130,1912,104,5394,26
3460,110,8842,3499,6096,62876,2746
24167,0,40,2395,34,2685,6
14828,3,177,2863,153,8741,24
33409,5,141,1942,121,2560,20
5633,28,662,3413,483,11848,179
11210,1396,106767,3099,72615,525030,34152
26612,17,463,2285,372,6130,91
28551,5,88,2178,74,2939,14
2255,6,103,3521,84,4867,19
5175,3128,307350,3437,195173,1050327,112177
32332,2,174,1985,141,2543,33
38349,4,339,1660,272,9612,67
6596,19,2000,3371,1422,39989,578
3138,28,1413,3505,1129,23627,284
36898,7,150,1757,135,2613,15
36843,36,950,1759,760,12442,190
42053,307,8202,1310,5866,78951,2336
8350,28,485,3258,389,8696,96
31407,0,49,2034,39,6609,10
35083,15,771,1870,574,8020,197
40763,57,1525,1493,1196,27009,329
37076,7,146,1745,118,7045,28
24288,8,272,2390,211,2841,61
41177,31,597,1451,428,8149,169
15635,59,4553,2822,3458,26870,1095
12821,7,406,3015,330,7884,76
23050,111,4111,2449,3155,44697,956
2210,790,48894,3521,33810,269838,15084
37432,57,1218,1723,933,7502,285
25659,13,271,2328,221,4041,50
18223,8,266,2697,199,4579,67
37492,7,238,1719,204,8118,34
26859,32,780,2274,587,7869,193
9678,24,977,3178,758,15436,219
35151,2,202,1866,164,3711,38
15457,2,114,2832,98,2256,16
8784,32,991,3231,773,7430,218
1887,4,181,3528,152,10639,29
37393,1,91,1726,69,4763,22
22823,14,378,2460,289,2935,89
28851,30,1955,2162,1601,10688,354
14245,15,2050,2906,1550,79069,500
9332,0,64,3198,49,5382,15
41435,47,486,1410,369,8570,117
2208,123,3916,3521,3150,35740,766
34935,49,676,1877,538,7661,138
24261,8,149,2392,126,2351,23
43527,4,55,945,39,3662,16
6199,21,710,3388,429,4018,281
32494,28,616,1979,483,8103,133
15020,24,258,2853,187,5466,71
36695,3,284,1769,230,7414,54
16897,123,5242,2762,3767,38299,1475
36062,31,1003,1803,787,66593,216
25131,28,2364,2352,1709,18793,655
7918,25,770,3293,616,12921,154
38494,2,226,1651,165,10507,61
26347,7,389,2297,330,2240,59
22230,584,34566,2488,24151,149224,10415
10251,5,72,3151,63,5300,9
42424,94,4622,1234,3220,62497,1402
27188,1,92,2259,68,1963,24
5856,1,203,3402,170,6615,33
34824,12,332,1883,253,4451,79
16697,4,270,2773,229,9412,41
26639,2,67,2284,55,1742,12
14978,0,104,2855,80,5281,24
38418,4,151,1656,131,6385,20
29667,3,91,2121,80,3730,11
33593,3,80,1935,67,6996,13
4190,11,282,3480,229,5806,53
20062,0,728,2611,570,8536,158
32473,74,1802,1980,1391,10578,411
37797,58,663,1699,503,5771,160
30286,1,41,2090,34,1645,7
43285,120,1601,1018,1259,24915,342
45715,4,161,357,103,2916,58
2958,25,1940,3509,1546,17745,394
7674,7,121,3313,103,6773,18
35874,3,267,1817,212,9073,55
35500,11,155,1846,127,4743,28
12948,14,442,3007,324,9485,118
21039,10,386,2555,302,19748,84
8883,8,515,3226,405,10739,110
42199,0,128,1280,99,11046,29
32057,0,125,1999,62,3260,63
6955,8,245,3354,199,2303,46
11659,7,358,3076,268,19680,90
36424,1,143,1784,120,3323,23
40398,4,233,1526,181,5911,52
26062,120,5113,2310,3533,31528,1580
24576,8,398,2376,321,5305,77
36832,4,110,1760,84,4992,26
25464,0,17,2338,14,1198,3
22104,24,2044,2494,1472,26658,572
25599,46,1749,2331,1361,25663,388
21992,16,1668,2501,1253,10812,415
38435,16,375,1654,287,4485,88
34055,13,265,1918,209,5525,56
23391,1,98,2432,87,3592,11
18259,1,55,2695,43,1999,12
16786,3,109,2767,86,17544,23
35300,79,1671,1857,1210,17909,461
43225,53,1414,1037,992,16078,422
3131,9,393,3505,279,9518,114
23609,2,77,2421,57,3472,20
40996,3,207,1473,156,7124,51
22404,6,160,2481,134,3852,26
31676,10,764,2018,632,9062,132
40225,2,141,1542,118,2394,23
1995,21,804,3525,624,8011,180
23013,16,1433,2450,1059,12183,374
4308,265,10221,3475,7969,47127,2252
25363,9,492,2342,410,9608,82
19528,4,169,2639,136,4469,33
25671,22,431,2327,325,3789,106
4876,13,199,3453,150,7674,49
12615,7,409,3026,315,8027,94
23193,4,197,2442,148,12333,49
34338,1,64,1909,53,4039,11
9349,124,6324,3197,4736,75221,1588
12744,0,18,3019,11,1329,7
33492,11,177,1938,147,5178,30
13236,87,4351,2981,3034,43314,1317
32477,10,1327,1980,1020,14614,307
32757,2,120,1968,86,2862,34
40440,0,25,1522,18,2237,7
13646,3,60,2950,50,4475,10
44705,11,222,698,140,3953,82
38439,24,501,1654,399,3800,102
43155,0,43,1056,31,2518,12
38705,44,1372,1635,1168,16093,204
39552,7,84,1584,71,3353,13
12623,3,104,3026,80,3204,24
40976,1,54,1474,41,3469,13
14288,5,313,2902,232,8780,81
25215,7,632,2348,490,4858,142
7945,3,61,3290,42,1573,19
14668,42,920,2875,760,10028,160
29902,18,939,2109,723,7114,216
18109,6,245,2702,200,3581,45
2127,24,617,3522,445,8012,172
18419,19,452,2688,344,5582,108
40197,1,14,1544,11,1175,3
5399,5,219,3424,156,4840,63
41840,6,702,1344,484,17593,218
19257,0,204,2652,161,6083,43
5322,27,948,3429,736,14326,212
29112,62,1260,2149,885,25494,375
29674,1,177,2121,125,3867,52
10709,79,4135,3126,3174,43390,961
34254,34,695,1912,540,7292,155
19708,8,467,2630,364,12629,103
45806,20,280,324,206,3273,74
4650,28,877,3463,738,7407,139
25349,39,762,2343,616,6185,146
5428,7,148,3423,124,4260,24
21323,2,85,2539,76,2574,9
18875,695,25111,2668,17450,118006,7661
18408,268,17479,2688,13349,121443,4130
12926,1,165,3009,118,2703,47
20552,28,1739,2585,1409,22764,330
23786,32,903,2414,629,5884,274
20616,87,6352,2582,4532,31784,1820
36877,15,639,1757,440,6063,199
33496,6,159,1938,138,3463,21
39722,58,2695,1574,1804,14079,891
16805,11,370,2766,295,6154,75
34413,21,444,1905,375,4969,69
33417,11,306,1942,250,6903,56
28597,74,2336,2175,1769,14300,567
13199,11,572,2983,416,8967,156
15866,128,5926,2813,4233,43152,1693
25239,1,114,2347,93,6914,21
24413,1,110,2384,91,4163,19
45946,41,506,265,414,14627,92
35631,271,18616,1836,13361,106096,5255
8480,117,3382,3250,2250,25392,1132
37683,29,670,1707,458,5623,212
29942,1271,91004,2107,57338,321006,33666
44618,193,4712,722,3105,29456,1607
38450,5,230,1653,192,11812,38
16573,166,8578,2779,6603,56228,1975
12411,93,5309,3037,3778,46004,1531
3878,101,9938,3490,7431,54795,2507
9618,0,28,3180,20,3899,8
1849,48,1892,3529,1564,16824,328
10568,607,43389,3135,29195,239109,14194
36625,2,141,1772,112,5719,29
32401,27,844,1982,695,16416,149
4836,26,471,3455,344,20125,127
11837,3,65,3068,53,2613,12
21480,633,34717,2530,25207,152211,9510
37082,13,244,1745,186,7389,58
20305,13,329,2597,230,6840,99
14442,1252,109732,2890,70360,299050,39372
3351,1,33,3501,29,3407,4
24875,57,2380,2363,1817,22340,563
5213,32,539,3434,450,10559,89
29163,280,7755,2147,5845,74335,1910
21183,18,479,2546,392,9644,87
28900,11,456,2160,345,6574,111
5723,24,287,3408,219,7153,68
29559,774,28631,2126,20410,145896,8221
37226,37,1932,1736,1307,26961,625
36840,4,129,1759,92,5358,37
5341,100,4642,3428,3543,77615,1099
17194,55,1276,2744,985,9747,291
43825,106,1266,848,971,8310,295
40558,107,1620,1510,1220,10417,400
40568,1,31,1510,24,1888,7
16095,3,216,2801,141,2886,75
4767,37,697,3458,582,13526,115
15319,38,3256,2837,2571,17085,685
43918,12,259,834,175,4655,84
31387,30,441,2035,334,2329,107
4726,3,238,3460,186,13122,52
35954,29,1237,1812,1018,10983,219
42141,51,971,1292,691,19772,280
22119,276,18991,2493,13658,59806,5333
11700,47,1497,3074,1188,13918,309
15740,16,797,2818,583,12228,214
14725,117,3259,2871,2456,24041,803
25888,1,37,2318,33,2819,4
17851,26,1041,2715,861,19428,180
21300,4,207,2540,176,3906,31
32890,1,34,1962,22,2187,12
33251,3,85,1948,66,5208,19
30000,494,11227,2105,8789,46759,2438
8853,10,416,3227,344,12679,72
19352,0,141,2648,118,4426,23
40029,52,655,1553,465,10482,190
42515,116,8437,1215,6397,57901,2040
40992,6,297,1473,223,4141,74
6595,3,144,3371,121,7734,23
17995,6,419,2707,332,22657,87
37846,6,78,1694,64,3307,14
26064,3,249,2310,202,7831,47
21176,1362,130301,2546,91414,385663,38887
24488,0,227,2381,176,5812,51
7417,2,97,3328,86,4851,11
32432,64,1422,1981,1060,16537,362
17862,6,678,2714,577,8283,101
45957,16,111,262,87,1890,24
26265,1,111,2301,89,9031,22
28583,331,17253,2176,12616,116742,4637
10343,10,176,3146,156,5127,20
13626,38,4923,2952,3508,38317,1415
40165,5,94,1546,83,2047,11
23917,7,570,2408,383,7507,187
9581,169,8186,3182,5970,120373,2216
37225,26,911,1736,721,12616,190
9378,14,676,3195,549,6390,127
41478,128,3819,1405,2969,26703,850
36446,11,209,1783,169,3937,40
44749,3,40,682,33,2114,7
24114,51,1931,2398,1538,18049,393
34772,4,159,1887,111,4369,48
19157,169,12062,2658,9379,81602,2683
28442,5,350,2186,290,4934,60
36057,9,252,1803,190,3665,62
3130,37,1699,3506,1262,27561,437
4574,202,8326,3465,5969,32772,2357
12253,16,139,3046,108,2769,31
21407,15,705,2534,529,5724,176
8014,15,257,3284,205,4049,52
32900,0,85,1961,62,4098,23
39025,38,1045,1616,677,12395,368
9551,7,203,3184,156,11923,47
22194,9,602,2490,469,26979,133
14364,8,528,2896,375,15251,153
35729,14,555,1828,464,5866,91
21725,11,481,2516,399,3321,82
34590,2,114,1897,94,4105,20
13143,12,1086,2994,843,8993,243
25991,8,196,2313,161,4282,35
37397,3,113,1726,88,5429,25
13742,57,1245,2942,897,11652,348
19155,12,1015,2658,737,7758,278
16718,63,2621,2772,2115,18792,506
21435,6,568,2533,422,17043,146
25309,853,52721,2345,35278,130767,17443
46171,2,25,170,15,878,10
29417,1,95,2133,73,2068,22
38823,0,45,1628,34,2181,11
40460,0,0,1520,0,4004,0
34930,12,240,1877,190,5032,50
45330,30,318,489,234,7071,84
37872,16,815,1692,593,11757,222
38175,2,165,1673,130,6015,35
9487,28,1206,3188,924,8426,282
40854,0,74,1483,52,4779,22
18146,11,252,2700,224,13060,28
34599,15,1163,1897,952,17348,211
8399,39,1584,3255,1228,23603,356
45581,0,120,418,91,2512,29
34757,4,152,1888,124,13080,28
18971,0,94,2665,83,1893,11
41361,10,275,1422,199,5192,76
42429,8,140,1233,109,4750,31
44142,18,306,798,227,11758,79
3940,27,812,3489,646,24469,166
25212,12,518,2348,431,8389,87
23420,19,634,2430,497,6389,137
31445,2,233,2031,178,10447,55
40508,5,161,1515,127,7260,34
39872,163,3319,1565,2755,35705,564
12589,2,58,3028,52,3965,6
38941,29,562,1621,405,10585,157
5203,25,1005,3435,549,19643,456
4230,17,292,3479,212,18562,80
25180,2,36,2349,32,2305,4
6498,4,160,3375,84,4112,76
39271,7,255,1599,196,5788,59
29968,5,195,2106,146,3881,49
15019,18,381,2853,296,3230,85
20227,230,13087,2601,9366,38836,3721
3566,44,1231,3497,972,13337,259
7955,79,4459,3288,3531,90936,928
29952,6,288,2107,229,6196,59
6920,7,91,3356,67,2097,24
37857,7,152,1694,109,9422,43
30174,13,135,2096,109,4179,26
4066,34,900,3484,728,16675,172
24932,0,14,2361,12,4440,2
9764,22,972,3174,797,7015,175
23103,28,3119,2446,2453,13624,666
30618,113,6872,2071,4718,44774,2154
36909,19,607,1756,494,13351,113
8414,470,19394,3255,14016,70088,5378
20037,66,1243,2611,930,7022,313
10674,114,5071,3128,3608,23426,1463
14630,21,1196,2877,956,8839,240
25360,19,878,2342,706,14990,172
16535,25,2255,2781,1647,38010,608
18638,202,12258,2679,8598,127258,3660
38678,3,174,1637,139,3957,35
45219,12,112,523,81,2710,31
10801,84,1787,3121,1387,62582,400
39789,1,18,1571,16,2525,2
2842,4,170,3511,149,10752,21
9636,26,1019,3179,810,32112,209
11098,70,2133,3105,1666,59020,467
33859,2,39,1925,32,2954,7
30340,1,53,2086,45,2238,8
4076,70,3279,3484,2493,42910,786
43663,8,161,894,129,6649,32
31007,5,158,2054,126,3062,32
38676,7,171,1637,130,4038,41
1643,4,104,3575,86,3815,18
40963,0,182,1475,131,4538,51
38406,36,958,1657,733,9655,225
18687,21,2254,2676,1461,22387,793
2156,185,5485,3522,4301,33685,1184
17410,50,4172,2732,3323,27279,849
19072,0,190,2661,151,4177,39
31232,7,344,2042,279,10735,65
7707,41,816,3311,624,10817,192
31963,0,155,2004,111,3339,44
15396,37,2469,2834,1792,24475,677
38140,2,47,1675,33,3283,14
35038,6,225,1872,174,7311,51
15677,306,12715,2821,9417,46569,3298
43435,20,314,972,254,5780,60
15765,1,27,2817,22,3369,5
22193,15,418,2491,319,5042,99
4634,0,40,3463,32,2180,8
2425,2,251,3518,193,12422,58
38666,3,68,1638,56,2416,12
25634,40,5697,2329,4070,32192,1627
16622,8538,364406,2777,210326,759007,154080
34918,59,1680,1878,1397,11429,283
2238,0,22,3521,18,3112,4
42497,24,610,1219,420,7238,190
2641,120,5441,3514,4498,43534,943
40413,0,31,1525,25,7315,6
6667,12,284,3368,226,17284,58
13557,9,37211,2956,13490,10412,23721
30435,11,353,2081,294,3873,59
33933,58,9916,1923,7232,54143,2684
27766,9,551,2224,441,10421,110
29244,26,484,2143,388,3705,96
22220,3,431,2489,357,6356,74
7427,11,439,3327,333,9957,106
42709,83,1545,1177,1090,14834,455
23886,3,118,2409,96,3841,22
26853,23,1249,2274,879,8126,370
4357,31,418634,3474,127497,8790,291137
22990,0,56900,2451,36345,269426,20555
21547,4,172,2526,131,3598,41
21924,285,25520,2505,18741,100780,6779
8284,83,3294,3263,2538,23738,756
43058,43,1134,1085,904,10732,230
18219,26,1803,2697,1318,15842,485
12244,89,5578,3047,4163,27375,1415
39477,48,2162,1588,1492,22772,670
17146,3,283,2747,237,4072,46
14410,116,14136,2892,10096,65619,4040
26480,7,829,2291,580,10868,249
22129,27,1650,2493,1220,14233,430
35690,1,56,1831,51,17933,5
5855,4,65,3402,53,2803,12
6855,1394,72452,3359,47331,417005,25121
15001,12,1215,2854,831,11045,384
23244,0,2646,2439,1916,37808,730
12385,12,958,3039,600,19081,358
12029,231,8506,3059,6061,52200,2445
25755,5,104,2324,79,3741,25
13326,85,3747,2975,2981,40474,766
29004,6,136,2155,119,6644,17
19971,0,94,2615,77,3528,17
36223,8,236,1794,179,5776,57
14320,26,809,2899,621,21110,188
1356,5,109,3704,97,2856,12
32311,8,120,1986,94,2088,26
30866,25,788,2059,591,8774,197
41713,10,188,1370,147,3896,41
40733,9,225,1497,162,3472,63
13652,114,9758,2950,7080,77298,2678
41393,6,269,1418,188,6769,81
44429,54,672,754,573,6083,99
45479,62,950,452,817,11409,133
14341,1,177,2897,152,6193,25
29766,57,4354,2116,3504,25815,850
36070,0,87,1802,72,3347,15
24712,44,3126,2369,2370,30536,756
42763,10,397,1163,274,8735,123
4695,266,14929,3461,10589,50532,4340
19477,0,38,2641,32,2052,6
11096,20,435,3105,347,12962,88
32770,5,690,1967,553,10867,137
13482,6,184,2962,145,4009,39
43445,6,72,970,50,2384,22
28397,2,71,2188,62,2502,9
12786,60,2600,3017,1799,46054,801
14912,21,1172,2859,904,17153,268
24429,1,98,2384,87,2784,11
20537,4,100,2586,78,2561,22
2668,18,593,3514,460,5203,133
36571,10,242,1777,184,9961,58
14301,17,743,2901,610,6218,133
5323,15,375,3429,284,9528,91
45356,49,480,483,407,5717,73
17886,14,616,2713,468,9167,148
20829,12,746,2569,630,12946,116
11385,53,1026,3091,773,9611,253
3258,12,554,3503,433,3303,121
31466,0,91,2030,68,3450,23
3348,11,358,3502,282,10182,76
10838,2,104,3119,84,11718,20
40721,23,423,1498,349,13899,74
3594,9,548,3497,454,34580,94
2727,6,190,3513,129,4674,61
11014,271,17973,3110,14150,103847,3823
32212,3,66,1991,58,2813,8
38432,5,83,1654,76,6732,7
17727,0,213,2720,182,4180,31
45969,7,90,258,66,2206,24
19933,6,281,2618,220,3618,61
36184,4,170,1796,139,9557,31
15476,70,1862,2831,1455,24856,407
42006,5,317,1318,230,15893,87
18716,38,1331,2675,1022,12602,309
25447,9,532,2339,449,7721,83
8432,4,84,3254,70,2266,14
10020,132,5502,3162,4284,48037,1218
44011,185,1994,820,1629,20205,365
28694,11,253,2170,198,15628,55
1756,9,149,3544,115,2568,34
38395,7,260,1657,212,5401,48
10099,30,851,3157,698,9936,153
9535,44,1489,3186,1147,13688,342
30534,32,504,2075,417,3946,87
2664,68,3195,3514,2544,28114,651
7088,3,107,3346,84,2797,23
22362,5,280,2483,238,12676,42
9569,50,2871,3183,2187,23466,684
18163,22,1206,2700,986,25044,220
4744,97,5973,3459,4541,30840,1432
40831,3,64,1486,56,5398,8
40954,2,99,1476,80,4274,19
40002,33,470,1555,373,8393,97
24064,13,506,2401,411,21206,95
13683,5,432,2948,337,7432,95
8247,10,433,3266,339,10746,94
36000,314,6050,1808,4378,76984,1672
34330,90,1227,1909,964,8571,263
7234,81,2683,3339,2110,19299,573
40786,11,440,1491,325,6998,115
4526,8,283,3468,242,4977,41
29462,0,57,2130,43,1360,14
13522,2,87,2959,69,2710,18
5009,14,245,3446,186,11284,59
3613,2,62,3496,53,4203,9
17202,9,366,2744,287,15307,79
3986,211,10087,3486,7699,129431,2388
10418,92,2841,3143,2054,22601,787
3094,12,508,3506,426,5845,82
28361,16,270,2190,228,5755,42
5778,32,1157,3406,894,13302,263
12670,38,645,3023,509,11539,136
46042,14,120,221,80,2703,40
4701,28,1206,3461,926,13006,280
4881,1,97,3453,84,3015,13
46254,11,245,148,192,1828,53
4149,11,273,3481,213,9679,60
4894,19,365,3452,297,6529,68
2834,7,198,3511,174,4493,24
20217,21,488,2601,363,14481,125
14513,11,451,2885,338,7433,113
45941,20,94,266,79,1349,15
38077,9,570,1680,399,9446,171
3236,13,439,3503,374,8703,65
44478,3,59,747,51,6075,8
19773,9,686,2626,563,9186,123
11607,40,2645,3079,2028,40932,617
15309,5,394,2837,301,8799,93
40463,647,22774,1520,16582,136056,6192
45268,5,58,507,39,2918,19
19200,19,1163,2656,871,9796,292
37694,0,175,1707,135,2897,40
16319,5,281,2792,215,4965,66
14572,9,209,2881,166,5712,43
37645,87,933,1710,681,8383,252
19555,0,86,2638,61,3359,25
24543,31,1154,2378,886,19226,268
44852,38,422,650,298,5086,124
17336,150,20649,2737,15155,82334,5494
34175,503,14656,1915,11046,53905,3610
31430,16,427,2032,351,3683,76
40961,30,1023,1475,818,12192,205
26780,62,8929,2278,6039,48185,2890
42064,0,0,1308,0,1371,0
4972,61,1523,3448,1275,35127,248
11745,2,191,3072,159,7264,32
40433,34,3806,1523,2718,21521,1088
36535,57,918,1778,736,7755,182
23857,0,57,2410,46,2044,11
27220,18,323,2257,258,3795,65
7734,131,7005,3309,5362,47511,1643
27173,23,466,2260,397,3311,69
40452,3,202,1521,149,5641,53
1116,5,264,3797,216,6378,48
41657,15,929,1379,737,13961,192
9063,8,1019,3215,797,26912,222
3664,382,22469,3495,16126,126081,6343
42308,0,125,1258,91,4047,34
18064,27,2021,2703,1536,13247,485
26557,1,77,2287,64,2426,13
40998,87,4134,1473,2887,19525,1247
39655,2,74,1578,53,3889,21
4052,25,1915,3485,1553,41337,362
17045,3,122,2753,105,11655,17
17590,0,2497,2724,1846,28377,651
1664,1,25,3568,22,1722,3
22828,861,33170,2459,24754,158245,8416
31108,25,495,2049,406,3514,89
17904,27,876,2712,688,6829,188
26705,1,31,2281,26,1844,5
7391,5,176,3330,158,6107,18
20937,29,4732,2562,3516,23798,1216
14723,892,50094,2871,38068,249422,12026
3773,22,452,3493,346,23202,106
8836,89,3512,3228,2581,43861,931
20330,3,231,2597,180,8039,51
16236,20,3646,2796,2322,22538,1324
39098,234,11183,1611,8140,73028,3043
23257,44,2241,2439,1642,21416,599
36241,1,40,1794,33,2023,7
43263,83,1369,1024,1137,25327,232
22593,5,166,2471,137,5220,29
11477,43,2838,3085,2198,13262,640
42243,42,2280,1270,1458,25091,822
2426,30,1485,3518,1208,20870,277
29431,26,1151,2132,882,13666,269
1969,67,3468,3525,2801,34510,667
46086,2,25,207,17,1441,8
24066,2,67,2400,50,3203,17
21128,5,397,2551,302,11339,95
44801,19,319,666,232,2926,87
8020,13,426,3284,300,8298,126
42075,106,3379,1306,2471,35462,908
12379,13,556,3039,443,9339,113
16776,4,343,2767,254,3874,89
17452,7,450,2731,376,10463,74
3564,13,193,3497,156,4503,37
12467,33,3027,3034,1830,13137,1197
46098,23,330,205,270,5680,60
41781,31,695,1357,570,12174,125
40078,2,132,1551,99,2954,33
14217,53,2533,2908,1802,16719,731
29858,7,326,2111,172,2538,154
12339,100,17411,3042,12646,43427,4765
38448,6,276,1653,219,5218,57
29313,42,1439,2138,1056,13427,383
9671,24,578,3178,473,4425,105
27807,28,3657,2221,2860,44328,797
4852,85,2988,3454,2394,38274,594
13368,48,2147,2972,1592,32797,555
27732,27,683,2226,560,10793,123
29582,6,128,2125,101,3661,27
41035,18,531,1470,382,14668,149
27731,39,1509,2226,1201,12304,308
28300,16,1036,2194,825,13414,211
27907,24,1738,2216,1395,12825,343
46078,3,106,209,73,1476,33
10561,512,17178,3135,12764,59397,4414
2837,11,174,3511,153,11109,21
16678,8,282,2774,241,4373,41
26664,2,70,2283,63,3683,7
30960,4,195,2056,160,5393,35
32940,22,395,1960,322,4040,73
29436,3,134,2132,104,4936,30
18947,22,853,2666,663,10696,190
23814,17,546,2412,465,4216,81
41240,168,5030,1441,3757,39422,1273
40604,4,91,1507,74,1968,17
39541,2,33,1585,29,2117,4
14568,165,15367,2881,12016,131783,3351
37274,6,238,1733,194,4434,44
24945,13,1399,2359,1139,9155,260
33560,198,4102,1936,3053,22966,1049
26193,11,2671,2304,1961,21424,710
35933,36,819,1813,616,8276,203
35886,1,89,1817,75,8723,14
38821,11,317,1628,253,5338,64
39600,17,586,1580,432,14709,154
14415,11,649,2892,533,25466,116
43045,27,346,1088,278,10922,68
30762,1,108,2064,84,2010,24
45325,15,231,490,197,7755,34
35347,5,52,1855,44,1924,8
37906,8,213,1690,172,3660,41
33298,141,7021,1946,5286,42746,1735
22400,16,1597,2481,1254,5530,343
31879,3,309,2008,254,6661,55
10075,8,105,3158,85,4451,20
6032,6,206,3393,161,6766,45
2535,6,345,3516,283,4740,62
36652,35,605,1771,478,7748,127
23087,6,500,2447,376,7996,124
21543,1,129,2526,88,3455,41
28736,39,2005,2168,1639,20782,366
17284,308,9314,2739,6473,35177,2841
37893,9,297,1692,238,5101,59
18130,124,5717,2701,4410,47625,1307
29906,29,1961,2109,1621,7125,340
35799,35,1924,1822,1446,12699,478
12793,2,110,3016,82,8929,28
20474,147,8540,2589,5473,42707,3067
12649,3,559,3024,447,13960,112
16760,2,0,2769,0,4218,0
16816,2,128,2765,102,5088,26
40901,127,3348,1480,2496,31182,852
8475,13,470,3251,327,6181,143
13060,27,764,3000,608,11089,156
10959,19,368,3113,271,9010,97
26023,7,287,2312,232,4228,55
46295,0,18,134,13,616,5
42782,4,497,1157,332,13525,165
43438,5,225,971,191,6611,34
7690,1112,59152,3311,40415,407887,18737
25080,5,378,2354,313,3149,65
27459,25,1263,2242,972,14174,291
8263,1,79,3265,50,1471,29
21081,12,283,2554,212,5182,71
41612,14,366,1386,263,12426,103
27554,43,872,2236,646,6558,226
28264,43,1968,2196,1610,10270,358
23064,494,22027,2448,16133,78818,5894
13638,42,1606,2951,1249,29528,357
14059,21,423,2916,347,4022,76
11167,321,20051,3101,14995,94058,5056
24048,3,84,2401,74,2216,10
2052,167,7566,3524,5780,45222,1786
2420,37,883,3518,694,65783,189
35111,85,4404,1868,3426,24910,978
22039,0,1544,2498,1106,33591,438
43086,1,38,1075,28,2146,10
22710,3,275,2465,224,5698,51
3333,8,91,3502,61,5101,30
12216,41,1102,3049,847,12588,255
6222,3,41,3387,38,2559,3
9284,47,1679,3202,1330,15749,349
41110,1,52,1458,36,5734,16
4409,17,857,3472,676,20681,181
21582,28,1978,2524,1521,15650,457
19368,46,1911,2647,1386,15180,525
12832,31,1477,3013,1218,30202,259
26854,63,2705,2274,1857,29793,848
1659,7,483,3570,362,9140,121
21594,85,3620,2523,2882,15713,738
43185,11,380,1049,214,6416,166
41058,14,169,1465,127,3744,42
28881,464,19646,2161,14915,67004,4731
34903,2,270,1879,199,9140,71
35010,5,322,1874,219,4126,103
18582,45,2809,2682,2250,23798,559
15870,4,208,2813,176,10417,32
15170,62,2396,2844,1890,15896,506
32925,579,65408,1960,50468,95655,14940
36600,12,171,1774,139,3996,32
10606,10,312,3132,233,6424,79
21259,10,1013,2541,796,8822,217
9068,6,314,3215,235,12423,79
23907,21,599,2408,442,4372,157
38997,6,195,1617,165,9224,30
4354,290,11100,3474,8015,42590,3085
18729,0,37,2675,34,3826,3
32349,3,186,1984,154,4476,32
39206,22,856,1604,702,13871,154
2242,41,1740,3521,1447,40748,293
18388,4,87,2689,70,4740,17
36932,20,1287,1754,917,12129,370
11090,22,354,3106,267,5164,87
36136,0,46,1798,40,3778,6
25288,7,289,2346,234,2572,55
15141,152,12543,2846,9544,60107,2999
13627,44,953,2952,763,19957,190
9540,9,206,3185,158,8775,48
14194,1,142,2909,113,5344,29
7745,40,971,3309,745,14831,226
40837,49,1576,1485,1179,17226,397
22182,53,1576,2491,1162,10023,414
25040,219,6236,2356,4610,23741,1626
4493,4,56,3469,48,1931,8
43400,14,339,982,272,9920,67
42356,6,174,1248,119,8238,55
45377,12,108,478,73,2354,35
1560,5,150,3592,122,2870,28
21396,21,1608,2535,1265,13108,343
28427,531,35304,2186,26114,175609,9190
33165,17,324,1950,270,7464,54
30289,11,290,2090,230,4801,60
31447,0,259,2031,210,8083,49
22163,266,7436,2492,5697,48034,1739
5819,5,191,3404,151,4294,40
10735,26,2323,3124,1743,23008,580
14645,39,2267,2876,1703,19122,564
30743,3,283,2064,224,5893,59
44738,19,331,687,245,5354,86
41357,11,191,1423,158,3932,33
25789,29,1178,2322,922,9660,256
4636,3,191,3463,160,3219,31
41827,9,462,1345,336,14932,126
4584,31,1154,3465,914,10364,240
20569,7,174,2584,143,2843,31
31553,4,148,2025,108,4296,40
3716,29,773,3494,541,8028,232
32004,11,482,2002,375,6653,107
28838,2,84,2163,74,1965,10
12373,11,744,3039,550,12940,194
14354,27,1273,2897,1003,11085,270
43010,41,585,1098,409,8773,176
20876,29,1352,2566,922,13714,430
3800,1,65,3492,52,2008,13
3931,155,5712,3489,3984,86975,1728
8808,8,514,3229,372,2917,142
23414,6,247,2431,190,8744,57
28206,4,352,2199,271,6585,81
20036,6,355,2612,280,6479,75
13302,119,5991,2977,4516,30699,1475
33605,96,3378,1934,2582,24625,796
25425,98,4818,2340,3531,66497,1287
8954,344,25940,3221,19079,52475,6861
12038,221,14422,3059,10507,99298,3915
6664,7,66,3368,54,3786,12
30381,58,1929,2084,1538,7642,391
26877,10,400,2273,340,5852,60
37627,9,268,1710,180,9313,88
37509,0,73,1718,66,2358,7
31426,9,233,2032,200,4013,33
31252,8,258,2042,198,3110,60
21548,0,66,2526,49,3784,17
38813,2,15,1629,11,2092,4
32968,7,446,1959,363,5397,83
13503,9,995,2961,765,17647,230
41976,1,69,1322,56,8298,13
25332,337,14875,2343,10893,81798,3982
33122,4,161,1952,134,5833,27
42458,1,36,1227,29,2451,7
37281,34,1728,1732,1401,6499,327
3614,19,647,3496,527,7432,120
15061,28,1209,2850,980,13911,229
6507,347,12669,3375,9324,80557,3345
27315,6,130,2251,111,2272,19
46339,7,58,115,53,1660,5
36842,50,2753,1759,2245,24124,508
30185,3,96,2095,78,2572,18
16533,1160,61020,2781,42515,140592,18505
13591,279,20378,2954,14101,111318,6277
3239,9,217,3503,184,7556,33
31997,1,50,2002,41,1660,9
41079,2,115,1462,92,5493,23
39372,21,776,1594,588,7459,188
38799,9,269,1630,205,11438,64
38282,1,84,1665,68,3680,16
36171,4,104,1796,87,2271,17
21416,574,24781,2534,19241,163605,5540
22582,169,7558,2471,5360,52305,2198
45536,85,850,435,727,6127,123
8546,4,286,3246,223,9851,63
24689,3,91,2371,75,5024,16
40554,11,232,1511,178,4122,54
16137,151,5471,2800,4163,23173,1308
3370,9,244,3501,183,3627,61
12353,17,555,3041,399,20707,156
1443,2,91,3642,81,2087,10
7366,4,520,3331,405,7861,115
2876,568,29038,3510,19887,184710,9151
13006,91,3146,3003,2261,27910,885
5132,83,8958,3439,6390,126517,2568
13117,19,1782,2995,1353,29266,429
45754,141,2726,342,2107,30218,619
29996,24,1118,2105,876,21226,242
32422,13,508,1982,320,8850,188
3157,17,210396,3505,75721,6961,134675
12508,59,3471,3031,2398,29657,1073
41098,25,1912,1460,1340,18718,572
32739,83,1295,1969,997,10974,298
10469,4,67,3140,50,3670,17
12886,185,8473,3011,6339,61692,2134
6860,3,98,3359,77,2553,21
18544,36,1162,2683,922,21549,240
19380,68,1816,2647,1386,12781,430
12785,1252,113128,3017,76141,752907,36987
39811,9,247,1569,207,6328,40
17328,6,413,2737,280,3310,133
8036,35,2361,3277,1863,25008,498
46260,18,197,147,149,2418,48
35876,4,77,1817,70,2095,7
5468,33,495,3422,390,5924,105
45040,51,526,594,440,11923,86
10353,24,1689,3146,1246,18358,443
8307,5,46,3262,38,2283,8
13675,8,523,2948,367,6613,156
33965,0,17,1922,12,1754,5
45382,53,507,477,398,8576,109
5947,92,3683,3397,2336,36077,1347
9613,7,395,3180,291,6216,104
27611,0,0,2233,0,2969,0
34030,50,2318,1919,1829,24916,489
28199,7,113,2199,89,2026,24
35992,26,272,1809,212,6754,60
45245,9,70,516,49,2518,21
13581,149,11068,2955,7748,73006,3320
10108,0,72,3157,55,1889,17
25342,0,12789,2343,9783,77321,3006
25712,2,465,2326,365,7709,100
45452,6,78,458,52,2417,26
44877,16,95,644,86,1947,9
6918,63,2824,3356,2023,26161,801
8293,136,4466,3263,3440,38198,1026
32484,11,246,1979,209,4619,37
24213,12,219,2394,194,3466,25
38389,5,307,1658,237,3341,70
9858,633,47860,3169,32247,162549,15613
5225,5,182,3434,154,12689,28
37646,1,35,1709,26,3271,9
5237,14,398,3433,335,6158,63
15565,30,1858,2826,1447,17274,411
26002,6,248,2313,212,1807,36
24536,3,192,2378,148,4474,44
33024,3,228,1956,176,6314,52
41387,1,29,1419,23,2495,6
36226,10,823,1794,562,7922,261
40268,10,441,1538,359,10139,82
39611,200,10630,1580,7876,59752,2754
4920,9,276,3450,207,7257,69
12164,6,270,3051,209,4693,61
3165,36,1333,3505,1063,19140,270
10725,12,595,3125,486,18048,109
18773,8,367,2673,296,5565,71
28482,31,602,2183,471,5654,131
1618,3,109,3582,81,4305,28
38833,7,206,1627,164,2598,42
40224,67,2593,1542,2040,22256,553
12326,0,50,3043,43,2672,7
39954,1,53,1559,43,2771,10
29204,8,169,2145,136,6421,33
27734,27,1296,2226,1099,12113,197
39071,251,14704,1612,10893,91780,3811
27437,235,15761,2244,11073,61240,4688
22272,84,4754,2486,3643,38568,1111
22148,5,308,2492,216,3257,92
11989,133,7380,3060,5836,65380,1544
8837,8,294,3228,239,5303,55
15751,8,342,2817,276,5050,66
37910,493,18880,1690,13993,111238,4887
18276,9,432,2694,325,4778,107
34674,10,271,1892,207,6324,64
3039,43,1396,3507,1068,13417,328
17380,1,121,2734,107,4332,14
19816,5,211,2623,176,7116,35
28253,5,520,2196,398,9128,122
29068,2,44,2151,34,5199,10
41644,18,372,1380,295,19605,77
40993,104,4171,1473,2972,44105,1199
10414,4,178,3143,137,13906,41
27182,37,1293,2259,965,16010,328
29769,12,335,2116,266,4342,69
39001,12,696,1617,492,14877,204
41523,59,504,1400,385,6214,119
20087,21,845,2609,516,12560,329
46150,0,31,181,30,2244,1
28766,44,2992,2166,2178,18616,814
8494,31,2437,3249,1763,14680,674
13785,7,316,2939,262,7403,54
3905,9,446,3489,330,12916,116
13084,34,1194,2998,1013,7919,181
40788,8,183,1491,139,3553,44
13511,11,222,2960,177,5183,45
30396,83,9483,2083,6972,81976,2511
37447,122,1510,1722,1108,8815,402
37177,329,14033,1739,10735,88874,3298
37965,124,3779,1687,2627,23316,1152
11162,577,33508,3101,26057,97170,7451
23470,6,336,2428,285,7065,51
23136,13,1394,2445,1023,17987,371
23267,35,1675,2438,1374,13400,301
34314,123,4040,1910,3209,43893,831
35364,35,383,1855,313,4852,70
45847,111,1254,310,1080,11224,174
9293,6,199,3201,149,8562,50
24532,2,446,2379,357,5880,89
2844,8,220,3511,133,4234,87
40770,4,124,1492,100,8938,24
10492,2,69,3139,59,4117,10
4131,15,627,3482,498,3897,129
9813,25,441,3171,352,12326,89
28139,8,293,2204,237,7323,56
44213,58,793,784,635,17069,158
2585,86,7516,3515,5521,47521,1995
10233,142,3512,3152,2642,39725,870
10607,43,1430,3132,1103,15175,327
6455,11,1050,3377,851,16557,199
11384,12,382,3091,304,7441,78
39133,97,7384,1609,5618,31984,1766
13635,23,1949,2952,1504,22135,445
44666,19,187,712,146,3638,41
1472,3,46,3617,39,2388,7
22918,39,652,2455,503,7700,149
46071,0,14,210,14,1077,0
4668,8,148,3462,121,4598,27
39030,3,190,1616,152,4856,38
38430,146,3400,1655,2555,36832,845
10926,1,23,3114,17,2003,6
10978,205,6426,3112,4668,118057,1758
27967,20,522,2212,442,3424,80
41495,6,147,1402,112,5943,35
36880,1,48,1757,41,1530,7
43164,30,526,1053,356,7080,170
2205,69,2190,3521,1464,17975,726
29638,547,27374,2122,20183,69830,7191
20254,1,152,2599,104,2008,48
14974,1,35,2855,28,2347,7
34291,28,542,1911,384,4195,158
40249,0,38,1540,27,1811,11
20922,20,452,2562,359,3005,93
46292,4,170,134,135,2224,35
25694,1,56,2326,48,1954,8
22232,733,35442,2488,24655,192155,10787
22074,259,11933,2496,8030,78135,3903
16223,1,65,2796,57,6554,8
20662,40,1832,2580,1522,41357,310
19341,3,260,2648,217,4314,43
32897,7,252,1961,176,18461,76
25705,20,2570,2326,1690,9376,880
8761,27,909,3232,646,7313,263
30975,0,36,2055,35,2587,1
36214,4,84,1795,72,2646,12
14843,0,86,2863,69,5492,17
9364,11,492,3196,373,3892,119
32374,45,883,1983,660,5369,223
14228,31,1773,2907,1446,20511,327
42288,8,250,1262,181,6090,69
3397,19,412,3500,304,18293,108
29943,21,662,2107,500,10643,162
22789,16,1283,2462,1029,12108,254
26535,111,3780,2288,3035,19698,745
9607,5,355,3180,271,11635,84
37892,5,151,1692,118,3919,33
14755,9,741,2868,569,7607,172
27931,402,34654,2214,22907,144281,11747
8747,2,349,3233,263,6148,86
31190,6,100,2044,84,2791,16
16553,16,766,2780,539,17529,227
41939,297,8139,1329,5939,81038,2200
39081,0,58,1612,48,1936,10
40258,7,203,1539,155,2827,48
12008,0,69,3059,54,1948,15
1874,3,99,3528,87,6664,12
13109,29,958,2996,779,19507,179
18703,22,696,2676,513,9015,183
17894,275,10732,2713,8071,75549,2661
29935,27,987,2107,778,8406,209
15570,0,1206,2825,923,11151,283
34345,1,41,1909,33,1775,8
12876,36,2052,3011,1693,24137,359
20796,7,425,2571,361,4985,64
31003,63,6599,2054,5184,27825,1415
3017,14,705,3507,567,8943,138
43713,28,521,878,442,5975,79
16051,11,359,2804,263,5824,96
5380,17,529,3426,434,33583,95
9670,16,534,3178,436,4599,98
6627,248,9566,3370,7306,203936,2260
37619,10,304,1711,228,7185,76
44758,27,445,680,325,6871,120
18158,57,2534,2700,1951,19200,583
5187,6,102,3436,84,2469,18
20279,9,345,2598,297,5971,48
6284,1,131,3385,103,3724,28
14457,5,31995,2889,10743,8336,21252
42008,1,61,1317,45,2218,16
18192,0,112,2698,83,10475,29
36678,6,171,1770,151,7476,20
44788,60,519,672,383,5439,136
23471,14,938,2428,795,13562,143
34740,5,490,1889,347,10575,143
2181,5,142,3522,109,4670,33
3699,60,713,3494,586,14439,127
44858,44,524,647,463,6933,61
40742,9,142,1496,115,4204,27
13256,3,503,2980,402,5746,101
2890,10,291,3510,246,14752,45
36380,1,110,1786,77,3413,33
29641,80,3567,2122,2796,36285,771
26471,1,95,2292,82,5130,13
39029,33,710,1616,564,10123,146
23947,326,30375,2405,22915,125331,7460
26219,700,28987,2303,22922,126979,6065
21810,3,75,2512,61,2106,14
38881,0,36,1624,28,4859,8
23918,4,164,2408,131,3190,33
24748,25,668,2368,508,11498,160
44285,44,404,776,339,9852,65
26208,19,558,2303,468,12506,90
13542,102,2257,2957,1748,19896,509
13766,13,617,2940,474,4707,143
34528,27,2055,1900,1576,19376,479
23393,43,3258,2432,2594,29851,664
25585,18,878,2332,650,11886,228
29537,5,584,2127,478,13094,106
30583,13,438,2073,365,5577,73
20593,2,87,2583,54,2035,33
27707,14,235,2227,184,8089,51
8424,30,1449,3254,1105,33388,344
28064,0,19,2207,17,1981,2
46246,4,16,150,12,998,4
15999,59,1563,2807,1184,13228,379
8738,10,636,3234,524,7914,112
7085,37,2279,3346,1415,21575,864
28112,0,96,2205,82,4312,14
37597,1,133,1713,94,3923,39
37230,55,2138,1736,1704,19020,434
40777,30,1298,1492,959,21695,339
36671,35,421,1770,343,7698,78
13206,6,183,2983,151,3773,32
43706,35,868,880,577,8803,291
20309,2,107,2597,82,4736,25
45092,6,150,569,93,5576,57
7804,26,2390,3304,1895,31970,495
16362,69,1914,2789,1468,16929,446
29671,10,265,2121,218,3294,47
46351,0,36,111,25,1108,11
34111,395,6721,1916,5110,25039,1611
32585,19,1148,1975,896,12154,252
7250,11,183,3338,150,3787,33
39177,18,253,1606,214,5338,39
11846,31,1262,3068,1040,10245,222
12543,3,102,3031,74,2463,28
32257,14,275,1989,200,5068,75
18918,8,497,2667,403,9675,94
46073,12,173,210,128,991,45
17165,2,0,2745,0,58767,0
40701,545,12086,1499,8595,108654,3491
38479,6,224,1652,178,8452,46
35255,53,2157,1859,1810,20433,347
11278,153,11793,3096,9201,59660,2592
7024,66,1470,3350,1089,26987,381
39403,128,3614,1592,2659,39191,955
3446,69,2427,3500,1842,19566,585
1011,8,156,3834,141,4982,15
11128,4,205,3104,173,3839,32
46300,6,109,131,102,2255,7
35851,36,511,1819,431,7862,80
4980,18,605,3448,518,15846,87
3585,229,4720,3497,3510,16931,1210
11558,7,150,3081,125,4620,25
16429,52,4921,2786,3795,21812,1126
13661,7,50716,2949,16218,23765,34498
44146,2397,68957,797,49369,381273,19588
40849,14,436,1484,359,15954,77
27622,8,161,2232,131,7037,30
42283,17,461,1263,292,8112,169
9261,2,363,3203,291,17373,72
6407,12,164,3379,129,2384,35
15713,31,2590,2819,2015,13383,575
17889,10,757,2713,572,12216,185
22170,290,17016,2492,11913,56374,5103
39777,17,687,1572,552,11867,135
33069,2,148,1954,119,3298,29
27770,48,3002,2224,1790,11894,1212
45463,2,44,456,20,1621,24
38231,12,245,1669,183,6739,62
15779,2,54,2816,49,3998,5
24368,12,425,2387,307,4530,118
24708,26,1343,2369,972,11394,371
3219,44,1695,3504,1387,27080,308
27693,9,285,2229,230,5934,55
8244,16,350,3266,261,4700,89
4180,6,164,3480,133,11141,31
28989,179,5492,2156,4104,55140,1388
37531,17,318,1716,219,9770,99
36831,51,816,1760,654,15399,162
45632,44,367,398,296,7820,71
18237,58,4401,2696,3226,32293,1175
29351,3,106,2136,86,2130,20
15833,19,1001,2814,750,7141,251
2213,157,5556,3521,4178,49089,1378
3831,2,100,3492,77,4120,23
22920,8,363,2454,276,11601,87
21784,25,672,2513,520,5338,152
45638,22,370,338,328,3122,42
20930,11,265,2562,226,2395,39
16524,20,1695,2781,1228,23804,467
45021,99,1131,602,872,9891,259
27883,9,281,2218,242,5872,39
43664,6,102,893,58,4038,44
40090,2,107,1550,81,3610,26
25014,483,21625,2357,15137,151133,6488
18881,3,275,2668,217,4678,58
14382,53,3652,2894,2435,40793,1217
8915,22,1080,3224,820,8605,260
12069,170,9816,3057,6701,76493,3115
28408,0,177,2187,150,5882,27
36602,3,72,1774,65,4638,7
46131,115,2055,190,1667,11643,388
12058,9,572,3058,446,5246,126
9938,12,488,3166,393,6852,95
23564,9,387,2424,319,7670,68
38772,1,82,1631,63,2552,19
25866,29,582,2319,479,8263,103
26499,15,637,2290,491,16290,146
1890,5,120,3528,96,4821,24
37767,32,1226,1701,1000,25127,226
40046,85,5300,1552,3907,35676,1393
31100,5,197,2049,165,6201,32
27972,333,11585,2212,9276,70763,2309
12141,15,788,3052,663,9426,125
22175,20,1496,2491,1125,10328,371
16050,9,405,2804,342,5769,63
41582,5,103,1391,89,4430,14
35067,7,270,1870,201,8758,69
9297,31,1355,3201,967,23794,388
35226,2,28,1862,22,3367,6
23026,67,1644,2450,1166,8447,478
7414,8,66,3328,40,6103,26
35024,1,80,1873,64,2670,16
6528,5,388,3374,301,5009,87
40007,75,1385,1555,1132,6281,253
44884,5,63,643,55,3260,8
11080,40,756,3107,614,4427,142
45622,48,605,401,484,9471,121
22303,2,33,2485,28,1834,5
24843,1,133,2365,109,3723,24
36771,12,643,1765,492,13562,151
3969,47,1920,3487,1375,21900,545
3813,43,10228,3492,6184,28814,4044
44724,16,131,692,103,3860,28
19427,38,3261,2644,1890,25599,1371
6118,10,200,3391,159,4302,41
33558,2,45,1936,28,3036,17
17854,0,188,2715,149,4232,39
23812,5,218,2413,168,3682,50
26128,4,227,2308,170,2700,57
38725,1,101,1634,80,4577,21
44166,66,803,793,618,25276,185
12313,16,288,3043,213,4185,75
20285,8,441,2597,365,5850,76
14794,143,10216,2865,7450,39404,2766
8357,379,200608,3258,65295,122574,135313
45486,12,227,449,156,4104,71
26837,5,286,2275,236,3016,50
28649,523,17560,2172,12397,150804,5163
28141,5,220,2204,184,8238,36
26361,8,791,2296,652,8208,139
1672,19,491,3566,419,8676,72
27612,61,1604,2233,1281,14848,323
3362,8,106,3501,79,4777,27
2780,453,15457,3512,10435,69738,5022
40751,43,1372,1494,1071,25937,301
34709,6,199,1890,141,4181,58
24147,289,31663,2396,22403,118116,9260
22914,19,248,2455,219,2324,29
2595,9,223,3515,171,6490,52
28202,17,1029,2199,830,6599,199
38566,46,1398,1645,1004,16626,394
34058,12,383,1918,312,15671,71
24339,12,1077,2388,898,12947,179
39459,9,347,1589,238,5370,109
1227,1,72,3764,61,3528,11
25953,58,4188,2315,2796,17153,1392
36128,31,876,1799,698,12757,178
31353,8,719,2036,650,4267,69
25424,11,553,2340,437,8572,116
22340,4,745,2483,538,3267,207
38716,0,109,1635,80,3943,29
16193,5,73,2798,55,2491,18
18433,14,494,2687,384,6534,110
20476,31,578,2589,489,6645,89
3749,14,352,3493,263,6967,89
33955,51,1467,1922,1093,23957,374
45260,21,180,511,133,3046,47
42177,74,1519,1284,1115,24849,404
41958,38,1183,1325,900,19750,283
45893,15,160,294,127,2832,33
2422,94,3133,3518,2538,21875,595
5816,1,50,3404,39,4286,11
41089,8,143,1462,104,4521,39
13492,4,98,2961,88,3065,10
7187,87,1632,3341,1293,36816,339
9828,8,232,3170,199,10255,33
41953,14,213,1326,171,4361,42
27330,3,282,2251,222,4425,60
32275,1,127,1988,106,8184,21
27577,0,69,2235,53,2500,16
19064,9,514,2662,387,15316,127
39286,26,573,1598,455,9080,118
36394,0,70,1785,60,2805,10
32742,14,602,1969,485,5150,117
11182,558,78189,3100,52179,226622,26010
15349,70,2679,2836,1962,31851,717
45609,130,1421,411,1093,10403,328
24124,27,1686,2397,1280,23836,406
6145,11,517,3390,391,8025,126
42032,1,23,1314,22,5387,1
29613,4,120,2124,100,3515,20
35105,1,175,1868,145,2063,30
41365,0,88,1422,68,2355,20
5568,227,11353,3417,8261,64207,3092
20086,3,65,2609,53,2363,12
34432,9,721,1905,497,12380,224
23003,57,3374,2451,2459,25046,915
2819,22,735,3511,503,8611,232
36078,13,1082,1802,679,11201,403
19344,11,3357,2648,2436,11864,921
26689,144,3547,2282,2559,13955,988
39237,13,451,1602,364,9080,87
6165,22,664,3389,410,20487,254
3759,7,222,3493,187,9865,35
21601,16,2397,2523,1889,14641,508
3939,25,1180,3489,798,13994,382
20210,3,194,2602,143,3936,51
26906,34,737,2271,607,6615,130
5451,4,171,3422,143,7518,28
21235,33,932,2542,757,16953,175
34257,67,2410,1912,1818,30241,592
26608,0,82,2286,68,6035,14
13233,184,6419,2982,4711,38582,1708
22801,21,773,2461,585,6798,188
32948,37,1270,1960,1048,24447,222
16365,89,3524,2789,2712,37271,812
28395,61,3643,2188,2664,43723,979
4009,10,481,3486,392,4961,89
4139,184,4881,3482,3581,43345,1300
35806,0,52,1822,44,2857,8
1696,4,111,3564,91,3880,20
32110,21,735,1996,587,5164,148
1680,0,34,3565,31,1647,3
22432,7,313,2479,241,4668,72
37919,2,79,1689,52,6026,27
35786,6,524,1823,389,8749,135
24298,4,217,2389,153,3967,64
38041,22,345,1682,275,9405,70
18373,19,2079,2690,1583,22599,496
45785,4,42,331,32,1330,10
31931,0,97,2006,86,5279,11
8211,33,1089,3268,826,10003,263
21489,17,634,2530,470,6881,164
18406,11,644,2689,522,9826,122
32789,27,1028,1966,786,17702,242
36497,25,461,1780,356,6344,105
22763,28,1581,2463,1128,14638,453
33807,0,136,1926,118,2557,18
38250,1,99,1667,85,4210,14
7774,2,160,3306,119,4219,41
31364,7,122,2036,105,3753,17
33701,0,0,1931,0,9208,0
41547,4,296,1396,224,6227,72
45923,2,153,280,116,3473,37
29749,11,475,2117,385,6049,90
38251,226,3323,1667,2340,21023,983
37455,0,52,1722,43,4225,9
10582,141,6348,3134,4641,54302,1707
3758,11,348,3493,270,5421,78
15567,0,318,2825,238,4552,80
42645,83,1547,1191,1081,16133,466
23001,4,205,2451,136,4794,69
22135,1167,47424,2493,36580,207361,10844
35297,38,493,1858,375,6722,118
1219,6,279,3766,225,9450,54
32749,3,407,1968,353,6210,54
20661,7,267,2580,220,8184,47
41306,11,325,1430,225,5495,100
8655,16,438,3239,304,10898,134
6979,6,354,3352,276,6823,78
31175,1,44,2045,36,3191,8
16994,81,4087,2757,2936,30270,1151
17832,1,71,2715,46,3308,25
11235,2,97,3098,67,2601,30
45956,22,165,262,109,1783,56
12804,57,6288,3015,4734,65711,1554
16301,16,1043,2792,815,7789,228
40534,1,85,1514,62,2832,23
9079,13,1015,3214,853,4181,162
32772,4,196,1967,167,5693,29
18120,41,2704,2701,2068,18390,636
20816,3,152,2570,132,3904,20
5697,13,554,3409,414,5518,140
7633,348,18658,3315,13209,112744,5449
39362,88,3458,1594,2593,19932,865
30657,3,159,2068,136,4920,23
35460,0,104,1849,86,9166,18
2745,9,631,3513,520,8500,111
29741,7,227,2118,177,7269,50
9648,1,42,3179,36,1695,6
30383,28,1360,2084,1033,25511,327
27681,1,37,2229,31,1051,6
11197,2,115,3100,94,3205,21
27416,4,108,2245,89,2649,19
15874,24,423,2813,345,5245,78
38582,100,2362,1644,1742,13150,620
25816,7,753,2321,591,11822,162
40890,23,340,1481,258,2880,82
17853,1,144,2715,115,3816,29
17184,73,1668,2745,1196,13885,472
43316,10,184,1010,156,13830,28
16289,45,1335,2793,1049,10195,286
40728,64,1562,1497,1169,31646,393
44140,364,5639,799,4546,49152,1093
37800,1,42,1698,35,3463,7
24191,2,76,2394,61,3675,15
10658,58,3935,3129,2924,33276,1011
28607,272,11239,2174,7362,59471,3877
5643,2344,137938,3412,91401,512959,46537
8584,13,473,3243,373,5829,100
33698,43,748,1931,531,6845,217
9168,9,372,3208,293,7248,79
16338,15,1589,2791,1238,13414,351
27194,1,90,2259,78,1833,12
22523,9,265,2474,220,4922,45
24461,4,121,2382,87,6953,34
38694,26,1365,1636,1026,14931,339
19136,0,1315,2659,995,5642,320
45856,4,92,307,54,3552,38
46199,314,15910,162,12190,45667,3720
39056,62,3180,1614,2260,16950,920
44221,124,1088,782,937,15763,151
38499,11,182,1650,149,4949,33
42473,72,856,1224,632,12022,224
28999,8,232,2155,213,14262,19
2072,510,42983,3523,29946,141543,13037
22588,3,173,2471,146,3172,27
15304,12,986,2837,773,11380,213
31428,4,137,2032,121,7082,16
4812,0,27,3456,20,2689,7
41486,73,1214,1404,820,19109,394
31438,0,47,2032,41,1842,6
4907,13,610,3451,405,7487,205
46155,36,595,177,513,8870,82
20812,6,245,2570,200,3251,45
27723,9,247,2227,193,2715,54
6640,69,2709,3369,2060,27258,649
6237,7,99,3387,78,7390,21
11304,133,4796,3095,3663,126246,1133
42881,257,3361,1134,2730,24649,631
33888,369,10168,1924,7659,82195,2509
46373,12,161,99,128,3368,33
23774,84,3730,2414,2964,36844,766
15443,331,25816,2832,18278,186101,7538
34600,65,2315,1897,1752,26959,563
1943,69,2349,3526,1712,18139,637
11279,42,2822,3095,2192,46821,630
7386,0,56,3330,48,2935,8
2478,53,1083,3517,895,8718,188
28217,5,225,2198,167,2779,58
22474,458,37292,2477,26659,148505,10633
26051,56,923,2310,672,10621,251
42556,96,2733,1208,1974,19583,759
27356,14,573,2249,445,8127,128
41686,109,3386,1374,2465,27871,921
7470,7,118,3326,95,3298,23
41948,153,1927,1327,1445,15403,482
43504,128,1972,952,1559,12534,413
37354,1,73,1729,49,4134,24
25397,9,351,2341,279,3979,72
40811,20,488,1488,347,8976,141
4434,6,176,3471,138,5481,38
7678,7,340,3313,273,9251,67
34124,0,25,1916,21,1392,4
11297,94,5492,3095,4225,37189,1267
32331,3,41,1985,32,3675,9
43392,9,106,983,88,2550,18
25001,55,1031,2358,835,7881,196
32485,6,218,1979,177,5004,41
12824,0,205,3014,162,6716,43
45701,13,169,366,134,3135,35
28339,15,1532,2191,1079,17212,453
15232,41,2743,2841,2220,31930,523
21555,25,1118,2526,786,6663,332
19850,0,1388,2622,1161,14818,227
46134,27,300,189,248,2913,52
2640,2,111,3514,83,3749,28
29422,98,1609,2133,1214,11496,395
42960,47,815,1114,671,12690,144
17105,4,414,2749,305,6081,109
25423,51,1558,2340,1175,8694,383
16848,32,931,2764,709,5395,222
2137,9,832,3522,537,11406,295
17396,8,477,2733,346,11806,131
42888,34,1111,1132,832,30365,279
31159,24,1026,2046,783,10563,243
22244,10,517,2487,417,11318,100
39803,1,40,1570,32,2609,8
7921,0,36,3292,28,1727,8
10165,40,1421,3155,1089,5738,332
40368,2,61,1528,47,10443,14
11840,2,85,3068,68,5347,17
42174,3,49,1284,32,2605,17
2310,24,1463,3520,1047,27707,416
12451,155,7398,3034,5894,71323,1504
44001,155,1300,823,1079,10136,221
5262,115,10466,3432,8473,92684,1993
34567,2,72,1898,61,6086,11
35141,3,101,1866,82,4674,19
5482,6,227,3421,117,3806,110
45771,51,501,333,436,7381,65
27877,5,314,2218,265,7332,49
14293,4,93,2902,79,4179,14
28828,3,120,2163,91,1458,29
42382,19,551,1244,389,19551,162
15446,313,20327,2832,13560,95255,6767
32197,20,514,1991,415,11006,99
22253,21,719,2487,554,14029,165
5792,7,186,3405,147,4883,39
25188,0,212,2349,167,3983,45
35221,71,2324,1862,1778,51855,546
18767,4,293,2673,242,7449,51
23503,38,3491,2427,2536,30122,955
31081,11,367,2050,312,16755,55
29775,5,352,2115,272,3703,80
27401,0,90,2246,73,2374,17
27676,143,4579,2229,3569,28884,1010
5857,41,175349,3402,64700,38855,110649
30168,65,2107,2097,1731,12414,376
8766,354,12363,3232,9566,62178,2797
8200,14,489,3269,413,8224,76
30567,23,702,2073,556,8674,146
22072,12,459,2496,315,11875,144
35554,13,214,1842,171,3774,43
35472,42,1256,1848,1004,10748,252
7587,20,658,3318,449,11026,209
32276,5,104,1988,92,2685,12
37025,4,322,1749,266,5340,56
32730,60,1317,1969,1039,21719,278
5767,20,348,3407,278,4768,70
36411,170,3116,1785,2386,13389,730
14125,7,227,2913,182,7912,45
3238,21,420,3503,324,6976,96
32876,26,586,1962,466,5153,120
3740,8,346,3494,292,5103,54
34676,32,344,1892,285,6157,59
13601,34,1068,2954,777,9042,291
45555,14,436,425,306,6188,130
4790,56,1682,3457,1280,22858,402
1837,10,386,3529,277,14297,109
6159,43,1578,3390,1222,50583,356
9738,6,225,3175,181,4705,44
31611,50,2922,2022,2127,24018,795
27124,32,546,2263,420,6058,126
27057,1,42,2267,37,1949,5
24303,6,212,2389,147,7729,65
8889,4,63,3225,51,2338,12
5096,61,2140,3441,1733,9046,407
41073,26,538,1463,391,5476,147
45605,2,57,413,33,2472,24
29366,0,90,2135,82,2855,8
40986,3,94,1474,75,9171,19
17817,12,638,2716,503,10471,135
43417,15,303,976,235,5499,68
34844,34,2070,1882,1739,8696,331
5549,1,107,3418,83,6569,24
3604,37,1182,3497,865,19710,317
35222,254,10922,1862,7351,44823,3571
7947,9,488,3290,375,13365,113
24186,0,45,2395,36,3585,9
12051,13,1007,3058,759,5286,248
4826,60,1790,3456,1468,9231,322
45207,18,177,527,116,2894,61
7666,17,525,3313,409,6842,116
10221,23,395,3152,308,6316,87
2659,39,1117,3514,909,14595,208
11566,2,66,3081,55,1181,11
3081,36,802,3506,638,4909,164
32338,6,720,1985,484,4812,236
17560,13,651,2726,526,8492,125
17913,25,1685,2712,1225,19924,460
5621,17,674,3414,557,8817,117
34308,15,681,1910,564,12521,117
22525,19,1357,2474,1038,14524,319
3185,22,1029,3504,771,12353,258
20807,0,924,2570,732,12033,192
16714,1,598,2772,417,8474,181
43149,4,193,1057,145,5266,48
45917,13,175,284,148,1960,27
3970,0,83,3487,38,1826,45
29874,0,49,2110,37,2574,12
36730,100,3259,1768,2568,19075,691
31272,96,4530,2040,3310,36044,1220
6189,314,7517,3389,5171,57903,2346
7646,7,407,3314,338,6322,69
10975,17,483,3112,368,6854,115
9231,9,253,3205,218,13077,35
24412,0,8596,2384,6527,33089,2069
32302,0,34,1987,29,2136,5
12699,9,219,3021,179,7370,40
40349,0,41,1531,36,3218,5
5084,6,102,3443,76,3094,26
4140,0,33,3482,29,2590,4
38662,189,2167,1638,1675,10289,492
41119,12,287,1457,214,5754,73
21248,555,35614,2542,26118,202105,9496
20840,25,937,2569,742,6742,195
4463,3,276,3470,216,2890,60
44806,11,80,665,70,1563,10
30634,2,138,2070,117,8061,21
9790,37,648,3173,542,11172,106
17160,69,2270,2746,1806,40047,464
11097,33,605,3105,436,12299,169
8712,114,1847,3235,1375,15919,472
4502,7,208,3469,184,8868,24
10238,275,17198,3151,12948,73869,4250
6549,32,1812,3373,1212,31965,600
21090,7,317,2553,233,9317,84
28019,113,18598,2210,12958,59780,5640
2312,29,1063,3520,747,6204,316
10391,0,65,3144,48,2265,17
30223,69,1588,2093,1221,16519,367
38126,19,381,1676,308,9691,73
16920,0,4391,2760,3386,39643,1005
38905,5,128,1623,92,3869,36
23030,21,653,2450,468,6020,185
33015,3,151,1956,125,7933,26
4716,26,869,3460,616,9486,253
13714,605,25364,2945,15949,220419,9415
6683,7,656,3367,480,15861,176
4197,39,1437,3480,1110,13334,327
45726,2,33,350,25,854,8
32481,15,547,1979,440,8957,107
3473,0,51,3499,44,3583,7
22772,22,789,2462,615,3301,174
18075,12,460,2703,382,3532,78
9047,10,1216,3217,958,27728,258
17999,8,324,2706,241,3866,83
16730,3,146,2771,112,3433,34
39836,2,81,1568,59,3546,22
6534,56,1392,3373,1018,16675,374
2158,6,224,3522,190,6631,34
28109,9,453,2205,365,7761,88
31183,353,46838,2045,32775,129930,14063
3706,74,2230,3494,1767,21886,463
10119,5,70,3157,59,2604,11
17158,81,1855,2746,1468,16408,387
25596,5,182,2331,144,4375,38
10331,16,872,3147,698,6779,174
46175,1,75,169,57,2342,18
16727,15,1076,2771,853,16064,223
41525,3,96,1399,81,7803,15
45215,4,28,524,18,1991,10
43628,23,660,907,544,11543,116
32988,5,115,1958,87,2500,28
6272,12,299,3385,240,2620,59
33005,28,524,1957,447,9727,77
28016,11,687,2210,534,9698,153
1908,195,5066,3527,3359,19882,1707
26768,5,765,2278,635,11399,130
1792,126,8143,3532,6077,45577,2066
29739,6,78,2118,59,4251,19
9212,19,680,3206,523,6138,157
37766,2,176,1701,132,5582,44
11206,346,15074,3099,10727,90468,4347
43231,3,88,1034,67,3248,21
36127,3,80,1799,71,2747,9
10319,12,197,3148,156,8241,41
2546,39,556,3516,481,25775,75
18782,1,280,2672,218,7632,62
11825,2,144,3068,114,3483,30
26214,126,7360,2303,5528,22373,1832
19279,4,136,2651,106,5081,30
42155,176,3550,1289,2280,46485,1270
2229,2,87,3521,80,3464,7
45966,32,257,259,224,4862,33
4591,33,483,3465,407,4515,76
21756,4,340,2515,281,7789,59
2476,8,921,3517,777,9273,144
9958,3,62271,3164,24314,2579,37957
37715,13,252,1705,206,5065,46
43267,0,50,1023,41,2428,9
28179,30,1140,2201,888,12190,252
31686,14,283,2017,226,4361,57
42762,38,598,1163,464,5168,134
39038,3,89,1615,74,8016,15
19691,88,3331,2632,2341,23287,990
43526,6,146,945,85,3685,61
38248,2,94,1667,76,6888,18
2183,13,452,3522,361,10042,91
10757,72,137388,3123,39580,46648,97808
6331,26,1006,3382,798,9935,208
34286,1,75,1911,61,2892,14
40564,15,241,1510,197,2837,44
5824,76,2808,3403,1868,14940,940
42815,3,56,1149,47,1975,9
20966,3,229,2560,188,3315,41
41356,97,2389,1423,1875,24782,514
14128,41,1442,2912,1181,24179,261
17082,13,449,2751,333,2737,116
12028,33,1326,3059,1090,10300,236
25889,2,108,2318,86,4946,22
18174,13,122,2699,101,4056,21
37638,23,375,1710,294,6535,81
25037,29,800,2356,602,8057,198
6226,258,8043,3387,6279,57218,1764
28220,1,141,2198,92,3616,49
45784,2,15,331,12,939,3
36237,5,182,1794,146,2235,36
24008,13,597,2402,464,3856,133
1279,3,53,3745,43,7045,10
37409,10,113,1725,96,3825,17
41320,6,122,1428,90,3344,32
12397,97,2380,3038,1851,15125,529
10073,97,6242,3159,4850,51259,1392
1802,37,2212,3531,1632,25457,580
32408,4,82,1982,76,1843,6
11249,166,7429,3097,5751,35946,1678
28541,2,48,2178,27,2700,21
8510,11,799,3248,597,17607,202
43674,33,304,892,265,4584,39
29288,25,603,2140,501,4633,102
29047,0,547,2153,438,6574,109
13525,9,365,2959,295,7843,70
42352,22,330,1249,246,6140,84
34347,2,111,1909,92,1979,19
37412,10,213,1725,184,3171,29
37239,14,483,1735,383,8360,100
13063,52,873,3000,695,15751,178
4854,23,443,3454,351,3431,92
40505,9,371,1516,303,7257,68
20293,41,1782,2597,1486,18685,296
10077,44,1362,3158,1077,17976,285
43508,10,253,951,193,6618,60
14559,0,158,2882,117,4857,41
27771,20,1343,2224,954,18861,389
40813,0,14,1488,10,1259,4
8908,108,4224,3224,3180,33696,1044
13727,63,5013,2943,3867,40140,1146
37942,6,129,1688,118,4993,11
12656,21,976,3024,752,16065,224
9219,229,16579,3206,11826,102208,4753
36005,17,539,1807,412,4529,127
24493,3,124,2381,90,3124,34
1927,6,190,3527,155,12137,35
3352,148,4712,3501,3863,35164,849
4896,32,2691,3452,2057,50148,634
12703,252,10311,3021,8018,68548,2293
39633,25,295,1579,257,4800,38
10207,4,341,3153,280,5830,61
44474,97,2192,746,1578,26928,614
41858,2,144,1341,107,2552,37
37527,8,114,1717,90,1984,24
34793,186,12739,1885,9435,49241,3304
25493,16,904,2337,687,8829,217
37654,5,185,1709,142,4838,43
39574,0,0,1582,0,3061,0
11679,1,80,3075,61,6236,19
23405,8,173,2431,147,2379,26
26792,34,1812,2277,1387,13087,425
21821,32,1718,2511,1260,18566,458
19896,3,202,2619,146,6827,56
10505,2183,170640,3139,113817,853730,56823
28081,2,255,2206,192,5943,63
45191,1,14,531,13,1567,1
23289,76,3303,2437,2630,19783,673
16636,20,1244,2776,985,11724,259
45589,187,3377,417,2526,17503,851
31908,145,4547,2007,3581,27789,966
33853,1,131,1925,98,4910,33
31359,52,2314,2036,1715,22354,599
17366,63,1266,2735,916,8706,350
40775,14,331,1492,239,6509,92
21967,17,1179,2502,920,13146,259
1665,3,142,3568,126,4895,16
19019,6,176,2663,153,9208,23
11654,16,1195,3076,879,19462,316
21091,9,625,2553,434,17323,191
30829,499,21771,2061,16193,90115,5578
40657,204,6634,1503,4799,53950,1835
39617,8,439,1580,329,6003,110
32147,5,137,1994,116,3486,21
20836,5,245,2569,212,6506,33
20959,0,113,2561,106,2660,7
3339,12,406,3502,314,13033,92
16313,10,202,2792,158,13510,44
44314,74,1250,770,892,11896,358
31036,115,1611,2052,1269,10833,342
2587,21,762,3515,594,22649,168
10092,74,3072,3158,2375,21756,697
39944,1,75,1559,58,2599,17
13602,119,5228,2954,3893,22434,1335
17304,24,1308,2738,1016,26917,292
43177,6,469,1049,296,9189,173
30785,45,2899,2063,2148,35623,751
38356,0,41,1659,28,3791,13
9306,8,639,3201,305,4634,334
32942,1,42,1960,35,2635,7
31329,84,3599,2037,2584,27195,1015
8939,95,4528,3222,3096,33004,1432
23126,8,189,2445,140,3923,49
40640,1,63,1504,50,3772,13
41076,250,5303,1463,3627,37580,1676
27754,23,737,2225,625,13612,112
7817,1,51,3303,46,1790,5
8021,35,722,3284,585,5324,137
28357,45,1950,2190,1626,12157,324
36759,1,42,1765,31,3862,11
40097,15,413,1550,277,9516,136
8254,91,3747,3265,2761,18683,986
10209,11,313,3153,236,6436,77
46038,2,12,225,8,1733,4
29177,0,42,2146,29,1516,13
2973,121,4356,3508,3253,114437,1103
11684,537,27107,3074,19420,269847,7687
20030,25,684,2612,522,3336,162
42990,11,312,1105,206,5228,106
41687,20,778,1374,548,13668,230
13322,44,1307,2975,1052,10325,255
29427,23,692,2133,566,8475,126
29082,4,313,2150,251,8963,62
10995,4,121,3111,93,2822,28
35727,192,5424,1828,4382,29588,1042
16851,71,4117,2764,3154,22676,963
31528,59,3435,2026,2775,31137,660
28913,0,56,2160,47,4890,9
1569,6,81,3590,65,5172,16
16146,45,1690,2799,1232,18785,458
20891,336,20744,2565,13999,117715,6745
31482,24,711,2029,563,7995,148
43175,25,509,1050,363,9156,146
35576,81,2269,1840,1627,17091,642
43172,8,160,1050,113,3715,47
7290,1,109,3336,94,7986,15
36628,7,263,1772,215,9061,48
24655,57,1936,2372,1489,21043,447
5463,2,128,3422,103,4137,25
5294,480,18914,3430,14049,219045,4865
38272,6,298,1666,259,2782,39
26157,98,7200,2307,4798,63689,2402
44207,25,126,785,111,3383,15
25908,105,8311,2317,6136,53957,2175
32996,24,837,1958,714,10047,123
40262,4,194,1539,154,8254,40
42134,29,376,1295,283,7129,93
15406,27,1109,2834,858,10039,251
19552,16,466,2638,375,6103,91
41757,58,2451,1361,1796,19301,655
4739,25,818,3459,618,18860,200
42289,8,217,1261,159,4412,58
9439,106,4460,3191,3387,63022,1073
8774,24,329,3232,251,3213,78
31563,5,390,2024,315,3155,75
5688,7,191,3410,125,4270,66
22907,571,44949,2455,29700,176740,15249
38386,7,136,1658,108,4498,28
40950,91,2263,1476,1571,18799,692
20352,3,613,2596,491,8947,122
6648,535,26500,3369,19812,149093,6688
42378,0,64,1245,39,4401,25
24726,43,3357,2369,2366,25018,991
22607,17,853,2470,696,9078,157
17856,10,708,2715,555,12018,153
35030,71,1578,1873,1238,13786,340
34804,38,2118,1885,1620,21956,498
13687,13,668,2947,493,8653,175
44751,89,1604,681,1180,19557,424
18988,45,825,2665,663,5660,162
37331,0,35,1730,28,1809,7
38415,5,306,1656,246,5667,60
14660,476,25155,2875,17973,90297,7182
15777,141,11221,2816,8672,56693,2549
1820,12,306,3530,187,5987,119
32751,5,146,1968,127,5630,19
42116,189,3480,1299,2600,26438,880
27857,5,169,2219,137,4917,32
35957,21,786,1812,607,15875,179
2244,1,77,3521,55,4658,22
41293,0,24,1431,19,7055,5
30051,57,3150,2102,2317,23328,833
10955,287,12326,3113,9489,183171,2837
3826,0,47,3492,28,2341,19
37687,2,120,1707,94,4041,26
37075,1787,76518,1745,41679,163027,34839
12427,1,102,3036,64,2609,38
45999,2,34,247,30,1770,4
43039,70,1206,1090,1002,29345,204
10806,38,1788,3121,1417,16993,371
9278,3,120,3202,92,9441,28
12098,3,75,3055,67,7715,8
45953,15,183,261,162,2924,21
15264,14,1101,2840,853,6471,248
38937,7,161,1621,132,5084,29
16572,20,1182,2779,866,14702,316
2667,4,93,3514,72,10022,21
16869,83,2034,2763,1651,10865,383
42163,44,1203,1287,1014,8768,189
2305,29,1949,3520,1541,9513,408
5388,6,66,3425,58,2348,8
13224,4,111,2982,96,6639,15
36818,37,1177,1761,876,9599,301
36146,2,169,1798,130,7160,39
20315,16,603,2597,486,11357,117
18308,14,803,2693,617,7332,186
11576,2,151,3080,119,9369,32
8179,5,85,3270,78,7215,7
31383,27,835,2035,683,7527,152
41107,38,324,1459,262,4404,62
15182,1,50,2844,36,4683,14
36155,2,139,1797,104,3740,35
24885,5,111,2363,76,5601,35
43743,26,483,870,368,17393,115
26816,38,3790,2275,2769,19320,1021
8713,9,265,3235,226,7538,39
17586,2,253,2724,163,7381,90
40237,50,1089,1541,811,21711,278
29925,5,487,2108,363,6403,124
25654,0,392,2328,299,4311,93
38223,46,977,1669,694,7422,283
37476,48,756,1721,584,15438,172
2272,173,3647,3520,2697,25956,950
31656,6,290,2019,241,3381,49
42741,3,146,1167,131,9456,15
2948,15,494,3509,399,11650,95
6085,23,790,3392,578,7166,212
15217,4,200,2842,157,4742,43
14213,3,250,2908,138,7804,112
45929,92,767,274,496,6773,271
8391,95,3462,3256,2515,55829,947
6117,15,666,3391,546,12583,120
41621,44,2002,1384,1187,14868,815
9197,2,62,3207,55,3718,7
6968,19,571,3353,425,8454,146
3835,12,166,3491,141,29974,25
36789,1,42,1763,34,2084,8
36296,17,608,1790,443,8699,165
19965,22,541,2616,461,18862,80
25987,12,467,2314,366,8648,101
45360,63,768,483,568,7443,200
28113,0,55,2205,47,1381,8
45867,10,285,305,172,5707,113
12248,696,50370,3047,37606,197261,12764
37071,0,115,1746,91,4144,24
36885,27,325,1757,260,3115,65
29787,20,1224,2115,977,12914,247
11419,4,119,3090,94,2902,25
46271,1,13,143,12,1217,1
13216,6,493,2982,410,6218,83
37588,3,225,1713,186,2939,39
34722,5,191,1890,151,3401,40
1935,72,2346,3526,1936,21386,410
25796,29,1622,2322,1303,25204,319
17819,3,124,2716,92,2941,32
32661,172,6758,1972,4716,26217,2042
25270,4,90,2346,75,1051,15
20064,15,760,2610,585,17100,175
29350,4,117,2136,95,3216,22
31577,0,105,2024,80,5289,25
28638,37,1161,2173,967,19430,194
9271,33,1028,3203,685,9872,343
5032,9,90,3445,68,3910,22
3824,4,119,3492,99,3709,20
9191,7,125,3207,82,5179,43
25497,92,7938,2337,6208,53068,1730
27868,37,750,2219,526,10144,224
2915,107,3168,3509,2521,38286,647
9449,1,117,3191,51,4723,66
20442,27,1917,2590,1459,19296,458
38019,188,3932,1684,2972,25755,960
36389,262,4611,1785,3359,24208,1252
16282,2140,93721,2793,66069,181041,27652
27724,142,10517,2227,6983,58350,3534
7350,49,1349,3331,1011,32118,338
38947,3,108,1620,91,4134,17
28746,1,61,2167,51,2686,10
34655,8,184,1893,153,7118,31
9148,16,571,3210,460,24462,111
23772,7,324,2414,281,3429,43
4505,20,991,3468,725,13777,266
10033,19,645,3161,491,10065,154
29971,23,513,2106,393,3907,120
15893,13,585,2812,450,10299,135
32141,1,71,1994,60,2906,11
43621,38,1114,909,931,19501,183
9960,3,112,3164,82,4104,30
20193,13,1159,2603,864,13470,295
44150,26,341,797,297,8522,44
14703,0,48,2872,39,3517,9
30283,12,291,2090,228,5642,63
8433,110,1222,3254,987,53805,235
43227,37,1247,1034,875,18984,372
14643,175,9177,2876,6359,48952,2818
45117,134,989,553,874,11379,115
14951,139,6396,2857,5011,39733,1385
30970,112,5837,2056,4150,41383,1687
43312,29,454,1010,345,5926,109
39596,12,405,1581,303,14555,102
4082,5,169,3484,135,8103,34
5612,30,245,3415,188,7298,57
39522,4,312,1586,211,7301,101
27791,160,4998,2222,3837,37399,1161
28155,5,512,2202,399,7819,113
33654,3,176,1933,146,5253,30
7989,143,8722,3285,6606,116285,2116
8869,7,304,3226,214,11082,90
12822,82,8810,3014,6635,56417,2175
4363,88,9870,3473,7595,17007,2275
22838,426,23229,2459,15847,126213,7382
34905,3504,124572,1879,82002,391783,42570
30945,7,74,2057,60,2810,14
20714,4,274,2576,223,5386,51
22811,7,278,2460,209,3870,69
13853,615,17399,2934,11799,118861,5600
35372,24,270,1855,224,3574,46
35692,9,192,1831,152,2762,40
17831,5,107,2716,84,3590,23
38136,29,778,1675,605,13061,173
16928,15,1552,2760,1196,24600,356
35677,11,431,1831,347,7611,84
33948,13,676,1922,531,21739,145
17186,175,18833,2745,11404,85377,7429
8128,5,576,3273,345,5847,231
4619,12,389,3464,298,6987,91
23916,0,66,2408,54,7241,12
45927,220,3480,276,2579,15480,901
44775,21,205,674,180,5476,25
27885,22,1308,2218,953,16111,355
35393,309,6022,1854,4435,24945,1587
30608,1,19,2071,16,2776,3
16443,231,14284,2785,10159,63851,4125
21013,49,1588,2556,1172,26751,416
38180,37,1771,1673,1247,21769,524
40749,113,4292,1494,2794,33190,1498
10407,54,2017,3144,1620,21126,397
34394,3,178,1906,148,7724,30
32273,1,114,1988,89,6335,25
22747,4,359,2464,276,12310,83
36403,0,31,1785,27,4004,4
14337,15,632,2898,507,6028,125
9038,4,157,3217,121,5241,36
2394,90,2824,3518,2364,21554,460
38916,87,1087,1623,854,10295,233
10112,17,214,3157,167,4725,47
20773,12,443,2573,356,5071,87
7433,6,462,3327,317,13366,145
32658,68,2891,1972,2239,23409,652
3411,190,10215,3500,7675,51592,2540
19666,8,499,2633,396,3348,103
3436,12,461,3500,366,5503,95
11532,33,1032,3082,834,15844,198
32321,29,672,1986,522,9195,150
2839,12,296,3511,210,11706,86
5222,16,508,3434,388,10226,120
33849,19,576,1925,467,7011,109
28114,9,697,2205,536,20862,161
12377,4,246,3039,168,2559,78
15977,14,958,2808,744,30724,214
14196,97,5212,2909,3919,49481,1293
32487,5,757,1979,620,5409,137
45366,47,478,481,389,10717,89
25586,5,235,2332,199,4197,36
17564,9,560,2725,453,8928,107
25835,100,4580,2321,3496,41278,1084
17150,194,11246,2746,8271,46938,2975
22179,3,177,2491,143,7171,34
5232,195,5022,3433,2961,24728,2061
12937,23,1099,3008,884,37937,215
28965,22,1205,2157,973,19480,232
26487,4,117,2291,101,2652,16
35140,8,317,1866,265,9993,52
46176,23,327,168,281,4651,46
23864,0,60,2410,51,4930,9
6066,56,1297,3392,1064,9976,233
21147,14,1037,2549,830,31863,207
30690,3,84,2067,74,2152,10
30584,14,1081,2073,901,8163,180
14008,51,2404,2920,1810,31592,594
26202,41,1523,2304,1261,10931,262
23233,1,169,2440,143,2589,26
23146,542,10141,2444,7751,49573,2390
40730,198,7629,1497,5709,64777,1920
32929,3,169,1960,132,4142,37
9053,19,987,3216,849,6509,138
44257,368,7207,778,5884,30335,1323
6112,9,590,3391,459,12453,131
8073,31,388,3276,314,3643,74
4011,47,1223,3486,970,9347,253
42337,335,7058,1253,5350,51417,1708
22278,137,5966,2486,4570,48980,1396
11268,0,26,3096,20,1798,6
7545,16,466,3321,380,8224,86
27400,11,664,2246,492,14011,172
4872,453,24092,3454,15688,200213,8404
18968,25,1150,2665,917,16675,233
5921,90,3523,3398,2631,13760,892
37272,157,1894,1733,1526,15606,368
45222,0,12,522,10,921,2
46065,13,146,212,97,3486,49
19868,4,96,2621,85,3680,11
42403,2,67,1240,52,3710,15
33400,6,141,1942,127,4849,14
20968,65,1665,2560,1320,11506,345
27063,2,283,2266,211,3106,72
45466,1,21,455,15,1070,6
9080,284,9417,3214,7023,37504,2394
22820,49,1555,2460,1131,5610,424
35466,88,2092,1848,1617,19148,475
9544,958,40185,3185,27523,121361,12662
29049,11,573,2153,451,12265,122
27417,146,14005,2245,9478,48225,4527
25375,0,22444,2342,15985,126773,6459
38822,3,55,1628,46,1895,9
10979,29,1795,3112,1431,17225,364
38736,63,1029,1634,769,7111,260
12592,63,2010,3028,1648,28794,362
38909,29,1187,1623,848,14713,339
2058,21,332,3524,287,5339,45
23041,8,147,2450,119,2251,28
14617,14,360,2878,285,7083,75
35203,10,207,1864,177,10920,30
44297,14,286,775,219,7381,67
44373,18,295,762,213,4230,82
7338,76,4469,3332,3238,15451,1231
25811,14,309,2321,271,9777,38
24250,70,1822,2392,1459,12427,363
18455,14,439,2687,330,4409,109
45810,15,122,323,100,2818,22
24538,0,53,2378,46,2054,7
5835,6,99,3403,85,5025,14
39452,7,212,1589,165,4869,47
2277,124,5976,3520,4631,55617,1345
30269,8,440,2091,361,14934,79
13537,14,784,2957,567,18931,217
13089,130,3657,2998,2795,38063,862
32565,5,167,1975,125,6221,42
5414,645,31107,3424,22217,274971,8890
30456,4,95,2079,75,6256,20
1608,5,380,3584,310,12484,70
32003,8,257,2002,212,4240,45
2064,18,1172,3523,865,13254,307
4994,21,574,3447,465,6625,109
38123,3,51,1676,41,3077,10
44948,40,572,624,407,4728,165
45971,4,79,257,48,1671,31
10638,383,7075,3130,5355,31779,1720
46289,58,2223,136,1781,13808,442
5345,8,808,3428,617,8656,191
8938,72,1592,3222,1244,19046,348
4957,35,305354,3449,101672,14322,203682
43781,120,2340,856,1902,23081,438
24934,40,1862,2360,1418,20214,444
14023,16,926,2919,770,18523,156
13845,28,1548,2935,1191,17637,357
13235,42,1804,2982,1466,38547,338
17691,20,6563,2721,4838,31974,1725
25383,18,1116,2341,940,8785,176
31860,11,357,2009,280,5801,77
2337,8,184,3519,149,6749,35
6624,7,283,3370,222,11032,61
12595,15,1158,3028,926,12415,232
9474,12,379,3189,301,4708,78
27352,119,2131,2249,1618,12443,513
15478,126,6375,2831,4775,60649,1600
22416,2,47,2480,30,2559,17
3322,65,3441,3502,2397,24272,1044
5028,12,52,3445,33,3799,19
25268,17,527,2347,445,5093,82
36218,10,236,1794,208,8557,28
24676,21,446,2371,324,4311,122
18437,385,28742,2687,16421,123913,12321
12288,2,103,3045,76,3722,27
21596,257,18582,2523,14082,113917,4500
20701,1,43,2577,42,1448,1
1866,236,9201,3528,7066,74527,2135
24981,3,153,2358,126,4091,27
4674,5,126,3462,105,8116,21
3221,3,134,3504,108,8485,26
19154,112,10417,2658,7335,81710,3082
36675,6,209,1770,163,11316,46
33213,0,136,1949,111,4359,25
40863,86,1222,1483,891,11356,331
35008,22,956,1874,650,14304,306
6740,15,1402,3365,974,14486,428
40694,17,599,1500,413,13531,186
22962,1247,112179,2452,73301,303139,38878
16286,4,178,2793,134,5914,44
7797,25,396,3304,323,4956,73
14546,51,857,2883,675,18909,182
3187,114,3736,3504,2918,81027,818
3677,0,25,3495,23,2115,2
42031,4,198,1314,143,6503,55
39861,5,160,1566,107,6851,53
20711,14,422,2576,333,6853,89
8290,4,50,3263,43,2771,7
32971,2,81,1959,60,3966,21
12162,41,1542,3051,1121,43051,421
34817,8,213,1883,171,5378,42
30107,39,1774,2100,1466,15831,308
9929,5,413,3166,324,8845,89
31867,1,149,2009,85,2151,64
13436,6,312,2966,271,10670,41
39980,37,763,1557,455,16153,308
4856,7,193,3454,128,6509,65
3638,7,87,3496,65,5564,22
39226,74,1336,1603,986,14596,350
45201,5,140,528,99,4626,41
20179,0,115,2604,102,2501,13
45820,16,122,319,92,3041,30
21693,742,38301,2517,27134,175067,11167
38677,4,76,1637,64,4997,12
25485,132,5965,2337,4108,46541,1857
2743,10,891,3513,749,8522,142
13829,3,217,2936,165,10364,52
44944,91,1290,625,1088,15466,202
14799,210,15740,2864,10828,33876,4912
9558,49,184881,3184,55575,26791,129306
6774,9,230,3363,187,11466,43
26042,0,112,2311,92,3180,20
32591,9,705,1974,557,9796,148
16268,24,1033,2794,853,12204,180
15491,5,259,2830,197,8405,62
42262,15,114,1267,84,1778,30
6352,7,55,3381,48,4093,7
40125,36,2206,1548,1674,18966,532
34324,1128,33764,1910,21088,217297,12676
5008,3,112,3446,82,6011,30
28673,0,53,2172,40,4306,13
16456,35,2343,2785,1722,14647,621
11552,2,155,3081,118,2662,37
19039,119,2900,2662,2248,15084,652
22713,45,2529,2465,1958,9090,571
33663,3,168,1932,140,6220,28
32309,0,48,1987,41,6708,7
33370,7,334,1943,274,3033,60
20069,2,157,2610,120,9737,37
41641,46,1569,1381,1179,28074,390
10215,1,61,3152,51,2086,10
4936,17,448,3450,369,7866,79
26358,42,1409,2296,1056,12131,353
18293,6,190,2693,141,3521,49
1271,5,91,3748,72,3501,19
4109,874,38386,3483,24399,252424,13987
24465,58,1410,2382,1116,12825,294
9445,105,6173,3191,4839,42622,1334
20121,29,1181,2607,895,15818,286
8990,10,246,3220,190,4236,56
16381,15,1040,2788,831,9212,209
29918,4,177,2108,144,4861,33
32439,6,349,1981,258,7124,91
32957,79,4453,1959,3516,49678,937
38163,246,11002,1674,8298,37791,2704
947,3,72,3853,62,2748,10
41763,12,376,1360,294,10438,82
31888,10,780,2008,659,9539,121
33149,1,30,1951,21,4080,9
19316,32,537,2649,446,5635,91
25932,3,92,2316,73,6672,19
22084,115,3144,2495,2451,14388,693
37736,39,1525,1703,1202,18228,323
10060,2,55,3159,47,2389,8
16802,11,541,2766,421,8930,120
6844,15,832,3360,628,12864,204
24097,1,36,2398,32,1021,4
7158,7,66,3342,50,3180,16
28061,66,7912,2207,5712,19934,2200
14079,5,87,2915,64,6039,23
22070,4,316,2496,242,11417,74
20649,34,1818,2580,1436,35521,382
39560,40,955,1584,703,12132,252
27897,4,155,2217,118,4147,37
41500,3,146,1401,111,6486,35
44465,26,406,750,273,8529,133
33736,46,1135,1929,896,13837,239
20271,27,1298,2598,920,16336,378
42222,293,8798,1274,6569,60638,2229
44576,22,582,729,437,12649,145
14667,40,2215,2875,1529,23212,686
14236,0,232,2906,182,19565,50
30005,30,1316,2105,842,13128,474
21938,30,725,2505,563,3658,162
35641,2,83,1835,72,8203,11
29437,0,0,2132,0,9088,0
26036,4,162,2311,133,7199,29
6029,3,97,3394,84,2696,13
41455,142,2996,1408,2148,29097,848
26504,0,114,2290,95,3897,19
35652,19,287,1834,236,4488,51
35318,69,556,1857,458,6340,98
40308,79,2728,1536,2169,15820,559
3369,84,4176,3501,3132,29737,1044
29597,17,590,2125,488,11794,102
2545,15,771,3516,583,27018,188
7806,32,775,3304,650,12674,125
38739,3,95,1633,72,3518,23
24051,40,1568,2401,1148,15315,420
33580,22,2028,1935,1554,25002,474
17073,37,2304,2751,1893,7211,411
6399,17,184,3379,140,11936,44
38411,70,624,1656,475,5787,149
46058,3,20,215,11,1065,9
42720,6,58,1174,42,4352,16
19737,31,1481,2628,1119,25731,362
10791,237,12174,3122,9256,128831,2918
28702,640,14547,2170,11676,57286,2871
46019,4,127,236,87,2276,40
31762,14,308,2014,233,4064,75
15796,1,40,2815,35,2704,5
35511,106,5893,1845,4476,21716,1417
14150,2,68,2912,54,3313,14
3667,28,960,3495,753,11052,207
28424,0,110,2186,99,5042,11
42943,6,110,1116,81,2442,29
13383,1,56,2970,42,5361,14
31948,1,101,2005,85,3472,16
34665,3,153,1892,133,8938,20
44954,87,1459,622,1301,14570,158
9761,30,826,3174,587,14943,239
33587,10,428,1935,331,7990,97
3274,39,2003,3503,1459,67501,544
21511,1,48,2528,31,3257,17
28743,11,744,2168,613,41847,131
35043,56,1553,1872,1342,13725,211
17055,1,178,2752,140,32934,38
38712,34,613,1635,472,5352,141
45747,9,229,345,128,4718,101
22341,1,93,2483,68,1521,25
26698,0,43,2281,38,2185,5
46070,45,711,210,607,9304,104
17496,8,609,2729,471,13283,138
9387,7,462,3194,338,5272,124
12708,11,368,3021,278,7222,90
25544,18,1316,2334,937,18501,379
40880,88,3275,1481,2322,33756,953
32906,1,48,1961,39,5591,9
21801,2,82,2512,75,4052,7
28632,2,112,2173,90,3410,22
29726,6,274,2118,196,11074,78
46143,1,107,183,97,2858,10
45703,24,204,364,179,5438,25
10126,194,6798,3157,5103,40513,1695
30389,2,67,2083,57,2304,10
15648,173,15188,2822,10966,36712,4222
28189,105,2406,2200,1792,11689,614
22959,141,11949,2452,9068,52615,2881
38996,10,270,1617,217,4902,53
46125,8,125,193,86,2330,39
25734,2189,87060,2325,60120,473788,26940
12638,68,2636,3025,1694,52079,942
46145,4,113,177,64,1735,49
38233,251,6574,1669,5219,54422,1355
5544,3,26,3418,18,1673,8
40406,49,547,1526,402,6245,145
38162,12,321,1674,238,7337,83
14368,56,2495,2895,1912,26799,583
20370,4,271,2595,217,14939,54
17318,15,769,2738,578,18676,191
15555,48,1628,2827,1289,6796,339
14174,46,4482,2911,3063,22055,1419
16632,40,1447,2777,1126,6413,321
2074,113,3189,3523,2574,21490,615
2749,13,513,3512,424,6445,89
19099,62,4645,2660,3410,42637,1235
7732,6,82,3309,49,2449,33
9704,0,164,3177,50,1565,114
16178,25,1727,2799,1180,34528,547
6926,76,2719,3356,1927,20683,792
32760,89,5253,1968,3366,28531,1887
20917,8,539,2563,409,5633,130
6535,2,110,3373,95,1976,15
41038,2,49,1469,42,5429,7
38805,2,108,1629,87,4196,21
42490,2370,55946,1221,38142,345144,17804
2233,0,70,3521,63,6963,7
17915,31,1882,2712,1475,23305,407
18825,2,160,2670,135,4243,25
6012,6,215,3394,166,2075,49
13265,16,461,2980,357,10191,104
13995,49,3079,2921,2010,28729,1069
6019,5,99,3394,86,3045,13
18877,2,209,2668,164,2160,45
16960,152,5148,2758,3821,20486,1327
1955,51,1871,3526,1544,30484,327
6463,50,3074,3377,2324,15801,750
8305,17,669,3262,539,7843,130
40456,14,375,1521,300,4708,75
9450,111,6044,3190,4693,43684,1351
20866,0,26,2567,22,2211,4
11630,66,2111,3078,1558,12430,553
34502,3,243,1902,210,3874,33
45060,15,223,586,185,5218,38
14111,139,4605,2913,3287,34417,1318
24997,14,603,2358,423,10028,180
12142,34,950,3052,738,16447,212
24293,0,71,2390,63,1685,8
21707,1,49,2517,40,1073,9
20957,14,1886,2561,1264,38960,622
7304,0,53,3335,45,1882,8
8105,44,1090,3274,869,14014,221
13067,170,12026,2999,8443,101612,3583
23895,111,7857,2409,5840,38166,2017
4759,56,1532,3459,1183,20907,349
23893,5,164,2409,145,8311,19
15948,24,1459,2810,1145,28345,314
14233,36,1157,2907,942,5714,215
27190,3,118,2259,102,1872,16
2073,111,4008,3523,2917,49799,1091
16208,40,1393,2797,1116,16349,277
14595,29,1486,2879,1180,11282,306
8398,45,1441,3255,1088,15278,353
39517,18,219,1586,177,3940,42
40667,7,384,1502,293,12698,91
30394,0,21,2083,15,3717,6
2978,84,3664,3508,2567,35932,1097
29997,4,101,2105,84,2608,17
31075,8,183,2051,139,4552,44
34601,39,1426,1896,1178,16797,248
31405,20,1102,2034,859,6275,243
17024,10,381,2754,322,7463,59
36777,38,707,1764,581,13258,126
11175,1,41,3101,35,4799,6
18695,39,1364,2676,1100,10057,264
4761,17,558,3458,442,13361,116
18352,83,3841,2690,2826,77060,1015
12676,8,175,3023,135,4173,40
8294,13,519,3263,390,13305,129
40393,34,2557,1526,1289,48332,1268
28953,16,500,2157,422,7173,78
13399,178,7237,2969,5636,51551,1601
25521,4,107,2335,92,4032,15
41174,63,1859,1452,1265,35963,594
32930,1,78,1960,65,3134,13
39088,4,150,1611,124,4061,26
13818,172,12491,2937,9268,142299,3223
32431,5,103,1981,83,3122,20
9533,0,213,3186,177,3688,36
34636,14,594,1894,488,7995,106
26914,9,524,2271,427,9657,97
10029,7,226,3161,178,2417,48
21466,8,155,2531,128,2585,27
40420,4,230,1525,175,2463,55
29084,1,170,2150,139,5347,31
15383,99,2156,2835,1608,12372,548
43710,57,540,878,423,5817,117
22578,39,2817,2471,2064,22261,753
41115,14,257,1458,202,4435,55
36802,30,911,1762,743,12287,168
25590,19,1089,2332,806,8065,283
21780,12,298,2513,257,5566,41
25181,36,2530,2349,2052,15776,478
38044,16,1315,1682,1048,19029,267
37891,6,90,1692,67,2977,23
16300,4,138,2793,112,3898,26
20554,21,998,2585,793,8301,205
7956,13,368,3288,296,10722,72
42359,8,393,1248,275,6680,118
23522,7,108,2426,93,2544,15
27403,1,47,2246,45,2541,2
39684,4,69,1576,56,4773,13
29283,161,2719,2141,1984,15976,735
42946,12,124,1116,95,3502,29
10917,1,44,3115,36,2534,8
7022,0,79,3350,65,2141,14
7444,8,388,3327,319,8857,69
15449,4,268,2832,212,5049,56
17767,0,108,2718,85,3436,23
28678,5,336,2171,241,4751,95
11582,1,81,3080,67,1610,14
46229,3,12,154,12,1354,0
1683,0,50,3565,41,1776,9
10667,19,663,3129,555,4436,108
16232,27,1504,2796,1197,25935,307
32674,12,388,1971,302,18875,86
42962,57,1272,1113,1025,33331,247
34673,560,123794,1892,85675,245093,38119
27481,3,500,2241,388,13237,112
31022,2,57,2053,43,6148,14
33712,5,204,1930,166,3783,38
15249,44,1597,2840,1226,9011,371
3334,155,8043,3502,6280,50522,1763
3241,13,411,3503,288,12921,123
17604,11,623,2724,511,8427,112
38925,1,34,1622,26,3304,8
10053,91,4031,3160,3072,36206,959
21651,14,514,2520,420,11005,94
20472,3,138,2589,113,4875,25
23575,68,1560,2423,1240,8969,320
22391,46,1512,2481,1193,14925,319
4738,2,16,3459,13,1866,3
12548,7,195,3031,113,15470,82
20446,157,8036,2590,5084,48483,2952
4211,246,8474,3479,6772,67571,1702
12039,75,1688,3058,1346,9914,342
14648,16,485,2876,342,12926,143
6464,7,130,3377,102,10017,28
29221,97,3118,2144,2257,35344,861
32645,0,93,1972,74,6018,19
25429,185,3034,2339,2385,11969,649
38825,0,37,1628,32,2499,5
17065,0,103,2751,86,6255,17
42530,48,1131,1213,883,19023,248
20831,47,4224,2569,3283,39607,941
27528,32,1212,2237,955,14507,257
27118,15,458,2263,369,5802,89
8672,9,260,3238,211,23788,49
30306,29,938,2089,729,11919,209
22490,19,2019,2476,1602,15530,417
28790,0,14,2165,12,1939,2
7494,20,794,3324,593,5525,201
35941,329,6493,1813,4924,30147,1569
16188,4,146,2798,121,5098,25
46207,3,45,158,35,1560,10
10435,16,497,3142,396,24310,101
11024,161,5086,3109,3952,72810,1134
11614,5,116,3079,99,5378,17
20263,1,88,2598,76,2695,12
30316,15,716,2088,559,17149,157
43101,100,1331,1071,1133,12709,198
24262,3,443,2392,359,15535,84
6332,11,455,3382,377,8295,78
44696,13,107,702,96,1477,11
29073,60,3370,2151,2670,37074,700
32203,5,71,1991,63,2375,8
36577,2,51,1776,38,3068,13
31592,3,143,2023,112,9219,31
40711,285,11308,1498,8039,66408,3269
28480,47,839,2184,665,13400,174
35737,0,145,1827,107,4401,38
41126,7,234,1456,180,9100,54
6620,64,3959,3370,2546,59297,1413
30457,100,9109,2079,5614,56174,3495
3590,7,164,3497,136,14830,28
29964,43,1453,2106,1091,6632,362
11466,1,14,3086,7,3043,7
21771,7,273,2514,229,6007,44
25731,0,99,2325,86,2702,13
2054,1207,77017,3524,52138,374879,24879
28647,56,1547,2173,1306,16534,241
45050,3,34,591,25,2238,9
14286,24,1101,2902,749,18655,352
7838,1,49,3301,36,3522,13
11785,37,3798,3069,2963,34515,835
42739,24,324,1167,247,5347,77
11965,20,376,3062,282,3697,94
23284,1,122,2438,103,3722,19
30828,7,290,2061,227,5770,63
22726,200,8372,2465,6149,46804,2223
1470,1,79,3618,72,3012,7
6179,10,269,3389,219,4521,50
13318,6,627,2975,490,19922,137
42291,16,363,1261,276,10522,87
15962,9,378,2809,316,5284,62
45671,2,25,378,16,2852,9
25885,89,2435,2318,1938,17316,497
17127,44,4672,2748,3250,12978,1422
40467,6,119,1519,90,6269,29
45880,90,1078,297,894,18981,184
13855,7,531,2934,326,4156,205
25618,46,1398,2330,1153,10858,245
4925,37,1906,3450,1458,18805,448
30234,15,1070,2093,842,19377,228
41799,0,39,1352,34,8182,5
20204,5,261,2602,225,5347,36
45816,1,23,320,13,955,10
23296,196,4620,2437,3442,22534,1178
6342,16,1396,3382,1030,6887,366
31525,1,108,2026,97,4290,11
38188,51,2737,1672,2140,20965,597
26372,35,1250,2296,1013,20137,237
5122,95,2192,3440,1756,14399,436
39825,10,288,1569,221,8415,67
24009,4,218,2402,184,8103,34
24527,38,1356,2379,1003,5440,353
20403,1,226,2592,170,2891,56
6933,2,35,3356,22,2677,13
46035,16,78,226,56,7453,22
38985,170,5151,1618,3846,38985,1305
39065,1,90,1613,68,2715,22
42059,6,123,1309,101,5793,22
39194,81,775,1605,617,6547,158
2981,28,1549,3508,1205,15055,344
41754,143,3905,1361,3043,30328,862
1413,5,134,3646,120,7868,14
39833,13,432,1568,326,7272,106
6849,5,178,3359,128,9993,50
33350,0,28,1944,24,1457,4
34947,20,502,1876,414,9681,88
21104,4521,255292,2552,152391,763914,102901
45358,29,257,483,209,5622,48
12756,9,389,3018,314,8625,75
41505,32,380,1401,294,3288,86
34607,63,1859,1896,1379,11954,480
4640,3,76,3463,65,3577,11
38453,28,1967,1653,1301,20235,666
8728,13,307,3234,243,4188,64
34630,8,253,1895,186,7157,67
11349,4,217,3093,186,7284,31
19111,33,681,2660,496,5399,185
31533,9,283,2026,249,4068,34
34248,18,880,1913,661,6903,219
13051,930,85164,3000,50661,332981,34503
2170,515,30095,3522,22195,136281,7900
38907,2,124,1623,88,11288,36
32647,13,430,1972,364,11521,66
19343,11,385,2648,301,11892,84
12432,18,963,3035,787,9832,176
20694,40,3933,2578,3124,27614,809
24001,15,411,2403,319,6680,92
3629,325,10625,3496,7248,126860,3377
2325,26,628,3519,515,12317,113
6754,90,6615,3364,5017,54185,1598
2278,27,754,3520,621,6899,133
10271,1,73,3150,61,2224,12
44925,36,284,631,221,4156,63
32626,10,486,1973,385,11996,101
22248,1,67,2487,40,1711,27
20312,51,4141,2597,3292,21330,849
46267,5,80,144,51,2345,29
19180,60,2486,2657,1832,15132,654
2891,5,107,3510,63,3645,44
41742,2,120,1365,94,6739,26
41283,20,653,1433,507,13441,146
9193,4,224,3207,158,4285,66
39281,10,996,1598,770,15134,226
32358,1,35,1984,31,1593,4
43104,257,2812,1071,2244,17660,568
27288,5,932,2253,706,12251,226
3908,247,9177,3489,6758,31734,2419
12891,18,483,3011,378,20993,105
16624,0,134,2777,92,6504,42
19146,13,302,2658,224,3863,78
45554,118,2589,425,1902,22186,687
3377,2,113,3501,95,3540,18
42130,14,689,1296,495,18037,194
22410,4849,160432,2480,98557,405537,61875
3547,2,22,3498,16,3067,6
39341,493,15905,1595,11194,127289,4711
21092,0,69,2553,60,2933,9
9338,62,2578,3198,1738,16553,840
31655,6,111,2019,95,1357,16
29365,3,170,2135,132,4516,38
42110,3,177,1300,137,8106,40
23437,3,258,2429,205,4284,53
41130,44,2016,1456,1486,21983,530
36941,5,431,1754,233,4653,198
36729,0,2593,1768,2022,30008,571
24478,66,3558,2381,2727,20620,831
30144,18,269,2098,228,5185,41
39850,10,148,1567,115,5983,33
13779,1,91,2940,77,3009,14
2835,10,319,3511,250,17277,69
16217,216,7307,2797,5048,25053,2259
25238,2,145,2347,111,6461,34
16612,5,466,2778,330,6035,136
6856,64,1303,3359,1044,14410,259
32175,29,1159,1992,869,18307,290
35936,20,1008,1813,760,9617,248
14218,8,626,2908,512,28081,114
8135,4,138,3273,107,7507,31
3822,22,562,3492,415,6504,147
7413,9,175,3329,145,5094,30
5574,0,113,3417,89,3966,24
16135,213,17281,2800,12375,112272,4906
42931,49,904,1120,688,14100,216
2257,6,240931,3520,86261,8431,154670
15544,7,355,2828,270,4035,85
45515,43,458,441,304,9397,154
21911,7,429,2506,341,4816,88
32329,6,200,1986,168,5425,32
3051,6,130,3507,94,3452,36
20394,46,3734,2593,2960,34784,774
28580,46,2386,2176,1800,23475,586
37207,14,284,1737,236,4767,48
37623,2,79,1710,69,3017,10
31558,7,898,2024,631,10450,267
4205,243,11061,3479,8798,72751,2263
10928,220,13166,3114,9786,69680,3380
7990,37,745,3285,522,8679,223
6508,5,80,3374,64,3299,16
40034,3,144,1553,114,6880,30
45445,38,334,459,285,11240,49
12757,20,78770,3018,23920,13767,54850
6082,13,581,3392,402,12879,179
5809,178,7800,3404,6049,71604,1751
28542,1,38,2178,35,2323,3
37241,13,432,1735,351,9999,81
30552,5,151,2074,117,3421,34
32727,25,721,1969,595,15022,126
45875,11,171,302,134,1723,37
4556,11,572,3466,392,9266,180
6496,24,433,3375,359,5621,74
4474,42,789,3469,566,14352,223
14388,8,426,2894,353,4779,73
20587,11,924,2583,690,23330,234
8400,253,11114,3255,7141,225117,3973
27702,3,234,2228,183,8716,51
39261,2,136,1599,111,4461,25
23869,6,305,2410,255,7038,50
12153,1,239,3052,172,6580,67
14016,16,319,2919,268,4512,51
45958,3,33,261,26,1150,7
41276,18,979,1434,701,12676,278
20857,0,372,2568,215,16095,157
46372,8,149,97,124,3185,25
8697,42,3143,3236,2332,23018,811
3277,37,995,3503,715,21269,280
11789,3,80,3069,64,2733,16
43953,40,532,830,431,9588,101
14549,17,561,2883,424,13444,137
9198,7,424,3207,321,4319,103
3372,55,1205,3501,912,9908,293
21332,22,1137,2538,923,7211,214
29604,0,151,2124,115,3409,36
17629,98,5289,2722,4006,44675,1283
45013,58,601,605,515,8398,86
46330,2,47,117,39,2226,8
6630,16,465,3370,339,10456,126
3625,9,215,3496,177,5090,38
13455,2,162,2963,129,5240,33
10156,22,800,3155,642,9353,158
7661,172,4246,3314,3227,29199,1019
1926,11,355,3527,245,7544,110
4840,7,114,3455,90,4068,24
36252,28,857,1793,650,7330,207
15826,0,76,2814,60,2422,16
18007,53,1918,2706,1357,33974,561
40919,20,526,1478,381,7932,145
30189,80,4164,2095,3048,23119,1116
14392,4,172,2893,142,4508,30
25296,3,206,2345,165,7777,41
25822,111,2734,2321,2156,16947,578
43686,90,1837,886,1623,24811,214
45805,5,98,324,67,1350,31
1008,5,124,3835,103,5541,21
28087,5,387,2206,311,6927,76
41541,58,1905,1397,1372,25551,533
31670,7,286,2018,232,8396,54
46079,8,99,208,86,1812,13
4221,2,112,3479,76,6078,36
22083,108,9358,2496,6960,36044,2398
42926,66,1690,1122,1258,13389,432
16652,0,174,2775,124,4597,50
22438,6,777,2479,616,7123,161
19285,70,3136,2651,2305,13398,831
21383,9,528,2536,431,6277,97
9436,33,1220,3191,957,22504,263
4816,9,354,3456,299,4278,55
1553,3,316,3593,214,7424,102
18951,16,331,2666,267,6102,64
34999,7,321,1874,246,5263,75
20802,220,7871,2571,5048,68504,2823
35872,3,73,1818,59,4452,14
23407,30,3400,2431,2533,18713,867
25334,0,42,2343,32,2974,10
19553,69,9047,2638,6588,48368,2459
43903,20,275,838,199,4604,76
28404,5,269,2187,218,4274,51
11117,1,141,3104,97,7468,44
14805,850,74783,2864,50033,206350,24750
30885,7,364,2059,315,6200,49
45375,4,70,478,61,3478,9
26665,54,2793,2283,2193,24147,600
18172,16,752,2699,593,7228,159
25015,45,1645,2357,1375,19170,270
40778,33,628,1492,483,13320,145
8746,6,159,3233,130,4715,29
29765,1,228,2116,178,3796,50
10890,23,2175,3116,1716,51928,459
12851,56,2741,3012,2018,18194,723
37019,5,283,1749,206,10358,77
6556,133,3928,3372,2725,28238,1203
39739,4,67,1574,55,11179,12
20206,2,318,2602,283,6293,35
21325,1,62,2538,55,2609,7
34041,81,4279,1919,2730,39833,1549
39352,5,191,1595,156,4356,35
18413,128,8442,2688,5798,47136,2644
11143,2,35,3103,29,2807,6
32390,32,670,1983,543,10354,127
29875,8,433,2110,342,11633,91
35810,16,570,1822,426,7454,144
17531,159,7475,2727,5584,40659,1891
9465,14,399,3190,292,5481,107
45216,23,522,524,323,7172,199
8499,230,15577,3249,11380,159295,4197
10416,493,78053,3143,48291,253525,29762
42555,4,77,1208,58,4404,19
33735,0,0,1929,0,2263,0
35527,10,406,1844,304,8458,102
39232,76,780,1602,604,12560,176
1947,347,21825,3526,14741,73178,7084
41051,11,306,1467,228,5869,78
4433,6,100,3471,85,4996,15
9805,7,436,3171,339,7230,97
44745,16,267,684,190,3912,77
28875,10,713,2161,556,26845,157
23259,5,156,2438,128,2145,28
13903,34,1331,2928,976,9764,355
38927,14,474,1622,391,6807,83
44832,0,11,656,10,1530,1
16877,126,6624,2763,4928,47736,1696
45787,152,1847,330,1600,17678,247
6911,4,138,3357,117,6910,21
14064,16,803,2916,651,15610,152
36855,5,275,1758,218,2102,57
28506,0,63,2182,53,2524,10
3783,5,112,3493,85,5468,27
13910,25,1792,2928,1473,16082,319
40395,14,457,1526,388,8255,69
41591,30,605,1389,418,10017,187
28121,12,597,2204,488,8587,109
12524,1,69,3031,42,1327,27
38829,10,677,1628,553,12716,124
29103,2944,220012,2150,137898,833111,82114
2385,4,606,3518,504,18767,102
29751,898,58621,2117,35759,174235,22862
37010,4,212,1750,176,4764,36
9361,4,141,3196,105,12944,36
28214,64,2096,2198,1514,14967,582
11174,3,170,3101,156,5584,14
13776,4,212,2940,160,4042,52
34200,13,678,1914,564,11069,114
10867,4,125,3118,95,8973,30
22821,111,5473,2460,3849,50132,1624
10308,66,2516,3148,1840,26028,676
36619,100,1765,1773,1340,14631,425
23788,14,403,2414,338,7959,65
28083,74,2589,2206,2202,35878,387
37279,84,1116,1733,854,9584,262
37451,68,1885,1722,1342,17808,543
36460,0,24,1782,19,3522,5
27302,667,36414,2252,25881,117393,10533
15762,0,76,2817,63,2784,13
43240,28,637,1031,458,10129,179
35873,1,18,1817,16,6263,2
42567,6,109,1206,84,7929,25
27703,19,472,2228,395,11306,77
18141,2,108,2700,82,4899,26
3440,15,448,3500,330,4040,118
4286,24,550,3476,410,5214,140
21026,95,6473,2556,4594,42774,1879
15871,24,1239,2813,953,7835,286
40738,5,74,1496,63,2318,11
1830,914,47607,3529,31516,266593,16091
12240,5,112,3047,87,3034,25
41560,28,1143,1395,794,17113,349
19469,142,11401,2641,7851,60496,3550
19462,2,390,2642,269,5397,121
39222,108,2322,1603,1847,9759,475
45111,239,2976,559,2354,14433,622
26534,63,3068,2288,2348,22177,720
25691,21,760,2327,623,6205,137
40682,7,245,1501,195,5771,50
42564,8,175,1207,137,6570,38
6281,14,461,3385,368,7718,93
28919,11,132,2159,112,2355,20
21859,57,1604,2510,1232,9595,372
9529,294,14456,3186,10448,114332,4008
8825,0,32,3228,24,3664,8
3696,11,268,3495,221,13523,47
24618,1,63,2373,57,4678,6
37187,68,2395,1739,1768,15222,627
38584,46,1466,1644,1210,10091,256
2983,63,3024,3508,2444,76082,580
22897,0,75,2456,56,3977,19
45024,12,125,602,103,7311,22
3508,4,112,3498,89,9395,23
29018,8,138,2154,112,3308,26
32045,20,886,2000,644,11647,242
39210,10,507,1604,416,11328,91
6356,3,125,3381,91,12557,34
14419,109,6283,2892,4992,54701,1291
29662,4,198,2121,162,7227,36
15723,34,1635,2818,1238,15604,397
7211,7,305,3340,248,14919,57
2342,109,2762,3519,2009,33430,753
35791,6,224,1823,173,10711,51
36503,33,891,1780,730,6520,161
20286,5,409,2597,334,13329,75
20310,0,86,2597,72,3171,14
37798,107,12183,1699,9010,52461,3173
17212,76,6961,2743,4977,39788,1984
28998,19,837,2155,585,4882,252
5293,7,314,3430,259,4741,55
4480,49,1004,3469,780,11232,224
12583,0,143,3029,122,8734,21
36493,19,1036,1780,769,13357,267
7903,34,691,3294,561,16700,130
11578,19,1230,3080,879,16209,351
5690,23,577,3410,463,7019,114
43115,221,2382,1066,1947,23190,435
8472,24,506,3251,406,2593,100
42132,66,859,1296,670,13174,189
17520,4,216,2728,179,4480,37
19527,0,35,2639,26,4771,9
2298,27,709,3520,555,10676,154
15208,7,383,2842,323,5076,60
32155,58,2077,1993,1593,14595,484
27485,600,23018,2241,16491,143915,6527
8431,36,1116,3254,797,9117,319
24517,0,32,2379,28,4839,4
20427,26,1801,2591,1461,9259,340
42619,13,529,1196,377,11822,152
42349,260,4553,1251,3405,37233,1148
17383,6,445,2734,359,10069,86
7199,3,79,3340,66,4021,13
25780,0,18,2323,13,3128,5
42021,7,135,1316,106,5342,29
36824,11,364,1760,283,9684,81
9511,5,172,3187,146,3293,26
45985,45,680,252,581,16392,99
5928,132,6002,3398,4427,53668,1575
7210,82,1794,3340,1456,41626,338
37820,10,370,1697,308,19583,62
15254,14,1053,2840,805,9388,248
42942,6,313,1116,203,5953,110
5836,17,688,3403,496,26626,192
27287,4,498,2253,419,15883,79
30801,1,209,2062,181,4861,28
21716,18,478,2516,385,9242,93
9237,32,926,3205,761,17320,165
5320,27,871,3429,606,17464,265
45845,31,342,311,239,3846,103
2275,18,557,3520,379,12584,178
25488,7,570,2337,464,12444,106
32254,1,40,1989,32,3613,8
39575,1,46,1582,38,3036,8
9112,33,1125,3212,856,18828,269
14931,0,349,2858,234,6766,115
17989,13,2819,2707,2105,60379,714
25446,0,298,2339,236,9483,62
18734,4,151,2674,114,2729,37
24592,12,610,2375,487,7132,123
32780,17,253,1967,221,4363,32
15225,66,6140,2841,4559,27659,1581
17855,9,558,2715,432,8071,126
15919,51,2801,2811,2227,29556,574
10813,4,115,3120,91,3410,24
27423,0,75,2245,42,2944,33
38892,40,941,1624,713,16277,228
36972,3,80,1752,61,2986,19
36672,17,508,1770,411,5065,97
26373,30,600,2296,474,5252,126
28030,0,829,2209,673,8069,156
23177,57,1416,2443,1058,17815,358
8149,4,85,3273,70,3979,15
40248,3,81,1540,62,7006,19
36463,74,1440,1782,1070,9805,370
5847,21,763,3402,623,6017,140
15997,29,807,2807,584,20523,223
22053,5,302,2498,257,3684,45
27895,9,684,2217,586,7418,98
8564,272,18165,3244,12469,120426,5696
35564,0,62,1842,52,5758,10
7600,7,75,3317,39,2782,36
1208,4,91,3766,80,5565,11
41545,31,649,1396,502,10715,147
8337,81,1035,3259,780,12203,255
41847,16,670,1343,547,11362,123
6982,185,13557,3352,5666,32838,7891
1852,304,14060,3528,10466,55255,3594
40896,17,744,1480,521,17487,223
32541,110,4520,1977,3302,17988,1218
44281,134,1409,777,1141,16771,268
37361,15,508,1728,387,5866,121
17553,264,31731,2726,22632,120632,9099
37810,576,17782,1698,13339,112540,4443
44907,5,144,636,109,2523,35
33959,1,185,1922,166,21978,19
14156,2,151,2912,103,5477,48
33170,117,4328,1950,3414,41202,914
3698,6,149,3494,133,19441,16
29452,9,324,2131,241,3822,83
44678,1099,62248,708,48633,146436,13615
5551,26,785,3418,599,29995,186
3032,9,380,3507,283,3407,97
6468,5,179,3376,135,3424,44
27286,2,76,2253,67,5456,9
33725,0,75,1930,60,5629,15
17204,235,17527,2744,11925,111431,5602
43852,1185,25915,845,20723,125226,5192
39073,0,0,1612,0,4269,0
1266,8,198,3748,163,6987,35
29243,109,2566,2143,2099,22540,467
28957,2,191,2157,136,7370,55
37637,10,201,1710,140,3045,61
34962,1,64,1876,52,2929,12
30558,9,297,2074,235,5082,62
27419,5,339,2245,278,4775,61
41963,19,329,1324,247,4329,82
29458,111,4322,2131,3107,31085,1215
13872,8,924,2933,672,8856,252
36546,368,24667,1778,17610,143692,7057
30479,5,69,2079,59,2891,10
30312,32,645,2088,489,7700,156
4491,35,842,3469,627,9282,215
36568,129,4232,1777,3107,15372,1125
21863,49,4400,2509,3198,22505,1202
17617,4,332,2723,222,14369,110
27317,35,1323,2251,1081,19025,242
22279,2,101,2486,84,4481,17
30852,2,124,2060,96,5489,28
37725,6,135,1704,106,2384,29
17117,32,987,2748,734,7165,253
7524,13,985,3322,702,36695,283
25894,7,193,2318,158,2809,35
16245,1,94,2795,75,10424,19
27141,72,4510,2262,3276,22141,1234
15083,91,4291,2849,3099,39019,1192
2327,33,2339,3519,1835,23006,504
2827,2,41,3511,28,5191,13
35046,2,137,1871,107,3570,30
9823,4,165,3171,141,6449,24
4195,98,3029,3480,2258,23972,771
46264,37,319,146,263,3714,56
46381,8,121,95,115,3386,6
20860,5,202,2567,155,3186,47
37105,31,493,1744,365,4187,128
30756,33,1078,2064,843,7443,235
43970,2,22,829,17,1738,5
27796,1,195,2222,156,8447,39
17697,11,779,2721,588,14337,191
29514,3,922,2128,730,25052,192
16036,19,941,2805,619,7130,322
32513,36,1109,1978,881,12599,228
21380,3,197,2536,161,4221,36
6998,30,892,3352,672,10234,220
19382,34,2221,2646,1633,40089,588
10346,10,170,3146,142,6588,28
20344,7,398,2596,320,4740,78
41635,1,22,1383,19,5508,3
15532,46,1996,2828,1602,28743,394
4605,49,943,3464,639,8915,304
5338,184,17262,3428,12313,85223,4949
29876,43,3548,2110,2684,26985,864
5772,1,53,3407,40,1399,13
41664,1,56,1377,44,4739,12
11664,34,1006,3076,852,6668,154
3085,36,3639,3506,2886,21599,753
7145,2,248,3343,213,4780,35
2331,116,3221,3519,2487,44357,734
39851,25,812,1567,598,5688,214
12150,8,110,3052,91,2638,19
27836,0,0,2220,0,7435,0
8212,0,11,3268,10,1487,1
44953,230,2512,622,2092,21439,420
11027,131,6216,3109,4590,39919,1626
11750,163,7324,3071,5417,57380,1907
44491,97,1258,746,1134,21589,124
19810,1,61,2624,45,3988,16
36862,1,99,1758,82,5883,17
46315,25,415,121,341,6758,74
9682,1,66,3178,53,2419,13
43364,5,131,993,97,3337,34
29168,4,440,2147,298,4159,142
16523,10,614,2781,467,6656,147
39164,9,521,1607,408,4200,113
3514,9,475,3498,341,4445,134
2864,5,193,3510,145,7496,48
43870,133,5742,844,4265,31216,1477
26617,0,123,2285,105,5683,18
30985,2,89,2055,76,2941,13
35152,2,253,1865,210,6728,43
27496,2,216,2240,157,3323,59
21782,3,200,2513,141,6768,59
16169,12,615,2799,481,11295,134
18296,0,47,2693,40,1988,7
18108,1,213,2702,176,3591,37
4995,28,605,3447,476,5710,129
39266,0,218,1599,174,5902,44
12166,6,64,3051,52,2156,12
17044,8,359,2753,289,5632,70
15372,34,2048,2835,1624,4635,424
3791,1008,50136,3493,33925,312708,16211
2790,16,358,3512,269,8734,89
8507,11,310,3248,268,6196,42
22689,19,1369,2466,896,19736,473
13007,44,1529,3003,1211,12465,318
8057,3,46010,3276,17605,3341,28405
7001,4,66,3351,55,2213,11
40684,4,112,1501,86,6214,26
40819,7,116,1487,95,3254,21
32383,145,3278,1983,2719,18003,559
27040,31,646,2267,489,7075,157
36028,6,157,1806,124,3493,33
39952,15,668,1559,438,14755,230
13388,100,4968,2970,3511,43147,1457
9274,4,142,3203,110,5572,32
45528,0,54,438,26,2200,28
32577,2,46,1975,40,5122,6
3781,4,69,3493,54,3414,15
15431,4,119,2833,91,6738,28
39907,2,201,1562,155,6618,46
37945,4,119,1688,97,9036,22
16983,53,2203,2757,1588,16264,615
2409,7,185,3518,155,13324,30
11148,9,432,3102,322,10842,110
45535,0,14,435,8,969,6
2806,75,5678,3511,4250,40149,1428
24831,250,11518,2365,8928,90431,2590
4298,12,216,3476,170,3070,46
3770,1,79,3493,62,3666,17
19659,14,819,2633,651,16935,168
27079,197,19869,2266,13783,101287,6086
31354,11,295,2036,246,2339,49
37252,6,373,1734,295,10973,78
11185,31,1107,3100,888,12025,219
3343,44,1525,3502,1239,6297,286
37653,7,198,1709,162,5203,36
40907,30,1303,1479,919,14198,384
41120,14,515,1457,401,11189,114
18683,58,2672,2676,2002,14048,670
20958,4,601,2561,499,8626,102
5805,3,201,3405,145,11709,56
41041,0,182,1468,131,3545,51
5105,7,299,3441,212,3600,87
31047,289,24107,2052,18114,100586,5993
3112,9,143,3506,122,4830,21
46113,7,165,199,134,2111,31
44714,6,108,694,79,2410,29
2756,14,466,3512,390,9602,76
17939,4,180,2710,152,2622,28
9730,62,2515,3176,1848,11191,667
37107,1,57,1744,48,2229,9
28981,19,878,2156,713,11128,165
13707,326,17970,2946,13195,67179,4775
14821,35,1557,2864,1273,16749,284
2533,9,152,3516,128,4649,24
6239,1440,84719,3387,56610,430141,28109
2649,17,1591,3514,1224,7447,367
27966,49,3442,2212,2720,19824,722
27259,164,4896,2254,3845,21080,1051
38929,76,1999,1622,1567,16144,432
24662,3,102,2372,76,7434,26
21268,2,74,2541,66,3425,8
41957,19,251,1325,177,8887,74
27818,64,1599,2221,1201,14723,398
1862,35,821,3528,637,9227,184
42256,113,1834,1267,1344,24827,490
2458,5,118,3517,98,3774,20
5587,40,1533,3416,1201,13167,332
29652,157,4878,2121,3642,27763,1236
14381,45,2490,2894,1899,19727,591
18708,1,236,2676,189,9590,47
3008,3,77,3508,33,4802,44
38311,11,391,1663,297,11191,94
23490,51,1931,2427,1555,12361,376
10859,30,200855,3118,53345,29127,147510
26875,16,617,2273,524,8755,93
32475,0,23,1980,21,2141,2
16923,14,1275,2760,908,15469,367
9337,0,48,3198,42,3029,6
7202,16,313,3340,255,4686,58
25090,3,123,2354,98,2373,25
12145,53,1084,3052,843,13805,241
7324,19,595,3333,498,19115,97
32112,21,506,1996,356,12268,150
20454,66,4017,2590,3001,29301,1016
38025,5,336,1684,265,6630,71
43405,2,30,979,17,1673,13
46344,12,201,111,179,2677,22
45169,27,257,538,213,7602,44
18456,8,199,2687,163,2974,36
26631,13,1178,2285,868,22931,310
21115,19,694,2552,508,4954,186
25706,12,368,2326,293,4088,75
8177,13,756,3270,551,29462,205
17638,211,41593,2722,25254,107394,16339
7571,10,141,3319,108,10858,33
6603,6,146,3371,116,2953,30
39512,6,297,1587,227,8049,70
45037,63,510,595,392,11717,118
34188,1,103,1915,81,3522,22
44834,4,30,654,27,1985,3
41274,5,347,1434,239,6841,108
42599,37,843,1201,572,15993,271
8764,2,170,3232,123,7032,47
39147,12,268,1608,210,5800,58
20588,15,1783,2583,1399,7030,384
9376,164,12741,3195,9420,62570,3321
10640,83,3189,3130,2546,24833,643
10650,106,15363,3130,11128,76726,4235
6666,2,104,3368,73,4349,31
27033,43,2580,2268,1846,28385,734
6557,11,159770,3372,59883,14917,99887
42995,31,1034,1103,777,14886,257
45025,6,192,601,128,5341,64
36974,27,1168,1752,841,13741,327
38465,19,434,1652,354,5691,80
16089,3,259,2802,199,4772,60
6575,8,98,3372,90,3630,8
23696,31,1390,2417,1118,22253,272
13260,0,1956,2980,1532,13339,424
30632,1,54,2070,44,3394,10
10236,98,4983,3151,3733,51496,1250
45255,4,32,513,23,2133,9
18205,8,308,2698,249,5052,59
8977,1,37,3220,33,1869,4
40033,0,141,1553,84,4947,57
6521,21,771,3374,445,19989,326
40521,1,51,1515,43,2666,8
2683,47,950,3513,715,11843,235
14944,8,699,2857,512,8881,187
10737,35,2102,3124,1689,21243,413
3326,17,289,3502,235,12520,54
25059,2,91,2355,86,8787,5
45935,9,110,271,94,3578,16
34861,2,79,1881,62,7159,17
9628,5,273,3180,226,12671,47
6850,15,366,3359,271,8315,95
9616,2,127,3180,111,4478,16
3154,20,578,3505,447,7453,131
31344,46,1261,2037,1059,21106,202
24273,3,406,2391,313,9815,93
13037,167,11743,3001,8415,69764,3328
13299,49,1108,2977,784,5564,324
12211,47,1366,3049,1023,24648,343
18398,76,7946,2689,6064,33515,1882
38505,1,46,1650,37,2543,9
2148,53,1324,3522,1040,9676,284
43668,4,117,893,88,4002,29
37061,66,1861,1746,1413,28416,448
22546,8,259,2473,206,8531,53
2927,144,4904,3509,3811,47715,1093
36366,37,395,1786,324,5913,71
32854,12,486,1963,341,5839,145
46136,10,190,188,142,1737,48
40553,3,146,1511,116,4041,30
38719,1,52,1634,42,5691,10
22494,0,3180,2476,2194,24737,986
35617,1,35,1837,27,3826,8
41566,5,67,1394,54,4632,13
22757,3,84,2463,80,1710,4
14987,3,232,2855,178,8985,54
34453,1,44,1904,36,3962,8
27311,75,2133,2252,1675,27715,458
35276,50,1026,1859,848,16609,178
38160,19,664,1674,472,10935,192
32596,9,442,1974,350,8442,92
16545,2,400,2780,257,2812,143
21150,24,1952,2548,1462,27984,490
27666,17,673,2230,579,6846,94
40623,1,81,1505,58,1298,23
44772,681,19670,666,11799,62018,7871
17354,7,458,2736,358,4059,100
39079,59,2254,1612,1752,13894,502
37248,31,485,1735,411,14238,74
12015,14,751,3059,559,9251,192
38498,2,78,1650,65,4018,13
38602,7,195,1642,160,3946,35
27224,40,1326,2257,1046,21220,280
5354,31,389,3427,314,4838,75
14530,3,187,2884,151,3206,36
18905,50,1272,2667,977,11763,295
14325,54,1335,2899,1004,15589,331
3763,150,5569,3493,3801,35133,1768
7686,28,877,3312,627,6415,250
41871,30,682,1339,585,10245,97
18672,0,28,2677,21,2062,7
37316,0,95,1730,72,2948,23
43472,22,377,963,291,6284,86
12449,1,184,3034,145,3806,39
35891,9,246,1816,199,5809,47
30882,347,9389,2059,7143,56385,2246
9571,118,10489,3183,6653,87400,3836
12178,145,4957,3051,3441,57011,1516
35329,33,2439,1856,1858,21156,581
12358,2,41,3040,32,3765,9
6243,42,2275,3386,1330,24504,945
3987,61,1962,3486,1554,16345,408
7847,2,108,3300,74,5002,34
10272,15,315,3150,259,2727,56
2984,4,69,3508,60,2387,9
41599,987,23104,1387,16768,123869,6336
42570,13,269,1206,180,9856,89
29219,12,515,2144,374,3915,141
31716,1,59,2016,41,1982,18
9317,28,684,3200,505,16322,179
27913,26,852,2215,694,14983,158
38961,23,269,1619,230,4255,39
46108,10,92,200,61,1828,31
13251,8,219,2980,191,6647,28
27569,12,2195,2235,1676,24358,519
27408,9,249,2246,210,6820,39
11999,243,7980,3060,5643,68506,2337
2702,12,226,3513,192,8496,34
24929,43,2291,2361,1741,34453,550
37880,19,459,1692,395,7234,64
15951,176,8606,2810,6533,64030,2073
30757,91,1936,2064,1583,18948,353
44559,22,241,733,167,4979,74
28291,1,113,2194,93,4988,20
31778,0,78,2013,42,3497,36
19811,8,451,2624,375,14175,76
33780,32,1089,1927,847,12014,242
21065,12,374,2555,282,7566,92
22589,27,1535,2471,1193,12245,342
28285,7,234,2195,203,3206,31
22949,657,34675,2453,23923,220043,10752
25797,8,538,2322,447,4096,91
42375,36,809,1245,607,18380,202
18907,57,4383,2667,3369,24946,1014
37959,446,11859,1687,8889,83676,2970
27579,17,381,2235,310,4807,71
14933,4,170,2858,134,2633,36
38148,1,29,1674,23,4218,6
32086,28,898,1997,609,5235,289
13219,8,215,2982,159,2976,56
40972,140,4739,1475,3579,56157,1160
20261,22,3276,2599,2151,12426,1125
16684,1,18,2773,14,1781,4
34831,22,447,1882,356,8398,91
32851,3,157,1963,120,4142,37
27072,18,511,2266,377,8344,134
33498,193,4565,1938,3333,23478,1232
39041,16,407,1615,345,6414,62
44850,167,2079,650,1745,19281,334
43258,1,145,1025,106,2692,39
25801,2,95,2322,80,5033,15
36520,1,70,1779,59,1846,11
29539,4,234,2127,180,7063,54
43230,38,1812,1034,1290,20804,522
40161,1,34,1546,27,4043,7
4107,1176,40643,3483,29077,136059,11566
40065,13,1534,1551,1210,11638,324
40012,1,100,1555,69,7915,31
16333,0,27,2791,24,1848,3
5244,13,1288,3433,948,11169,340
30213,28,1467,2094,1136,22198,331
43718,354,3924,877,3270,40079,654
13023,7,579,3002,454,29015,125
42057,0,43,1309,39,4665,4
42246,28,499,1269,362,14466,137
1210,12,592,3766,480,12202,112
31859,7,186,2009,121,3799,65
38526,5,132,1648,111,4332,21
19324,25,925,2649,744,10593,181
42909,84,1474,1127,1179,27714,295
22277,34,4403,2486,3283,33248,1120
39898,51,2331,1563,1848,28528,483
20630,121,9479,2581,6936,38411,2543
15547,18,398,2827,320,6330,78
33890,3,96,1924,81,1841,15
34074,0,77,1918,61,2882,16
4801,20,307,3457,213,12590,94
43201,15,409,1044,287,6516,122
42639,6,69,1193,52,5192,17
3549,13,246,3498,182,4709,64
15672,29,1134,2821,785,12317,349
7632,4,320,3315,250,10808,70
30089,48,1890,2101,1539,33299,351
41022,2,120,1471,93,3851,27
37303,0,30,1731,27,3346,3
46026,23,365,233,302,4850,63
35079,0,239,1870,188,16752,51
13011,37,2972,3003,2188,46754,784
31360,14,994,2036,775,6011,219
6500,6,92,3375,74,2009,18
3483,9,269,3499,210,4437,59
23550,23,1494,2425,1114,13532,380
21108,188,5416,2552,4282,38212,1134
3850,35,831,3491,655,22266,176
34162,63,2107,1916,1635,11974,472
7258,2,42,3338,37,2904,5
30291,24,402,2090,345,5960,57
5989,14,150,3395,125,5104,25
42047,12,305,1311,239,4554,66
5755,4,209,3407,174,4769,35
35521,15,847,1845,663,13506,184
44935,4,19,629,15,1446,4
37269,44,2205,1733,1399,37621,806
17483,135,7118,2730,5341,46467,1777
5434,2694,188736,3423,129237,466913,59499
7679,45,1702,3313,1354,7476,348
24913,17,2736,2361,2092,65410,644
10510,2917,211603,3138,113481,551124,98122
21608,706,98930,2522,64699,209347,34231
13690,12,387,2947,315,9838,72
15078,16,901,2849,724,12053,177
4734,138,3648,3460,2610,34625,1038
23507,24,749,2426,554,11648,195
18357,8,555,2690,414,6796,141
2503,20,754,3516,532,8747,222
37557,1,25,1715,21,2826,4
15404,33,3528,2834,2774,28504,754
13633,108,5952,2952,4723,77727,1229
10034,11,239,3161,185,5085,54
42431,14,591,1233,385,9010,206
7513,37,1610,3323,1260,25504,350
16058,9,560,2804,415,8070,145
37285,88,1602,1732,1298,17697,304
2470,16,408,3517,351,9759,57
4256,158,4518,3478,3322,27884,1196
29983,0,1160,2106,918,25529,242
18614,68,3834,2680,2741,17628,1093
41760,112,2754,1360,2129,47143,625
7280,7,339,3336,243,3911,96
3074,48,1993,3506,1580,11581,413
16988,355,35740,2757,23100,147907,12640
18681,4,105,2677,80,4102,25
24326,30,1830,2388,1412,22072,418
4766,46,1343,3458,1090,9878,253
32530,56,1943,1977,1340,32862,603
38042,5,170,1682,142,4819,28
18177,4,84,2699,63,3663,21
12269,45,1331,3046,989,13497,342
35987,7,192,1809,151,8308,41
27349,12,4474,2249,3559,4127,915
9381,4,79,3194,59,3188,20
21472,25,714,2530,540,13533,174
35037,17,614,1872,496,9099,118
13362,0,122,2972,94,3523,28
29317,40,3694,2138,2615,25211,1079
40006,8,89,1555,72,3564,17
30028,497,22216,2104,16374,126322,5842
11900,10,320,3065,222,5275,98
40607,7,283,1507,218,4116,65
3829,1,23,3492,17,2124,6
6328,13,494,3382,318,10530,176
39444,41,593,1590,464,8602,129
30610,35,1217,2071,923,13533,294
42324,6,127,1255,93,6075,34
45556,2,40,424,17,1478,23
34165,56,1341,1915,1105,12668,236
18884,1,443,2668,362,6317,81
35948,4,305,1812,208,17528,97
39419,69,792,1591,628,9052,164
32599,188,7503,1974,5514,59765,1989
16288,609,27279,2793,19458,60618,7821
14896,48,1838,2860,1347,25429,491
28477,0,74,2184,55,2222,19
26843,24,922,2274,716,8924,206
32450,220,5746,1981,3972,36468,1774
39520,4,279,1586,209,4822,70
24546,57,3030,2378,2157,17984,873
38035,10,263,1683,197,4741,66
8416,3,170,3255,123,7455,47
26273,1,56,2301,49,2031,7
30697,4,314,2066,254,5538,60
13691,260,30552,2947,20535,89697,10017
43454,4,169,968,104,4376,65
25947,2,140,2315,113,6848,27
7223,1,23,3340,20,2202,3
29296,34,786,2139,624,8194,162
38964,14,270,1619,186,3052,84
13203,15,527,2983,436,20139,91
12806,26,2727,3015,1980,31314,747
32600,22,497,1974,404,4603,93
20826,7,831,2569,663,13442,168
43556,31,1058,933,846,20995,212
19584,3,184,2637,155,5392,29
25350,5,161,2343,115,7794,46
13221,48,722,2982,595,41421,127
35164,5,197,1865,160,5318,37
18417,1596,141027,2688,90744,399785,50283
35041,6,182,1872,147,8145,35
32060,142,6120,1999,4880,33863,1240
8367,1,22,3258,19,1165,3
42542,4,79,1210,55,2819,24
18580,8,462,2682,376,14956,86
15365,8,201,2835,153,4976,48
41016,3,147,1471,107,4760,40
17814,1,89,2716,72,4886,17
33616,60,1474,1934,1217,23845,257
11002,33,2983,3110,2013,24110,970
38155,23,287,1674,231,3676,56
28513,1,34,2181,29,2727,5
34822,4,112,1883,95,7201,17
33742,9,444,1929,325,19247,119
7249,31,1308,3339,978,25509,330
21270,13,577,2541,437,4910,140
23615,59,1862,2421,1395,13735,467
14566,15,1022,2881,850,9761,172
46275,2,27,141,24,557,3
43361,6,121,985,99,6382,22
25517,65,1979,2336,1602,10464,377
2050,9,561,3524,408,5713,153
20129,20,863,2607,640,12894,223
1807,63,3547,3531,2666,32885,881
34116,1,19,1916,15,1124,4
5022,1240,54400,3446,39173,274554,15227
43396,90,2494,982,1770,15794,724
34557,2,153,1899,135,4185,18
6465,1,29,3377,22,1916,7
13210,18,779,2983,567,9936,212
7514,65,1937,3323,1547,17811,390
9620,5,293,3180,224,4335,69
4568,188,7721,3466,5683,65100,2038
42180,43,502,1284,378,7062,124
30398,16,1164,2083,888,12342,276
15748,45,2571,2817,1898,23672,673
33246,32,290,1948,241,3569,49
2859,56,1923,3511,1431,34950,492
35206,9,348,1863,276,7298,72
3434,3,275,3500,213,7987,62
19885,58,3196,2620,2380,54378,816
7751,65,1934,3308,1464,42132,470
41268,48,1539,1436,1211,14732,328
38222,55,1245,1669,965,9241,280
24919,69,2209,2361,1658,25632,551
19692,9,308,2632,233,6052,75
37300,8,215,1731,165,8194,50
40891,15,1036,1481,639,13392,397
26030,4,385,2311,282,6619,103
20085,118,3747,2609,2868,40850,879
21572,240,11886,2525,8935,34567,2951
18486,26,2120,2685,1545,19924,575
39908,1,52,1562,39,4419,13
17959,75,4358,2709,3372,29436,986
46231,2,23,154,13,1502,10
19533,225,9063,2639,6395,35036,2668
3374,114,3615,3501,2820,44596,795
34475,2,120,1903,94,4396,26
16155,14,797,2799,659,8679,138
36866,30,1895,1758,1434,32814,461
43031,21,465,1094,361,20283,104
3883,2,88,3490,76,2748,12
16818,583,58418,2765,40849,90481,17569
15252,10,231,2840,174,4711,57
42227,122,2003,1273,1431,27501,572
30978,9,466,2055,387,7112,79
5134,118,5876,3439,4030,36263,1846
3028,203,6129,3507,4266,99155,1863
4561,47,1823,3466,1349,12603,474
28879,21,1034,2161,836,10202,198
15822,7,308,2814,237,16589,71
21978,17,835,2501,684,8861,151
39877,299,8635,1564,6230,50183,2405
25482,6,268,2337,201,14808,67
25699,271,16693,2326,12452,56526,4241
29153,42,2260,2147,1678,23703,582
12041,17,408,3058,303,5966,105
13746,8,242,2942,191,2755,51
12489,2,233,3033,186,6080,47
19017,33,1544,2663,1233,17797,311
32163,9,633,1993,524,13419,109
8420,17,510,3255,391,11331,119
45707,2,18,360,13,1510,5
8252,28,801,3266,555,7265,246
16142,54,1466,2800,1180,12480,286
30262,3,109,2092,83,2087,26
46363,0,29,104,29,1028,0
32196,6,193,1991,157,2983,36
7857,157,109728,3299,40173,46950,69555
3147,29,1150,3505,889,14869,261
40280,1,218,1538,171,7746,47
30233,0,189,2093,145,4155,44
11830,3,94,3068,83,6368,11
15073,18,881,2850,656,30048,225
45769,83,1321,334,1111,19500,210
4842,19,991,3455,724,13858,267
38939,7,354,1621,258,9953,96
19963,3,166,2616,114,7874,52
14210,27,1054,2909,811,14937,243
36212,207,14112,1795,11573,45376,2539
28398,6,385,2188,241,8872,144
31228,15,473,2043,403,6656,70
18196,0,303,2698,238,7083,65
17417,220,12976,2732,10098,124436,2878
45696,5,30,368,16,1373,14
7535,9,264,3321,216,19476,48
12569,10,1055,3029,781,11407,274
23477,7,280,2427,202,8504,78
43474,17,553,963,418,11513,135
42538,1,143,1211,104,5685,39
12275,45,903,3045,592,7064,311
19255,11,510,2653,422,8609,88
44733,13,343,689,233,5755,110
26225,448,25373,2303,17175,146925,8198
13239,12,1149,2981,845,5309,304
9783,14,522,3173,422,5142,100
5186,43,300,3436,246,20680,54
27039,63,1485,2267,1050,10165,435
32440,6,194,1981,166,3375,28
8347,79,2845,3258,2120,41496,725
33097,8,398,1953,356,2730,42
21220,12,447,2543,311,4718,136
38503,0,100,1650,82,3790,18
32822,0,81,1965,68,2632,13
18003,60,3564,2706,2879,30019,685
6337,21,1712,3382,1251,12655,461
39112,3,169,1610,113,4335,56
4871,27,861,3454,659,21795,202
43403,47,668,981,452,7093,216
35852,3,122,1819,101,4481,21
6836,321,17725,3360,12424,87853,5301
41534,76,987,1398,769,10961,218
45442,11,157,460,124,3348,33
11902,16,759,3065,613,10333,146
46109,2,44,200,30,1650,14
5596,14,196,3415,159,9532,37
42436,2,121,1231,93,2486,28
8236,137,5848,3267,4311,44156,1537
43035,87,2173,1092,1544,14898,629
17724,8,490,2720,384,3467,106
6636,2,83,3369,69,8619,14
3191,7,176,3504,141,6759,35
45930,21,241,274,173,3970,68
2356,79,4779,3519,3641,178684,1138
37193,53,1279,1738,1051,9195,228
27493,1,86,2240,67,2425,19
19311,27,1508,2650,1196,10596,312
2692,53,1330,3513,1127,28572,203
9462,9,235,3190,192,2691,43
7435,15,521,3327,415,8875,106
7000,3,46,3351,30,2188,16
34964,15,498,1876,407,6975,91
9489,5,286,3188,232,13930,54
3647,104,6835,3496,5222,33531,1613
8944,32,1197,3222,859,8668,338
21545,4,190,2526,151,2658,39
3626,15,600,3496,520,5627,80
31276,52,1389,2040,1100,19607,289
3125,2,47,3506,38,4219,9
32412,2,64,1982,48,2149,16
18294,214,20427,2693,14195,88269,6232
35723,336,7479,1828,5820,29727,1659
30747,10,235,2064,196,4835,39
16403,17,1538,2786,1215,12116,323
39549,8,114,1584,83,2696,31
33226,7,242,1949,204,8057,38
8487,4,111,3250,84,3341,27
11369,10,400,3092,325,8005,75
14984,246,9619,2855,6670,53909,2949
21960,79,5747,2502,4345,21001,1402
44780,171,1987,673,1697,26784,290
20348,274,11057,2596,7940,59427,3117
41440,12,716,1410,488,13913,228
16922,18,935,2760,761,12211,174
36407,142,3325,1785,2442,30838,883
5156,994,38776,3437,26592,239646,12184
2957,5,239694,3509,84731,7343,154963
19266,9,739,2652,576,12542,163
45514,2,36,442,27,2453,9
31825,5,406,2010,314,11500,92
18750,47,2181,2674,1679,15140,502
45332,4,86,489,45,2850,41
30797,19,647,2062,522,14059,125
31012,13,433,2054,360,4618,73
28787,0,205,2165,164,6036,41
12138,65,1477,3052,1102,10104,375
46021,47,462,235,357,5725,105
1931,23,1949,3526,1624,13045,325
33369,14,1727,1943,1301,17892,426
30907,0,0,2058,0,10828,0
1920,12,295,3527,242,4654,53
40102,140,6263,1550,4245,62344,2018
25722,6,300,2325,231,6244,69
37471,13,346,1721,288,6212,58
32601,115,3501,1974,2833,28498,668
7827,5,104,3302,79,1926,25
31984,16,980,2003,726,26013,254
27613,2,72,2233,61,2018,11
26405,8,219,2294,189,4361,30
41846,16,532,1343,401,10695,131
12169,38,1072,3051,788,15181,284
32845,28,2771,1963,2031,66743,740
40163,83,3155,1546,1980,18460,1175
44790,15,128,671,91,1935,37
30257,194,3799,2092,2614,23808,1185
42532,67,1353,1212,1019,40632,334
20644,201,4039,2581,3033,25992,1006
45425,3,50,465,43,3275,7
7562,23,443,3320,360,3359,83
3903,1,72,3490,48,3092,24
36677,0,83,1770,64,5931,19
39661,4,147,1578,124,9223,23
27961,3,222,2213,188,3855,34
37273,16,297,1733,236,4944,61
12189,53,2242,3050,1688,20687,554
33052,15,428,1955,342,7014,86
23577,1,130,2423,115,3368,15
27187,6,172,2259,132,2817,40
30036,2,212,2103,148,5426,64
28044,78,1102,2208,830,8406,272
46002,32,434,246,322,5814,112
11151,0,52,3102,48,3891,4
9174,45,1320,3207,1051,25215,269
9500,329,26497,3187,19479,47870,7018
17166,3,136,2745,107,2907,29
2387,333,14161,3518,10956,55786,3205
34669,104,1021,1892,765,9229,256
22386,10,464,2481,318,10431,146
40172,1291,38381,1546,25753,192668,12628
10856,4,68,3118,59,4731,9
21344,11,453,2538,349,11091,104
2619,15,411,3514,331,7423,80
45788,2,27,330,21,1708,6
35563,0,45,1842,38,3437,7
31218,246,5104,2044,3597,47062,1507
11781,3,135,3069,102,4363,33
16896,46,2366,2762,1777,12371,589
13429,278,22560,2967,13445,131318,9115
7440,1,64,3327,50,2020,14
4829,12,360,3456,280,12139,80
42756,11,355,1164,235,7011,120
16370,24,975,2789,743,4285,232
40212,4,155,1543,137,3762,18
1994,26,2085,3525,1415,40918,670
6947,90,2936,3354,2160,14966,776
33384,44,1278,1943,889,10046,389
9187,436,21244,3207,16252,90031,4992
10006,3,118,3163,92,7056,26
32977,14,417,1958,339,8943,78
13174,67,1706,2984,1344,18276,362
11438,9,768,3088,537,16315,231
10243,11,180,3151,124,2519,56
30484,2,129,2078,107,4442,22
8740,2,178,3234,152,5556,26
45154,25,296,543,199,4714,97
23691,10,229,2417,163,5168,66
1895,251,8477,3527,6428,132754,2049
19696,69,2742,2631,1970,18512,772
40240,2,181,1540,138,6135,43
26123,4,246,2308,216,3939,30
8183,43,1207,3270,951,7247,256
31969,2,136,2004,123,3389,13
41471,29,817,1406,626,9763,191
11596,24,517,3080,406,8958,111
24122,0,131,2397,108,5118,23
25737,6,740,2324,582,18959,158
37935,76,737,1688,558,6654,179
38075,9,168,1680,151,3815,17
2491,3,229,3516,197,7360,32
41743,22,1146,1364,739,22590,407
43416,212,4289,976,3283,31008,1006
42414,285,10266,1237,7160,95661,3106
6415,149,5456,3379,3978,38451,1478
21846,16,1361,2511,1055,15122,306
37054,1,61,1746,49,2738,12
22545,2,167,2473,131,5971,36
20066,3,159,2610,127,7149,32
39972,0,202,1558,154,5708,48
29127,43,1040,2148,872,10872,168
45473,1,26,454,19,1359,7
34393,22,618,1906,500,14981,118
12218,244,71519,3049,45619,234338,25900
36315,4,116,1789,103,1901,13
1566,1,31,3590,28,1701,3
20248,145,24698,2599,14687,73215,10011
15026,6,417,2852,347,6745,70
21587,11,701,2524,555,7708,146
8639,112,2627,3240,1914,23609,713
27729,11,420,2227,298,6963,122
36650,156,4794,1771,3693,55168,1101
28874,154,27386,2161,22106,60448,5280
10708,28,1038,3126,806,27177,232
34263,10,263,1912,208,4936,55
4177,15,1057,3480,672,7050,385
34580,15,531,1898,413,7449,118
13852,9,417,2934,295,6939,122
10936,98,6741,3114,5227,102208,1514
43409,22,191,978,166,5840,25
12176,38,899,3051,683,13885,216
29628,7,132,2123,99,2421,33
13666,24,1169,2949,916,34544,253
29158,2,76,2147,68,2688,8
10808,2,33,3120,27,1953,6
28382,8,407,2189,315,7987,92
5419,3,66,3424,55,1989,11
40019,1,22,1554,19,8141,3
24010,14,403,2402,298,6216,105
29405,2,80,2134,71,2995,9
38727,12,483,1634,363,10056,120
22880,26,951,2457,744,4363,207
20837,25,1372,2569,1064,9448,308
2567,37,3063,3515,2243,19561,820
20418,51,3675,2591,3020,13977,655
14054,36,2279,2917,1648,70097,631
30387,1,228,2084,184,4158,44
4414,36,1009,3472,786,25131,223
5920,9,133,3398,103,7957,30
30003,12,357,2105,295,5008,62
1897,23,462,3527,380,11312,82
32167,11,119,1993,85,2574,34
29708,23,1053,2119,767,14299,286
33774,19,495,1928,394,9793,101
15946,14,1035,2810,807,26671,228
43293,34,536,1016,376,4961,160
13616,13,197,2953,157,2323,40
43018,192,3367,1097,2503,44690,864
12947,10,674,3007,586,6058,88
4989,10,231,3447,187,7338,44
31589,13,1433,2023,1096,16460,337
46226,0,8,155,6,1016,2
34307,20,954,1910,730,11477,224
37292,2,181,1732,137,3836,44
43751,1,42,868,32,3666,10
28586,108,6650,2176,4983,27025,1667
8528,0,32,3246,29,1941,3
9584,12,146,3182,114,10863,32
4089,60,1281,3483,979,23623,302
31790,10,197,2012,104,1861,93
36931,178,8982,1755,7248,47612,1734
14214,255,14341,2908,9547,45524,4794
45304,23,184,497,147,4270,37
7792,18,336,3304,257,4361,79
12159,2,160,3051,136,6984,24
39767,5,153,1572,105,5627,48
35428,2,70,1851,57,2955,13
40481,218,6149,1518,4639,26991,1510
4098,5,225,3483,153,13116,72
43116,0,17,1066,13,3337,4
38786,1,77,1630,71,2098,6
24827,5,207,2366,174,2446,33
45057,6,107,588,72,4022,35
24332,4,135,2388,104,4251,31
30512,12,198,2076,156,3809,42
18943,0,6673,2666,4737,40972,1936
39666,44,546,1577,416,10466,130
19935,79,5077,2618,3854,32204,1223
24880,2,440,2363,314,10115,126
14702,18,755,2873,607,12108,148
3313,15,318,3502,264,4731,54
41786,15,290,1355,219,6787,71
41186,0,0,1450,0,4365,0
41371,4,254,1421,201,3119,53
13491,1,107,2961,85,2780,22
31005,16,451,2054,332,6556,119
6616,21,701,3370,393,12086,308
12163,38,988,3051,757,12635,231
45457,5,52,457,40,3279,12
18165,2,111,2699,87,2837,24
9924,21,625,3167,489,9708,136
10977,2,56,3112,42,3796,14
3057,5,294447,3507,92359,4345,202088
21919,10,426,2506,328,11106,98
35803,12,286,1822,219,4388,67
30849,3,103,2060,85,1534,18
3811,29,481,3492,351,22083,130
37709,18,479,1706,389,14113,90
6340,3,137,3382,108,6920,29
37649,10,357,1709,306,5926,51
33438,133,3698,1941,2899,30451,799
2770,36,500,3512,408,11062,92
27789,4,206,2222,152,4345,54
19597,1,262,2636,199,6526,63
3025,41,1241,3507,771,8896,470
4110,10,492,3483,321,4778,171
25501,0,317,2336,281,8626,36
9479,52,858,3189,572,9716,286
11538,1,80,3082,64,2713,16
42239,3,383,1270,200,11375,183
8508,35,1241,3248,971,10233,270
11742,44,902,3072,717,22077,185
22428,0,1119,2480,913,13364,206
12492,2,98,3032,71,2827,27
22140,25,1512,2493,971,11987,541
28644,2,156,2173,113,5707,43
2251,29,1141,3521,391,32620,750
28130,18,840,2204,669,7304,171
42277,15,258,1263,195,3091,63
17292,0,195,2739,150,4752,45
46087,7,134,207,121,1874,13
45855,84,2033,279,1683,21409,350
38555,5,148,1645,105,4543,43
10441,43,735,3142,564,25610,171
7036,116,2618,3349,2034,22189,584
29534,4,377,2127,277,16469,100
7726,3,232,3310,177,6443,55
23629,9,405,2420,314,4099,91
39059,12,277,1613,234,5498,43
12660,9,255,3024,177,5254,78
10194,218,9659,3153,6862,64955,2797
24219,4,1176,2393,967,37662,209
26078,0,129,2310,97,3194,32
34846,5,469,1882,343,6271,126
46045,38,532,221,427,6843,105
5113,8,245,3440,184,5945,61
7508,67,6267,3323,4330,75729,1937
34978,32,1402,1875,1086,8272,316
41738,3,196,1365,143,8011,53
20461,54,3790,2590,2804,17204,986
15564,60,3463,2826,2532,29173,931
18124,2,88,2701,76,2185,12
30946,8,338,2057,255,6769,83
33341,3,164,1944,138,2937,26
39090,4,128,1611,106,3395,22
21526,156,7674,2527,5481,41144,2193
2459,72,3915,3517,3063,61861,852
22062,63,2065,2497,1571,12286,494
9322,246,12175,3199,8312,64128,3863
14831,11,648,2863,511,9272,137
39411,116,3651,1591,2556,42960,1095
26788,176,6105,2277,4300,49666,1805
33471,1,84,1939,74,3607,10
25093,27,618,2354,456,4029,162
43386,240,3839,968,2851,47798,988
22700,39,845,2466,626,5499,219
36559,1,85,1777,57,2675,28
18351,7,306,2691,217,5962,89
43006,6,305,1099,192,4736,113
24281,13,524,2390,437,6682,87
31499,42,886,2027,687,6205,199
35537,24,1613,1843,1137,13063,476
26738,1,55,2279,44,3908,11
37144,141,4724,1741,3451,36981,1273
32617,2,47,1973,37,3357,10
40766,136,4172,1493,3206,25273,966
40008,36,828,1555,637,6764,191
37765,38,442,1701,350,4800,92
44815,2,19,662,14,1357,5
40198,132,3662,1544,2787,30193,875
24437,9,332,2383,268,5885,64
46160,39,355,174,296,3952,59
4398,30,1658,3472,1275,21343,383
45275,326,4154,505,3517,17162,637
5394,6,310,3425,251,8977,59
45743,5,97,342,71,3627,26
38224,1,88,1669,66,3458,22
15096,143,5848,2849,4172,28094,1676
14074,94,4198,2916,3265,38172,933
14610,15,802,2878,629,12069,173
7685,3,63,3312,55,2799,8
3019,0,22,3507,17,2471,5
26454,15,479,2292,394,8840,85
46385,0,5,92,4,912,1
27483,5,220,2241,159,5695,61
19145,16,392,2658,309,6182,83
6325,4,243,3382,182,14747,61
42750,17,568,1166,386,6815,182
23168,29,2089,2443,1500,41993,589
6853,144,12271,3359,7774,56764,4497
11548,3,177,3081,149,4671,28
4613,13,401,3464,328,10288,73
3063,476,0,3507,0,297507,0
30462,2,51,2079,42,1932,9
29697,33,1485,2119,1104,25565,381
27249,3,195,2255,174,8666,21
21072,136,4690,2554,3655,16688,1035
35608,112,2791,1838,2180,12922,611
30249,3,296,2092,242,5173,54
26680,27,1842,2282,1338,25683,504
36418,5,155,1784,125,5036,30
31608,7,215,2022,164,2881,51
2652,2,48,3514,45,3850,3
26876,13,533,2273,409,5088,124
11984,2,92,3061,71,4084,21
42784,2,128,1156,96,9763,32
35773,10,415,1825,332,11198,83
23419,129,5216,2430,3854,28253,1362
4056,41,1185,3484,938,14448,247
22795,201,5099,2461,3768,28361,1331
7442,9,496,3327,336,5907,160
6695,40,1740,3367,1432,19547,308
16801,5,208,2766,178,3332,30
31373,17,885,2035,658,12497,227
4303,7,245,3476,204,7945,41
1557,5,24923,3592,7277,1927,17646
45551,0,8,427,6,1291,2
41246,154,3988,1440,2795,52226,1193
25924,10,442,2316,339,5673,103
17329,20,799,2737,677,7564,122
12520,2,278,3031,222,3590,56
19091,1,34,2660,27,3359,7
30138,14,548,2098,439,3993,109
23253,11,1147,2439,830,10564,317
9593,65,2909,3181,1909,26604,1000
16287,4,365,2793,256,7891,109
16008,139,11857,2807,9265,62377,2592
23736,1,63,2415,51,4746,12
37563,7,470,1714,357,5165,113
29321,114,2760,2137,2135,16572,625
38278,59,1119,1666,893,7165,226
2916,6,189,3509,164,15768,25
23343,3,257,2435,211,4640,46
45006,3,68,606,51,2224,17
9370,7,667,3195,502,19822,165
39766,16,319,1573,251,8207,68
43483,30,389,960,283,5242,106
42690,21,487,1179,387,9944,100
9622,39,999,3180,781,11839,218
23585,98,3303,2422,2698,18031,605
14901,51,1374,2859,1067,15763,307
29909,7,239,2109,187,3130,52
18995,11,724,2664,608,6781,116
46116,9,208,197,168,4959,40
24578,8,314,2376,238,2871,76
7317,243,13094,3334,9818,65213,3276
10366,3,164376,3146,50594,4754,113782
3004,13,538,3508,424,9472,114
31924,2,65,2007,53,3774,12
21854,8,430,2510,349,6549,81
11124,127,7669,3104,5929,44415,1740
34949,133,4002,1876,2901,39452,1101
22231,391,23315,2488,17231,119397,6084
42802,4,105,1150,90,3186,15
29683,5,74,2120,64,4578,10
30432,11,353,2081,261,5459,92
26363,12,558,2296,446,6942,112
38521,1,106,1648,85,4218,21
3557,0,180669,3497,68702,1659,111967
22944,2,232,2453,180,9957,52
2161,50,1489,3522,1195,15755,294
28614,41,796,2174,618,8681,178
32055,21,996,1999,695,17719,301
12078,45,1596,3056,1049,21815,547
23286,0,141,2437,101,2792,40
30341,28,2241,2086,1896,6843,345
2802,74,1403,3511,1109,10978,294
17302,2,81,2738,53,9342,28
2217,35,1755,3521,1433,33096,322
21705,379,16713,2517,12170,46338,4543
40324,78,2914,1535,2192,31740,722
24528,12,520,2379,429,4820,91
13670,60,2190,2949,1709,17272,481
1857,39,424863,3528,120715,26792,304148
32211,14,298,1991,250,6026,48
3952,13,201,3488,176,4713,25
37953,6,293,1687,230,10527,63
33044,1366,103014,1956,68714,282020,34300
37176,8,264,1739,225,10875,39
27395,50,3994,2246,2847,22336,1147
16150,269,13292,2799,10164,47906,3128
17943,294,26411,2710,18881,98949,7530
11844,60,2025,3068,1366,12967,659
18506,6,467,2684,287,5105,180
4943,35,803,3449,637,5603,166
42309,22,495,1258,391,6114,104
6330,22,2339,3382,1623,8805,716
2307,18,307,3520,220,10777,87
4904,63,1490,3451,1185,13658,305
2777,0,20,3512,16,2199,4
42745,7,228,1166,163,7290,65
14795,23,993,2865,742,15169,251
23723,7,145,2416,129,4306,16
18990,2,148,2664,124,2597,24
29799,6,265,2115,205,5733,60
22120,30,2808,2493,2180,20995,628
15578,29,1334,2825,990,12084,344
29114,17,525,2149,389,3455,136
18889,4,361,2668,263,5999,98
11189,701,28353,3100,22280,94696,6073
38170,44,3336,1673,2698,12782,638
2124,13,329,3522,277,6159,52
19557,42,4876,2638,2902,22531,1974
38923,28,1111,1622,798,15625,313
30720,1,104,2065,88,5401,16
35144,25,648,1866,516,6173,132
12082,612,35566,3056,23554,230638,12012
31912,23,1400,2007,993,9741,407
2693,5,184,3513,153,8648,31
39686,23,525,1576,430,10749,95
26155,3,195,2307,170,4130,25
41037,38,808,1470,643,20539,165
45012,7,99,605,72,2766,27
33785,2,80,1927,67,3166,13
29852,11,350,2112,285,12096,65
24013,22,2092,2402,1431,5345,661
1875,32,238,3528,188,5532,50
33779,49,1325,1927,1044,11415,281
36823,14,635,1760,491,16983,144
31171,29,337,2045,272,4725,65
23042,31,3358,2449,2677,21863,681
19703,7,573,2631,458,9269,115
28378,829,107688,2189,73908,176896,33780
33247,3,127,1948,112,3028,15
20758,9,361,2574,287,5805,74
16478,19,758,2784,608,12786,150
2154,21,699,3522,581,12715,118
19390,3,335,2646,277,10954,58
8240,3,188,3266,150,3826,38
34259,4,278,1912,217,8483,61
2608,76,4361,3514,3172,43422,1189
39914,6,91,1561,77,4326,14
15147,62,4182,2845,3252,41507,930
15681,36,1248,2820,941,13076,307
37536,136,3040,1716,2296,21832,744
32699,292,12299,1970,8594,97552,3705
17695,14,456,2721,361,3172,95
3331,19,464,3502,353,4872,111
17192,79,2151,2744,1593,34796,558
4986,15,614,3448,441,8549,173
30670,22,854,2068,622,7173,232
25928,3,173,2316,118,4681,55
35104,3,396,1869,330,5963,66
15785,151,9919,2816,7461,67772,2458
14612,373,19357,2878,14250,148542,5107
7539,30,785,3321,612,10779,173
28651,10,490,2172,396,6966,94
7134,25,1154,3344,954,13335,200
29949,7,278,2107,232,3433,46
3806,278,28937,3492,19636,67450,9301
8544,34,1158,3246,743,14374,415
39976,25,621,1557,511,16453,110
7500,153,8502,3324,6066,46095,2436
23636,21,1682,2420,1116,27193,566
21557,22,2186,2526,1685,11469,501
16751,6,539,2769,448,9616,91
46210,1,38,158,23,1142,15
22057,274,20330,2497,14545,136246,5785
24477,99,3203,2381,2633,20985,570
39626,539,32153,1579,24593,164641,7560
17596,62,5137,2724,4061,45224,1076
2931,17,714,3509,569,16296,145
41311,52,506,1429,367,6795,139
11793,2,85,3069,73,2417,12
18492,6,294,2685,189,10453,105
8445,114,2770,3253,2244,30582,526
26447,3,307,2292,249,3340,58
2322,50,1450,3519,1090,11875,360
39702,21,811,1575,578,14009,233
42371,22,254,1246,168,3983,86
42268,52,1753,1265,1268,28824,485
5889,33,934,3400,792,18033,142
5097,1195,43322,3441,30472,153809,12850
41145,24,620,1455,463,12052,157
39162,3,44,1607,37,4863,7
10179,2,90,3154,57,2151,33
41880,47,1046,1337,786,30092,260
32084,10,407,1997,304,10212,103
37535,1,69,1716,55,4587,14
39311,3,100,1597,82,6615,18
9290,55,1930,3202,1499,25857,431
12011,61,4170,3059,3105,63880,1065
13121,36,1154,2995,885,13997,269
38760,29,429,1632,300,5580,129
45059,89,1990,587,1506,12755,484
34753,206,3433,1888,2405,17676,1028
42796,20,230,1152,169,6128,61
5283,10,273,3431,219,16275,54
9896,17,589,3168,399,4931,190
30938,45,1143,2057,921,15322,222
40087,15,592,1550,363,6544,229
30550,10,695,2074,516,7132,179
2991,20,696,3508,579,14223,117
16341,6,135,2790,102,3798,33
33935,2,146,1923,112,7500,34
14650,0,138,2876,106,4602,32
39975,24,501,1557,366,10249,135
25200,0,121,2348,95,10617,26
27254,49,2031,2255,1614,11974,417
36552,51,906,1778,692,16201,214
38920,18,682,1622,508,12407,174
31006,12,496,2054,395,7476,101
7103,828,32263,3346,22900,115825,9363
38559,7,390,1645,281,13684,109
29007,246,3889,2155,3131,16145,758
5412,3,200,3424,150,3631,50
45910,27,1085,288,546,7444,539
23307,0,59,2436,47,2482,12
21711,26,3623,2516,2425,18731,1198
9694,0,86,3177,55,11094,31
42205,11,423,1278,305,8878,118
29843,0,55,2113,44,4309,11
22114,21,1313,2493,1042,14440,271
10234,11,354,3151,261,8426,93
7496,2,119,3324,90,4243,29
4684,1,37,3462,31,3601,6
39327,82,1331,1596,1028,14952,303
29792,6,370,2115,287,6099,83
19653,14,2048,2633,1451,29369,597
43522,12,258,947,214,6160,44
44312,11,101,771,84,6934,17
4899,17,324,3452,263,12834,61
7027,0,140,3350,122,4355,18
33212,105,4453,1949,3482,38744,971
43228,33,720,1034,485,15397,235
20896,232,20098,2564,14716,126881,5382
45335,69,922,487,793,5457,129
15445,0,92,2832,76,1658,16
45395,5,28,473,24,2188,4
30426,7,280,2081,232,7742,48
3605,9,303,3497,229,4770,74
6170,1,216,3389,174,6109,42
24099,13,491,2398,385,8926,106
23266,34,966,2438,831,6600,135
14327,1,27,2898,20,4771,7
9589,1,73,3182,63,2873,10
35308,82,745,1857,575,5652,170
34879,174,13852,1880,8884,102943,4968
38574,1,50,1644,38,3584,12
37084,4,171,1745,132,6024,39
19685,6,212,2632,179,3307,33
8633,12,494,3241,400,6703,94
45506,4,52,446,34,1547,18
6978,70,1290,3352,804,14261,486
17295,13,434,2739,360,2983,74
17877,3,318,2714,254,6059,64
35454,52,1592,1850,1216,12041,376
32560,12,218,1975,184,3819,34
39084,18,1014,1612,773,6915,241
22799,2,123,2461,103,3091,20
13262,0,1228,2980,1006,15434,222
28222,4,305,2198,235,8631,70
14822,211,5536,2863,4115,30898,1421
15301,8,429,2837,351,10644,78
7146,5,146,3343,122,3173,24
41949,362,13936,1327,9875,78250,4061
45308,36,413,496,314,4262,99
18772,43,1334,2673,1051,12558,283
44847,45,631,650,552,14362,79
19946,0,1650,2617,1315,20962,335
20965,7,241,2560,202,3717,39
39058,10,266,1614,197,11742,69
2332,16,1162,3519,939,18515,223
13703,19,577,2946,486,3845,91
3509,11,436,3498,340,19129,96
32237,4,49,1989,42,2984,7
17759,6,266,2718,205,3634,61
36682,23,603,1770,471,6396,132
14675,2,74,2875,61,4219,13
45314,167,3463,493,2909,28005,554
3430,20,762,3500,594,11630,168
5501,16,969,3420,772,12951,197
6084,2,142,3392,104,8577,38
12310,1,52,3044,32,2441,20
43745,368,12449,868,10177,92980,2272
19648,22,915,2633,697,9980,218
19934,2,77,2618,67,2110,10
13729,5,327,2943,268,10149,59
42026,24,290,1315,211,8254,79
44893,8,80,640,59,1847,21
39078,11,646,1612,398,11770,248
31397,15,443,2034,358,15646,85
9531,800,32601,3186,25454,124687,7147
6734,50,1540,3365,1168,17307,372
43075,6,376,1078,233,7486,143
39654,1,79,1578,60,4604,19
16832,29,982,2765,810,9535,172
6598,27,1509,3371,1105,30979,404
41914,65,2238,1333,1561,19324,677
4278,50,2329,3477,1804,41838,525
6815,5,156,3361,117,3453,39
38801,120,2096,1629,1623,20192,473
6822,124,5049,3361,3737,67205,1312
38089,11,261,1679,211,11375,50
4683,5,102,3462,84,3903,18
25226,815,29651,2348,21991,114306,7660
28403,10,408,2187,330,6987,78
2651,14,233,3514,186,12239,47
39637,71,2478,1579,2017,28565,461
24520,2,360,2379,287,8481,73
16340,6,412,2791,337,8988,75
42331,21,666,1254,537,6164,129
24833,80,2453,2365,1936,12630,517
6178,76,3044,3389,2280,27120,764
32700,39,850,1970,671,8656,179
34405,102,4300,1906,3339,28313,961
46261,5,60,146,36,1936,24
40120,3,91,1549,67,3095,24
25574,1248,97165,2333,67510,289703,29655
29472,22,555,2130,422,4088,133
3481,0,16,3499,14,2111,2
22388,74,2573,2481,1929,23880,644
12894,1,236,3010,166,8498,70
32023,42,3105,2001,2380,34612,725
20799,1150,81265,2571,54828,318292,26437
41235,9,214,1442,162,8730,52
43184,29,314,1049,228,7549,86
7627,22,953,3316,715,15784,238
40610,10,133,1506,104,2479,29
17408,1,81,2732,68,2650,13
3926,9,308,3489,242,6658,66
13841,2020,72929,2935,46347,238795,26582
17845,2,83,2715,61,2530,22
14511,3,130,2885,104,7160,26
28769,6,117,2166,109,5750,8
22909,14,564,2455,449,8319,115
37108,19,281,1744,236,4818,45
24516,214,4852,2379,3516,19228,1336
41822,44,970,1347,824,19060,146
31512,3,140,2027,110,3551,30
36655,2,67,1771,52,3030,15
7658,10,276,3314,233,7744,43
12706,14,343,3021,286,3551,57
38351,30,1496,1660,1179,11928,317
15211,10,176,2842,143,5133,33
18467,7,152,2686,104,6564,48
46313,21,346,122,286,5569,60
13595,26,1784,2954,1420,54306,364
36436,23,749,1784,567,20474,182
5925,38,1366,3398,1048,21118,318
2951,129,6242,3509,4473,138990,1769
21169,408,18386,2547,12674,156470,5712
12873,45,1048,3011,801,8100,247
7595,24,689,3318,536,9174,153
46051,11,147,217,103,5642,44
41526,174,4059,1399,2976,27910,1083
20180,10,464,2604,391,5229,73
46355,5,63,108,44,1290,19
24938,44,2728,2360,2214,29103,514
36665,88,1851,1770,1412,11956,439
2794,2,136,3511,102,3588,34
8976,6,231,3220,179,4805,52
20256,5,209,2599,172,4554,37
1103,6,251,3801,211,7152,40
10715,240,10516,3126,8056,40639,2460
35590,39,843,1839,699,9422,144
13740,6,272,2942,208,10285,64
1527,4,51,3602,45,1715,6
39624,77,2066,1579,1552,18333,514
18288,2,179,2694,153,2515,26
13905,27,2811,2928,1658,20378,1153
18811,8,334,2671,260,2180,74
38975,5,111,1619,85,5701,26
5950,3,56,3397,50,2444,6
27378,4,118,2247,88,2952,30
38336,633,22845,1661,17014,110656,5831
9026,1,106,3218,85,7835,21
34732,1,138,1889,108,3721,30
44795,33,590,669,427,3369,163
4970,159,8728,3448,5698,50348,3030
18279,2,79,2694,69,3586,10
34271,49,1459,1912,1215,13591,244
6298,8,173,3384,144,5574,29
40411,4,159,1525,113,5571,46
8133,7,217,3273,174,10516,43
29675,21,618,2120,498,6130,120
2850,31,1129,3511,725,14732,404
23452,2,81,2429,67,4905,14
3965,6,85,3488,69,4139,16
9996,18,313,3163,228,4983,85
46291,2,38,134,24,1484,14
2724,12,71,3513,54,9274,17
38908,23,924,1623,676,12500,248
29256,1,491,2142,377,6450,114
21356,4,236,2537,190,8820,46
35745,13,365,1827,295,3332,70
9319,31,469,3199,341,3392,128
45972,17,142,256,114,2146,28
19132,139,17612,2659,13111,81933,4501
40304,168,4454,1537,3188,40881,1266
43033,13,323,1092,219,4614,104
30628,7,237,2070,194,7796,43
36207,21,516,1795,361,6710,155
42529,92,1758,1213,1376,36977,382
40470,57,1567,1519,1142,18628,425
44763,8,65,680,59,3560,6
4642,47,1218,3463,952,14930,266
38750,10,282,1633,208,5507,74
33335,327,10809,1944,7792,35756,3017
7860,1,26,3298,25,1982,1
41855,519,10539,1342,7454,89039,3085
4895,16,513,3452,410,4469,103
7428,11,1135,3327,680,18017,455
28770,1,71,2166,58,4449,13
11144,1,0,3103,0,2594,0
35383,27,1100,1854,814,14710,286
44842,46,412,652,323,5351,89
39464,2,184,1589,150,7392,34
12429,1,95,3035,84,8088,11
16413,5,146,2786,117,4959,29
3973,878,40880,3487,29810,166270,11070
29637,21,777,2122,601,10391,176
24334,0,2524,2388,2040,29256,484
25455,2,192,2339,167,4302,25
43204,188,5799,1044,4195,15742,1604
2319,9,396,3519,321,11257,75
6056,3,91,3393,66,4501,25
12184,94,7210,3050,5262,75599,1948
22315,4,182,2485,130,6298,52
44765,11,178,680,132,4662,46
18445,6,378,2687,314,11288,64
28456,6,153,2185,135,5082,18
26230,0,14,2303,11,1257,3
9922,2,132,3167,109,2601,23
18389,5,503,2689,408,2959,95
3820,23,1156,3492,926,20189,230
12917,6,1152,3009,839,9918,313
31355,4,126,2036,111,3418,15
28821,84,1054,2163,793,5756,261
41829,9,664,1345,519,17324,145
7621,14,419,3316,338,8128,81
3512,14,589,3498,493,5826,96
4157,72,205243,3481,65844,11474,139399
40666,44,1932,1502,1516,16024,416
5956,1,30,3396,23,2856,7
17242,0,362,2741,295,9846,67
31446,3,147,2031,117,3603,30
11696,71,2244,3074,1751,7754,493
45093,68,825,568,623,8435,202
15549,80,4275,2827,3138,50158,1137
44785,36,302,672,272,6389,30
21966,159,4925,2502,3886,17621,1039
3200,21,985,3504,753,29623,232
23255,8,188,2439,144,3091,44
25648,23,687,2328,498,10460,189
21792,0,326,2513,265,5667,61
36487,7,307,1781,247,5342,60
39389,30,1261,1593,985,17085,276
10684,20,710,3127,532,11411,178
12682,135,6333,3023,4862,63496,1471
24182,13,291,2395,220,7035,71
42871,6,107,1137,88,2574,19
21698,99,15984,2517,10889,52471,5095
28132,42,1465,2204,1122,8400,343
21289,26,1266,2541,1013,13601,253
24074,4,124,2400,85,2165,39
4069,119,4230,3484,3345,72413,885
27642,2,29,2231,24,2187,5
23018,40,4277,2450,3005,42671,1272
31084,1166,57845,2050,37139,222031,20706
37413,480,20219,1725,12517,95650,7702
6714,8,478,3366,280,5537,198
10896,66,3623,3116,2671,20692,952
10701,85,2745,3127,2087,13233,658
40579,525,15746,1509,11858,91037,3888
28420,1,149,2187,122,4243,27
29967,19,562,2106,428,10996,134
1905,36,467,3527,374,9565,93
45051,4,100,589,92,4079,8
8346,54,1771,3258,1272,15410,499
25307,127,4725,2345,3462,34411,1263
2498,8,267,3516,192,9236,75
18640,9,230,2678,195,2524,35
43598,13,139,917,108,2513,31
20369,102,4392,2595,3246,24443,1146
10446,59,1501,3142,1210,13668,291
25804,306,10200,2322,7869,48972,2331
29440,19,771,2132,619,8102,152
28997,5,445,2155,339,9597,106
37372,143,3284,1727,2551,23854,733
39656,561,17733,1578,13500,113587,4233
34695,70,727,1891,568,8388,159
18129,148,5447,2701,4221,43821,1226
27047,0,119,2267,108,2216,11
28171,11,245,2201,209,4709,36
3482,1,108,3499,94,2952,14
12060,97,4452,3057,3376,50082,1076
4630,6,55,3463,48,2898,7
3405,20,473,3500,382,12635,91
34811,6,143,1883,118,5898,25
31793,4,73,2012,55,5988,18
8401,90,4696,3255,3624,35740,1072
41197,8,142,1449,119,2921,23
3379,40,2703,3501,2129,25211,574
7161,5,213,3342,177,5759,36
34810,16,1395,1883,999,17679,396
11398,13,858,3090,611,7066,247
28205,18,409,2199,325,3679,84
12787,11,268,3016,219,5426,49
5456,100,3204,3422,2560,90751,644
36350,116,2938,1787,2246,18613,692
3981,2,69,3486,60,5424,9
32248,85,1691,1989,1268,12475,423
32572,2147,106351,1975,63145,487836,43206
30054,9386,729609,2102,460618,1909401,268991
6729,111,4530,3366,3069,19886,1461
12431,15,409,3035,277,6401,132
34562,4,70,1898,63,6812,7
42363,96,5040,1247,3456,44412,1584
27239,4,166,2256,138,3729,28
4736,4,57,3460,45,4310,12
10892,47,1403,3116,1105,12667,298
35484,21,876,1847,625,21880,251
32241,0,71,1989,58,1997,13
20809,3,416,2570,350,9819,66
6568,37,3410,3372,2781,114660,629
8720,6,209,3235,182,9939,27
34299,8,270,1911,206,5346,64
5465,6,135,3422,102,5007,33
28461,133,3034,2185,2182,13052,852
46020,48,569,234,497,7578,72
26749,5,264,2279,217,7488,47
38381,0,71,1658,56,4706,15
30464,2,114,2079,85,2890,29
35219,49,2909,1862,2314,25634,595
17214,43,1923,2743,1507,15558,416
9906,9,355,3168,273,6190,82
31043,3,80,2052,66,4726,14
28660,2,190,2172,147,3962,43
24948,11,329,2359,270,4152,59
13435,7,255,2966,199,6893,56
37411,34,853,1725,599,5656,254
13769,9,566,2940,460,5840,106
29394,37,1925,2134,1626,4415,299
40608,8,123,1506,102,2742,21
46253,0,3,148,3,3733,0
46201,3,56,161,50,908,6
15551,22,672,2827,510,5374,162
33961,20,1270,1922,1041,18054,229
3023,1,56,3507,44,4328,12
25711,6,598,2326,476,5292,122
30968,12,273,2056,231,2744,42
36426,6,215,1784,147,2900,68
7293,1,24,3336,21,3003,3
41753,16,213,1362,174,3519,39
36417,8,475,1784,390,6558,85
41334,19,823,1426,601,9544,222
21434,20,849,2533,659,5419,190
25870,82,2809,2319,2351,19282,458
6437,13,544,3378,385,4925,159
16556,17,565,2780,404,2888,161
1881,7,176,3528,140,8533,36
14362,63,3699,2896,3111,45368,588
41769,3,114,1359,89,6503,25
43042,9,235,1090,168,3827,67
10097,48,1260,3158,1036,20170,224
45792,35,256,329,209,4670,47
33630,15,605,1934,470,5954,135
13972,216,16083,2922,11426,49082,4657
42737,94,597,1169,449,9515,148
27544,120,4778,2237,3692,34163,1086
43864,12,143,844,106,4037,37
4830,99,3260,3456,2677,16265,583
27322,6,305,2251,245,6470,60
33833,8,483,1925,378,9676,105
25733,17,1102,2325,888,19532,214
44123,3,71,801,58,2019,13
30344,63,1540,2086,1119,10183,421
45850,7,97,309,67,3061,30
7130,64,4162,3344,3034,43652,1128
3953,10,462,3488,353,19343,109
45663,4,46,384,34,1416,12
14986,9,515,2855,441,10602,74
45568,64,1158,421,957,6253,201
18957,126,4174,2666,3092,28703,1082
19834,11,862,2623,701,10194,161
16779,8,278,2767,207,11942,71
37142,55,1303,1742,1044,13452,259
45911,22,180,287,137,3636,43
43036,11,203,1091,166,2219,37
40648,59,2575,1504,2033,17107,542
3230,17,586,3504,498,17060,88
34683,31,492,1891,388,9501,104
46378,4,82,96,62,1024,20
34942,1,219,1877,178,3626,41
31480,17,5883,2029,4377,33896,1506
46029,118,1028,232,854,13700,174
33628,29,504,1934,406,3234,98
18732,6,375,2675,237,4272,138
31710,18,309,2016,252,4148,57
17534,14,1062,2727,765,13843,297
22251,1,74,2487,70,2230,4
19875,16,1151,2621,873,10184,278
34179,1266,80559,1915,51462,397580,29097
10019,3,57,3162,47,2459,10
39148,7,186,1608,150,4894,36
1883,126,6904,3528,4715,58412,2189
34428,34,969,1905,777,12191,192
37708,7,234,1706,207,3344,27
36496,0,31,1780,25,3270,6
25582,4,292,2332,227,5542,65
30311,14,473,2088,400,3936,73
38857,101,1334,1626,1005,19033,329
25806,0,878,2322,678,13286,200
33692,4,159,1931,126,3978,33
31484,2,55,2029,46,4150,9
41326,72,3013,1427,2197,38880,816
6459,1,321,3377,269,5840,52
33447,187,2264,1940,1766,10269,498
18937,22,1001,2667,764,9151,237
43740,9,192,870,148,5642,44
24275,3,68,2391,55,2207,13
22868,2,80,2457,69,4183,11
19284,0,573,2651,461,5308,112
37136,32,815,1742,639,6796,176
13045,44,1296,3000,1022,7916,274
31509,12,1046,2027,851,13976,195
29233,42,2653,2143,2037,14749,616
10612,5,25,3132,20,2671,5
31016,21,495,2053,407,8873,88
14761,81,5398,2868,3901,26402,1497
2515,10,214,3516,180,5391,34
21278,7,564,2541,471,13443,93
37761,40,1145,1701,832,15837,313
25760,13,346,2324,286,9359,60
31288,1164,50101,2039,31280,153157,18821
29466,4,266,2130,191,4403,75
8192,8,188,3269,158,8623,30
46036,8,134,225,85,2715,49
2681,138,14552,3514,8859,98464,5693
34916,29,776,1878,605,7073,171
13431,114,5970,2967,4671,64511,1299
8520,128,7377,3247,5474,44689,1903
29903,2,57,2109,38,1566,19
21483,222,10621,2530,6992,80146,3629
2912,351,12712,3510,9947,101615,2765
7875,5,284,3297,207,10523,77
4063,5,69,3484,59,3114,10
43614,1,67,911,52,6905,15
14601,1017,67043,2879,45964,304874,21079
41908,9,230,1333,197,8478,33
8554,14,392,3245,309,7290,83
2381,63,1890,3518,1423,18046,467
2939,2,65,3509,55,4744,10
37002,10,338,1750,284,11323,54
13918,1,63,2927,58,6161,5
24012,11,461,2402,368,4735,93
4362,326,9697,3473,7231,106101,2466
14159,173,9991,2912,6884,72589,3107
13381,2,18,2971,14,1940,4
28877,9,357,2161,284,6502,73
38632,2,163,1639,123,6399,40
27494,443,13352,2240,10306,48097,3046
35693,3,102,1831,85,3465,17
14251,18,833,2905,647,11677,186
21409,16,863,2534,722,12095,141
6984,2,28,3352,26,3456,2
12877,25,1387,3011,1026,30991,361
43900,54,693,838,524,7674,169
32413,600,27513,1982,19980,151403,7533
18630,19,409,2679,349,4210,60
38070,0,229,1680,174,3728,55
36861,3,70,1758,58,2091,12
16679,534,58286,2774,38101,249059,20185
45334,13,115,489,97,1529,18
33980,41,998,1921,819,12192,179
38683,81,2378,1636,1775,14224,603
34715,1,62,1890,51,4182,11
5593,8,134,3415,112,5130,22
3930,14,585,3489,460,6461,125
4062,12,87,3484,71,4153,16
11183,43,1424,3100,1097,13208,327
41386,16,1070,1419,800,15395,270
1922,66,3575,3527,2468,21271,1107
34582,46,1382,1897,1116,11414,266
6422,268,14368,3378,10823,119314,3545
15023,2,232,2853,189,8322,43
4540,22,1391,3467,1081,31244,310
13530,382,39610,2958,24315,237952,15295
35295,4,176,1858,155,1605,21
1379,1,37,3677,34,7608,3
11585,8,295,3080,238,6816,57
4135,393,18312,3482,13446,82175,4866
41609,241,5430,1386,3810,58146,1620
20169,1,93,2604,81,3439,12
15878,0,4527,2813,3222,15579,1305
9230,35,1042,3205,814,6490,228
13868,35,2589,2933,1972,17568,617
21381,27,702,2536,564,13780,138
37237,41,3050,1735,2069,28799,981
15817,5,591,2815,490,13161,101
24301,1,464,2389,315,13659,149
24922,1,28,2361,27,3684,1
23278,145,3168,2438,2510,16688,658
19010,6,433,2664,370,11579,63
25741,6,510,2324,409,4145,101
3849,228,9550,3491,7109,67396,2441
7122,38,1351,3344,1071,12317,280
2269,7,94,3520,77,3954,17
8849,12,359,3227,296,14562,63
24816,43,2561,2366,1939,28073,622
29185,40,1816,2146,1474,25055,342
42825,11,270,1148,201,6633,69
29143,5,220,2148,186,4048,34
9357,764,160530,3196,69165,134102,91365
9649,7,177,3179,149,5708,28
40581,65,2176,1509,1604,23087,572
27090,2,46,2265,40,1827,6
3616,22,589,3496,492,9605,97
34077,4,132,1918,90,4498,42
35565,21,1469,1842,1074,8055,395
12561,48,2203,3029,1696,29115,507
32885,7,358,1962,289,3730,69
15357,106,2160,2835,1584,14816,576
20686,1,164,2578,126,4200,38
10163,13,618,3155,497,7830,121
10915,26,1180,3115,785,36037,395
23272,32,1059,2438,862,10459,197
25632,0,23,2329,19,1771,4