Mod,likes,downloads,time,unique_dl,views,dl_dif
63950,25,269,246,239,5250,30
57940,0,5,440,4,2264,1
62592,92,2066,283,1635,21648,431
38703,26,698,851,443,6915,255
9585,92,1512,1377,949,19105,563
40186,18,239,831,188,6546,51
43145,798,15581,784,12184,219158,3397
1687,5,201,1456,150,9841,51
5183,30,1458,1419,947,13595,511
50978,1214,23434,650,17411,92055,6023
2996,30,1061,1445,748,12952,313
50327,5592,71517,666,48049,218711,23468
3118,20,692,1444,481,21403,211
21584,31,1697,1206,1142,16339,555
631,26,1172,1464,684,32157,488
10771,145,3860,1369,2652,33833,1208
55070,1070,15035,517,12887,129190,2148
57083,1374,26411,464,19272,116763,7139
30620,4197,91129,1028,64995,228556,26134
23292,16,407,1180,275,6558,132
12110,10757,260889,1358,155887,740115,105002
8832,548,14915,1380,9379,71369,5536
66476,2,130,175,104,4634,26
33650,428,15634,976,10981,100431,4653
23535,37,901,1176,753,40115,148
32490,45,1911,997,1245,27828,666
38169,88,1451,865,1196,16585,255
14749,114,3747,1322,2660,30209,1087
53049,3,40,585,32,6290,8
56564,1689,32164,478,24159,179354,8005
25432,22,704,1135,459,13448,245
63040,165,2166,272,1742,24578,424
16741,4163,140661,1292,95581,632879,45080
48125,82,1146,726,982,11105,164
33433,27,364,981,260,5705,104
7733,12,523,1387,350,20814,173
38405,18,521,858,370,13879,151
17600,5,200,1277,133,6202,67
9388,4,265,1378,201,19323,64
18462,4369,150130,1261,92520,501540,57610
13587,13,624,1338,430,12776,194
49441,1,58,689,56,2648,2
20812,1516,73537,1220,43624,243988,29913
12374,13,457,1355,216,5282,241
10297,294,7406,1373,4982,60310,2424
15122,3827,149110,1317,93995,520467,55115
29198,9,305,1056,163,6815,142
53632,2128,25258,570,21878,169748,3380
41280,108,1975,814,1737,26454,238
49549,75,610,686,508,16322,102
63401,411,8598,262,7207,31476,1391
4276,30,841,1432,629,56497,212
4835,81,3160,1424,2317,41842,843
35358,371,6723,938,4854,43045,1869
3304,229,8167,1442,5295,28699,2872
23910,11,180,1169,128,11971,52
30557,240,4279,1029,2837,20979,1442
46523,105,2286,746,1785,27423,501
19543,4,79,1242,61,12799,18
30977,913,34024,1021,24489,254533,9535
41218,677,10536,814,8660,109534,1876
9385,31514,579534,1378,338802,1027570,240732
68513,10,260,109,168,5751,92
58234,21,203,430,139,11670,64
30119,133,3863,1038,2767,16896,1096
13962,134,5868,1333,3609,33992,2259
38512,286,3669,855,2952,25372,717
66719,3,25,167,18,1195,7
59013,6,78,405,52,2503,26
54625,151,2634,535,2194,25685,440
34492,951,16789,960,12623,90687,4166
11672,5,559,1362,246,14023,313
29707,1982,67156,1047,42513,313621,24643
30897,15,550,1023,388,10005,162
10054,13,732,1374,487,18705,245
63678,37,231,255,200,6240,31
3997,34,1788,1435,1306,20926,482
42470,1798,34752,795,26872,254426,7880
61543,88,1278,316,1075,13639,203
37698,45,1007,877,811,15351,196
57188,11,123,461,84,5612,39
60599,160,2492,350,1960,29273,532
56116,17,132,491,84,7822,48
29742,209,2636,1046,1568,20263,1068
6074,33,916,1409,709,20633,207
51155,42,570,644,455,11763,115
16321,1,104,1299,62,7530,42
23661,22,699,1173,537,27996,162
42039,14,177,802,140,11592,37
31909,1551,24309,1007,16937,73329,7372
31435,58,916,830,703,7776,213
9383,17,215,1378,156,8303,59
51677,8,82,630,60,2582,22
36026,36,1071,922,678,55412,393
36138,22,506,919,368,5142,138
37083,23,458,895,343,14826,115
23854,323,7221,1170,4461,37782,2760
54755,209,1734,528,1254,15147,480
55653,39,448,504,368,7676,80
58001,172,3763,438,2712,23326,1051
67808,99,1302,131,1043,13297,259
51208,422,7552,643,5864,93636,1688
15304,37,1002,1315,683,9816,319
28964,228,4309,1060,2939,43423,1370
51881,43,437,624,353,10562,84
53683,9,80,568,72,5255,8
58489,4844,61703,421,47339,172697,14364
6292,108,2370,1407,1515,17036,855
5825,27,1285,1412,759,20085,526
11872,16,846,1360,427,14803,419
29565,3,122,1049,89,2851,33
1567,94,4652,1457,3247,45265,1405
27533,55,1568,1089,974,13914,594
19685,11,257,1240,221,21386,36
56100,14,146,492,135,4995,11
8131,583,9317,1383,5834,44628,3483
59814,27,436,378,279,7672,157
17532,47,1660,1278,1250,33585,410
1200,1533,77705,1460,55837,294981,21868
21039,4,147,1216,110,16467,37
49733,91,1174,681,891,30613,283
1000,23,986,1461,766,24609,220
54971,362,7188,523,6659,54506,529
7276,5,289,1393,208,13471,81
65236,16,191,208,178,9008,13
53898,33,352,561,284,5063,68
41818,26,251,805,163,5959,88
34153,14,243,966,206,7964,37
66802,4,59,164,45,1510,14
51,768,32909,1471,21354,184248,11555
66331,3,78,179,61,6190,17
19524,31,1134,1242,879,44925,255
58654,40,499,416,438,13873,61
68555,12,233,106,182,3062,51
41273,539,12079,815,9266,100615,2813
19968,49,2472,1235,1565,17278,907
36119,18,540,920,404,8673,136
56624,9,112,477,86,5747,26
2022,6,164,1454,101,10259,63
32847,1278,30519,991,21284,137828,9235
68668,1,64,103,47,4131,17
23395,618,12569,1178,8890,95763,3679
50320,823,11115,666,9484,101364,1631
8201,6,308,1383,208,5252,100
37754,121,3407,875,2227,32461,1180
26606,38,819,1109,473,6861,346
24878,4,156,1147,112,10620,44
5381,38,1639,1417,1113,30086,526
57668,53,447,449,369,9418,78
22337,499,8826,1196,6121,91962,2705
37253,32,1307,889,983,20732,324
15102,28,1451,1318,806,13489,645
29175,2299,35156,1056,26345,310304,8811
29705,109,2120,1047,1541,23322,579
18826,0,0,1255,0,17817,0
5346,10,233,1418,160,12904,73
28804,18,666,1064,357,10113,309
50782,170,1824,655,1489,13789,335
68907,5,100,95,75,2491,25
16516,71,1851,1296,1210,32740,641
11370,13377,303087,1365,169218,845773,133869
31092,46,1243,1019,859,19825,384
19669,48,1044,1240,694,28575,350
42169,10323,248131,800,194162,1004136,53969
28861,12,298,1063,185,7920,113
4517,17,645,1429,453,16560,192
37310,45,1026,888,851,17444,175
10690,510,9085,1370,5250,35677,3835
61849,17,389,307,270,3635,119
63135,5,113,269,75,4766,38
56989,3,29,466,24,3629,5
15727,14,779,1308,558,37584,221
44903,23,459,764,308,5256,151
60953,27,501,336,368,8079,133
37943,5,130,871,105,3897,25
26278,25,547,1117,326,6398,221
49759,427,5314,680,3683,44468,1631
10216,958,25035,1373,15490,108171,9545
54693,13,162,533,126,19861,36
60368,75,842,358,689,5312,153
14679,15,736,1323,557,15140,179
53955,25,242,560,195,7567,47
67429,174,3333,144,2775,32775,558
52911,437,4891,589,3744,24939,1147
56132,18,351,491,226,9154,125
10711,53,1765,1370,1174,36645,591
44069,59,953,774,800,27675,153
67802,11,202,131,145,3838,57
9474,36,1213,1378,760,10225,453
62806,57,886,277,611,10754,275
12346,62,936,1355,526,9713,410
23214,20,426,1181,317,13605,109
67290,15,366,148,328,4778,38
11884,90,1758,1360,1111,11009,647
1670,30,950,1457,679,22564,271
59896,53,619,375,506,8083,113
20579,15,807,1224,610,16468,197
66999,7,178,157,119,4087,59
8644,96,3139,1381,1966,42255,1173
36085,107,2491,921,1837,11679,654
17019,6,190,1287,136,10154,54
35663,134,3737,931,2728,23460,1009
5932,2396,41263,1411,29138,224456,12125
57225,92,1285,461,1138,28795,147
1289,66,2660,1459,1830,34723,830
64972,2,20,214,16,1796,4
57841,1035,13464,443,11228,90837,2236
20875,41,1563,1219,1086,18249,477
46631,2,85,744,64,3886,21
65300,64,1365,207,1116,11498,249
5073,20,508,1421,370,9307,138
30961,6,304,1021,195,10818,109
31498,23,657,1013,391,9382,266
13424,90,4079,1341,2481,88626,1598
21179,2,220,1213,152,6965,68
66979,56,659,158,575,11971,84
39146,29,736,845,576,12689,160
48370,12,613,722,375,9594,238
68859,16,244,96,212,3636,32
30623,76,2567,1028,1509,19203,1058
54677,89,542,533,476,6474,66
8430,550,10225,1382,6305,40256,3920
32877,489,9279,991,7555,42357,1724
63864,15,344,249,280,7329,64
66683,18,157,168,122,3945,35
9745,186,4040,1376,2550,24863,1490
21666,2233,78697,1205,44956,251334,33741
23383,78,1364,1178,938,17205,426
52657,62,759,598,630,26810,129
5741,11,418,1413,289,5338,129
16619,2193,65892,1294,43306,221126,22586
5557,154,2476,1415,1515,34919,961
55502,244,4177,509,3003,26506,1174
40693,25,441,824,389,18004,52
29951,41,926,1041,605,12760,321
11822,5,279,1361,149,6969,130
34211,181,2551,965,1909,16543,642
39770,269,6417,838,5213,44858,1204
9257,38,1103,1379,725,13702,378
62935,7,61,274,51,1985,10
63857,38,416,250,341,7143,75
64499,10,84,230,57,2529,27
19450,10,402,1244,273,10977,129
56135,25,335,491,290,13429,45
45897,22,315,753,282,21720,33
5532,2,52,1415,29,4767,23
16335,38,1663,1299,1079,27813,584
40196,13,559,831,444,8851,115
33775,1118,25244,974,16571,159629,8673
67718,18,241,135,193,2537,48
9469,50,604,1378,496,6895,108
6828,118,5547,1400,2964,32868,2583
16158,12,316,1301,226,7824,90
51139,6,97,645,76,2629,21
8876,5,142,1380,91,5054,51
28031,53,1145,1078,783,16909,362
13333,3,192,1342,128,11145,64
14528,38,928,1324,711,11443,217
38191,234,6159,864,4419,35385,1740
62834,158,1451,276,1248,12751,203
36976,54,519,898,391,9564,128
5607,65,2882,1415,2112,33770,770
59595,59,724,385,598,14475,126
26412,540,31704,1114,19486,145989,12218
38312,142,1806,862,1391,19918,415
61300,1863,28776,316,22377,149303,6399
15560,10,483,1311,341,13081,142
33528,17,263,979,184,8506,79
66471,33,509,175,372,12897,137
25753,52,1377,1128,896,13283,481
18959,67,1169,1253,772,26724,397
51503,4,75,635,61,8054,14
23086,172,3941,1183,2946,30997,995
15987,61,1783,1304,1358,18004,425
23401,83,2451,1178,1363,58957,1088
59912,738,21710,374,17881,108807,3829
53661,19,264,569,222,7380,42
24159,112,2431,1163,1527,19922,904
17177,410,10485,1285,6937,87642,3548
18350,141,3946,1263,2826,42053,1120
68127,108,2807,122,2124,19217,683
42572,32,852,794,648,17960,204
45159,28,329,761,255,7771,74
14174,43,1254,1330,822,9182,432
54073,248,3055,555,2505,63744,550
35593,13,214,932,170,4651,44
30566,70,2526,1029,1336,14995,1190
19055,184,3016,1251,2032,17622,984
1334,74169,1798360,1459,1336876,4247395,461484
41008,61,1188,818,965,27622,223
22822,30,905,1188,727,28020,178
22301,7,103,1197,78,33620,25
11963,2265,81405,1359,44699,402062,36706
66807,1,29,164,22,2198,7
14145,31,757,1330,537,12987,220
35568,165,4104,933,3329,18226,775
66706,874,28709,167,22819,99366,5890
6474,15,454,1404,332,12337,122
30684,2135,68975,1027,44712,211157,24263
12561,198,3877,1352,2389,24435,1488
29307,132,4999,1054,4047,26622,952
16857,240,11473,1290,7897,76903,3576
43147,45,1138,784,921,16793,217
51498,4,31,635,26,3987,5
37895,112,2006,873,1428,16662,578
61338,15,219,322,154,11585,65
30448,13,254,1031,155,7499,99
38561,22,430,854,328,13566,102
5720,121,5660,1413,3452,59496,2208
16392,285,5617,1297,3687,64797,1930
22794,16,784,1188,565,15108,219
35045,210,3333,946,2323,19333,1010
58523,342,5337,420,3901,70255,1436
36286,6895,108436,915,80324,400429,28112
12298,327,8793,1356,6011,33162,2782
49969,310,4943,675,3680,24656,1263
64908,38,519,217,412,12842,107
34679,728,20517,955,14645,105349,5872
66796,732,10068,164,8011,31556,2057
58166,2727,39871,433,31734,238043,8137
29910,42,680,1042,398,7076,282
30847,9,255,1023,159,6697,96
9978,43,2300,1375,1405,22957,895
59762,35,236,379,203,5196,33
5912,18,451,1411,318,24520,133
49596,5,120,685,77,11050,43
7005,35,1089,1397,730,17123,359
4917,6,369,1423,255,18086,114
28894,34,1167,1062,734,10185,433
53573,60,1111,572,818,15456,293
8176,58,2050,1383,1367,37591,683
15451,80,1156,1313,729,7137,427
58074,139,1613,436,1248,21079,365
6195,9,955,1408,607,10041,348
15607,9,238,1310,189,7153,49
3060,101,2046,1445,1490,22384,556
5439,58,2101,1416,1485,58833,616
9412,9,348,1378,211,7740,137
18336,469,9594,1264,5796,39391,3798
53933,16,171,561,125,14360,46
50460,520,7535,662,5857,66986,1678
23560,603,13099,1175,8894,35487,4205
50820,45,688,654,560,7386,128
30411,24329,670765,1032,429021,1226301,241744
2600,167,3563,1449,2455,26703,1108
32672,2,98,995,57,3374,41
25104,72,1611,1142,1146,22173,465
64385,62,1809,233,1382,15063,427
6040,233,7733,1409,5870,85655,1863
12816,6,596,1349,260,5665,336
67550,13,169,140,147,4844,22
68280,0,4,117,4,1534,0
9343,205,4003,1378,2643,23059,1360
30588,42,699,1029,440,6166,259
33797,22,419,974,347,4662,72
65799,11,123,195,95,1834,28
30622,55,1632,1028,1138,13942,494
22187,8,394,1198,263,8406,131
60868,2378,49240,337,36891,187435,12349
47315,1404,12924,735,10567,78991,2357
46166,56,1102,750,866,11517,236
46147,4,66,751,52,4015,14
4798,12,473,1425,357,12391,116
13162,71,2187,1344,1152,25391,1035
38668,71,527,852,425,5987,102
31541,68,1714,1013,1148,19144,566
64421,2,18,232,9,2446,9
24276,90,3627,1161,2667,42195,960
1989,118,3289,1454,2284,45417,1005
12332,24,2796,1355,1386,30182,1410
10144,576,24710,1374,16253,126847,8457
31415,35,939,1015,607,14958,332
30626,123,2124,1028,1590,27395,534
26307,56,1551,1116,931,16508,620
999,32,878,1461,649,30414,229
5977,151,5937,1410,4325,78353,1612
10334,10,521,1372,368,8749,153
59503,53,684,388,550,10840,134
25146,548,14292,1141,11824,63076,2468
35405,216,3709,937,2251,29996,1458
29883,17,888,1043,606,28706,282
26622,5,205,1109,165,9380,40
32294,115,3156,1001,2063,19747,1093
60744,7,99,344,73,2408,26
44252,39,675,771,497,9401,178
6628,801,20793,1402,13849,113653,6944
62759,6,49,278,35,2490,14
2812,58878,2647433,1447,1326640,6785823,1320793
50349,1368,23772,666,19091,79206,4681
23925,11,456,1168,324,15715,132
47162,75,2881,737,2021,27970,860
30546,207,5025,1029,3145,58264,1880
33227,1384,40497,984,22370,159462,18127
25826,8,590,1127,357,24803,233
65949,127,2661,191,2253,40566,408
35376,18,334,929,257,12257,77
54853,37,478,526,317,9620,161
50395,189,2639,664,1923,33442,716
26945,55,1079,1102,827,14794,252
7765,19,966,1387,603,19329,363
49353,2,39,691,28,3436,11
27216,137,1944,1096,1215,14841,729
48574,57,871,715,711,15847,160
1049,43,1755,1461,1185,24349,570
16069,2974,293926,1302,193736,610153,100190
52180,9,120,615,84,2669,36
1642,1,167,1457,135,14720,32
20437,117,6509,1227,4458,53437,2051
27531,8065,135058,1089,82633,347547,52425
21661,634,14187,1205,9203,41652,4984
41411,712,15901,813,10528,49583,5373
37181,570,15149,891,12485,33954,2664
66643,24,417,170,360,7037,57
53996,56432,1158374,558,615291,3208444,543083
45717,3,86,755,60,4647,26
54794,14,162,529,115,7951,47
23218,12,540,1181,378,6057,162
58771,51,1599,412,1146,28981,453
58890,11,140,409,118,3550,22
21635,0,36,1205,27,2699,9
65248,21,112,208,89,5798,23
2836,4391,208662,1447,134414,270855,74248
8606,16,938,1381,596,14418,342
32245,225,3294,1002,2447,30924,847
17120,305,8405,1286,6106,59485,2299
11016,81,2609,1367,1669,33727,940
22804,7,360,1188,228,10303,132
5379,241,11066,1417,7815,80049,3251
42758,102,1898,788,1565,33439,333
54172,1975,53618,552,38890,157523,14728
2149,23,668,1453,458,17556,210
11506,92,4349,1364,2501,38191,1848
30705,137,4631,1026,2891,27696,1740
210,1184,36752,1469,17351,74809,19401
50497,8,116,662,81,15209,35
66267,60,1411,181,908,42551,503
47358,35,240,735,192,6778,48
13885,86,1776,1334,1143,13359,633
16415,52,906,1297,659,13162,247
48077,5232,123578,726,91478,562538,32100
54636,35,251,535,203,7538,48
37236,89,1121,890,869,10677,252
20382,123,5843,1228,3864,55993,1979
48457,99,1060,720,805,12549,255
26437,2294,69030,1113,42195,330515,26835
51780,406,3996,627,2854,18963,1142
17974,89,4033,1269,2898,34978,1135
7099,14,526,1396,312,12490,214
18106,799,19885,1267,13959,88843,5926
4346,337,20855,1431,12445,102067,8410
55065,443,5274,520,4176,32603,1098
24277,8,134,1161,120,19359,14
1650,47,1316,1457,905,17599,411
59614,150,1426,385,1158,11826,268
19051,63,1884,1251,1410,28959,474
14563,61,1962,1324,1311,14831,651
53790,258,7263,565,6406,85512,857
28147,6641,260984,1076,180043,794168,80941
22368,5245,144040,1196,100297,559494,43743
35052,11,178,946,120,6276,58
50661,441,8154,658,6273,69571,1881
6589,47,974,1402,669,10463,305
7059,11022,352937,1396,199396,1210439,153541
11435,97,2050,1364,1330,11713,720
19033,810,13009,1251,9195,54691,3814
21962,426,5217,1201,3070,24896,2147
26349,69,1848,1115,1098,19367,750
21389,105,1082,1209,850,10972,232
7704,6,353,1388,219,3930,134
20056,317,1700,1233,1071,14022,629
24836,36,1014,1148,730,9248,284
3168,27,368,1444,258,5713,110
55552,401,6081,507,4937,41050,1144
4273,86,8751,1432,4880,38042,3871
24884,39,724,1146,474,13279,250
39603,12,405,840,313,6379,92
61528,15,186,317,152,7310,34
2068,1910,46583,1453,29180,111355,17403
54608,22,658,536,474,22527,184
15262,58,2135,1315,1437,32917,698
53171,4689,72206,581,56688,301717,15518
10651,115,4152,1370,2921,52404,1231
1455,59,2144,1458,1537,20232,607
9333,299,12092,1378,6923,61744,5169
37929,38,705,872,574,12661,131
22993,178,5343,1185,3900,27047,1443
33024,32,888,988,625,23458,263
35728,87,1993,930,1492,15559,501
33602,3610,102495,977,74573,408940,27922
9315,173,3420,1378,2433,34475,987
927,2,161,1462,126,19516,35
65038,37,410,212,308,6005,102
32325,1,98,1001,73,4686,25
491,5,398,1466,253,27500,145
48429,4,223,721,170,12158,53
28767,5,277,1065,180,3587,97
43119,163,2957,784,2427,27049,530
28443,104,3047,1071,1837,13329,1210
9519,12,750,1377,487,7271,263
49241,218,5358,694,4249,30685,1109
68980,10,65,92,48,2904,17
60449,50,369,355,254,4445,115
51963,8,145,622,116,6230,29
22222,118,2772,1198,1819,17355,953
27009,16,688,1100,425,15740,263
51684,0,21,630,16,2819,5
1090,46,1987,1461,1372,68879,615
19363,54,1378,1245,981,30011,397
57357,48,386,456,303,8046,83
59536,4,53,387,39,6100,14
50734,367,6856,656,5135,25636,1721
13692,1329,35265,1337,21889,183835,13376
5261,113,1406,1418,974,15085,432
24359,1534,14785,1158,10007,98101,4778
951,631,19100,1462,12420,81344,6680
1451,337,20172,1458,12135,94561,8037
17250,1318,33608,1283,24457,208238,9151
67734,60,903,134,765,9040,138
23739,41,1402,1172,947,23001,455
1512,147,5931,1458,4104,77290,1827
27189,1153,19007,1097,14346,101412,4661
20580,8,547,1224,376,37351,171
59183,450,6999,400,5588,61800,1411
61544,38,349,316,262,7994,87
19278,56,1225,1247,845,11490,380
37334,231,3207,887,2089,45738,1118
12567,143,2666,1352,1508,11660,1158
6373,68,912,1406,664,14745,248
56639,10967,222840,476,171225,630697,51615
61372,16,296,321,200,10983,96
28015,86,6584,1078,3957,26900,2627
33423,56,1472,981,1090,26339,382
17165,142,3455,1285,2497,50293,958
28852,68,3762,1063,2020,14289,1742
1532,12,335,1458,238,19081,97
20335,309,8343,1228,5558,45981,2785
5748,72,1736,1413,1289,19787,447
14343,330,7851,1327,5901,133926,1950
6910,13,201,1399,138,5619,63
67878,16,291,129,243,5181,48
55834,84,727,500,604,15742,123
10199,6,164,1373,102,7029,62
27946,23,595,1080,358,9134,237
5976,74,1978,1410,1307,10382,671
38399,54,813,859,717,15224,96
9678,6,233,1377,151,14427,82
49270,145,2868,694,2308,29056,560
6749,497,15208,1400,9657,141883,5551
67305,479,4608,147,3697,28904,911
8643,4,53,1381,36,14070,17
55854,8,154,499,101,7125,53
34573,62,1285,958,898,25239,387
12380,14,2004,1355,779,27641,1225
19522,85,2920,1243,2041,66323,879
64703,113,2204,224,1636,9272,568
55094,90,1391,520,1070,14003,321
48341,28,2375,722,1656,8597,719
64090,0,19,242,14,1312,5
20529,5,204,1225,138,4142,66
22555,105,1785,1193,1100,15415,685
27461,7,138,1091,81,4999,57
28641,10,734,1067,438,9933,296
46410,544,10766,748,7990,81455,2776
64209,4,43,238,29,2976,14
21319,13,5252,1211,4191,32104,1061
37056,6,396,895,263,8571,133
33710,23,695,975,468,16715,227
13167,29,489,1344,256,9011,233
27108,337,13904,1098,8609,141164,5295
57196,68,1089,461,677,15800,412
16940,39,1953,1289,1446,17581,507
1660,3,175,1457,135,9335,40
30410,2,37,1032,30,4137,7
61649,32,924,313,655,16580,269
65429,0,14,204,9,1521,5
392,57,1257,1466,942,14241,315
32339,1072,32009,1001,21279,174673,10730
3583,680,18599,1440,13166,52772,5433
41239,9,184,815,147,2339,37
45559,197,2744,757,2401,31475,343
8011,13,848,1384,503,23482,345
35236,90,1289,941,884,12879,405
10958,1302,38614,1368,24466,174222,14148
11029,86,3621,1367,1990,16936,1631
24207,73,3903,1162,2630,40473,1273
56872,1,38,469,38,4126,0
19950,3,121,1235,92,12131,29
31855,9,375,1008,230,10202,145
31023,150,2209,1020,1466,42857,743
17861,168,3150,1272,2225,49389,925
23545,20,556,1176,405,9115,151
37337,12,420,887,327,13232,93
21122,185,2739,1214,1949,34184,790
22952,938,22814,1185,14719,58935,8095
41550,357,9270,810,8056,86821,1214
55201,22,255,517,209,7003,46
31603,109,1479,1012,988,18471,491
69020,0,10,91,8,781,2
62856,1800,36396,276,28566,192529,7830
10093,1685,40381,1374,24888,182138,15493
39397,63,657,843,498,7873,159
32932,29,1087,990,763,11517,324
56265,29,294,487,241,7637,53
36553,41,1895,906,1587,35041,308
64398,83,884,231,697,8212,187
6467,48,1673,1404,1064,54708,609
38538,1,23,855,14,1666,9
59919,13,149,374,119,9373,30
19034,254,4836,1251,3638,37411,1198
35146,43,934,943,646,24717,288
64146,2,39,240,27,8322,12
48000,99,1879,727,1351,31258,528
32226,63,1280,1002,1132,29058,148
37120,25,404,893,262,12774,142
38025,753,14784,868,10709,194819,4075
23498,38,2068,1176,1719,12874,349
6662,4,78,1402,52,6163,26
1960,37,883,1454,631,27292,252
31260,545,6762,1017,4856,44130,1906
25556,168,5272,1133,3433,30515,1839
23840,46,1060,1170,757,11256,303
63288,2,46,265,38,2442,8
62256,10,163,293,131,2736,32
6665,302,9201,1401,6988,78441,2213
28602,57,1403,1068,893,24621,510
53160,132,1382,582,961,13968,421
7816,1,116,1386,75,25567,41
5436,26,789,1417,561,10993,228
37287,120,2940,888,2372,40856,568
2049,129,3566,1454,2592,49520,974
9944,10,600,1375,394,11754,206
54648,20,311,534,245,4306,66
62472,2426,45338,286,34003,234895,11335
60716,34,893,345,606,10281,287
25693,55,1458,1129,1169,11456,289
23638,73,2041,1174,1381,50619,660
34931,84,1615,949,1138,18066,477
14634,15,402,1323,319,17948,83
4141,11595,439090,1434,243796,1266700,195294
10178,251,6186,1373,3873,22655,2313
26834,1222,30929,1104,18462,99703,12467
61801,376,5039,308,4128,47936,911
31769,177,2783,1009,1775,9776,1008
37358,5221,121383,886,90103,282039,31280
38757,38,792,851,627,12820,165
53599,8,75,571,61,4633,14
504,44,3691,1466,2734,28355,957
10084,1731,93970,1374,57826,342888,36144
6083,23,800,1409,547,16207,253
52316,51,646,610,440,29375,206
27213,131,2383,1096,1574,12343,809
20575,42,1801,1224,1277,33402,524
49537,26,444,687,404,16546,40
54663,89,890,533,773,17846,117
26708,129,3561,1107,2098,23414,1463
64115,6,49,241,34,4036,15
15956,303,9365,1305,6001,82129,3364
16090,1957,37274,1302,27209,151059,10065
49285,4146,70088,693,51707,280123,18381
11120,18,483,1367,317,8904,166
52588,0,289,601,230,5091,59
37613,24,611,879,360,16955,251
14590,859,25845,1324,17752,131371,8093
57918,10,267,441,168,8442,99
50907,110,1153,652,822,7482,331
49063,41,854,699,724,25001,130
13269,5,242,1343,127,14422,115
64555,0,11,228,9,3609,2
40655,268,5336,825,4328,80769,1008
30562,117,3646,1029,2386,65231,1260
60132,4,64,367,42,3641,22
728,5,433,1464,238,24486,195
3960,41,1236,1435,936,38814,300
63047,32,281,272,200,3267,81
18063,6,234,1268,174,13856,60
66997,61,676,141,523,6453,153
25534,19,1076,1133,664,21436,412
54226,73,434,550,372,4100,62
31938,620,18209,1006,11026,157719,7183
46835,26,552,742,422,10187,130
24385,448,21269,1158,15750,87541,5519
36804,338,5849,903,4496,70921,1353
28864,13,365,1063,228,4162,137
15059,3,309,1318,216,22082,93
60851,6,62,340,50,1470,12
18619,0,0,1259,0,11708,0
4017,21,278,1435,198,9213,80
10151,53,1940,1374,1071,13593,869
65862,25,431,193,330,9620,101
21127,111,2902,1214,2043,25728,859
17808,232,3777,1273,2509,26242,1268
52350,695,18500,609,14552,90566,3948
38866,4,104,849,84,8168,20
51804,27,425,626,259,8007,166
49584,19,320,685,235,8404,85
33122,178,5721,987,4119,96985,1602
25027,126,3072,1143,2006,25544,1066
5664,62,2608,1414,1583,16775,1025
36835,319,9349,902,7185,52778,2164
37511,0,56,882,39,3495,17
31432,485,5742,1014,4906,64196,836
29649,1804,55508,1048,33631,258720,21877
19856,68,2071,1237,1525,20196,546
30318,56,1750,1034,1143,26655,607
9788,26,751,1376,531,22313,220
9821,170,11047,1376,6909,42005,4138
21787,643,13714,1203,9916,34007,3798
67204,81,1348,151,1145,14741,203
64643,24,363,225,317,8713,46
61073,9,90,331,82,9595,8
64289,34,380,235,299,6943,81
28186,4,59,1075,40,5705,19
34733,303,5319,953,3751,29465,1568
54202,21,329,551,270,14462,59
17242,68,2501,1284,1735,17928,766
25463,21,331,1135,280,19083,51
20339,13,632,1228,457,14591,175
13933,364,9343,1333,6244,63726,3099
16507,30,1615,1296,1292,27340,323
30806,7,494,1024,308,11361,186
25227,32,1621,1140,1332,44147,289
40937,583,7562,820,5339,28087,2223
5887,165,7305,1412,5220,53755,2085
68465,22,425,110,333,6699,92
62800,2286,26761,277,19606,67686,7155
18857,2,109,1254,74,4395,35
68117,38,390,122,301,2629,89
28003,4,305,1078,194,9762,111
30307,17,316,1034,231,4958,85
51437,373,6290,637,4949,49530,1341
2512,32,1007,1450,669,24344,338
67299,20,280,147,204,8183,76
30804,701,10985,1024,8238,32670,2747
15050,545,18040,1318,12618,128737,5422
1454,30,1561,1458,1047,13608,514
51761,6,42,628,37,4179,5
60183,25,338,365,244,8061,94
30531,4,127,1029,74,5694,53
1538,653,16208,1458,10506,58572,5702
27661,96,1518,1086,769,18198,749
22921,500,9098,1186,5953,31808,3145
45129,14,137,762,105,4393,32
25480,170,2265,1134,1533,23956,732
36523,4,206,907,149,20170,57
51067,39,471,647,396,12209,75
15627,146,3996,1310,2776,37042,1220
64835,259,5678,219,4678,42041,1000
49309,71,907,692,763,10983,144
40471,36,581,827,473,13079,108
18733,46,2247,1257,1284,53196,963
38321,9,186,861,140,6766,46
68764,7,61,99,57,2630,4
29017,826,12064,1059,8413,59098,3651
5265,919,21364,1418,13928,81821,7436
7548,740,20095,1390,13336,106049,6759
33755,52,1456,974,895,9518,561
40199,38,1053,831,833,10477,220
980,17,1363,1462,1027,16596,336
3733,663,37835,1438,23678,258106,14157
33145,13,431,986,268,9285,163
18958,569,29960,1253,18202,81878,11758
7015,2773,93859,1397,55349,346120,38510
38220,10,300,864,213,6552,87
49028,8,95,701,81,4832,14
22901,148,3706,1186,2521,25695,1185
3632,282,10609,1439,7221,106806,3388
30115,110,1777,1038,1131,10904,646
52126,73,1875,616,1418,14054,457
28582,16,401,1068,223,9508,178
7712,1510,33625,1388,22369,190236,11256
29917,29,795,1042,659,21815,136
41999,17,144,802,117,3442,27
31066,60,1480,1019,961,20644,519
62709,4,30,280,26,4282,4
30415,20,544,1032,398,5306,146
8003,9007,282813,1385,155903,896349,126910
26495,15,724,1112,440,12714,284
60423,148,4405,356,3637,34705,768
30505,1315,29788,1030,17998,124937,11790
64768,12,117,222,81,2175,36
18489,888,14433,1261,11067,92258,3366
18998,72,2783,1252,1927,54135,856
66411,788,15228,177,12642,60664,2586
55829,2572,60770,488,47656,444022,13114
53016,111,1100,586,893,14951,207
67495,7,143,141,119,4768,24
62628,106,1493,281,1029,11385,464
21238,39,767,1212,615,28353,152
19260,11,398,1247,301,9649,97
24470,8,208,1156,154,11286,54
60532,194,1703,352,1311,9995,392
53937,405,11467,560,8406,86855,3061
23786,89,2733,1171,1965,18930,768
26421,31,1908,1114,1039,24581,869
63399,10,96,262,83,6400,13
6481,111,2411,1404,1526,10234,885
40757,19,252,823,186,4195,66
33592,54,1056,978,655,6644,401
8143,518,21132,1383,12130,69027,9002
18949,11,1076,1253,699,45508,377
17020,225,4469,1287,2880,18368,1589
8543,368,8637,1382,5367,43318,3270
64787,43,411,221,364,13561,47
37912,302,7265,872,5441,77362,1824
38124,34,282,866,248,7929,34
35220,16,212,941,170,7991,42
4670,1036,28441,1426,18762,100593,9679
3869,21,458,1436,320,20751,138
54872,214,3753,526,3112,36687,641
22286,427,11962,1197,8249,95165,3713
12368,20,880,1355,512,18521,368
51153,9,87,644,64,3770,23
60122,1106,19038,367,12819,81332,6219
15513,1021,15468,1312,9697,73873,5771
62775,145,2510,278,1708,32727,802
13878,832,44078,1334,28157,244389,15921
35864,22,397,926,346,12744,51
775,108,4394,1463,3371,40397,1023
11924,554,16792,1359,11141,70789,5651
49366,879,11849,691,9958,123401,1891
62049,6,60,299,47,2545,13
37154,207,5528,893,3869,82798,1659
19942,3,162,1235,114,9236,48
63443,31,450,261,389,11072,61
1863,71,3010,1455,2113,110147,897
13352,197,6109,1341,3779,47353,2330
30769,55,840,1025,514,8344,326
64316,24,107,235,86,20090,21
21957,34,785,1201,530,10971,255
15979,212,5550,1304,3788,31811,1762
507,236,6102,1465,4700,273622,1402
14446,9,1027,1325,677,6668,350
35065,21,564,946,408,5535,156
68560,227,3123,106,2665,25815,458
64248,3,75,237,46,8511,29
48337,16,390,722,304,6619,86
61294,70,887,323,734,15217,153
1632,660,16058,1457,11590,91443,4468
27645,99,2971,1086,1903,17236,1068
6583,594,26867,1403,16472,180499,10395
60620,1405,25590,349,21518,76252,4072
36173,530,5570,918,4685,50640,885
25553,25,1159,1133,728,27439,431
57395,137,2111,456,1765,35232,346
59559,686,12615,387,10155,53976,2460
25852,21321,496139,1126,292275,2302300,203864
61302,77,748,323,649,7748,99
23677,113,2783,1173,1892,22418,891
24721,15,515,1150,364,10484,151
64168,8,129,239,99,4858,30
66644,4,129,170,104,2579,25
22981,10,539,1185,406,10246,133
58410,7,117,425,67,3822,50
63483,0,0,260,0,2903,0
18516,67,3248,1260,2182,49985,1066
34209,80,1637,965,1255,34112,382
34422,193,7444,961,5100,36644,2344
3021,106,16690,1445,8810,81390,7880
11184,69,3028,1366,1609,26380,1419
62530,16,219,285,185,5645,34
35402,15,306,937,206,3532,100
34969,241,1510,948,1194,14421,316
31837,63,1839,1008,1305,9443,534
9223,170,3000,1379,1884,34499,1116
30740,41,696,1026,578,28157,118
54187,132,2019,552,1599,18765,420
30375,37,2034,1033,1280,20276,754
11330,252,10824,1365,6385,69576,4439
32798,280,4545,993,3244,26606,1301
52383,11,101,608,67,4523,34
14212,12,529,1329,382,26924,147
23202,378,10648,1181,8260,106313,2388
37219,110,2046,890,1708,45152,338
57964,26,287,439,230,8185,57
29995,525,13897,1040,9834,160243,4063
59509,6,75,388,35,4345,40
726,30,1708,1464,1153,50010,555
35841,44918,738439,924,508315,2711972,230124
63459,19,294,260,232,5689,62
28801,9,577,1064,341,13103,236
34974,8,405,947,252,11047,153
12977,52477,1312796,1347,971612,3048522,341184
26095,395,4585,1120,4019,59182,566
15063,2,390,1318,285,25675,105
64701,30,610,224,481,10973,129
97,22,522,1470,381,12836,141
59173,277,2703,400,2176,31377,527
16703,579,17359,1293,11319,111926,6040
12243,14,626,1356,363,31814,263
8546,36,956,1382,710,19704,246
5254,10,459,1419,308,18296,151
64336,3,60,234,47,4948,13
25280,4664,79338,1138,54695,181251,24643
23195,9,199,1181,126,8177,73
14264,2,72,1328,63,4385,9
16314,0,56,1299,36,6966,20
67712,3,29,135,25,3075,4
4142,4752,275599,1434,146588,1069767,129011
60422,13,157,356,121,3804,36
33392,65,459,981,382,8283,77
23567,46,718,1175,501,14305,217
68176,4,170,120,58,7125,112
60903,4326,80598,337,62616,382928,17982
22844,483,14428,1187,9308,60609,5120
26544,274,6342,1111,4358,83510,1984
19271,19,749,1247,518,9816,231
33981,301,10450,970,8100,115921,2350
36427,264,3900,910,2837,31335,1063
3396,19,499,1442,363,14606,136
26691,160,4670,1107,3317,34253,1353
16303,32,783,1299,506,21158,277
9539,738,25791,1377,16449,65342,9342
17038,33,1827,1287,1272,43303,555
37212,27,678,891,536,18356,142
23954,14,225,1168,155,5777,70
60443,44,649,355,548,10379,101
56673,124,2798,475,1961,33004,837
54630,39,192,535,150,6526,42
59148,38,808,401,444,6329,364
6203,33,740,1408,508,17328,232
8117,27,502,1383,332,5710,170
35483,10,193,935,139,3965,54
35431,7,63,936,55,6192,8
64898,16,261,217,205,3803,56
12106,893,27007,1358,15096,260758,11911
68814,12,187,98,156,4375,31
55058,9,59,521,49,3160,10
64456,7,68,230,59,2808,9
55048,107,925,521,731,4323,194
57569,76,1055,452,836,15932,219
24209,57,1762,1162,1125,15140,637
13142,623,28203,1344,17015,168038,11188
27070,1254,108144,1099,59147,301442,48997
57956,11,240,440,189,4440,51
54019,66,1123,557,921,24115,202
15884,1101,20943,1306,13747,74462,7196
22805,37,2297,1188,1506,48931,791
48792,37,1219,709,1004,20025,215
43531,1,91,779,80,10552,11
19525,189,2558,1242,1654,13547,904
18084,4,237,1268,162,3357,75
35671,33,732,931,557,11907,175
39082,3,263,846,185,7725,78
20900,1887,35544,1218,23463,167615,12081
28844,4,195,1063,120,6011,75
17671,7,164,1275,128,7788,36
27395,1351,45525,1092,28372,122430,17153
7039,86,2255,1397,1640,13500,615
27686,16,667,1085,424,15192,243
39128,1778,36928,845,29479,120164,7449
25956,596,15690,1124,10179,49836,5511
6597,42,1913,1402,1390,33318,523
28362,361,8021,1072,4953,57864,3068
68611,8,82,105,61,4717,21
21777,25,886,1203,540,5953,346
11405,318,11640,1364,7746,33089,3894
49300,33,559,693,482,13813,77
48587,288,3514,715,2690,36758,824
394,22,761,1466,557,44907,204
53055,24,199,585,162,3336,37
19049,63,1346,1251,963,20961,383
63478,8524,196434,253,151146,454910,45288
14544,227,11466,1324,8159,64846,3307
59592,65,1504,385,1270,12474,234
36481,254,3577,909,2973,55854,604
24837,240,5056,1148,3438,43478,1618
19356,71,1563,1245,1080,23428,483
57353,7009,415657,457,223627,686761,192030
62332,13,300,290,249,6545,51
53250,52,498,580,404,7358,94
30056,34,1161,1039,728,11564,433
19812,2,99,1237,77,4197,22
25400,9,269,1136,216,15982,53
653,3,153,1464,111,15856,42
68705,2,57,101,35,3964,22
24112,8,890,1164,630,19168,260
60360,0,23,358,19,3272,4
34170,777,23780,966,19007,134381,4773
24638,25,1461,1152,952,15713,509
21312,47,1144,1211,732,31279,412
62280,25,211,292,183,5044,28
38481,24,818,856,634,11292,184
777,5,362,1463,237,23389,125
64633,138,1410,226,1079,10628,331
67222,97,1456,150,1245,21973,211
634,179,6065,1464,4409,52103,1656
12043,6,499,1358,254,12524,245
4604,27,1017,1427,610,15024,407
37445,58,775,884,637,9887,138
15631,87,1990,1310,1363,21602,627
38634,672,7926,852,5217,42118,2709
64571,2,45,227,36,1559,9
6360,5,134,1406,91,5864,43
3878,109,3086,1436,1688,22767,1398
54072,4,25,555,22,3086,3
16720,68,2320,1292,1527,26594,793
62428,6,100,287,86,3818,14
57909,6545,116939,438,84767,598363,32172
50959,9,71,650,63,5411,8
567,43,1719,1465,1235,18081,484
17718,4,625,1275,311,10227,314
1293,87,4532,1459,3371,41501,1161
36986,6,211,897,174,4191,37
3319,34,1826,1442,1260,16000,566
63666,6,80,255,58,3093,22
6089,227,8473,1409,5373,81355,3100
56546,18,180,479,130,4703,50
49787,62,1131,601,996,21459,135
64355,15,160,233,147,9803,13
63012,4,82,273,68,3942,14
1458,77,3749,1458,2698,28347,1051
28992,270,5287,1060,4051,26248,1236
50012,73,1196,674,889,5767,307
61043,7,66,333,52,3789,14
51434,119,1941,637,1554,16375,387
5125,84,2727,1420,1956,31351,771
7740,112,2596,1387,1653,20552,943
65587,29,217,200,154,2323,63
1849,11,437,1455,331,11865,106
64192,106,1426,239,1140,10227,286
32657,1667,25958,995,17212,122669,8746
65264,9,114,207,65,4736,49
13111,66,1535,1345,863,27997,672
52767,52,574,594,445,23128,129
39132,30,590,845,461,9902,129
21880,187,2741,1202,2016,15091,725
34507,78,1667,959,1138,7996,529
794,13,471,1463,347,24839,124
35676,59,699,931,541,10065,158
60674,49,352,346,292,7161,60
40905,113,2435,820,2107,25536,328
32706,757,12326,994,8493,106922,3833
40287,69,1213,830,998,22299,215
18586,14,601,1259,483,8672,118
5524,75,1597,1415,1001,10981,596
65995,1,10,189,9,1307,1
63626,21,397,256,347,4911,50
5545,8,248,1415,174,3972,74
54759,154,1701,530,1358,12201,343
29701,39,1071,1047,615,8328,456
8780,34,1431,1381,977,12705,454
50014,68,1181,674,919,31149,262
64038,143,1918,243,1611,27769,307
30026,5831,110840,1040,73732,247343,37108
27498,105,2976,1090,1951,36522,1025
61402,14,260,321,198,6941,62
67763,755,11205,133,8986,76130,2219
45458,6,159,758,122,9297,37
598,37,2167,1465,1461,23031,706
23305,12,344,1180,228,18938,116
33465,70,1283,980,921,33647,362
16136,68,2423,1302,1807,32469,616
41307,27,488,814,363,8885,125
50512,4,108,661,85,3755,23
41341,4,135,813,110,7435,25
3808,9,142,1437,111,21375,31
23069,9,332,1183,227,8936,105
41354,30,372,813,287,8096,85
7807,1875,78310,1386,46271,575659,32039
31695,55,1002,1010,697,16724,305
55355,85,646,512,516,8865,130
36282,67,1131,915,817,18937,314
56082,101,1400,493,1021,10992,379
36053,222,2949,921,2339,25109,610
52005,21,209,621,166,4935,43
8609,412,12508,1381,7184,42261,5324
57671,19,357,449,309,5541,48
60494,13,117,353,85,1940,32
13022,0,0,1346,0,10713,0
26832,28,417,1104,340,9038,77
53879,1895,35554,562,26305,96707,9249
61444,13,143,319,107,6698,36
50378,532,6745,665,5267,68586,1478
36453,346,5310,910,4081,37460,1229
58312,12,345,428,271,6869,74
456,199,6010,1466,3361,47206,2649
63801,186,2944,252,2451,34123,493
50795,261,4247,655,3477,30205,770
53840,17,112,563,74,3485,38
3864,16,451,1436,307,16671,144
22517,2349,34580,1193,23251,83237,11329
20853,29,623,1219,442,8639,181
1032,31,1170,1461,882,49101,288
7547,6,276,1390,166,13273,110
65983,59,982,190,724,3925,258
29163,39,1774,1056,899,17518,875
18392,240,4755,1262,3159,60732,1596
53282,58,842,579,681,17553,161
30352,161,11503,1033,7973,49980,3530
30862,52,1223,1023,805,25597,418
37061,122,2377,895,1698,21120,679
39865,102,1103,837,888,7742,215
26056,225,8326,1121,5545,65837,2781
49878,46,509,677,354,12173,155
9705,517,9796,1376,6481,53037,3315
20182,17,488,1231,339,21046,149
25491,27,295,1134,215,8392,80
381,16,743,1466,503,32472,240
51598,6,236,632,187,9670,49
53392,8,143,576,125,6823,18
35875,27,567,926,413,9057,154
15009,13,348,1319,262,11093,86
68242,105,1797,118,1568,24719,229
5057,108,3504,1421,2574,62908,930
22479,23,1070,1194,761,18414,309
61612,39,786,314,632,8744,154
61850,4,122,306,107,2043,15
50750,14,345,656,223,9138,122
37843,31,758,874,565,22366,193
55374,23,317,512,252,13181,65
12208,16,2522,1357,1221,19458,1301
59084,7,91,403,74,10116,17
61619,2,18,314,14,2765,4
37279,16,570,888,451,13572,119
36384,356,4264,912,3426,36590,838
8560,195,4979,1382,3171,17803,1808
7256,35,740,1393,487,6922,253
24486,39,1199,1156,825,18711,374
29293,3,230,1054,124,3690,106
31702,26,916,1010,563,7670,353
13938,54,2749,1333,1559,11999,1190
55773,22,264,501,219,4881,45
7103,285,7594,1396,5275,40618,2319
662,1,79,1464,53,6466,26
28739,64,2050,1065,1191,23001,859
63634,696,10282,256,8364,76612,1918
35736,9,230,930,168,7800,62
63199,314,3191,268,2719,29109,472
23282,17,641,1180,476,25416,165
19203,10,466,1248,314,13930,152
28448,716,32122,1071,21295,167196,10827
11038,9,362,1367,228,7996,134
31348,29,1161,1015,644,6910,517
67605,337,5665,138,4799,59522,866
16002,385,6367,1304,4389,63259,1978
2560,90,4479,1449,2986,44367,1493
21142,252,5465,1214,3962,53333,1503
36914,1268,19865,900,16423,111563,3442
19714,0,0,1239,0,18850,0
61470,11,170,318,136,6192,34
47583,4,113,732,79,5430,34
68621,1,53,104,44,2298,9
1649,175,7578,1457,5107,71941,2471
54284,80,967,548,792,12040,175
36163,105,2792,918,2032,75537,760
56222,16,183,488,118,7346,65
61810,57,647,307,484,24956,163
23457,58,1463,1177,1171,46309,292
1635,18,444,1457,311,20113,133
29483,27,669,1051,462,12919,207
51206,25,310,643,244,5871,66
69055,2,67,90,41,3054,26
28938,46,944,1061,667,16953,277
31898,25,545,1007,313,4554,232
1705,16,659,1456,451,22920,208
35409,11,304,937,187,7920,117
15472,105,2744,1312,2014,30547,730
29541,131,2136,1050,1550,8992,586
66282,110,785,181,683,7678,102
18307,16,765,1264,512,15946,253
64437,13,154,231,132,6217,22
65955,0,12,190,4,1375,8
7086,45,1772,1396,1172,40572,600
14866,9,177,1321,115,9136,62
34618,17,327,956,224,8024,103
34474,102,1478,960,1117,11042,361
16379,6,696,1298,566,16922,130
64959,71,1075,215,962,20716,113
50766,1,58,656,48,2700,10
36996,25,635,896,518,15569,117
5341,72,1834,1418,1488,19772,346
32864,190,2294,988,1752,31496,542
28429,324,7404,1071,4677,43013,2727
63208,24,225,267,183,7256,42
34264,18,451,963,328,3878,123
512,18,745,1465,472,12704,273
6495,8615,199308,1404,124350,462566,74958
19273,8,385,1247,276,20187,109
48636,25,308,714,247,10734,61
54020,17,400,557,276,8951,124
18836,1,70,1254,38,7366,32
64844,13,86,219,64,5550,22
22800,2325,51546,1188,32689,152789,18857
3036,2,268,1445,201,25131,67
24307,828,25645,1160,16713,98084,8932
65018,44,295,213,247,3883,48
21644,37,820,1205,700,19495,120
3577,31,1084,1440,861,17122,223
23747,14,372,1172,252,10733,120
29009,36,416,1060,249,4177,167
55386,119,1450,511,1183,16855,267
6568,119,3083,1403,1873,51112,1210
57560,26,204,452,156,4454,48
55622,25,380,505,302,7492,78
56050,57,570,493,435,11844,135
23189,6,186,1181,167,16111,19
66513,11,106,174,75,8859,31
52100,41,714,617,587,11561,127
68133,8,102,121,77,4352,25
58617,154,2717,415,2087,21754,630
6185,20,822,1408,464,9724,358
9059,8,348,1379,219,9339,129
13053,31,851,1345,488,8786,363
40419,7,250,828,188,8374,62
22027,15,490,1200,397,9924,93
22120,35,687,1199,515,14841,172
51471,52,1007,636,876,28239,131
3142,2250,198030,1444,101299,689978,96731
51301,514,8470,641,6386,40014,2084
39024,88,1161,847,921,9768,240
58854,42,435,410,350,9892,85
35284,241,2761,940,2277,41052,484
34292,32,884,964,552,5951,332
4689,18,904,1426,680,18599,224
212,152,3569,1468,2490,36091,1079
64900,27,278,217,200,4205,78
31758,516,9680,923,6823,28971,2857
57103,7,68,463,59,2713,9
1547,70,2269,1457,1576,52393,693
217,97,7817,1468,5447,52806,2370
8104,32,1675,1383,999,15445,676
6763,114,5170,1400,3490,87334,1680
7149,9,528,1395,343,16319,185
47437,9,166,734,112,5139,54
48794,94,1166,708,940,24256,226
15994,196,8461,1304,6436,81377,2025
48117,140,1338,726,1062,11391,276
17547,179,4006,1278,2950,63186,1056
61314,55,764,323,627,20497,137
50805,135,1530,654,1244,25500,286
41463,13,222,812,170,8170,52
12759,21,581,1350,345,20155,236
53044,12,319,585,248,7883,71
35397,53,1510,937,1120,18122,390
1256,28,1067,1459,795,17481,272
30918,744,15590,1022,10667,136810,4923
67888,8,59,129,55,4854,4
2738,1474,78337,1448,54292,483839,24045
18730,8,96,1257,70,32855,26
17277,14,1215,1283,764,12596,451
13291,13,604,1343,303,10990,301
38033,58,1678,868,1261,45334,417
28072,24,638,1078,392,25835,246
34337,156,3941,963,2778,27922,1163
17864,42,1467,1271,1058,24967,409
451,1,285,1466,181,10842,104
8700,84,3869,1381,2354,35227,1515
33470,167,2332,980,1814,20209,518
18258,781,22252,1265,16121,156500,6131
52456,171,3884,605,3271,43165,613
27042,100,1116,1099,650,9556,466
1737,113,2516,1456,1683,39766,833
50613,52,1034,659,776,9726,258
33148,508,9991,986,7017,63081,2974
31200,8,171,1017,100,5074,71
65838,6,37,193,35,4421,2
3439,93,5624,1441,3504,89498,2120
8615,52,1603,1381,932,12506,671
48970,81,979,703,821,7308,158
56048,84,899,493,675,12881,224
37667,8,125,878,111,9726,14
65360,94,1260,205,1056,16274,204
63631,40,239,256,192,6770,47
26207,445,10243,1119,6453,59949,3790
11376,19,734,1365,418,15620,316
22119,7213,114720,1199,64730,303148,49990
4367,43,1635,1431,950,17106,685
52503,41,637,603,564,24290,73
10247,8,246,1373,174,8480,72
54120,6,29,554,27,5850,2
29273,113,3740,1054,2469,32804,1271
8862,52,2813,1380,1827,27008,986
32521,380,6596,975,2868,99568,3728
49837,45,568,679,379,4714,189
37003,185,2916,897,2285,51521,631
29156,88,2579,1056,1646,17094,933
63100,0,36,270,25,2108,11
56040,596,4817,494,4460,32654,357
7010,1690,138891,1397,79626,664088,59265
27884,17,874,1081,546,28930,328
65990,25,433,190,345,6012,88
57333,23,270,458,210,4038,60
56766,6,97,473,90,5139,7
52282,168,2730,611,1997,19173,733
31467,20,394,1014,251,6616,143
23593,345,12112,1175,8625,76501,3487
61816,23,575,307,454,14950,121
21341,1113,23250,1210,16476,177554,6774
26866,39,1198,1103,778,12712,420
38647,116,2136,852,1736,28612,400
16313,0,57,1299,25,5688,32
49514,20,287,687,238,4980,49
39682,26,607,839,491,21580,116
30296,11,743,1034,452,27358,291
39104,7,105,846,76,8608,29
27430,622,26218,1091,16861,115442,9357
14424,110,3082,1326,2290,29072,792
40181,57,939,832,744,6646,195
17720,966,28142,1275,19693,153961,8449
60114,68,1205,367,966,27223,239
39988,216,5467,835,3895,45029,1572
24978,19,1083,1144,650,11462,433
12724,0,0,1350,0,3501,0
5513,12,239,1416,154,10738,85
41567,22,369,810,254,5883,115
31785,4,66,1009,55,5123,11
35815,758,10544,928,8512,38002,2032
18699,10,595,1257,470,19470,125
50960,134,2522,650,1934,29318,588
30283,2,130,1035,57,17720,73
14169,54,1164,1330,813,13613,351
30182,0,0,1036,0,4724,0
49325,26,770,692,593,12223,177
35439,50,972,936,696,12990,276
67162,22,285,152,252,6340,33
54842,7,61,527,52,4838,9
52741,36,624,595,440,10504,184
58614,19,221,417,182,4908,39
56400,6,86,483,77,8874,9
3886,7,445,1436,318,18922,127
66676,10,197,168,147,6912,50
3739,551,31175,1438,17532,149494,13643
15699,8842,299281,1309,182541,1202076,116740
13922,1593,56784,1333,39649,121046,17135
3709,8,194,1438,128,9798,66
49443,12,311,689,254,5797,57
33518,94,1916,979,1210,17972,706
43565,16,322,779,267,8628,55
29920,10,228,1042,153,11249,75
41625,49,718,809,543,21718,175
53944,109,1472,560,1182,16650,290
40405,7,122,828,85,9095,37
38751,49,914,851,802,25574,112
34785,22,523,952,359,9951,164
64874,304,8770,218,3854,66077,4916
25644,112,4293,1130,2704,69629,1589
62674,6,62,280,46,2794,16
52103,45,543,617,400,7398,143
68525,3,32,108,25,2353,7
8044,25,536,1384,348,9807,188
67282,4,36,148,28,3805,8
31913,7,172,947,114,5637,58
21525,1070,33764,1207,23735,146244,10029
35195,65,1952,939,1577,28674,375
52458,99,1198,605,867,8870,331
49723,2236,38184,681,29300,134864,8884
4448,23,2085,1430,1035,40342,1050
29551,2120,31443,1050,19959,149768,11484
20137,126,3833,1231,2722,50207,1111
49946,22,294,676,255,20247,39
49150,182,2978,698,2265,26245,713
30833,4023,63508,1024,41169,260370,22339
50882,2451,38161,652,25636,196909,12525
14140,21,274,1330,195,13405,79
32075,355,6552,1005,4143,28996,2409
15095,808,31641,1318,19292,153241,12349
16607,11,176,1294,115,6364,61
10598,162,2791,1371,1852,25324,939
18878,71,1809,1254,1250,18603,559
58766,9,121,413,93,4882,28
39418,404,8109,842,6043,55604,2066
14641,65,2016,1323,1387,20960,629
37747,16,603,875,348,8605,255
28649,150,3437,1066,2096,17924,1341
67585,60,590,138,469,6345,121
11891,183,8204,1360,4532,55809,3672
23934,113,6295,1168,3909,44127,2386
3504,76,1864,1440,1458,112782,406
32454,42,732,998,452,13637,280
68680,4,27,102,25,934,2
13473,95,7125,1340,4137,29780,2988
56436,62,817,482,498,8199,319
25508,421,8198,1134,5796,34694,2402
44259,190,3804,771,3089,36746,715
62474,17,435,286,382,8809,53
2987,0,76,1445,51,7105,25
17995,12,1018,1269,734,22687,284
12295,1689,46483,1356,29416,214909,17067
5604,999,32156,1415,23437,242758,8719
67304,28,568,147,406,7788,162
62969,2,21,273,10,2269,11
38471,56,937,857,720,12768,217
57519,43,473,454,362,3649,111
16254,0,82,1300,59,2387,23
41980,20,356,803,277,6502,79
57025,58,676,466,509,8051,167
33559,179,3802,978,2537,27007,1265
661,373,17870,1464,11113,199857,6757
18549,99,1465,1260,1200,19611,265
64973,105,1435,214,1162,15378,273
14116,40,906,1330,539,17244,367
61538,174,5113,316,3607,58797,1506
63315,369,5548,264,4699,32177,849
31585,68,1246,1012,813,21188,433
21054,2,82,1216,61,10469,21
35896,29,1145,926,875,20672,270
51228,14,125,643,109,3026,16
49486,84,1123,688,778,6854,345
59297,76,1148,395,961,10084,187
61974,36,511,301,415,5325,96
52433,2,68,606,51,15899,17
24776,16,166,1149,132,11537,34
48777,1221,16075,709,11265,93040,4810
30141,358,12155,1037,7813,100534,4342
29867,6,412,1043,251,5944,161
51657,1378,15780,631,12605,109437,3175
50708,328,5889,657,4616,85825,1273
58743,586,11102,413,9151,101029,1951
34731,226,2994,953,2154,27583,840
17448,4,232,1280,185,29157,47
32562,161,1989,988,1389,48638,600
63280,26,426,265,305,10056,121
23452,25,574,1177,406,14635,168
11084,12,1103,1367,642,22274,461
26538,66,1021,1111,669,13606,352
26156,26,1398,1120,869,16027,529
26338,90,7612,1116,4368,28941,3244
10940,3714,100338,1368,61764,182532,38574
61643,274,4254,313,3402,32419,852
58644,41,391,415,308,6405,83
2032,199,4345,1454,2994,29591,1351
41466,482,8179,810,6715,70836,1464
39514,3,102,841,96,6555,6
4758,194,6698,1425,4700,204142,1998
5077,22,1789,1421,1124,19058,665
52778,77,1384,594,1145,17149,239
30929,14,451,1022,277,11586,174
50581,10,132,659,101,4044,31
207,41,2019,1469,1326,33356,693
58348,156,1169,427,917,8185,252
26265,88,2784,1117,1578,18456,1206
32130,1,38,1004,18,8034,20
38495,4,103,856,87,7184,16
24664,5555,348361,1151,204617,1277385,143744
67891,314,4889,129,3858,34405,1031
29835,10,436,1044,233,4159,203
36746,399,5138,904,3699,23099,1439
16627,23,1142,1294,710,16104,432
38640,67,477,852,383,8020,94
64217,36,531,238,412,8646,119
22334,6,325,1196,241,17721,84
27456,20,585,1091,386,12240,199
67218,29,357,150,276,2961,81
66337,20,221,179,171,1573,50
54721,130,2453,532,1611,24544,842
15286,3,161,1315,114,5430,47
32848,35,1522,991,943,36474,579
10029,15,504,1374,366,13273,138
21714,242,8617,1204,5893,75119,2724
9937,253,5041,1375,3364,27332,1677
38541,373,4712,855,3659,17914,1053
49487,73,734,688,586,24284,148
27021,10,396,1100,235,9835,161
66161,232,2480,184,1999,12138,481
32605,22,841,996,472,18872,369
16310,9,269,1299,201,5542,68
16785,38,1164,1291,865,17529,299
28198,6,172,1075,141,8469,31
22016,273,10429,1200,6915,51771,3514
13460,146,4597,1340,2807,45622,1790
32709,22,431,994,333,9926,98
25749,269,15529,1128,10194,71635,5335
29215,49,1436,1056,1086,10643,350
516,2,90,1465,54,14361,36
47747,28,292,730,242,10986,50
6857,5,123,1399,78,12446,45
28735,9,888,1065,535,14215,353
67607,5,129,138,97,5320,32
49802,33,809,679,643,15280,166
26482,1,66,1113,39,4990,27
66992,1,43,157,35,2477,8
9334,142,5105,1378,3327,57693,1778
11735,40,1056,1361,610,18261,446
63704,101,1404,254,1094,15992,310
68180,27,328,120,259,4056,69
52336,25,287,610,228,5872,59
61382,6,87,321,55,2693,32
39377,1133,8601,843,6496,52310,2105
57567,4,176,452,44,5963,132
18062,3,131,1268,90,7267,41
52134,103,975,616,852,10168,123
56836,25,237,471,172,3735,65
15931,27,1227,1305,911,54629,316
51285,168,1930,641,1680,27485,250
60840,250,2801,340,2434,33824,367
1453,210,9073,1458,5754,151414,3319
3306,4335,123650,1442,78352,306721,45298
64562,12,125,228,106,4843,19
8320,321,10881,1383,6738,39501,4143
58949,13,133,407,113,4260,20
17627,91,1678,1276,1266,15562,412
1853,82,4403,1455,3073,72101,1330
8497,14,738,1382,491,6004,247
23397,289,5721,1178,4194,42617,1527
3149,250,5765,1444,4155,48220,1610
65601,0,15,200,9,1170,6
42063,1,16,801,12,11587,4
18650,71,2417,1258,1637,49832,780
58872,33,740,409,517,18774,223
40644,2,155,825,70,5304,85
33644,104,1931,975,1090,55819,841
13931,15621,383870,1333,227262,1052416,156608
5659,39,1083,1414,745,26594,338
10832,487,14267,1369,8402,47374,5865
25005,33,770,1144,455,14169,315
1824,46,1306,1455,951,39043,355
27222,111,2680,1096,1643,24382,1037
1829,17,433,1455,304,16226,129
50659,11,159,658,104,5830,55
4210,595,21569,1433,13858,155950,7711
28741,4156,92676,1065,64052,193719,28624
24234,7176,169595,1162,124655,784121,44940
27814,18,445,1083,286,15280,159
11240,116,6052,1366,3506,64348,2546
55031,29,354,521,295,12712,59
60324,18,229,360,182,5499,47
14178,6005,148957,1330,107997,433124,40960
22160,36,1309,1198,918,37816,391
36593,167,3016,904,2393,17069,623
57210,21,243,461,197,9771,46
38093,0,19,867,16,7888,3
15641,3001,68402,1310,43749,299220,24653
25625,127,3149,1131,1950,17560,1199
14306,25,766,1328,451,10218,315
34739,69,911,953,644,15664,267
60834,46,819,340,473,19281,346
67606,8,563,138,205,5163,358
31485,6203,141600,1004,99542,611185,42058
36465,9,161,909,117,8397,44
12914,24,1053,1348,696,18100,357
19084,29,379,1250,252,9031,127
28184,101,2780,1075,1726,21444,1054
41308,397,5241,814,3918,18558,1323
21535,576,13650,1207,8943,83470,4707
10744,82,3623,1370,2264,38490,1359
37788,15,327,875,233,12853,94
58373,186,2377,426,1940,22386,437
24146,381,12311,1163,8548,71205,3763
43853,26,380,776,290,9736,90
9930,12528,440932,1375,233627,892844,207305
23146,48,2790,1182,1781,26083,1009
26950,63,1780,1101,1312,68288,468
38301,3549,74687,862,58064,298625,16623
64200,302,4531,227,3387,27011,1144
25950,188,4760,1124,2993,44822,1767
61627,1,23,314,17,2895,6
51408,45,522,638,386,9395,136
24588,96,1722,1153,1072,15493,650
452,2,137,1466,88,4275,49
58200,68,1377,432,1083,13178,294
32301,22,518,1001,343,5576,175
1058,2,242,1461,175,22012,67
9744,40,793,1376,540,9403,253
33319,72,1805,975,1050,11741,755
15417,214,4399,1313,3180,52791,1219
38901,2113,36893,848,26677,104204,10216
2974,852,53894,1445,34359,283455,19535
61395,993,12774,321,9906,87489,2868
40400,5941,70272,828,47931,203059,22341
20094,123,3003,1232,2160,39059,843
4905,4,166,1423,100,5936,66
45980,16,231,752,195,6968,36
39993,1193,19372,835,16136,119648,3236
60725,23,328,344,239,3426,89
64512,6,129,229,83,5689,46
61771,14,185,309,163,5797,22
19176,56,1693,1249,1140,13502,553
35787,2,83,928,65,6481,18
11581,35,1126,1363,577,12106,549
13780,6,260,1336,157,12500,103
24114,22,852,1164,600,11803,252
33076,14,336,987,204,20578,132
2040,15,681,1454,469,15997,212
36249,1940,44975,916,34317,178754,10658
68865,54,407,96,346,7878,61
34279,19,433,963,326,3168,107
27912,78,2041,1080,1567,12492,474
35212,19,441,941,319,18649,122
5504,2749,109884,1416,74925,253615,34959
59286,96,1620,396,1224,17868,396
5860,1483,52556,1412,32334,229350,20222
34772,109,2991,952,2082,34101,909
66298,4,85,180,51,4332,34
67437,45,615,144,486,6191,129
51633,8848,207294,631,138567,901264,68727
9757,18,693,1376,486,14820,207
45877,133,1786,754,1485,20914,301
28442,98,1835,1071,1252,39376,583
58148,38,1385,434,778,16528,607
24824,143,4059,1148,2683,24970,1376
33939,10230,287063,952,216017,961587,71046
9117,864,41302,1379,26171,153682,15131
63099,24,425,270,333,5306,92
15505,15,709,1312,515,18540,194
49814,340,3657,679,2701,48919,956
10226,61,1520,1373,978,10506,542
32180,45,1329,1003,902,20360,427
22112,9,271,1199,185,14238,86
3816,61,2002,1437,1425,38203,577
35592,113,2733,932,2156,37059,577
60202,4,40,364,26,5181,14
34821,77,2423,951,1637,25133,786
1739,188,12439,1456,7637,88661,4802
28227,19,310,1075,233,4824,77
38076,53,737,867,661,11979,76
52639,16,137,598,114,5622,23
26684,9,387,1107,240,7271,147
19981,48,1014,1234,705,44239,309
55869,58,1159,499,791,16140,368
57161,56,631,462,515,11993,116
6769,60,2122,1400,1304,24309,818
12417,15,708,1354,357,11260,351
27781,5,361,1084,243,16523,118
11078,9,291,1367,182,14317,109
52536,404,5505,602,4570,42995,935
62827,10,260,277,193,10233,67
18755,50,807,1256,551,14624,256
18843,83,2580,1254,1830,27977,750
8162,617,12549,1383,8093,39885,4456
17459,35,580,1280,426,10954,154
29091,49,1053,1058,719,21823,334
49980,12,280,675,206,4995,74
45741,20,276,755,235,8729,41
46132,15,162,751,120,6226,42
64836,58,939,219,702,10068,237
13137,135,5161,1344,3307,40182,1854
32998,279,10318,988,6497,37236,3821
7352,4,110,1393,83,11655,27
384,33,1914,1466,1293,20127,621
24220,28,1322,1162,933,27020,389
53747,2,33,567,24,2313,9
27777,40,1318,1084,858,13613,460
68084,20,317,123,230,4376,87
7634,135,5208,1389,3342,21013,1866
60447,44,504,355,393,7543,111
9211,14,749,1379,447,15512,302
62201,44,532,294,406,9286,126
88,2040,88320,1470,49182,396772,39138
33638,0,34,977,28,4602,6
61219,64,1519,326,1242,10308,277
35156,17,214,943,144,3333,70
3843,3,222,1437,136,9418,86
16373,14,857,1298,599,34063,258
13608,23626,832473,1338,566533,2546402,265940
41279,312,5383,814,4393,53126,990
16482,64,724,1296,558,24784,166
55962,18,262,496,235,16033,27
10893,31,1464,1368,964,35248,500
53592,4,186,572,153,4277,33
3609,8,212,1440,166,10206,46
66322,15,179,180,145,9875,34
19411,2,164,1244,130,8157,34
57042,10,75,465,62,2592,13
2186,12,294,1452,217,12044,77
54125,109,1320,553,1070,19996,250
22623,185,4113,1191,2765,20276,1348
62683,131,1912,280,1536,14181,376
51923,33,568,624,410,17220,158
56108,6,88,492,67,3234,21
19809,0,0,1237,0,9646,0
25872,564,9708,1126,5720,71353,3988
36522,6,220,907,160,9645,60
48350,58,741,722,544,9459,197
60306,42,797,360,634,8395,163
19349,83,2629,1246,1917,93732,712
2815,29,834,1447,647,16505,187
68647,2,57,103,42,5695,15
43569,108,1645,779,1370,21250,275
26888,319,9898,1103,7121,82050,2777
25149,22,750,1141,647,16681,103
62845,18,522,276,354,17996,168
46687,41,561,743,456,8378,105
22080,15,432,1199,309,4976,123
61089,165,2199,331,1732,9253,467
1422,23,982,1458,683,16138,299
68192,2,19,120,19,4925,0
37489,1584,21810,883,16107,79605,5703
26445,2394,47957,1113,33110,213474,14847
17948,16,296,1270,192,5105,104
61239,46,372,325,291,9390,81
25392,9842,262933,1136,163790,795407,99143
46967,253,4996,740,4011,54810,985
68394,69,701,113,562,7726,139
50144,290,4390,671,3557,43481,833
52853,5274,108619,591,84455,356254,24164
29105,301,7863,1058,5318,61354,2545
2910,91,3048,1446,2383,18036,665
59958,10,134,373,85,3582,49
61016,531,7559,334,5961,52464,1598
17608,109,3242,1277,2350,31434,892
9859,106,2702,1375,1616,19429,1086
60063,179,3181,368,2434,54075,747
17472,12,361,1279,260,9417,101
55456,27,466,510,416,12006,50
25352,127,2783,1137,1892,35054,891
53429,18,207,575,138,6162,69
9783,129,6615,1376,4349,40745,2266
630,23,1513,1464,975,44313,538
2933,2504,152531,1446,87804,628026,64727
67956,26,526,127,432,14996,94
67262,3,60,149,50,1131,10
33174,305,4205,985,2707,44692,1498
17476,7,65,1279,49,7208,16
18801,17,420,1255,294,10201,126
10273,0,47,1373,37,7356,10
18107,80,3504,1267,2453,52177,1051
54151,165,2461,553,1976,43100,485
511,30,1398,1465,975,54507,423
57462,9,108,455,70,2985,38
37955,1284,45749,871,34625,104845,11124
26629,80,2627,1108,1601,34378,1026
14883,7,208,1321,147,9396,61
65027,8,137,212,104,6528,33
54604,58,744,536,590,10794,154
17426,358,9534,1280,6770,55265,2764
50510,15,290,661,236,8250,54
32465,112,3793,998,2038,30069,1755
53870,0,11,562,8,2772,3
48852,37,704,707,535,8014,169
57273,30,549,459,435,8951,114
58256,11,119,430,81,7993,38
26203,51,640,1119,387,7956,253
24856,7,236,1147,206,6813,30
33383,4,54,982,29,4846,25
62527,4,90,285,61,3043,29
35972,24,343,924,278,16330,65
67220,36,615,150,480,7353,135
61833,46,658,307,545,11370,113
3058,5,413,1445,295,18992,118
15923,26,1042,1305,825,25390,217
63728,6,69,253,58,4550,11
61460,2687,32015,319,27099,122674,4916
1269,2892,151381,1459,85312,719749,66069
34080,384,9454,968,7030,65534,2424
53902,634,6607,561,5061,38295,1546
68886,1,97,95,94,1969,3
22056,5013,153073,1200,107249,770655,45824
28175,6,545,1076,309,10108,236
6716,4,259,1401,163,13994,96
49747,475,5328,681,4322,50146,1006
66740,9,127,166,88,4563,39
57891,19,194,441,155,5445,39
6986,101,2235,1398,1634,15731,601
10350,17,444,1372,271,8184,173
68615,1,53,104,31,2924,22
40796,4,107,822,80,7708,27
67497,9,199,140,148,5301,51
25548,17,384,1133,308,11827,76
57821,354,4869,444,3984,23645,885
58151,2140,34844,433,28330,112836,6514
30033,1964,57939,1040,39201,314105,18738
33192,137,2973,985,1930,27687,1043
14438,73,1943,1325,1496,28640,447
18913,23,1094,1253,828,13574,266
25309,435,11972,1138,8043,150989,3929
50543,13,258,660,198,11369,60
14459,130,7710,1325,5153,43833,2557
26289,277,6177,1117,3699,43318,2478
44837,41,913,765,764,19156,149
60665,105,1298,346,1092,12060,206
59169,28,269,400,246,10785,23
61214,8,122,326,94,8930,28
22586,124,3561,1192,2417,50915,1144
56520,17,161,479,132,4168,29
48938,12976,378642,704,244180,826658,134462
55709,19,140,503,137,4272,3
25524,52,788,1134,515,8061,273
32860,16,421,991,274,7971,147
65303,25,179,207,152,3827,27
3978,4,159,1435,115,17674,44
729,10,689,1464,485,13613,204
13069,78,3186,1345,1849,61633,1337
13600,11,246,1338,167,11189,79
58175,7,64,433,52,4926,12
12425,575,24994,1354,13760,109176,11234
56879,16,321,469,285,8772,36
57505,215,2491,454,1940,14243,551
68268,2,29,117,16,943,13
38507,1725,32931,840,24701,80629,8230
7176,4,107,1394,82,8152,25
24428,545,16186,1157,10911,94357,5275
30841,6,289,1023,173,4480,116
5588,3890,183970,1415,105009,936077,78961
38125,5,243,866,200,10679,43
56381,100,1020,484,714,24614,306
64136,54,594,240,432,6780,162
56726,71,569,474,453,6150,116
4971,11,465,1422,345,8593,120
8735,24,1226,1381,751,13341,475
36285,49,771,915,476,9979,295
29019,105,1904,1059,1249,21682,655
53930,28,277,561,208,5409,69
18784,90,2890,1256,2133,24737,757
53666,59,907,569,728,11938,179
36345,55,763,913,619,12005,144
56084,1825,30281,492,24719,127243,5562
61052,34,506,332,420,16728,86
12182,118,2512,1357,1380,25765,1132
55475,274,3459,506,2720,27309,739
53729,226,2198,567,1705,13744,493
62231,9,185,293,159,3245,26
64357,42,329,233,283,6688,46
11163,78615,1811662,1366,1082741,6344357,728921
22283,265,6450,1197,4225,39476,2225
60758,19,368,343,246,5651,122
22113,6238,226145,1199,151825,567482,74320
23835,86,2402,1170,2033,45049,369
13804,450,6258,1335,5030,62348,1228
54623,2038,23681,535,18591,62948,5090
32784,0,35,993,25,3222,10
20769,104,3555,1221,2256,42381,1299
1248,1632,60257,1460,37103,138272,23154
32943,208,3501,990,2433,28319,1068
19660,12188,428786,1240,258619,987858,170167
10509,654,22908,1371,14860,114465,8048
62008,62,942,301,708,15071,234
10051,895,40385,1374,26346,219975,14039
65273,30,324,207,263,3498,61
15985,38,1034,1304,749,16588,285
56024,359,5357,494,4221,40253,1136
68919,4,108,94,84,4683,24
61569,411,8962,315,6270,39536,2692
18593,1807,47600,1259,31562,219041,16038
1641,2,123,1457,80,6761,43
57784,59,1744,445,1398,15723,346
23749,20,736,1172,621,9786,115
57558,33,633,452,546,16491,87
32445,38,726,999,402,9230,324
34520,23,303,959,202,5500,101
34930,675,15300,949,11422,61426,3878
60060,60,1297,369,1058,25749,239
50908,34,376,652,294,5071,82
62232,31,536,293,379,9614,157
15124,9,548,1317,394,36673,154
7204,141,3198,1394,2111,44554,1087
15442,644,11275,1313,6746,62738,4529
61808,957,16897,307,12993,64003,3904
50639,2,31,658,27,2565,4
46930,23,371,741,282,4492,89
8935,1,129,1380,81,9350,48
55244,9,124,516,90,6439,34
27564,41,1324,1088,818,10489,506
38462,37,889,857,682,11832,207
7224,100,3075,1394,2046,25762,1029
12068,1322,30413,1358,20547,202990,9866
7487,13,209,1391,140,7390,69
18145,81,4175,1267,2824,35974,1351
55507,86,1239,508,1025,12980,214
420,34,1647,1466,1077,40066,570
14823,238,7691,1321,5726,59949,1965
20097,12,355,1232,256,11005,99
1981,16,821,1454,472,36048,349
4635,16,481,1427,345,18491,136
54731,29,213,531,198,7359,15
23345,24,1204,1179,794,12139,410
62841,17,150,277,127,3248,23
66373,4,49,178,41,2826,8
22090,35,1457,1199,856,20221,601
67233,355,5873,150,4969,47777,904
27179,11,454,1097,230,10255,224
13957,32,727,1333,417,8604,310
34247,8,484,965,306,9907,178
34317,70,1264,964,994,10135,270
9912,5129,136634,1375,84707,250758,51927
18473,32,825,1261,516,21056,309
51018,98,855,649,730,8923,125
62561,23,399,284,312,10861,87
35696,8,255,931,174,14333,81
66856,243,4984,162,4305,45600,679
26428,34,292,1113,193,4619,99
57204,0,271,461,211,6602,60
51510,24,347,635,257,3508,90
66088,3,86,186,68,1550,18
337,663,29191,1467,20523,160134,8668
8995,165,7723,1380,4993,27235,2730
18603,6,257,1259,200,13910,57
54183,48,441,552,377,15693,64
61210,6,120,326,73,9407,47
8332,283,6919,1383,4406,31488,2513
18685,275,5924,1257,4007,61232,1917
22495,336,9249,1194,6283,119696,2966
32371,313,7162,1000,5529,74812,1633
52546,51,827,602,699,10653,128
2565,31,640,1449,414,5748,226
36882,27,394,901,266,5038,128
19385,23,1061,1245,685,9468,376
36035,7,242,922,198,6273,44
51698,40,329,630,262,3233,67
37528,281,2571,882,1876,31344,695
33508,308,5869,979,4159,28021,1710
8264,46,2002,1383,1368,16669,634
65405,30,484,204,336,5204,148
41361,6,100,813,82,6832,18
24933,1673,39589,1145,28987,173789,10602
35782,139,1507,929,1104,7949,403
51626,79,1773,631,1298,18991,475
28446,19,966,1071,566,12293,400
53367,20,236,577,176,9679,60
22683,189,3751,1190,2567,124234,1184
47276,80,2058,736,1595,15978,463
23074,71,2921,1183,2061,50763,860
17218,413,11304,1284,7942,52056,3362
14021,189,5554,1332,3995,50751,1559
51851,9,159,625,121,4916,38
55549,118,1049,507,842,18049,207
25078,77,3025,1142,2133,23184,892
19345,35,1373,1246,948,16598,425
49129,112,1389,698,1115,57012,274
9018,17,771,1380,523,14558,248
53920,5,51,561,39,5332,12
60852,142,1448,339,1153,16213,295
46247,56,884,749,750,14531,134
18982,67,1323,1252,1038,31776,285
30814,112,2018,1024,1267,13197,751
37660,2642,42368,878,31028,161689,11340
44688,35,752,767,568,20504,184
965,70,1809,1462,1312,29554,497
66728,1,11,167,7,1020,4
24200,75,1789,1162,1096,10813,693
56076,14,152,493,131,6064,21
29955,72,1152,1041,771,30593,381
18703,20,505,1257,410,15065,95
24525,93,2016,1155,1195,22293,821
5815,7,538,1412,353,19706,185
49141,4,126,698,88,4394,38
13798,1905,45855,1335,32976,159373,12879
26010,35,1951,1122,1011,17779,940
66805,3,68,164,45,2716,23
22233,534,18828,1197,13497,115423,5331
43765,1734,42241,777,32573,415330,9668
24176,74,2839,1163,1793,37312,1046
23154,327,10086,1182,5570,33184,4516
50807,33,545,654,382,7007,163
23188,39,834,1181,374,12535,460
21342,9,410,1210,313,12525,97
27530,107,1605,1089,920,9732,685
18617,0,0,1259,0,11212,0
52129,8,168,616,108,8197,60
39679,109,1676,838,1347,23974,329
61071,27,366,331,280,9826,86
19403,940,22476,1245,14510,72111,7966
48293,237,4550,723,3705,28972,845
57384,3,164,456,121,2437,43
31675,1733,36664,1011,25992,262059,10672
17143,28,627,1285,488,9684,139
44792,209,4550,765,3876,26687,674
19717,440,10949,1239,7621,134788,3328
51946,58,873,623,800,13493,73
16327,40,2002,1299,1420,31383,582
37422,4679,66733,885,54731,314454,12002
33514,3,94,979,63,5247,31
56686,4,84,475,58,4572,26
60444,33,318,355,281,7643,37
33910,3,161,972,136,12245,25
48845,7,106,707,83,18282,23
14790,70,1289,1322,877,9244,412
19275,27,1330,1247,989,23737,341
26149,19,776,1120,468,11129,308
4891,42,711,1423,536,15574,175
52668,42,536,597,429,13458,107
54871,44,648,526,528,10260,120
41062,108,2838,817,2226,43643,612
14221,1932,83651,1329,57108,492357,26543
18479,4,322,1261,234,13130,88
4249,58,1199,1432,794,30423,405
23125,6261,140585,1182,94112,480383,46473
52993,79,1695,587,1365,17553,330
13234,1332,27339,1343,17385,179414,9954
67892,5,40,129,31,2205,9
13119,1,83,1345,51,7777,32
15784,58,1881,1308,1160,27643,721
54590,10,110,537,84,2989,26
8686,56,1842,1381,1148,12720,694
11687,38,491,1362,252,3583,239
68796,9,93,98,70,2023,23
13561,1609,43485,1338,29789,370263,13696
36441,8,462,910,369,12743,93
735,41,3581,1463,2702,76969,879
33327,57,1117,982,766,23954,351
54703,2523,34797,532,29299,216637,5498
66296,69,486,180,368,4872,118
25180,14,256,1141,186,12482,70
11546,1102,54439,1363,33097,266986,21342
18925,62,2254,1253,1242,15683,1012
9089,23,1007,1379,589,34583,418
54021,348,8762,557,6886,25714,1876
43071,118,1604,785,1375,18044,229
11799,196,12393,1361,7101,67146,5292
27764,151,3800,1084,2139,20705,1661
2605,3,166,1449,118,11497,48
31119,28,547,1019,384,9258,163
14693,992,18284,1323,13204,122167,5080
3119,28,955,1444,656,38257,299
6379,14,432,1405,304,23145,128
64576,71,1353,227,1143,25260,210
54402,22,205,543,171,7484,34
14489,10,548,1325,391,10507,157
36298,51,1469,915,1278,20536,191
24248,194,3336,1161,2362,30156,974
17812,12,508,1273,407,11463,101
52717,3339,39924,595,26162,118652,13762
52474,2675,35375,604,28831,238542,6544
21833,9,397,1203,260,10187,137
68301,200,3856,116,3101,27853,755
3192,294,16936,1443,11101,139845,5835
7032,51,1179,1397,758,38198,421
63195,7,136,267,107,5005,29
30614,126,3224,1028,2205,37248,1019
22791,1856,62586,1188,42689,278426,19897
56220,12,135,489,135,8114,0
30920,26,1031,1022,639,10551,392
2086,22,1034,1453,784,53408,250
34419,2,125,961,80,6866,45
3222,64199,1512861,1443,972492,3978306,540369
9561,11,1299,1377,861,13350,438
20591,32,1427,1224,888,9651,539
15810,629,22409,1307,15499,364703,6910
58189,37,833,432,653,10117,180
58712,13,132,414,112,9394,20
18229,6,315,1265,222,9664,93
37628,119,1409,879,1154,16208,255
24511,748,14605,1155,11771,105278,2834
23444,101,5970,1177,3660,34416,2310
2220,258,6318,1452,4334,60157,1984
31393,36,852,1015,586,9742,266
11685,24,1418,1362,691,10822,727
42865,173,2022,788,1469,17959,553
12535,255,5296,1353,3583,35510,1713
1137,59,1546,1460,1152,22901,394
28973,33,515,1060,343,4817,172
50823,661,7531,654,5487,34865,2044
44952,2,70,763,52,10124,18
9242,80,7092,1379,4441,53271,2651
59711,16,125,381,91,4384,34
51902,91,1699,467,1328,13630,371
16511,186,5015,1296,3317,66027,1698
16437,56,733,1297,632,16695,101
65664,15,131,198,117,7416,14
13452,1,94,1340,66,4401,28
62116,15,123,297,95,11615,28
25495,1374,26506,1134,18505,91311,8001
51562,77,846,633,686,11483,160
62334,5,37,290,31,2298,6
8137,25,1049,1383,724,37163,325
5373,32,740,1417,491,15594,249
1686,45,2511,1456,1725,39932,786
48969,4,131,703,103,15814,28
64304,30,355,235,257,7987,98
60796,2641,48574,197,39930,199674,8644
42786,26,384,790,315,16795,69
12762,54,1897,1350,1128,21323,769
64270,16,268,236,204,7099,64
1108,345,14629,1461,8974,57078,5655
14154,15,543,1330,385,8989,158
50719,810,10679,657,8307,66534,2372
48480,1154,23212,719,16615,166567,6597
21118,164,2961,1214,2152,19601,809
54852,53,581,527,402,7079,179
46518,9547,265859,746,195792,559437,70067
12968,239,6635,1347,4109,103736,2526
20096,18,931,1232,690,10721,241
17569,73,2987,1277,2061,27406,926
32545,283,7413,996,4169,30356,3244
34782,59,2493,952,1598,37787,895
65781,17,198,195,150,4426,48
61694,80,893,312,632,9491,261
58446,10,250,423,177,5360,73
28950,2099,75974,1061,54328,438260,21646
51348,18,608,639,482,11512,126
37103,2,71,894,52,5867,19
54081,56,600,555,448,12216,152
48750,0,0,710,0,16852,0
4756,58,2509,1425,1819,45669,690
32146,29,598,1004,409,8835,189
25353,38,940,1137,669,27599,271
10058,0,0,1374,0,9041,0
61289,1070,15354,323,11260,44937,4094
62801,829,18450,277,14631,68931,3819
59085,386,8635,402,6654,47053,1981
27919,52,1741,1080,1145,30085,596
46454,79,572,747,433,8478,139
16902,39,504,1289,396,22951,108
5660,18,1108,1414,728,16538,380
15731,21,575,1308,395,10797,180
60580,60,893,350,683,10278,210
38656,16,322,852,248,9793,74
56279,3550,54211,486,43872,170517,10339
65747,9,110,196,87,3693,23
11967,57,1266,1359,534,16382,732
51101,45,715,646,566,7307,149
49439,4,42,689,32,2322,10
4066,57,3911,1434,2591,49557,1320
17803,15,275,1273,197,11109,78
577,93,4472,1465,3294,50528,1178
63007,44,584,273,456,7989,128
49591,58,1039,685,675,11453,364
31853,121,5001,1008,3418,37266,1583
51215,9,154,643,124,3657,30
30399,86,2379,1032,1526,28148,853
64147,101,1569,240,1188,30592,381
53682,5,66,568,56,3750,10
32082,9,210,1004,139,4439,71
514,476,11846,1465,8219,77382,3627
42093,745,20315,800,16291,149279,4024
4001,188,7442,1435,5143,142517,2299
25068,3379,84887,1142,59218,338023,25669
180,772,53522,1469,37386,299367,16136
49052,20,569,700,409,25142,160
14767,1755,63202,1322,41176,298863,22026
6333,1550,42613,1406,27338,95668,15275
35290,71,1054,940,801,14856,253
60890,15,130,338,105,5231,25
19372,1411,30125,1245,21044,313708,9081
58912,6,94,408,62,3308,32
7311,45,2201,1393,1334,23033,867
28176,664,20955,1076,14933,131444,6022
16237,745,39647,1300,25548,179496,14099
13427,184,5159,1340,2963,58068,2196
8551,46,1817,1382,1097,24731,720
15873,8,557,1306,226,10942,331
10871,56,1051,1368,655,9009,396
63998,39,448,245,369,8196,79
23387,296,7066,1178,4646,95978,2420
64032,43,1562,244,860,16563,702
19739,0,71,1239,50,8396,21
22842,208,4787,1187,3204,49242,1583
15209,828,20112,1316,13820,83970,6292
315,133,4390,1467,3316,43267,1074
24968,80,4139,1145,2482,21541,1657
1776,12,224,1456,156,8645,68
3782,151,7264,1437,4763,52389,2501
35842,885,14807,927,12059,167230,2748
57359,68,1052,457,836,23589,216
60281,20,383,360,287,3922,96
38534,1094,16041,854,12877,184879,3164
31765,33,1605,1009,1079,17646,526
55429,10,135,453,122,7104,13
1199,69,2063,1460,1470,24592,593
35380,40,585,937,419,8754,166
50515,22,406,661,263,4071,143
48992,148,2057,702,1475,13305,582
3227,1277,32569,1443,21257,211063,11312
33972,32,362,971,262,13911,100
38037,71,1118,868,842,22740,276
53557,488,5705,573,4578,51796,1127
981,3148,103747,1461,62749,594699,40998
7780,29,806,1387,533,7174,273
1918,18,575,1455,410,20684,165
29813,121,4661,1044,2826,58218,1835
26971,9,263,1101,154,8516,109
36015,20,724,923,502,10667,222
68487,10,145,109,121,5088,24
67208,110,2182,150,1783,17371,399
1504,41,967,1458,683,31053,284
22453,116,4800,1194,3034,38531,1766
5485,10221,332276,1416,201687,1281912,130589
16876,22,562,1290,380,12115,182
11478,347,9939,1364,6055,51850,3884
9177,2,82,1379,51,8262,31
68506,11,160,109,129,6719,31
48802,134,2000,708,1641,16615,359
5335,220,4628,1418,3127,45092,1501
5730,983,35969,1413,22799,117480,13170
4764,1409,56272,1425,34633,158439,21639
41902,503,5951,804,5046,51382,905
34197,1,140,966,92,2953,48
13236,1467,60843,1343,39729,343821,21114
64296,174,2447,235,1841,26777,606
24500,31,611,1155,427,15085,184
54880,20,146,526,133,11817,13
40697,38,1029,824,814,19100,215
50208,43,873,669,703,16394,170
34265,25,704,964,522,10572,182
14635,74,1495,1323,919,16354,576
9002,23,829,1380,553,16317,276
26297,28,468,1117,396,14691,72
3910,183,3815,1436,2741,103421,1074
11485,408,28312,1364,13836,150571,14476
58229,86,1736,430,1416,16255,320
21303,0,77,1211,58,6728,19
54742,10,98,531,72,2807,26
55165,3,64,518,57,6493,7
63233,1,125,267,111,5722,14
50665,2,92,658,70,3218,22
65463,12,131,203,110,3611,21
57079,31,326,464,256,3275,70
8886,81,2565,1380,1650,16842,915
2475,370,9960,1450,6410,101598,3550
39762,468,8319,838,7023,75263,1296
30060,59,2016,1039,1279,19055,737
2330,14,592,1451,413,12297,179
36367,63,488,912,370,5969,118
49013,66,1429,702,1219,17166,210
48935,10,284,704,224,4756,60
24474,2874,57081,1156,38011,382844,19070
68505,6,77,109,61,3247,16
8879,964,26894,1380,16675,116054,10219
23931,113,1705,1168,1258,36944,447
24252,10,389,1161,279,18202,110
63310,4,66,264,56,3044,10
60629,10,94,348,82,3151,12
40491,13020,248797,820,157298,857311,91499
63755,18,204,253,162,3482,42
16959,7,126,1288,97,13426,29
34009,11,410,969,240,12311,170
63145,20,273,269,214,5524,59
27695,25,998,1085,629,7618,369
61961,47,519,302,365,8577,154
18890,281,8388,1254,5710,36453,2678
10206,258,11974,1373,7272,55961,4702
60540,8,156,352,114,8284,42
21517,603,21057,1207,10918,89336,10139
34639,54,1251,956,888,22777,363
26492,15,557,1113,359,8601,198
10145,8,240,1374,169,43457,71
32004,95,4670,1006,2632,28263,2038
68470,11,331,110,253,5005,78
48271,486,7289,723,5958,46410,1331
32257,33,1010,1002,659,8391,351
152,498,5319,1469,3744,29478,1575
55760,84,836,502,721,8846,115
316,25,989,1467,772,25234,217
62188,545,13228,294,8576,30632,4652
58500,244,2677,421,2054,13607,623
55556,23,140,507,112,9269,28
10601,25,865,1371,496,9061,369
52285,10,175,611,115,13572,60
9224,295,4966,1379,3292,29634,1674
20159,330,10664,1231,7357,92445,3307
53129,282,3297,562,2527,58977,770
48518,167,1816,718,1424,16454,392
52132,4,36,616,30,6428,6
22132,1814,33264,1199,21463,105828,11801
58936,24,486,407,335,10658,151
35400,172,4102,936,2869,26314,1233
5298,21,531,1418,365,7927,166
51342,471,4124,600,3436,67826,688
68805,178,4028,98,3332,24792,696
26831,31,1484,1104,854,12631,630
10623,353,11515,1371,7662,60117,3853
11782,129,5298,1361,2976,35298,2322
17773,97,3493,1273,2432,29529,1061
60610,24,448,349,345,6955,103
25547,14,133,1133,111,16918,22
6177,1,68,1408,55,4470,13
48774,51,1269,709,835,25218,434
18731,173,4066,1257,2839,67709,1227
17040,972,22404,1287,15213,195929,7191
68285,17,364,117,260,3523,104
46156,2719,68334,750,49542,184468,18792
62442,25,459,287,369,4368,90
68282,25,346,117,280,6045,66
67683,53,667,136,489,6429,178
49694,96,1301,682,981,11099,320
14276,10,404,1328,317,9728,87
33991,33,1101,970,759,13858,342
27401,512,13295,1092,11078,96631,2217
12534,1351,42427,1353,25895,259641,16532
66688,131,2747,168,2219,22213,528
62098,99,1325,297,1108,19352,217
28340,5,351,1072,216,6073,135
16563,0,0,1295,0,12255,0
48837,4,359,706,248,4651,111
8890,117,3087,1380,1840,34174,1247
16414,339,13969,1297,8924,180095,5045
21363,4,266,1210,195,11631,71
66609,219,3708,170,3026,30916,682
9541,1411,31012,1377,20078,207794,10934
66877,33,507,162,413,14193,94
61162,15,115,328,91,4975,24
25133,11,198,1141,134,5307,64
1341,1,213,1459,110,4102,103
51986,0,14,622,13,3573,1
47160,51,698,737,633,12585,65
34256,91,2012,965,1264,9445,748
18485,47,1612,1261,1218,20296,394
18111,20,749,1267,596,12587,153
12643,354,8033,1351,4995,40846,3038
38713,44,573,851,397,18413,176
16364,114,2192,1298,1454,24280,738
35962,644,13394,924,11294,80943,2100
13177,13,755,1344,496,17425,259
35599,14,266,932,218,9319,48
14024,35,662,1332,427,10346,235
27904,115,3567,1081,2580,59409,987
42510,94,1018,795,867,46492,151
58911,22,293,408,214,5350,79
49556,8,64,686,53,5853,11
19375,285,5255,1245,3485,20072,1770
26636,140,5805,1108,3810,86248,1995
25770,4,262,1128,168,17862,94
12770,824,33967,1350,19114,109182,14853
27520,68,1693,1089,1110,17872,583
33395,7599,165520,981,118450,516252,47070
6878,20,581,1399,407,17907,174
59905,77,1483,374,1082,14727,401
11821,267,7034,1361,3666,28496,3368
10335,116,4682,1372,2815,32436,1867
36395,46,711,911,528,10874,183
64377,269,3464,233,2795,47037,669
66460,10,140,176,86,10082,54
13570,11,436,1338,265,20152,171
36900,28,390,900,286,12675,104
15071,18,950,1318,671,36513,279
18162,6,355,1267,196,6676,159
20108,31,339,1232,263,25640,76
51962,36,785,622,630,9708,155
12215,0,0,1357,0,7796,0
24374,29,956,1158,680,16070,276
24223,192,3723,1162,2757,58188,966
23246,1178,33248,1181,23598,233140,9650
33318,67,2203,983,1226,7648,977
49562,643,8336,686,6778,59234,1558
68196,533,5197,120,4019,21667,1178
11395,26,935,1364,633,15916,302
52923,56,864,589,644,13859,220
24805,5634,137458,1148,86444,238091,51014
19874,14,538,1236,362,13376,176
26513,34,626,1112,388,12230,238
27518,32,701,1089,560,24396,141
12675,17,710,1351,385,14091,325
3951,445,24235,1436,16206,134644,8029
12394,177,1697,1354,1069,25020,628
54428,14,172,543,131,3536,41
68850,39,629,96,480,5238,149
61776,965,19068,294,13609,106403,5459
10437,234,6431,1372,4172,60686,2259
19987,16,567,1234,431,49608,136
1382,3791,205254,1459,124165,363800,81089
37753,41,595,876,399,8558,196
20668,23,578,1223,418,9726,160
55897,823,10601,498,9016,59358,1585
63132,25,367,269,274,3916,93
50146,178,2990,668,2285,40522,705
50067,1013,13929,672,11091,136391,2838
63795,44,872,252,559,8360,313
50503,1,42,661,34,2664,8
15661,24,914,1309,580,20955,334
30208,51,3681,1036,1614,13822,2067
12830,8,507,1349,277,34012,230
21225,713,5329,1212,3638,33395,1691
65480,102,1485,202,1229,7213,256
13354,126,5427,1341,2847,58801,2580
15329,908,19671,1314,12397,143740,7274
64862,74,1448,218,904,12128,544
23543,60,1811,1176,1154,39032,657
8971,231,11294,1380,6977,66149,4317
25903,96,2587,1125,1640,11245,947
20819,59,1610,1220,1139,48891,471
30689,143,3190,1026,2719,27675,471
37954,31,1134,871,890,13037,244
64642,13,246,225,170,10907,76
58577,106,2108,418,1605,9601,503
58818,961,24146,411,17038,106845,7108
28722,7,554,1065,321,27198,233
45841,39,1327,754,989,17788,338
8752,70,2963,1381,1811,39066,1152
61472,3,23,318,20,3966,3
46933,32,340,740,240,8366,100
62018,7,75,300,60,3270,15
236,85,5037,1468,3752,55380,1285
23001,74,1289,1185,842,15234,447
35443,470,9955,936,7581,117522,2374
60468,21,287,352,247,10664,40
19719,37,1625,1239,1212,38873,413
55276,1211,10514,515,9284,93073,1230
66748,57,588,166,463,6411,125
42358,48,974,797,737,7558,237
24806,239,8057,1148,6186,62973,1871
28540,108,2964,1069,2182,24353,782
60867,27,287,339,217,6545,70
63820,72,861,251,697,8176,164
19193,964,32351,1248,22432,249607,9919
11053,11,378,1367,240,10909,138
35493,9,170,935,142,2907,28
51547,22,123,634,100,6459,23
52174,24,244,615,212,6584,32
19679,11,611,1240,449,8687,162
8701,1,33,1381,23,4103,10
17601,114,1653,1277,1388,13308,265
45954,14,351,752,293,13048,58
17057,303,5312,1287,3663,20381,1649
49673,601,9137,683,7960,69974,1177
22127,99,2916,1199,1989,20178,927
3129,46,3268,1444,2217,56967,1051
65067,8,96,211,80,5294,16
7127,5818,630655,1395,318277,1361922,312378
19631,160,1662,1241,1116,22138,546
17410,49,474,1281,331,9040,143
61039,53,526,333,436,9715,90
19526,48,1063,1242,763,7492,300
16895,40,1820,1289,1300,35577,520
15790,63,1877,1308,1326,52198,551
5738,21,504,1413,348,23673,156
58215,32,478,431,413,10509,65
34849,58,1440,951,952,16783,488
40310,119,1845,830,1421,29967,424
522,4042,154616,1465,91860,397055,62756
9560,209,6419,1377,4226,34874,2193
23809,8,185,1170,135,10173,50
31834,10,218,1008,161,5729,57
25890,58,710,1125,516,14112,194
49860,504,6101,678,4733,39522,1368
40302,775,13181,830,10476,45644,2705
47260,32,659,735,579,18668,80
29359,45,905,1053,610,11469,295
712,499,13283,1464,9127,108568,4156
18262,5,226,1265,181,10912,45
33549,73,2542,978,1484,20739,1058
27444,23,1425,1091,874,20335,551
57839,320,4564,443,3702,32512,862
35973,17,472,924,353,5521,119
18431,54,1463,1262,1003,24837,460
28415,52,1126,1071,760,10071,366
33134,195,9461,986,6439,70535,3022
36809,101,1826,903,1410,13428,416
5910,1597,31422,1411,18584,181397,12838
66183,13,150,183,115,3746,35
6510,0,74,1403,44,7607,30
11814,62,1517,1361,790,14756,727
13667,3721,125007,1337,72892,698948,52115
3022,50,3697,1445,2334,19356,1363
68591,1,86,105,18,1594,68
67454,16,112,143,90,3825,22
22785,0,0,1188,0,14787,0
26100,7,96,1120,79,8453,17
20963,28,500,1217,360,9884,140
25024,580,15099,1143,9588,109278,5511
17401,1426,44272,1281,30558,203304,13714
3010,144,3688,1445,2451,35285,1237
60079,3,82,369,59,4407,23
9681,119,5447,1377,3152,44316,2295
59660,116,1451,383,1113,13596,338
64007,15,136,245,109,4509,27
11153,8,264,1366,140,14708,124
28820,33,524,1064,471,23203,53
11737,14,927,1361,467,19229,460
41995,21,292,802,241,7152,51
698,5,212,1464,165,9569,47
31406,8,405,1015,257,7438,148
2436,24,836,1450,629,19884,207
16112,280,7183,1302,5123,68461,2060
27570,92,2926,1087,1842,41037,1084
32960,43,1024,989,608,11304,416
65859,18,678,193,523,10241,155
21682,45,983,1205,695,41268,288
25740,414,9381,1128,6131,34056,3250
5784,10,306,1413,188,6049,118
21372,72,1441,1210,1134,19410,307
53882,81,1276,562,880,22677,396
43737,46,887,777,723,23212,164
18060,5,412,1268,259,13559,153
33290,47,1481,983,860,15701,621
39235,6,152,844,116,4930,36
36177,4690,117439,918,74727,379114,42712
35036,94,1879,946,1219,21794,660
9226,4,251,1379,155,11146,96
34301,15,437,964,312,6261,125
28858,246,7620,1063,4713,62243,2907
8094,239,18036,1383,12144,127364,5892
52404,51,431,607,299,3980,132
23804,38,517,1170,358,15362,159
66631,48,546,170,476,9437,70
2853,16,1254,1447,921,52852,333
24994,162,2460,1144,1554,18421,906
55308,117,2155,513,1836,27148,319
11332,39,835,1365,543,10664,292
4064,169,4041,1434,2860,33191,1181
47963,0,0,728,0,2361,0
33635,231,7110,977,5159,68932,1951
25154,731,9074,1141,5597,42572,3477
60641,25,244,347,188,5920,56
29866,135,5340,1043,2698,29759,2642
24017,4,72,1166,59,12990,13
54091,167,1740,554,1438,31547,302
10788,0,372,1369,245,13104,127
68234,52,627,119,525,6339,102
54885,3,56,526,44,5148,12
22193,11,267,1198,132,7055,135
37729,155,2195,876,1746,19354,449
30475,26,1062,1030,686,10361,376
56700,118,1136,474,960,15951,176
14806,37,932,1321,600,18251,332
44871,3,46,765,37,2153,9
21058,33,756,1215,616,12780,140
26901,67,1626,1103,1024,10002,602
62999,12,206,273,163,3515,43
2675,133,5500,1448,3656,45021,1844
29553,8,292,1050,201,6249,91
65497,55,639,202,542,7054,97
12664,7,287,1351,159,7748,128
66060,20,362,187,299,11731,63
65047,39,502,212,405,4967,97
1243,126,3994,1460,2458,35509,1536
58070,40,335,436,247,5860,88
38384,1879,29085,859,22070,295048,7015
352,7,180,1467,128,11805,52
49191,47,762,696,669,22524,93
14584,0,1442,1324,981,28405,461
11181,3,265,1366,151,39410,114
31972,149,2990,1006,2113,21199,877
31975,57,909,1006,572,12273,337
34977,94,4062,947,2580,30200,1482
52349,133,2495,602,1961,23468,534
41910,13,307,804,216,7984,91
17872,22,632,1271,475,11979,157
28046,53,1236,1078,769,6242,467
67821,2,15,131,14,1398,1
38142,14,179,865,137,5501,42
7688,9,471,1388,311,15431,160
1087,120,4112,1461,2860,68904,1252
21187,7,496,1213,355,19304,141
62494,43,749,286,560,9578,189
19514,1072,40910,1243,28218,252924,12692
20749,72,2787,1221,1961,16194,826
9135,16,300,1379,205,6805,95
40388,16,330,828,236,6611,94
21383,21,1533,1209,1022,14838,511
4909,4,220,1423,149,26688,71
31645,30,436,1011,296,6472,140
63407,152,2799,262,2361,16541,438
50798,493,9989,655,7520,76648,2469
10849,101,7911,1369,4544,41003,3367
61206,482,9643,326,6284,100401,3359
29574,17,773,1049,509,14627,264
67090,596,12071,155,10007,64256,2064
32131,77,1904,1004,1417,31487,487
30642,4993,141380,1028,82652,851227,58728
23497,0,0,1176,0,22585,0
49937,68,1192,676,956,40557,236
22641,29,502,1191,322,11158,180
8594,176,5487,1381,3979,29836,1508
8040,6,142,1384,98,5168,44
65262,7,44,208,33,1846,11
6120,22,693,1408,475,16947,218
23331,14,458,1179,324,12070,134
39738,221,3945,838,3102,33683,843
54299,53,724,548,609,15720,115
31884,261,8421,1007,5068,22888,3353
62616,6,88,282,63,3168,25
23703,50,986,1172,757,35147,229
15621,83,2007,1310,1378,27819,629
61940,516,13522,303,9966,100500,3556
22883,5,179,1187,157,12730,22
29984,16,607,1041,463,4579,144
8075,2508,82749,1384,50569,238845,32180
34398,18,384,961,255,8383,129
10285,129,5702,1373,3556,35371,2146
9078,265,6089,1379,3910,38585,2179
34517,58,981,959,643,16733,338
64777,50,893,221,721,13098,172
61304,10,140,323,107,4445,33
49494,67,565,687,421,12049,144
41585,170,1502,809,1153,22577,349
43179,136,2154,783,1651,32115,503
24707,112,4916,1150,2999,23805,1917
23060,35,437,1183,360,17146,77
30089,156,4578,1038,2983,55469,1595
750,60,2665,1463,1936,30849,729
18545,135,3746,1260,2619,43667,1127
31632,195,4008,1011,2848,34043,1160
10919,76,3466,1368,1799,19924,1667
54769,112,997,530,802,13878,195
11554,574,50809,1363,25148,151733,25661
51736,55,611,629,479,9414,132
30240,37,1194,1035,872,13416,322
33247,473,12444,984,9233,92745,3211
38643,19,111,852,94,6193,17
25472,16,484,1135,350,7935,134
30966,38,654,1021,469,16279,185
34624,130,3397,956,2460,30164,937
14834,12,1080,1321,708,15313,372
67809,6,177,131,115,9250,62
54099,56,246,554,209,5954,37
21875,82,5041,1202,2493,30856,2548
34960,7131,161356,925,122324,619235,39032
8500,23,888,1382,539,9968,349
26829,19,544,1104,336,13763,208
18807,16,228,1255,178,20800,50
61968,1032,26117,302,22404,177689,3713
50559,11,311,658,207,3161,104
21607,148,4492,1206,3089,19554,1403
12825,2,123,1349,72,10006,51
45003,6,178,763,127,9062,51
53219,5,84,580,63,4108,21
24627,2211,55043,1152,35243,226899,19800
5530,21,463,1415,357,7295,106
11937,14,466,1359,228,24696,238
10214,687,43621,1373,27441,231514,16180
25539,258,5587,1133,3964,26252,1623
62186,143,3071,229,2461,17276,610
46819,0,114,742,77,5026,37
15053,8,533,1318,361,55650,172
44078,400,6045,773,5121,63370,924
22106,105,4614,1199,2623,27325,1991
13864,237,7993,1334,5577,46217,2416
1107,81,3246,1461,2022,17201,1224
65932,12,215,191,181,5297,34
50534,97,1261,660,962,21270,299
48595,180,3793,714,3032,75101,761
10147,530,22999,1374,14007,81243,8992
63497,10,194,260,131,6260,63
21019,9,490,1216,402,18925,88
61843,59,610,307,440,12220,170
17567,139,2495,1277,1724,27326,771
59186,24,443,399,347,9636,96
35784,38,504,929,346,5755,158
24168,34151,1008917,1163,664121,2185162,344796
19834,290,4668,1237,2877,56980,1791
58091,1729,28736,435,22126,100278,6610
15911,269,7600,1305,5227,89976,2373
37836,0,23,874,21,7382,2
16230,0,227,1300,142,4302,85
63858,20,425,250,352,5796,73
33916,1910,24173,972,15095,62003,9078
61078,29,643,331,557,6562,86
56378,89,1005,484,869,7556,136
56133,30,272,491,220,9293,52
18328,6,351,1264,252,9991,99
62513,117,2241,285,1512,20378,729
35807,32,631,928,540,21263,91
31369,75,1761,1015,1117,54449,644
10045,286,5032,1374,3151,34444,1881
41090,32,638,817,523,14336,115
50695,2,32,657,28,3875,4
30972,48,898,1021,634,20374,264
57233,53,595,460,475,7581,120
14280,39,1301,1328,842,24696,459
19227,7,515,1248,343,12637,172
50556,81,804,660,678,16968,126
54824,6,87,528,67,3332,20
56970,224,4743,467,3535,64754,1208
61909,18,250,304,186,5585,64
654,164,8318,1464,5302,69552,3016
49616,339,4737,681,3255,49435,1482
7872,5,376,1385,214,14134,162
66993,15,181,158,158,5356,23
56103,25,159,492,118,3586,41
47101,98,1260,738,1033,12510,227
14026,639,9999,1332,6155,105303,3844
16603,407,10446,1295,6700,33401,3746
4501,10,171,1429,123,11757,48
14155,6,512,1330,320,9726,192
15062,10,820,1318,559,24070,261
28734,4,474,1065,262,10868,212
25660,11,469,1130,268,8310,201
24047,80,3295,1165,2272,35378,1023
61805,5,158,308,127,3356,31
29352,16,539,1053,373,13650,166
68125,1236,24479,122,19626,81725,4853
40969,103,1720,819,1458,29366,262
56242,11,143,488,78,3990,65
64103,20,478,241,362,6857,116
10818,9,542,1369,356,27232,186
3655,88,3982,1439,2875,54092,1107
9488,133,3288,1378,2030,32864,1258
22601,200,3701,1192,2697,18688,1004
21251,14,628,1212,404,4524,224
64228,33,292,237,257,5823,35
31592,120,3345,1012,2427,27928,918
61648,131,1725,313,1371,22235,354
10179,355,8797,1373,6232,72285,2565
12932,90,1818,1347,936,18785,882
67239,127,1662,149,1395,8477,267
63937,10,71,247,50,5436,21
21785,276,6690,1203,4962,55292,1728
28438,1102,21553,1071,14649,107549,6904
16985,413,5688,1288,4879,33325,809
27766,21,461,1084,315,5879,146
25152,8,369,1141,230,9636,139
1029,5,257,1461,196,13053,61
3603,5,262,1440,175,22120,87
20821,67,972,1220,622,12718,350
23415,135,3209,1177,2236,27396,973
15405,4,171,1313,129,5673,42
44333,1347,21100,770,16714,86171,4386
26660,1598,25286,1107,16927,147413,8359
17753,129,7814,1274,5628,32376,2186
52749,30,526,595,322,10171,204
23276,13,205,1180,177,21355,28
34251,554,9232,965,6879,61038,2353
65611,8,258,199,197,4476,61
5818,13,167,1412,115,4581,52
35310,11,431,939,209,6529,222
16026,23,1176,1303,794,19324,382
51915,212,1683,624,1383,20384,300
19022,390,13569,1251,8831,119148,4738
10454,48,2814,1372,1763,19932,1051
11254,76,3598,1366,1738,55520,1860
53446,0,598,575,289,3857,309
59128,241,2735,401,2217,15059,518
53911,68,769,561,583,6615,186
8335,86,2345,1383,1572,27980,773
22375,14,381,1195,290,16290,91
35227,391,6810,941,5138,86073,1672
19059,73,1582,1251,1157,21305,425
10803,13,659,1369,348,4743,311
59553,199,3100,387,2329,12513,771
48962,14,185,703,152,3484,33
64560,47,671,228,559,9127,112
15719,490,8695,1309,5967,80371,2728
25786,157,1663,1128,1130,9972,533
22877,68,1150,1187,703,6184,447
36870,58,1768,901,1354,50233,414
63153,50,475,269,377,10453,98
28747,7,380,1065,309,5589,71
6152,268,3912,1408,2961,27836,951
24977,748,14636,1144,9811,81779,4825
30658,187,7480,1027,4609,22479,2871
13230,3360,89353,1343,59351,586034,30002
63918,390,5706,247,4932,44804,774
29225,166,3755,1055,2844,22434,911
64427,42,665,231,510,6662,155
15171,1,138,1317,105,5222,33
63770,15,270,252,196,3976,74
64284,44,274,235,227,5943,47
62587,21,249,283,185,13790,64
2185,53,2984,1452,1901,27841,1083
36342,19,447,913,366,9388,81
21959,93,1722,1201,1187,18443,535
15654,20,459,1309,285,9206,174
12251,95,3337,1356,2009,41176,1328
16346,22,705,1298,464,30803,241
65542,15,124,201,76,2978,48
12519,17,1117,1353,554,17409,563
32683,72,2127,995,1490,45826,637
31404,40,788,1015,530,21919,258
15746,7,618,1308,468,11627,150
21927,10,805,1201,498,14811,307
58514,43,445,421,334,7093,111
35635,148,2287,932,1733,37582,554
25306,62,2761,1138,1666,17191,1095
37,30,1612,1472,1140,26131,472
15184,4,1050,1316,692,11601,358
34498,7,132,959,86,3422,46
6859,109,5231,1399,2708,30956,2523
51692,188,1824,630,1422,7596,402
3850,0,55,1437,39,7813,16
1714,7,278,1456,188,17683,90
68089,31,270,123,217,4357,53
62831,27,341,277,282,4815,59
350,53,2004,1467,1485,33413,519
59254,1875,25019,397,20450,136540,4569
15715,27,1046,1309,791,32749,255
2018,147,3776,1454,2502,26214,1274
23005,0,24,1184,19,3609,5
53759,28,378,469,316,15859,62
39346,6,111,843,88,3881,23
6350,31,785,1406,550,18838,235
35804,587,10651,928,7480,42237,3171
68938,17,196,93,178,6059,18
34770,836,19704,952,13872,90951,5832
10169,45,1491,1373,1003,7788,488
67810,11,120,131,111,3611,9
59869,429,9274,376,7723,51017,1551
16311,1983,42153,1299,26195,255350,15958
67359,672,11656,145,8445,70820,3211
6078,69,2902,1409,1979,26372,923
14730,1451,45051,1322,32863,306188,12188
35250,42,534,941,393,17842,141
36413,633,13342,911,10518,79872,2824
56102,68,798,492,630,16436,168
35108,77,1976,944,1642,17333,334
25176,388,7137,1141,6098,71160,1039
8485,435,5764,1382,3888,33174,1876
1251,40,1521,1460,1011,12606,510
34455,199,4576,960,3127,22074,1449
55666,23,557,504,411,12039,146
12103,52,1118,1358,644,14863,474
30348,431,6425,1033,4431,41009,1994
20371,232,5667,1228,3966,69437,1701
12107,1,346,1358,176,16135,170
30258,160,3122,1035,2085,29001,1037
52049,554,6966,619,4903,81302,2063
22008,13,825,1200,603,27121,222
37063,397,4320,895,3302,39784,1018
8284,44,962,1383,642,5248,320
63917,14,179,247,135,8380,44
515,2145,54042,1465,33780,217990,20262
34705,48,1469,954,984,10571,485
18577,11,272,1259,235,27065,37
31867,7,247,1008,162,13118,85
1354,65,2834,1459,1846,23219,988
36057,272,8609,921,6215,64863,2394
6200,40,1347,1408,1072,22174,275
32360,61,3362,1000,1926,20928,1436
15842,814,27363,1307,18477,119378,8886
52691,111,1402,596,1155,40836,247
19366,46,1112,1245,884,37686,228
10317,20,388,1373,237,8358,151
56015,33,484,494,392,7111,92
28657,3,47,1066,36,4415,11
62104,33,472,297,368,12337,104
22733,658,22898,1189,13952,98638,8946
63250,55,1338,266,1066,23030,272
31933,26,647,1007,415,6663,232
49079,14,177,700,134,6774,43
18219,87,3003,1265,2243,87280,760
61182,4,48,327,35,3913,13
30713,350,8531,1026,5836,54724,2695
32043,32,849,1005,607,5876,242
57041,28,232,465,145,6358,87
31172,30,782,1018,513,7383,269
18053,15,740,1268,533,8273,207
38731,502,6403,851,4918,43293,1485
55137,33,608,519,466,6010,142
6108,2,90,1409,67,6357,23
56370,6,92,484,76,5801,16
22824,2,52,1188,45,3995,7
2561,38,1246,1449,872,33199,374
14891,0,0,1321,0,37543,0
68239,48,1075,118,689,21955,386
16481,2306,84387,1296,54040,401774,30347
4799,165,4361,1425,3087,21462,1274
12007,28,1466,1359,768,26416,698
52914,79,889,589,743,17259,146
40678,431,7078,825,5654,39595,1424
34762,8,316,952,178,6617,138
37658,287,4972,878,3322,41299,1650
15162,26,1603,1317,1017,48703,586
68157,9,143,121,129,3210,14
26712,130,4757,1107,3156,38395,1601
30732,10,372,1026,214,5484,158
27333,29,1058,1093,629,7623,429
39840,7,269,837,167,10618,102
32774,0,69,993,43,3695,26
3862,11,655,1436,460,10610,195
12817,111,2612,1349,1424,22904,1188
10937,560,51115,1368,24376,156090,26739
13008,89,2116,1346,1335,18314,781
36203,44,1124,917,937,42516,187
229,45,3078,1468,1997,33903,1081
45982,4,45,752,31,9476,14
19235,2,164,1248,118,23725,46
47082,72,1458,739,1091,14778,367
30709,59,1805,1026,1146,20696,659
3126,135,4787,1444,3124,27061,1663
51126,138,2562,645,1926,26515,636
7794,56,2726,1387,1883,60764,843
10409,216,11337,1372,6864,99887,4473
65124,22,231,210,206,5268,25
42486,41,779,795,629,19913,150
57137,7,87,463,56,2631,31
51288,57,735,641,527,18631,208
58239,163,1676,430,1376,13091,300
7147,63,1098,1395,749,15565,349
35844,7,138,927,98,4633,40
59861,28,397,376,337,8830,60
35690,25,372,931,313,11926,59
6462,188,7723,1404,5624,51249,2099
50702,30,1218,657,931,8811,287
11619,5,424,1362,194,6894,230
64410,2,152,232,91,5072,61
36410,293,5397,911,4244,41079,1153
67169,4,114,152,91,3249,23
65654,1,29,198,20,2881,9
6735,40,1771,1401,1157,33521,614
6282,5,315,1407,198,22514,117
34185,54,1482,966,1030,26082,452
26510,289,6537,1112,4760,65674,1777
11678,234,11042,1362,6186,74026,4856
1409,3629,126976,1458,78057,266847,48919
3077,42,1866,1445,1300,18226,566
16918,27,1000,1289,702,37683,298
49693,780,8046,682,6244,33395,1802
9430,39,1163,1378,644,15971,519
56771,14,172,472,116,5908,56
31882,861,22891,1007,15554,106723,7337
34752,120,1754,953,1352,8354,402
10683,70,2208,1370,1394,21849,814
26697,9,247,1107,159,5339,88
37371,34,404,886,300,10175,104
11553,15,544,1363,285,10130,259
15438,3750,133584,1313,83875,578376,49709
10050,2501,57687,1374,35491,121524,22196
12271,31,1235,1356,679,14454,556
2744,247,11428,1448,7537,35307,3891
26782,92,3420,1105,2292,85849,1128
1474,25,1031,1458,731,34579,300
32016,302,6546,1005,4658,86470,1888
52366,22,352,609,263,5124,89
7552,708,47236,1390,29505,184319,17731
39653,9,385,839,298,8833,87
59713,14,125,381,90,4338,35
58030,21,401,437,312,12000,89
52010,22,565,621,435,13306,130
29318,45,684,1054,509,20593,175
26383,115,1689,1114,1152,14910,537
13166,2093,88140,1344,57511,286281,30629
64359,1,13,233,10,4091,3
11774,147,4432,1361,2109,15935,2323
65049,2,36,212,24,4071,12
42372,86,1705,797,1395,23873,310
6970,9,343,1398,244,8245,99
16480,62,3198,1296,1865,43723,1333
66833,0,9,163,3,1596,6
11538,32,1055,1363,680,13649,375
31816,93,3177,1008,1979,22173,1198
60103,18,147,368,112,5212,35
55462,887,7296,510,6584,47205,712
15284,15,1210,1315,772,13018,438
58717,269,6168,414,4568,54427,1600
14493,20,1641,1325,1001,7734,640
2015,40,1294,1454,1099,15864,195
49958,83,1211,675,987,24368,224
7034,1441,47541,1397,29163,129472,18378
4838,22,1076,1424,771,9369,305
34236,17,376,965,293,6675,83
13567,275,11910,1338,7866,99028,4044
54213,26,168,550,131,15246,37
20626,8,225,1223,170,10480,55
18896,114,2647,1254,1744,23156,903
28104,88,3105,1077,1589,17603,1516
46683,67,1016,743,712,20246,304
26591,0,0,1110,0,9936,0
38045,23,467,868,344,8743,123
9065,78,2611,1379,1918,42901,693
41574,6,122,810,90,4307,32
45782,1327,19312,755,14564,75121,4748
60409,7,351,356,124,4059,227
55822,41,595,90,455,6265,140
46914,0,0,741,0,4094,0
66731,53,687,166,573,8387,114
14055,280,20142,1331,13678,134998,6464
810,2753,89200,1463,57953,225181,31247
50699,8,57,657,36,3381,21
57480,75,1020,454,758,8013,262
21764,48,1788,1204,1141,31278,647
36419,20,530,911,424,18239,106
2397,309,17733,1451,11251,75980,6482
25946,827,17725,1124,10284,133989,7441
26749,35,687,1106,538,30307,149
57371,4449,73997,457,58026,321135,15971
45509,1786,24777,757,19764,208758,5013
52955,30,714,588,543,5231,171
20450,3,104,1226,67,4208,37
16557,6,341,1295,222,13827,119
41597,41,610,806,464,17780,146
33340,52,848,982,538,8277,310
1842,124,3789,1455,2709,50512,1080
28035,9,129,1078,94,2743,35
3490,165,2628,1441,1854,19314,774
50855,2749,52265,653,42492,255601,9773
13753,76,3024,1336,1780,22283,1244
18139,118,6803,1267,4823,91318,1980
29747,35,1074,1046,602,11085,472
20729,673,11681,1222,8239,100486,3442
66279,23,207,181,151,5684,56
55249,2,27,516,22,2439,5
39368,57,807,843,662,10266,145
849,2454,150822,1463,98123,367571,52699
37293,148,10196,888,6548,43714,3648
40476,20,715,827,578,10210,137
40024,47,933,834,703,14449,230
68801,1,42,98,17,1973,25
40670,177,3294,825,2531,19034,763
35362,1036,13800,938,9238,53800,4562
67389,5,21,145,13,16803,8
52006,332,4623,621,3786,26814,837
13789,73,2396,1335,1384,23869,1012
62751,29,376,278,251,9961,125
10157,22,1003,1374,666,14540,337
26443,203,5238,1113,3686,93993,1552
45208,45,906,761,654,16034,252
27851,13,393,1082,217,11045,176
31737,3106,71053,1009,41172,213521,29881
66835,5,33,163,26,2562,7
47837,5,126,729,85,2463,41
13842,70,2137,1335,1299,39163,838
28557,91,2708,1068,1664,27281,1044
56965,139,2422,467,2008,12788,414
47300,109,2407,736,1756,26557,651
32219,73,2340,1002,1429,17468,911
14099,7,475,1331,306,7941,169
58113,8,218,435,157,8376,61
69002,53,456,91,406,6133,50
40100,3,141,833,94,4773,47
54672,2613,27925,533,22671,184031,5254
58016,251,15074,438,11092,74820,3982
22118,41,1899,1199,1321,60672,578
31599,23,290,1012,219,4633,71
15470,14,505,1312,383,10962,122
10257,9,236,1373,150,7287,86
7101,7,322,1396,195,11722,127
57476,10,100,455,74,3797,26
33371,46,629,982,419,8036,210
62403,4,53,288,34,4971,19
16742,10,136,1292,102,7497,34
46729,97,2754,743,2185,28759,569
5946,101,4326,1411,2995,60311,1331
8596,49,1386,1381,847,31974,539
8372,25,1362,1382,892,17353,470
12485,25,1924,1353,1128,19943,796
38914,53,821,848,643,7035,178
54767,143,1894,530,1552,22324,342
63627,27,358,256,278,7025,80
39349,290,5464,843,4441,35767,1023
18195,6,363,1266,212,9725,151
39562,21,544,840,408,10305,136
10390,133,5972,1372,3971,32331,2001
53715,189,1890,567,1354,12452,536
2935,254,14145,1446,9151,92207,4994
47640,5,93,731,70,9432,23
58907,107,1723,408,1277,14831,446
65282,112,3124,207,2470,23165,654
34350,5,83,963,69,15547,14
38776,145,2523,850,1835,62689,688
40372,312,4190,829,3486,41965,704
62987,55,411,273,356,8574,55
10778,443,12429,1369,7456,100655,4973
15965,2,78,1304,53,16139,25
47323,65,1834,735,1341,24247,493
17121,48,1463,1286,1050,19468,413
37356,28,364,886,288,7175,76
11468,29,928,1364,432,7534,496
30647,275,6252,1027,4217,73249,2035
19754,15,389,1238,239,11071,150
65825,4,69,194,49,5831,20
30549,16,818,1029,476,21932,342
28907,175,2295,1062,1548,13818,747
56780,15,303,472,248,4449,55
52737,62,1117,595,881,14013,236
1410,22,778,1458,521,21962,257
58003,39,321,438,258,5977,63
40736,166,3632,823,2829,13089,803
63847,153,1913,250,1556,11303,357
25713,1972,66102,1129,45390,235606,20712
8334,44,999,1383,730,35053,269
63426,44,811,262,751,13532,60
16908,32,1413,1289,1068,45068,345
67247,736,9953,148,7662,51535,2291
15336,31,872,1314,596,24434,276
15864,74,2482,1306,1594,36381,888
23909,74,1746,1169,1230,35746,516
18707,51,1210,1257,829,17468,381
42506,728,8089,795,6217,84545,1872
65401,68,1134,204,951,16832,183
29987,21,512,1041,338,13324,174
36757,20,332,904,281,11043,51
9513,457,15351,1377,8997,48956,6354
57808,82,1269,444,1086,18244,183
42460,4,144,795,95,3597,49
18920,79,2412,1253,1730,15208,682
25061,89,3138,1142,1969,18722,1169
14839,9,406,1321,307,13093,99
59477,1730,41830,389,32251,156137,9579
33960,5,64,971,41,4473,23
55798,767,6827,501,6298,46828,529
14838,9,395,1321,256,8368,139
64737,35,353,223,295,8715,58
19610,41,711,1241,525,12297,186
35589,15,238,932,172,2749,66
19798,16,413,1238,306,9191,107
34296,17,302,964,185,4212,117
16583,23,585,1295,439,33559,146
5264,91,2844,1418,1896,24433,948
4851,15,986,1424,680,28077,306
37774,5726,135754,865,102177,398422,33577
14184,0,0,1330,0,12723,0
29490,274,4246,1051,3394,23691,852
67770,45,1386,133,1150,15977,236
47114,53,1489,738,1023,18869,466
65073,9,52,211,38,5976,14
65225,7,97,208,72,4774,25
1136,59,4740,1460,3124,42205,1616
23048,52,1943,1184,1474,26573,469
21834,408,4735,1203,2652,20871,2083
69052,7,69,90,63,1649,6
58592,104,827,418,664,10650,163
48736,5,110,711,95,5029,15
2106,3,198,1453,141,15197,57
45672,130,2202,756,1679,18564,523
51158,22,426,644,323,30104,103
21816,19,774,1203,451,15570,323
27878,247,4956,1081,3186,33596,1770
9851,228,5479,1376,3411,24462,2068
25592,31,1216,1132,749,16205,467
20417,316,11757,1227,7565,94955,4192
14492,96,3067,1325,1817,70902,1250
37460,9116,127936,883,104801,567733,23135
64976,539,5369,214,4480,37872,889
53418,6,86,575,68,4452,18
32322,14,495,1001,323,12869,172
25715,13,188,1129,170,6351,18
14009,381,15467,1332,10672,89243,4795
31129,23,278,1019,168,6296,110
2989,6,136,1445,105,16088,31
3073,20,958,1445,673,19814,285
20308,132,1825,1229,1097,11775,728
51596,4123,51659,632,37616,388710,14043
108,8,442,1470,276,15403,166
28579,104,4941,1068,3152,43513,1789
4091,79,1924,1434,1328,22797,596
45721,139,1451,755,1111,16947,340
225,3322,158166,1468,92837,386380,65329
13576,158,7673,1338,3939,22578,3734
41975,37,602,803,517,14535,85
19986,12,607,1234,420,5869,187
24128,35,1256,1164,858,29168,398
65213,73,1766,208,1628,16239,138
12113,27,1162,1358,635,10583,527
23052,372,8177,1184,5665,61346,2512
49132,12,152,698,122,2937,30
2844,80,3451,1447,2285,24175,1166
31125,5,42,1019,25,1254,17
31176,5,238,1018,137,5566,101
27310,77,1664,1094,1047,16436,617
4334,121,4139,1431,2659,22446,1480
2860,76,2819,1447,1864,39897,955
29538,27,1035,1050,667,12309,368
54274,4646,49740,548,35201,178923,14539
2997,24,919,1445,613,19310,306
62835,245,3482,276,2837,20281,645
59057,151,1793,404,1404,7922,389
5542,30,1894,1415,1376,18993,518
47609,31,247,732,209,8278,38
52131,35,325,616,226,3150,99
14035,292,9082,1332,5856,91636,3226
29800,282,6860,1044,5419,67711,1441
29418,402,6255,1052,3727,26419,2528
62174,11,244,295,192,6157,52
30093,521,11957,1038,7984,63661,3973
21961,172,4015,1201,2453,78448,1562
19900,35,966,1236,533,9287,433
14981,799,42115,1319,23038,230835,19077
53727,41,408,567,291,23221,117
30497,26,646,1030,450,4715,196
33519,74,1703,979,1062,13841,641
5026,18,834,1421,565,20878,269
60364,50,427,358,337,5077,90
27055,113,2522,1099,1632,20023,890
65599,51,403,200,339,4911,64
50383,20,215,665,178,5290,37
28798,18,423,1064,261,15173,162
51058,5,121,647,89,9113,32
52088,19,326,618,245,13793,81
6125,7,459,1408,288,22122,171
9090,1440,42207,1379,25834,227075,16373
66157,1,23,184,14,1606,9
37240,45,1250,851,952,24043,298
17786,3,244,1273,177,8128,67
11353,613,14692,1365,8657,59441,6035
28670,181,5220,1066,3334,44810,1886
30825,5,255,1024,138,4640,117
40117,154,2287,832,1825,21057,462
33629,108,1915,977,1390,17067,525
10609,68,3899,1371,2281,47896,1618
29171,372,10873,1056,7794,99964,3079
66703,29,325,168,263,2226,62
66466,4,124,175,93,4236,31
62070,15,288,298,237,5744,51
61886,275,6012,305,4733,40231,1279
14508,1,74,1325,49,4231,25
65337,129,1666,206,1314,21919,352
59596,123,1123,385,869,13913,254
22395,30,1520,1195,1041,17910,479
68770,47,757,99,685,15795,72
7337,299,23299,1393,13978,76159,9321
27487,72,2206,1090,1521,20900,685
24335,489,9948,1159,7055,93369,2893
66200,90,2231,182,1715,16101,516
8356,1383,47372,1383,31757,188502,15615
37138,99,2010,892,1622,30187,388
38556,5,58,855,57,5271,1
11208,74,3110,1366,1943,23493,1167
43204,107,1859,783,1525,30748,334
51635,233,2761,631,2307,21372,454
60587,18,251,350,194,3975,57
61166,9,65,328,50,4646,15
31945,74,2234,1007,1405,23968,829
66577,15,186,171,152,5641,34
5715,5,143,1413,93,16462,50
50236,12,170,668,130,2523,40
45585,280,3582,757,2634,40130,948
38249,19,264,863,216,4501,48
68537,28,609,107,510,7328,99
53190,6,54,581,39,4150,15
8225,320,9296,1383,6010,71703,3286
106,1151,132178,1470,80171,586334,52007
271,157,13870,1468,9223,59446,4647
55182,243,3767,518,3039,46636,728
67906,19,207,129,173,2990,34
50113,102,2194,671,1554,12334,640
26110,67,1462,1120,938,20314,524
31887,26,1740,1007,1154,7885,586
48153,34,545,725,394,15870,151
26314,2,100,1116,62,7697,38
63468,50,696,260,558,9309,138
29090,62,2244,1058,1516,38566,728
260,47,1247,1468,922,28332,325
4487,20,600,1429,402,20020,198
5083,39,841,1421,595,14646,246
31538,183,4835,1013,4157,79236,678
14892,29,1156,1320,814,17414,342
27100,18,857,1098,537,16912,320
20907,18,480,1218,353,11673,127
21539,0,903,1207,595,12887,308
27800,13,367,1083,215,9769,152
41020,33,446,818,352,5230,94
50957,54,338,650,259,6535,79
42872,15,361,788,293,10693,68
66509,54,738,174,573,6199,165
11950,14,209,1359,125,13178,84
4118,21,681,1434,460,19372,221
51876,7,168,625,127,7238,41
65407,126,1859,204,1561,17378,298
54205,1206,12222,551,9942,85494,2280
55205,40,617,517,454,13738,163
51815,1,89,626,58,5210,31
16986,73,2099,1288,1173,19563,926
4343,218,7065,1431,4448,52911,2617
3562,1097,29232,1440,21163,158367,8069
46230,39,353,749,310,16559,43
16776,546,13850,1291,9236,86811,4614
1192,10642,348394,1460,205404,698961,142990
529,18,1087,1465,721,8069,366
54074,32,390,555,304,5653,86
60216,15,298,363,214,4973,84
11605,5,167,1363,92,3985,75
24388,13,319,1158,241,12637,78
35509,4,139,934,85,6024,54
15266,2,111,1315,65,6632,46
58560,477,4733,419,3521,17914,1212
58042,7,102,437,83,4671,19
34206,62,868,965,614,18363,254
43525,528,7069,779,5325,40328,1744
20898,71,1572,1218,1216,17927,356
28598,116,5005,1068,2925,66911,2080
53607,93,1115,571,950,20864,165
13506,440,22296,1339,13537,121364,8759
58412,23,181,424,145,5330,36
43950,41,378,774,297,9915,81
54423,3595,50028,541,34907,342907,15121
54589,586,15708,537,10142,107224,5566
2060,1625,40586,1453,25559,179384,15027
17578,3,213,1277,152,11903,61
57177,12,107,462,87,3717,20
29625,18,849,1048,669,6668,180
45338,209,2380,759,1996,50504,384
56297,13,251,486,171,4574,80
57780,2,36,445,24,6048,12
18211,250,4920,1266,3274,45929,1646
565,195,7851,1465,5589,53319,2262
64282,0,1206,235,937,37880,269
27922,40,1469,1080,1030,21952,439
18888,39,1803,1254,1275,36540,528
13665,1334,45791,1337,27085,219714,18706
6802,807,18484,1400,12160,79765,6324
20829,36,932,1220,620,7124,312
13486,52532,1497539,1339,822171,3518437,675368
3384,0,158,1442,113,16542,45
28445,113,2542,1071,1527,8017,1015
49956,53,1086,676,742,18239,344
20953,75,1227,1217,742,12968,485
64148,18,303,240,275,8693,28
14699,24,979,1323,733,12437,246
33942,61,2253,971,1636,14479,617
18463,356,25064,1261,15967,120693,9097
40776,8,237,822,186,3185,51
30215,14,421,1036,277,4415,144
32625,38,1400,994,783,9783,617
29022,3,123,1059,81,4510,42
3329,686,17476,1442,11724,92926,5752
35959,0,0,924,0,3800,0
31268,3038,52264,1016,38001,135822,14263
30416,1995,49662,1032,31393,242695,18269
24302,63,2654,1160,1715,48154,939
17520,152,2856,1278,2146,23870,710
24148,7,194,1163,148,8557,46
53496,38,692,574,526,6941,166
58366,1277,20799,424,16791,70753,4008
20260,8,251,1230,191,7112,60
20681,1118,28336,1223,17224,197778,11112
50685,815,11580,657,9605,88119,1975
38518,4,43,856,40,7283,3
43473,0,40,780,35,2522,5
3693,2523,77253,1438,41767,140443,35486
66535,1,8,173,6,1108,2
31537,56,1049,1013,626,19191,423
26662,2677,39543,1107,24541,104181,15002
3146,27,676,1444,460,61332,216
42766,150,3288,790,2561,55798,727
61520,367,7748,317,5371,36876,2377
22426,73,4529,1195,3682,34056,847
41812,11,222,805,201,8313,21
24153,13,459,1163,323,15188,136
48711,27,689,711,530,31927,159
15533,153,6083,1311,4184,68457,1899
68311,5124,117448,104,84043,372335,33405
45254,128,1419,760,1077,12120,342
498,16358,635603,1466,378346,1579626,257257
12459,30,680,1354,365,8304,315
58775,26,369,412,281,9228,88
56880,190,2887,469,2310,38806,577
48527,52,421,717,326,4832,95
20319,25,380,1229,233,5883,147
60659,22,367,347,248,11023,119
15930,869,43236,1305,27557,213567,15679
43633,13,537,778,409,17129,128
55096,38,431,519,320,17500,111
5808,3,183,1412,86,3133,97
15610,122,3771,1310,2559,32382,1212
16064,26,731,1302,473,17138,258
61417,92,901,320,803,20480,98
49940,42,566,676,439,10958,127
50103,20,334,672,286,5114,48
56572,29,468,478,399,8563,69
61674,79,776,312,653,8834,123
36381,168,2128,843,1773,16025,355
12559,587,27336,1352,14818,221157,12518
51460,138,1929,637,1577,26199,352
9691,5,224,1376,162,7261,62
27502,636,12191,1089,7857,114895,4334
39434,526,8279,842,6162,80857,2117
48279,155,2805,723,2304,32204,501
32828,908,18006,988,13446,175487,4560
31786,27,779,1009,510,11966,269
10653,22,1137,1370,730,15784,407
2601,47,2397,1449,1650,55657,747
28751,298,5683,1065,3786,34720,1897
22116,427,9711,1199,6801,75632,2910
22431,85,2981,1195,2250,32542,731
25963,721,12754,1124,8578,116606,4176
573,489,15225,1465,10050,100438,5175
24747,429,12281,1149,8963,115218,3318
14591,73,1663,1324,1079,16025,584
45702,1,73,756,53,3545,20
13979,49,2483,1333,1374,30713,1109
26954,5,242,1101,220,14263,22
26778,32,1283,1105,672,10573,611
16450,19,257,1296,199,13554,58
50109,2007,37948,668,30052,116179,7896
64997,23,345,214,277,4054,68
9283,12,350,1379,235,12693,115
19784,3,103,1238,72,3256,31
11791,172,4637,1361,2272,23961,2365
42622,81,925,792,722,18548,203
55655,2,15,504,11,2072,4
3407,51,1261,1441,915,17465,346
36261,33,258,916,190,2875,68
51798,1307,17335,626,15019,178787,2316
26693,1512,30615,1107,20187,109518,10428
34845,31,412,951,291,4773,121
8765,36,1179,1381,783,14456,396
65692,12,116,197,87,4264,29
18333,234,6703,1264,4330,32889,2373
4801,16,984,1425,621,26412,363
50988,262,5196,649,3548,54005,1648
364,25,956,1467,609,6332,347
8783,255,5582,1381,3633,31356,1949
36788,70,1401,903,1136,26592,265
37443,93,1442,884,1197,14434,245
35413,84,1641,937,1339,11900,302
50554,47,625,660,509,11780,116
34984,22,631,947,404,7177,227
11682,63,1054,1362,620,21905,434
60214,16,174,363,141,3946,33
35826,618,8477,927,6577,56928,1900
50983,3,62,650,44,2862,18
14195,155,3346,1329,2193,26652,1153
3963,343,9546,1435,6410,53327,3136
57216,15,162,461,119,2883,43
2026,3446,164808,1454,110521,459585,54287
29519,474,6086,1050,3671,43130,2415
21391,14,242,1209,188,15528,54
9975,9,369,1375,245,15642,124
34060,1276,34722,968,25420,143569,9302
3169,1,132,1444,88,10782,44
7867,117,5748,1385,3448,58460,2300
52803,12,159,593,119,3439,40
9229,1527,71477,1379,43607,259837,27870
31223,91,1991,1017,1183,27172,808
2778,5,247,1448,147,18693,100
10122,722,45583,1374,29773,173604,15810
59090,307,4233,387,3314,30543,919
36159,688,11117,918,9214,96027,1903
59180,1,57,400,45,3128,12
24756,7,272,1149,177,7146,95
14647,12,579,1323,421,13049,158
9885,148,3421,1375,2105,41022,1316
51554,7791,152849,634,122813,535263,30036
30408,2777,58840,1032,33358,180981,25482
26119,11,448,1120,286,24296,162
47863,23,353,729,312,10206,41
34952,12,397,948,227,9752,170
10256,161,6369,1373,3114,67051,3255
22529,9,365,1193,219,7561,146
13530,1070,33217,1339,20953,148247,12264
55831,26,313,500,242,9281,71
18088,43,1546,1268,972,10410,574
32200,37,384,1003,284,8558,100
22745,43735,1448361,1189,838047,2243234,610314
12131,25,1194,1358,579,32027,615
4472,56,2385,1429,1484,16101,901
38201,399,6061,864,4550,25114,1511
53990,67,673,558,561,11339,112
47264,182,3227,736,2780,29088,447
6453,11,281,1404,190,36647,91
28026,391,11261,1078,7281,108064,3980
23608,450,17484,1175,11086,231839,6398
6087,8,212,1409,138,7599,74
66626,24,140,170,124,5071,16
66726,26,335,167,283,11226,52
60782,3,46,342,33,2556,13
65087,17,278,211,225,6615,53
64986,27,891,214,669,7771,222
37221,6,199,890,166,5095,33
62462,8,113,287,76,3891,37
543,4,186,1465,103,9989,83
8051,7,275,1384,196,11932,79
36480,1649,38125,909,30707,144377,7418
59482,40,659,389,492,18140,167
22675,10,325,1190,233,8269,92
17736,4724,189776,1274,119110,449851,70666
31591,3497,93055,1012,60456,241736,32599
49642,35,522,684,443,17063,79
2676,4414,181713,1448,120033,1087066,61680
39290,30,498,844,408,8476,90
19867,121,2914,1236,2115,35524,799
21497,1,33,1207,27,3648,6
14067,1572,55170,1331,34879,339236,20291
68316,1,12,115,8,4557,4
62301,65,864,291,741,25933,123
29139,44,1963,1057,1238,12354,725
37963,432,23160,870,16501,70408,6659
59788,118,1947,378,1701,14015,246
3006,1052,33991,1445,22989,205549,11002
61394,21,117,321,84,4396,33
9287,73,5005,1379,3178,25619,1827
47086,1641,35084,739,27181,159922,7903
7557,0,16490,1390,10753,141917,5737
30576,27,1075,1029,675,23511,400
23698,6903,127398,1173,90155,295356,37243
35654,15,513,932,334,3806,179
49176,1557,28761,697,24060,144007,4701
43413,549,8483,781,6524,62711,1959
58343,16,415,427,309,8583,106
59875,1679,30826,376,24051,111261,6775
12752,1070,33868,1350,22742,135611,11126
37957,52,751,870,522,9679,229
14244,37,1126,1329,746,17321,380
59372,603,10914,393,8450,70125,2464
27643,2629,63354,1086,37868,130940,25486
1701,236,7886,1456,5363,87530,2523
42023,8,140,802,89,6118,51
68945,2,28,93,18,1972,10
50834,233,4123,654,3258,67792,865
33578,33,637,978,455,3811,182
48834,55,512,707,428,13171,84
17490,26,604,1279,440,22448,164
56622,157,1096,477,945,14614,151
11824,45,805,1361,456,24138,349
54136,7,34,553,32,4226,2
32250,37,910,1002,598,16553,312
5613,37,1538,1414,990,14725,548
12606,9,579,1352,268,4512,311
61445,5,48,319,37,2570,11
34652,4,128,955,94,2963,34
9548,1995,58717,1377,40810,247390,17907
46941,108,1536,740,1247,27718,289
31468,174,2691,1014,1780,22530,911
24667,119,4020,1151,2812,42029,1208
12993,610,14956,1346,8500,35514,6456
11259,3249,112505,1366,58881,599958,53624
68713,48,488,101,385,3274,103
992,92,2783,1461,1859,49360,924
6838,17,339,1400,227,9352,112
6423,41,1496,1405,1038,13984,458
35445,36,456,935,352,4314,104
27975,85,1865,1079,1200,19126,665
1825,11,763,1455,498,28749,265
8325,523,12486,1383,8087,48963,4399
3598,151,5639,1440,3971,34917,1668
23484,4,167,1177,114,6529,53
31805,68,1050,1008,707,22154,343
6139,214,8441,1408,5739,102008,2702
1429,120,4276,1458,2921,96038,1355
1536,33,1605,1458,1172,36550,433
13564,2,258,1338,121,6310,137
63611,10,226,257,195,10138,31
29877,655,9247,1043,5445,44465,3802
14439,231,8069,1325,5648,72565,2421
34275,12,428,963,307,4237,121
46182,22,428,750,305,8447,123
9398,7,127,1378,89,5559,38
3885,4,133,1436,96,16937,37
11041,10,359,1367,223,7416,136
21928,69,1872,1201,1302,27175,570
63904,64,948,248,793,18715,155
24915,35,1162,1146,734,9852,428
30971,13682,414064,1021,304557,736928,109507
60095,1547,20251,368,16542,151741,3709
11961,0,0,1359,0,4236,0
63080,2,45,270,35,2738,10
13264,47,1987,1343,1301,54274,686
3498,177,11592,1441,7672,111518,3920
28903,129,3320,1062,2228,17051,1092
34023,104,1690,969,1200,24153,490
38328,905,14107,861,10693,36705,3414
14869,154,6895,1321,4428,66056,2467
53936,54,632,561,451,28172,181
24240,561,20579,1161,13145,183866,7434
60965,70,997,335,737,7982,260
39275,0,49,844,28,8926,21
43133,0,0,784,0,13763,0
4498,39,1494,1429,819,19186,675
21991,742,23026,1201,15716,83487,7310
30759,4828,150941,1025,116690,570915,34251
65674,10,66,197,52,1828,14
23076,14,530,1183,459,21674,71
35516,1503,24380,932,17684,154065,6696
37321,0,0,888,0,8045,0
19586,64,1604,1241,1117,20730,487
31408,80,1723,1015,1074,25825,649
29949,36,671,1041,586,12687,85
9722,39,810,1376,518,6191,292
6701,1323,33370,1401,22416,180951,10954
58226,21,218,430,181,5153,37
26824,1,62,1104,45,2475,17
4289,944,16350,1432,12332,92773,4018
57392,5,118,456,97,6477,21
38869,92,1351,849,1072,7519,279
37100,321,5871,894,4153,33466,1718
50632,71,1052,658,884,14492,168
40222,26,486,831,318,15347,168
33328,57,2085,982,1512,32944,573
62603,945,11036,282,8511,54941,2525
11381,30,1465,1365,981,24349,484
57409,24,253,455,212,12687,41
15444,270,32187,1313,23914,114295,8273
14824,76,1470,1321,1051,47033,419
30578,821,18402,1029,13761,164331,4641
20128,2,270,1232,210,9816,60
58742,22,178,413,144,2841,34
58561,37,486,419,394,9383,92
50985,270,6771,649,4883,54878,1888
60918,56,1195,337,1017,20580,178
35574,20,495,933,346,10092,149
31703,116,2084,1010,1309,22070,775
20047,18,405,1233,305,8861,100
33119,273,2758,987,2064,23013,694
6954,22,1476,1398,1007,17210,469
58367,115,769,426,598,10908,171
22352,39,971,1196,627,12057,344
23778,4,598,1171,323,11265,275
48728,21,453,711,397,6244,56
3487,75,4718,1441,3344,52319,1374
34160,11513,362361,966,246488,1827038,115873
7852,45,2474,1386,1781,65213,693
11136,27,907,1366,496,15631,411
49037,29,339,701,261,7165,78
34633,13,452,956,265,10028,187
4337,22,1073,1431,771,33572,302
31848,59,1329,1008,836,15737,493
68247,3,27,118,20,2855,7
17341,24,672,1282,495,12374,177
24282,8068,139540,1161,84835,338978,54705
60950,6,86,336,66,2951,20
23382,37,940,1178,653,8406,287
29260,29,1032,1055,660,16930,372
40531,125,2327,826,1524,19278,803
24780,149,2014,1149,1366,20863,648
36891,1969,31683,894,26570,176936,5113
12637,2689,91633,1351,58355,239015,33278
4744,471,37794,1425,22213,238972,15581
18507,33,1198,1260,971,18151,227
23491,136532,3052596,1176,2248643,4909458,803953
34795,2309,28728,951,20804,101166,7924
21826,188,5205,1203,3585,48533,1620
53025,3,42,586,29,2095,13
473,25,1324,1466,913,32739,411
7166,18,1189,1395,863,25234,326
8888,730,22459,1380,16499,101672,5960
66082,2,49,187,35,2672,14
41959,165,2635,803,2151,23455,484
29398,306,7718,1052,5246,35676,2472
67757,49,915,133,708,5680,207
9472,483,17715,1378,11443,118195,6272
51165,9,140,644,107,5823,33
58077,302,5758,436,4268,28517,1490
20499,85,4734,1226,3461,36771,1273
46881,169,2287,741,1825,25207,462
64659,30,420,225,322,3264,98
13678,18,595,1337,364,32389,231
14987,12,300,1319,234,18866,66
18510,6,156,1260,100,3381,56
32098,18,971,1004,593,13694,378
33652,226,3775,976,2758,42363,1017
64332,7,79,234,61,3462,18
23056,0,0,1183,0,4714,0
22313,344,7032,1197,4726,58932,2306
23745,46,1755,1172,1187,25626,568
51888,30,380,624,313,4297,67
50390,631,8206,665,6999,57382,1207
30728,163,5173,1026,3610,35706,1563
7665,222,7422,1388,5121,66275,2301
62071,257,4543,299,3820,35131,723
846,86,2718,1463,2030,50376,688
52583,8055,88626,601,69745,331774,18881
16651,95,2599,1294,1684,33328,915
15868,4,212,1306,136,4006,76
23733,1029,25312,1172,17969,169805,7343
36793,66,2558,903,1863,12652,695
14283,52,1722,1328,1118,39718,604
50944,15,161,651,136,2972,25
23647,136,2847,1174,1779,14442,1068
31756,26,778,1009,471,18439,307
11081,3,163,1367,104,19422,59
40547,664,12647,826,9414,37577,3233
15995,13,386,1304,269,12501,117
25388,6,207,1136,133,11684,74
60493,433,6718,353,5636,48939,1082
33196,4277,64774,985,41378,283851,23396
26571,38,744,1110,466,16997,278
2639,41,1164,1449,631,19338,533
12029,27,915,1358,534,13569,381
55422,8,138,511,102,8523,36
45594,136,1967,756,1793,18633,174
36300,91,947,914,809,23336,138
56285,26,480,486,404,9876,76
68062,13,152,122,108,4275,44
27608,29,847,1087,572,21753,275
12780,8,163,1350,91,5704,72
29676,297,5854,1048,4031,60989,1823
1971,2624,112102,1454,69295,390150,42807
17031,14,373,1287,288,14602,85
3243,295,10959,1443,7338,96368,3621
57944,145,932,440,757,15027,175
33243,16,592,984,386,7010,206
5973,8,209,1410,153,3983,56
48855,798,14086,707,9929,63985,4157
59977,80,548,372,413,7829,135
12666,18,676,1351,289,10284,387
14680,3,143,1323,102,15387,41
27312,0,100,1094,68,5162,32
64108,1,40,241,34,2467,6
1800,195,4116,1456,2837,24460,1279
23118,7,121,1183,82,6620,39
64828,23,259,220,194,2845,65
64425,14,230,231,174,6394,56
54704,220,3852,532,3162,39141,690
51149,2214,27744,632,22418,103968,5326
9099,471,19717,1379,13121,130895,6596
36476,20,347,909,304,9629,43
14656,163,5786,1323,3971,26137,1815
38875,32,629,849,537,15984,92
37500,681,24458,883,15977,137983,8481
49460,42,557,689,453,13616,104
12577,404,18822,1352,10403,101605,8419
27952,23,825,1079,623,16286,202
32173,7,153,1003,93,5395,60
64738,22,417,223,296,6714,121
37956,237,4822,871,3772,33655,1050
63570,7,37,258,35,2746,2
50098,105,1045,672,855,36652,190
17754,1077,52666,1274,35057,119009,17609
12400,97,6817,1354,3815,41323,3002
33237,37,1019,984,596,9399,423
10261,308,11287,1373,7022,68784,4265
10208,269,4987,1373,3350,38760,1637
62113,120,2547,297,2115,27784,432
18082,40,1051,1268,827,32171,224
67297,162,2890,147,2470,20004,420
37049,35,921,896,768,37780,153
57717,69,712,448,577,7391,135
22198,67,1908,1198,1233,36100,675
10017,37,1201,1374,818,16153,383
65098,376,6096,211,5059,35492,1037
64718,447,7721,223,6280,37793,1441
6932,44,1713,1398,1135,32084,578
35224,211,3050,941,2049,36783,1001
54009,409,4490,558,3538,60688,952
66475,2,71,175,59,2676,12
34561,44,1862,958,1138,11762,724
21753,119,3545,1204,2014,40967,1531
49078,31,482,700,437,18568,45
58092,31,383,435,287,7426,96
14040,19,967,1331,585,21122,382
10425,44,1830,1372,1062,14854,768
63779,8,95,252,71,4314,24
9882,10,153,1375,96,7679,57
22524,831,18391,1193,11007,126893,7384
32546,149,2754,997,1871,50329,883
12601,122,6408,1352,4184,52148,2224
64735,65,1081,217,919,10674,162
26787,40,644,1105,445,9421,199
16965,42,1544,1288,1135,19889,409
53246,189,1656,579,1538,11120,118
18248,147,2898,1265,1890,43089,1008
20885,20,469,1219,296,5529,173
54302,5618,69282,547,55798,194770,13484
8323,256,13067,1383,7638,60498,5429
8930,10,602,1380,434,13033,168
3491,16,333,1441,203,14785,130
67506,0,15,141,10,3859,5
66879,24,264,161,230,6429,34
29138,51,1413,1057,900,33988,513
28460,57,1048,1070,641,10326,407
27003,337,8884,1100,6141,49657,2743
21402,321,9202,1209,5712,44832,3490
55215,1384,15753,517,12214,121920,3539
50954,5469,65632,650,49403,300973,16229
27617,32,683,1086,428,4701,255
68045,129,1664,124,1516,15691,148
64388,350,6752,232,5559,52270,1193
24134,25,1293,1163,906,24995,387
1508,289,9513,1458,6595,62872,2918
36111,503,9800,920,7968,117078,1832
34207,386,9329,965,6654,93886,2675
22941,39,1983,1185,1357,23126,626
40391,63,869,828,648,13484,221
42606,19,219,793,180,5712,39
48693,18,253,712,198,4249,55
3494,5,138,1441,87,14433,51
43625,76,1433,778,1096,16657,337
19269,1583,31129,1247,20089,100934,11040
1294,486,18117,1459,11907,89805,6210
48467,1939,45536,719,31481,264179,14055
54335,19,192,546,147,23396,45
63146,144,3035,269,2262,17397,773
2530,24,1082,1450,725,21845,357
31018,104,3520,1020,3052,112588,468
14332,4,256,1327,155,7917,101
67601,453,8242,138,6950,71956,1292
14462,5,143,1325,105,3015,38
35508,14,157,934,118,8116,39
67457,5,79,143,73,3211,6
1831,115,3710,1455,2806,57683,904
1176,8,394,1460,260,10686,134
3635,171,3793,1439,2537,23739,1256
64230,180,2133,237,1568,29022,565
31477,876,12799,1014,8148,80398,4651
17992,123,3096,1269,2255,40959,841
31398,121,1988,1015,1462,21559,526
32005,44,1209,1005,780,5459,429
1592,31,1263,1457,900,45667,363
47135,216,4639,738,3617,52153,1022
15559,13,644,1311,475,57430,169
28733,7,269,1065,171,11638,98
55039,31,350,521,280,21621,70
12616,20,1590,1352,941,32170,649
32323,24,841,1001,543,20025,298
9935,3564,110557,1375,71842,419681,38715
5886,13,330,1412,249,4199,81
22813,8,237,1188,196,13901,41
60090,141,1767,368,1450,40512,317
31787,39,1061,1009,748,13703,313
68367,305,7379,114,5541,58324,1838
48220,33,562,724,435,15308,127
58529,57,597,420,546,9976,51
6238,108,4326,1407,2581,42346,1745
5663,13,541,1414,380,17668,161
60232,95,1205,363,962,16054,243
49364,9,291,691,200,5284,91
57081,54,704,464,596,12028,108
64756,59,1478,222,1270,7656,208
35859,63,1639,927,1114,7319,525
59568,168,4447,386,3291,49098,1156
10312,70,1316,1373,971,23490,345
30202,11,389,1036,279,4718,110
60863,11,90,339,51,5297,39
13612,11,348,1338,191,10767,157
33144,1934,44930,986,32084,342477,12846
32129,17,427,1004,328,16463,99
33293,104,2277,983,1596,17159,681
31375,509,10707,1015,7298,69186,3409
12670,560,21068,1351,11869,90005,9199
68216,3,39,119,34,3165,5
46648,108,983,744,726,7371,257
6025,16,1119,1410,692,30908,427
35006,287,6992,947,5272,71917,1720
24522,2877,52156,1155,37416,271769,14740
53836,59,581,564,480,9419,101
47649,6452,121330,730,98365,675595,22965
20240,0,0,1230,0,7523,0
52965,11,321,588,244,7441,77
50284,88,1348,667,1087,16837,261
32279,5,133,1002,99,4736,34
22699,75,2720,1190,1824,54714,896
53945,138,1942,560,1419,12686,523
15337,56,1924,1314,1230,12744,694
8608,123,5382,1381,3158,59138,2224
9985,72,2118,1375,1567,23953,551
41510,10,213,811,197,17583,16
65925,21,141,191,116,4691,25
20927,161,5259,1218,3261,81822,1998
9536,116,2184,1377,1442,18912,742
6276,4787,243266,1407,144592,789628,98674
53033,4,500,586,360,13084,140
54928,106,1279,524,1070,7844,209
26141,8,137,1120,124,5614,13
11179,243,4586,1366,2883,27545,1703
38529,11877,218474,855,180991,706193,37483
8067,141,3036,1384,2018,23147,1018
27225,11,260,1096,154,3655,106
47021,154,1857,740,1292,11609,565
35785,128,1921,928,1478,32692,443
32076,12,513,1005,299,10821,214
49465,564,7866,689,5531,57975,2335
49090,8,81,699,65,5479,16
63590,70,514,258,444,11556,70
56732,89,2333,473,1791,22498,542
66617,11,60,170,47,3344,13
53271,18610,264842,567,186489,1089352,78353
13770,628,18464,1336,11654,71574,6810
52044,483,7253,619,5818,79507,1435
50875,5034,131070,652,96348,422482,34722
7231,1144,39553,1394,27628,115723,11925
13301,3,209,1342,125,8369,84
63546,1,17,259,12,1733,5
14257,38,7604,1328,5184,39269,2420
49939,662,8220,676,5980,93262,2240
47936,87,1016,727,815,7200,201
13756,0,0,1336,0,7748,0
44697,128,1396,767,1211,17741,185
22093,82,3095,1199,1983,16514,1112
64267,193,3311,236,2605,20603,706
65275,11,141,207,122,4255,19
1144,110,2836,1460,2195,20078,641
12644,542,10960,1351,7500,38903,3460
58796,36,398,412,326,5647,72
64912,10,220,217,158,4637,62
59235,152,1172,398,853,7537,319
37573,70,1628,880,1345,13361,283
34505,416,7785,959,5514,38675,2271
24149,318,5990,1163,4107,53322,1883
66781,2,34,165,22,1081,12
28617,111,3187,1067,1919,20775,1268
1658,122,2590,1457,1846,20588,744
32426,226,3323,999,2576,25525,747
52491,499,9480,604,7098,82765,2382
53546,369,3405,573,2740,17745,665
12884,83,739,1348,514,13333,225
10333,14,785,1372,452,13552,333
23078,209,10061,1183,7115,46010,2946
3111,918,125531,1444,62640,296716,62891
8049,76,2550,1384,1626,13368,924
9506,51,1842,1377,1212,23136,630
52922,89,950,589,669,9975,281
2572,56,1821,1449,1317,13806,504
6586,7,274,1402,166,3773,108
20012,24,1087,1234,713,10504,374
66813,3,23,164,16,3054,7
52981,386,5121,587,4343,55135,778
14358,14,553,1327,400,14889,153
2646,62,2450,1449,1572,46929,878
19830,49,773,1237,512,10158,261
64936,17,232,216,179,4767,53
61641,9,241,313,175,18539,66
40492,142,1438,827,1046,9563,392
11397,1320,33488,1364,22759,149743,10729
31614,123,3670,1012,2465,19013,1205
65239,33,679,208,527,13015,152
53640,49,362,569,297,8777,65
4797,149,5520,1425,3704,65754,1816
4844,6,182,1424,134,10115,48
9617,9,226,1377,147,9698,79
18203,32,1095,1266,803,15637,292
57411,18,213,456,163,5925,50
20098,179,7354,1232,4754,67589,2600
1395,4790,198654,1459,99242,455582,99412
41191,18,219,816,152,9831,67
35865,10,156,926,125,4968,31
41158,37,472,816,384,11530,88
29137,3812,117629,1057,74692,519991,42937
66782,4,30,165,23,3146,7
11213,59,1092,1366,677,12413,415
50746,16,392,656,312,11112,80
55732,68,812,502,705,37455,107
31618,68,2105,1012,1129,6822,976
54209,13,87,551,62,5095,25
11658,38,886,1362,442,5847,444
34157,227,5011,965,3447,41364,1564
66328,16,269,179,195,3197,74
18243,702,15733,1265,11486,51909,4247
66430,0,12,176,7,1484,5
48107,616,10830,725,8120,97688,2710
17543,46,3299,1278,2416,30506,883
19545,295,5147,1242,3170,23907,1977
50021,11,192,674,156,8651,36
55431,199,2915,510,2248,42117,667
65881,11,94,192,71,5127,23
11390,1304,46974,1365,29586,162895,17388
50546,1829,21958,660,17419,124952,4539
9570,209,5326,1377,3296,28653,2030
3368,33,1229,1442,849,32104,380
7012,95,2752,1397,1978,85572,774
1575,339,8161,1457,5472,25534,2689
32623,57,753,996,519,12155,234
25864,52,1227,1126,936,21645,291
34582,8,224,958,155,10246,69
62293,43,1033,291,713,18243,320
23147,56,1824,1182,1170,41160,654
5372,33,568,1417,385,17306,183
49189,24,435,696,293,12538,142
19308,19,356,1246,242,6400,114
28074,16,648,1078,378,14469,270
54679,3474,36052,533,28850,120169,7202
50297,0,45,667,37,2833,8
63469,1,41,260,30,3713,11
53404,38,478,576,391,9815,87
15883,27,749,1306,481,9792,268
64246,38,514,237,417,6802,97
3220,17,889,1443,644,16934,245
19364,21,512,1245,364,13921,148
67066,14,242,156,167,3113,75
64454,15,227,231,183,3386,44
12082,375,16396,1358,8733,110776,7663
21228,4190,111180,1212,73049,708997,38131
9118,1280,61820,1379,38777,335842,23043
18500,67,1667,1260,1259,44500,408
12579,8,1065,1352,551,29830,514
28553,52,760,1069,516,7205,244
24331,12,273,1159,162,3805,111
54045,89,725,557,605,6544,120
69023,25,489,90,379,6757,110
17438,409,9028,1280,6323,58387,2705
19787,3,110,1238,82,10495,28
33317,47,1504,983,1126,9327,378
67386,30,579,145,425,9833,154
53132,86,580,582,539,10407,41
19088,7,230,1250,199,9501,31
26677,956,29420,1107,20190,199027,9230
10722,16,768,1370,504,11312,264
35917,2068,58185,925,45529,266142,12656
22492,26,651,1194,449,13968,202
14363,165,2381,1327,1703,28910,678
19207,15,290,1248,265,15186,25
20018,549,13443,1234,8663,109660,4780
29468,167,4142,1051,3028,38387,1114
20178,6,221,1231,165,13249,56
7887,26145,1556059,1385,930835,3034411,625224
59369,97,1456,393,901,13556,555
28271,105,3158,1074,2242,19848,916
34140,11,240,967,148,2689,92
40050,493,9591,834,7970,99382,1621
65685,82,1732,197,1280,14842,452
19540,2,39,1242,29,37186,10
65549,114,2531,201,2083,9356,448
45599,29,580,757,485,6213,95
68294,4,102,116,75,4867,27
49412,2,27,690,23,2982,4
50951,53,460,650,386,5533,74
27097,97,2263,1098,1406,15724,857
1521,49,840,1458,582,14676,258
37946,1108,89886,871,64076,232127,25810
36230,7,143,917,113,5251,30
63081,18,310,270,271,11562,39
66889,19,190,161,148,3741,42
50915,39,481,651,407,9627,74
30359,8,598,1033,352,8115,246
65279,23,308,207,260,3978,48
65498,3,239,202,162,4274,77
21273,9,481,1211,303,7512,178
49739,17,266,681,239,5805,27
60483,1,11,353,9,2774,2
19337,79,1192,1246,876,16209,316
24029,45,1267,1166,1069,31577,198
61774,19,193,309,153,6433,40
19174,0,0,1249,0,5304,0
45550,3,84,757,72,3931,12
64405,2,24,232,19,1994,5
36216,7,167,915,131,8645,36
68844,16,417,97,404,8177,13
14561,548,21017,1324,13496,67028,7521
54158,8,73,553,59,5251,14
23891,154,2983,1169,2046,28637,937
9789,20,1055,1376,636,12658,419
56471,68,747,481,542,12858,205
59809,2245,45782,378,35741,142681,10041
28859,2,211,1063,139,13202,72
15439,604,15976,1313,10949,121716,5027
45407,27,237,759,195,6727,42
48568,141,3005,715,2029,44040,976
56539,56,575,479,521,45941,54
47499,514,6691,733,4989,51676,1702
2321,378,9708,1451,6322,45790,3386
12290,18,618,1356,362,10328,256
13668,28,548,1337,326,11268,222
6311,958,30292,1407,19706,160518,10586
52152,301,4136,616,3389,36749,747
64220,55,524,238,406,4075,118
29508,30,1340,1050,772,12583,568
38420,37,942,858,726,13647,216
39598,28,676,820,484,30422,192
18772,2146,40132,1256,27561,164904,12571
5903,50,2129,1411,1355,20591,774
26481,42,486,1113,388,17959,98
21157,173,5212,1213,3723,61576,1489
16411,2717,106126,1297,71305,660723,34821
46871,222,4832,741,3638,44900,1194
33938,27,504,971,342,9041,162
31290,31,513,1016,314,4231,199
19012,2,362,1252,248,13991,114
48897,28,579,705,406,5602,173
2770,883,23538,1448,16349,106311,7189
35863,929,15183,923,12024,131060,3159
33655,121,3426,976,2494,35841,932
54291,216,2094,548,1748,16131,346
46366,44,477,748,354,6775,123
29746,77,1827,1046,1140,17386,687
30808,211,4310,1024,2521,26498,1789
57175,7,110,462,92,5596,18
214,47,3004,1468,2118,34225,886
64128,31,239,240,196,2848,43
6812,157,3653,1400,2355,19773,1298
20798,43,1317,1221,888,17177,429
10397,95,2810,1372,1766,27098,1044
19182,7,223,1249,175,7583,48
68723,4,82,101,72,10399,10
61790,27,459,308,400,6799,59
57379,277,4094,456,3123,35920,971
14570,6,491,1324,310,5870,181
40680,0,560,825,393,5575,167
14426,87,1480,1326,976,13052,504
26400,36,1874,1114,1126,33236,748
50671,471,8564,658,6897,31578,1667
24390,1733,81790,1158,50057,363840,31733
2306,79,3449,1451,2414,92839,1035
47138,8,260,738,192,9371,68
52633,1055,23736,599,19018,181015,4718
2621,83,2511,1449,1793,55928,718
29212,78,2015,1056,1288,14553,727
8258,3935,192412,1383,113753,602182,78659
25148,5,331,1141,218,9331,113
21899,107,2841,1202,1563,17982,1278
64171,192,2867,239,2054,11815,813
51849,33,586,625,447,13354,139
59035,1360,30164,404,23980,166269,6184
25476,10367,207072,1134,124961,1008185,82111
25719,4,83,1129,66,6684,17
15437,259,8113,1313,5860,73506,2253
45926,63,1503,753,1135,12859,368
2577,292,8586,1449,5835,72543,2751
32616,9,658,996,510,35677,148
50100,393,5810,672,4895,64123,915
17189,6,207,1284,160,9699,47
50724,25,249,657,195,3305,54
12104,103,1811,1358,1284,18671,527
65953,176,1801,190,1483,11322,318
51495,362,3476,632,2657,38162,819
34970,20,356,947,245,10643,111
57591,5653,83216,451,65372,216882,17844
46915,3675,62838,741,47745,231607,15093
14287,0,0,1328,0,9967,0
37355,442,9527,886,6225,62781,3302
25028,126,2309,1143,1771,47973,538
34853,0,98,950,66,3765,32
60390,7,168,358,121,6810,47
4993,25,761,1422,537,30343,224
67196,57,1356,151,949,16173,407
52952,18,232,588,166,5687,66
54147,34,312,553,252,9145,60
38230,3,173,864,113,8046,60
64226,4,53,238,35,1488,18
16724,568,16954,1292,8796,72352,8158
2759,16,626,1448,469,31835,157
27600,64,1659,1087,1134,23995,525
49996,345,3756,665,2908,29133,848
15736,25,765,1308,533,10984,232
63463,70,617,260,440,4041,177
31312,303,5358,1016,3692,26610,1666
29161,4,94,1056,79,6925,15
15865,2086,175534,1306,115614,611459,59920
19425,1414,35663,1244,24383,192671,11280
63136,370,4165,269,3128,46957,1037
15890,38,1485,1306,994,20898,491
22060,20,1010,1200,715,20004,295
54689,310,2674,533,2214,36473,460
56252,32,240,485,207,6001,33
24775,11,433,1149,307,7316,126
24217,38,1434,1162,889,15089,545
22142,8,487,1199,348,9960,139
24719,19,605,1150,362,6738,243
57246,113,1377,460,1150,17731,227
35951,208,2499,924,1999,34933,500
34175,6,200,966,124,2389,76
63659,75,957,255,794,18102,163
10404,433,15707,1372,8530,52642,7177
17611,4,160,1277,138,19215,22
56778,26,186,472,160,5571,26
33029,73,1733,988,1325,25649,408
5481,372,11826,1416,7704,89312,4122
42957,896,27329,787,21063,195762,6266
2315,98,4015,1451,2978,67543,1037
50892,3300,65708,652,46638,286823,19070
62172,32,461,295,376,10336,85
40961,58,885,819,666,19434,219
3589,16171,523482,1440,335843,1063559,187639
9122,17,502,1379,347,14987,155
33382,51,776,982,580,17012,196
4771,46,1208,1425,868,20834,340
32738,3,80,994,51,2931,29
35159,10,186,943,142,14632,44
2748,6,206,1448,138,14850,68
25324,171,3987,1137,2951,55878,1036
13067,10860,339907,1345,203116,1565752,136791
29447,898,15027,1051,10234,64535,4793
54101,13,74,554,56,3221,18
37742,189,3456,876,2584,49383,872
63767,3,61,252,49,2299,12
11986,232,8730,1359,5619,72711,3111
28135,105,2149,1076,1385,22493,764
60833,6,52,340,45,10000,7
17798,372,11534,1273,8557,83424,2977
52545,24,455,602,330,11125,125
10495,52,1385,1371,882,8510,503
3606,538,10334,1440,7316,75665,3018
45243,13,219,760,174,6413,45
38187,25,326,864,278,9110,48
36192,315,4534,917,3376,33435,1158
8684,426,18328,1381,10734,86594,7594
30885,59,664,1023,429,6460,235
25364,107,1479,1136,918,15311,561
53521,585,6756,573,5174,51631,1582
63649,33,691,256,560,7649,131
24154,330,26630,1163,16035,109019,10595
3946,35,1107,1436,793,13427,314
20781,23596,990438,1221,671501,3198490,318937
48180,34,327,725,283,12623,44
32832,23,417,992,301,11291,116
25310,4319,73407,1138,52442,172995,20965
66388,33,357,177,290,4742,67
12893,125,4753,1348,2509,38868,2244
36462,28,760,909,601,9068,159
22820,83,3511,1188,2515,38093,996
52308,63,891,610,647,10326,244
13132,89,3390,1344,1760,23340,1630
12020,18,897,1359,493,20855,404
68711,7,103,101,90,4863,13
63683,12,241,255,190,3226,51
11085,4227,69587,1367,38411,133473,31176
26138,42,835,1120,518,19325,317
22516,8,144,1193,99,5274,45
22250,12,825,1197,588,23844,237
56799,39,488,472,422,7084,66
55069,484,7213,520,5864,33771,1349
20501,656,14045,1226,9513,126301,4532
58316,18,307,428,238,17380,69
57388,5,132,456,104,7003,28
36535,1192,18097,907,14346,110575,3751
29424,567,9715,1052,6760,86999,2955
57794,108,2013,445,1650,15429,363
11204,6,84,1366,50,4712,34
45692,5508,91946,756,61590,275208,30356
2625,13,793,1449,564,26068,229
2144,606,25016,1453,15698,64002,9318
13,116,4262,1472,2462,52325,1800
36733,32,492,904,388,6366,104
65829,49,475,194,377,9966,98
30873,19,706,1023,469,3772,237
54065,215,2027,556,1539,16578,488
17704,6526,267904,1275,176151,1034612,91753
15465,12,567,1312,388,10446,179
31738,52,1749,1009,1109,30381,640
35351,39,404,938,313,9789,91
9999,142,7650,1374,4618,57788,3032
32136,302,4792,1004,3367,40605,1425
1871,1,158,1455,116,8629,42
32776,23,521,993,363,16395,158
58067,0,0,402,0,3623,0
46022,15,457,752,370,10475,87
57373,11,187,457,144,3036,43
18454,58,2378,1261,1650,17991,728
38400,924,16216,859,11611,44537,4605
58630,284,3709,417,3049,29453,660
25091,311,14080,1142,7701,151706,6379
2567,6,501,1449,371,26595,130
58362,32,559,426,398,10108,161
17087,176,2484,1286,1674,44382,810
14674,142,3654,1323,2585,29775,1069
51811,62,735,626,572,11335,163
16367,5,517,1298,306,14956,211
62747,55,953,279,632,16381,321
3892,8,329,1436,231,30481,98
21483,4,122,1208,74,5874,48
46426,15,194,747,145,6374,49
22020,289,12889,1200,8316,116245,4573
26655,39,581,1108,381,8036,200
34348,51,962,963,860,19423,102
3962,28,852,1435,661,12553,191
10987,41,1228,1368,791,44500,437
8144,82,2177,1383,1350,44922,827
16394,1910,58744,1297,36620,349424,22124
48848,38,547,707,408,7666,139
27306,73,2396,1094,1859,22734,537
15652,0,0,1309,0,9359,0
41810,105,995,805,850,11273,145
10376,109,3607,1372,2116,54305,1491
12532,50,1466,1353,802,9746,664
13133,6025,147358,1344,96317,623363,51041
7764,243,7330,1387,5130,47539,2200
56046,43,661,493,553,4993,108
54466,678,13950,541,10105,53868,3845
45891,19,247,753,199,9194,48
66223,21,257,182,195,5538,62
60660,881,13587,347,11040,93052,2547
31054,79,2059,1020,1372,25827,687
2433,26,541,1450,414,12363,127
34075,94,1606,968,1079,12021,527
50035,87,1080,673,864,17319,216
35063,159,2763,946,2120,22182,643
13263,82,1539,1343,992,35151,547
28665,108,1766,1066,1228,15305,538
33067,6,57,987,44,3838,13
22010,130,5133,1200,3494,127009,1639
53594,43,682,572,601,24099,81
3961,32,1360,1435,902,63467,458
6776,7,111,1400,85,11970,26
66744,277,3607,166,3068,26085,539
18049,58,1257,1268,922,32153,335
40387,24,821,828,647,27179,174
66160,880,13809,153,10562,135744,3247
43976,15,371,775,297,7226,74
8190,113,2685,1383,1750,32399,935
64497,0,8,230,8,1930,0
41436,46,810,812,664,13066,146
63292,89,1916,265,1416,27271,500
34838,21,406,951,296,10039,110
27647,287,7776,1086,5182,32722,2594
17370,187,8130,1281,5512,101839,2618
3419,165,5628,1441,4043,26231,1585
14173,530,14283,1330,10361,109110,3922
22073,164,6398,1200,4357,51611,2041
15649,22,688,1310,511,6646,177
34592,354,3875,957,2786,28142,1089
14888,32,712,1321,520,15001,192
61656,114,950,313,780,12287,170
25999,313,8932,1123,5631,39891,3301
18015,120,3432,1269,2526,61328,906
61949,22,196,303,152,7021,44
66133,30,386,185,313,8206,73
13531,9242,347603,1339,219226,1139630,128377
55803,254,2819,501,1863,17220,956
30096,69,2284,1038,1493,22781,791
38149,43,734,865,539,10515,195
46295,8,153,749,118,6701,35
35127,330,6255,944,4839,37734,1416
12249,32,1127,1356,705,28630,422
25846,28143,1241232,1127,727603,3799646,513629
36382,8,182,912,136,17976,46
28077,7,332,1077,265,7091,67
61215,44,604,326,463,20956,141
14308,12325,262158,1328,183799,977049,78359
34278,15,476,963,343,5057,133
15882,56,969,1306,700,22283,269
11473,618,14391,1364,8172,85765,6219
59704,101,1181,381,944,7311,237
44216,372,6160,771,4524,49868,1636
22196,215,6629,1198,4637,48601,1992
16909,82,1342,1289,978,17708,364
15701,926,13333,1309,9254,59380,4079
62489,394,8793,286,6317,71856,2476
48488,75,950,719,733,21166,217
20076,18,1060,1233,703,10239,357
11118,75,1422,1367,906,29471,516
38671,49,736,852,554,19603,182
13161,5,198,1344,130,7072,68
13615,18,1313,1338,848,23103,465
20811,3,249,1220,180,18808,69
48596,14,239,714,180,11106,59
38994,45,580,847,467,12031,113
13031,17,817,1346,450,31724,367
7197,94,2394,1394,1640,23794,754
62342,5,18,290,16,3150,2
37092,5,124,894,105,4986,19
68511,3,83,109,64,2915,19
59110,126,1520,402,1190,16250,330
400,465,19452,1466,11127,64766,8325
13641,11974,353475,1337,221865,1298461,131610
59341,1026,47859,394,34636,210722,13223
5215,182,13458,1419,8650,52554,4808
53057,6,68,585,52,3300,16
31195,543,10066,1018,7290,29489,2776
32746,4,128,994,107,1572,21
18461,97,3276,1261,2276,73011,1000
39033,90,3125,847,2386,27919,739
173,715,30667,1469,19277,122091,11390
33028,188,4853,988,3183,41454,1670
49428,66,524,689,355,9536,169
23250,64,1646,1181,1249,33096,397
24702,258,7972,1150,5639,161965,2333
68878,26,268,95,219,2568,49
3640,4,364,1439,220,16962,144
26887,20,235,1103,156,6952,79
36924,30,381,899,285,8165,96
61884,728,8412,305,6854,37188,1558
18610,0,0,1259,0,54974,0
35929,1317,24723,925,18184,153805,6539
15541,17,850,1311,636,15208,214
20779,267,4219,1221,2969,24473,1250
30931,9,241,1022,151,5192,90
30197,0,36,1036,28,5158,8
2904,16,804,1446,512,34280,292
67523,5,54,141,38,2075,16
14157,9727,173987,1330,112908,445090,61079
59779,37,495,379,400,17602,95
14182,38,747,1330,512,23324,235
11388,37,1787,1365,1202,32125,585
66737,4,69,166,54,5829,15
5644,1162,35685,1414,22382,289482,13303
10799,42,1327,1369,840,41634,487
56112,263,4597,492,3280,23308,1317
41148,28,504,816,395,9064,109
50600,216,1994,659,1546,30660,448
17682,5,187,1275,128,10385,59
14252,37,1237,1328,930,27747,307
21184,1503,64294,1213,41243,331262,23051
22469,70,2138,1194,1516,36687,622
5474,12,636,1416,450,25315,186
11111,65,2054,1367,1117,16333,937
27623,55,1041,1086,574,6352,467
27815,9091,274654,1083,173071,813074,101583
22707,598,20553,1190,15099,41875,5454
1972,24,1005,1454,649,20195,356
64713,160,2398,205,1979,19688,419
4849,108,2297,1424,1344,14285,953
4281,2,131,1432,99,9148,32
49769,5,131,680,101,3563,30
22246,333,9402,1197,6716,104707,2686
7357,8,314,1392,233,4397,81
50773,94,2742,655,2440,24786,302
3463,18,311,1441,215,16766,96
28966,52,2286,1060,1374,34476,912
11988,24,735,1359,331,10000,404
28561,18,249,1068,194,11978,55
52102,571,7188,617,5924,94226,1264
4572,128,3569,1428,2494,40210,1075
34745,58,2496,953,1562,23774,934
67629,57,521,137,449,8423,72
44049,202,2609,774,1982,13749,627
16154,11,423,1301,291,7099,132
56008,15,170,493,130,5692,40
19422,25,400,1244,318,17926,82
24430,21,576,1157,371,10668,205
62625,6,240,281,183,3722,57
58463,98,832,422,583,7728,249
46753,25,385,743,326,21935,59
32263,12,324,1002,219,13705,105
7265,14,544,1393,386,18207,158
29786,76,1827,1045,1072,20978,755
20886,55,1557,1219,966,35996,591
12814,169,5838,1349,3878,52567,1960
58517,117,1420,420,1110,25464,310
62573,44,895,283,675,10665,220
13571,908,22817,1338,13940,85203,8877
51733,2436,33286,629,25914,128439,7372
25709,700,22736,1129,14791,145782,7945
19347,236,5217,1246,3093,36107,2124
42528,1,33,795,24,2384,9
24791,33,906,1149,632,21367,274
28326,106,2368,1072,1418,30863,950
25674,15,534,1130,377,13346,157
4318,12,645,1431,503,34048,142
50869,28,200,653,158,3464,42
21388,274,6051,1209,3823,23338,2228
54594,12,86,536,68,3905,18
9400,569,19475,1378,11731,126857,7744
23367,23,989,1179,714,10255,275
36213,37780,847227,917,457388,2352023,389839
57995,53,618,437,446,11579,172
8095,752,23049,1383,14347,82397,8702
26957,165,8076,1101,5560,65109,2516
11829,24,1260,1361,650,12649,610
35471,898,28572,935,23845,108410,4727
50873,201,2053,653,1633,15836,420
17503,365,15195,1279,10833,96719,4362
14211,26,885,1329,703,74177,182
49570,1,41,686,32,2185,9
554,12,379,1465,286,36126,93
26620,221,5340,1109,3535,80066,1805
16359,126,1361,1298,864,22855,497
59171,664,11638,400,8912,64513,2726
11718,59,2230,1362,840,11044,1390
526,965,77768,1465,45913,253206,31855
9752,13448,475704,1376,281388,1838576,194316
11115,21,590,1367,367,15527,223
2993,108,2836,1445,2118,31653,718
45894,13989,325589,753,231062,1101793,94527
22627,260,7773,1191,5097,30161,2676
37684,163,2152,877,1641,18487,511
18323,69,1489,1264,1078,70175,411
17437,85,1690,1280,1020,14816,670
2950,66,2008,1446,1275,21097,733
1190,12,674,1460,473,17115,201
1121,85,3850,1460,2665,37967,1185
28652,57,695,1066,514,18100,181
64691,126,1773,224,1509,12123,264
5272,12,610,1418,476,14458,134
13858,5,240,1334,142,19324,98
41917,113,1288,804,982,11911,306
6301,686,27173,1407,17203,158313,9970
2764,567,10632,1448,7662,57045,2970
27710,312,4440,1085,2946,17682,1494
59174,4777,91603,400,69721,281327,21882
5245,146,3488,1419,2193,30097,1295
52652,72,755,598,651,24806,104
24762,29,591,1149,465,13034,126
15600,88,2236,1310,1478,40561,758
31087,3458,65523,1019,45551,151605,19972
5038,6,409,1421,285,17741,124
12236,90,3175,1356,1618,33069,1557
66192,22,293,183,242,4057,51
67927,64,810,128,666,8383,144
67243,18,333,149,279,3950,54
66163,86,1146,183,942,11711,204
56954,490,11670,466,8687,39024,2983
29391,15,769,1052,485,6670,284
23315,6,192,1180,151,5079,41
4000,17,557,1435,411,15160,146
58143,25,333,434,249,6763,84
22742,151,3713,1189,2539,31423,1174
6376,22,693,1405,458,46255,235
31753,31,569,1009,391,10051,178
38335,28,895,861,620,11344,275
22622,585,12493,1191,8940,50506,3553
38331,536,8652,861,6865,89021,1787
66222,110,1645,182,1465,18322,180
42950,7,172,787,132,4734,40
67938,106,1376,127,1090,12418,286
4412,283,9647,1430,6549,47295,3098
20155,50,1393,1231,962,18047,431
50201,102,1790,669,1333,30781,457
22832,31,577,1187,393,12935,184
39804,2,76,837,56,5105,20
32529,39,626,997,413,8699,213
50096,1662,32466,672,23934,220090,8532
61728,78,1354,310,1120,17218,234
38156,47,1207,865,879,17859,328
52343,13,314,609,284,10559,30
69029,36,578,90,508,7413,70
34832,26,1166,951,776,7014,390
67438,27,463,143,397,12415,66
21315,186,5503,1211,3017,50334,2486
14860,226,7311,1321,5079,33562,2232
16152,2,134,1301,89,24572,45
8251,5,493,1383,260,4630,233
21280,28,603,1211,422,8889,181
37117,318,5370,894,4232,29511,1138
57746,69,740,447,622,9858,118
15003,178,3468,1319,2412,24951,1056
31545,220,3141,1013,2285,24536,856
38648,32,867,852,640,18136,227
63128,66,1145,269,832,8976,313
3080,7,240,1445,149,10506,91
19047,9,199,1251,147,8833,52
14196,41,2110,1329,1571,24542,539
64954,35,1109,214,760,13942,349
1889,73,2056,1455,1434,29188,622
56633,91,919,477,724,7526,195
22658,197,3982,1191,2847,46515,1135
61919,27,430,304,327,6513,103
36336,2844,35405,913,28067,231793,7338
10901,6521,208740,1368,121784,829973,86956
25941,9450,258001,1124,160957,894679,97044
38215,24,307,864,196,5279,111
12599,49,1916,1352,923,10532,993
59978,16,268,372,247,9672,21
32035,44,624,1005,400,15530,224
51229,175,3538,643,2732,27709,806
29363,179,5952,1053,4655,40883,1297
27780,907,16083,1084,10517,81421,5566
23744,27,495,1172,354,12442,141
60949,115,1343,336,1081,9185,262
63392,126,1201,263,948,12779,253
10956,108,3258,1368,2025,35466,1233
62682,5,90,280,70,3163,20
13077,3,242,1345,100,11793,142
26646,79,1330,1108,849,10782,481
16028,7074,152556,1303,97652,713424,54904
23309,101,1347,1180,823,15031,524
4336,82,2552,1431,1884,19545,668
50910,116,1671,652,1307,13861,364
56420,316,6696,483,5595,57156,1101
14431,1417,40201,1326,27890,310009,12311
17309,42,519,1282,313,7366,206
35824,2,45,927,38,1384,7
37383,68,1489,886,1179,23803,310
36714,1131,37932,904,31780,180412,6152
8675,3,240,1381,161,8553,79
13975,17,755,1333,416,7939,339
28241,42,1076,1074,697,15828,379
45065,49,651,762,544,14903,107
15079,26,834,1318,628,13879,206
5011,3,154,1422,105,9196,49
56374,7,89,484,81,4196,8
32594,371,24385,996,16293,84077,8092
66032,11,84,188,66,3498,18
23824,18,543,1170,379,9434,164
36871,224,5473,901,4782,58608,691
68971,89,1892,92,1586,15557,306
52496,317,5879,604,4449,41510,1430
3075,478,16303,1445,10421,97116,5882
25665,57,1522,1130,899,12767,623
10038,35,984,1374,621,24240,363
65680,35,328,197,252,4399,76
17916,721,15700,1270,9876,130353,5824
54096,37,601,554,449,8762,152
12275,36,764,1356,488,10983,276
51528,2,43,630,35,2420,8
17190,262,8896,1284,6277,50733,2619
65295,8,60,207,47,2770,13
7266,77,3674,1393,2571,41502,1103
38387,15,283,859,190,8488,93
66981,233,5033,158,3728,43699,1305
3593,54,1359,1440,929,26528,430
4784,5726,115537,1425,71883,370599,43654
15676,41,1187,1309,846,14554,341
58895,96,831,409,621,7525,210
17475,7,123,1279,86,24452,37
24625,70,1479,1152,1015,18494,464
6546,1848,49111,1403,30612,194890,18499
59086,34,804,402,562,12691,242
11863,82,2611,1360,1230,39509,1381
43143,202,1196,784,880,14317,316
38655,28,786,852,581,25905,205
21503,158,6955,1207,4619,35955,2336
62102,12,76,297,71,6321,5
68113,4,29,122,24,1809,5
63930,584,9355,247,6219,32329,3136
29188,187,3565,1056,2593,26601,972
27191,29,739,1097,560,13269,179
34543,140,4177,959,3103,44329,1074
58869,33,541,409,424,8689,117
3359,127,5256,1442,3466,75315,1790
57733,83,975,447,854,10902,121
52685,25,311,596,223,3344,88
918,24,1325,1462,882,31836,443
14717,19,1189,1322,793,10022,396
7183,8,653,1394,379,13371,274
25029,10233,252091,1143,159388,732744,92703
56946,92,883,467,700,9702,183
11580,27,1642,1363,917,19149,725
3991,16,704,1435,490,41236,214
8690,1,261,1381,139,11182,122
30645,24,854,1028,569,28060,285
54860,73,772,526,559,11818,213
6075,1115,42932,1409,30655,239087,12277
38091,67,1035,867,863,7531,172
7457,2,252,1391,169,8856,83
19377,3617,111444,1245,75423,714137,36021
18242,18,899,1265,621,18674,278
22177,57,2744,1198,1725,33537,1019
29425,70,1694,1052,1193,16030,501
31595,77,2620,1012,1820,37448,800
5234,78,3147,1419,2017,33983,1130
26766,1301,38412,1106,25532,120668,12880
37814,10,246,874,158,5397,88
32044,8,403,1005,278,4508,125
7393,30,1110,1392,748,24620,362
51001,219,3849,649,3029,27524,820
60981,43,285,335,246,6225,39
47911,22,300,728,238,18755,62
51129,115,1159,645,888,17810,271
59693,6,86,382,64,2352,22
30674,38,1887,1027,1093,20338,794
19018,265,5874,1251,4107,62793,1767
31839,763,20531,1008,12368,92396,8163
57511,36,296,454,261,12703,35
7165,9,316,1395,200,8417,116
58554,344,3541,419,2221,17376,1320
54144,160,2136,553,1609,18772,527
8113,2,313,1383,218,5496,95
36227,16,246,917,211,11937,35
54858,91,1007,526,755,15575,252
60961,48,574,335,460,7192,114
21824,130,4538,1203,2991,30588,1547
63211,15,306,267,201,7818,105
26472,10,688,1113,427,15064,261
5794,591,19759,1412,12700,58968,7059
7484,7922,205859,1391,119366,596800,86493
10358,107,2933,1372,1653,25995,1280
2227,378,6931,1452,4823,20363,2108
37983,20,263,870,202,5150,61
18155,640,17532,1267,11763,94870,5769
19397,31,660,1245,483,6226,177
11135,4415,120423,1366,67705,302345,52718
29668,48,2026,1048,1213,49722,813
51136,3579,88205,645,63502,882082,24703
41839,27,668,805,500,12717,168
20985,76,2221,1217,1660,42699,561
22652,90,2863,1191,1943,32156,920
50323,16,190,666,138,4536,52
65740,172,3110,196,2489,25316,621
18453,32,506,1261,360,10618,146
29898,35,1240,1042,799,16055,441
60357,18,204,358,157,5518,47
19129,23,739,1249,570,13286,169
46453,40,655,747,518,22006,137
10386,2356,100723,1372,55838,572581,44885
60709,8,154,345,134,15636,20
40988,17,407,818,319,7387,88
47675,43,852,731,690,11726,162
53298,73,900,579,753,12349,147
28462,190,1606,1070,1335,14813,271
66124,583,10328,185,8327,63635,2001
16173,72,1929,1301,1263,13689,666
4947,3091,81573,1423,46535,201722,35038
13494,24,1600,1339,889,12344,711
19687,10,164,1240,145,17556,19
56956,43,335,467,263,4079,72
40347,25,433,829,373,9350,60
9709,106,2456,1376,1756,61801,700
7107,85,4738,1396,2991,49067,1747
25821,2,63,1127,56,12101,7
843,76,1901,1463,1310,35217,591
49430,662,11260,684,8483,91675,2777
56003,21,344,495,210,7326,134
5994,21,866,1410,606,15432,260
32863,29,822,991,525,7740,297
16542,168,3009,1295,2235,31246,774
15855,521,12209,1306,8494,142137,3715
38031,18,315,868,253,15139,62
11068,1453,65053,1367,35407,332235,29646
49490,20,284,688,230,17120,54
15548,100,4787,1311,3577,63925,1210
65893,96,1650,192,1454,26138,196
66185,685,8269,183,6035,26344,2234
21103,1026,20758,1214,13993,140377,6765
27463,8162,271653,1091,151707,977815,119946
60995,3,136,334,105,3151,31
38524,390,9344,855,6724,27378,2620
37545,421,9749,881,7811,63854,1938
61005,152,1455,334,1268,21676,187
53318,609,8394,578,6944,68161,1450
28332,0,58,1072,36,8718,22
8023,2142,31215,1384,19735,89727,11480
37395,8,215,885,172,7416,43
14619,19,907,1323,643,21775,264
41504,146,2602,811,2225,43768,377
17365,136,2775,1281,1954,15142,821
42580,306,7067,794,5714,63740,1353
46245,88,1063,749,887,10278,176
60672,10,113,346,96,7781,17
26577,144,3825,1110,2374,45163,1451
36376,97,2128,912,1798,17090,330
58164,227,2438,433,1945,18029,493
60892,0,27,338,22,3571,5
11356,1974,57527,1365,37076,161433,20451
38448,1037,13511,857,10570,77039,2941
62928,2686,54489,274,43807,209900,10682
16162,1301,40045,1301,29071,177817,10974
59089,19,226,403,188,6460,38
12384,15,707,1355,408,40559,299
62075,37,220,298,194,5078,26
475,301,14697,1466,10008,131260,4689
53278,125,3757,579,2514,33900,1243
67548,53,820,139,610,12390,210
31651,9,280,1011,175,5335,105
20478,20,765,1226,498,12955,267
2527,22,936,1450,615,27742,321
13148,437,22220,1344,12423,127146,9797
17928,39,951,1270,695,12595,256
41962,45,451,803,393,8156,58
49524,19,228,687,165,6453,63
32537,96,3695,997,2536,26741,1159
62748,15,483,279,212,3606,271
59160,0,11,400,9,1850,2
18425,259,4577,1262,3148,52935,1429
59849,17390,687502,377,382327,2631012,305175
32466,27,288,998,235,11958,53
34194,36,877,966,618,16667,259
56800,275,6655,471,5029,58121,1626
36428,87,1655,910,1223,29208,432
48298,8,143,723,111,17748,32
17014,41,936,1287,628,11075,308
61218,2988,86914,326,65035,403259,21879
22752,0,51,1189,44,11279,7
19334,53,927,1246,599,9464,328
63150,42,1085,269,881,17248,204
55914,433,10265,497,8218,98474,2047
13366,7137,249870,1341,148451,1155478,101419
60881,14,181,339,139,5374,42
12972,13,1018,1347,580,30465,438
35870,8,187,926,123,7382,64
68473,5,90,110,72,4089,18
55857,21,315,499,242,5821,73
36388,6,415,912,334,11403,81
52064,9,82,618,73,5507,9
33702,417,5895,975,4211,20327,1684
5736,33,1416,1413,1020,19392,396
4257,80,2969,1432,2102,45554,867
57967,74,1243,439,1013,16606,230
43769,105,1539,777,1137,13563,402
58757,41,448,413,370,8851,78
32334,8,485,1001,314,17950,171
11996,18,526,1359,290,16950,236
53279,4,85,579,73,6615,12
26390,18,642,1114,433,3886,209
20307,5,142,1229,117,7303,25
15589,319,4552,1310,2972,51739,1580
13317,7172,200662,1342,127659,819726,73003
1377,799,79753,1459,51842,227892,27911
40741,81,2001,823,1527,19474,474
50833,4,287,654,146,10832,141
53954,24,196,560,178,4148,18
16830,3,173,1291,122,10781,51
25546,65,1247,1133,916,21789,331
46211,80,1047,750,843,9065,204
26556,3437,91259,1110,49311,245378,41948
61971,30,363,301,327,5927,36
60894,9,92,338,34,3928,58
41198,8939,308325,816,233407,592429,74918
42374,0,108,797,50,5501,58
40825,243,5419,822,4074,33474,1345
15554,1,129,1311,79,20257,50
28604,7,167,1068,149,24056,18
3354,17,394,1442,233,12724,161
32327,81,2484,1001,1507,20017,977
17785,243,7385,1273,4732,68476,2653
56817,9,145,471,121,4817,24
23242,8,137,1181,107,4412,30
36461,31,345,909,241,4409,104
63001,22,317,273,230,5171,87
41204,79,1178,816,955,9931,223
55476,13,144,509,100,12596,44
35275,92,2007,939,1403,22468,604
12630,72,1272,1351,776,13170,496
59507,117,1696,388,1294,26299,402
63920,1202,23189,247,19324,103022,3865
60007,19,269,371,174,11692,95
46499,11,419,746,335,18229,84
26354,4770,150722,1115,94519,497821,56203
29449,32,1000,1051,599,28441,401
25162,356,8051,1141,6092,133425,1959
42073,31,381,801,267,3649,114
27501,221,4312,1089,2625,34608,1687
194,788,32039,1469,21800,143219,10239
61786,33,451,308,326,9477,125
52723,110,1078,595,881,15842,197
34243,8,174,964,128,8463,46
52288,5,36,611,29,2493,7
61055,6,80,332,61,6741,19
24055,72,3211,1165,1857,21716,1354
12526,67,3843,1353,2210,53716,1633
29037,8,554,1059,330,10170,224
56299,2,78,486,63,6714,15
22190,300,21033,1198,14271,212963,6762
38118,231,4432,866,3733,29497,699
66896,95,1726,161,1418,17200,308
62473,19,197,286,157,4560,40
20851,210,4896,1219,3067,36273,1829
62539,7,119,284,98,6978,21
28341,8,229,1072,161,21269,68
8210,21,600,1383,385,19632,215
41303,34,430,814,350,10855,80
14485,69,1894,1325,1371,14338,523
2338,109,3460,1451,2238,50044,1222
33562,2002,49497,978,30284,166208,19213
28943,5,315,1061,189,6680,126
27594,4409,140946,1087,90272,678820,50674
2215,634,10737,1452,7253,163630,3484
13846,107,5280,1334,3212,38459,2068
39027,38,781,847,560,10313,221
29764,2,48,1045,32,6941,16
65581,4,45,200,39,2019,6
54539,229,2542,539,1957,20003,585
53294,237,5350,579,4261,44565,1089
57426,7,275,456,223,4796,52
49014,9,193,699,148,10701,45
18491,72,2098,1261,1443,24163,655
13114,6,348,1345,202,14981,146
1765,96,2983,1456,2022,66759,961
29364,14,282,1053,198,9536,84
20943,8,653,1217,445,23076,208
7391,106,5194,1392,3716,75862,1478
24569,16,407,1154,283,9029,124
3325,4759,155277,1442,91501,389713,63776
49635,200,2682,684,2072,37631,610
18573,48,1326,1259,1080,65819,246
63549,2,79,259,59,6312,20
44081,27,436,773,337,11966,99
25498,8,223,1134,125,7608,98
56472,36,630,481,464,15032,166
28545,7631,192471,1069,130175,693435,62296
8653,12,529,1381,366,9345,163
53568,44,541,572,470,9577,71
21473,57,1778,1208,1213,11145,565
29756,673,15619,1046,11373,34935,4246
63498,6,70,260,56,3494,14
4246,38,1224,1432,921,14813,303
8451,501,17541,1382,10966,106086,6575
60329,181,2741,360,2233,24202,508
18272,5583,105453,1265,70064,336416,35389
33142,35,1097,986,725,27715,372
65283,4,50,207,41,3331,9
29203,80,1654,1056,1076,15888,578
59051,20,192,404,138,3939,54
42306,124,1220,798,927,17516,293
23558,46,663,1175,471,10459,192
52645,39,501,598,416,7534,85
3637,34,1334,1439,889,32128,445
62492,9,139,286,88,3397,51
362,2149,72144,1467,50221,222071,21923
61070,286,4157,331,3425,35694,732
55400,422,5168,511,4081,31556,1087
23611,11,725,1174,498,13861,227
8063,5,820,1384,498,9893,322
13819,0,29,1335,21,3293,8
34972,94,2889,947,2098,30507,791
2971,2188,135104,1445,87356,839388,47748
27808,430,7744,1083,4920,55440,2824
31669,4082,58616,848,47584,237260,11032
30440,3,73,1031,49,5023,24
21037,917,37461,1216,29020,173494,8441
20631,25,521,1223,407,8503,114
32815,324,7166,992,4988,47081,2178
46048,48,860,751,567,10110,293
45679,144,2568,756,2015,50238,553
28920,106,2548,1061,1601,22259,947
29025,1635,50485,1059,36072,198273,14413
63033,123,1882,272,1580,23750,302
16672,1,85,1293,60,6181,25
47026,7,60,739,43,8026,17
8666,182,11086,1381,7415,102111,3671
27542,513,9476,1088,6538,73706,2938
64413,223,2271,232,1764,12113,507
6809,12,397,1400,253,39024,144
39332,28,691,843,594,13759,97
60037,56,512,370,420,8265,92
60804,1137,24504,341,18173,92626,6331
21728,10,205,1204,140,17234,65
16332,272,2940,1299,2367,40083,573
54023,8,147,557,140,6199,7
62632,34,247,281,205,11345,42
68724,4,45,101,25,2580,20
6952,199,11176,1398,7298,89842,3878
31734,5,112,1009,85,2207,27
16343,117,1295,1299,854,27388,441
5402,30,1174,1417,753,20814,421
31587,449,8649,1012,5904,52511,2745
64769,2440,86649,205,65148,299482,21501
34816,45,441,951,301,4859,140
22948,21,457,1185,337,15853,120
41561,2101,23033,810,16662,149906,6371
43218,1,55,783,37,1675,18
59901,261,6017,374,4987,51018,1030
60802,9,52,341,43,4153,9
1860,19,923,1455,675,23015,248
54825,1494,13376,528,10733,67771,2643
68622,11,206,104,156,4860,50
34554,1,47,958,30,3253,17
43609,4296,77605,778,56995,569814,20610
63448,10,108,261,69,2899,39
32588,30,1044,996,644,10783,400
51623,160,1694,624,1291,17376,403
19295,17,694,1246,532,14617,162
68498,55,1967,109,1169,16793,798
50777,13,299,655,215,5812,84
63289,17,363,265,253,7267,110
28410,110,2734,1071,1881,18926,853
15241,9,450,1316,297,24850,153
26604,17,710,1109,444,15967,266
54000,41,834,558,611,12319,223
68134,18,146,121,113,4921,33
14170,179,6068,1330,4152,37685,1916
15506,13754,363804,1312,236184,753567,127620
10166,1093,26911,1374,17684,99211,9227
9260,4,169,1379,105,10987,64
32014,17,556,1005,318,10704,238
57486,45,293,454,236,6249,57
16051,5,160,1303,113,33137,47
6708,101,3187,1401,2533,31462,654
55327,15,131,513,107,5454,24
31192,86,1284,1018,950,21938,334
50270,23,320,667,243,4731,77
46187,1,312,750,212,9480,100
19228,129,1846,1248,1383,27668,463
5273,1,72,1418,48,5514,24
35476,50,1354,935,967,10916,387
14568,476,14467,1324,10093,100001,4374
21759,115,1934,1204,1271,14421,663
28897,46,864,1062,589,43857,275
3256,68,1201,1443,809,21647,392
4976,4,190,1422,142,11957,48
54369,27,374,545,306,15708,68
48137,41,647,725,528,9503,119
20081,98,2220,1232,1597,34980,623
15668,33,2024,1309,1328,16677,696
41450,52,903,812,673,11626,230
67939,61,967,127,787,5615,180
43177,397,8988,783,7065,55065,1923
63346,231,3122,264,2079,40139,1043
8600,24,1077,1381,718,15513,359
67963,1,22,127,16,1773,6
53053,288,3035,585,2446,58184,589
19185,3,53,1249,42,5359,11
22471,186,5161,1194,3634,40241,1527
22616,414,8436,1191,5125,70918,3311
28803,50,2855,1064,1281,14853,1574
17729,36,2299,1274,1652,65780,647
33834,6,130,973,90,5052,40
33471,57,1330,979,830,13081,500
31807,726,10149,1008,6276,40383,3873
20333,38,921,1228,653,16936,268
13220,248,2910,1344,1910,45039,1000
48899,7,79,699,62,5683,17
58806,386,6392,411,5386,42892,1006
53881,35,403,562,369,7050,34
37099,4,72,894,66,4373,6
61113,410,3378,326,2847,22563,531
27582,14,460,1087,314,10094,146
13128,1011,46843,1344,28368,157893,18475
36988,83,3192,897,2405,34669,787
19082,13,544,1250,419,7373,125
63874,2818,43309,224,34051,163969,9258
60237,5,199,363,134,3742,65
59777,8,113,379,81,10635,32
64260,90,1892,236,1491,32627,401
11589,45,1650,1363,996,10622,654
5763,147,2200,1413,1313,37352,887
20507,22,1023,1225,714,16989,309
26042,78,1458,1122,945,12502,513
36467,14,278,909,227,9359,51
43065,14,333,785,258,6567,75
11612,22,1135,1362,672,21866,463
43721,92,799,777,573,10555,226
17141,73,1714,1285,1245,36160,469
53951,5,49,560,34,3229,15
4832,175,6054,1424,4054,33572,2000
1345,4589,124677,1459,73435,355760,51242
61505,5,79,317,67,3537,12
26335,1278,34566,1116,22039,199512,12527
3506,447,11195,1440,8254,32169,2941
28308,5,223,1073,148,14209,75
67465,15,139,143,113,2525,26
50521,340,6664,661,5027,67681,1637
30654,49,1044,1027,653,13200,391
46186,34,481,750,377,6341,104
33285,56,1398,983,928,7724,470
18981,8220,312793,1252,192338,1010255,120455
18280,20,582,1264,386,25607,196
19436,71,2334,1244,1392,31686,942
32689,122,2134,995,1570,37407,564
22792,9,235,1188,183,12147,52
905,671,22716,1462,15089,66472,7627
49820,24,434,679,301,5390,133
552,61,2466,1465,1760,82683,706
16905,156,3375,1289,2272,49849,1103
12847,15,907,1349,520,23037,387
53098,21,439,583,348,27804,91
32613,172,4315,996,2648,28084,1667
26953,301,13012,1101,8396,91122,4616
7672,151,4990,1388,3078,28094,1912
61150,3,63,328,54,7238,9
37275,1,47,888,37,4656,10
26638,344,7464,1108,4909,54649,2555
35811,97,2005,928,1233,14490,772
53438,39,553,575,461,8967,92
64143,8,120,240,62,2103,58
63855,73,1513,250,1237,10677,276
16598,241,8190,1295,4525,25796,3665
39015,8,234,847,173,6823,61
5164,4681,176110,1420,111708,397749,64402
56887,1,7,469,7,1459,0
13721,17,490,1336,291,9026,199
7480,66,2922,1391,2086,34159,836
330,158,5551,1467,3251,31527,2300
15568,163,3119,1311,2088,56020,1031
30254,1518,24474,1035,18113,175095,6361
18387,6,312,1262,231,8919,81
32551,168,4338,997,3063,36885,1275
59676,13,124,382,89,4797,35
56086,539,14722,492,12724,92275,1998
24073,143,1553,1165,1140,98553,413
45756,91,2469,755,1588,11121,881
26903,666,10406,1103,6125,70514,4281
13122,105,3566,1345,2219,59432,1347
2097,309,5000,1453,3226,27199,1774
19972,105,2360,1235,1720,37370,640
39071,205,4838,846,3428,84952,1410
15844,12,469,1307,290,7133,179
30631,4355,86950,1028,63548,237485,23402
7684,7,351,1388,229,30959,122
66969,25,191,158,158,2341,33
32999,168,3654,988,2217,24314,1437
15121,72,3632,1317,2295,35871,1337
23609,105,3981,1175,2427,66591,1554
42113,33,619,800,473,14769,146
58394,923,12364,425,9402,102253,2962
38565,20,398,854,298,3898,100
22656,88,1574,1191,1058,35880,516
15504,26,1017,1312,724,54362,293
9961,58,2019,1375,1111,20030,908
22847,1763,51821,1187,33171,222780,18650
49838,0,8,679,4,1717,4
13680,30,449,1337,288,9759,161
51552,4,148,634,111,6098,37
50530,216,2176,661,1775,29684,401
38151,7658,102280,865,71162,362006,31118
13964,36,497,1333,375,19296,122
67572,43,1365,139,1031,18995,334
27275,29,1380,1095,812,13970,568
15708,467,16901,1309,11046,108262,5855
7119,94,2013,1395,1115,43791,898
53646,85,649,553,550,10459,99
20033,79,5346,1233,4110,57287,1236
49484,33,581,688,474,15229,107
61857,92,901,306,699,15496,202
21281,40,1642,1211,1208,19068,434
60073,631,10771,369,7634,43415,3137
17868,50,1520,1271,975,26034,545
11851,42,2224,1360,1085,16528,1139
5036,12,404,1421,316,19765,88
9782,31159,1144859,1376,688792,2961893,456067
27242,84,3640,1096,2083,17362,1557
31034,823,22383,1020,14472,50899,7911
227,149,8783,1468,5541,43334,3242
66271,36,409,181,327,3722,82
30823,3715,84051,1024,55557,249352,28494
17470,4,135,1280,113,11547,22
22976,88,2228,1185,1456,21557,772
4629,28,1830,1427,1290,49339,540
68568,7,47,106,37,2174,10
2702,5,219,1448,146,11970,73
25477,33,726,1134,525,9230,201
62741,27,429,278,335,9868,94
23843,173,1861,1170,1229,22445,632
16879,16,689,1290,570,36100,119
10000,53,1185,1374,661,19560,524
8899,19,1131,1380,680,20898,451
66536,451,6100,173,5076,24832,1024
11648,75,2379,1362,1388,22580,991
32168,19,1637,1003,1077,28455,560
51142,7,45,645,32,4130,13
27630,99,1965,1086,1408,36620,557
29123,4427,164366,1057,122124,646292,42242
40673,4,164,825,133,13773,31
32896,54,1878,990,1247,37839,631
34469,512,9318,960,5669,47755,3649
184,235,13096,1469,9400,110067,3696
61939,77,1036,303,774,14086,262
16441,33,865,1297,619,14929,246
11636,34,758,1362,414,6462,344
37978,2919,112133,860,77709,495897,34424
20214,68,1719,1230,1214,19458,505
29375,4131,83415,1053,54787,354683,28628
36447,43,788,909,617,20899,171
31647,69,1694,1011,1156,23191,538
10590,60,2309,1371,1392,21512,917
2977,35,996,1445,704,50581,292
28847,125,2202,1063,1708,34744,494
33065,22,825,987,500,17131,325
19505,115,3402,1243,2182,30799,1220
68413,47,647,112,507,10257,140
58018,216,2519,438,1957,33610,562
22319,7,499,1196,348,8417,151
32829,35,1234,992,757,18588,477
298,52,2768,1467,2036,23884,732
63343,11,134,264,102,3884,32
67507,538,11755,141,9275,68144,2480
25506,97,2240,1134,1569,37534,671
26502,1062,23427,1112,15271,100712,8156
40689,21,916,824,696,36224,220
52602,406,4428,600,3443,32956,985
10180,429,23523,1373,16204,135873,7319
57971,53,1009,439,794,30292,215
2886,20,1149,1446,898,49736,251
39167,144,2712,845,2057,56703,655
26249,8,749,1118,491,27112,258
9870,87,2205,1375,1306,28511,899
68174,6,126,120,107,3428,19
10401,3,225,1372,97,6627,128
45140,247,6333,762,4924,57692,1409
55758,100,1159,502,922,13695,237
14924,2,338,1320,259,9854,79
15077,4,715,1318,489,29478,226
64417,46,971,232,761,18744,210
50996,65,828,649,602,19934,226
67987,978,19814,126,16339,109893,3475
21134,22,429,1214,283,4059,146
27347,14,508,1093,311,24605,197
60982,64,473,335,381,8797,92
41432,13,335,812,276,18271,59
26462,2,234,1113,144,5784,90
16613,14,795,1294,480,12930,315
20610,28,1595,1224,1151,24852,444
9411,185,5314,1378,2921,30928,2393
8390,9,502,1382,309,12204,193
36827,189,2580,902,2149,43977,431
32464,77,2128,998,1348,15030,780
9966,67,3917,1375,2122,18054,1795
36816,138,1871,902,1418,27050,453
8358,1228,34009,1383,23292,216067,10717
35740,5,239,930,164,3496,75
30004,43,1351,1040,823,32172,528
58705,4008,86064,414,61886,193167,24178
1835,28,968,1455,688,16206,280
35163,134,2744,943,2041,45061,703
4985,66,1080,1422,717,32995,363
8855,16,947,1380,616,18176,331
20990,0,0,1217,0,4196,0
32389,160,2684,999,1791,21670,893
27720,15,317,1085,194,8875,123
21543,87,2443,1207,1901,31900,542
64888,4,88,218,57,5375,31
65528,833,12274,201,10364,96287,1910
5037,5,182,1421,128,8647,54
33994,791,13579,970,9630,50820,3949
37544,118,2986,881,2631,50321,355
50005,1216,11175,674,9179,99764,1996
17261,36,531,1283,380,14526,151
31163,102,2495,1018,1599,72940,896
36754,70,1102,904,882,9807,220
34283,14,747,964,491,18389,256
67913,8,155,128,131,2645,24
55772,108,864,501,677,13147,187
58185,1,61,432,48,2976,13
62470,386,10797,285,7969,136558,2828
3636,12,956,1439,646,22342,310
25316,190,2182,1137,1331,12360,851
17284,7,129,1283,99,11208,30
49879,4,126,677,109,5395,17
30502,3,149,1030,102,2454,47
30265,0,79,1035,62,3291,17
2555,5,226,1449,131,7804,95
35421,38,1043,936,773,21739,270
30248,206,8209,1035,4849,60922,3360
61283,7,88,324,76,4767,12
23870,1845,47481,1169,32020,140975,15461
24491,67,1322,1156,821,13432,501
57456,1766,26311,455,19457,120634,6854
3821,107,5108,1437,3456,41789,1652
34214,9,274,965,183,5833,91
62051,28,343,299,265,6142,78
21495,33,412,1207,297,6178,115
33153,14,491,986,295,15203,196
62924,20,315,274,251,8368,64
31495,59,985,1014,721,16171,264
51102,19,247,646,180,3899,67
15544,2,92,1311,64,6086,28
64438,9,209,231,160,6505,49
38164,8336,185006,865,142780,885982,42226
11352,174,5453,1365,3429,39331,2024
8665,38,615,1381,337,10034,278
2206,46,1611,1452,1193,17467,418
24575,23,615,1154,422,9181,193
23043,465,8596,1184,6121,36776,2475
7078,100,2570,1396,1617,22255,953
54084,100,1615,555,1220,18334,395
51478,5,119,636,97,6738,22
52342,2,37,609,22,3033,15
64978,164,2346,207,1858,24265,488
60205,1474,41064,364,31052,130977,10012
4347,8,418,1431,299,29924,119
1152,19,705,1460,562,21853,143
64333,0,49,234,32,2754,17
61035,11212,213186,332,152627,735269,60559
23646,122,1497,1174,1234,35748,263
46828,2,133,742,94,4574,39
61777,53,1524,309,1135,35337,389
21403,13,333,1209,251,13559,82
68771,39,477,99,427,7085,50
2677,65,1632,1448,1024,20454,608
68840,13,139,97,119,3137,20
38195,80,937,864,641,11858,296
30386,169,2678,1032,1754,34636,924
56417,146,1498,483,1137,34333,361
22735,127,2431,1189,1679,21335,752
23725,21,708,1172,478,6303,230
373,339,26497,1467,17351,142908,9146
27841,22,879,1082,597,20930,282
19237,54,1319,1248,1034,9715,285
378,506,20077,1466,13139,96768,6938
50982,62,1098,649,838,20098,260
18904,53,1468,1253,1070,19129,398
52991,186,2744,586,2361,34173,383
19510,50,1469,1243,1013,19212,456
11786,1,239,1361,108,4881,131
4776,5,351,1425,204,6551,147
23848,537,17725,1170,12369,127731,5356
35744,3,129,928,93,4446,36
23081,114,1996,1183,1304,47364,692
12649,95,8599,1351,4267,33422,4332
59891,94,1503,375,1169,18807,334
46795,47,705,742,599,12051,106
23160,39,2230,1182,1587,42473,643
60341,1,8,359,7,1208,1
53436,20,245,575,202,7372,43
67762,6,112,133,89,4941,23
10680,246,6844,1370,4404,64435,2440
56431,74,1126,482,959,21329,167
36211,2,130,917,103,4347,27
61946,52,415,303,289,4356,126
66538,10,68,173,50,4060,18
35552,216,3998,932,3125,25591,873
59397,71,679,392,523,4279,156
1135,33,960,1460,697,22829,263
5221,14,421,1419,296,8421,125
35506,4736,104815,934,80274,420243,24541
45907,15,165,753,129,4743,36
41587,190,4322,809,2711,27684,1611
43436,34,783,780,582,11785,201
14732,53,2830,1322,2014,25091,816
7152,50,1464,1395,992,30918,472
56153,53,677,490,579,11877,98
54199,459,5118,547,3890,36636,1228
20426,8,265,1227,223,8572,42
31693,90,3210,1010,2216,32299,994
27127,4,317,1098,202,9775,115
8475,24,1139,1382,681,14542,458
67190,27,702,151,590,16796,112
7316,79,12440,1393,5753,49488,6687
46740,39,611,743,524,11250,87
17943,2,148,1270,114,8696,34
57818,16,280,444,247,11443,33
39280,24,792,842,591,21616,201
38280,142,1448,862,991,11072,457
58375,24,384,426,324,4110,60
15515,180,5061,1311,3479,57917,1582
32681,201,2506,995,1661,17158,845
49328,24,319,692,244,4036,75
13305,239,7677,1342,4608,55436,3069
31646,5,134,1011,94,5640,40
37458,52,914,884,694,8839,220
31454,72,1418,1014,866,16125,552
61978,294,4432,302,3582,32089,850
5942,220,7127,1411,4919,97083,2208
1634,31,1344,1457,860,43619,484
50645,69,776,658,635,7306,141
59526,5,67,388,51,2967,16
59056,2783,53735,403,42319,234326,11416
49070,45,938,700,736,16527,202
27484,27,1001,1090,689,23823,312
16901,157,4092,1289,2532,40280,1560
54232,14,186,550,145,6583,41
17363,25,459,1281,340,16338,119
43817,8,154,777,127,2984,27
9843,1087,30733,1376,20720,118844,10013
7843,10,341,1386,276,9991,65
56967,155,5693,467,4074,42532,1619
60049,12,102,370,84,5113,18
8629,51,1392,1381,914,8821,478
68741,32,246,100,217,5910,29
17032,10,182,1287,149,11780,33
9504,9063,321445,1377,192880,650651,128565
30272,915,13156,1035,9174,65564,3982
9512,41,2202,1377,1427,24743,775
12799,11,750,1349,334,28352,416
3518,461,9382,1440,6282,63397,3100
60568,172,2122,350,1701,15294,421
11217,13,295,1366,161,6000,134
27906,793,15702,1080,10921,110694,4781
29333,15,246,1053,228,9325,18
9336,646,9735,1378,5783,76042,3952
28231,14,646,1074,373,8076,273
68303,3,62,116,41,8103,21
11777,150,5400,1361,3043,66712,2357
3480,949,12657,1441,8237,53976,4420
10123,681,16003,1374,11223,131531,4780
68149,46,532,121,484,9285,48
32108,123,1571,1004,1109,10717,462
11410,121,6591,1364,4325,40606,2266
7609,72,4845,1389,3162,73193,1683
5010,3523,146537,1422,107741,373403,38796
12012,13,797,1359,425,16571,372
8632,22,319,1381,214,5521,105
68345,24,329,115,261,4503,68
31074,0,0,1019,0,57249,0
19912,92,1577,1236,1313,34837,264
26569,54,1302,1110,904,15483,398
68834,10,153,97,127,3260,26
63253,6,90,266,53,6530,37
25184,74,3097,1140,2097,23272,1000
21765,3095,53541,1204,34332,119212,19209
32102,10,246,1004,166,14040,80
1544,10,687,1457,438,44623,249
32555,25,1065,996,748,7949,317
50459,7749,214742,663,156684,848374,58058
66356,55,1384,179,1142,6265,242
60636,944,15534,347,12540,137709,2994
19476,23,523,1243,371,6351,152
53503,32,315,574,264,7125,51
11422,127,5452,1364,3520,42436,1932
24821,34,894,1148,604,23398,290
21633,562,11960,1205,8100,76354,3860
8476,35,1764,1382,1086,26328,678
11534,4014,112252,1363,68168,378805,44084
18018,55,1313,1269,955,18782,358
16704,16,367,1293,277,12857,90
38130,6,149,866,110,8074,39
55105,4,42,519,35,4372,7
45652,58,790,756,622,13418,168
15408,14,449,1313,330,10819,119
27301,3091,83644,1094,52787,535184,30857
12488,268,12457,1353,7638,78534,4819
53571,711,8704,572,7270,65772,1434
18789,41,2032,1255,1508,20119,524
27028,5595,119307,1100,72890,669128,46417
63259,68,884,266,700,13296,184
37123,159,3141,893,2532,28627,609
25678,565,8493,1130,5278,83151,3215
32278,139,1837,1002,1219,12822,618
299,20,1336,1467,795,45635,541
9420,221,6107,1378,3985,34700,2122
1612,5,361,1457,202,8416,159
57712,94,1728,448,1334,30120,394
25141,16,189,1141,125,4452,64
44693,5,124,767,93,5803,31
19518,59,810,1243,603,11358,207
51096,51,419,646,327,9394,92
21198,103,3367,1213,2273,23429,1094
22891,6,118,1186,81,6710,37
21547,41,789,1207,605,18191,184
35473,12,469,935,295,8735,174
2002,178,5901,1454,3685,59220,2216
66849,22,575,162,507,8394,68
36790,3,61,903,52,6284,9
34754,69,1198,953,794,8840,404
14741,42,1315,1322,850,21799,465
8985,31,1788,1380,1113,25879,675
56547,210,3508,478,2831,24950,677
27684,0,0,1085,0,4970,0
23892,38,1196,1169,818,17691,378
64255,19,358,236,291,4803,67
8736,16,830,1381,586,12120,244
68896,671,9967,95,8640,33243,1327
10908,162,9240,1368,5237,67110,4003
13586,1025,20446,1338,14098,173048,6348
7532,210,2739,1390,2171,15968,568
20545,25,1252,1225,961,19140,291
16211,10,343,1300,221,41647,122
27875,75,1203,1081,1015,14425,188
8066,1224,30606,1384,19349,173237,11257
13033,13,784,1346,457,17488,327
47385,90,970,734,789,7235,181
66507,13,201,174,168,4120,33
16653,21,293,1294,237,14417,56
47739,25,295,730,226,7378,69
14441,206,4076,1325,3017,36456,1059
33594,9,172,978,139,8039,33
29029,42,784,1059,482,7901,302
13501,62,2641,1339,1547,20800,1094
7892,142,2491,1385,1574,13267,917
18383,80,2314,1263,1462,24813,852
56997,21,215,465,177,5459,38
12683,1184,58695,1351,37086,273103,21609
36164,37,839,918,719,42568,120
13422,25,1623,1341,1020,27512,603
41859,33,371,804,263,9464,108
60069,2,41,369,26,3205,15
61241,1,15,325,12,1766,3
14059,7,117,1331,83,3436,34
66821,44,373,163,320,5503,53
58398,18,183,425,147,5083,36
31567,590,8231,1012,5859,49722,2372
18535,11,182,1260,132,12453,50
50476,126,1800,662,1416,37520,384
62938,115,2204,274,1893,20818,311
61363,87,1011,322,761,6491,250
8080,2549,162852,1384,86712,334198,76140
38486,33,537,856,416,10309,121
25898,243,5759,1125,4640,74765,1119
11448,221,10843,1364,5850,44483,4993
68383,59,847,113,688,9523,159
37464,189,2518,883,2046,16503,472
57095,9,70,463,65,4969,5
34048,10,436,968,271,7661,165
58637,246,2885,417,2280,21305,605
629,3,206,1464,150,11344,56
29402,28,1048,1052,621,10759,427
49850,36,591,678,434,10183,157
50848,143,3288,653,2436,14870,852
34584,56,859,958,593,12586,266
60916,1169,22815,336,17694,100440,5121
7496,613,20888,1391,14243,104532,6645
15046,30,1102,1318,792,20642,310
8784,339,12648,1381,6565,81811,6083
9395,0,166,1378,109,9164,57
51390,445,7155,638,5782,46952,1373
11474,66,3670,1364,2096,30985,1574
20795,35,278,1221,232,12397,46
48552,0,30,716,24,2365,6
23626,3327,79093,1174,49092,427918,30001
21615,1226,24291,1206,15161,139988,9130
15580,0,0,1310,0,5627,0
30668,70,2754,1027,1869,12151,885
1855,25,2165,1455,1001,16627,1164
60751,18,479,343,347,6819,132
64582,29,443,227,320,4911,123
588,17,1123,1465,642,37786,481
34065,9,374,968,244,7744,130
52664,39,401,597,350,11293,51
11928,360,10867,1359,6806,94454,4061
56932,1,22,468,15,2380,7
41615,60,918,809,682,19243,236
12727,41,1228,1350,708,13387,520
19513,14,502,1243,384,17493,118
20113,88,2828,1232,1868,22771,960
66568,135,1360,171,1047,17747,313
31444,472,12951,1014,9105,56486,3846
34107,499,18599,967,11743,46028,6856
18601,678,31068,1259,20929,197379,10139
14698,305,10062,1323,7134,122746,2928
67648,21,317,137,252,12794,65
16352,54,998,1298,678,9127,320
23249,225,6212,1181,4296,45263,1916
56599,529,11949,477,9079,51523,2870
42432,413,5707,796,4641,53753,1066
222,206,3038,1468,2003,28378,1035
3300,550,16514,1442,10707,95717,5807
52314,11,116,610,101,3417,15
36857,11,336,902,259,8126,77
7200,43,1321,1394,857,43921,464
31921,10,461,1007,277,10948,184
26886,4,341,1103,222,9273,119
16532,587,27930,1295,18125,249266,9805
15500,22,958,1312,664,20835,294
1684,17,373,1456,235,8684,138
30175,7360,186014,1036,127979,786754,58035
13463,21,1043,1340,643,10303,400
56179,369,9863,489,6840,125443,3023
24237,102,1468,1162,1040,18980,428
5879,259,8819,1412,5834,41318,2985
44787,113,1735,765,1482,24613,253
5770,470,16982,1413,9621,67264,7361
53595,28,292,572,223,5425,69
20151,16,654,1231,449,4991,205
26559,198,4256,1110,3185,33509,1071
66765,58,560,165,471,5689,89
45252,138,3041,760,2487,23571,554
52115,7245,118367,616,94299,572101,24068
16022,340,17437,1303,11446,68984,5991
10891,14618,262454,1368,147260,587011,115194
29714,51,1374,1047,759,7594,615
58786,43,470,412,347,6989,123
52804,85,1039,593,817,15670,222
40460,38,936,827,725,10594,211
51396,61,894,638,698,27018,196
35792,554,8086,928,6194,62426,1892
35879,29,1084,926,803,15364,281
14113,229,7078,1330,5046,79361,2032
59929,47,569,374,470,11909,99
2009,1405,131288,1454,79563,406468,51725
52181,11,162,615,121,6196,41
17666,36,992,1276,765,26415,227
2062,122,8714,1453,5967,96695,2747
29611,438,18207,1049,12157,51685,6050
15387,326,8251,1314,5991,109286,2260
61966,40,292,302,238,3459,54
33228,24,470,984,310,7720,160
29818,47,599,1044,369,11239,230
35965,1335,16222,924,11659,159845,4563
3284,98,5711,1442,4025,27578,1686
24095,13,486,1164,321,20594,165
21972,61,1956,1201,974,18492,982
29623,36,1868,1049,1201,34163,667
17609,8197,224085,1277,164130,647716,59955
9209,934,20453,1379,12036,88193,8417
23886,948,24319,1169,16544,98277,7775
19841,5483,147661,1237,90544,442719,57117
40577,5,140,826,103,5345,37
57725,134,1924,447,1520,18682,404
55776,99,1809,501,1557,17349,252
25551,287,14109,1133,8898,115262,5211
30221,270,2529,1036,1571,19538,958
29400,13,651,1052,413,14485,238
55076,564,11037,520,8833,66070,2204
25172,4,90,1141,64,5627,26
51305,4,128,641,116,7579,12
51992,227,3276,621,2881,25295,395
14216,1388,43277,1329,29324,270184,13953
21796,21,644,1203,450,12062,194
18450,500,12217,1261,8959,41548,3258
15940,139,3511,1305,2322,41169,1189
16630,40,1270,1294,712,9177,558
52531,35,447,602,361,7555,86
15176,46,1078,1316,746,16697,332
8570,20,962,1382,600,20272,362
31809,83,1493,1008,939,26697,554
54644,170,2463,534,1950,22618,513
7056,163,4302,1396,3067,57669,1235
23948,343,4691,1168,3591,16875,1100
39289,494,9871,844,6459,49318,3412
10782,22,1018,1369,639,33415,379
54549,49,331,538,286,7517,45
4828,86,3962,1424,2920,45272,1042
5432,453,15014,1417,10665,165529,4349
31718,44,1315,1010,681,13355,634
41358,18,487,813,368,8240,119
26696,4,217,1107,140,16434,77
39069,203,1712,846,1343,11793,369
51892,103,1525,624,1245,30229,280
35260,17,248,940,165,7022,83
12188,118,3497,1357,2147,39662,1350
38567,24,763,854,484,5816,279
22828,0,0,1187,0,3669,0
30795,29,1337,1024,833,13229,504
16821,45,1987,1291,1263,38344,724
14963,18,694,1319,453,8627,241
11790,225,8308,1361,5360,56445,2948
52397,8700,167320,607,124378,531740,42942
10965,66,1737,1368,1088,28169,649
8020,43,1472,1384,962,33467,510
48571,30,361,715,295,8833,66
28881,6,116,1062,104,4982,12
14080,19,798,1331,457,19741,341
18137,14,800,1267,575,12952,225
20405,14,402,1227,299,13553,103
3333,109,6229,1442,3795,26920,2434
23669,52,869,1173,626,22996,243
62976,73,1811,273,1300,18540,511
11462,162,8632,1364,5764,51584,2868
58490,66,1044,421,835,30512,209
57602,4,40,451,37,2645,3
11859,29,1939,1360,934,22979,1005
55970,13,172,496,125,6446,47
22611,3893,107264,1192,69444,416937,37820
11122,11,809,1366,523,31968,286
23600,26749,673828,1175,393892,1809996,279936
9284,5,236,1379,182,7241,54
63276,264,5351,265,3785,54597,1566
43741,2028,50863,777,39034,218200,11829
48869,3088,59210,706,44908,199038,14302
54808,1136,12787,528,10481,106474,2306
50397,5,43,664,30,4977,13
54723,62,922,532,774,15639,148
27636,1022,41204,1086,27562,189909,13642
33185,122,3066,985,1927,84340,1139
29255,39,961,1055,578,15280,383
63243,1671,27009,266,20771,88880,6238
68545,11,111,107,92,5578,19
27697,113,3380,1085,1865,11438,1515
27847,473,12649,1082,7799,72451,4850
31287,7,135,1016,89,24484,46
62216,13,164,294,135,5942,29
21295,178,4607,1211,3053,28232,1554
53366,81,688,577,563,8538,125
26908,24,721,1102,604,24873,117
10426,126,4955,1372,3119,26795,1836
53193,3,67,581,47,3927,20
21378,699,15761,1210,9442,97362,6319
28643,71,1300,1067,849,19980,451
936,6,327,1462,238,19163,89
21964,49,1779,1201,889,57321,890
24161,138,2088,1163,1407,26928,681
26458,79,2509,1113,1753,33573,756
21499,14,707,1207,458,19819,249
17328,54,689,1282,494,12625,195
690,640,10456,1464,6433,70598,4023
8993,1,172,1380,100,3282,72
30478,30,443,1030,306,5462,137
24449,81,2410,1157,1494,32525,916
50776,78,1323,655,1161,12902,162
32202,13,374,1003,253,24397,121
50913,2,54,652,41,2003,13
35099,51,706,945,468,6508,238
41994,78,845,802,647,6210,198
50195,20,202,670,145,11306,57
33696,39,797,975,560,8903,237
66387,18,202,164,160,6002,42
59513,13,214,388,181,4647,33
67425,59,691,144,577,13113,114
56562,3,61,478,41,3122,20
7241,9453,249614,1394,143704,695014,105910
52896,193,5277,589,3790,38231,1487
27210,116,3075,1096,1837,25755,1238
67754,42,478,133,370,3799,108
19991,40,1337,1234,1021,19220,316
23562,8,480,1175,357,8155,123
66447,19,341,176,268,6298,73
10890,206,4942,1368,3273,55317,1669
38013,35,618,869,497,5915,121
21132,631,9296,1214,6151,33206,3145
56656,34,277,476,216,7782,61
27662,46,1027,1086,714,9582,313
5646,63,2297,1414,1638,13600,659
67181,516,4705,151,3724,29765,981
32144,6,167,1004,128,3271,39
13109,0,0,1345,0,14069,0
62388,8,345,289,181,7955,164
18091,820,21659,1268,16319,90542,5340
30773,16,588,1025,363,10742,225
51603,571,15715,632,12388,66413,3327
19499,21,921,1243,480,12895,441
62111,100,1922,297,1425,9446,497
33411,35,746,981,558,18427,188
223,303,12690,1468,8180,55689,4510
29006,1442,35505,1060,24850,183498,10655
27607,32,376,1087,248,5117,128
57670,27,266,449,217,6066,49
54359,5,60,546,39,1885,21
32359,244,4970,1000,3260,29728,1710
55045,30,292,521,240,7231,52
57138,10,322,463,148,8168,174
19238,19,807,1248,559,8343,248
64010,10,102,244,76,5443,26
31552,70,2384,1013,1647,41411,737
64251,1357,29554,237,22154,176973,7400
39403,12,127,843,99,6265,28
15267,27,1319,1315,966,18991,353
37997,642,11304,869,9648,105195,1656
48659,29,817,713,583,8246,234
29738,116,2509,1046,1601,28011,908
26699,5,113,1107,96,6441,17
42010,9,101,802,72,5746,29
39197,21,580,845,503,16333,77
54244,1144,15236,550,11253,80864,3983
40556,2,166,826,122,5603,44
28201,12,313,1075,194,6619,119
36712,277,5973,904,4994,39889,979
58891,12,299,409,211,4823,88
68290,4,67,116,51,2706,16
67041,21,840,156,609,9568,231
38066,1085,19618,868,14675,105769,4943
16409,39,489,1297,344,8000,145
49359,169,2958,691,2539,34198,419
68071,27,464,123,340,13072,124
61406,99,3577,320,3023,23340,554
1702,14765,574004,1456,344560,1176289,229444
30615,29,867,1028,487,9537,380
20135,5,286,1232,231,15438,55
38303,6,66,862,46,6208,20
40941,27,403,819,235,25077,168
33214,252,7733,985,5574,82896,2159
59185,96,940,400,663,8256,277
25451,2004,86809,1135,60759,479594,26050
12025,3383,136032,1359,93751,436004,42281
57963,52,1092,439,682,4040,410
3412,20,766,1441,532,20050,234
33931,42,1374,971,948,32313,426
66924,107,1799,160,1420,19810,379
34764,866,36987,952,26545,186906,10442
59687,267,3763,382,2892,28831,871
25293,23,703,1138,528,24718,175
44631,801,7941,767,6647,111624,1294
35845,89,3483,927,2418,32532,1065
55612,77,630,505,516,13450,114
41263,18,81,815,66,5686,15
9205,607,23616,1379,14060,124639,9556
2557,33,2342,1449,1565,62407,777
41634,7690,132191,806,86775,669186,45416
52443,17,384,606,240,19002,144
7011,297,8052,1397,5859,41354,2193
2524,687,34033,1450,21523,78238,12510
23111,12,200,1183,147,6355,53
22769,69,2047,1189,1491,21111,556
2653,2147,55830,1449,35451,149059,20379
33480,9,275,980,177,7708,98
169,22,775,1469,519,6681,256
6615,79,2617,1402,1685,25357,932
50028,3,92,674,79,3338,13
54358,63,597,546,524,19704,73
130,149,5451,1470,2870,41196,2581
14349,10,364,1327,261,10114,103
49057,45,761,700,631,12542,130
167,889,39143,1469,23090,85805,16053
19849,56,1925,1237,1389,25248,536
57229,33,509,460,348,21611,161
38304,4,101,862,63,2430,38
47223,19,627,736,555,25643,72
7618,332,12231,1389,7622,144951,4609
4187,9,348,1433,252,12308,96
25288,19,539,1138,357,14946,182
56071,32,375,493,296,10211,79
34738,12,236,953,171,8278,65
52580,20,403,601,318,9860,85
36764,345,3499,904,2848,31956,651
31660,9,309,1011,231,5413,78
36883,243,2735,901,2302,31061,433
33781,16,294,974,210,5138,84
46468,0,18,747,15,3134,3
54306,6434,104527,547,77948,362189,26579
27181,19,412,1097,299,17759,113
57986,4,41,438,33,2619,8
54865,5,15,526,9,2077,6
63073,16,164,271,124,4691,40
53702,68,817,568,689,13283,128
67925,48,498,127,382,4673,116
16114,3,266,1302,173,12540,93
55206,5942,97924,517,77392,363174,20532
63066,54,472,271,423,5041,49
57490,36,488,449,377,6301,111
64233,10,138,237,121,8867,17
20006,26,548,1234,401,11211,147
33325,40,492,982,341,6163,151
69050,3,57,90,48,1259,9
17400,2920,79257,1281,57125,364426,22132
19219,7,245,1248,188,11407,57
12030,22,736,1358,400,19521,336
4589,11,498,1427,285,23508,213
2384,901,43749,1451,29353,375696,14396
20951,14,199,1217,124,5220,75
30784,11,376,1024,229,15167,147
18201,0,160,1266,136,8604,24
32338,26,507,995,419,7968,88
40326,8,188,830,151,7686,37
51429,5,119,637,91,8903,28
912,673,18093,1462,12639,135504,5454
3581,58,1500,1440,948,16481,552
8710,367,10834,1381,6588,59439,4246
25640,26,442,1131,292,6970,150
25703,136,3861,1129,2343,26862,1518
3790,1054,34411,1437,23637,177498,10774
33091,185,10994,987,7731,41935,3263
24502,10,420,1155,308,15484,112
25655,424,6804,1130,4389,41310,2415
18921,8,134,1253,99,10526,35
304,15,621,1467,453,17216,168
57047,13,280,465,203,16565,77
31728,12,368,1010,231,8153,137
26214,384,11530,1119,7405,76792,4125
57880,21,436,442,373,4485,63
3525,65,1534,1440,1076,22925,458
51679,384,5252,630,4254,36696,998
23337,2859,179429,1179,104770,705864,74659
56714,8,89,474,71,8320,18
26368,473,6490,1115,4594,24859,1896
21741,416,8419,1204,6259,47720,2160
42138,26,544,800,362,9617,182
57085,15,418,464,332,7755,86
58932,42,459,407,356,9606,103
68665,57,588,103,532,12063,56
37638,375,7146,879,5313,27367,1833
37095,33,579,894,441,7057,138
24008,71,3236,1167,2173,41015,1063
20663,442,12466,1223,8976,103888,3490
66103,6,100,186,83,2088,17
25607,10984,213979,1132,136788,488033,77191
21419,319,6675,1209,4772,89543,1903
55055,54,408,521,305,13185,103
12223,234,6269,1357,3567,33244,2702
20817,5,122,1220,92,5211,30
32184,40,1023,1003,593,8868,430
14373,44,1181,1327,840,21314,341
37452,1296,20684,884,15235,82677,5449
9390,43,1119,1378,695,15229,424
60719,153,1610,342,1376,21210,234
11420,30,1016,1364,585,13801,431
27005,158,4636,1100,3786,32636,850
52158,48,573,613,425,10237,148
10387,82,1435,1372,886,12662,549
20942,229,7641,1218,5539,61862,2102
54138,265,4150,553,3275,21874,875
30317,4,204,1034,128,5124,76
38805,297,7368,849,5759,81065,1609
16637,553,7286,1294,4903,72073,2383
17445,33,1117,1280,823,15723,294
4959,8,263,1422,185,14477,78
20433,753,22934,1227,14907,147218,8027
17950,59,3261,1270,2377,40354,884
47253,25,530,736,445,9501,85
25689,156,1645,1129,1192,21179,453
48176,35,207,725,188,8556,19
60307,59,520,360,402,5460,118
40241,33,478,831,378,17165,100
4804,5505,139461,1425,72563,333511,66898
35030,32,689,946,450,9957,239
29767,18,256,1045,175,14056,81
23170,2772,121920,1182,82264,584905,39656
32737,446,12858,994,8381,121593,4477
3097,189,4128,1444,2666,34766,1462
51991,10,240,621,177,19217,63
56725,62,1041,474,906,15340,135
11780,0,0,1361,0,6696,0
9175,93,2513,1379,1731,42780,782
3200,553,13569,1443,9071,49777,4498
19770,82,1503,1238,996,9987,507
51508,38,623,635,482,5353,141
14572,11,572,1324,385,20607,187
46509,79,942,746,661,9320,281
56853,3,57,470,41,2556,16
53036,33,410,586,310,21201,100
4992,6,190,1422,116,12720,74
59524,66,891,388,709,10343,182
48993,79,1695,702,1490,16742,205
6929,66,1228,1398,797,8612,431
25796,880,15008,1127,9932,91445,5076
4325,4,731,1431,531,29144,200
22705,52,1574,1190,1102,33027,472
48650,167,1640,713,1342,27489,298
36389,245,4044,863,3241,49602,803
51397,0,31,638,26,2772,5
17883,31,331,1271,235,7025,96
29971,20,500,1041,336,7816,164
26359,10708,342549,1115,207056,610219,135493
62159,93,874,295,742,11324,132
57645,101,1368,450,945,10269,423
10644,7,269,1370,188,9090,81
13936,21,2829,1333,1490,40079,1339
30289,517,9698,1035,6695,59426,3003
19732,30,642,1239,435,10260,207
38500,110,1253,856,996,23288,257
31447,189,4914,1014,3194,35892,1720
54491,51,380,540,288,9410,92
39221,46,1411,845,1024,17376,387
65061,985,16945,206,13737,97567,3208
14168,2,128,1330,87,6797,41
6014,75,4296,1410,2976,28256,1320
36706,0,40,905,32,5869,8
32740,17,564,994,330,8221,234
35626,9,160,932,124,7404,36
549,601,22023,1465,14796,131130,7227
49335,9,83,692,73,1903,10
37052,156,2046,895,1496,29283,550
35901,33,532,926,428,13037,104
62735,219,3537,279,3030,25414,507
24704,4152,101985,1150,72679,501819,29306
37494,57,1576,883,1299,28685,277
54918,13,242,525,162,3202,80
20119,3,269,1232,205,19479,64
64740,0,2,223,2,2321,0
24766,2362,68520,1149,41604,218887,26916
35150,698,19816,942,13526,115737,6290
13940,186,5956,1333,4026,55459,1930
11604,112,3978,1363,2393,27008,1585
30407,226,6583,1032,5272,67367,1311
51270,1296,15789,642,12166,59944,3623
57536,30,312,453,269,9542,43
46855,3,47,741,39,8091,8
57394,186,1126,456,853,15199,273
27008,157,4680,1100,3299,29739,1381
32883,27,267,990,207,5761,60
24538,44,1635,1154,1080,42373,555
7670,30,444,1388,265,11710,179
52373,73,941,608,736,19205,205
36319,8,101,913,79,6184,22
52635,120,1508,598,1132,11468,376
10929,176,7798,1368,4464,46813,3334
30743,77,2948,1025,2042,33419,906
30354,41,1118,1033,948,17161,170
57489,420,10778,405,7305,84099,3473
50562,3,48,660,43,2630,5
38483,15,269,857,211,6269,58
59765,31,705,379,509,15410,196
4928,201,4718,1423,3437,46316,1281
16750,194,3504,1292,2275,24790,1229
36905,42,462,900,388,7141,74
36377,30,482,912,381,23762,101
68551,12,177,107,148,1462,29
2743,42,1139,1448,778,40680,361
26250,21,1068,1118,648,13909,420
5813,34,887,1412,593,12482,294
1170,16,796,1460,611,11116,185
33999,13,228,970,204,10240,24
65010,128,1409,213,1107,13858,302
28190,567,15960,1075,11400,136079,4560
7155,300,7588,1395,5028,70067,2560
63840,33,558,250,426,10165,132
68184,102,1165,120,999,8976,166
8990,147,3539,1380,2273,15351,1266
15679,24,644,1309,424,8740,220
13307,763,18374,1342,12651,131723,5723
31519,17,347,1013,243,12461,104
66690,567,14405,168,11282,85585,3123
4786,903,29349,1425,15227,60438,14122
62547,3,123,284,91,5907,32
60452,218,2185,355,1728,16545,457
38073,477,13242,868,9851,138152,3391
32893,507,18585,991,13271,121456,5314
15823,61,1748,1307,1173,31281,575
8193,460,18414,1383,11525,76182,6889
59617,33,454,384,362,8333,92
33845,9,293,973,247,12353,46
62272,44,560,292,473,7891,87
65743,16,137,196,115,2096,22
59671,45,514,383,419,7805,95
36546,58,929,906,769,11842,160
37809,14,287,874,232,9517,55
2268,214,5281,1452,3809,40872,1472
25373,1795,47697,1136,31524,274262,16173
66830,6,68,163,53,3339,15
6095,7,393,1409,220,18516,173
11680,0,0,1362,0,8211,0
8567,5,194,1382,144,8513,50
12908,179,11650,1348,7131,49885,4519
59933,49,934,373,785,7849,149
1189,307,12696,1460,8281,45809,4415
9719,1148,66616,1376,40726,272716,25890
21359,22,1074,1210,731,8224,343
31928,88,3270,1007,2279,29684,991
57806,39,397,444,320,11006,77
66421,1,36,177,30,4553,6
48193,117,1269,725,941,15874,328
16616,44,1072,1294,845,19545,227
48514,5,173,718,118,3512,55
27491,12,260,1090,155,12225,105
54129,5,51,553,36,4445,15
41067,3,63,817,42,4311,21
28449,65,1784,1071,1225,34660,559
21619,11,539,1206,397,6431,142
3056,90,3521,1445,2197,25262,1324
11528,44,1886,1363,1158,50343,728
61524,253,4541,317,3292,32908,1249
66250,13,100,181,84,2936,16
59702,653,10597,381,8536,51411,2061
6621,118,2734,1402,1940,36078,794
20414,79,1029,1227,768,10317,261
19807,10,558,1237,401,22378,157
37733,2,92,876,72,4536,20
33463,3,185,980,122,5818,63
27403,15,411,1092,368,22994,43
30084,32,646,1038,425,12693,221
15325,411,18502,1315,11742,99420,6760
28127,160,7604,1076,4814,45204,2790
18945,15,1089,1253,702,28849,387
66217,14,264,182,144,8656,120
36798,147,4255,899,3258,22162,997
6057,116,10929,1409,6776,66982,4153
63077,24,809,268,622,6903,187
28027,59,1632,1078,1104,19862,528
33865,52,1405,973,1009,25549,396
21531,92,5443,1207,3618,51123,1825
34331,797,11686,963,8615,53738,3071
40001,34,501,834,387,8079,114
2919,14,848,1446,605,47241,243
11494,0,0,1364,0,16126,0
22458,24,459,1194,371,23750,88
54467,19,236,541,209,8747,27
44179,8541,252584,772,177201,723429,75383
29622,10919,237525,1049,133175,1098689,104350
2294,210,11738,1451,5404,81494,6334
35612,134,2262,932,1603,25216,659
57464,211,3088,455,2452,31264,636
31486,3,65,1014,50,5757,15
26485,36,706,1113,608,19195,98
34510,110,2915,959,2048,23258,867
54192,2,18,551,10,3526,8
4582,250,15358,1428,9922,59189,5436
19699,68,2949,1239,1968,71499,981
53251,215,4073,580,3345,55052,728
35091,41,847,945,611,17750,236
7708,175,3408,1388,2379,22380,1029
30774,18,487,1025,287,7835,200
10229,126,4208,1373,2614,29378,1594
30331,339,6720,1034,4844,39135,1876
37591,471,15387,876,12958,129561,2429
49045,171,2458,701,1612,20630,846
65861,6,156,193,111,7575,45
28838,13,426,1063,296,5301,130
4963,18,1158,1422,706,19566,452
54955,573,6503,524,5439,45876,1064
58405,194,4535,425,3069,19093,1466
41087,13498,274816,817,199301,1563109,75515
29651,14,533,1048,367,13427,166
55152,95,692,518,518,6534,174
23822,16,375,1170,195,6984,180
40922,2114,49179,820,31782,99485,17397
26006,33,1914,1123,1084,36830,830
56022,570,10023,494,7643,35281,2380
5367,9,227,1417,171,6068,56
66215,2,69,182,56,3118,13
60111,1513,27849,368,22457,104032,5392
30498,166,4881,1030,3364,49339,1517
17879,815,15443,1271,10458,83448,4985
41491,14,149,811,102,4355,47
12612,32,1036,1352,607,18777,429
18690,4,152,1257,116,8068,36
17791,4,105,1273,71,4155,34
27386,10,176,1092,143,6408,33
60240,177,1902,362,1548,28595,354
43425,73,2330,781,1851,35598,479
17838,4,67,1272,59,10356,8
57793,123,1476,445,1146,17690,330
56349,155,4220,485,3310,33977,910
9899,20,748,1375,535,9720,213
13837,979,41491,1335,27213,121578,14278
45308,4,62,760,47,5907,15
9461,15,418,1378,268,14775,150
18609,4,134,1259,110,12060,24
19053,54,1075,1251,795,24934,280
55881,0,12,498,12,3200,0
33039,531,12091,988,8855,61953,3236
13462,296,10475,1340,6013,91415,4462
29921,12,375,1042,240,9892,135
52535,33,390,602,315,10216,75
13995,800,18838,1332,11947,150097,6891
44874,25,626,765,477,12866,149
13519,15,1277,1339,766,32757,511
26450,49,814,1113,554,15767,260
9962,2203,42827,1375,24325,97799,18502
792,3,301,1463,237,9681,64
30021,110,3484,1040,2650,34960,834
10388,5,158,1372,88,7769,70
18939,6,274,1253,208,9235,66
14430,101,1797,1326,1300,25869,497
479,1761,41846,1466,27390,206563,14456
29793,2,107,1045,76,4984,31
32068,127,5308,1005,4141,47682,1167
9508,85,1683,1377,1112,8838,571
65226,28,344,208,275,7155,69
31167,1162,14746,1018,9905,70557,4841
50642,88,1452,658,1074,19740,378
57126,26,463,463,346,7026,117
68241,0,399,118,343,1975,56
37583,9,129,880,109,3971,20
41761,27,533,806,406,13939,127
40077,24,287,833,159,3366,128
6356,233,13767,1406,8495,82512,5272
34087,111,2158,968,1377,17130,781
63104,2,62,270,38,3670,24
64671,18,172,224,152,4104,20
20678,0,67,1223,67,4188,0
13517,8,284,1339,205,5727,79
57832,71,993,444,776,10104,217
50032,7587,119584,611,93145,470076,26439
25686,674,17805,1130,11336,119227,6469
8525,3,192,1382,117,3561,75
48601,312,4160,714,3308,31763,852
56864,4,101,470,71,5708,30
19415,69,1132,1244,743,17391,389
36734,196,3535,904,2686,17015,849
57457,57,901,455,735,10502,166
3792,63,2338,1437,1610,16087,728
665,361,14682,1464,10415,77069,4267
59012,197,3440,405,2431,13817,1009
66358,11,209,179,166,2916,43
24451,117,2743,1156,1997,31551,746
49479,34,562,688,453,19647,109
9711,40,763,1376,493,10910,270
52655,12,91,598,73,4237,18
3468,40,1307,1441,899,14822,408
58955,27,374,406,331,6788,43
4538,12,389,1428,278,19578,111
21634,32,1777,1205,1067,10151,710
2231,337,7856,1452,5540,81324,2316
4449,37,1957,1430,1343,20904,614
62028,65,589,300,479,3731,110
48911,59,646,705,515,19297,131
13752,191,6805,1336,4393,75396,2412
36095,35,672,920,555,14185,117
58043,143,1254,437,1034,8431,220
27969,18,606,1079,420,16571,186
21412,34,1311,1209,954,26213,357
32809,1590,45699,992,34520,122465,11179
67089,2,45,155,37,2659,8
1044,20,443,1461,331,17686,112
37905,316,6079,872,3758,19892,2321
13200,65,2361,1344,1242,34747,1119
24886,62,1050,1146,738,12452,312
16444,54,1570,1297,1121,29490,449
3796,12,375,1437,261,24195,114
35607,10,437,932,304,5379,133
22767,16,714,1189,503,18674,211
51115,44,488,646,389,4005,99
48851,8,104,707,71,2657,33
66863,1,20,162,15,745,5
11318,4351,580251,1365,305891,1873801,274360
62546,116,2182,284,1693,12288,489
39,119,6477,1471,4576,102414,1901
9143,21,610,1379,350,11759,260
17380,4,168,1281,145,10230,23
50321,6,75,666,60,2187,15
17134,120,2796,1285,1953,21801,843
62894,496,4433,275,3446,35072,987
814,6571,174595,1463,119469,583974,55126
66931,42,441,160,321,8448,120
16635,162,3981,1294,2727,45562,1254
57990,12,170,439,151,5455,19
4219,84,2017,1433,1615,33705,402
68579,46,597,106,477,8306,120
42980,35,741,787,565,16589,176
49773,66,1189,680,989,31465,200
52608,2,65,595,52,6358,13
17297,5,102,1282,78,6105,24
68025,5,100,123,88,2556,12
21126,15,581,1214,425,17127,156
11508,56,915,1364,569,8793,346
50624,36,427,659,340,10053,87
26086,19,295,1121,200,9263,95
8706,157,5232,1381,3430,92569,1802
37724,205,5614,876,4450,82124,1164
2539,50,1921,1449,1187,16412,734
48940,85,1141,704,951,13553,190
19799,5584,150616,1238,96051,391992,54565
8719,1182,39757,1381,25415,163221,14342
8705,66,2645,1381,1649,24258,996
15963,2605,65718,1304,44108,361631,21610
13498,72,4281,1339,2476,26600,1805
21774,134,2962,1203,2021,22285,941
2947,20175,712583,1446,439748,1563767,272835
47176,1083,16082,737,13006,74653,3076
58356,36,521,426,412,15405,109
33401,17,309,981,207,10142,102
26877,3,68,1103,62,7034,6
51021,5,97,648,76,4013,21
11121,9,254,1367,158,5863,96
962,66,1463,1462,1121,49118,342
36938,637,12454,899,8100,112499,4354
22325,135,5717,1196,3809,51969,1908
49451,0,0,689,0,3636,0
10044,480,17078,1374,11326,130271,5752
31631,11,395,1011,235,5920,160
36722,907,20711,904,15229,187762,5482
56573,169,2693,478,2168,19236,525
14436,373,11768,1325,7432,107333,4336
30238,187,4197,1035,3430,46681,767
51346,76,877,639,762,16931,115
4193,17,320,1433,224,18893,96
14937,4,285,1320,177,5906,108
60041,25,256,370,184,10159,72
7526,0,79,1390,59,16643,20
13062,135,4217,1345,3048,58385,1169
5476,54,4289,1416,2929,39485,1360
11856,23,1126,1360,462,9247,664
16406,3,108,1297,69,5178,39
57858,1037,14497,442,11288,99478,3209
42686,13,264,791,194,14492,70
39156,101,1032,845,916,20372,116
2236,9,177,1452,137,8014,40
31814,38,346,1008,265,5536,81
35840,8,264,927,213,6948,51
32413,46,489,999,303,3926,186
4877,19,620,1424,453,49922,167
20924,286,4750,1218,3136,74931,1614
7488,390,7938,1391,5081,48835,2857
7443,51,906,1391,721,54058,185
50396,893,15677,664,12151,106071,3526
14435,1,131,1325,89,5526,42
49230,97,1406,695,1073,9747,333
8741,3417,137878,1381,72291,333530,65587
59695,9,117,382,86,3812,31
52225,21,211,613,173,3674,38
23099,2181,58483,1183,37964,280766,20519
50705,18,190,657,149,6835,41
38344,2373,33597,855,28219,218865,5378
66975,14,162,158,132,4100,30
1424,56,1376,1458,1001,15941,375
27320,84,1035,1094,674,10056,361
21562,293,7793,1206,5133,42113,2660
21664,95,1524,1205,999,23741,525
16318,5,203,1299,137,9501,66
1123,4716,227181,1460,133133,349431,94048
55046,49,426,521,325,4878,101
67312,45,414,147,301,3580,113
20680,161,4013,1223,2587,31195,1426
7751,15,649,1387,372,18798,277
15704,147,2996,1309,2017,30985,979
25275,1,143,1138,127,27202,16
69004,8,138,91,111,2845,27
57013,7,199,466,162,4115,37
68552,69,814,107,687,4855,127
52057,2514,33348,619,25843,216064,7505
46581,20,552,745,284,8274,268
49349,164,1985,691,1537,29190,448
59053,737,18455,403,14423,95654,4032
64759,739,27335,222,21568,101230,5767
27470,137,2629,1090,1669,14669,960
38322,6,160,861,132,5062,28
5699,42,1081,1414,742,26224,339
54736,19,849,531,505,4014,344
27873,154,3310,1081,2212,37659,1098
58621,63,772,417,613,22533,159
51082,81,579,646,536,12583,43
49491,10,230,688,154,21872,76
39549,8990,157353,841,118476,803635,38877
776,1001,57364,1463,36001,145768,21363
35743,144,1560,930,1078,12461,482
54336,28,262,546,203,9214,59
29179,118,3011,1056,1799,23613,1212
24800,60,1746,1148,1199,19579,547
9331,931,29404,1378,18449,144269,10955
13450,804,14847,1340,8918,76710,5929
33983,29,694,970,402,15991,292
23710,198,4173,1172,2818,18802,1355
21232,1659,43157,1212,28270,170545,14887
38053,14646,357331,868,264638,1344069,92693
61618,33,399,314,298,10461,101
52881,72,969,590,831,21262,138
66697,0,17,168,14,1711,3
59383,48,691,392,584,15984,107
3680,18,794,1439,562,23387,232
17905,57,1890,1271,1410,23202,480
28713,15,549,1065,311,5113,238
4829,3,146,1424,98,11274,48
42588,21,246,793,188,6503,58
15061,13,614,1318,447,37482,167
12023,4,248,1359,133,8579,115
31969,23,462,1006,362,10624,100
815,51,1474,1463,967,47230,507
38080,1,142,867,70,4618,72
68093,7,130,122,95,4049,35
59099,8,231,402,171,5104,60
1335,60,1392,1459,977,19364,415
54738,273,1561,531,1320,23469,241
38306,76,1252,862,1128,18091,124
8086,44,663,1384,393,6510,270
66883,10,206,161,168,2398,38
56604,14,117,477,92,2995,25
49083,70,1874,699,1441,18147,433
29819,12,708,1044,454,26659,254
22932,8,710,1186,487,10660,223
3817,54,1510,1437,1053,36569,457
4414,9,392,1430,286,11870,106
10036,22,1171,1374,751,12032,420
26988,195,11771,1101,7458,43278,4313
41207,404,14740,816,11109,41166,3631
22876,1050,28180,1187,19676,133030,8504
42568,54,757,794,592,14419,165
33676,44,1243,976,738,11422,505
43517,839,11820,598,9024,64697,2796
16115,13,218,1302,161,7364,57
37860,14,256,873,213,12607,43
33913,28,428,972,306,8379,122
49438,51,1045,689,778,16476,267
48262,3213,65843,724,50582,234197,15261
18837,373,8300,1254,5634,71520,2666
34439,65,867,961,635,17883,232
56730,66,668,473,463,16653,205
8295,121,2975,1383,1816,20861,1159
12053,582,14765,1358,9688,69122,5077
48566,874,15811,715,11831,81564,3980
18021,1623,23372,1269,17558,106113,5814
30062,2797,51225,1039,36613,222706,14612
7402,6,429,1392,291,14808,138
5324,169,3676,1418,2740,38448,936
4307,10747,393675,1432,233348,1405885,160327
29338,3,88,1053,61,7198,27
33886,558,13095,972,9481,67620,3614
51505,231,3553,635,2726,79334,827
66804,14,302,164,220,8410,82
52207,50,530,614,455,6116,75
44039,24,344,774,252,4545,92
7848,15,543,1386,368,12298,175
1638,216,5817,1457,4042,24167,1775
9991,36,1121,1374,712,12214,409
64830,2711,63536,218,45352,142227,18184
16789,12,361,1291,241,11963,120
14302,8,1355,1328,657,9922,698
61133,27,360,329,312,5737,48
22655,2,163,1191,118,12115,45
15542,2431,63480,1311,48752,357646,14728
11170,24,1596,1366,947,26049,649
6761,70,4227,1400,2743,27771,1484
10886,42467,1360559,1368,837027,2281723,523532
8375,35,2475,1382,1530,51197,945
61705,32,519,311,400,6855,119
3723,77,1975,1438,1363,20162,612
56109,144,1341,492,1101,10772,240
63623,2565,63047,257,52420,237568,10627
48529,29,510,717,413,10971,97
30584,60,1267,1029,808,15430,459
55893,62,1264,498,793,11272,471
68344,45,538,114,480,8473,58
1722,379,14743,1456,11005,210664,3738
29812,0,0,1044,0,12295,0
65259,733,13606,208,10807,81853,2799
24317,3,137,1160,99,4024,38
56364,1,56,484,34,4199,22
31338,331,7185,1015,4803,36535,2382
57184,387,7690,461,6314,56004,1376
17973,3,162,1269,128,6482,34
27156,10,396,1097,257,18235,139
5974,23,999,1410,731,17532,268
24501,27,577,1155,464,10205,113
33321,89,1678,983,1204,36884,474
45996,15,164,752,133,5932,31
913,81,2003,1462,1449,40061,554
64154,269,4692,239,3079,34870,1613
53554,0,117,572,108,7805,9
53680,2,35,568,28,3089,7
18673,29,610,1258,429,8360,181
3573,216,5112,1440,3416,63019,1696
17454,79,1350,1280,1007,18391,343
23526,23,258,1176,212,18435,46
40688,8,458,824,406,13464,52
17909,20,238,1270,154,3811,84
58747,18,128,413,105,3358,23
55607,2203,23292,506,17108,102613,6184
1766,5,181,1456,138,7448,43
14202,20,511,1329,336,7528,175
51401,4685,86021,638,67260,519079,18761
16855,289,9283,1290,7285,220813,1998
8276,101,6313,1383,3723,57681,2590
22215,2,124,1198,89,4694,35
65020,103,2089,204,1570,22869,519
49072,111,2001,700,1755,48043,246
2661,7,391,1449,275,19011,116
32055,81,1590,1004,1170,14546,420
21191,45,939,1213,646,15029,293
54586,618,7115,534,5820,104054,1295
59938,26,620,373,433,8194,187
38635,1271,19711,828,14737,162885,4974
4684,60,1799,1426,1287,23541,512
15833,322,5699,1307,3655,49296,2044
26399,20,2095,1114,1277,24047,818
36926,32,456,888,371,14072,85
42768,233,4862,790,3864,47996,998
57237,194,1763,460,1328,14509,435
29459,114,8441,1051,5584,25827,2857
16577,0,182,1295,131,7827,51
21247,159,4116,1212,2682,25172,1434
8633,32,728,1381,474,9866,254
52517,2,57,603,51,4100,6
8303,2608,56623,1383,38611,136783,18012
42624,55,1045,792,854,26609,191
3597,29,898,1440,651,13930,247
53609,92,1078,571,925,24856,153
56796,55,592,471,449,15878,143
31554,102,3259,1013,2017,23099,1242
56149,12,212,490,180,7726,32
3083,221,5814,1445,4013,35881,1801
25441,166,2614,1135,1920,27343,694
13527,0,0,1339,0,6251,0
67409,33,413,144,315,6044,98
34168,9,169,966,108,15984,61
12572,35,2370,1352,1346,32165,1024
12501,705,22410,1353,14058,165793,8352
2637,899,25246,1449,15646,99261,9600
58519,1107,24998,420,18611,161663,6387
5161,29,600,1420,430,13104,170
37571,11,231,880,187,11094,44
60644,68,1196,347,989,38327,207
15562,7,503,1311,400,37367,103
23513,28,1163,1176,662,16772,501
18231,144,3455,1265,2764,39276,691
49632,5,114,684,81,6067,33
22229,19,790,1197,543,13353,247
56409,4,53,483,44,3568,9
61613,77,1914,314,1387,15700,527
14121,83,2531,1330,1762,19392,769
6581,6,262,1403,172,19247,90
3456,70,7299,1441,4563,34507,2736
13800,260,6384,1335,4373,39069,2011
14039,1725,79801,1331,42155,287054,37646
21699,242,2738,1204,1919,19292,819
23280,54,1066,1180,698,15431,368
36897,140,1466,900,1092,12390,374
49613,19,419,685,362,10437,57
65210,200,3171,209,2661,22173,510
11904,259,12519,1360,7493,109525,5026
28723,17,566,1065,361,7793,205
34989,23,634,947,462,13066,172
12967,2,112,1347,66,9014,46
10506,1489,47768,1371,30247,283271,17521
34620,671,11519,955,8359,67655,3160
60798,129,2165,342,1712,29446,453
55965,88,667,496,537,14165,130
12653,24,1041,1351,627,13501,414
692,435,11804,1464,7496,44968,4308
14351,3577,73477,1327,53824,258139,19653
58836,32,289,411,233,3800,56
7388,42,2324,1392,1633,17603,691
10340,139,7558,1372,4308,80004,3250
60939,7,181,336,45,2805,136
4869,15073,619734,1424,380123,1250937,239611
23594,5,151,1175,108,3329,43
58169,4,44,433,30,4111,14
65926,92,1073,191,985,19808,88
27109,12,621,1098,395,16662,226
22245,12,551,1197,345,7227,206
54311,113,1222,547,1052,17094,170
11367,62,1521,1365,884,29288,637
16952,107,2890,1288,2212,28252,678
45374,500,10250,759,8397,96143,1853
17293,16,835,1282,587,17280,248
18944,8,408,1253,317,12782,91
24251,26,938,1161,633,18368,305
8614,175,11947,1381,8279,65564,3668
35789,3040,77188,928,50740,738320,26448
12957,864,46425,1347,25353,269124,21072
60689,47,955,346,727,8733,228
17103,18,837,1286,609,7495,228
19622,2079,74213,1241,50625,406793,23588
12129,170,3185,1358,2205,42427,980
19290,237,8182,1247,5324,71184,2858
15795,126,3644,1307,2512,24118,1132
2113,57,2342,1453,1502,27532,840
65853,55,1106,193,877,16713,229
56650,46,347,476,236,11477,111
40554,415,8617,826,6835,68888,1782
50453,9,83,663,64,4024,19
13992,532,20296,1332,13365,119918,6931
23445,0,24,1177,18,2204,6
28900,426,10256,1062,7391,109345,2865
18839,391,8728,1254,6663,76445,2065
42642,238,3351,792,2721,56000,630
1956,683,34342,1454,14945,93474,19397
34277,29,722,963,489,6607,233
67820,4,70,131,46,4188,24
28978,5665,180337,1060,121760,720442,58577
221,37,1709,1468,1294,33659,415
26671,1768,27194,1107,17567,144549,9627
18313,14,2190,1264,820,25517,1370
64960,21,413,215,310,9553,103
26527,20,532,1112,352,50277,180
33012,25,483,988,267,18649,216
41758,13,294,806,249,10302,45
14814,27,871,1321,627,25150,244
1922,14,877,1455,623,14225,254
65161,7,50,210,43,1830,7
59178,9,62,400,48,3729,14
9426,3309,114810,1378,68089,289284,46721
57407,99,1238,456,986,10386,252
68527,49,704,108,611,10252,93
59188,22,383,400,259,4371,124
30991,5,210,1021,163,9230,47
12209,19,1413,1357,677,24101,736
3802,41,520,1437,335,11896,185
766,48,1695,1463,1214,40067,481
49684,379,4549,682,3676,29934,873
55375,162,2232,512,1720,31156,512
30708,15,516,1026,343,23559,173
15745,2,124,1308,53,2554,71
22594,31,691,1192,581,26236,110
37816,152,1680,874,1288,11370,392
3555,18,556,1440,361,8158,195
3634,1731,40743,1439,28843,84086,11900
15130,0,0,1317,0,38779,0
29290,0,0,1054,0,10073,0
32653,55,1076,995,662,9450,414
34008,6,317,970,191,19602,126
63154,5,91,269,60,5683,31
19550,3,196,1242,131,5724,65
60839,17,154,340,128,2306,26
22364,546,69442,1196,41116,160853,28326
36151,76,911,919,775,17623,136
13441,167,5024,1340,3172,80879,1852
3995,1,108,1435,67,6465,41
43233,41,525,782,435,17368,90
25601,0,113,1132,78,8686,35
32067,14,451,1005,270,13316,181
18442,7,471,1261,295,6184,176
61001,2,52,334,40,3360,12
14380,3705,118112,1326,78027,608133,40085
8078,6206,174700,1384,110649,342818,64051
11584,20,1196,1363,679,14061,517
63300,170,2654,265,2113,22839,541
20958,27,1490,1217,1026,38793,464
26194,286,5030,1119,2960,27190,2070
63602,33,387,257,311,6524,76
11271,20,487,1366,324,27802,163
38536,3,77,855,59,5548,18
10746,1222,20374,1370,12796,109122,7578
64984,21,156,214,128,3481,28
8364,6,322,1382,208,12948,114
29170,181,5214,1056,3066,30313,2148
58015,188,1746,438,1331,16806,415
25798,20,953,1127,606,18829,347
48915,494,10887,705,7915,103397,2972
67702,83,805,135,613,5253,192
65412,84,967,203,820,12462,147
34012,53,825,970,652,7505,173
56542,108,1757,479,1381,15384,376
66335,2,42,179,31,4381,11
21600,16,549,1206,411,12270,138
55084,30,359,520,302,9671,57
50538,233,2855,660,2336,44580,519
11237,36,2196,1366,1207,50133,989
55903,10,289,498,185,4881,104
27583,16,550,1087,345,10685,205
8187,72,1613,1383,1059,15317,554
53735,85,2872,567,2144,21138,728
31182,115,2076,1018,1403,18625,673
4855,17,711,1424,523,18515,188
29226,110,2464,1055,1823,14456,641
5307,585,17782,1418,10744,87643,7038
54453,208,3829,542,3239,38511,590
166,303,12308,1469,6746,135955,5562
13847,181,2343,1334,1538,24260,805
21859,5,202,1202,149,5047,53
37925,0,28,872,24,6060,4
32090,411,8694,1004,5535,30771,3159
55809,19,320,500,286,9894,34
19300,38,257,1246,212,15703,45
52018,59,819,620,726,11586,93
11282,769,23793,1365,15049,140305,8744
18347,7,419,1263,289,10980,130
6476,1028,45811,1404,29302,275607,16509
57363,865,16150,457,12488,102049,3662
61373,36,327,321,287,3230,40
21895,55,1242,1202,838,32817,404
21203,14,880,1213,618,12518,262
21185,39,1389,1213,917,13471,472
50730,120,2022,656,1583,28054,439
54649,5,72,534,57,7953,15
51108,25,459,646,355,10815,104
36122,86,1153,920,957,20648,196
63389,182,2710,263,2237,28997,473
64458,35,534,230,442,8584,92
43017,266,3540,786,2683,24899,857
40574,188,2254,826,1660,29610,594
32449,77,1444,999,1025,19540,419
53152,6305,103582,582,74824,586482,28758
59776,30,369,379,288,5827,81
81,88,3820,1471,2541,87232,1279
34362,25,916,962,647,16886,269
49397,287,5776,690,3590,43635,2186
54707,63,459,532,355,6099,104
16766,374,5266,1291,3540,68946,1726
15575,44,1425,1311,1005,19912,420
17802,129804,6567355,1273,3350716,10540958,3216639
25609,27,888,1132,498,13162,390
11344,599,15970,1365,9654,59988,6316
5252,58,2853,1419,1812,15179,1041
63198,98,1445,268,1161,6413,284
2801,1512,29568,1447,21064,139097,8504
30775,55,1750,1025,1151,44290,599
32985,35,558,989,344,6947,214
62958,28,474,274,350,18665,124
10460,1063,19797,1372,14096,54688,5701
51117,31,145,646,113,7600,32
67657,23,163,136,137,2008,26
396,20,663,1466,526,49715,137
59082,51,661,403,579,16300,82
58684,12,102,415,72,2951,30
50770,23,365,655,299,8722,66
30888,209,4701,1023,3237,51022,1464
13375,0,0,1341,0,7473,0
23988,4,83,1167,67,9486,16
44506,58,1352,769,1022,33363,330
61424,17,225,320,175,4154,50
32437,28,397,999,270,6441,127
2429,481,30917,1450,21861,143455,9056
17407,34,1736,1281,1278,30237,458
37696,3652,175900,877,127179,223537,48721
51783,596,10113,627,7995,77092,2118
64943,19,182,215,139,8979,43
5304,20,874,1418,595,32033,279
19765,9,491,1238,359,10370,132
16477,13,276,1296,224,19315,52
4653,13,396,1427,262,16777,134
44397,44,679,770,471,24682,208
10081,1,152,1374,113,6037,39
69051,13,140,90,118,4809,22
6544,1205,25060,1403,17210,255345,7850
26238,90,1683,1118,1055,17675,628
59666,57,460,383,354,5988,106
23407,221,7061,1178,4967,48297,2094
43913,66,773,776,587,19552,186
12076,172,7316,1358,3847,42154,3469
68902,0,2,93,1,785,1
59521,30,427,388,301,11267,126
12328,5,230,1355,129,27703,101
54717,62,1121,532,601,29587,520
7041,533,13472,1397,8552,53764,4920
2596,395,5308,1449,3491,43512,1817
24435,41,1038,1157,652,23546,386
67073,5,56,155,45,2697,11
67682,9,98,136,86,1627,12
18530,107,3185,1260,2324,37249,861
4376,185,5239,1430,3641,71757,1598
58491,1310,14451,421,11326,62440,3125
58213,183,1259,431,1018,8452,241
46052,11,176,751,149,6942,27
22310,7,384,1197,276,18785,108
28373,34,256,1072,203,6540,53
16056,21,337,1303,229,7463,108
48844,107,1510,707,1224,17584,286
19181,31,1260,1249,886,21078,374
20057,46,2790,1233,1986,35607,804
33079,12,277,987,209,7423,68
15839,8,168,1307,114,5558,54
62984,2,30,273,23,3614,7
29426,146,2850,1052,2051,43797,799
30986,2475,38027,1021,28491,200225,9536
64872,4,51,218,39,3626,12
58472,11,119,422,93,7559,26
24063,17,358,1165,258,20949,100
28942,33,1485,1061,1040,27440,445
562,2372,185867,1465,100445,638020,85422
22316,533,10580,1196,7372,81115,3208
4892,24,816,1423,558,26507,258
57278,30,614,459,440,9347,174
59079,40,528,403,415,15464,113
34007,761,12812,970,8512,110711,4300
10475,1,143,1371,90,6639,53
1023,68,2491,1461,1638,12301,853
99,249,15731,1470,10656,97760,5075
54857,3,70,526,59,3463,11
22618,428,11297,1191,8313,59349,2984
63702,1942,34930,254,28324,130242,6606
58376,79,1957,426,1552,33956,405
33342,15,932,982,586,24877,346
21613,39,1109,1206,690,27793,419
54196,1785,25909,551,20666,110413,5243
19042,122,2256,1251,1675,20400,581
14454,3,151,1325,91,8563,60
32310,89,3044,1001,1902,22331,1142
38554,18,304,855,228,8907,76
42332,1776,42758,798,35778,230647,6980
8903,1415,41942,1380,29470,108717,12472
34381,35,1171,962,913,14057,258
613,3,478,1464,369,11549,109
24197,42,1468,1162,986,16853,482
7777,7,451,1387,214,25905,237
9316,176,4043,1378,2842,19756,1201
68678,26,316,102,250,9489,66
29673,466,6924,1048,4932,39142,1992
12849,22,926,1349,523,31831,403
3228,20,1235,1443,882,12788,353
27718,9,135,1085,98,3210,37
8803,7,259,1380,158,7661,101
11036,404,9198,1367,6019,80630,3179
12155,9,548,1357,310,45055,238
67948,38,309,127,236,7770,73
1698,7,178,1456,132,16578,46
39152,147,2161,845,1566,17249,595
15555,9,731,1311,494,53651,237
63190,116,1097,268,854,10407,243
40834,37,543,822,464,13607,79
24750,717,30949,1149,23011,94674,7938
59656,1,19,383,16,4275,3
42616,1964,31955,792,25830,220453,6125
19996,1,135,1234,95,3338,40
10304,1171,19579,1373,14716,128606,4863
7804,4138,83420,1386,60012,283620,23408
26874,1064,38823,1103,24261,288262,14562
25523,142,3604,1134,2054,20489,1550
1022,480,26934,1461,15935,92335,10999
3371,35,1097,1442,749,33330,348
26108,273,6045,1120,3977,30095,2068
5357,27,716,1417,485,11179,231
14786,718,15490,1322,11734,119741,3756
65855,146,3625,193,2780,17943,845
48506,1,83,718,64,3538,19
26326,1244,30457,1116,20377,175571,10080
35057,81,1523,946,977,27709,546
24386,62,1187,1158,743,11018,444
35687,96,1805,931,1338,13939,467
1476,32,706,1458,520,28747,186
57328,169,2260,458,1813,26933,447
59987,24,461,372,363,9040,98
61099,117,2338,330,1823,26860,515
65639,2,50,199,33,5045,17
56136,44,944,491,684,8634,260
65269,51,816,207,645,10420,171
11481,639,17228,1364,9575,112384,7653
12530,141,4339,1353,2653,34394,1686
61320,61,500,323,431,11169,69
25,174,12600,1472,7852,83335,4748
66377,128,1659,178,1326,22201,333
11411,46,1975,1364,985,18824,990
12671,0,0,1351,0,9229,0
15265,303,7416,1315,4803,60159,2613
29046,18,922,1059,498,7294,424
59877,33,419,375,337,10532,82
5135,0,112009,1420,65949,539997,46060
51520,4,84,635,63,5418,21
25856,32,636,1126,387,4338,249
60945,8,92,336,77,5443,15
60616,3,12,349,8,2501,4
63749,0,0,253,0,3145,0
19829,20,933,1237,666,15337,267
3546,65,1811,1440,1166,13755,645
2833,525,9945,1447,5846,87719,4099
66268,20,185,181,146,4382,39
54348,14,122,546,109,10401,13
6737,31,695,1401,519,15998,176
36801,10,91,903,73,10752,18
33261,5926,108720,983,71963,336120,36757
24144,11,322,1163,202,7444,120
63486,23,186,260,147,2619,39
58315,11,90,428,70,3607,20
56219,465,10350,489,8414,154600,1936
28707,12,455,1065,284,21416,171
28436,58,1534,1071,936,23204,598
65175,26,418,209,356,8019,62
15300,545,8921,1315,5856,75116,3065
68846,68,775,96,648,18678,127
50337,20,240,666,199,7024,41
65703,41,313,196,279,4798,34
14525,2471,30142,1324,18350,126544,11792
37155,39,692,892,471,10432,221
55464,27,199,510,157,4475,42
17096,212,3659,1286,2686,60011,973
22206,12,369,1198,234,7466,135
33294,50,561,983,417,10108,144
6700,34,1541,1401,984,26539,557
33478,11,228,980,179,9637,49
26142,86,1367,1120,897,17323,470
26172,0,120,1120,80,8963,40
49420,17,239,689,170,9362,69
9614,4950,345581,1377,202253,1013513,143328
49362,2,27,691,20,3703,7
23965,2019,87265,1167,52158,277369,35107
28164,28,483,1076,326,7132,157
51030,134,1533,648,1164,15208,369
25782,40,1301,1128,773,12190,528
48905,0,25,705,21,2003,4
10536,4,133,1371,90,8121,43
50654,26,497,658,397,8970,100
68148,10,185,117,170,2541,15
53905,15,192,561,163,9320,29
28376,18,705,1072,443,4524,262
34429,87,1814,961,1303,8385,511
6577,9,378,1403,270,15364,108
44939,27,295,764,226,10548,69
3404,10,352,1441,265,15728,87
2099,6,377,1453,259,18915,118
147,18,1055,1469,616,23680,439
26093,7,641,1121,331,9782,310
6801,29,601,1400,407,15740,194
50102,25,354,672,318,12859,36
15546,93,2923,1311,2147,57517,776
56406,5,92,483,73,4653,19
67761,8,108,133,75,2425,33
67811,1189,23852,131,18494,130737,5358
4994,935,67419,1422,40413,236212,27006
24116,1555,25666,1164,16862,60681,8804
19123,30,1120,1249,872,43895,248
29506,0,0,1050,0,10640,0
4405,301,7174,1430,4523,51336,2651
57234,49,503,460,402,6856,101
8354,46,875,1383,584,8252,291
8955,346,13446,1380,8498,60909,4948
29133,194,7404,1057,4908,50189,2496
67502,1,41,141,36,4414,5
31319,67,1160,1004,750,8905,410
52105,24,284,617,212,6742,72
49592,45,524,685,413,11451,111
5309,196,5746,1418,4014,96242,1732
558,74,2985,1465,2160,45339,825
37087,20,295,895,254,8032,41
16614,106,2543,1294,1684,20816,859
8395,2079,91708,1382,57005,223603,34703
10824,717,17132,1369,11425,87932,5707
64334,13,167,234,114,7840,53
32194,127,2838,1003,2147,32642,691
8831,89,2736,1380,1636,17043,1100
31593,636,10392,1012,6830,57301,3562
37940,82,1098,871,844,16648,254
38357,5,144,860,119,5527,25
6172,4004,114698,1408,64504,407429,50194
66055,36,457,187,363,6015,94
27511,786,26224,1089,16674,128323,9550
20420,73,3353,1227,2380,36048,973
50241,198,2810,668,2238,24704,572
23951,105,4123,1168,2388,57211,1735
49007,144,1920,702,1507,13963,413
36956,196,4321,898,3113,22593,1208
35580,9,301,933,193,7789,108
22777,149,7368,1188,4099,66676,3269
28171,2,58,1076,37,7359,21
33472,3,86,980,54,4824,32
866,3461,130597,1462,84097,328928,46500
16948,19,1120,1288,736,16102,384
14047,28,1360,1331,844,10148,516
37678,113,2415,878,1677,22129,738
1585,379,13967,1457,9221,183668,4746
63428,65,1374,261,1170,17915,204
56541,25,204,479,189,6717,15
31085,49,1048,1019,678,36249,370
51924,305,3462,623,2554,20066,908
12677,20,1031,1351,442,8041,589
4217,1425,65213,1433,39426,230806,25787
53272,5,148,579,60,2927,88
2239,0,91,1452,64,11495,27
44818,439,6468,765,4990,74433,1478
15456,58,3373,1313,2264,52740,1109
9608,9,414,1377,226,8763,188
16658,2443,60827,1294,41522,476824,19305
49941,0,529,676,359,12814,170
68001,16,172,126,148,10131,24
22258,79,2488,1197,1669,31551,819
8561,251,11494,1382,7043,113868,4451
62298,153,2699,291,2276,36434,423
4453,1,101,1430,73,1953,28
66243,125,1501,181,1259,23601,242
7260,63,2180,1393,1448,17252,732
2884,10,288,1446,203,16192,85
2898,1,81,1446,51,6512,30
67959,4,56,127,44,5058,12
32602,315,7244,996,5372,32726,1872
11964,35,943,1359,514,6990,429
2891,2,228,1446,177,15999,51
38389,1863,29649,859,21331,77636,8318
21841,18,735,1203,485,30709,250
32235,853,23537,1002,14646,159060,8891
3301,135,2290,1442,1652,25039,638
52810,159,1848,592,1546,15594,302
31744,82,2270,1009,1465,30172,805
3966,26,474,1435,379,8939,95
1735,10,374,1456,303,18028,71
9607,26,665,1377,468,16263,197
23694,411,6404,1173,3918,32714,2486
6972,22,681,1398,437,19281,244
37520,30,884,882,721,36134,163
7805,3,75,1386,55,22218,20
65846,6,115,193,89,2771,26
31353,129,1230,1015,799,11149,431
40095,612,7853,833,6373,48560,1480
29207,188,4467,1056,2957,26125,1510
54221,64,1214,550,905,13105,309
47495,52,435,733,356,11680,79
42316,131,2916,798,2396,38884,520
68768,27,446,99,392,5062,54
20150,22,592,1231,453,6321,139
53965,38,468,559,366,6145,102
30925,126,2640,1022,1652,29988,988
32008,33,1082,1005,640,5934,442
33864,36,1240,973,893,14107,347
67242,10,138,149,103,3325,35
24078,18,544,1165,331,19578,213
60345,13,160,359,109,3572,51
8153,81,2787,1383,1799,22968,988
44273,30,328,771,238,7475,90
58273,9,102,429,84,6154,18
51711,305,4991,629,4032,43883,959
44291,133,1519,770,1167,22549,352
6271,96,2540,1407,1764,54676,776
47231,157,3050,736,2160,34450,890
31696,89,1350,1010,948,22031,402
31943,45,1682,1007,1100,20577,582
20278,605,9840,1229,6479,43930,3361
11014,12,1034,1367,601,27186,433
19750,216,4458,1239,3160,43388,1298
33101,229,5425,987,3856,53266,1569
58218,212,3048,431,2344,16813,704
19346,141,3413,1246,2296,30924,1117
35966,3168,53469,924,43956,288889,9513
7104,563,32804,1396,18536,185018,14268
37998,21,463,869,377,22625,86
59886,31,442,375,340,12506,102
48433,34,479,721,394,10526,85
32783,49,1493,993,985,23553,508
14372,16,387,1327,298,10140,89
23586,0,118,1175,84,5619,34
19943,2780,42965,1235,29465,139472,13500
68387,746,8044,113,6244,24553,1800
61240,37,731,315,562,6294,169
17072,236,4904,1286,3117,43317,1787
14897,312,8213,1320,5966,62336,2247
16253,245,11515,1300,8240,92545,3275
36303,51,933,914,572,12509,361
817,365,28190,1463,17134,260984,11056
58050,1078,19322,437,15295,69535,4027
20410,40,1214,1227,958,6832,256
51727,280,3243,629,2501,21008,742
13241,1223,36075,1343,25795,196365,10280
66795,64,838,165,659,6062,179
30337,471,10823,1033,7289,108108,3534
54278,70,382,548,302,3972,80
62432,1,34,287,23,4003,11
27145,407,13093,1097,7345,38521,5748
19455,9,235,1244,169,7974,66
54238,1,657,550,411,25252,246
2216,61,2079,1452,1535,30519,544
56579,5,81,478,62,6213,19
5791,43,811,1412,571,19984,240
18271,11,470,1265,351,13818,119
65397,7,76,204,63,2675,13
32844,62,1428,990,870,9887,558
55964,38,347,496,276,3583,71
15447,8,220,1313,144,15870,76
3241,38,2342,1443,1665,27910,677
1174,19,541,1460,377,23329,164
23065,547,15518,1183,10119,62802,5399
26491,2520,41095,1113,27081,105839,14014
10202,133,3493,1373,2137,44442,1356
15756,38,1413,1308,969,17573,444
24026,9,514,1166,427,22452,87
64292,11,123,235,103,6345,20
18533,115,2303,1260,1725,25783,578
50917,34,458,651,419,16183,39
62476,6,118,286,104,2535,14
5397,425,12370,1417,8321,132446,4049
63981,144,1428,245,1057,12778,371
25266,19,328,1139,278,16131,50
28266,24,924,1074,607,14605,317
18478,28,419,1261,283,8195,136
30670,49,1342,1027,800,12653,542
7110,70,3684,1396,2402,33723,1282
5961,229,7846,1411,4869,26581,2977
37818,1,45,874,37,2902,8
39475,72,1792,841,1423,36949,369
66860,67,1379,162,1026,13703,353
61232,30,257,325,194,4785,63
8423,144,3268,1382,2197,21902,1071
37232,14,143,890,108,4018,35
37024,81,1236,896,1099,17375,137
55859,223,3030,499,2448,20894,582
34711,203,4255,953,2948,37962,1307
6567,20,492,1403,344,19383,148
6458,70,2625,1404,1683,30368,942
67838,26,688,130,546,7951,142
33100,9,466,987,286,8785,180
29580,10,399,1049,263,15225,136
67378,2,17,145,11,2692,6
7787,37,1526,1387,1014,21962,512
30967,31,973,1021,685,10423,288
47420,12,451,734,325,9588,126
57664,20,132,449,120,5844,12
24847,16,482,1147,338,6699,144
48224,128,1889,724,1479,13182,410
61691,401,6562,312,5243,42985,1319
120,1451,79540,1470,53421,374236,26119
52954,7,83,588,43,3005,40
57992,37,442,439,358,22018,84
56396,48,631,483,519,12680,112
18727,39,991,1257,707,54014,284
66554,23,308,172,214,8497,94
48296,84,1167,723,920,10237,247
30436,10,423,1031,357,13722,66
66369,7,231,178,188,4998,43
19735,10,614,1239,475,21959,139
7094,918,20142,1396,13307,77521,6835
24344,9,424,1159,293,9314,131
1618,1721,41471,1457,29205,102653,12266
21308,399,8323,1211,5615,40122,2708
22895,202,4048,1186,2377,37169,1671
23967,28,1081,1167,693,18479,388
55311,19,156,513,116,5343,40
66134,48,1636,185,997,16190,639
38341,136,1946,861,1522,17850,424
37986,0,29,870,22,2383,7
29981,21,698,1041,395,4322,303
63717,1,75,254,45,2176,30
64352,924,20776,234,17584,74010,3192
19738,38,603,1239,499,21201,104
58624,3,37,417,34,3769,3
11905,53,2076,1360,1027,15120,1049
1234,538,47228,1460,32270,186802,14958
41513,2,56,811,41,5580,15
63809,27,553,251,439,6203,114
60816,0,0,165,0,3886,0
30103,11,404,1038,229,8521,175
20400,81,1212,1227,814,10666,398
45936,4,49,753,37,1632,12
62401,4,23,288,17,4829,6
21704,69,1176,1204,763,31215,413
11311,32,1255,1365,721,10781,534
6949,65,2414,1398,1659,47354,755
63671,244,3881,255,3133,20553,748
56662,31,522,476,341,11730,181
8634,764,14748,1381,9590,85284,5158
63600,15,160,257,124,4981,36
52953,0,0,588,0,2579,0
61190,39,1347,318,809,21997,538
2901,49,1543,1446,1044,33453,499
19383,103,4857,1245,3592,47575,1265
67962,13,117,120,89,1991,28
58733,34,505,413,378,7918,127
34769,23,975,952,651,23791,324
55927,115,1344,497,1120,22321,224
50628,116,2506,659,2096,19664,410
7208,33,1041,1394,772,54069,269
12454,5333,239309,1354,157231,482381,82078
52529,76,829,602,652,12690,177
3959,36,2129,1435,1408,41680,721
2116,83,5236,1453,3437,46354,1799
67558,15,92,140,82,2500,10
47296,41,1109,736,844,31398,265
62931,65,523,274,411,11032,112
11099,451,10574,1367,5725,34025,4849
41009,379,4502,818,3638,46188,864
28212,61,1656,1075,1088,13240,568
9517,37,1217,1377,805,34789,412
65843,4,105,193,88,3522,17
30922,36,615,1022,499,11653,116
35560,186,4238,931,2964,19338,1274
27734,6,214,1085,127,7200,87
2089,158,3588,1453,2515,88603,1073
7028,145,2268,1397,1441,12160,827
22477,1352,53613,1194,31967,218994,21646
46571,32,366,745,297,7788,69
37336,138,3736,887,2880,63046,856
54231,14,169,550,117,4041,52
28407,11,181,1071,147,5974,34
28842,28,280,1063,256,4776,24
11744,1262,42550,1361,25642,159520,16908
23552,70,1833,1175,1013,10164,820
55578,15,89,506,74,7663,15
63849,27,277,250,209,5226,68
31155,12,179,1018,128,10850,51
17423,592,5065,1281,3875,60375,1190
12021,790,29373,1359,17352,165545,12021
14571,1,99,1324,66,10751,33
67267,177,3379,149,2568,28911,811
12270,94,1058,1356,693,24532,365
26497,495,8051,1112,6176,58565,1875
36724,4,88,904,70,16062,18
23671,9,293,1173,200,3319,93
13875,332,11085,1334,7456,87988,3629
22148,54,1397,1199,980,18490,417
60274,18,615,361,323,11845,292
14691,167,10035,1323,6246,33943,3789
48478,120,1063,719,822,10600,241
41894,191,3215,804,2552,23429,663
4476,542,12411,1429,8755,78586,3656
6072,50,1100,1409,732,45629,368
59528,38,363,384,267,7778,96
28236,726,21096,1074,13930,130208,7166
18457,16,970,1261,621,13473,349
68132,22,789,122,623,5401,166
9679,1,8,1377,8,5579,0
21904,12,368,1202,250,18701,118
41684,8,252,807,209,19064,43
10612,2234,75338,1371,46783,264767,28555
65188,8,100,209,88,1530,12
15272,1257,37196,1315,23000,155457,14196
2369,22,856,1451,613,23275,243
60695,62,1192,345,917,13466,275
22961,52,1133,1185,834,33195,299
27418,8279,169391,1091,107730,478986,61661
8442,5,219,1382,146,10406,73
2333,18,762,1451,567,10922,195
67931,112,1841,128,1515,27760,326
23708,5,353,1172,220,12914,133
54339,179,2175,546,1529,10525,646
20424,28,912,1227,593,13837,319
66789,1,18,165,14,1281,4
56348,58,609,485,504,9281,105
13955,7,511,1333,294,19136,217
24737,1396,30490,1150,21470,110627,9020
11112,74,2751,1367,1712,31874,1039
53899,8,213,561,161,5954,52
37388,25,423,886,309,14131,114
35530,57,1141,934,778,14654,363
18885,64,1588,1254,1180,22246,408
58938,333,9373,407,5941,27600,3432
8053,120,2823,1384,1772,23528,1051
13197,2376,106125,1344,61733,597666,44392
18505,433,16876,1260,11144,161508,5732
25859,70195,1420388,1126,1039693,4178555,380695
9599,74,2042,1377,1333,32311,709
67207,114,1562,150,1326,17027,236
8047,51,1134,1384,704,8039,430
26493,27,1533,1112,987,23535,546
50861,320,5678,653,4439,30110,1239
48216,26,257,724,197,3683,60
67828,205,2088,130,1610,18712,478
6526,50,2316,1403,1543,37729,773
22505,50,2663,1194,1864,38634,799
53090,142,1368,584,1085,19898,283
22520,23,882,1193,624,10173,258
369,1081,26213,1467,17609,114746,8604
33259,170,3706,984,2361,19383,1345
41636,83,1054,808,911,34730,143
9064,716,22564,1379,13267,159686,9297
30070,196,6292,1039,4071,25686,2221
15824,311,6048,1307,3962,56449,2086
38497,9170,370135,856,296106,660815,74029
52292,11,216,611,160,17076,56
49626,283,2119,684,1823,37331,296
35822,21,438,928,328,13978,110
22422,117,3019,1195,1950,13484,1069
38504,16,165,856,151,5318,14
57870,9092,150587,442,108205,630899,42382
51714,63,738,629,622,14173,116
10048,8,263,1374,181,19954,82
63226,53,674,267,559,15164,115
7680,14,562,1388,418,32023,144
31196,4,121,1018,92,8150,29
25236,189,2119,1139,1322,12688,797
12547,19,583,1352,358,4879,225
22522,7339,160517,1193,87800,496283,72717
23660,151,6886,1173,4569,36089,2317
53021,304,4519,586,3401,49142,1118
44268,21,377,771,282,5472,95
64871,25,495,218,317,7919,178
11665,111,3508,1362,1953,27856,1555
62234,17,195,293,146,7691,49
18233,88,5763,1265,2525,62202,3238
65489,44,471,202,417,12898,54
21807,98,3730,1203,2362,50650,1368
48592,2,71,714,55,6429,16
32652,6,409,995,276,17249,133
57380,4,42,457,32,1557,10
34099,288,7538,967,5108,45008,2430
61198,48,833,327,698,24541,135
55216,3,99,517,83,2529,16
62602,69,605,283,500,6993,105
62830,342,4604,277,3737,37513,867
63614,2,150,257,79,3138,71
16976,1770,33884,1288,21273,267903,12611
2556,9,567,1449,364,12082,203
29689,7,435,1047,229,4270,206
59362,876,19889,393,13387,107386,6502
62299,33,356,291,289,4642,67
34994,50,1260,947,841,14441,419
56319,176,4077,485,3418,31441,659
58492,25,726,421,520,21331,206
13677,21,808,1337,484,13929,324
46676,101,1717,743,1455,30571,262
19315,2598,45259,1246,27899,210236,17360
5430,6,167,1417,106,6191,61
5810,86,3743,1412,2641,49234,1102
28685,12895,281419,1066,171182,1076348,110237
29259,452,9199,1055,6744,66667,2455
67020,7,181,157,133,4568,48
63324,55,467,264,357,7390,110
41314,6,193,814,146,21243,47
35713,2768,76769,930,55817,348941,20952
65096,313,5056,211,4257,57324,799
58339,68,1209,427,999,16098,210
5606,76,2458,1415,1562,16028,896
16978,22,541,1288,351,20922,190
65112,136,1284,211,1001,9285,283
65195,11,73,209,62,2224,11
23902,2,110,1169,77,3973,33
49704,184,3062,682,2449,30409,613
62665,2228,33623,281,26511,105534,7112
25790,1257,24266,1127,16022,110857,8244
33385,714,13328,973,9376,109278,3952
60737,14,451,344,315,3795,136
12095,0,0,1358,0,2999,0
56059,131,1376,493,1083,20740,293
21217,8,399,1212,266,4710,133
56623,1110,30310,477,23327,143722,6983
25287,22,439,1138,282,11497,157
55500,125,2044,509,1010,16554,1034
52558,84,999,602,875,15669,124
20026,13,432,1234,290,6195,142
34408,204,5990,961,4688,52616,1302
10996,61,1740,1368,1131,17277,609
16956,27,1867,1288,1323,13881,544
8245,81,1678,1383,1092,13118,586
64445,75,880,222,757,7573,123
38211,118,1445,864,1157,21609,288
15832,9,270,1307,189,11245,81
523,513,13628,1465,9264,98371,4364
32648,1491,26482,994,20855,175441,5627
11645,216,15848,1362,8665,51408,7183
4757,12,520,1425,353,27907,167
52672,13,126,597,113,14059,13
19827,84,4294,1237,2311,52846,1983
61762,93,2262,309,1671,55412,591
18265,2,84,1265,62,7886,22
60626,104,1713,348,1219,14128,494
24859,54,1788,1147,1457,27293,331
58154,184,2614,433,1917,15056,697
6392,31,1205,1405,872,17908,333
19354,118,2003,1245,1604,77938,399
67974,12,207,126,140,4247,67
37951,424,8765,871,7252,49046,1513
61828,10,197,307,157,6473,40
22606,8,274,1192,208,31797,66
45026,36,532,763,328,3734,204
1047,520,17711,1461,11717,117376,5994
60558,61,725,351,539,20883,186
39001,8,118,847,98,4742,20
44106,3534,52371,773,38386,261190,13985
42434,380,8587,796,5979,98673,2608
5998,16,552,1410,408,13562,144
14871,9417,350332,1321,204176,1519243,146156
11525,645,26288,1363,17060,192382,9228
31919,4,99,1007,69,4465,30
56058,38,534,493,407,6505,127
10716,4,165,1370,98,22247,67
102,18,965,1470,646,33639,319
2918,34,703,1446,509,17188,194
17867,0,83,1271,62,11006,21
33615,0,0,977,0,13538,0
21265,15277,280389,1212,175144,591529,105245
38237,226,3516,863,2719,20261,797
33564,74,1063,978,824,15377,239
9588,243,8627,1377,5697,42337,2930
15094,4048,165549,1318,105140,502492,60409
25979,27,931,1123,579,30701,352
20483,7072,219712,1226,153966,768336,65746
65612,9,125,199,110,4732,15
22030,268,3431,1200,2388,22292,1043
28006,2,41,1078,30,7659,11
67660,58,962,136,680,13465,282
53259,2,76,580,62,2902,14
11432,98,5618,1364,3420,60369,2198
6228,105,4233,1407,2793,73147,1440
29124,32,1614,1057,897,19458,717
31648,20,737,1011,510,40313,227
54920,84,938,524,827,17746,111
50942,33,411,650,328,10253,83
63330,294,4291,264,3596,17927,695
56610,60,541,477,388,6661,153
1160,147,4940,1460,3263,26079,1677
52756,53,557,594,493,18630,64
60283,4,43,361,33,3857,10
68592,47,629,105,501,8060,128
49664,8,148,683,102,7883,46
54476,4,56,541,50,3697,6
63373,38,634,263,492,9915,142
68409,13,209,113,187,5346,22
54629,264,3131,535,2682,35841,449
51844,269,3003,625,2417,20658,586
69054,88,702,90,652,9000,50
27858,48,1063,1082,603,6149,460
64215,560,8701,216,6412,77953,2289
22902,6,416,1186,313,12866,103
20490,22,919,1226,641,9907,278
52909,771,10420,589,8401,44926,2019
27541,24,668,1088,410,9295,258
64590,105,761,227,557,6887,204
11490,64,5322,1364,2739,20824,2583
7153,60,1855,1395,1192,38048,663
23365,16,210,1179,150,4898,60
68441,31,515,111,442,10870,73
11662,4074,118859,1362,63125,456366,55734
8298,2611,51993,1383,32362,108343,19631
30474,4,211,1031,183,11948,28
44657,11,234,767,173,5376,61
19630,312,4802,1241,3557,35994,1245
48833,3,94,707,65,14497,29
15949,23,1234,1305,876,24966,358
26251,19,1179,1118,671,11475,508
9359,2087,77484,1378,44222,305889,33262
16970,157,6268,1288,3131,37769,3137
61462,21,278,319,216,3777,62
335,32,1613,1467,1248,34340,365
13664,20,1352,1337,720,8760,632
41137,11,445,816,362,14109,83
24687,45,1022,1151,756,15606,266
24908,292,7540,1146,5146,58053,2394
35895,358,7672,925,5887,38583,1785
37178,15,396,892,295,11371,101
1743,13,765,1456,468,41168,297
7345,4,189,1393,119,6721,70
32229,4643,85899,1002,57284,224639,28615
62120,245,2397,296,1834,12527,563
30551,233,9413,1029,5479,20568,3934
29513,44,914,1050,475,8697,439
55398,1992,25750,511,19162,110634,6588
16291,291,4956,1299,3464,28151,1492
62359,5,62,289,48,5157,14
25071,89,1869,1142,1064,8690,805
6308,131,5924,1407,4107,50316,1817
5315,3171,79087,1418,50864,392086,28223
65502,852,9200,202,7305,69112,1895
14087,1707,45395,1331,32567,149357,12828
67229,2,43,150,39,4974,4
26920,92,2007,1102,1092,15470,915
40734,32,469,823,402,10661,67
55265,23,124,515,87,3188,37
19547,254,10331,1242,6984,51749,3347
56246,168,2888,488,2288,27120,600
21458,1701,55714,1208,34247,386602,21467
53238,59,845,580,702,6750,143
15469,11,171,1312,121,5459,50
24642,25,812,1152,541,11866,271
31413,12,366,1015,239,11610,127
5631,28,1464,1414,967,23097,497
64123,18,160,240,125,4294,35
28970,74,2265,1060,1472,52510,793
59111,0,604,402,445,8247,159
42392,424,5853,797,4527,28302,1326
27376,14,556,1093,340,9726,216
34786,148,2566,952,1950,39311,616
37104,739,9845,894,7528,34172,2317
35614,146,5035,932,3851,65265,1184
614,4,430,1464,312,43740,118
12044,5,320,1358,178,14267,142
12338,80,2997,1355,1986,35722,1011
63703,6,142,254,125,12999,17
35494,113,1853,933,1336,17011,517
15915,132,3770,1305,2721,23734,1049
4061,376,11686,1434,7737,137832,3949
28940,94,4129,1061,2745,56612,1384
34981,4358,81874,947,50478,259576,31396
53329,1086,11183,578,8641,60823,2542
35167,14,300,943,215,5775,85
18057,3,70,1268,55,3531,15
29079,112,3259,1058,1953,16084,1306
928,183,5986,1462,4248,28243,1738
23656,84,2706,1173,1991,47630,715
4791,63,1418,1425,987,22763,431
8222,410,11939,1383,8276,93385,3663
61953,28,203,303,152,3690,51
51983,255,4089,621,2881,28347,1208
32682,37,984,995,614,9233,370
29595,0,0,1049,0,7571,0
7434,41,1369,1392,897,26808,472
35720,24,528,930,401,11812,127
11454,205,7304,1364,4571,47303,2733
22648,317,7614,1191,5652,32939,1962
63192,8,49,268,41,3065,8
42300,125,6137,798,5072,35661,1065
54572,419,4881,537,3876,35238,1005
35672,4,183,931,101,4589,82
38953,4,61,848,54,13645,7
13294,17,308,1343,192,6050,116
20376,13,900,1228,645,15596,255
33454,9,238,980,156,3322,82
37416,171,2333,885,1726,15879,607
31422,11,311,1014,186,9986,125
57778,47,937,445,690,23174,247
31915,377,6483,1007,4630,28732,1853
65151,23,367,210,301,7360,66
21969,130,2206,1201,1468,16097,738
17349,99,2460,1282,1823,38938,637
52209,55,484,614,384,5122,100
61567,10,66,315,55,1673,11
40705,904,17405,824,12684,108625,4721
64808,6,196,220,138,3910,58
58282,8,119,429,90,5245,29
56025,5,60,494,47,4749,13
7882,215,11098,1385,6855,110065,4243
61452,312,12285,319,9392,56922,2893
68004,11,73,125,62,3108,11
68777,1,48,99,32,2772,16
4553,8,226,1428,166,10088,60
53342,35,527,578,429,10277,98
68761,9,145,100,108,4386,37
33262,79,1259,983,842,10994,417
53102,66,579,583,467,9471,112
29213,16,459,1056,280,2922,179
4465,7,282,1430,211,15701,71
46736,184,2687,743,2080,30038,607
31752,53,711,1009,458,10247,253
21638,91,1488,1205,957,15583,531
50754,126,1520,656,1072,16039,448
38886,84,1948,849,1547,25856,401
3840,37,1446,1437,1050,32225,396
49679,17,358,683,271,14399,87
16912,47,2551,1289,2115,28616,436
19100,54,2530,1250,1536,15877,994
50580,25,320,659,264,9095,56
50342,140,2450,665,2036,19473,414
4010,161,8127,1435,5169,59351,2958
35323,20,1037,939,722,12099,315
29531,28,2006,1050,1219,16850,787
15253,387,8338,1316,5687,92270,2651
13021,0,0,1346,0,12922,0
31213,31,610,1017,395,13360,215
4735,978,40339,1425,23384,170932,16955
58434,3,25,424,20,2411,5
11273,85,2813,1365,1822,19149,991
38072,97,2653,868,2105,42299,548
22484,15,530,1194,298,5539,232
51191,44,528,643,413,7233,115
28948,10,638,1061,335,6323,303
7048,619,43991,1397,28421,145739,15570
59939,17,202,373,144,6782,58
9414,31,1866,1378,1191,41609,675
61020,13,264,334,201,9375,63
58122,239,3547,434,2678,12963,869
39612,8,374,840,274,11425,100
28100,47,1489,1077,998,34886,491
9667,27,1422,1377,738,12763,684
24158,40,685,1163,546,11299,139
65281,11,181,207,135,4082,46
24804,108,1552,1148,941,14134,611
66196,19,278,182,231,4368,47
11438,33,1447,1364,945,11574,502
66534,34,395,173,314,6692,81
22067,798,21274,1200,15061,143876,6213
3866,85,2080,1436,1505,66538,575
27076,92,2437,1099,1583,19144,854
36113,45,720,920,612,15454,108
52618,83,891,599,711,8095,180
56993,26,264,466,208,6287,56
30301,19,761,1034,464,14312,297
17118,3,204,1286,149,15504,55
42910,172,2786,788,1767,22716,1019
40729,122,1501,401,1021,16998,480
1534,19,822,1458,587,23515,235
50191,39,453,670,313,17618,140
32061,9,211,1005,152,6058,59
8405,44,1588,1382,976,22870,612
60490,2,33,353,19,4464,14
6099,465,18437,1409,11645,168204,6792
7215,28,1050,1394,636,25328,414
40803,118,1894,822,1640,15087,254
6211,4,182,1407,122,12708,60
2126,30,1852,1453,1328,26833,524
5788,101,2509,1413,1718,26504,791
48806,84,1138,708,848,14239,290
22830,36,1703,1187,1104,30683,599
30892,138,3813,1023,2556,41118,1257
19930,754,36536,1235,22756,209215,13780
36341,19,342,913,296,7875,46
37823,22,912,874,738,18318,174
30663,554,10291,1027,7281,62571,3010
55640,1459,22222,505,16176,100330,6046
48997,150,2395,702,1894,40949,501
38444,54,524,858,381,11563,143
62957,3,48,274,35,2697,13
20565,19,878,1225,626,10755,252
10430,20,906,1372,532,12235,374
44177,2,75,772,62,6256,13
35341,36,967,938,626,9742,341
8229,492,12790,1383,8526,103649,4264
58926,18,222,407,174,6113,48
56876,0,0,469,0,7604,0
4546,20,657,1428,484,14718,173
53185,26,421,581,344,7381,77
36279,151,1960,915,1599,14515,361
62226,3,43,293,36,2544,7
21936,1019,21184,1201,14731,245215,6453
49231,571,10360,694,7306,47132,3054
12788,145,6386,1349,3877,85674,2509
3171,57,1057,1444,726,9732,331
5796,50,1073,1412,719,31043,354
20203,124,4057,1231,2723,17343,1334
22784,60,3051,1188,2011,25166,1040
37472,2,20,883,16,2881,4
4329,52,1601,1431,1144,33262,457
44614,25,368,768,287,5789,81
59335,929,28890,394,24509,107281,4381
19222,6,428,1248,296,18955,132
40094,107,1979,833,1576,12727,403
17628,266,5841,1276,4059,50628,1782
61860,24,467,306,375,6364,92
1217,668,23613,1460,15944,108813,7669
23639,152,3922,1174,2424,44177,1498
62710,90,891,280,688,8959,203
48860,30,719,707,550,15336,169
13568,54,2198,1338,1282,36939,916
20154,6,215,1231,167,8418,48
13268,88508,3702386,1343,2421124,7364114,1281262
19677,14,821,1240,571,21764,250
57440,1579,47981,455,32269,184670,15712
33874,11,94,973,71,4703,23
22486,403,9083,1194,5922,57846,3161
26553,140,4813,1110,2746,38856,2067
7297,15,525,1393,327,13278,198
64729,13,147,223,111,3919,36
6898,17,867,1399,647,20622,220
24371,228,7541,1158,4630,82826,2911
20648,96,3305,1223,2279,39091,1026
2665,95,2327,1449,1785,48240,542
24020,30603,626753,1166,333971,1345484,292782
12241,59,4189,1356,2152,35677,2037
2150,23,2451,1453,1583,101577,868
62508,129,1649,285,1226,13257,423
62167,53,1868,295,1485,15524,383
68450,2,58,111,43,3990,15
23735,156,3136,1172,2619,33211,517
68848,8,103,95,84,1926,19
10732,10,396,1370,271,9129,125
11364,28,489,1365,283,11100,206
10948,56,847,1368,562,13569,285
63297,20,566,265,412,8105,154
60374,41,1772,358,1192,17918,580
53858,22,267,563,178,9076,89
56973,19,345,467,279,13330,66
11622,38,3188,1362,1781,30950,1407
66327,19,275,179,201,7432,74
11766,56,2616,1361,1070,25318,1546
49604,181,2142,685,1689,19325,453
27020,15,664,1100,372,9156,292
61887,20,259,305,192,7581,67
16282,2501,69097,1300,48384,416436,20713
82,279,17938,1471,10227,155414,7711
33952,155,2562,971,1934,10964,628
41097,415,9675,817,7948,49704,1727
5506,4,248,1416,173,22814,75
15181,168,3909,1316,2740,39506,1169
1721,11,444,1456,311,15423,133
10992,13,510,1368,313,11573,197
933,208,8897,1462,6593,31073,2304
28575,150,3037,1068,2074,12440,963
7663,531,24326,1388,15587,238027,8739
36080,2,53,921,44,4499,9
48839,25,239,707,189,5804,50
26791,5,62,1105,51,15699,11
7105,8,238,1396,156,9176,82
1372,69,1917,1459,1301,18426,616
36332,211,2717,913,2005,21490,712
56586,79,664,478,598,11897,66
34954,156,3048,948,2048,19172,1000
41746,2,52,806,39,3920,13
60227,20,178,363,142,7844,36
54207,28,488,551,329,15477,159
32420,106,4560,999,3077,65326,1483
66831,23,364,163,300,9567,64
8197,589,36828,1383,20492,146104,16336
67434,13,151,144,103,4883,48
36274,40,1007,915,864,24075,143
19253,210,8221,1247,5268,100941,2953
20899,32,864,1218,611,12666,253
36936,18,365,899,336,6855,29
32799,56,1718,819,1356,34159,362
65106,4,37,211,23,2393,14
15615,33,768,1310,589,19385,179
36200,15,412,918,328,11134,84
28590,49,1796,1068,1204,24477,592
23357,0,0,1179,0,3114,0
859,1112,45222,1462,26496,327377,18726
26460,60,1252,1113,824,31339,428
16712,9469,467187,1293,319110,1369307,148077
18835,65,1859,1255,1293,64357,566
44324,519,11105,770,7432,41704,3673
10242,7,187,1373,115,4840,72
67774,20,262,133,218,12780,44
58947,167,4534,406,3304,17640,1230
55583,114,918,506,713,12051,205
25716,71,1753,1129,1168,12997,585
3366,79,4515,1442,3112,48864,1403
22254,47,690,1197,456,9856,234
24877,34,1880,1147,1157,26356,723
11883,362,13252,1360,7904,63424,5348
48576,53,1044,715,920,12385,124
20594,48,672,1224,507,9664,165
59677,7,52,382,42,2345,10
28841,49,602,1063,373,8618,229
8778,12,445,1381,268,5073,177
41213,65,1161,816,840,7352,321
61262,69,1241,324,998,5245,243
24676,90,1213,1151,916,20587,297
24399,436,19371,1158,11156,81788,8215
59902,42,503,374,398,11433,105
32033,51,1831,1005,1139,29583,692
49178,2872,37381,697,29031,295277,8350
27769,139,4647,1084,3150,39896,1497
21435,1499,28677,1209,18976,88350,9701
36124,1177,19390,920,13029,85910,6361
60724,15,182,344,150,5627,32
40745,502,8280,823,6524,40230,1756
62613,48,548,256,408,9991,140
29664,19,331,1048,259,18279,72
23571,249,5746,1175,3865,19933,1881
9103,56,1464,1379,917,18830,547
17579,21,564,1277,455,12323,109
15843,10,164,1307,113,14394,51
68888,18,167,95,151,2794,16
1566,36,1249,1457,910,48367,339
64050,23,628,243,531,13553,97
49985,42,604,675,471,13801,133
27170,3,82,1097,65,3519,17
13374,78,2239,1341,1274,15565,965
63535,3,96,259,68,4574,28
12272,0,36,1356,21,4201,15
12073,35,2231,1358,1039,24433,1192
4179,62,2313,1433,1436,28126,877
21215,2112,52462,1212,33674,237639,18788
53633,29,360,570,271,4797,89
2725,2,94,1448,64,8383,30
59580,110,1586,386,1282,20144,304
20546,36,1099,1225,768,51216,331
972,51,1760,1462,1126,43513,634
35683,231,3406,931,2655,48302,751
37222,87,2305,890,1747,17569,558
62223,208,3860,294,3104,14440,756
35184,30,610,942,447,10260,163
48533,76,1786,717,1480,15806,306
35989,132,2106,923,1717,23493,389
16298,55,1039,1299,770,34447,269
55572,12,210,507,150,17580,60
10512,10,273,1371,175,10128,98
4762,1175,21626,1425,13857,201260,7769
32630,27,774,995,587,18293,187
50958,258,3386,650,2480,14017,906
56029,0,0,492,0,6967,0
14509,5646,95390,1325,64844,258521,30546
7509,23,1087,1391,696,32774,391
31059,179,3220,1019,2375,39419,845
26014,111,2444,1122,1634,24218,810
40909,52,922,820,727,13250,195
3559,3,163,1440,118,17957,45
40616,23,656,825,506,13362,150
58543,240,3296,420,2452,19392,844
4620,61,1167,1427,887,15979,280
27595,119,2097,1087,1374,8935,723
18339,1,145,1264,119,8102,26
14181,317,8139,1330,5737,46919,2402
59193,27,276,399,217,3908,59
12792,479,26660,1349,17344,202308,9316
19925,42,625,1235,424,23455,201
57732,219,2760,447,2200,13020,560
474,36,2564,1466,1557,49640,1007
635,199,6829,1464,4884,74700,1945
48791,256,4126,709,3222,52983,904
62884,643,12041,275,9336,103442,2705
14946,238,6034,1320,4206,41631,1828
38116,55,575,866,440,5667,135
24442,28,614,1157,417,9067,197
58421,37,491,424,371,16684,120
27388,104,3696,1092,2626,39227,1070
28783,80,1978,1064,1338,21688,640
4271,8,419,1432,286,17435,133
27119,1224,32732,1098,17906,135168,14826
67584,6,83,138,74,3675,9
43253,34,909,782,761,21579,148
8294,5,155,1383,94,10681,61
54669,118,2491,533,2010,15085,481
15696,69,1487,1309,874,17455,613
4177,19,517,1433,388,12178,129
6345,150,3368,1406,2218,103498,1150
14427,53,1213,1326,813,9679,400
32107,12,286,1003,198,7811,88
17796,4,93,1273,63,2583,30
10026,3,98,1374,54,3409,44
24926,66,3443,1146,2180,30236,1263
29638,6,135,1048,103,10121,32
10546,161,6975,1371,4988,47416,1987
22300,2935,113340,1197,81087,373714,32253
56536,72,652,479,529,11992,123
37324,742,11787,887,9424,66191,2363
13763,138,3267,1336,1884,24229,1383
639,88,3153,1464,2184,37302,969
14664,503,13135,1323,8846,48332,4289
59659,6,50,383,41,3866,9
6310,7,342,1407,236,8553,106
28930,31,748,1061,538,7119,210
63982,32,222,245,194,4177,28
48522,117,1794,710,1323,36058,471
53610,199,2712,571,2044,14406,668
34070,35,605,968,397,10841,208
10792,47,991,1369,598,16051,393
66971,1581,35103,158,26472,189332,8631
27905,13,504,1081,184,6441,320
60631,77,1193,348,938,14895,255
33279,32,1092,983,700,9914,392
51457,16,254,637,182,6731,72
39143,204,2911,845,2335,29697,576
63698,91,1328,254,1156,36656,172
1530,9,1448,1458,834,19540,614
58082,25,498,436,360,12670,138
67816,322,5171,131,4357,51450,814
6876,177,8907,1399,5969,64741,2938
68327,71,1122,115,941,20428,181
20497,435,12125,1226,8396,152651,3729
45098,16,442,762,316,3378,126
33619,7,117,977,89,2822,28
20614,1142,66629,1224,38995,336559,27634
48530,7,90,717,62,10185,28
31733,1179,27408,1009,19167,92673,8241
28855,113,1862,1063,1030,8789,832
54043,111,702,557,584,9370,118
30266,93,1595,1035,1260,18825,335
11051,26,1078,1367,564,8751,514
1629,6,140,1457,103,16093,37
4719,13406,546468,1426,323289,1465642,223179
1654,150,4002,1457,2933,24532,1069
64207,29,361,238,302,7753,59
24797,3,91,1149,77,6109,14
1027,83,3752,1461,2647,43184,1105
40105,131,1685,833,1354,12733,331
449,7,308,1466,215,24445,93
31233,27,711,1017,622,17069,89
32933,129,3477,990,2527,33230,950
61560,3,58,316,44,3286,14
23532,204,5190,1176,3816,70521,1374
28196,758,25046,1075,15959,66690,9087
68190,10,516,120,428,12465,88
33266,405,4551,983,2919,26364,1632
33590,296,8251,978,6001,74679,2250
59945,478,7279,373,5605,51360,1674
13415,9,886,1341,508,12696,378
8119,16,356,1383,243,3865,113
24179,23,244,1163,184,8034,60
8498,5,363,1382,253,10227,110
56072,4,279,493,84,5649,195
62742,20,261,279,210,5430,51
46760,129,3466,742,2588,20130,878
32417,16,636,999,371,4765,265
8569,155,3481,1382,2221,26861,1260
36944,258,7086,899,5629,71550,1457
65316,60,594,206,475,4012,119
35950,217,5096,924,3708,35565,1388
57548,29,478,453,336,9619,142
29679,57,1708,1048,1071,9985,637
1483,68,2852,1458,2148,50264,704
34232,63,1220,965,892,24933,328
37644,86,1263,879,1009,21881,254
57624,62,928,450,734,20078,194
16315,23,289,1299,229,15522,60
31099,3,80,1019,53,2649,27
43829,26,602,776,501,17349,101
36208,45,522,917,392,5341,130
25550,19,323,1133,213,10172,110
39863,174,2109,837,1738,15884,371
17298,1303,27189,1282,18511,257743,8678
3541,12,380,1440,250,16158,130
63807,10,214,251,162,9383,52
57473,6,92,455,71,4571,21
14411,1,126,1326,66,4926,60
1131,104,3850,1460,2413,75073,1437
51330,2312,55485,640,39750,97516,15735
9668,38,1180,1377,827,55560,353
2982,46,1634,1445,1093,25932,541
68849,128,2606,94,2305,23030,301
8048,305,6204,1384,3788,30167,2416
4328,250,4890,1431,4166,48191,724
11453,60,1680,1364,992,8927,688
59604,11,282,384,112,8488,170
36991,259,6398,897,4680,32797,1718
13419,69,2000,1341,1281,41087,719
439,11,214,1466,153,15560,61
54733,81,1065,531,829,22259,236
38938,23,431,848,332,7617,99
68719,88,1242,101,1048,14034,194
19060,62,1759,1251,1198,72600,561
24515,4,260,1155,174,4872,86
38157,18,381,865,307,9770,74
62164,29,373,295,254,5970,119
29349,0,0,1053,0,11652,0
33348,155,3535,982,2467,30415,1068
17742,217,5807,1274,4235,34276,1572
68941,21,407,93,306,7278,101
52113,0,0,617,0,3164,0
42193,26,440,800,347,14138,93
37070,1164,17063,895,14035,214220,3028
12064,9,359,1358,189,23910,170
8125,59,2101,1383,1353,18851,748
59393,55,714,392,604,11569,110
22059,1,94,1200,72,5928,22
26209,5,355,1119,225,5844,130
27345,216,2223,1093,1495,23278,728
68842,18,185,97,155,3836,30
29012,70,1027,1060,699,8288,328
51251,3,41,641,32,3489,9
27663,65,1758,1086,1390,42307,368
5286,13,352,1418,254,9761,98
41109,33,532,817,456,20766,76
30779,4,191,1025,101,4863,90
29362,24,633,1053,448,20574,185
30737,3136,57798,1026,45121,179136,12677
61265,349,6389,324,4982,63865,1407
5871,7,174,1412,119,21998,55
34768,6,227,952,168,8682,59
27174,3,90,1097,59,2067,31
14042,618,8131,1331,5510,39363,2621
59935,619,16280,373,12667,66233,3613
27147,46,1954,1097,1235,32673,719
34701,92,1064,954,775,13903,289
31257,105,2540,1017,1435,12283,1105
9220,109,3940,1379,2595,58626,1345
26892,71,2893,1103,1429,16489,1464
12072,171,5756,1358,3643,34144,2113
7696,2408,39502,1388,22966,154319,16536
35939,70,1252,924,977,9603,275
60020,4,50,371,39,2592,11
62879,36,504,274,398,5961,106
67732,62,707,134,562,8832,145
3950,7,929,1436,391,29030,538
3105,94,4704,1444,3257,82494,1447
40179,202,3739,832,3140,59403,599
33045,47,603,988,398,4835,205
43797,43,699,777,571,22679,128
52841,5535,76946,590,56599,433243,20347
10140,192,5447,1374,3490,34993,1957
32557,356,9675,996,7043,42749,2632
36406,1376,19214,911,15642,145514,3572
67194,82,1390,144,1060,11598,330
14727,857,33321,1322,22313,173455,11008
23020,33,1985,1184,999,15781,986
39203,43,482,845,394,12412,88
20813,62,1755,1220,1209,21978,546
5090,29,680,1421,459,34711,221
58173,9,168,433,139,7137,29
68655,22,268,103,198,3815,70
31650,80,2969,1011,1631,13458,1338
67084,177,2224,155,1857,25011,367
13797,239,9342,1335,6164,109359,3178
11917,167,4921,1360,2680,28135,2241
27549,7,533,1088,350,15941,183
14387,1289,29621,1326,22914,225207,6707
8761,3,238,1381,157,3413,81
63569,6,117,258,88,2953,29
54702,39,390,532,301,9533,89
64313,719,16924,235,13350,106325,3574
11274,0,0,1365,0,11581,0
19220,126,7152,1248,5066,54237,2086
49891,27,315,677,225,3783,90
15642,169,3691,1310,2364,62210,1327
12424,2895,128565,1354,69486,667111,59079
20566,84,3420,1225,2270,85373,1150
17075,4,50,1286,44,8259,6
21161,16,682,1213,529,23125,153
64941,4884,70715,216,55996,233346,14719
68584,2,16,106,14,3035,2
28413,72,2163,1071,1430,31915,733
9206,302,5865,1379,4122,91064,1743
17557,10,288,1278,214,7321,74
18622,3,225,1259,183,4296,42
1401,48,1534,1459,1134,22309,400
33927,141,2210,972,1703,40226,507
49790,18,384,680,333,15185,51
34688,4,136,954,96,4649,40
48261,3,187,723,107,7236,80
67477,12,127,142,96,3545,31
35384,39,396,937,307,4933,89
29692,24,774,1047,460,13160,314
20500,12,256,1226,196,10595,60
42416,4,128,796,83,3687,45
19338,3,132,1246,102,5466,30
43043,60,880,786,733,16410,147
12283,57,2068,1356,1208,27997,860
14670,3868,149024,1323,99729,696877,49295
12983,0,204,1347,101,6568,103
21163,3541,95301,1213,59532,342248,35769
58800,6,48,412,39,3179,9
9973,86,1239,1375,748,10790,491
32343,6,186,1001,127,2635,59
18362,7,232,1263,187,6893,45
1041,1837,47993,1461,29447,220808,18546
9904,2535,95779,1375,58370,501333,37409
40341,34,712,829,537,30311,175
24218,146,3443,1162,2387,50819,1056
14736,3,95,1322,68,9057,27
27112,25,571,1098,389,29385,182
67036,15,174,156,145,3660,29
67538,8,64,140,48,2342,16
40142,394,6821,832,4538,26378,2283
64297,31,405,235,320,6548,85
59894,12,99,375,82,3764,17
20277,86,3725,1229,2474,26207,1251
50477,1064,8035,530,6596,103126,1439
26036,10,994,1122,551,15365,443
9810,189,7405,1376,4741,32745,2664
52467,25,225,604,197,5784,28
28605,9,184,1068,116,4463,68
3990,15,1055,1435,833,13612,222
26318,229,7061,1116,4085,35712,2976
52681,1949,27242,596,22287,157955,4955
12112,318,15611,1358,8444,211902,7167
10887,28,1106,1368,658,17971,448
55142,4,46,518,36,4482,10
3084,929,44013,1445,24026,135432,19987
63377,10,128,263,116,3444,12
22265,3,195,1197,143,7362,52
65556,4,54,201,46,3557,8
2090,152,3766,1453,2670,40306,1096
18561,21,336,1260,263,5023,73
35321,451,7841,939,5948,43240,1893
911,25,1562,1462,1186,58438,376
55647,17,178,504,131,9736,47
15602,44,2520,1310,1699,27017,821
66566,15,227,171,171,9138,56
37759,22,367,875,298,6372,69
56682,77,1018,475,834,8994,184
18214,158,6763,1266,4560,48446,2203
57292,16,341,457,253,7839,88
14465,1015,29859,1325,20172,232366,9687
64293,5,28,235,22,2238,6
589,67,3209,1465,2212,56727,997
19431,13,403,1244,304,18299,99
62303,468,5068,290,4098,25788,970
12997,62,3351,1346,1876,32338,1475
47956,220,1967,728,1531,17351,436
23737,223,2693,1172,1891,16827,802
62493,3037,58044,280,41819,248137,16225
66803,15,171,164,146,1957,25
55935,22,215,497,183,8146,32
4941,552,30853,1423,12660,72117,18193
34476,0,0,960,0,2888,0
54805,1249,15222,528,11359,63983,3863
51871,919,20260,624,15415,76491,4845
35682,3789,70423,931,52577,413096,17846
54171,0,208,552,116,5195,92
23810,6,211,1170,132,9806,79
38262,33,593,863,446,9658,147
37263,15,299,889,237,5360,62
30871,22,731,1023,505,4738,226
46847,28,608,742,410,32502,198
21089,236,5600,1215,4019,86247,1581
42288,2,67,799,40,3685,27
34323,190,5078,963,3666,76343,1412
23364,4582,153036,1179,85007,500118,68029
12307,412,12301,1356,7506,60451,4795
50271,73,879,667,679,11433,200
645,25,634,1464,445,13225,189
31788,992,26972,1009,18068,111264,8904
65906,6,63,192,47,5677,16
13876,151,4413,1334,2873,43907,1540
602,10,657,1464,400,22537,257
14142,76,1706,1330,1080,11080,626
19880,201,6360,1236,4355,72507,2005
57205,120,1077,461,910,14313,167
34199,7,202,965,141,3952,61
62888,71,1913,275,1160,22062,753
4822,487,20434,1424,14325,210054,6109
5306,63,2881,1418,2081,12621,800
28047,41,1039,1078,831,17071,208
64829,35,262,219,216,13056,46
2381,9,251,1451,171,28947,80
35722,16,471,930,364,7580,107
36235,59,1118,916,906,18403,212
32720,7,176,994,125,5618,51
611,1060,46447,1464,29295,250776,17152
62423,17,233,288,194,13440,39
51980,3347,38968,622,31654,277243,7314
31642,217,7922,1011,5080,44659,2842
26453,185,4534,1113,3068,21717,1466
34373,45,502,961,376,8473,126
63935,32,558,247,446,6254,112
20226,149,2484,1230,1700,31184,784
43305,32,517,782,362,7242,155
59281,45,908,396,460,8394,448
30163,88,1168,1037,860,32003,308
18471,123,4081,1261,2770,40064,1311
65270,1,25,207,19,1799,6
19078,14,266,1250,193,9300,73
22076,3,111,1199,80,5006,31
16179,376,10645,1301,6394,73650,4251
4853,3,104,1424,89,6393,15
34013,19,753,969,474,11031,279
34522,115,3952,959,2670,39027,1282
45036,26,510,763,380,7102,130
30401,596,18305,1032,11895,58057,6410
20814,12,243,1220,170,6016,73
25882,548,9112,1126,6125,90376,2987
6425,276,6407,1405,4300,67198,2107
6077,5,168,1409,101,6230,67
49120,1,136,699,112,10510,24
50421,28,431,664,197,34538,234
17178,1073,72182,1284,44097,414716,28085
61584,55,756,315,607,10031,149
2226,258,13010,1452,7808,66217,5202
6941,30,1185,1398,835,20747,350
55236,324,4120,516,3480,61108,640
30601,251,1872,1028,1377,17084,495
65082,95,838,211,594,7223,244
23906,59099,1218602,1169,870888,2064374,347714
51193,23,347,643,282,14497,65
51038,6840,117877,648,82174,408359,35703
33907,87,2444,971,1657,14009,787
44486,55,499,769,426,14653,73
12913,14,825,1348,404,29900,421
5495,338,16081,1416,10247,133528,5834
38411,37,578,859,436,7314,142
66156,51,1620,184,1113,11539,507
56202,47,720,489,560,8467,160
20905,5,71,1218,62,15731,9
926,149,5171,1462,3334,24204,1837
30733,468,11649,1026,7925,131966,3724
48892,31,303,706,243,5448,60
17238,4,87,1284,65,6071,22
5291,11,267,1418,179,11235,88
4678,58,2052,1426,1482,23233,570
15786,2695,57621,1308,38655,175967,18966
46720,399,5316,743,4216,30294,1100
21214,1,56,1212,40,11726,16
62153,1354,15347,295,11961,53303,3386
64809,17,159,220,129,14925,30
58262,196,1314,429,1013,23625,301
36544,28,537,907,387,13200,150
21605,73,1992,1206,1281,34026,711
20590,227,2860,1224,2309,38671,551
18087,616,27760,1268,16798,85955,10962
60028,56,736,371,633,10101,103
46767,79,831,742,660,20797,171
58886,86,1278,409,1009,18388,269
40769,34,319,823,255,4420,64
35581,5840,87759,933,59320,311871,28439
67778,83,1554,132,1280,20091,274
1477,1,52,1458,37,3695,15
37908,7,90,872,74,7496,16
9366,2190,44212,1378,28289,144947,15923
51240,238,3860,642,3137,17465,723
16267,20,919,1300,596,15231,323
30279,1599,27925,1035,19485,150609,8440
6275,39,573,1407,425,11194,148
66859,152,2817,162,2298,33863,519
28148,19,820,1076,548,10350,272
51749,120,1263,628,939,9290,324
41964,44,471,803,371,9895,100
54926,27,193,524,158,5459,35
62715,69,1242,279,1033,16011,209
33894,0,60,972,36,4664,24
13311,67,2066,1342,1215,17372,851
20806,12,790,1220,597,8117,193
67895,62,585,129,419,10434,166
44098,221,4591,773,3601,50304,990
54478,4,50,541,38,2921,12
12970,30,1078,1347,563,15719,515
56736,145,3044,473,2232,18651,812
50055,10,149,673,117,10903,32
59289,4,114,396,83,2584,31
3321,93,3614,1442,2540,51029,1074
37048,217,5886,883,4791,48673,1095
51556,1640,18627,634,14534,66453,4093
4746,116,6254,1425,4435,63029,1819
10789,4480,135369,1369,69558,382560,65811
6127,5,211,1408,145,11680,66
68469,7,142,110,108,3284,34
61826,3416,105690,307,72428,516679,33262
14840,2,157,1321,105,6143,52
21160,90,2455,1213,1751,27188,704
2825,110,6053,1447,4047,57911,2006
41662,678,9709,808,7280,38659,2429
7445,161,10886,1391,6620,93041,4266
13983,1264,37349,1332,25411,243302,11938
21166,271,8692,1213,5996,36778,2696
51186,11,189,644,135,13892,54
13734,25,1103,1336,677,17890,426
29956,150,6339,1041,4053,48491,2286
58930,352,4236,407,3403,14357,833
11285,0,0,1365,0,8202,0
66265,7,84,181,65,3741,19
40272,651,8780,830,6839,62081,1941
26715,71,2680,1107,1765,49843,915
32195,19,458,1003,309,16862,149
10328,69,1666,1372,984,14292,682
57445,10,186,455,145,3783,41
27910,217,5983,1080,4420,31594,1563
32370,94,2187,1000,1511,15785,676
9820,34,1928,1376,1304,21711,624
13767,2,220,1336,123,7034,97
34457,57,1394,960,1013,24701,381
12570,84,2057,1352,1089,25742,968
22176,8,404,1198,263,7972,141
22320,57,1662,1196,1082,15786,580
24533,30,2308,1155,1449,39299,859
5019,13,669,1422,406,17182,263
34773,24,539,952,336,3755,203
24032,28,590,1166,415,13742,175
25560,2,62,1133,51,5201,11
60519,33,371,352,295,4423,76
8059,31,601,1384,393,13138,208
2814,2980,71445,1447,39627,177571,31818
33486,30,871,980,434,8307,437
40872,163,2170,821,1684,14731,486
51302,736,10690,641,8125,104920,2565
65509,43,804,202,720,10941,84
30118,7,444,1038,267,15424,177
56160,88,1391,490,1129,16157,262
13859,23,1151,1334,670,12153,481
30516,15,259,1030,167,2343,92
1850,16,816,1455,568,18231,248
49212,36,1707,695,1369,12770,338
51609,346,5404,632,4740,53043,664
7300,371,14643,1393,9645,83168,4998
15916,17,662,1305,488,15529,174
32646,26,789,995,551,11200,238
51456,658,6604,637,5177,45206,1427
58235,53,619,430,518,17062,101
65302,3,42,207,36,5060,6
48725,635,12174,711,9391,98143,2783
2003,67,4129,1454,2661,46107,1468
28668,612,12385,1066,7519,68975,4866
39912,256,4302,836,3480,30704,822
33286,212,4403,983,3225,35677,1178
2570,214,16729,1449,9790,92974,6939
48557,1206,17416,716,14207,140966,3209
61067,19,282,331,221,6544,61
28884,131,1936,1062,1268,12070,668
5075,146,6756,1421,4374,56529,2382
52636,152,2251,598,1692,32291,559
50353,24,355,665,306,7673,49
54487,85,755,541,616,19353,139
32771,22,321,993,227,6568,94
43131,26,481,784,371,7620,110
20561,697,12759,1225,9328,86994,3431
54133,18,246,553,190,8893,56
12598,145,3950,1352,2287,24219,1663
16788,8,276,1291,220,5735,56
54241,33,215,550,178,3066,37
3839,107,4045,1437,2909,116761,1136
31564,142,3257,1013,2082,11346,1175
34791,24,702,952,464,5278,238
21077,20,747,1215,518,39631,229
20498,7,598,1226,482,33842,116
26546,23,430,1111,339,10031,91
48699,14,1277,711,1001,14182,276
61958,990,20487,301,16668,122508,3819
32549,33,1072,997,699,20389,373
24123,9,359,1164,256,13385,103
57334,52,1238,458,967,9375,271
56961,2521,41526,467,32023,154821,9503
33292,31793,750360,983,501149,2108212,249211
2194,566,10307,1452,6471,42546,3836
58238,85,1259,430,1046,31239,213
17836,1284,17955,1272,12702,97847,5253
55000,31,327,522,249,6109,78
58821,19,289,411,212,8335,77
13745,341,11441,1336,6803,25972,4638
53377,3,17,577,16,2853,1
35216,188,3544,941,2638,14808,906
40512,8190,289757,826,204344,737418,85413
10250,3,330,1373,241,9802,89
39643,46,624,839,481,13655,143
26803,84,1927,1105,1177,24555,750
67949,2,89,127,71,6121,18
24239,6823,145023,1161,87659,314785,57364
11146,45,2100,1366,1296,36325,804
15908,446,14919,1305,10781,125288,4138
18794,150,3042,1255,2214,21947,828
26456,154,2578,1113,2170,35593,408
1182,397,7052,1460,5211,50204,1841
57666,31,367,449,278,8968,89
13516,138,2977,1339,1876,39650,1101
25084,1377,26461,1142,18757,92028,7704
28319,21,407,1073,248,9544,159
40403,15,203,828,166,6328,37
560,62,1924,1465,1377,20115,547
59273,1511,33450,396,26731,151157,6719
31360,1176,20565,1015,14528,68316,6037
62846,18,447,276,390,2899,57
15537,16,1529,1311,939,20025,590
24650,38,2252,1152,1628,34035,624
12253,1242,35718,1356,24365,159715,11353
19277,70,1413,1247,992,19083,421
24959,0,478,1145,324,22104,154
26269,2793,226035,1117,171792,251533,54243
56451,2,133,482,105,4387,28
30822,21,440,1024,310,10601,130
49772,5,149,680,99,9235,50
16644,145,7030,1294,4140,18451,2890
35557,130,2936,933,2262,25830,674
67753,9,90,133,71,12841,19
24225,7,252,1162,211,22347,41
17903,3514,102243,1271,59559,205637,42684
47284,31,829,736,664,21003,165
26651,322,6964,1108,4657,58378,2307
58127,78,1533,434,1071,22132,462
55275,0,0,515,0,4850,0
15486,385,6719,1312,3998,47606,2721
31437,10,228,1014,168,5000,60
14745,46,962,1322,768,24684,194
4818,1434,62706,1424,38391,394882,24315
25937,436,10595,1124,6974,46916,3621
64086,2,61,242,38,1679,23
46014,13,281,752,206,5963,75
15197,281,7254,1316,5111,65999,2143
41328,13,319,814,241,7027,78
23117,411,7303,1183,4032,63069,3271
22209,38,1522,1198,1030,20826,492
25773,128,2772,1128,1783,13974,989
60963,1394,13129,335,9837,38194,3292
42548,3,52,794,37,4201,15
1713,85,4255,1456,2826,57154,1429
25151,33,383,1141,231,6562,152
37481,9121,225389,883,182877,694655,42512
35137,38,880,944,679,16833,201
47332,441,4867,735,3892,27558,975
57568,273,3544,452,2917,80108,627
10372,17,541,1372,343,8015,198
22442,40,1648,1194,1197,24684,451
28662,96,1475,1066,952,11328,523
34556,10,313,958,221,10450,92
25616,165,6629,1131,5284,58912,1345
55993,103,1486,495,1070,19838,416
62606,50,658,275,584,13137,74
34571,31,513,957,355,9611,158
29891,84,2264,1043,1560,24721,704
13339,20,1034,1342,645,16508,389
62162,9,148,295,113,7400,35
34730,571,12075,953,9479,66658,2596
22217,145,2768,1198,1697,26172,1071
22499,53,1292,1194,998,18471,294
49636,67,997,684,775,8316,222
31281,77,1125,1016,725,32331,400
39096,21,565,846,443,12285,122
58259,26,601,429,421,8646,180
31313,3,47,1016,45,4892,2
47781,10,370,729,129,3224,241
25895,119,1897,1125,1239,22910,658
30230,16,585,1036,499,11098,86
17544,2,68,1278,48,3459,20
17991,47,1726,1269,1242,42195,484
14772,5,185,1322,143,5696,42
60215,166,2986,363,2394,18865,592
45212,426,7106,761,5805,38133,1301
36780,8432,152813,903,104556,941234,48257
33943,19,196,971,127,6050,69
19359,169,5915,1245,3405,39467,2510
64120,21,227,241,179,8899,48
37444,124,2947,884,2593,38092,354
6187,451,11135,1408,7614,121193,3521
44922,2477,64818,763,47550,324708,17268
59037,87,820,404,592,6631,228
12797,71,2070,1349,1260,45615,810
45654,78,1172,756,950,15853,222
57815,47,464,444,363,8181,101
17411,213,5670,1281,3980,37260,1690
4247,80,2296,1432,1415,31023,881
57709,5,83,448,63,6585,20
16266,454,7189,1300,5147,62036,2042
25764,2,120,1128,80,3940,40
51473,16488,249437,636,196510,920166,52927
14940,35,948,1320,603,15870,345
59492,30,321,389,264,7047,57
15875,61,833,1306,660,25434,173
50200,163,1744,669,1450,19759,294
56920,27,720,467,494,12619,226
12407,2,308,1354,145,6447,163
50488,66,991,662,800,16086,191
51782,23,479,627,355,28067,124
14926,31,818,1320,612,36043,206
6930,12,423,1398,306,17994,117
67029,33,452,157,427,13807,25
37835,2,33,874,28,8613,5
56342,59,745,485,537,12183,208
20516,77,3861,1225,2746,46055,1115
48718,78,1535,711,1196,11861,339
67909,62,590,128,482,8146,108
8482,69,1687,1382,1056,27696,631
32272,20,596,1002,379,5424,217
18923,127,1889,1253,1239,19288,650
16029,43,1290,1303,830,19085,460
61734,11,59,310,50,3552,9
61280,20,243,324,176,3794,67
68596,38,689,102,511,7443,178
52665,78,747,595,594,10829,153
35646,30,1135,932,803,18100,332
3699,33,633,1438,483,19242,150
19911,63,3617,1236,2659,46595,958
19118,78,3625,1250,2497,40091,1128
29208,2,193,1056,130,5152,63
22848,43,1118,1187,834,8128,284
20409,29,1120,1227,785,13224,335
30073,710,12722,1039,9187,76371,3535
27544,12,496,1088,312,26136,184
32937,135,3530,990,2359,30189,1171
43181,77,983,783,768,13235,215
39952,11,353,835,271,4576,82
19092,123,3381,1250,2395,32158,986
65971,76,1398,190,1120,5342,278
65146,901,14618,210,12905,94568,1713
48945,274,4356,704,3606,76640,750
57248,8,42,460,33,3032,9
16234,7,226,1300,182,14942,44
46236,10,204,749,158,5988,46
35095,50,1541,939,912,15176,629
50577,9,386,659,224,3930,162
21708,85,3243,1204,1930,25738,1313
2956,6,356,1446,214,10754,142
15484,173,6723,1312,4638,49039,2085
38274,13,204,862,164,3311,40
56123,31,356,491,294,5458,62
38214,2,36,864,32,3398,4
5526,871,38204,1415,23887,194338,14317
44636,329,3927,767,3443,70131,484
50899,6,62,652,43,3277,19
28502,133,2758,1069,1804,64111,954
11903,68,1778,1360,781,14471,997
30499,163,5531,1030,3813,82345,1718
56487,188,3811,481,2927,44904,884
68873,45,487,95,400,2814,87
36890,328,6968,901,5178,87926,1790
61511,21,391,317,286,9846,105
64801,223,3578,221,2833,36382,745
65178,54,1036,209,838,13200,198
59189,34,555,399,482,16195,73
55280,263,3172,514,2707,43411,465
17234,18,477,1284,365,13990,112
31798,75,1978,1008,1405,30361,573
551,95,3136,1465,2171,52710,965
4639,19,972,1427,591,11034,381
59036,342,4601,404,3588,22912,1013
29314,0,0,1054,0,3255,0
47775,23,297,729,243,11680,54
8166,4,276,1383,192,18058,84
38378,310,3660,860,2732,36398,928
20863,76,1248,1219,779,13727,469
60351,28,431,359,359,4698,72
57001,3,59,466,54,2291,5
34612,15379,304555,955,178501,794151,126054
59793,19,307,378,239,5728,68
62141,3,40,295,28,1832,12
50251,192,2552,668,1954,15566,598
14109,11,368,1330,233,17433,135
13671,33,1118,1337,657,7066,461
63612,112,1543,257,1282,10715,261
26329,3374,79699,1116,53633,328261,26066
58210,140,4219,431,3140,32738,1079
6457,18,1414,1404,921,13916,493
61995,4454,201672,296,120253,621826,81419
13557,58,1996,1338,1067,18513,929
12370,38,852,1355,485,17028,367
56060,2,93,493,67,4097,26
56341,0,24,485,17,2855,7
10195,21,925,1373,604,38706,321
22293,40,862,1197,587,51070,275
41784,2011,37161,806,22662,200503,14499
60795,11,109,342,84,3351,25
6796,79,4108,1400,2822,37629,1286
34302,375,4690,964,3201,24735,1489
1861,6,525,1455,391,22107,134
24858,129,2891,1147,1827,28648,1064
50874,19,284,653,202,6148,82
9629,244,4392,1377,3139,41598,1253
58449,34,490,423,335,4844,155
18241,12,862,1265,607,36675,255
62343,9,179,290,108,3608,71
23780,1500,36066,1171,26160,263611,9906
37739,23,627,876,505,27788,122
53048,16,252,585,161,8223,91
64532,2649,45086,229,36529,251372,8557
33582,15890,501204,978,371259,1482294,129945
2782,3354,98055,1448,53134,164659,44921
64869,18,903,218,309,6648,594
29053,9,756,1059,492,8197,264
11820,0,0,1361,0,12906,0
16815,708,36173,1291,25757,228692,10416
20325,2,72,1228,59,5042,13
26375,55,1962,1115,1272,20436,690
50998,669,11208,649,8819,125716,2389
60818,0,0,165,0,4389,0
12426,3345,86346,1354,52899,327888,33447
55571,25,185,507,165,10630,20
4561,102,5214,1428,3675,40381,1539
67672,10,147,136,122,2994,25
13921,199,9634,1333,6025,91840,3609
68999,9,167,91,148,3383,19
36010,5,316,923,243,14622,73
13645,8,682,1337,468,21613,214
18529,113,3255,1260,2030,26388,1225
4700,144,3585,1426,2371,38164,1214
33164,6202,116407,986,77871,351207,38536
33169,302,4945,985,3385,58420,1560
7569,51,1915,1390,1121,23323,794
25850,2,173,1126,117,10126,56
59260,871,12359,394,9953,45286,2406
28269,69,1164,1074,763,22562,401
28555,1616,52118,1068,36239,220064,15879
54353,9,23,546,20,3066,3
32568,55,631,996,432,7012,199
34110,246,5058,967,4183,51216,875
2587,75,3055,1449,1876,23910,1179
13928,10,482,1333,311,28141,171
53182,115,1288,581,916,17291,372
26392,62,2608,1114,1492,14296,1116
32528,23,600,997,441,13156,159
37652,74,1571,878,1103,28137,468
28297,21,499,1073,385,11441,114
30450,63034,1989997,1031,1226217,4643018,763780
5508,279,12220,1416,8454,98090,3766
61559,52,866,316,769,24984,97
45203,113,1432,761,1071,23631,361
51926,27,442,623,299,6317,143
38004,5622,222088,869,188002,521322,34086
43457,125,1388,780,1052,16689,336
5754,36,3834,1413,2402,35411,1432
12902,699,12196,1348,7595,44457,4601
35304,41,1211,939,876,14439,335
17972,27,899,1269,714,17073,185
55994,284,5012,495,4088,22503,924
59219,576,11239,398,8339,64589,2900
32668,38,1443,995,845,13683,598
55051,82,1052,521,852,9863,200
51579,298,3932,633,3106,54975,826
11772,53,2154,1361,1109,11234,1045
62208,118,1016,294,813,10303,203
46717,14,220,743,181,26171,39
25853,953,18194,1126,11741,66810,6453
58355,23,457,426,350,7823,107
63205,12,136,267,96,3278,40
28504,162,4397,1069,3083,50107,1314
37982,1735,34350,870,28276,229150,6074
27746,120,2596,1084,1893,26109,703
19994,6,275,1234,179,19438,96
13644,101,3631,1337,2327,42165,1304
66639,19,322,170,282,6553,40
9480,2,165,1378,84,7110,81
25422,1477,18617,1135,11929,114214,6688
22806,87,2723,1188,1904,22380,819
37662,59,666,878,463,17394,203
42204,142,3221,800,2582,53925,639
19348,2154,36222,1246,20782,264495,15440
11434,26,608,1364,386,13041,222
58317,16,237,428,219,7661,18
17982,22,598,1269,467,15470,131
40610,526,8838,825,6467,94935,2371
3363,15,178,1442,127,15864,51
13757,53,1240,1336,702,21703,538
67111,13,139,154,121,6917,18
32962,32,1327,989,894,21512,433
33176,169,3310,985,2336,34516,974
20275,2,119,1229,92,5812,27
50287,37,486,667,405,18049,81
58094,39,811,435,650,14198,161
36875,6693,148140,901,110535,708667,37605
19025,9,176,1251,129,12946,47
19405,0,0,1245,0,20454,0
29167,7487,135158,1056,80931,471899,54227
27452,309,9717,1091,6577,51978,3140
61017,72,715,334,622,9153,93
28353,47,942,1072,626,12882,316
28226,8,392,1075,250,6997,142
57965,166,2475,439,2058,32222,417
66428,994,12068,172,9418,54087,2650
9163,43,3475,1379,2440,44142,1035
48947,171,2244,704,1744,49583,500
5802,25,1869,1412,1381,18199,488
29474,129,1883,1051,1207,15935,676
56856,321,6769,470,5738,36526,1031
24753,40,1699,1149,1163,14786,536
22659,62,1712,1191,1112,28999,600
67721,23,171,135,129,2501,42
35068,900,19950,945,15153,101669,4797
33030,5,86,988,61,3322,25
52356,96,1399,609,1116,36623,283
51943,43,488,623,456,9741,32
52367,62,439,609,337,8613,102
41744,29,639,806,524,12943,115
3767,5,355,1438,254,24779,101
64641,16,257,225,202,7439,55
4820,23,469,1424,368,26984,101
1004,23,1368,1461,946,63136,422
35662,180,2883,931,2458,39688,425
6361,110,3041,1406,2127,43163,914
29537,5,253,1050,150,6324,103
20441,17,821,1227,628,23071,193
26058,115,2645,1121,2292,46046,353
22562,1066,24837,1192,14786,74422,10051
28000,4,223,1078,140,5559,83
21257,19,286,1212,184,5822,102
31088,3146,42332,1019,25452,115468,16880
61542,380,5635,306,4126,35081,1509
43749,473,7556,777,6013,47331,1543
8685,141,6962,1381,4399,40653,2563
28426,201,3667,1071,2009,18903,1658
32300,3,189,1001,122,4314,67
23676,13,514,1173,370,8821,144
7859,34,755,1386,537,11495,218
30612,3417,67493,1028,42279,319886,25214
23903,733,41120,1169,27152,299467,13968
11541,5,188,1363,109,6642,79
4413,65,2727,1430,1892,56915,835
56551,300,3950,478,2815,30322,1135
6411,2262,41055,1405,28082,191080,12973
12740,194,3331,1350,2047,37223,1284
520,177,10085,1465,6628,178256,3457
59255,13,169,397,143,7663,26
2824,3,302,1447,189,10688,113
29645,20,593,1048,335,9841,258
3645,22,819,1439,626,10066,193
9754,3,426,1376,278,9064,148
20700,4365,78419,1222,59736,353158,18683
24439,1300,25690,1157,17501,110303,8189
65465,7,144,203,137,2785,7
22227,28,1018,1197,613,18310,405
30816,2672,63233,1024,41968,224252,21265
38722,229,3591,851,2728,22049,863
50728,7,177,656,140,8780,37
52898,30,402,589,300,10655,102
56659,86,974,476,797,10796,177
20761,31,1604,1221,1017,16290,587
5749,9,952,1413,730,18339,222
37379,993,14300,886,11014,110749,3286
5979,32,1190,1410,840,34662,350
22358,19,927,1196,705,23524,222
15828,22,770,1307,526,28190,244
28123,20,662,1077,413,10736,249
28960,105,3714,1060,2176,28927,1538
21399,25,522,1209,369,11349,153
22722,525,7108,1189,4977,91442,2131
22570,6,189,1192,148,6134,41
22553,27,717,1193,516,8450,201
17183,0,279,1284,224,8928,55
145,2207,164660,1470,106293,949766,58367
28811,20,1150,1064,664,15928,486
62679,113,1472,280,1170,13666,302
51232,456,5529,643,4291,76025,1238
61516,22,338,317,293,12438,45
28345,26,931,1072,610,15303,321
18741,105,2264,1256,1608,33681,656
2878,160,4091,1446,3158,25795,933
68407,14,96,113,75,3855,21
18303,42,1025,1264,707,31455,318
30778,44,1055,1025,742,27652,313
45851,15,284,754,178,3709,106
22900,2,205,1186,153,5541,52
10067,542,14610,1374,8778,78604,5832
64178,35,222,239,175,4778,47
63556,452,6771,259,5222,24126,1549
36508,75,1517,908,1112,20053,405
63654,15,155,255,119,2663,36
49233,408,11313,695,8082,97911,3231
10485,41,1944,1371,1129,49082,815
11286,18,593,1365,321,17573,272
34494,304,3170,959,2549,21571,621
11103,330,11655,1367,6942,57065,4713
29460,107,1927,1051,1613,19664,314
2992,652,29976,1445,21769,100846,8207
62118,135,1411,296,1193,13490,218
30136,137,4090,1037,3085,95422,1005
51965,40,411,622,351,7529,60
57122,37,699,463,527,15343,172
34235,155,5453,965,3664,38100,1789
31137,60,2643,1019,1659,17699,984
2092,607,24299,1453,15991,138548,8308
58300,75,651,428,551,12857,100
58345,53,857,427,709,10697,148
31847,109,1870,1008,1381,26069,489
6743,10,412,1400,292,9170,120
68162,49,1210,120,970,11261,240
62079,461,6634,298,5358,61670,1276
14205,3734,90353,1329,62066,346443,28287
55154,558,5530,518,4331,80984,1199
65475,2,69,203,48,2253,21
29642,0,0,1048,0,4884,0
55093,122,1115,520,859,13593,256
68302,13,154,116,132,4905,22
21309,17,841,1211,618,13987,223
13730,827,39492,1336,22290,211409,17202
26775,67,1047,1106,716,12001,331
23583,39,828,1175,479,4944,349
55370,526,10508,512,8465,68332,2043
57773,47,675,445,485,11872,190
69042,0,15,90,11,563,4
29378,677,16576,1053,9389,74095,7187
26690,8,109,1107,96,5132,13
55963,486,6592,496,4511,37179,2081
55780,136,1605,501,1370,18851,235
3402,7,1071,1441,728,11942,343
14534,52,1175,1324,837,24381,338
53878,151,5443,558,4289,33377,1154
39570,277,2927,840,2205,22735,722
51363,40,549,639,429,5603,120
18460,4,212,1261,170,5481,42
52918,1154,17778,589,14148,73237,3630
47191,52,816,737,609,21586,207
19556,1635,39385,1242,27495,119570,11890
5954,120,4095,1411,2327,29926,1768
979,10,573,1462,377,7097,196
30683,10,564,1027,343,3792,221
65297,24,241,207,205,5710,36
26808,16,374,1105,190,5184,184
61608,2493,28735,314,23224,123075,5511
49845,7,119,679,97,5054,22
36759,249,2138,904,1497,9901,641
5811,927,39507,1412,22354,116704,17153
66099,13,198,186,153,3213,45
28922,249,8047,1061,6003,68315,2044
11669,1076,44391,1362,22242,202540,22149
10918,6,222,1368,130,20233,92
41631,21,236,808,181,11092,55
23678,1,131,1173,93,5967,38
57458,3,58,455,46,4170,12
14913,558,12783,1320,8744,127836,4039
1771,93,6478,1456,3740,25026,2738
57563,468,9390,429,7312,57009,2078
64254,12,85,236,67,5690,18
51250,5,60,642,44,2935,16
32363,3575,52180,1000,42258,874545,9922
20715,1,66,1222,51,5006,15
64206,20,367,238,279,23759,88
974,93,2830,1462,1950,52651,880
32386,794,14438,1000,10259,66170,4179
16694,7,199,1293,147,18063,52
19931,71,3066,1235,2220,38515,846
31994,36,345,1006,238,9572,107
17655,45,928,1276,623,6663,305
50673,2,47,658,36,2792,11
55969,58,1397,486,949,34351,448
30736,11,218,1026,168,10334,50
35788,186,4986,929,3594,57573,1392
59742,184,1538,380,1172,16571,366
55608,10,289,505,236,9440,53
66003,100,1510,189,1249,17233,261
16083,114,2636,1302,1831,27219,805
30347,227,3903,1033,2600,22507,1303
57096,36,476,463,372,14258,104
633,107,4323,1464,2930,32355,1393
621,50,1611,1464,1176,19438,435
61855,50,647,306,500,8535,147
12293,303,14680,1356,8530,59848,6150
17820,322,9442,1272,6424,103626,3018
20251,192,4979,1230,3558,41847,1421
63903,2946,57315,248,45543,219627,11772
52242,28,551,613,465,9976,86
10277,10087,476592,1373,268096,2019152,208496
65923,47,391,191,335,11455,56
23796,1211,27296,1171,18180,112361,9116
9387,1270,51536,1378,28816,312124,22720
9967,10,388,1375,246,12457,142
14445,14,1703,1325,1140,15388,563
31147,153,3722,1018,2490,14541,1232
2336,276,10651,1451,7099,40778,3552
18487,62,1204,1261,981,17144,223
37237,33,737,890,473,14722,264
56768,0,359,472,269,11366,90
19166,24,782,1249,615,12288,167
55876,54,750,499,534,5210,216
1621,17,921,1457,606,41905,315
64752,557,7032,222,5937,42956,1095
7652,33,978,1389,661,17009,317
6391,18,272,1405,195,7462,77
49128,335,3264,698,2304,23589,960
37190,10,260,891,204,7758,56
44051,158,3061,774,2659,29683,402
40384,12,318,828,233,8750,85
21024,52,1262,1216,921,19550,341
6161,2030,69980,1408,45377,211746,24603
17957,26,839,1270,703,21571,136
2023,6,282,1454,211,20825,71
7461,171,6108,1391,3938,52741,2170
34084,16,446,968,257,8129,189
12859,237,6795,1348,3999,33040,2796
52348,445,4150,609,3323,29025,827
54701,5,30,532,28,4653,2
28229,3,62,1074,43,3988,19
36220,5,153,917,130,13939,23
24492,305,7353,1156,4913,55902,2440
9881,149,6243,1375,3645,27397,2598
58983,420,8443,396,6685,75471,1758
65325,311,3654,206,3050,31397,604
1909,982,29905,1455,20066,158287,9839
902,28,951,1462,662,33897,289
48267,4,69,724,48,1943,21
26479,18,1055,1113,932,16418,123
311,9407,171751,1467,142545,635350,29206
9952,155,7910,1375,4513,86543,3397
51192,10,149,643,121,4860,28
55613,1019,14643,505,11367,52970,3276
62053,60,697,299,587,10462,110
65512,20,104,202,90,2560,14
56885,25,385,469,329,9509,56
1212,504,15676,1460,10335,80729,5341
54612,8,86,536,64,4506,22
19388,0,15,1245,15,3797,0
21051,6,190,1216,139,8859,51
31126,51,1283,1019,851,15013,432
48656,12,298,713,243,7368,55
11705,10,508,1362,276,4418,232
10903,341,9759,1368,6392,71563,3367
30390,44,1023,1032,663,19660,360
50063,63,574,673,471,13546,103
30686,33,537,1026,350,6440,187
51803,18,515,626,403,9334,112
2775,15,1112,1448,771,20946,341
35967,41,1304,924,1017,12899,287
19923,134,4180,1236,2791,54167,1389
49792,219,2325,679,1782,25409,543
39668,4,73,839,53,2183,20
64048,89,896,234,705,16035,191
18492,15,559,1261,431,25236,128
67043,80,2011,156,1606,15045,405
21080,169,3549,1215,2401,30983,1148
929,88,3420,1462,2340,90059,1080
4624,613,18777,1427,11903,89775,6874
31106,10,353,1019,207,11981,146
13386,2417,97465,1341,56626,419797,40839
60773,83,1141,343,946,9651,195
11329,206,4728,1365,2724,32307,2004
26176,17,686,1119,446,14946,240
3470,9,299,1441,200,12148,99
65942,34,290,191,242,3546,48
31529,23,1087,1013,668,10586,419
9525,8,354,1377,203,4219,151
26328,22,767,1116,445,8471,322
65051,10,190,212,147,4482,43
56918,3,50,468,46,4225,4
67670,10,158,136,114,6785,44
16550,18,695,1295,512,9950,183
15024,1963,49564,1319,32551,254343,17013
53179,219,3499,581,2841,23327,658
25970,257,10927,1123,7210,61983,3717
34888,2,499,949,262,17187,237
33086,32,1059,987,711,9207,348
24113,1,111,1164,93,4943,18
11055,134,4886,1367,3406,66701,1480
7598,15,775,1389,535,32147,240
13446,2688,92968,1340,58050,279030,34918
31739,5,198,1009,168,12389,30
31833,83,2546,1008,1571,21728,975
32190,71,1462,1003,994,18405,468
54250,65,611,549,520,30248,91
33726,6,372,975,235,9802,137
26748,126,3137,1106,1976,33812,1161
68641,6,94,103,64,5260,30
21207,22,401,1213,298,6703,103
46073,389,6720,751,5488,73436,1232
28681,73,1489,1066,933,12088,556
64299,14,172,235,144,7754,28
58153,45,573,433,435,23541,138
28157,2,48,1076,34,4131,14
4385,512,11242,1430,6444,64725,4798
45440,4,108,759,84,1489,24
9932,35,1251,1375,858,17176,393
59421,13,147,391,103,7931,44
9415,80,1332,1378,952,15706,380
29076,12,478,1058,306,6178,172
20458,5,168,1226,138,5049,30
63244,11,104,266,66,3085,38
7585,5,160,1390,119,5217,41
54509,13476,200410,512,156847,1125981,43563
29976,18,368,1041,222,7875,146
58571,10,221,419,180,5044,41
23144,56,3318,1182,2119,30659,1199
16558,15,586,1295,418,8259,168
43996,0,1065,774,697,24141,368
13908,13,679,1334,388,14650,291
62220,34,302,294,228,4626,74
25012,200,7778,1143,5298,50324,2480
30451,112,1127,1031,701,8997,426
15961,75,2454,1304,1843,34535,611
15728,6,601,1308,410,15695,191
10699,0,3014,1370,2020,16275,994
34163,42,1796,966,1177,6041,619
41791,42,1243,806,830,10582,413
3122,20,777,1444,580,27514,197
55444,49,468,510,366,10409,102
34353,21,325,963,219,5552,106
950,450,15199,1462,9852,55898,5347
23495,96,3173,1176,2091,31176,1082
25951,57,444,1124,308,10197,136
25403,62,1261,1136,870,11659,391
66184,3,35,183,28,1763,7
50008,74,915,674,754,8680,161
56450,4,66,482,52,3390,14
60072,47,763,369,585,13659,178
19105,21,1086,1250,829,25339,257
66727,5,72,167,58,4408,14
33296,1985,34558,983,25739,123306,8819
57680,37,362,449,282,6295,80
66841,4,47,163,26,1735,21
51728,66,1538,629,1171,35729,367
41848,163,3438,805,2743,58660,695
58608,23,240,418,191,5087,49
16249,220,6409,1300,4676,54509,1733
64521,6,64,229,51,4601,13
63628,165,1925,256,1497,8902,428
10704,0,299,1370,155,13750,144
64131,395,6953,240,5409,19326,1544
32515,18,421,997,350,18855,71
40488,8,231,827,170,6845,61
28732,207,1380,1065,1055,28665,325
11614,556,15711,1362,9777,100877,5934
41003,38,889,818,666,12055,223
29687,1050,33555,1047,20263,253604,13292
35082,11,254,945,169,14618,85
9074,14,923,1379,581,17232,342
5240,33,1468,1419,969,21673,499
52943,57,719,588,571,13149,148
13794,8,375,1335,191,9713,184
35997,109,1558,923,1230,21642,328
66110,59,904,186,762,10625,142
68982,602,13458,92,10748,71835,2710
22081,5,236,1199,164,8554,72
52112,17,227,617,198,14904,29
32564,177,1937,996,1282,28039,655
61713,51,619,311,511,9619,108
57776,6,40,445,31,4604,9
61195,9,72,327,57,5126,15
12259,542,41357,1356,24976,240098,16381
29446,178,3304,1051,2436,104309,868
53623,0,0,570,0,6830,0
45175,22,373,761,299,12021,74
40629,60,719,825,581,12340,138
65834,2,64,194,55,1996,9
57570,36,416,452,314,8653,102
6975,174,3616,1398,2257,58651,1359
28778,1094,18668,1064,12857,58525,5811
44752,270,5188,766,3222,42525,1966
5092,8,495,1421,330,9904,165
49307,752,8836,692,6956,72792,1880
67464,4,33,143,27,2264,6
14090,37,1846,1331,1254,16152,592
66132,30,427,185,326,9446,101
58600,5,68,418,42,3604,26
15100,92,4776,1318,3406,27699,1370
28731,181,3991,1065,2361,11409,1630
2057,301,24915,1454,16387,171385,8528
48654,64,788,439,585,11717,203
48573,354,4978,715,3846,64768,1132
19058,46,822,1251,624,6489,198
20852,119,3285,1219,2333,46560,952
59768,7,180,379,144,4901,36
8388,42,754,1382,496,11044,258
4782,30,1811,1425,1256,22001,555
47491,102,940,733,755,14813,185
5274,49,1118,1418,734,13855,384
36742,367,8495,904,6460,45723,2035
49554,41,708,686,554,8579,154
7711,4,213,1388,101,6089,112
14792,108,3355,1322,2236,143523,1119
11458,68,2024,1364,1348,18514,676
24279,135,3371,1161,2392,36364,979
21147,5,334,1214,233,6945,101
13886,0,0,1334,0,12628,0
1258,18,812,1459,554,21489,258
58114,21,451,435,339,6395,112
10700,24,288,1370,228,8377,60
25964,393,4948,1124,4302,52858,646
6482,18,383,1404,254,8690,129
42494,93,1217,795,950,18570,267
58198,49,731,432,612,12390,119
5173,36,1410,1420,873,15359,537
65911,101,852,192,562,7096,290
56037,4363,86443,494,66403,332382,20040
19605,13,237,1241,169,4713,68
10573,8223,177802,1371,120980,551315,56822
67135,8,155,153,121,7257,34
20386,118,2555,1228,1776,21133,779
24694,17,278,1151,187,13220,91
23767,76,1364,1171,974,23091,390
65912,87,1314,191,1140,10184,174
29129,17,488,1057,391,8740,97
34643,46,791,956,576,12117,215
61049,27,234,333,197,4502,37
20387,7,246,1228,176,6751,70
17065,67,1346,1287,1020,31506,326
33798,61,1122,974,814,23072,308
18011,238,6666,1269,5007,52932,1659
25330,229,3531,1137,2370,36608,1161
50732,3,103,656,85,4364,18
8839,4,210,1380,135,8703,75
3891,54,1932,1436,1422,34665,510
67798,36,388,132,355,5013,33
37558,8,221,881,170,7998,51
60914,11,133,337,108,5050,25
31157,50,1038,1018,662,18935,376
27027,4,72,1100,48,4702,24
30910,20,614,1022,337,18896,277
41012,14,461,818,304,8710,157
1793,22,1248,1456,893,24651,355
49559,3,110,686,94,6707,16
67123,72,799,154,633,9382,166
40849,36,995,821,862,13974,133
23341,1,158,1179,132,8904,26
21844,143,2877,1203,2028,62048,849
956,556,24644,1462,16596,123318,8048
5018,3,113,1422,86,4289,27
19382,5,230,1245,168,8994,62
24104,43,422,1164,306,6689,116
65711,31,816,196,641,10986,175
26942,23,580,1102,375,12336,205
14307,282,8765,1328,6053,101852,2712
10863,63,2383,1369,1447,32255,936
23740,52,1581,1172,1009,12280,572
35549,136,2740,933,2052,18802,688
28927,19,620,1061,466,12760,154
37852,3,100,873,75,5013,25
52237,21,427,613,335,10915,92
60750,165,3573,343,2744,18649,829
58243,82,741,430,654,17265,87
17394,6,231,1281,154,6641,77
1287,10,777,1459,554,24114,223
39307,1,124,844,102,4026,22
25305,38,812,1138,499,16420,313
29192,0,4,1056,3,11296,1
56501,115,2994,480,2464,51323,530
55297,2,45,514,37,4514,8
58870,28,254,409,202,8658,52
38235,5,126,863,82,2066,44
64583,71,1126,227,896,21230,230
25484,386,18996,1134,12035,61284,6961
42620,165,2805,792,2263,26471,542
67787,2,11,132,7,2304,4
60213,77,1672,364,807,16117,865
11593,169,7128,1363,4314,20398,2814
41375,1405,23144,813,15277,77131,7867
21793,14,461,1203,329,17008,132
58960,1757,43794,405,31679,126287,12115
40223,127,2923,831,2210,36739,713
23134,192,4149,1182,2842,40040,1307
16333,3,229,1299,156,15696,73
66553,0,87,172,72,4218,15
62397,35,253,288,210,5122,43
37401,0,32,885,27,4645,5
53559,48,549,572,398,7512,151
8088,441,13804,1384,8882,71003,4922
64159,4,47,240,33,2208,14
22987,665,49284,1185,33283,163550,16001
10556,223,6154,1371,3991,50671,2163
59240,28,429,398,359,11686,70
66058,8,139,187,120,10507,19
37577,1,12,880,9,3855,3
64022,33,554,244,418,9289,136
63076,17,178,271,142,12527,36
6451,19,426,1404,317,20769,109
50080,174,3538,672,2825,73503,713
55166,623,8489,518,6656,41396,1833
64625,70,1060,226,865,12952,195
18377,299,12002,1263,7619,45963,4383
27992,12,169,1079,109,2871,60
49724,20,228,681,180,4669,48
67172,9,196,151,137,4430,59
34927,85,1994,949,1356,26087,638
23581,32,1346,1175,862,6732,484
36813,278,4025,903,2902,21651,1123
23820,155,4495,1170,3176,63403,1319
51538,4,31,634,19,1474,12
63949,197,3875,246,3048,16730,827
19416,585,14808,1244,9845,130289,4963
65689,4,22,197,18,2768,4
2879,9,465,1446,295,15477,170
24786,66,1570,1149,1087,31224,483
17371,167,4304,1281,2934,49290,1370
9150,54,812,1379,631,8629,181
353,18,917,1467,629,42202,288
19915,4,171,1236,126,11406,45
62618,34,570,282,378,18972,192
50929,42,503,651,363,11494,140
21509,22,693,1207,523,12408,170
49508,7,165,687,138,12088,27
14144,16,351,1330,244,10627,107
47292,54,937,736,701,28206,236
44056,20,182,774,122,3596,60
36047,5111,120125,917,82676,649009,37449
66571,4,58,171,50,2577,8
55784,6,49,501,40,2487,9
23441,17,306,1177,207,9869,99
11769,588,13573,1361,7733,49309,5840
62063,1,27,93,21,1973,6
52116,34,410,617,288,11300,122
30007,69,1897,1040,1179,57896,718
12482,135,6382,1353,3556,131603,2826
13736,540,14733,1336,9238,71284,5495
29461,4,132,1051,93,6393,39
42562,4,81,794,59,2904,22
5853,1016,44354,1412,28134,316218,16220
15364,0,0,1314,0,5258,0
53308,45,696,578,561,7177,135
1358,61,1709,1459,1230,48721,479
45280,438,7861,760,5789,38565,2072
51601,164,3614,632,2939,44708,675
58061,772,20737,436,15172,52977,5565
21814,1,99,1203,68,10049,31
65103,2,12,211,8,2055,4
24004,11,329,1167,198,6898,131
6613,53,2781,1402,1952,35294,829
61590,334,5755,315,4136,23528,1619
15195,36,1287,1316,932,21766,355
23025,23,835,1184,602,15188,233
59381,25,335,392,265,7005,70
43429,6,336,780,230,10811,106
55955,179,2482,496,1991,25372,491
8504,49,1720,1382,1019,26940,701
36174,59,746,918,581,13858,165
26663,244,6209,1107,4205,81480,2004
5393,33,1913,1417,1287,24743,626
25532,95,2246,1134,1498,13224,748
36129,454,13101,919,11230,74249,1871
17817,1341,33627,1273,23064,140940,10563
19303,2402,44811,1246,27260,131372,17551
56296,24,386,486,259,6493,127
35474,13473,439352,935,250436,2145495,188916
4429,685,39810,1430,21055,205387,18755
6069,61,914,1409,582,7943,332
17081,25,516,1286,408,13672,108
13754,29,990,1336,581,18790,409
29054,43,564,1059,391,6383,173
50180,36,394,670,317,8465,77
54113,44,493,554,376,9305,117
50787,383,7560,655,6548,70828,1012
53382,497,8440,576,7138,81466,1302
50000,13,116,674,107,10213,9
54507,35,418,540,318,7091,100
38369,8,92,860,62,3249,30
63589,21,483,258,323,8034,160
11628,291,6848,1362,4530,43674,2318
7555,72,2151,1390,1418,60320,733
33150,80,2668,986,1784,53232,884
25063,35,1376,1142,890,26880,486
15455,93,2560,1313,1672,49987,888
1125,9,228,1460,170,16127,58
16012,313,8894,1303,6186,108863,2708
8300,73,2472,1383,1635,13320,837
55263,173,5881,515,4249,40895,1632
26784,237,4313,1105,2936,45681,1377
31652,3,88,1011,54,2925,34
42282,103,1220,799,990,10345,230
10377,115,3856,1372,2535,38586,1321
68008,221,3795,121,3240,23207,555
66170,86,881,183,717,4849,164
6841,6,243,1399,152,5346,91
58289,23,268,428,200,13509,68
4749,312,17254,1425,11194,115220,6060
68810,3,125,98,64,4993,61
1201,56,1708,1460,1257,34655,451
7822,58,1545,1386,984,36409,561
45303,2,31,760,16,6086,15
68718,5,67,101,54,1693,13
21400,45,1140,1209,795,39830,345
56608,0,17,477,11,3161,6
28785,475,14564,1064,12771,108594,1793
48971,66,576,703,448,21570,128
19433,16,1107,1244,907,28052,200
64249,560,7414,236,5933,46029,1481
68727,18,201,101,141,5166,60
37202,2063,98810,891,72477,496734,26333
50987,11,118,649,94,5247,24
31148,156,2502,1018,1756,23999,746
56385,37,425,484,322,9324,103
66808,3,40,164,29,2778,11
27060,8933,233704,1099,149593,1021467,84111
17455,75,3141,1280,2175,36771,966
51284,523,7887,641,3810,66639,4077
49713,375,4358,672,3633,39881,725
20060,8,564,1233,444,24712,120
10585,116,2727,1371,1775,18491,952
51932,76,925,623,661,10080,264
28469,52,1411,1070,1075,15970,336
9699,11,301,1376,223,4317,78
67188,86,1062,151,836,5451,226
49257,30,899,694,707,6643,192
20783,10,233,1221,184,11234,49
38345,47,896,861,711,31397,185
23029,1239,46859,1184,34531,327773,12328
10966,15,843,1368,507,10817,336
48678,28,437,712,358,8299,79
49638,373,10564,684,8148,72503,2416
28656,18,611,1066,383,9543,228
57899,33,516,441,420,16883,96
12992,187,7015,1346,4279,44439,2736
20255,45,1332,1230,906,8654,426
29822,223,4062,1044,2471,20512,1591
65687,9,236,197,211,9244,25
3467,2735,84202,1441,54470,219744,29732
31264,21776,664432,1016,452996,1590177,211436
17717,256,5100,1275,3502,30742,1598
55114,55,1487,519,668,14788,819
55441,14,157,510,133,7621,24
27159,26,1453,1097,911,28676,542
39745,154,2838,838,2257,26903,581
23921,13,203,1168,169,12434,34
21034,122,3561,1216,2561,45373,1000
23862,24,708,1169,565,63551,143
36983,10,187,897,146,7391,41
13382,302,9136,1341,6163,75987,2973
49064,1,125,700,87,14465,38
57667,29,381,449,305,6885,76
16215,21,851,1300,714,22790,137
19704,59,1228,1239,985,21610,243
52721,623,6104,595,4610,26477,1494
31527,172,2506,1013,1567,13925,939
12220,16,435,1357,238,7484,197
1607,2,115,1457,82,18716,33
36033,2061,43268,922,33771,187857,9497
35769,197,3778,929,2849,27910,929
58487,104,654,421,506,7065,148
56611,22,313,477,249,5368,64
23622,57,947,1174,631,6569,316
5597,622,17398,1415,10299,74584,7099
65839,1687,24446,193,20097,145576,4349
30664,10,388,1027,239,15266,149
55149,39,1453,518,1057,20913,396
21776,409,8366,1203,6552,153738,1814
60576,3535,52123,350,40838,155486,11285
10263,14,832,1373,499,13489,333
67331,11,169,147,131,5075,38
68131,1094,15844,121,12441,75413,3403
29030,4,120,1059,106,5637,14
40540,20,456,826,348,7188,108
25725,34,1171,1129,738,8064,433
14802,17,559,1321,396,28658,163
57689,46,959,448,769,14126,190
37007,343,3639,897,2849,33359,790
18553,12,680,1260,492,13533,188
15453,13,216,1313,159,5285,57
22595,21,633,1192,441,31022,192
65372,251,2556,202,2059,12246,497
52346,93,1472,609,1262,19644,210
65671,41,616,197,485,14246,131
62361,21,223,289,171,4079,52
6167,3,337,1408,179,14055,158
36339,1405,28870,913,25443,156424,3427
3159,3161,59260,1444,41881,157583,17379
20432,13,386,1227,286,9520,100
54711,31,246,532,209,11293,37
26605,4137,178056,1109,109549,732077,68507
12280,0,0,1356,0,8590,0
32608,124,1420,996,942,9758,478
21366,1649,42623,1210,28776,342241,13847
30715,42,1210,1026,646,15525,564
46825,2,75,742,46,2943,29
56318,61,612,485,497,4777,115
29560,322,9260,1050,6093,66409,3167
37874,1068,18471,873,15441,110896,3030
30217,167,6918,1036,4658,42450,2260
21781,6,174,1203,122,6415,52
38919,235,2510,848,1965,19340,545
3896,1670,49356,1436,27507,288091,21849
23304,109,2923,1180,1630,26272,1293
23077,39,1865,1183,1200,29107,665
9675,59,1760,1377,1256,22625,504
18829,13,623,1255,464,11613,159
4384,66,1802,1430,1236,24115,566
58179,100,1391,428,1138,14220,253
4365,35,1837,1431,1195,21088,642
59127,15,238,401,170,4159,68
24845,56,1422,1147,1030,29346,392
7021,47,1865,1397,1181,33023,684
16094,147,5541,1302,4056,31287,1485
10347,48,1436,1372,926,13856,510
38955,57,738,840,585,20663,153
23672,4,175,1173,152,12974,23
33639,918,14765,977,10812,81643,3953
62328,2474,27826,290,20347,87276,7479
14990,11,319,1319,223,15666,96
18715,56,1419,1257,1099,37507,320
44557,1873,26991,768,20414,230301,6577
26918,27,827,1102,487,6128,340
48463,67,1275,716,961,37027,314
39134,56,1711,845,1393,27565,318
33459,35,767,980,497,7734,270
37625,36,819,879,641,10829,178
18430,31,1122,1262,737,9544,385
18881,4,137,1254,114,9592,23
10785,16,433,1369,280,6116,153
25522,0,0,1134,0,14559,0
56053,25,294,493,219,5602,75
41031,20,814,818,714,27680,100
43213,268,2660,783,2171,15180,489
9097,11,1108,1379,683,10983,425
38090,177,1667,867,1305,10646,362
56838,43,608,470,493,11940,115
42020,871,16884,801,13832,158579,3052
63984,109,1619,245,1345,11000,274
14359,9,267,1327,202,10081,65
24259,13,414,1161,347,8922,67
67435,75,1355,144,1150,15376,205
48211,121,1615,723,1322,28861,293
23454,164,5709,1177,3775,32354,1934
42776,39,1080,790,802,14901,278
26789,52,2384,1105,1389,20654,995
9131,4385,162805,1379,97168,382022,65637
61236,96,2412,325,1589,24105,823
61782,14,164,308,132,9046,32
32901,87,1754,991,1236,21550,518
38017,324,5684,869,4404,72797,1280
42318,294,4524,798,3381,40002,1143
39248,5,143,844,125,6017,18
27526,9,228,1089,127,5051,101
32756,460,10737,993,8010,67117,2727
40840,140,2080,821,1651,14915,429
12665,89,2169,1351,1252,29917,917
17231,8,311,1284,227,12263,84
8637,13,632,1381,415,10377,217
47329,26,333,735,273,7414,60
4333,3264,120987,1431,76068,452197,44919
3286,34,949,1442,670,15668,279
36899,47,579,900,460,12762,119
23446,17,617,1177,448,10476,169
63816,11,169,251,125,2187,44
63098,114,1701,270,1394,13510,307
53517,20,419,574,330,20364,89
35449,31,469,936,339,3923,130
32056,1612,34624,1005,22087,149616,12537
24865,204,3026,1147,1941,28107,1085
23406,60,1453,1178,1088,18297,365
21443,322,9808,1208,6909,69693,2899
49976,1,22,675,21,3613,1
6808,545,13251,1400,8942,44244,4309
65086,19,431,211,326,10579,105
6817,44,2846,1400,1791,31070,1055
13153,23,1061,1344,585,14212,476
35667,45,784,931,548,14374,236
35352,113,3978,938,3038,44836,940
39093,126,1127,846,835,9503,292
19658,19,363,1240,289,10335,74
8616,38,3388,1381,2036,31811,1352
36753,5,82,904,59,2191,23
58263,32,277,429,209,2745,68
12235,1702,27667,1356,17271,100707,10396
35649,32,479,930,346,8131,133
10135,860,20495,1374,12858,148766,7637
15763,5,144,1308,85,4212,59
34857,12,250,950,159,9664,91
20567,54,1068,1225,853,27735,215
13551,3045,78456,1338,47942,304883,30514
43030,35,340,786,269,12499,71
64818,18,245,220,188,5531,57
9983,50,810,1375,519,14130,291
2607,179,6362,1449,4378,52325,1984
2307,16,418,1451,327,7436,91
2602,24,987,1449,685,48342,302
52703,405,4192,596,3355,52751,837
25380,259,5258,1136,3476,36358,1782
67261,774,14098,149,11284,110634,2814
68438,4,39,111,23,4101,16
32156,3008,48098,1003,35875,128908,12223
36359,16,493,913,370,11651,123
37574,5,85,880,67,4806,18
53938,133,2571,560,1819,52060,752
61912,1474,23929,304,19265,110575,4664
9225,32,1397,1379,923,18947,474
55189,171,2080,518,1708,23340,372
25206,36,929,1140,660,24327,269
25449,11,574,1135,323,5716,251
25128,4,36,1141,32,5699,4
18024,1528,16713,1269,11987,59487,4726
7742,288,14622,1387,9251,183906,5371
56497,416,4525,480,3684,35361,841
16665,264,8248,1294,5778,82844,2470
52264,27,455,612,366,14034,89
18932,20,463,1253,270,5676,193
38088,31,241,867,162,5105,79
47899,26,564,729,447,11974,117
36269,76,1258,915,969,18897,289
17506,33,699,1279,560,23803,139
68130,5,174,122,123,8213,51
59969,87,2079,372,1768,16978,311
32478,22,1163,998,882,11427,281
13064,841,15952,1345,11008,44756,4944
16166,57,1391,1301,1089,8477,302
66094,10,132,186,116,12743,16
16754,364,10088,1292,6405,44981,3683
24798,171,3640,1148,2346,29165,1294
68072,2,87,123,70,4720,17
1154,385,17324,1460,12779,81843,4545
2326,9,205,1451,156,7675,49
31701,590,11068,1010,7325,53070,3743
51856,19,251,625,205,5656,46
2970,126,2718,1445,2038,29211,680
34531,1,30,959,20,4558,10
32295,21,253,990,193,8209,60
10175,29321,960653,1373,640673,2322330,319980
38550,104,889,855,654,15981,235
30649,587,10478,1025,6945,125407,3533
24068,84,4365,1165,2950,10496,1415
23227,53,2680,1181,1550,61326,1130
49279,3885,55578,693,39112,206536,16466
36878,38,729,901,580,11216,149
21036,67,1488,1216,874,7357,614
40096,76,1008,833,806,23137,202
15467,359,8600,1312,5634,52780,2966
62316,8,132,291,102,3036,30
25059,0,58,1142,42,6641,16
9072,103,1642,1379,1107,13307,535
33667,8,273,976,180,7709,93
34841,12,172,951,131,8474,41
14903,32,831,1320,645,17423,186
35573,70,1929,933,1452,14137,477
34270,25,276,964,206,3119,70
4850,184,2700,1424,2108,24573,592
4845,89,2674,1424,1759,58296,915
17188,80,2234,1284,1689,43727,545
66797,105,1238,164,910,10229,328
58241,2,30,430,22,4702,8
3776,1226,23422,1437,15691,152820,7731
55278,106,1225,514,914,11407,311
13129,146,5059,1344,2861,30332,2198
5445,14,438,1416,354,11141,84
27204,37,720,1096,467,9230,253
14452,52,1437,1325,1064,23328,373
12375,79,2952,1355,1770,26276,1182
62471,26,396,286,326,12001,70
26352,1355,33952,1115,20527,185603,13425
9022,360,12035,1380,7884,61152,4151
21858,2,62,1202,51,3979,11
30504,13,620,1030,367,12554,253
23143,5,109,1182,90,6897,19
28802,68,2033,1064,1195,9210,838
14628,82,3608,1323,2595,53867,1013
51956,16751,240342,622,171188,581053,69154
23016,21,423,1184,295,7293,128
11595,48,2114,1363,1329,19389,785
27459,48,1506,1091,901,14364,605
11033,0,600,1367,352,8035,248
21318,26,462,1211,224,12519,238
68503,3,37,109,26,2106,11
63595,298,3651,257,2979,39973,672
4615,2,156,1427,110,10081,46
29382,3,204,1053,135,3694,69
52617,38,411,599,312,12979,99
8170,587,17735,1383,11301,68922,6434
66180,23,182,183,146,2681,36
68028,1239,29118,125,24268,195667,4850
22829,116,4431,1187,2871,80228,1560
468,840,21002,1466,14993,86486,6009
12198,0,0,1357,0,7147,0
53114,53,576,583,486,9118,90
12904,3,145,1348,79,7876,66
14227,34140,972171,1329,662198,2090621,309973
23411,10,240,1178,169,6709,71
23333,28,1238,1179,804,18048,434
50676,0,16,658,13,3152,3
18324,196,3282,1264,2402,23054,880
14587,12,455,1324,314,18546,141
52670,2,41,597,29,2874,12
28848,28,1211,1063,789,28029,422
1688,602,12069,1456,8317,48496,3752
14907,1,0,1320,0,14352,0
8859,1359,57001,1380,32436,316423,24565
30506,2138,39633,1030,26366,127814,13267
61212,7,97,326,67,2002,30
31478,18,749,1014,463,7869,286
63406,3,23,262,17,2320,6
51592,844,11005,632,8311,63954,2694
31300,145,3187,1016,2378,27796,809
53761,139,1526,566,1198,16221,328
19722,4,170,1239,137,10222,33
7891,92,5180,1385,3141,43361,2039
25654,4927,100372,1130,63531,405764,36841
4868,211,7963,1424,5225,78256,2738
66696,2,23,168,12,1747,11
11947,19,1736,1359,810,27928,926
59632,83,592,384,450,10494,142
64793,218,3312,221,2616,25193,696
48776,1207,14949,709,10831,100214,4118
37115,10,177,894,149,3471,28
1297,337,13780,1459,9988,50520,3792
19676,28,1211,1240,866,19385,345
58616,7,71,417,55,3601,16
41875,6452,133779,804,103917,585779,29862
24328,195,4928,1159,2660,19692,2268
3457,236,7670,1441,5224,55144,2446
56729,183,3692,474,2992,28801,700
25996,0,58,1123,41,3352,17
10810,10,458,1369,247,20375,211
28516,56,2311,1069,1602,49636,709
54489,463,5750,540,4421,45102,1329
32443,23,389,999,274,7031,115
26658,231,6453,1108,4797,33580,1656
49756,9277,133786,680,96460,557083,37326
35988,95,2377,923,1647,23662,730
8328,2556,69662,1383,42635,195563,27027
37806,1942,69642,874,53396,414559,16246
47819,51,858,729,604,8524,254
37352,15,500,886,390,12245,110
13217,18,921,1344,498,15566,423
19736,190,5465,1239,4058,85451,1407
20535,16,988,1225,637,15855,351
21459,3624,86743,1208,59206,313416,27537
6191,14,365,1408,219,9372,146
26619,877,19035,1109,11780,125212,7255
49639,180,2117,684,1685,10381,432
15850,32,755,1306,550,17743,205
3488,1292,39131,1441,25498,176756,13633
56755,96,1953,473,1427,22298,526
68202,98,1054,120,858,11456,196
64358,4,58,233,37,4142,21
48454,15,204,720,147,6995,57
4568,3,115,1428,86,15067,29
3781,63,2025,1437,1374,33676,651
7478,1027,57956,1391,33876,299108,24080
67191,5,76,151,60,3896,16
25708,990,16639,1129,9576,54078,7063
58309,6,35,428,34,2579,1
21884,661,18853,1202,12566,86435,6287
14014,49,3807,1332,2527,28787,1280
35499,4,408,935,260,19093,148
21732,155,6342,1204,3605,36006,2737
9713,25,1135,1376,756,8416,379
33284,34,589,983,461,8140,128
58435,37,397,424,345,9161,52
52413,20,256,607,187,4211,69
4919,5,224,1423,156,9411,68
5236,25,2403,1419,1577,28214,826
65562,27,449,201,333,6633,116
36372,290,4434,912,3241,50174,1193
2922,47,3851,1446,2336,59891,1515
9073,15,804,1379,514,22101,290
60222,729,17028,363,12008,56643,5020
8535,2919,97533,1382,66792,361834,30741
58779,35,349,412,300,9991,49
33189,6,191,985,136,10008,55
63255,145,1781,266,1412,12635,369
15757,60,1582,1308,1117,21557,465
40753,215,3552,823,2820,46420,732
20032,44,1297,1233,914,24486,383
20313,27,1641,1229,1233,58787,408
32305,60,789,1001,526,11514,263
67155,15,261,152,218,5915,43
19306,62,2095,1246,1470,31809,625
53203,11,140,580,73,3378,67
50316,3256,58649,666,49110,175292,9539
2182,643,36832,1452,22153,148173,14679
56959,14,227,467,148,3714,79
20872,48,1024,1219,784,20479,240
36009,1,30,439,20,2471,10
51604,11,89,632,60,3897,29
20521,706,30678,1225,19534,157679,11144
49436,71,858,689,692,16391,166
21680,27,1661,1205,981,13771,680
15411,9736,465109,1313,275521,934622,189588
57729,157,2669,446,1821,32846,848
68631,60,521,104,462,5551,59
60184,98,1553,365,1394,16255,159
42273,657,16293,799,12796,110211,3497
3140,25,691,1444,514,26791,177
14819,16,642,1321,460,22817,182
46934,366,7348,740,5844,116126,1504
21488,1189,29043,1208,19285,183944,9758
65792,27,371,146,320,12795,51
27082,11,612,1099,391,11568,221
60581,24,573,350,429,3843,144
60954,659,9290,336,7368,37214,1922
31365,411,10806,1015,6526,48747,4280
54071,80,787,555,692,12356,95
63687,50,774,254,550,9709,224
46699,514,10445,742,8846,124039,1599
60284,147,1627,361,1298,13607,329
25502,57,3632,1134,2246,28216,1386
64585,30,434,227,340,5786,94
59565,103,966,384,742,12258,224
16521,625,15446,1296,11427,72089,4019
38174,6,209,865,144,10510,65
40706,12917,261470,824,175765,680917,85705
52889,7,132,590,114,19716,18
33976,29,1485,971,979,37311,506
23053,40,1114,1184,833,13827,281
36276,32,671,915,547,8281,124
61571,3,75,315,42,6077,33
11080,56,2908,1367,1808,18832,1100
58191,963,15720,432,12761,119765,2959
55071,273,3607,520,3180,32827,427
17613,132,3036,1277,1952,15489,1084
36550,2,122,906,90,7402,32
32655,1189,34069,995,23365,248469,10704
19531,3,121,1242,89,9160,32
9763,866,36437,1376,21548,127130,14889
57954,31,441,433,285,3908,156
9565,10,243,1377,147,5292,96
64160,25,289,240,242,5511,47
7901,7804,186796,1385,99173,370649,87623
56744,2568,48165,471,35771,152149,12394
10481,519,11302,1371,7864,30167,3438
33037,18,656,988,391,8306,265
10976,376,5686,1368,3216,18200,2470
27221,125,2826,1096,1881,69126,945
51666,139,1760,630,1455,24005,305
25179,543,10956,1141,7403,36468,3553
2722,10,313,1448,177,11156,136
28620,21,842,1067,544,16641,298
30776,8,365,1025,199,8576,166
60365,21,256,358,159,5475,97
54445,226,4255,542,3387,34845,868
25794,1752,52110,1127,35015,184879,17095
57695,13,269,448,218,10862,51
1517,3,235,1458,156,18066,79
8852,59,1669,1380,987,24862,682
27500,23,830,1089,518,30928,312
3297,60,2953,1442,1887,22269,1066
58311,673,14034,404,9727,69342,4307
32644,1533,85433,995,61824,199791,23609
16625,262,2650,1294,1897,40375,753
49126,164,4303,698,2212,34078,2091
61085,354,5295,331,4391,63070,904
4208,13,667,1433,497,20199,170
5267,75,3837,1418,2555,52285,1282
1625,84,5702,1457,3700,44176,2002
67719,39,465,135,374,3195,91
68701,15,218,102,156,4706,62
20822,177,5780,1220,4161,48421,1619
31463,506,7591,1014,4794,32594,2797
50338,46,441,666,347,7074,94
44288,6,78,771,63,3725,15
48487,1350,15441,713,11530,146465,3911
4509,9,214,1429,165,10571,49
52272,10,207,612,155,11261,52
20398,6,213,1227,161,11238,52
302,78,6042,1467,4448,32175,1594
19539,7,284,1242,217,7869,67
57433,95,1122,455,895,10522,227
21123,3533,147385,1214,109958,820846,37427
3980,59,3428,1435,2572,38906,856
49649,128,2432,684,1754,23731,678
49339,572,11647,691,9522,70478,2125
1448,71,4019,1458,2765,36781,1254
20996,13,277,1217,194,6800,83
13888,671,19620,1334,12025,136660,7595
30204,68,2343,1036,1381,15098,962
8612,12,569,1381,349,8369,220
68098,6,57,122,44,2409,13
22169,34,781,1198,506,21994,275
35849,16,325,927,225,5427,100
66648,8,122,169,87,4617,35
7184,2816,50180,1394,33584,352053,16596
34440,7,228,960,162,7636,66
35419,44,496,936,357,4894,139
737,211,13472,1463,9091,122227,4381
2612,98,1668,1449,1220,18982,448
37169,95,1098,892,821,13988,277
51987,107,2439,622,1856,48695,583
33000,5,47,988,37,9122,10
29150,2,76,1057,36,1567,40
35685,8,595,931,376,7441,219
9776,367,13912,1376,9145,64026,4767
2569,183,7040,1449,4902,49900,2138
48317,253,3265,722,2648,14458,617
33558,42,926,978,717,27519,209
59204,13,114,399,85,2986,29
11812,197,4867,1361,2632,42611,2235
29266,117,3003,1055,1934,16999,1069
54163,863,8618,553,6811,184457,1807
706,21,673,1464,480,26706,193
58924,27,248,407,174,3004,74
48582,191,1364,714,1007,21059,357
33316,66,1420,983,1301,30587,119
17462,39,804,1280,582,14142,222
57625,84,1125,450,929,32236,196
3451,13,207,1441,133,8680,74
4251,27,488,1432,365,10352,123
218,24,3207,1468,1655,20875,1552
52856,244,2296,591,1769,18078,527
11276,22,1175,1365,678,18325,497
55250,91,2520,516,1870,20263,650
23812,13739,503942,1170,355695,1914917,148247
743,5760,153616,1463,103128,395711,50488
31327,4,227,1016,193,23398,34
10705,77,6541,1370,4399,77429,2142
13449,73,3332,1340,2016,16574,1316
32819,54,1282,992,763,12540,519
5097,3,97,1421,64,15660,33
43289,17,412,782,297,15957,115
6888,32,765,1399,585,17059,180
43357,7,252,781,195,11569,57
34061,565,18645,968,11968,139510,6677
28706,26,794,1065,472,7447,322
33070,2368,41079,987,28327,142263,12752
3807,68,3941,1437,2850,41857,1091
10010,55,1674,1374,1059,27242,615
31720,92,2141,1010,1365,24660,776
1461,41,1682,1458,1154,28058,528
5929,8,184,1411,142,8638,42
14751,296,10060,1322,6743,98243,3317
3100,259,14051,1444,9292,80189,4759
64734,7,63,223,44,6000,19
45539,55,872,757,661,13178,211
52544,32,277,602,216,4734,61
62861,19,248,276,181,4798,67
6188,41,939,1408,623,13519,316
28316,154,3105,1073,1888,42998,1217
49619,85,1412,685,1076,19047,336
30630,185,3454,1028,2566,32095,888
51451,6,64,637,55,3378,9
55257,16,155,515,138,5221,17
54054,124,1282,556,1042,19144,240
19731,1,59,1239,43,11223,16
28070,79,1262,1078,879,18029,383
50091,53,1481,672,1189,27894,292
59259,8,197,397,167,7700,30
33322,61,1185,983,798,13674,387
6421,12,485,1405,321,15664,164
20731,19,715,1222,505,25516,210
29045,107,2876,1059,1856,28465,1020
1188,414,9113,1460,5817,28945,3296
21685,0,0,1205,0,4419,0
57453,2,22,455,17,2134,5
10354,91,2262,1372,1358,24308,904
52423,13525,279089,607,217749,820633,61340
2660,1,148,1449,92,6844,56
27866,6585,199673,1081,129413,522009,70260
52358,10,235,609,162,5218,73
61377,862,17149,321,12631,127766,4518
67415,72,1036,144,854,13611,182
50745,3,91,656,78,9669,13
11158,23777,408782,1366,277620,1502999,131162
25224,59,1743,1140,1199,8551,544
23756,24,433,1171,297,21659,136
20667,9,277,1223,231,13457,46
7118,99,4309,1395,2722,31436,1587
68861,10,85,96,66,3105,19
10158,303,7419,1374,4936,59503,2483
25130,17,554,1141,423,27094,131
24725,68,2216,1150,1737,25880,479
28230,1,18,1074,12,2964,6
68876,341,7317,95,5786,39644,1531
30480,46,1177,1030,736,6699,441
68707,483,10313,101,8997,86917,1316
28792,268,11608,1064,8896,76257,2712
42148,222,4841,800,3881,34078,960
65390,14,363,205,257,4440,106
59620,49,685,384,499,11392,186
60967,31,226,335,181,6099,45
6540,43,3020,1403,2104,51369,916
57341,48,671,457,586,10780,85
55589,51,929,506,804,11572,125
31661,12,182,1011,134,5400,48
20285,32,935,1229,708,11069,227
32078,393,5782,1005,3960,36400,1822
55407,886,7205,511,6260,73917,945
62105,254,6001,296,5142,49568,859
57938,829,8240,440,6828,36566,1412
33988,75,1059,970,794,15148,265
48652,5903,98867,713,74443,680263,24424
41296,50,656,814,556,29628,100
60035,27,413,370,312,9836,101
17216,34,2091,1284,1162,29593,929
33577,292,9977,978,7199,59710,2778
33596,104,2777,978,1918,22243,859
57123,6,33,463,25,2094,8
53247,18,345,580,271,5285,74
6045,8,528,1409,307,18080,221
3838,614,46172,1437,27454,302657,18718
6960,107,4207,1398,2662,39887,1545
47170,85,1200,737,909,24229,291
60790,136,2396,341,1900,33826,496
52097,102,2024,617,1325,9368,699
11086,34,580,1367,365,13906,215
38674,107,2031,852,1573,18372,458
12140,74,3183,1358,1735,19599,1448
4504,52,3261,1429,2124,63194,1137
33130,576,12951,986,9124,67063,3827
29329,2211,36362,1053,24991,201871,11371
18941,3783,141932,1253,98948,866545,42984
7354,829,32936,1392,19470,239289,13466
10630,107,4180,1370,2542,41739,1638
58564,29,368,419,289,6963,79
25440,264,3152,1135,1988,22536,1164
56764,46,465,464,381,5100,84
25377,132,4250,1136,2617,62319,1633
15093,6,710,1318,458,6072,252
51404,583,5249,638,4116,24662,1133
55310,29,273,513,209,4510,64
10393,6,250,1372,179,7414,71
54069,5,49,555,41,2641,8
3098,21,1178,1444,836,18715,342
39451,125,2571,842,1970,29086,601
60541,43,341,351,291,3111,50
35441,9,200,936,157,4803,43
66483,45,532,175,425,7612,107
15574,1961,85128,1311,49730,165669,35398
29784,116,5892,1045,3286,32187,2606
62886,286,4359,275,3238,25425,1121
54488,18,260,541,177,7729,83
62445,5,98,287,73,3108,25
30025,11,1193,1040,592,13843,601
65023,8,91,212,56,2587,35
12580,1319,22866,1352,16066,74412,6800
34303,13,349,963,259,7739,90
57825,177,2481,444,1936,34300,545
35892,337,5504,926,4322,69824,1182
2505,76,3003,1450,1905,42580,1098
28623,67,2990,1067,1874,33312,1116
57044,2881,37296,465,31150,172254,6146
29360,37,914,1053,599,22977,315
30548,54,1215,1029,713,15467,502
3707,226,5045,1438,3621,60681,1424
9600,27,1010,1377,594,11264,416
2920,152,6042,1446,3980,99378,2062
27468,119,2102,1091,1360,25717,742
25002,24,828,1144,556,14492,272
37845,16,128,873,102,8539,26
18187,162,3990,1266,2731,22916,1259
34756,1215,18160,953,13497,89652,4663
9778,5097,187944,1376,111197,685552,76747
63827,34,425,251,364,11094,61
56533,1672,24737,479,20122,142174,4615
67028,3,83,157,54,2889,29
7057,40,3330,1396,2213,48384,1117
18847,7,311,1254,221,17337,90
18311,568,11711,1264,7707,65989,4004
23992,42,1708,1167,1143,13042,565
24822,16,393,1148,248,10217,145
11736,10,378,1361,211,12153,167
65860,11,318,193,230,4664,88
51008,39,708,649,407,5929,301
52206,41,362,614,316,11497,46
57238,48,436,460,332,6614,104
6374,21,431,1406,279,15620,152
42153,15,256,800,180,12404,76
5039,10,208,1421,132,10342,76
6365,182,8788,1406,5736,53199,3052
49574,15,171,686,148,4852,23
8563,533,13663,1382,9779,72791,3884
7321,39,1091,1393,767,18387,324
28154,256,4212,1076,2923,38125,1289
12730,145,3912,1350,2268,45955,1644
66415,15,156,177,125,4312,31
50658,187,2275,658,1860,18366,415
67121,0,15,154,11,5411,4
61658,399,8439,313,7144,70947,1295
17762,38,879,1274,611,13454,268
29092,114,3425,1058,2163,27491,1262
14472,125,2848,1325,1803,22883,1045
26668,451,15205,1107,10331,88517,4874
62080,16,197,298,151,7575,46
45293,151,1637,760,1288,29741,349
12836,192,3993,1349,2441,30302,1552
55296,10,130,514,100,9778,30
34033,61,781,969,474,5577,307
53593,20,286,572,242,10661,44
3362,25,452,1442,333,14924,119
54892,130,1405,525,1080,12955,325
40323,14,196,830,153,16856,43
28634,201,3936,1067,2440,14291,1496
18023,150,6755,1269,4709,34900,2046
24562,4,239,1154,176,7375,63
45424,637,9926,759,7012,35090,2914
55839,42,312,500,289,17539,23
67257,52,862,149,672,10551,190
20270,5,198,1229,166,8117,32
30543,51,3844,1029,2399,36737,1445
61556,10,184,316,162,3708,22
17078,185,2508,1286,1836,22020,672
51055,64,481,647,407,15456,74
29320,37,1373,1054,841,17533,532
24639,30,544,1152,360,5126,184
29690,1599,67968,1047,54792,204315,13176
17552,70,3313,1278,2501,38344,812
20538,27,718,1225,570,44162,148
40978,31,417,819,288,20499,129
12276,1716,61977,1356,37755,310256,24222
9035,291,6444,1380,4532,32805,1912
27547,53,1071,1088,805,30385,266
8443,75,2287,1382,1566,77038,721
26340,7,182,1115,165,9541,17
14149,256,4478,1330,3096,19272,1382
60338,23,170,359,117,2644,53
32342,58,1320,1001,887,16388,433
32887,12,428,991,305,22852,123
52727,21,323,595,274,5728,49
33877,448,6964,973,4975,28341,1989
68936,26,156,94,135,5386,21
31715,19,429,1010,276,4063,153
39828,19,438,837,385,15381,53
32590,21,524,996,378,6547,146
41748,9,184,806,123,6875,61
64067,2499,40626,242,32313,220428,8313
41468,22,572,812,451,14397,121
38719,133,1328,851,1003,14982,325
23890,930,22920,1169,15013,140748,7907
24950,617,17880,1145,12144,142941,5736
37227,165,2576,890,1955,34722,621
65211,42,454,209,326,9411,128
25992,79,1844,1123,1102,11735,742
11577,8,488,1363,252,15828,236
68243,15,106,118,90,2680,16
27536,383,9487,1089,6222,116892,3265
63916,14,293,247,220,5100,73
34391,73,1509,962,1012,15756,497
9335,711,16732,1378,10185,45220,6547
31203,9,120,1017,68,7167,52
59400,9,165,392,132,9652,33
36259,47,1430,916,1035,22567,395
57504,6,129,454,96,5409,33
8108,63,3837,1383,2190,18388,1647
34196,12,210,966,183,5032,27
24749,126,3792,1149,2649,35122,1143
19270,5317,166496,1247,110177,539809,56319
11206,3274,105793,1366,64148,446256,41645
13890,28,1833,1334,1193,41918,640
22989,115,3733,1185,2596,66902,1137
21121,302,5983,1214,4679,72500,1304
19888,35,468,1236,356,14478,112
11847,140,17517,1360,8408,165564,9109
33680,156,2783,976,2049,21644,734
12318,154,5351,1355,3198,40717,2153
4760,11,278,1425,183,15953,95
23321,93,1149,1180,775,11235,374
22888,6,144,1186,95,14712,49
3435,3,190,1441,108,13932,82
49620,676,16390,682,13262,77973,3128
5471,68,1879,1416,1255,15977,624
65705,133,2176,196,1805,11825,371
49999,11,170,674,138,9674,32
64074,57,1455,242,1111,21867,344
30899,190,3777,1023,2993,51180,784
63976,9,104,245,79,3114,25
10635,38,1218,1370,765,26916,453
68332,33,602,115,508,9041,94
1717,15,788,1456,493,12345,295
37305,81,1888,888,1596,46567,292
4306,434,15799,1432,11521,68214,4278
24972,80,4242,1144,2242,19971,2000
1784,52,1987,1456,1357,30327,630
40274,672,10746,830,8691,108622,2055
34540,4,108,959,62,5633,46
28613,96,5033,1067,3016,34343,2017
32101,43,824,1004,619,16791,205
68833,1,14,97,8,510,6
11768,153,5209,1361,2554,95695,2655
48442,330,4363,720,3526,47651,837
45018,64,769,763,572,19169,197
17597,57,1025,1277,760,14391,265
57515,40,446,454,339,8286,107
36708,50,555,905,414,9768,141
33987,81,1860,970,1261,26974,599
33706,160,2477,975,1769,26646,708
32127,5,77,1004,56,5535,21
8115,22,782,1383,485,6512,297
65504,39,349,202,261,5632,88
34003,41,754,970,559,59010,195
20553,142,4165,1225,2781,85074,1384
59683,291,9470,382,7326,37960,2144
19894,343,17682,1236,11395,53629,6287
37184,20,399,891,337,7988,62
28057,60,870,1078,559,8708,311
60613,51,615,349,440,11042,175
60510,28,328,353,250,4153,78
53459,162,1849,575,1289,12017,560
62572,69,1089,283,939,14328,150
38457,2,132,857,100,11857,32
60645,5,110,347,69,4418,41
11439,830,37239,1364,21333,282628,15906
2151,2,163,1453,121,11572,42
40815,55,761,822,588,16713,173
52197,171,1462,614,1127,20921,335
48973,1,48,703,34,7141,14
36701,1935,24845,905,19688,67012,5157
16842,0,0,1290,0,8180,0
64276,168,2672,236,2186,82573,486
28280,0,17,1074,13,3451,4
50411,165,2754,664,2379,22950,375
51931,42,2426,623,1697,25581,729
64999,50,576,214,494,4501,82
54102,274,2257,554,1761,13038,496
4690,252,30009,1426,19591,165937,10418
65130,31,254,210,217,3171,37
24904,59,1647,1146,1155,24062,492
31824,51,922,1008,681,4859,241
20946,62,1207,1217,792,22089,415
37967,0,17,870,15,4727,2
54621,54,536,535,432,14761,104
13321,2480,71687,1342,47551,109007,24136
17913,79,2466,1270,1911,19973,555
64516,15,207,229,184,4681,23
29530,7,374,1050,253,8929,121
59292,805,13430,395,9469,71265,3961
15645,14,489,1310,350,17270,139
48968,274,4328,703,3621,57635,707
5988,5270,127042,1410,77092,226330,49950
60478,4,33,354,23,1378,10
2288,290,5770,1452,4006,72511,1764
14414,166,2400,1326,1711,27871,689
40841,106,2255,821,1881,24423,374
58337,32,441,427,384,4938,57
21469,260,5649,1208,4754,112107,895
55984,103,1033,495,837,19216,196
68528,92,1495,108,1246,16893,249
20091,18,616,1232,431,14763,185
14726,2,47,1322,39,7538,8
47957,172,3403,728,2558,50596,845
21789,28,504,1203,330,15027,174
80,736,17353,1471,10661,119440,6692
37595,21,388,880,300,8139,88
20911,1942,53014,1218,37805,400659,15209
18842,21,1309,1254,911,38610,398
33161,354,3554,986,2466,22216,1088
20165,9,416,1231,339,25462,77
12901,80,2130,1348,1245,20021,885
38138,220,2770,866,2181,22917,589
8429,62170,2072372,1382,1329168,5850889,743204
3293,394,10952,1442,8268,67168,2684
13548,351,6884,1338,4671,44836,2213
50762,258,3584,656,2668,55351,916
4841,7,400,1424,211,6803,189
40633,68,2039,825,1710,26120,329
57152,13,146,462,114,6020,32
5433,48,3958,1417,2490,48099,1468
5990,130,2886,1410,1856,57837,1030
64509,14,196,229,149,9232,47
59228,228,1879,398,1508,20721,371
34548,52,1411,958,1206,18329,205
38716,33,307,851,224,4817,83
14331,31,1385,1327,996,20087,389
12982,29,1165,1347,734,35490,431
1198,22,740,1460,587,20644,153
104,13,1429,1470,898,13192,531
50450,22,388,663,302,4976,86
32793,48,1449,993,905,8940,544
51807,30,445,626,237,10416,208
18136,8,513,1267,392,34301,121
3064,51,3052,1445,2446,35784,606
55383,46,532,512,396,8415,136
17781,109,5743,1273,4237,74479,1506
2374,60,1308,1451,872,22224,436
61332,686,8606,322,7127,47071,1479
34384,578,10741,962,8239,82370,2502
4211,308,11698,1433,8092,102619,3606
35808,23,468,927,373,21931,95
181,60,2346,1469,1652,92219,694
2634,58,1148,1449,717,60353,431
66708,51,757,167,583,11127,174
56311,7,173,486,138,5002,35
48205,6,83,724,67,5769,16
5677,221,10102,1414,6125,107599,3977
68880,6,72,95,52,2015,20
24310,724,28424,1160,17874,205758,10550
67080,30,431,155,391,5904,40
42734,43,537,791,482,15465,55
62421,39,428,288,363,8689,65
26435,10,383,1113,227,7325,156
36947,37,505,899,386,4753,119
49067,32,372,700,297,5923,75
31497,7,336,1013,205,7958,131
49784,23949,455377,679,295635,1827830,159742
25675,6668,167951,1130,109648,355253,58303
31273,299,4531,1016,3230,27093,1301
14063,3,166,1331,116,9074,50
67289,13,118,148,73,4594,45
28225,175,5001,1075,3285,35476,1716
6148,402,15027,1408,10652,99515,4375
22468,80,3891,1194,2675,50814,1216
68099,15,105,122,92,3899,13
38316,3,129,861,90,6283,39
67110,8,92,154,58,5431,34
44079,193,2164,773,1674,39532,490
27018,127,3631,1100,2558,125314,1073
13686,47,986,1337,559,12384,427
35438,33,614,936,435,11639,179
41969,8,238,803,178,6568,60
26753,15,454,1106,367,9638,87
24636,0,0,1152,0,2361,0
49983,8298,140023,675,108925,434127,31098
61181,138,3792,327,2613,25680,1179
54788,15,245,529,165,3173,80
29685,44,805,1047,554,5869,251
65131,69,519,210,430,7638,89
1589,25,1337,1457,979,19303,358
38159,19,396,865,278,12643,118
18301,15,629,1264,478,15056,151
64424,47,819,231,591,22945,228
14433,304,9527,1325,6526,45219,3001
28282,1075,26506,1074,17090,207340,9416
50752,387,5621,656,4443,62774,1178
5652,42,1148,1414,806,19780,342
10136,49,1325,1374,824,7730,501
54744,1391,13349,531,11129,110893,2220
50911,1,25,652,19,5293,6
18263,2747,62754,1265,42021,165839,20733
43123,9019,140136,780,97962,598324,42174
55744,12,138,502,92,3654,46
11031,0,125,1367,82,4953,43
21204,48,1709,1213,1241,22543,468
16412,354,12184,1297,8809,74417,3375
55851,10,202,499,146,9534,56
40354,7,83,829,66,2663,17
62805,6,100,91,90,5072,10
14007,11171,348440,1332,198604,884735,149836
19139,8,608,1249,444,14904,164
9957,858,18909,1375,11381,117089,7528
58058,88,1235,436,923,22287,312
17168,8128,250998,1285,169109,655025,81889
6420,20,795,1405,516,24736,279
58536,1558,69905,419,47726,193555,22179
52139,27,251,616,217,5776,34
16775,128,3175,1291,2155,32137,1020
22686,40,1188,1190,868,24881,320
53076,41,521,584,431,9950,90
18345,583,12876,1263,8871,133791,4005
35637,11,252,932,192,3459,60
40125,166,3852,832,3344,30961,508
21428,37,1556,1209,961,17269,595
62460,18,175,287,136,4180,39
7125,45,1239,1395,812,15489,427
1265,6,273,1459,157,28027,116
66293,13,189,180,145,15810,44
64380,56,615,233,517,6368,98
46829,447,7198,741,6186,75248,1012
14190,69,1307,1329,930,18403,377
52313,48,1696,610,1379,21968,317
63130,7,219,269,142,5486,77
68447,33,626,111,491,8186,135
9353,85,2386,1378,1614,30635,772
4293,480,23407,1432,15170,99420,8237
29821,134,3585,1044,2643,38542,942
33783,7,165,974,116,4994,49
53202,10,130,581,103,4972,27
17751,339,10757,1274,6883,30472,3874
23273,15,619,1180,491,24172,128
34713,13370,292241,950,165201,1611628,127040
13970,2765,70683,1333,46790,330092,23893
11571,0,0,1363,0,8792,0
61581,4,101,315,72,2930,29
35117,9021,241302,944,162894,780910,78408
65874,20,655,192,563,11371,92
19506,141,2128,1243,1376,14738,752
51002,372,4488,649,3532,45739,956
60337,44,452,359,360,4890,92
45915,4,111,753,73,6214,38
51119,41,593,645,434,7555,159
59916,27,293,374,239,3306,54
41290,5,413,814,302,12901,111
30782,0,0,1024,0,10498,0
63174,47,792,268,605,7865,187
29108,4,307,1058,189,6390,118
64916,31,510,217,377,10020,133
8085,7,183,1384,126,6355,57
42788,363,6427,789,5110,51945,1317
36969,263,1779,898,1351,24159,428
27330,14,428,1093,259,19367,169
29038,4,35,1059,34,5888,1
47123,140,2600,738,1743,16709,857
32762,4,283,993,223,10347,60
42692,11,319,791,247,7874,72
769,11047,351043,1463,210089,958824,140954
54540,2321,32928,537,27040,120612,5888
29507,383,7643,1050,4900,35001,2743
36987,493,4227,897,3240,26393,987
29305,180,3020,1054,1940,19163,1080
46190,15,229,750,135,2901,94
13073,97,4383,1345,2554,29466,1829
1600,76,7092,1457,5015,103295,2077
65404,6,66,204,45,2237,21
6184,59,1747,1408,1151,9982,596
33675,44,530,976,388,11723,142
13806,31,1719,1335,1031,19020,688
52421,5,102,607,68,10518,34
6559,66,1612,1403,1105,13195,507
16386,41,1441,1297,907,38570,534
14037,87596,4580251,1331,2390793,8525460,2189458
23164,2790,84575,1182,62508,383863,22067
31124,107,2046,1019,1319,17576,727
24263,336,8743,1161,6180,64070,2563
57973,36,418,439,334,13771,84
54720,36,591,529,350,13657,241
28022,3205,131012,1078,86374,376178,44638
36394,17,356,898,244,6334,112
43107,1870,40215,784,32214,148163,8001
47885,467,7908,729,6689,87992,1219
8775,60,1731,1381,1067,13613,664
39374,75,1421,843,980,12893,441
36144,8,393,919,302,15654,91
5951,4,93,1411,53,10514,40
21430,53,1747,1209,1162,34543,585
68708,27,443,101,340,7574,103
12433,571,24531,1354,13561,101441,10970
57681,47,382,449,298,9443,84
49299,115,1497,692,1201,15920,296
7590,988,27847,1389,17851,138948,9996
54815,14,563,528,148,18393,415
35385,22,522,937,318,7693,204
60128,108,2016,367,1607,15958,409
16187,273,15096,1301,8940,145406,6156
22744,52,1257,1189,773,9213,484
65417,53,452,204,359,5398,93
32430,12,700,999,433,16979,267
68795,1,16,98,14,5582,2
47859,75,1552,729,1225,22344,327
18813,24,1492,1255,1010,8911,482
36999,114,1886,897,1576,19195,310
12555,313,6654,1352,5168,46852,1486
65150,31,899,210,831,4048,68
1367,703,33853,1459,19944,133390,13909
45232,7,216,761,180,3051,36
1781,127,4963,1456,3093,34231,1870
4250,218,5259,1432,3827,55957,1432
7788,5,206,1387,146,12820,60
53074,107,2464,584,1954,24934,510
17083,4,105,1286,83,4225,22
66056,8,158,187,134,3243,24
64257,14,342,236,223,7163,119
52920,11,184,589,145,7807,39
3901,151,7183,1436,4455,30014,2728
36043,13,448,921,329,9238,119
36383,264,5665,912,3816,26458,1849
27803,91,2289,1083,1373,21866,916
22189,2,83,1198,54,5159,29
24021,176,7987,1166,5212,29262,2775
58246,161,1848,429,1350,9264,498
23789,174,2820,1171,1853,13485,967
16049,164,3716,1303,2690,62546,1026
53168,40,392,581,303,13781,89
34820,497,9425,951,7131,121585,2294
9602,25,1032,1377,639,13255,393
55361,112,1207,512,733,9867,474
10479,116,2508,1371,1508,35035,1000
64094,454,4766,241,4124,49799,642
45183,31,636,761,479,7418,157
57343,75,1246,457,992,9380,254
43981,20,199,775,158,9211,41
8558,17,642,1382,414,10858,228
59854,2890,66614,376,53333,183893,13281
68995,17,447,91,407,17773,40
14862,9,504,1321,379,28188,125
13003,128,5849,1346,3467,61693,2382
25900,536,8234,1125,5412,57141,2822
20434,779,19535,1227,12777,148522,6758
36405,52,1028,911,779,14068,249
61370,28,329,321,274,7829,55
44229,6,169,771,140,12258,29
32053,43,794,1005,493,6809,301
13185,339,11141,1344,6826,61105,4315
5250,462,13081,1419,7114,159982,5967
31210,263,5041,1017,3403,47062,1638
27098,14,180,1098,113,3735,67
26961,62,976,1101,623,8495,353
29606,402,9805,1049,6530,69799,3275
49474,1,24,688,20,3653,4
21965,76,2429,1201,1594,25719,835
21453,151,3542,1208,2633,67550,909
60842,84,2052,340,1637,14615,415
45438,136,2441,759,1866,29034,575
29982,6,163,1041,95,3719,68
32364,104,1970,1000,1239,10707,731
45734,5,83,755,50,3607,33
18763,4856,190491,1256,123074,659156,67417
51755,383,5389,628,4479,68813,910
62078,4,76,298,50,2049,26
9049,82,2359,1379,1580,17855,779
8240,159,4360,1383,2798,31327,1562
18901,192,3918,1254,2721,44257,1197
4315,3,92,1431,67,5823,25
66427,36,472,176,362,14312,110
53866,7,158,562,128,16542,30
30914,60,1326,1022,1004,33442,322
29439,365,9665,1051,6267,46646,3398
41824,471,6721,805,5055,46892,1666
39492,21,223,841,170,3552,53
61893,11,82,300,67,4858,15
31840,70,1598,1008,1095,25762,503
30393,779,10069,1032,7087,62322,2982
36475,1283,21465,909,16617,95962,4848
682,15,1007,1464,684,12684,323
16153,36,1035,1301,723,37587,312
4374,8095,165427,1430,106175,667970,59252
17514,40,756,1278,497,6379,259
31615,26,681,1011,397,5702,284
3764,5,171,1438,119,15427,52
40898,38,846,820,714,9284,132
29781,12,172,1045,128,7091,44
1630,35,1190,1457,763,19147,427
6814,171,8093,1400,5450,46861,2643
11573,8,230,1363,122,9067,108
51529,0,0,513,0,7666,0
10406,17,505,1372,308,6738,197
67003,7,68,157,58,1989,10
24905,10,366,1146,252,9015,114
38379,12,291,860,214,10921,77
65227,153,1983,208,1694,13442,289
6304,19,1465,1407,920,13837,545
21881,16,519,1202,404,12001,115
27586,14,396,1087,245,16640,151
23785,361,7684,1171,5233,46639,2451
11853,7,582,1360,227,8191,355
1406,27,1165,1458,850,33538,315
32493,88,1898,996,1492,20373,406
23003,33,559,1185,425,20311,134
56837,244,3349,470,2619,37597,730
22874,643,19770,1187,13000,58067,6770
2819,2607,62625,1447,41536,260760,21089
34544,4,57,959,50,2285,7
67587,16,250,138,223,6804,27
7064,16,413,1396,291,10224,122
19902,59,3375,1236,2297,28688,1078
652,56,7690,1464,5230,52147,2460
5550,50,2012,1415,1292,18407,720
15318,116,2748,1315,1857,24632,891
34552,2,78,958,49,8648,29
10453,125,1816,1372,1273,16683,543
26,13194,619142,1472,385278,2244353,233864
2071,23,1071,1453,731,34589,340
49344,11769,420735,691,308973,1003288,111762
49529,24,357,687,305,11038,52
1762,21,1060,1456,687,25514,373
59439,29,368,391,309,21353,59
32404,516,11318,999,7426,77915,3892
1711,5,233,1456,164,7095,69
50914,992,15970,651,13202,121881,2768
53165,0,18,581,16,2415,2
63877,32,272,249,200,5093,72
54806,25,207,528,185,7580,22
54272,196,2641,548,1856,20520,785
7647,508,7809,1389,5268,35795,2541
34046,31,742,969,494,12489,248
27069,42,851,1099,519,21163,332
23297,15,358,1180,230,3662,128
32199,14,402,1003,294,21473,108
49373,925,7995,677,6503,60713,1492
36292,0,758,915,660,23851,98
38460,51,2088,857,1594,14279,494
53164,147,1582,581,1196,11866,386
61443,135,1597,319,1151,25825,446
54730,1420,9080,531,7467,42565,1613
64044,115,1164,243,953,7388,211
62044,8,73,300,63,4183,10
20617,133,2534,1224,1644,35033,890
22256,63,3121,1197,2405,46958,716
1952,2377,87271,1454,53912,300335,33359
5363,99,3498,1417,2711,26330,787
59462,136,2070,390,1581,55519,489
33200,951,16832,985,10613,73378,6219
26689,931,20662,1107,15363,212689,5299
58306,0,0,428,0,4922,0
6790,23,774,1400,589,38995,185
61046,29,553,333,425,12731,128
6487,147,4001,1404,2738,55373,1263
67252,205,3602,149,3101,37768,501
33009,4,163,988,99,4827,64
39814,68,1383,837,1183,18581,200
53943,9,102,560,91,6513,11
41874,151,1659,804,1244,16792,415
38373,58,963,860,744,9769,219
42394,1323,24301,797,18575,82145,5726
7075,75,2125,1396,1522,51742,603
10200,50,1141,1373,724,39678,417
61806,79,1429,308,1283,19013,146
23203,5,134,1181,98,5118,36
64952,11,163,215,126,2432,37
20856,8,292,1219,227,13146,65
23254,126,1658,1180,1085,23074,573
60898,11,145,338,117,4068,28
37429,566,18272,884,14799,204032,3473
6679,117,3183,1401,2217,35940,966
55934,193,2785,497,2150,27783,635
27743,63,1386,1084,871,16875,515
861,38,2518,1462,1571,36921,947
38931,212,2283,848,1921,32331,362
53738,1240,23917,567,20382,90841,3535
66519,5,85,173,64,4788,21
49295,120,2100,692,1786,27228,314
50058,439,8587,672,6515,101940,2072
30384,5,241,1032,144,7590,97
256,5841,286501,1468,193284,1348836,93217
40256,20,467,830,318,22510,149
12667,4,328,1351,181,29621,147
54661,10,195,533,163,5486,32
44517,75,1164,768,943,12513,221
52906,1261,12628,589,10483,149259,2145
41431,22,349,812,270,12536,79
15389,7258,206045,1314,128371,693247,77674
28543,170,4305,1069,2583,36664,1722
68021,4,84,125,58,3733,26
3759,0,90,1438,52,8770,38
61947,104,935,302,757,10251,178
49892,2020,29970,677,25034,183866,4936
10196,17,649,1373,442,11030,207
60935,445,8429,319,6397,77052,2032
61553,60,1021,315,825,15403,196
66760,19,173,166,150,8058,23
14747,165,2410,1322,1480,21737,930
34948,325,4910,948,3721,44187,1189
50514,6,102,661,79,8128,23
64060,4,156,243,62,3144,94
31745,85,1530,996,1011,26086,519
49246,947,39903,694,30972,216335,8931
22571,18,568,1192,446,14430,122
42942,87,1685,787,1217,29116,468
1203,24,972,1460,700,27827,272
55672,172,2137,504,1533,24545,604
27823,57,1339,1082,1016,13574,323
68619,32,439,104,380,5120,59
38210,22,339,864,208,6508,131
24140,109,3046,1163,2111,63813,935
550,12,1200,1465,762,9588,438
10878,116,2877,1368,1749,24663,1128
49379,18,200,690,150,6352,50
64551,1,21,228,17,1776,4
60282,35,686,361,427,12587,259
53480,24,492,575,384,6369,108
33878,7,127,973,93,5648,34
39388,275,3309,843,2341,25271,968
68417,161,1994,112,1636,14204,358
26272,11,237,1117,142,6752,95
6943,133,3053,1398,1919,44252,1134
42109,1089,20823,800,14033,108071,6790
52024,14,341,620,227,11249,114
8523,119,3339,1382,2060,31245,1279
51917,22,167,624,122,3405,45
54563,65,1684,538,1220,9718,464
18270,27,696,1265,528,15394,168
26906,159,3036,1103,1879,51290,1157
24110,22,816,1164,626,14124,190
35319,34,378,939,258,6765,120
14624,73,2239,1323,1542,28967,697
36067,2723,83870,921,59502,451868,24368
60550,18,237,351,209,7838,28
60805,41,780,341,498,24649,282
55631,7,74,505,60,4941,14
8789,70,3316,1381,2135,31739,1181
18369,77,2033,1263,1566,17493,467
41704,205,3538,807,2693,35912,845
23935,109,1899,1168,1430,35189,469
55836,13,315,500,122,9463,193
18547,1,65,1260,57,7390,8
16797,7,414,1291,282,49973,132
4054,14,356,1435,245,23212,111
55943,121,2570,496,1850,16748,720
43955,16,105,775,80,7288,25
61186,19,276,327,193,11805,83
12946,75,2960,1347,1940,187887,1020
51472,13920,173886,636,123737,563117,50149
60960,19,249,335,189,5854,60
59663,0,3,383,3,3310,0
33453,100,4355,980,3338,57199,1017
14073,100,5353,1331,3709,81503,1644
4338,132,2646,1431,1862,81193,784
15018,87,2710,1319,1647,29037,1063
11334,1,120,1365,79,5172,41
16039,158,3982,1303,2942,57216,1040
52675,71,1256,597,977,26532,279
25631,227,3458,1131,2279,27402,1179
6977,13,1262,1398,941,13179,321
60154,32,463,366,390,8587,73
15058,2,540,1318,391,19132,149
64773,10,169,222,133,2576,36
45570,11,147,756,98,2627,49
54180,9,119,552,97,4649,22
53154,54,769,581,564,12853,205
43891,510,12630,776,9693,137761,2937
9659,986,30122,1377,18643,99838,11479
27366,12,221,1093,147,6671,74
17485,4,147,1279,107,6639,40
56442,31,553,482,408,11348,145
36820,10,333,902,232,17678,101
64457,2,31,230,26,4704,5
2463,57,2162,1450,1589,48764,573
26396,15,1057,1114,698,16832,359
26632,14,236,1108,213,11337,23
31740,6,200,1009,126,7206,74
20844,25,679,1220,480,20047,199
638,172,5988,1464,4076,74038,1912
64062,448,6229,242,4313,21914,1916
48032,155,1834,727,1479,19716,355
35373,306,6340,938,4797,36259,1543
24410,114,5946,1157,3829,33462,2117
19052,67,2403,1251,1954,35677,449
13233,257,9085,1343,5482,57947,3603
66148,56,583,184,463,4423,120
24733,46,563,1150,438,8466,125
65353,6,138,205,92,3932,46
57093,31,326,464,251,4507,75
25781,18,626,1128,372,11109,254
58180,0,58,432,35,4473,23
31000,226,5451,1021,3422,20732,2029
17101,11,787,1286,464,10817,323
24958,46,715,1145,604,28444,111
53555,4,38,573,25,2365,13
60690,7,93,345,82,10258,11
30895,424,13516,1023,10068,102489,3448
10300,120,7204,1373,4419,41941,2785
14734,5,133,1322,81,8944,52
59133,164,2477,401,1860,25026,617
60886,106,1112,338,977,12439,135
50120,148,1874,671,1457,23441,417
32948,324,9572,990,5937,91503,3635
57375,10,75,457,48,3791,27
30142,67,2857,1037,1730,19423,1127
51073,351,4591,647,3957,29047,634
11386,65,2635,1365,1415,23113,1220
50677,101,1151,653,967,15177,184
65844,175,3186,193,2613,62850,573
59487,92,1155,389,862,10405,293
67771,19,186,133,145,3215,41
16692,53,637,1293,536,5007,101
16440,98,3371,1297,2572,22351,799
26653,5474,227187,1108,141995,666450,85192
9956,196,6474,1375,4652,65279,1822
51378,5,38,638,35,3913,3
28889,34,1755,1062,1119,20914,636
53314,891,11536,578,9817,62514,1719
8986,740,26760,1380,18279,105074,8481
66258,8,97,181,64,4140,33
14709,2880,74402,1323,52674,379123,21728
40630,22,317,825,246,17232,71
7511,283,6083,1391,3631,47688,2452
26343,97,2247,1115,1416,19523,831
44849,39,437,765,300,10829,137
62595,90,1265,283,960,14931,305
42847,48,629,788,496,9404,133
64003,19,345,245,293,11915,52
31781,11,264,1009,173,2817,91
61344,5,97,322,87,5433,10
58359,1237,13981,426,10317,60426,3664
62939,1,16,274,9,2787,7
1753,103,2488,1456,1753,20625,735
1780,72,1316,1456,983,9858,333
62420,20,306,288,246,4529,60
10953,56,2114,1368,1159,19035,955
29502,12,216,1051,146,6258,70
19083,8,632,1250,476,20502,156
34923,18,563,949,413,5678,150
10885,39,899,1368,612,16126,287
31130,64,1482,1019,913,26391,569
51817,118,1264,626,979,12111,285
53410,47,588,576,461,9801,127
49921,28,297,676,240,14224,57
245,129,6486,1468,3505,36958,2981
49645,6,161,684,146,9052,15
31821,212,5555,1008,4102,31249,1453
18940,9334,257046,1253,159219,1296741,97827
54333,139,3708,546,2876,31768,832
5935,9,331,1411,238,20264,93
4275,212,8936,1432,6679,160536,2257
68974,20,256,92,167,6824,89
10766,64,536,1369,392,9876,144
59607,31,483,385,361,6991,122
1934,101,2263,1455,1549,34128,714
27958,58,2307,1079,1378,22840,929
62169,24,266,295,224,6810,42
65400,73,601,204,494,7384,107
30271,8,219,1035,151,9376,68
22103,41,557,1199,411,16742,146
59714,1295,17293,381,13952,58911,3341
740,239,5401,1463,3956,41934,1445
68809,26,409,98,400,14639,9
15244,17,665,1316,458,14247,207
34799,1083,17172,952,12555,98535,4617
3722,434,13776,1438,9960,72398,3816
13184,385,28133,1344,17092,88074,11041
35620,6,240,932,176,8711,64
60023,19,372,371,276,7853,96
22526,84,2748,1193,2238,62017,510
53852,2,28,563,23,5080,5
27066,117,3389,1099,1873,17833,1516
40874,180,2361,821,1817,19172,544
38129,984,15041,865,10878,47067,4163
39601,197,3732,840,3206,46044,526
21757,36,1271,1204,760,12723,511
49496,1744,22985,688,15172,147073,7813
4664,64,1771,1426,1213,37569,558
22984,30,1008,1185,734,10710,274
64164,33,828,239,682,8923,146
303,21,1678,1467,1108,41517,570
8885,76,2154,1380,1320,12687,834
67930,7,117,128,95,4497,22
57687,10,119,448,91,4641,28
25567,1,224,1133,137,4079,87
50772,654,8937,655,7695,67916,1242
2739,9,544,1448,371,23560,173
14796,388,11526,1321,8035,72414,3491
21654,338,5402,1205,3678,49485,1724
9407,25,835,1378,565,13788,270
38818,8,151,849,123,5015,28
9350,37,422,1378,306,12579,116
9119,7,454,1379,317,10964,137
34747,144,4449,952,3050,26306,1399
8818,40,1073,1380,745,6230,328
31949,86,2813,1007,1718,25637,1095
12054,22,1260,1358,676,29713,584
68436,53,275,111,228,4353,47
52401,23,443,607,317,9138,126
5418,251,7880,1417,5534,33429,2346
12845,854,15155,1349,9379,46411,5776
3778,60,1405,1437,907,16779,498
58859,84,699,410,586,8500,113
3043,17,1023,1445,802,10489,221
17577,353,11043,1277,6666,39354,4377
12207,12,625,1357,301,16546,324
69043,237,4296,90,3666,36424,630
55627,426,9008,505,6721,72690,2287
52936,92,1392,589,1091,13577,301
14529,21,720,1324,540,10688,180
63865,4,41,249,34,1980,7
13342,442,22931,1342,12877,150909,10054
22716,796,15297,1190,10311,83812,4986
55649,82,755,504,636,10722,119
328,93,3044,1467,1912,36608,1132
246,1223,23900,1468,14135,160161,9765
9854,6,292,1376,202,6835,90
19978,50,1382,1234,938,7899,444
24108,35,586,1164,437,8481,149
60391,3,54,357,45,4554,9
11006,25,1489,1367,896,16042,593
10921,40,1329,1368,818,17961,511
40285,49,544,830,453,5310,91
19764,7,284,1238,185,8001,99
29857,45,839,1043,535,7741,304
66083,35,361,187,294,2577,67
60256,4,67,362,57,1961,10
52258,607,7410,612,6129,52215,1281
37719,602,13727,876,10921,46708,2806
54040,29,271,556,228,8844,43
31299,24,520,1016,293,3360,227
62114,25,233,297,178,2196,55
15848,3,181,1307,139,6123,42
19015,74,3007,1252,2082,67262,925
5049,104,3786,1421,2425,14996,1361
30501,704,20297,1030,12901,181137,7396
49583,21,288,685,253,12652,35
24472,149,3588,1156,2518,36777,1070
11290,31,897,1365,526,18134,371
39400,2610,39398,843,31614,270005,7784
27022,26148,712199,1100,450809,1586470,261390
44410,1184,17875,715,13046,128927,4829
31903,18,509,1007,290,7555,219
22029,10,157,1200,104,6357,53
33306,29,515,983,323,5728,192
67317,11,152,147,114,2606,38
20801,7992,237873,1220,173511,1807600,64362
60149,21,328,366,249,15550,79
12552,316,10377,1352,6106,63601,4271
50778,69,1030,655,797,12448,233
19140,422,7233,1249,5897,59427,1336
36797,23,336,903,273,8915,63
5965,752,19421,1410,10537,87382,8884
56343,9,125,485,84,3325,41
28830,28,713,1063,441,13059,272
48346,774,9379,722,7271,82046,2108
36744,23,704,904,497,13127,207
49614,920,19223,684,14378,94431,4845
44197,2680,46543,772,36163,163673,10380
9562,199,6833,1377,4158,28132,2675
20752,26,622,1221,441,5993,181
33502,2689,58451,979,34666,175257,23785
18419,84,2535,1262,1880,43399,655
13971,260,7889,1333,5286,45141,2603
64627,14,268,226,211,6465,57
44223,115,1858,771,1455,22398,403
47469,131,1939,734,1629,20410,310
10957,8,357,1368,206,10745,151
47533,71,1061,733,820,12775,241
56416,46,644,483,469,8438,175
5497,15,397,1416,243,16132,154
21893,69,3066,1202,2230,45432,836
52127,231,2048,616,1699,34605,349
27360,4,187,1093,120,2497,67
30356,47,1272,1033,739,7326,533
18873,2,55,1254,47,7698,8
41579,486,4460,810,3004,19343,1456
49942,47,537,676,434,14998,103
6393,183,6066,1405,4222,35734,1844
67302,13,212,147,163,2312,49
14611,30,1370,1324,896,29180,474
57578,4223,80266,446,60863,159127,19403
22878,1091,33113,1187,20673,206679,12440
48326,7,107,722,85,2959,22
54307,22,436,547,353,8651,83
57178,63,1125,455,873,8470,252
15734,216,12403,1308,7407,29651,4996
20401,32,599,1227,420,11993,179
18386,206,11113,1262,7165,71015,3948
17362,62,2371,1281,1630,31818,741
37415,238,6648,885,5541,118318,1107
53775,30,644,566,355,8178,289
24065,3871,137340,1165,88798,571732,48542
23879,87,3483,1169,2274,24476,1209
56660,7,100,476,83,4940,17
274,35,422,1467,255,24851,167
5546,52,2977,1415,2018,28337,959
66717,147,2356,165,1983,22808,373
49824,53,1006,679,789,18666,217
56960,79,1060,467,863,11928,197
6704,43,977,1401,596,9827,381
67794,16,90,132,80,2713,10
29456,27,534,1051,357,8181,177
37199,1,23,891,20,3407,3
67594,9,97,138,77,1623,20
29702,149,4289,1047,2965,36907,1324
56277,57,907,486,668,14345,239
26713,1240,24061,1107,16516,276075,7545
35194,23,419,942,318,9417,101
54505,118,1892,540,1359,32927,533
52283,3699,47986,611,36270,402174,11716
10578,1098,24612,1371,14399,161637,10213
12529,52,1312,1353,762,18950,550
33172,471,12904,985,10290,59479,2614
66173,5,48,183,41,1775,7
30162,179,2807,1037,1996,27162,811
7824,3056,138535,1386,92044,325236,46491
38449,151,2537,857,2111,38027,426
18337,18,464,1264,329,8550,135
32438,29,869,999,552,31097,317
11933,144,5020,1359,3099,43219,1921
34426,12,281,961,207,8220,74
38573,123,2200,854,1677,24361,523
1252,504,25015,1460,15507,99925,9508
3669,6,578,1439,422,13863,156
17556,26,1098,1278,888,11008,210
66649,1,9,169,7,1240,2
55511,32,288,508,230,10141,58
65435,7,91,203,62,2791,29
527,5,171,1465,126,9367,45
47243,7,307,735,224,6406,83
1919,127,4669,1455,3102,39950,1567
10625,1444,41198,1371,26112,101542,15086
13292,290,14827,1343,9817,70103,5010
4174,543,10864,1433,7204,60300,3660
2025,205,6624,1454,3886,40020,2738
47104,73,666,738,520,7992,146
65797,3,35,195,23,5864,12
55871,22,312,499,255,11967,57
62941,503,11476,274,9301,80197,2175
51377,14,247,638,185,9085,62
1725,25,943,1456,633,21798,310
61432,4,106,320,81,4410,25
68824,95,1611,97,1330,14584,281
40430,34,435,828,329,7739,106
38950,325,6646,848,5261,25040,1385
25439,1329,24266,1135,17356,152733,6910
50738,11,182,656,141,5837,41
1809,483,15751,1455,10755,38504,4996
59008,18,115,405,81,3590,34
53482,19,174,574,134,5524,40
56829,82,1277,471,1119,13409,158
5541,5,385,1415,297,10108,88
66873,0,18,162,10,1612,8
38455,12,238,857,163,3901,75
68802,23,397,98,356,10280,41
7123,26,1227,1395,820,82195,407
59633,6,50,384,37,5104,13
68107,17,161,122,130,3437,31
66143,11,103,184,86,6140,17
3544,141,6497,1440,4287,35064,2210
28780,2842,56882,1064,37109,261515,19773
56962,860,12865,467,10687,148766,2178
14199,15,305,1329,234,7258,71
41864,91,1350,804,1038,13005,312
40442,2,26,828,20,1247,6
38094,753,10271,863,8296,48792,1975
41369,10,498,813,358,10438,140
14837,9,347,1321,248,15271,99
24634,6,190,1152,144,5531,46
20784,431,7803,1221,5204,104091,2599
17977,156,4245,1269,3179,24159,1066
48894,606,7249,706,5903,85522,1346
53106,53,833,583,664,10740,169
32385,3,166,1000,111,11435,55
12779,244,13883,1350,8828,74557,5055
51774,53,690,627,590,10519,100
9154,6,300,1379,191,14865,109
12310,11,789,1355,420,12231,369
58864,5,78,410,67,3436,11
26979,51,1059,1101,670,9101,389
11929,132,7401,1359,4837,84038,2564
30890,21,965,1023,608,25385,357
12635,140,14365,1351,7782,94826,6583
33649,34,496,976,442,5986,54
61976,6,110,302,103,2817,7
58141,648,41988,434,31454,126575,10534
2445,361,11497,1450,7153,97040,4344
47516,21,406,733,287,8415,119
58745,144,2393,413,1768,20376,625
64911,45,388,217,317,10854,71
64183,2,42,239,36,2618,6
29621,28,1378,1049,848,18558,530
3323,26,608,1442,429,19755,179
33019,66,1164,988,834,16510,330
14965,51,753,1319,515,11466,238
34252,111,1593,965,1242,30513,351
43932,51,489,775,407,15703,82
27986,23,529,1079,421,20953,108
54998,39,321,520,252,10709,69
35269,6,109,940,83,3392,26
40337,404,6681,825,5158,57961,1523
28596,576,12552,1068,8219,99673,4333
52266,6283,103185,612,77264,266102,25921
39634,0,0,839,0,19159,0
68612,5,92,104,62,2974,30
12406,0,0,1354,0,27065,0
57609,44,947,451,643,15765,304
30536,255,5104,1029,3766,60727,1338
4202,45,2105,1433,1440,31617,665
56125,10,122,491,90,7649,32
54958,0,0,524,0,9126,0
12446,0,0,1354,0,9528,0
4483,356,27236,1429,18337,138639,8899
25426,780,23686,1135,15461,175509,8225
63732,7,191,253,123,6156,68
57217,6,34,461,28,1864,6
7802,19,738,1386,518,43582,220
69031,27,494,90,403,7203,91
41245,4,201,815,112,3521,89
59795,26,307,378,237,5916,70
68740,10,97,100,81,1576,16
13653,22,946,1337,466,4962,480
8576,41,2245,1382,1430,45421,815
9164,74,2121,1379,1458,26297,663
17623,1352,34398,1276,20973,97826,13425
39870,26116,501257,836,404456,1593739,96801
23823,30,822,1170,603,20405,219
8726,8,268,1381,190,14195,78
48868,202,2810,706,2229,24619,581
29593,131,2307,1049,1445,9313,862
59650,173,2783,383,1397,28161,1386
9277,283,5739,1379,3727,39508,2012
2972,28,1768,1445,1398,11195,370
49797,58,566,679,469,9878,97
65356,769,10886,205,8754,83049,2132
28024,202,12156,1078,6262,79317,5894
29342,21,245,1053,146,2765,99
35658,9,273,932,206,7358,67
8603,85,2338,1381,1446,27134,892
37261,471,7979,888,6464,113912,1515
23663,311,23543,1173,15187,53829,8356
5525,39,1019,1415,659,16312,360
12203,17,507,1357,330,10424,177
10450,94,1992,1372,1324,19131,668
64416,18,364,232,266,3881,98
55512,29,424,508,314,9116,110
63764,153,1906,253,1596,11070,310
63873,11,129,249,91,2266,38
52593,2196,39562,596,31007,265588,8555
1734,24,3262,1456,2298,20008,964
17279,46,1521,1283,1105,29197,416
61467,18,231,318,189,6342,42
13993,534,21422,1332,12438,193676,8984
54104,45,398,553,322,7345,76
64967,31,421,214,320,3729,101
23795,204,2881,1171,2087,29667,794
3091,31,1082,1444,678,22186,404
30069,490,8033,1039,5035,81397,2998
23897,27,770,1169,486,12490,284
3788,858,55303,1437,32321,219883,22982
31016,529,6986,1020,4780,20182,2206
59182,1,25,400,16,1748,9
13638,3795,181916,1337,105759,663944,76157
57242,162,3048,460,2130,28800,918
24935,38,1657,1145,1096,17616,561
24143,59,981,1163,671,30506,310
10230,60,2304,1373,1460,24207,844
64028,31,396,244,305,7559,91
14397,139,4894,1326,3527,43689,1367
54500,104,1057,540,851,11230,206
49883,23,490,677,397,8869,93
56708,92,1019,474,806,9417,213
68598,23,379,105,329,6241,50
1225,26,674,1460,492,19823,182
52223,7,83,613,75,6206,8
63405,47,624,262,487,8464,137
63016,84,792,273,663,12511,129
6976,148,9983,1398,6009,64495,3974
16919,2004,71877,1289,57577,583464,14300
117,0,0,1470,0,12358,0
19697,21,397,1239,280,13822,117
18448,79,2152,1261,1503,12349,649
28921,413,10171,1061,6218,57626,3953
3846,72,1527,1437,1082,41407,445
51489,146,2072,636,1687,21198,385
20770,211,4520,1221,4076,35519,444
33832,273,6134,973,4652,104384,1482
49396,21,812,690,642,24149,170
51930,6,103,623,81,8039,22
56263,32,212,487,166,4232,46
53925,50,1309,560,985,52124,324
37026,1375,23486,896,17432,210786,6054
11609,14790,292583,1363,178657,501291,113926
31356,26,447,1015,273,13202,174
32801,88,1548,993,995,43355,553
57812,40,361,444,249,6143,112
59419,1266,22460,391,17503,128526,4957
18515,3,164,1260,112,6023,52
41689,23,520,808,387,12934,133
18234,232,4514,1265,3301,46122,1213
25357,5,295,1137,219,5468,76
56380,103,1297,484,1024,9565,273
56832,22,411,470,319,7643,92
35665,3021,77825,930,54309,391366,23516
66139,17,201,185,163,4685,38
3871,10295,563450,1436,341576,2147367,221874
68792,27,435,98,338,7496,97
10497,96,3797,1371,2365,20161,1432
39925,139,2937,836,2102,29620,835
62809,233,1952,277,1645,7472,307
26271,2786,67960,1117,43899,273949,24061
8439,49,1224,1382,798,16880,426
19964,125,4663,1235,3133,34978,1530
44743,93,964,766,783,9107,181
27155,6,1056,1097,615,14596,441
58865,219,5175,410,4242,27984,933
52170,1,17,615,17,2675,0
24269,0,77,1161,57,3687,20
37675,136,2099,878,1744,32954,355
18059,746,18480,1268,12778,152090,5702
42194,10,202,800,162,11696,40
21292,14,478,1211,323,18216,155
9360,0,1,1378,1,9930,0
60996,1,20,334,12,3058,8
10063,0,0,1374,0,7356,0
15258,5,190,1316,142,25822,48
47265,139,1781,736,1468,19535,313
65864,8,99,193,83,6451,16
25413,20,746,1136,477,9473,269
6147,73,2352,1408,1641,31425,711
33017,12547,585475,986,323021,1775123,262454
12928,5036,116313,1348,65860,312525,50453
26997,190,2847,1100,1926,18927,921
12351,14,681,1355,348,14528,333
55610,56,382,505,272,5944,110
34836,561,17226,951,13249,101714,3977
63148,27,1025,269,797,10703,228
44061,3,39,774,28,3098,11
30080,185,2878,1038,2127,16890,751
26182,13,664,1119,385,12698,279
61885,166,1764,305,1452,30811,312
50306,62,701,667,567,7562,134
11866,25,1165,1360,566,16922,599
50753,567,8061,656,5796,45357,2265
884,7,302,1462,205,22741,97
585,225,10497,1465,7264,162809,3233
25443,121,1918,1135,1240,31590,678
60922,36,255,337,211,4349,44
68780,137,1943,99,1583,14244,360
59451,9477,244573,381,182229,866732,62344
68637,14,789,101,671,15749,118
66829,704,11624,163,9606,82843,2018
30469,1850,44962,1031,32593,235447,12369
30891,49,1270,1023,822,15967,448
39362,20,365,843,301,6190,64
5842,315,13441,1412,8906,200210,4535
20634,31,1665,1223,1294,24300,371
54310,39,374,547,318,8658,56
38034,230,3189,868,2441,43309,748
36125,21406,523878,920,316063,1260369,207815
4065,2,91,1434,57,5770,34
52253,576,11595,612,8903,84028,2692
65643,8,81,199,54,3495,27
5005,15,498,1422,344,26052,154
26815,45,729,1104,499,10594,230
57585,0,0,452,0,8041,0
64881,13,161,218,138,7059,23
52333,0,12,610,10,1988,2
10459,57,1666,1372,1070,25370,596
36474,3,94,909,73,8472,21
31114,546,9510,1019,6898,44075,2612
57352,49,289,457,231,15646,58
29204,237,10985,1056,7579,110750,3406
54161,3,54,553,32,5914,22
1113,159,5447,1461,3523,39907,1924
11503,186,6197,1364,3316,74353,2881
18795,468,17268,1255,11638,278892,5630
21194,285,4495,1213,2907,17655,1588
19435,206,3500,1244,2787,41210,713
58822,194,1699,411,1342,15102,357
53343,53,1007,577,782,35971,225
179,75,3718,1469,2841,21112,877
27058,106,2115,1099,1378,18079,737
53648,8,90,569,80,5833,10
50339,1030,11381,664,9100,120603,2281
54516,118,1197,539,1054,22521,143
32498,190,2852,997,2098,34815,754
19002,127,6668,1252,3036,27944,3632
15758,253,8211,1308,5386,83777,2825
31377,1140,22267,1015,16660,104910,5607
22221,32,659,1198,447,7626,212
3395,956,30434,1442,20324,189607,10110
4116,23,771,1434,500,25215,271
60515,24,295,352,237,7137,58
40087,431,10708,833,8212,28561,2496
56549,0,118,478,110,3879,8
8781,510,8887,1381,5750,69657,3137
13762,297,6542,1336,3924,75610,2618
29464,87,3458,1051,2362,28050,1096
24203,3,336,1162,248,18829,88
51809,831,39822,626,27742,153916,12080
24659,369,5172,1151,3499,50091,1673
4571,1670,36518,1428,25039,120860,11479
65448,19,223,203,208,4816,15
57814,126,1427,443,1083,20243,344
32395,4,262,1000,148,4750,114
47544,17,246,733,197,14069,49
28418,4502,105424,1071,76543,529875,28881
60891,15,175,338,113,8009,62
65801,31,255,194,188,7021,67
19023,2805,56707,1251,41926,162179,14781
10489,13,289,1371,176,6525,113
65563,2,38,201,26,2222,12
9772,9,781,1376,458,14568,323
38436,17,536,858,456,10323,80
19283,1829,37138,1247,21460,189555,15678
26345,729,14194,1115,9037,60289,5157
18754,198,10707,1256,6861,40455,3846
8922,2263,84162,1380,50123,304993,34039
13783,6,377,1335,212,8751,165
68558,204,3459,107,2855,34457,604
18651,654,24931,1258,15904,147313,9027
39320,115,1538,843,1173,10802,365
33396,26,1212,981,798,15376,414
56888,0,60,469,7,3477,53
46925,10483,363061,734,257701,1288484,105360
61795,42,468,308,355,3565,113
534,990,45084,1465,26088,111740,18996
41565,9,284,810,205,5445,79
16222,53,1077,1300,764,18327,313
68835,15,189,97,156,3841,33
61325,53,551,323,483,9874,68
25910,59,1858,1125,1107,14612,751
16275,10,520,1300,416,19028,104
35085,12,174,945,113,6640,61
18838,0,0,1254,0,5292,0
39274,9,218,843,166,7779,52
23855,4,123,1170,87,4172,36
16868,32,1151,1290,797,20181,354
16278,3,397,1300,246,11856,151
19215,31,821,1248,596,14013,225
15335,534,12071,1314,6779,73457,5292
31069,13,564,1019,406,14130,158
63210,10,125,267,97,3947,28
9214,27,1012,1379,646,9980,366
827,58,1684,1463,1198,30612,486
4862,37630,1634481,1424,882774,3342634,751707
68371,4,54,114,41,5842,13
12434,13,1122,1354,552,10711,570
18828,34,619,1255,444,12349,175
4723,205,6887,1426,4789,57531,2098
4587,34,1296,1427,750,14600,546
38198,6,128,864,107,15172,21
25844,94,2248,1127,1503,33289,745
28962,48,1011,1060,646,35464,365
63956,1,79,246,51,3907,28
14637,69,1777,1323,1225,35096,552
63754,46,2052,253,1680,19735,372
25816,3,97,1127,65,7127,32
17779,4187,112958,1273,78056,645259,34902
1096,771,35855,1461,24137,162881,11718
47,1799,126302,1471,56844,469055,69458
12085,2271,64685,1358,36774,141514,27911
7159,612,18749,1395,10856,151050,7893
54401,97,702,544,541,10510,161
51061,29,219,647,173,8139,46
3556,146,4994,1440,3356,94022,1638
9160,64,1671,1379,1048,12863,623
53471,282,4096,575,3359,29359,737
20222,5,113,1230,80,6959,33
65693,51,319,197,272,4184,47
14811,148,5355,1321,3740,48579,1615
23200,455,14610,1181,10323,87006,4287
22807,89,1265,1188,850,21530,415
7837,94,1537,1386,1147,36675,390
4606,38,1416,1427,939,23486,477
45874,5,132,754,95,4618,37
14066,355,8602,1331,5564,81463,3038
18594,540,7699,1259,5339,36923,2360
40203,18,620,831,447,9475,173
41084,35,597,817,477,9550,120
61739,11,267,310,217,10511,50
19484,20,286,1243,226,6588,60
21688,87,1954,1205,1122,26010,832
10448,23,988,1372,662,34989,326
28336,13,318,1072,216,7434,102
20357,1149,25257,1228,18004,93497,7253
58699,6,59,414,46,6853,13
4024,248,9038,1435,5454,56698,3584
8683,1315,36928,1381,24142,190074,12786
27449,442,27639,1091,17091,49507,10548
31673,483,15128,1011,10213,112142,4915
21849,21,457,1203,291,14011,166
32642,117,3012,995,1999,16281,1013
9296,31,1454,1379,957,15415,497
3215,15,729,1443,505,18795,224
68372,21,318,114,267,11183,51
12246,164,7767,1356,4244,30465,3523
13146,199,9959,1344,6207,43431,3752
45525,1039,23150,757,17044,188195,6106
35424,53,824,936,647,22456,177
63780,16,218,252,167,4415,51
51370,108,1837,639,1538,29732,299
12591,20,473,1352,257,15768,216
35019,25,793,946,521,21651,272
64983,125,3510,214,2810,17515,700
60433,8,129,356,111,7874,18
53799,42,411,565,313,7505,98
32570,57,677,996,443,14281,234
6461,218,9813,1404,5904,175236,3909
14062,302,8256,1331,5648,61152,2608
59164,112,1418,400,1173,11221,245
22306,22,1363,1197,918,32282,445
33484,169,4204,980,2729,20545,1475
51287,152,1520,641,1178,16341,342
55842,107,1720,500,1384,14717,336
678,73,1517,1464,1077,27318,440
27304,363,7499,1094,4699,116154,2800
25899,171,4314,1125,2888,37773,1426
27432,1472,46439,1091,30407,272366,16032
24092,214,5358,1164,3898,42163,1460
59805,39,349,378,273,5996,76
4793,1311,45337,1425,26505,262046,18832
15070,7,269,1318,200,33716,69
61171,19,616,328,487,13019,129
40418,18,273,828,221,5957,52
48504,66,775,717,544,6451,231
48585,5,59,715,44,3978,15
4215,19,599,1433,399,24759,200
1371,244,7324,1459,5148,57537,2176
65053,281,3145,211,2517,19953,628
29939,25,1131,1042,580,9802,551
58299,41,412,428,336,6715,76
53950,1925,24873,560,20624,124776,4249
58837,12,171,411,122,2981,49
52556,664,13139,601,10210,78966,2929
53046,43,784,585,624,19133,160
18197,21,676,1266,552,20441,124
813,79,1706,1463,1319,25701,387
25160,19,532,1141,343,11728,189
21754,84,1834,1204,1159,20004,675
53191,1,81,581,59,4950,22
51867,11,129,625,88,3035,41
18266,157,3394,1265,2290,19797,1104
13186,246,3487,1344,2395,24688,1092
44531,22,270,768,199,5661,71
62544,16,355,284,244,10175,111
27911,49,1871,1080,1263,30396,608
8282,90,5675,1383,3361,47304,2314
28727,73,1468,1065,929,35657,539
15342,31,1359,1314,946,20800,413
52309,108,1380,610,1115,12808,265
26554,93,2253,1110,1410,55027,843
28995,175,5607,1060,4373,102793,1234
55493,491,7389,509,5854,95758,1535
52816,30,432,592,336,13638,96
60253,1,104,362,71,10857,33
54831,28,279,527,213,6558,66
65116,21,357,211,225,3885,132
21448,38,814,1208,607,4614,207
65145,8,120,210,96,7491,24
1954,6,399,1454,315,43756,84
35320,61,905,938,596,94345,309
51729,30,237,629,188,4909,49
32291,41,1001,1001,688,22625,313
60927,58,715,337,577,13782,138
30319,11,214,1034,191,11470,23
40636,5,109,825,79,4515,30
62307,326,4257,291,3290,32524,967
12935,178,6861,1347,4135,29465,2726
36534,6143,88356,907,54831,252752,33525
38010,10,41,869,38,1656,3
23711,0,46,1172,37,4867,9
17582,5118,178654,1277,115635,650102,63019
26129,746,14296,1120,8684,187383,5612
54349,2452,30700,546,22907,98213,7793
23351,358,9166,1179,5783,26521,3383
14852,43,2555,1321,1832,24815,723
54185,615,6006,552,4348,46358,1658
2586,15,485,1449,331,12103,154
64244,130,1901,237,1613,21576,288
885,1331,29639,1462,19257,90187,10382
37697,262,3317,877,2759,21946,558
55912,44,559,498,438,14458,121
35773,3,280,929,171,9937,109
54577,70,683,537,534,18912,149
13879,6,602,1334,354,12204,248
18264,697,12929,1265,9076,51640,3853
67469,7,121,142,93,6780,28
32414,118,5534,999,3502,30319,2032
60223,61,678,363,535,5483,143
61326,54,871,323,704,10660,167
4022,108,3824,1435,2496,53371,1328
12237,46,850,1356,571,9605,279
62215,8,137,294,81,1902,56
24649,72,1052,1152,718,10182,334
20503,35,1529,1226,1018,14525,511
51424,5,83,637,61,3944,22
19924,988,22577,1235,14101,100846,8476
1562,50,1567,1457,1192,39283,375
50840,202,3056,653,2343,43587,713
60083,22,185,369,151,10717,34
33637,66,2175,971,1387,19533,788
24476,78,1520,1156,1051,12843,469
44091,44401,697300,773,497028,1594871,200272
58065,29,396,436,284,5458,112
9424,2226,61889,1378,38437,188158,23452
5356,15,284,1417,205,8494,79
27621,450,12643,1086,8455,75599,4188
65762,21,310,195,238,7365,72
14886,248,6138,1321,4814,53373,1324
5461,30,911,1416,622,19718,289
65048,7,103,211,85,3795,18
38517,11,147,856,110,2051,37
66984,85,1404,158,1071,27986,333
13348,11372,384665,1342,202931,1074671,181734
13728,21,1157,1336,695,43070,462
57130,201,2867,463,2300,23314,567
67096,29,206,155,159,2526,47
25662,93,1603,1130,1329,27592,274
29385,116,3265,1052,1995,26083,1270
30729,77,4425,1026,2893,58125,1532
34460,503,7683,960,5955,53821,1728
59842,136,1973,377,1383,22419,590
17759,22,427,1274,294,14149,133
27551,13,264,1088,171,17484,93
11887,78,1707,1360,889,14634,818
8111,15,496,1383,306,7244,190
35317,12,182,938,162,7060,20
41637,613,13625,808,10664,66917,2961
56221,103,1603,489,1341,20447,262
6171,7,221,1408,143,14971,78
51024,1549,27516,648,22223,104204,5293
66756,8,78,166,66,2741,12
67521,43,346,141,273,5259,73
15091,243,4301,1318,3365,47295,936
1522,1091,48658,1458,30988,133539,17670
55972,771,8958,496,7375,55339,1583
53960,0,14,560,14,2432,0
61639,264,3361,313,2944,11063,417
42842,102,1191,789,896,12256,295
63281,15,184,266,143,7967,41
9245,78,2240,1379,1449,23687,791
12037,31,1128,1358,656,18795,472
23706,20,973,1172,685,12743,288
57622,21,298,450,244,5765,54
18546,65,2085,1260,1612,26506,473
29583,108,2259,1049,1266,19090,993
13123,0,82,1345,30,3765,52
20048,40,834,1233,614,28602,220
34933,345,7225,949,4628,23689,2597
67271,6,107,148,75,5277,32
27178,4168,128410,1097,88621,292911,39789
32463,97,1570,998,1120,39116,450
4041,320,9570,1435,6637,126628,2933
52444,423,5075,606,4218,31095,857
63790,53,805,252,684,18843,121
33964,2,136,971,90,8936,46
68794,117,2597,98,2112,14181,485
11295,105,5176,1365,3199,39378,1977
13296,41,2374,1343,1378,29594,996
67265,21,194,149,137,2677,57
8404,49,2202,1382,1431,71741,771
16338,3,205,1299,134,7152,71
41030,8,184,818,146,20967,38
4742,51,2444,1425,1509,18483,935
46663,50,685,744,495,23895,190
2979,3610,105035,1445,58246,180132,46789
34354,119,2036,963,1456,26171,580
34825,22,360,951,266,5991,94
15123,17644,578678,1317,391827,2136239,186851
67126,4,37,154,30,4329,7
45831,239,2579,754,2212,25172,367
68860,44,785,96,676,10021,109
23574,2748,60952,1175,42798,190086,18154
50226,59,873,669,682,16865,191
67182,55,745,151,559,10753,186
22452,82,3856,1194,2535,46281,1321
13827,2,127,1335,99,5631,28
14826,45,805,1321,657,17390,148
26613,24,113,1109,84,100823,29
40801,67,404,822,365,6532,39
20188,186,4128,1231,3021,40130,1107
25123,11,398,1142,283,18229,115
27584,0,0,1087,0,30806,0
35444,18,284,936,183,3845,101
5260,42,670,1418,447,9840,223
26196,86,2464,1119,1669,30737,795
921,53,2210,1462,1521,31411,689
33640,4,328,977,178,7332,150
30538,23,530,1029,442,36069,88
22296,319,8989,1197,6542,82303,2447
63228,68,1233,267,779,12201,454
21057,29,833,1215,571,17188,262
56846,61,685,469,602,17588,83
3069,26,1663,1445,1183,81798,480
21504,40,504,1207,331,10318,173
59473,83,743,389,567,6495,176
40485,18,247,827,178,7647,69
4435,22,1361,1430,911,32785,450
19070,55,1742,1251,1357,45962,385
38275,30,531,862,480,16212,51
23223,14,196,1181,143,7795,53
34321,2532,50150,963,31759,275233,18391
31292,28,416,1008,265,5068,151
64697,288,3121,224,2549,14054,572
59027,11,182,404,132,5604,50
23300,43,960,1180,640,14901,320
13306,466,18137,1342,13734,108429,4403
10852,135,3019,1369,1890,14989,1129
4631,19,409,1427,306,10972,103
63740,52,524,253,440,11214,84
32516,254,6115,997,4187,65680,1928
19753,14,849,1238,649,40094,200
63485,79,902,260,739,8884,163
67656,246,3457,137,2861,39354,596
30065,31,487,1039,351,15478,136
63966,27,423,246,327,10403,96
18805,85,1794,1255,1470,16580,324
7645,16,227,1389,182,5171,45
64376,80,1288,233,1122,12506,166
25627,3,69,1131,48,4898,21
5628,337,12662,1414,8128,44335,4534
32805,247,6176,992,4210,45759,1966
65710,13,144,196,112,2945,32
62992,52,728,273,644,21578,84
34406,62,941,961,634,7251,307
11277,267,15688,1365,9048,159223,6640
37746,2152,39342,876,30441,344450,8901
60051,90,1161,370,928,12543,233
22634,8,394,1191,296,18724,98
9680,42,1644,1377,993,15000,651
29803,361,10518,1044,6236,56727,4282
13211,32,1102,1344,538,11833,564
52137,126,1853,616,1524,19227,329
24741,37,1452,1150,944,34167,508
230,2,150,1468,92,12119,58
23516,34,617,1176,475,33625,142
27785,472,15779,1084,10577,121964,5202
8744,333,9593,1381,5982,47310,3611
55841,1,9,500,6,1440,3
68051,15,169,124,139,7048,30
22409,154,11739,1195,6511,61209,5228
16772,336,8284,1291,5331,72818,2953
53064,16,346,585,226,10030,120
44413,133,1496,769,1148,11319,348
41282,47,835,814,671,14310,164
10946,202,9528,1368,5892,32199,3636
68207,45,529,119,438,12637,91
24316,9,183,1160,145,6013,38
22685,14,575,1190,399,23696,176
66199,9,151,182,119,3818,32
277,171,8215,1467,5502,86039,2713
27504,111,2362,1089,1537,33954,825
63185,1,36,268,25,3822,11
20177,1,133,1231,90,2691,43
31808,4,144,1008,99,7322,45
2024,78,2382,1454,1376,20507,1006
60789,1454,28506,342,22894,142483,5612
12557,80,1970,1352,1058,19347,912
20585,0,105,1224,63,9971,42
38003,25,811,869,594,14419,217
56988,6,38,466,33,3299,5
25793,617,14182,1127,10032,63813,4150
49012,39,569,702,488,14521,81
33089,28,1217,987,710,13441,507
35116,96,2336,944,1659,14199,677
8501,720,25693,1382,16968,84545,8725
49813,29,547,679,409,15371,138
36087,10,239,920,179,10970,60
55696,4,98,503,73,18291,25
59217,0,3,398,1,1621,2
27529,423,10520,1089,6444,64670,4076
35878,113,2014,926,1417,26056,597
51417,1600,18263,638,14930,124714,3333
29933,85,932,1042,493,11764,439
10085,305,6635,1374,4012,43206,2623
60769,471,9581,343,7722,47492,1859
3152,127,3342,1444,2158,18960,1184
5801,37,1158,1412,775,14547,383
12899,6,205,1348,114,5313,91
27334,94,4937,1093,3067,28766,1870
13703,50,2042,1337,1318,18276,724
31455,58,1060,1014,678,11898,382
27745,19,668,1084,389,12685,279
2102,40,1478,1453,1010,28043,468
25681,31,795,1130,563,17355,232
24041,13,471,1166,344,7729,127
54690,23,146,533,116,4326,30
65679,27,238,197,198,3118,40
61381,78,843,321,595,5805,248
37901,20,353,873,252,2941,101
40608,67,1060,825,822,8809,238
31158,31,480,1018,298,5513,182
24812,50,1051,1148,688,13945,363
672,52,2147,1464,1351,32878,796
19903,136,1290,1236,891,10064,399
33146,43,726,986,445,7606,281
49142,19,336,698,243,7190,93
31211,80,1086,1017,762,12131,324
29678,66,1800,1048,1158,37701,642
17994,3,716,1269,268,11715,448
22064,4,27,1200,22,7325,5
2209,165,4127,1452,2857,31396,1270
8575,30,1783,1382,1058,43835,725
68755,104,695,100,586,10119,109
32782,135,4450,993,3000,18318,1450
61956,80,565,303,449,13586,116
59697,60,632,381,484,15358,148
59349,31,348,394,286,7451,62
53897,6,75,561,61,5955,14
59373,149,4071,393,3289,14895,782
4812,63,2085,1424,1367,16538,718
13913,259,7698,1334,5335,45529,2363
36038,15,315,922,266,6164,49
7447,31,675,1391,477,13108,198
67322,9,251,147,136,5486,115
43897,12,421,776,368,13330,53
44649,32,987,767,710,16533,277
17368,338,10455,1281,7286,116160,3169
24986,20,580,1144,429,18596,151
36426,15,352,910,277,6820,75
10322,73,1520,1373,1037,25614,483
61792,53,607,308,514,10609,93
3662,6,159,1439,113,11633,46
31317,89,1376,1016,892,13943,484
9620,40,1745,1377,960,21348,785
8660,25,1230,1381,865,19805,365
8943,3194,63801,1380,46641,217992,17160
50263,440,4770,667,3766,41363,1004
55200,4,65,517,43,3155,22
10617,56,3030,1371,1924,76924,1106
34400,261,6180,961,4702,92512,1478
35913,71,1512,924,1127,16031,385
58026,29,322,437,281,19740,41
22154,3,135,1198,105,10655,30
16906,152,4356,1289,2881,57752,1475
60635,86,1669,348,1371,20296,298
62728,290,6913,279,5257,48210,1656
22002,68,1771,1200,1145,17759,626
8015,110,3479,1384,2627,31245,852
20302,25,2654,1229,1917,23800,737
67030,59,489,157,389,5215,100
1757,84,3582,1456,2612,36762,970
18379,67,2235,1263,1648,42434,587
16565,452,8573,1295,5529,35371,3044
40668,2,33,825,16,1503,17
56556,17,218,478,155,7745,63
67318,21,488,147,303,5967,185
39769,113,2191,838,1691,19582,500
57889,178,2840,442,2258,24596,582
35819,5883,168369,928,127774,342681,40595
11389,20,882,1365,559,10506,323
59867,775,23220,376,19047,74179,4173
40315,124,3124,830,2388,26820,736
37910,145,2298,872,2009,23253,289
65031,1,59,212,50,5489,9
19177,84,2172,1249,1521,38813,651
20215,64,1611,1230,1201,41047,410
68987,22,534,92,430,6625,104
16102,9,499,1302,324,12452,175
53430,12,115,575,95,4007,20
68732,2,73,101,51,3102,22
10905,574,8007,1368,4767,26490,3240
27161,57,1064,1097,591,13072,473
43821,58,1024,777,788,28957,236
22837,1,61,1187,47,5397,14
39719,181,4320,839,3458,51944,862
20665,84,5675,1223,3107,35117,2568
6107,53,1543,1409,1007,10762,536
39048,98,1080,846,696,7559,384
3135,216,11261,1444,6471,101282,4790
10167,3,221,1374,136,7948,85
57346,202,3894,457,2951,26020,943
34390,68,1128,962,824,22140,304
46405,55,1130,748,888,23852,242
483,4,208,1466,139,12080,69
61723,263,4383,311,3588,52587,795
67450,15,211,143,161,3358,50
3750,91,2252,1438,1622,13726,630
59522,89,931,388,710,8308,221
8456,1101,27611,1382,16670,136842,10941
22381,43,664,1195,492,12592,172
25953,22,708,1124,498,31924,210
22450,594,10500,1194,7765,62011,2735
50068,14,226,672,203,7971,23
26551,91,1237,1111,692,8129,545
24586,2,174,1153,150,7102,24
56972,136,1642,467,1267,16203,375
35151,2,119,943,73,4980,46
13392,17,868,1341,498,10994,370
14807,2,236,1321,151,4158,85
32916,229,7132,990,6121,86274,1011
62219,4,110,294,84,4735,26
24924,512,17974,1146,12786,96375,5188
57497,14,264,454,181,3610,83
25613,34,772,1131,503,10095,269
2580,193,5155,1449,3819,26695,1336
27811,55,897,1083,651,8797,246
25879,144,3692,1126,2561,17937,1131
62663,352,5148,281,3991,55299,1157
55704,12,301,503,262,14358,39
50689,3,122,657,82,12776,40
52090,453,4410,618,3611,24582,799
53694,54,446,568,358,8775,88
21886,138,3989,1202,2601,25886,1388
14058,101,2778,1331,1784,23833,994
37228,64,832,890,678,8329,154
25653,124,3253,1130,2019,30032,1234
22943,18,661,1185,457,8746,204
36945,42,1336,899,830,25530,506
26836,26,764,1104,463,3614,301
67018,6,60,157,53,2678,7
14474,699,20258,1325,13481,74595,6777
24027,1,117,1166,72,5558,45
29586,128,1949,1049,1291,21655,658
49658,5,193,683,90,3510,103
61139,2548,29821,329,24048,98371,5773
22050,709,19991,1200,12606,160423,7385
35245,113,2045,941,1447,21451,598
2616,960,35855,1449,23816,122544,12039
52204,28,295,614,271,22983,24
23105,4,142,1183,95,5977,47
2712,78,1827,1448,1281,21255,546
51680,19,381,630,303,10393,78
42279,5,97,799,68,3930,29
6385,42,1147,1405,765,15651,382
57495,1,20,454,15,4319,5
831,4,152,1463,109,9536,43
51148,842,12240,644,10054,55257,2186
36959,177,4858,898,3822,69106,1036
27232,8,318,1096,211,6878,107
15553,6,412,1311,316,25540,96
61130,18,155,329,115,3696,40
24479,88,2238,1156,1449,15112,789
13297,66,2853,1342,1765,35860,1088
50505,147,2168,661,1880,34382,288
1185,15,498,1460,309,25203,189
25628,1528,48347,1131,30382,242391,17965
57595,13,280,451,213,3163,67
61255,6967,158238,324,118266,436162,39972
61491,111,2532,318,1200,20792,1332
52124,25,381,616,256,8744,125
24541,24,805,1154,548,9378,257
54606,120,1086,536,776,6431,310
25925,13,741,1125,454,17848,287
8460,90,2788,1382,1760,14906,1028
9328,23,1090,1378,672,16708,418
8602,5,349,1381,236,12992,113
66987,2,73,158,46,4001,27
28322,2,54,1072,37,3173,17
2110,52,2890,1453,1916,77964,974
4811,49,2041,1424,1467,33658,574
15601,113,2533,1310,1723,36400,810
20016,101,4611,1234,3237,110920,1374
68080,37,473,123,330,10765,143
43521,237,4484,779,3832,41263,652
37126,390,11921,893,9596,116143,2325
15345,31,587,1314,362,6058,225
12685,16,3317,1351,1651,14769,1666
67780,10,171,132,145,5226,26
910,18,896,1462,545,16796,351
8091,14,731,1384,476,7796,255
32924,39,486,990,327,8052,159
10845,28,1380,1369,819,22924,561
56156,5,82,490,68,4288,14
42772,39,891,790,750,17382,141
53401,127,1911,576,1664,32778,247
65984,173,2503,190,2131,22540,372
51189,9697,197395,639,154542,793637,42853
49832,43,934,679,820,19006,114
32171,21,621,1003,397,22385,224
11034,39,1107,1367,782,12452,325
56803,54,910,471,720,13784,190
31687,109,1497,1010,1085,8024,412
15673,2,96,1309,66,7755,30
62477,8,87,286,69,7064,18
56867,35,408,469,323,9596,85
7386,189,3352,1392,2227,22062,1125
48586,445,5864,714,4454,45663,1410
40951,96,1356,819,1075,12019,281
27862,13,804,1082,502,12911,302
66857,8,179,162,140,6021,39
61497,7,111,318,81,2614,30
16745,594,13610,1292,10439,108024,3171
66815,6,52,164,49,3441,3
6435,6,196,1405,133,16595,63
52338,52,535,609,415,9175,120
67071,15,145,155,92,4783,53
28249,21,391,1074,265,4514,126
8216,591,16067,1383,9842,75164,6225
27668,823,13543,1085,8287,102057,5256
66494,8,107,174,82,5062,25
2258,125,2810,1452,1972,18477,838
42442,42,1365,796,1129,21364,236
48516,13,419,718,303,7827,116
61222,24,387,326,290,9228,97
55712,25,281,503,230,8074,51
19102,27,1055,1250,661,12169,394
27180,13,470,1097,281,7293,189
42920,17,547,787,468,9572,79
60764,24,305,343,239,4069,66
33850,147,2323,973,1616,21090,707
29660,44,655,1048,467,12035,188
68485,27,321,110,286,6512,35
62331,194,3010,290,2537,29524,473
34011,55,1325,970,895,18733,430
66439,1,31,176,19,1491,12
13556,2,149,1338,76,14802,73
19582,1,89,1241,72,7755,17
60386,221,4632,358,3553,20731,1079
19226,130,4348,1248,3014,48595,1334
42550,11,147,794,112,7596,35
10143,1375,54518,1374,32921,134027,21597
54254,301,3245,549,2411,29164,834
32472,12,410,998,257,9817,153
30201,28,602,1036,436,5665,166
34783,51,1847,952,1291,84355,556
26452,270,13373,1113,6630,82089,6743
62789,70,880,278,580,12783,300
6475,426,17948,1404,11490,123703,6458
3979,1987,64315,1435,40045,271160,24270
26812,31,1085,1104,701,12664,384
29356,468,8367,1053,5747,83539,2620
31002,1919,35774,1021,23388,215164,12386
44746,1,90,766,75,5542,15
25799,798,12400,1127,10639,248019,1761
60873,67,863,339,689,19939,174
27421,95,1871,1091,1176,17959,695
540,6,244,1465,166,52860,78
13126,5,611,1344,331,16256,280
59314,215,7407,394,5810,28125,1597
10835,31,2534,1369,1479,15548,1055
16360,8,357,1298,224,14050,133
40332,8,143,829,117,9338,26
41288,3,100,814,59,6843,41
1936,885,25360,1455,16909,120824,8451
65934,226,4174,191,3430,44190,744
11544,40,1088,1363,660,12676,428
37789,1633,24472,874,20078,139593,4394
5719,867,18975,1413,13862,93707,5113
32852,37,1508,991,999,13667,509
44462,16,257,769,186,9943,71
2872,19,389,1446,295,27409,94
3588,27,1137,1440,759,27868,378
6369,7,177,1406,121,6092,56
65499,13,375,202,311,14719,64
8383,137,5587,1382,3679,39554,1908
13469,1136,26601,1340,15798,187865,10803
60710,338,3703,345,2740,19655,963
60781,47,565,342,441,14660,124
2480,460,15351,1450,10764,111065,4587
18613,9,977,1259,603,17418,374
40642,24,733,825,586,10303,147
41447,1558,24191,777,17517,154851,6674
2936,98,1792,1446,1151,23476,641
5343,41,2268,1418,1390,14223,878
54490,27,425,540,348,6710,77
68961,6,72,93,57,2478,15
4628,54,702,1427,473,13169,229
12747,67,3373,1350,2080,69592,1293
38715,60,1060,851,883,15037,177
13304,37,2426,1342,1405,38691,1021
21540,1729,36698,1207,21681,207403,15017
61683,91,1630,312,1282,25561,348
34399,5570,111516,961,66736,219136,44780
56644,120,1445,476,1126,20616,319
34873,7,151,950,111,2158,40
37672,26,908,878,801,28173,107
50483,1652,45047,662,30641,243724,14406
2109,9,423,1453,298,16183,125
57362,16,233,457,170,6251,63
37968,16,199,870,172,7846,27
2865,12,379,1447,273,21357,106
32328,4,82,1001,46,4639,36
9897,909,71666,1375,39377,198056,32289
65908,11,194,192,128,3869,66
42322,478,6484,798,5522,60832,962
10402,56,784,1372,529,15823,255
59504,220,2758,388,2224,17969,534
27407,692,12890,1092,9600,177707,3290
10880,115,4771,1368,3137,32834,1634
54945,20,143,524,106,6577,37
29306,18,604,1054,334,7995,270
32506,25,400,997,270,5467,130
11130,3734,61727,1366,35186,265823,26541
67362,35,447,133,398,8339,49
41055,1,21,817,20,3012,1
31811,115,3013,1008,2140,21034,873
10103,30,1203,1374,818,22047,385
62780,77,698,277,590,11353,108
67678,23,235,136,190,7604,45
22796,29,568,1188,344,12746,224
55559,243,5222,507,3735,35982,1487
24299,5,358,1160,172,10950,186
35571,10,227,933,141,2981,86
53771,261,8489,566,6122,29900,2367
21003,4,154,1217,121,4531,33
8402,19,1097,1382,723,9195,374
16035,3,160,1303,114,20199,46
3033,7,662,1445,433,16834,229
65579,120,1589,200,1334,14348,255
54583,27,454,537,312,10649,142
59093,6,167,402,129,2695,38
65892,1,37,192,26,4054,11
15626,64,1412,1310,944,41882,468
14127,0,316,1330,217,15702,99
366,17,1207,1467,790,30935,417
58484,27,192,421,162,5124,30
66672,30,461,168,353,9127,108
61558,38,372,316,310,9421,62
29842,1,189,1044,119,3006,70
24016,155,5527,1166,3383,46457,2144
49815,34,344,679,286,4186,58
40014,26,617,834,529,8059,88
25911,49,1399,1125,858,26490,541
6923,7685,429648,1398,229677,984331,199971
1603,2629,84227,1457,52596,248439,31631
31004,32,1059,1021,718,17782,341
15196,12,1017,1316,647,11963,370
53587,5,81,572,56,4122,25
8742,245,10559,1381,7134,135394,3425
2609,27,556,1449,408,25016,148
39427,58,883,842,685,9501,198
17386,6,263,1281,217,8348,46
18273,2785,64924,1265,45677,232384,19247
56291,38,676,486,514,13975,162
33345,253,5489,981,3660,22270,1829
41479,11,247,811,198,8821,49
66195,4,41,183,33,1052,8
56405,4,35,483,24,1788,11
31323,1,118,1016,74,4778,44
15729,10,338,1308,227,11723,111
14887,845,22802,1321,15088,92008,7714
18316,0,0,1264,0,6462,0
34527,202,4509,959,3108,28839,1401
56589,52,597,477,462,6354,135
50532,703,11384,661,8657,57154,2727
11387,267,10329,1365,6135,125427,4194
25219,5,92,1140,77,19233,15
36393,926,12950,911,10000,135637,2950
33977,730,14982,971,11589,83259,3393
66915,1216,24506,160,20023,137962,4483
57385,39,678,456,472,23415,206
27279,30,640,1095,467,11605,173
68823,9,219,97,169,6070,50
12824,55,1034,1349,577,16361,457
2427,14,669,1450,490,20842,179
14527,4,168,1324,99,20561,69
55427,11,140,511,88,5827,52
68222,11,242,119,163,5665,79
32172,314,4704,1003,3045,29001,1659
36222,687,17817,917,12205,58212,5612
7522,233,5345,1390,3547,34684,1798
23679,42,1196,1173,888,21229,308
3440,8,270,1441,200,14613,70
64998,17,244,213,203,7015,41
55565,230,5602,507,4544,43248,1058
61802,39,449,308,373,2477,76
36156,65,978,918,754,18560,224
22996,1231,21471,1185,15227,68954,6244
54569,1,48,537,31,3478,17
46708,71,888,743,669,21009,219
67017,87,1305,157,893,11099,412
46192,23,294,750,210,11191,84
12453,85,3779,1354,1778,15080,2001
1110,511,10891,1461,7043,89524,3848
22224,52,2416,1197,1771,14619,645
32717,31,389,994,321,11963,68
36901,50,624,900,508,6423,116
3167,500,14764,1444,9104,52869,5660
19775,13,376,1238,273,29290,103
16552,35,659,1295,479,11852,180
30085,4,185,1038,111,8233,74
16294,6,210,1299,150,11802,60
55940,13,275,497,203,10478,72
18421,368,15382,1262,10490,97891,4892
10689,10,796,1370,539,14169,257
44572,30,585,768,362,12571,223
35188,118,1548,942,1105,19946,443
59315,16,105,394,85,4529,20
38203,8,76,864,67,2660,9
30412,43,1104,1032,632,11160,472
59202,8473,226225,395,168929,792442,57296
42644,185,7628,792,5873,39676,1755
51673,68,880,630,621,11411,259
49660,95,1181,683,987,18571,194
37297,36,370,888,281,10007,89
48752,24,415,710,325,8272,90
36092,11,487,920,424,12475,63
21555,19,563,1207,395,8760,168
48676,22,334,712,291,14532,43
63787,89,725,252,565,7446,160
16224,155,3086,1300,1717,13924,1369
29993,108,1913,1041,1700,42711,213
58587,221,4039,418,3444,27102,595
55973,155,2651,496,2383,27377,268
26227,22,406,1118,328,30522,78
37485,29,508,883,369,10844,139
27095,4043,92572,1098,57312,172895,35260
67411,6,100,144,82,5275,18
57533,43,1219,453,917,22940,302
53240,23,298,580,225,7105,73
23616,360,11815,1174,8493,143700,3322
30203,25,803,1036,584,6130,219
955,516,19623,1462,14144,69423,5479
63046,1,10,272,9,1094,1
4773,40,1188,1425,841,58009,347
29722,77,1714,1046,1092,17170,622
68054,14,295,124,219,5022,76
32618,2,74,996,48,4041,26
37467,52,813,883,664,10652,149
67405,21,352,145,268,4884,84
50678,10,219,658,193,9967,26
20807,422,10496,1220,6730,75954,3766
9815,81,2415,1376,1467,24347,948
26830,56,1738,1104,1041,11533,697
12527,18,854,1353,432,8136,422
17923,140,3550,1270,2544,20871,1006
10793,13,494,1369,306,11947,188
18150,141,4110,1267,2777,67932,1333
13410,102,3567,1341,2204,60256,1363
34682,2,104,955,57,3358,47
36310,273,4225,914,3638,51329,587
9060,363,5125,1379,3416,62952,1709
14695,149,3116,1323,2195,51611,921
62052,23,279,299,183,7421,96
20416,38,1573,1227,1211,35455,362
38189,12,361,864,301,11036,60
6999,95,2658,1397,1773,17570,885
51020,10,109,648,77,5173,32
22890,9,200,1186,146,10009,54
66122,10,97,185,73,1857,24
5201,34,836,1419,545,16530,291
12268,1637,44790,1356,28509,220827,16281
18911,385,4994,1253,3399,105112,1595
3388,26,912,1442,623,15579,289
36557,5,81,904,62,6161,19
12047,156,5267,1358,3016,26851,2251
51199,1096,17395,643,13996,61462,3399
6706,239,9004,1401,5576,47764,3428
23354,1183,31547,1179,22032,170779,9515
31465,124,1917,1013,1316,24259,601
1320,225,16901,1459,11463,57055,5438
16647,0,0,1294,0,5290,0
61525,13,98,317,97,4022,1
32140,12,350,1004,221,9694,129
61110,1140,17558,330,13321,45222,4237
39329,15,340,843,296,7109,44
57724,16,126,447,86,5090,40
60628,87,1285,348,1061,12164,224
65391,0,16,205,13,1701,3
32428,6,123,999,73,7568,50
34310,3,84,964,52,3261,32
14756,4,234,1322,180,7200,54
6224,197,7811,1407,4439,17858,3372
24142,120,1579,1163,1158,11485,421
22438,591,28021,1195,19041,129164,8980
50890,18,161,652,132,5777,29
25600,25,514,1132,288,3611,226
16828,121,2858,1291,1840,32175,1018
67177,3,78,151,65,5632,13
24280,37,1346,1161,929,39208,417
22311,28,938,1197,766,49223,172
61654,24,416,313,294,5801,122
30276,3,75,1035,63,2575,12
30568,435,9419,1029,6451,75062,2968
18044,436,15064,1268,10329,113951,4735
37005,7,142,896,106,6828,36
24420,29,355,1157,277,26747,78
21227,17,385,1212,291,42376,94
66502,665,12985,174,11094,83797,1891
13628,52,3372,1337,2137,38975,1235
54237,112,1645,550,1342,36062,303
2721,668,11795,1448,8206,86701,3589
46820,41,1330,742,1094,33523,236
14985,68,3113,1319,1946,41209,1167
20082,62,1006,1232,693,17769,313
11608,201,13148,1363,7862,103755,5286
33230,14,245,984,164,15914,81
3758,176,7029,1438,4971,66301,2058
61922,68,1034,304,807,9869,227
58750,12,235,413,199,10746,36
39061,40,1040,846,720,21460,320
4951,16,475,1423,348,9263,127
1498,34,671,1458,527,43784,144
48669,626,10354,712,8748,73031,1606
17017,22,1155,1287,814,19671,341
13867,74,1342,1334,782,9808,560
43125,35,599,784,446,12541,153
52368,70,498,608,389,5316,109
50419,59,594,664,467,5136,127
19179,116,4147,1249,2532,18469,1615
22826,4,223,1188,160,14487,63
35533,12,211,934,154,5404,57
51309,4,79,641,64,3508,15
24820,37,849,1148,560,19578,289
13277,6,187,1343,121,23138,66
59841,330,4026,324,3157,37966,869
35928,3,92,925,66,5202,26
29532,0,0,1050,0,39871,0
53493,6,53,574,43,3038,10
49829,211,2349,679,1845,12321,504
52564,54,834,601,714,25415,120
52904,97,1281,589,1007,8682,274
65216,1226,28354,209,22607,93481,5747
7108,384,14491,1396,9354,61647,5137
52549,20,245,602,194,8670,51
55124,95,1839,504,1372,23858,467
50307,4454,66875,667,49908,170226,16967
50731,798,22474,656,15894,110896,6580
53303,8,182,578,124,5785,58
56515,446,4520,480,4056,42978,464
38435,106,2279,858,1309,14612,970
10864,2136,79756,1369,47477,478263,32279
23080,7,667,1183,451,15504,216
56598,7,103,477,86,4684,17
29442,37,971,1051,589,9800,382
49895,0,2336,677,1245,10104,1091
14607,791,8933,1324,6427,48614,2506
56362,105,1293,484,1107,17365,186
7343,33,927,1393,641,41857,286
57534,165,1844,453,1602,13897,242
23213,1,84,1181,59,4066,25
65425,12,143,204,101,6296,42
24509,380,10320,1155,6544,50973,3776
651,6,132,1464,77,8044,55
66410,9,205,177,126,4525,79
5916,1217,37012,1411,25388,138071,11624
29416,74,1793,1052,1316,35398,477
28597,11,262,1068,174,3835,88
14609,1019,22924,1324,14675,88442,8249
35125,2153,40168,944,30514,318009,9654
37098,26,584,894,494,11366,90
19570,3,111,1242,58,5648,53
59554,6,74,387,49,6496,25
18845,148,2407,1254,1732,36297,675
2751,582,39706,1448,26762,268263,12944
51578,7,70,633,57,10779,13
48329,520,6382,722,4469,166799,1913
24796,2,125,1149,79,5797,46
63265,75,1206,266,994,12492,212
67981,290,6497,126,5345,36002,1152
9894,2019,64540,1375,43253,178507,21287
58687,231,5048,415,4182,30556,866
3147,5219,211643,1444,125547,465455,86096
10581,8,364,1371,205,11411,159
15637,51,1689,1310,1079,22035,610
684,34,2789,1464,1941,24471,848
65068,3,33,211,23,3239,10
5401,109,4369,1417,2894,32330,1475
13365,5,398,1341,224,8700,174
30245,25,503,1035,311,6428,192
24043,144,3539,1166,2332,29380,1207
3530,30,887,1440,659,22360,228
50551,2,96,660,66,8836,30
30541,24,1046,1029,788,10003,258
29228,99,3357,1055,2107,29228,1250
37439,50,1001,884,780,17508,221
40811,9,110,822,87,4207,23
17369,7,536,1281,367,14620,169
9880,7,239,1375,160,24053,79
844,34,1059,1463,735,25137,324
7501,341,18017,1391,12551,64179,5466
32324,10,235,1001,165,7817,70
36185,537,17019,918,13372,38042,3647
62797,294,5168,278,3969,29356,1199
55113,45,840,518,631,22786,209
43885,150,2481,776,1885,19608,596
53877,130,1664,562,1459,18634,205
39595,111,1767,840,1325,26124,442
64861,1,23,219,17,2172,6
35038,795,30773,946,19196,222166,11577
34115,333,21695,967,13181,46509,8514
40860,76,1052,821,726,15365,326
66950,11,114,159,76,3297,38
14639,0,131,1323,98,7169,33
23899,450,11387,1169,8218,46129,3169
29157,60,1191,1056,747,17131,444
50154,19,168,670,129,3139,39
50079,39,663,672,523,12766,140
40720,35,542,824,452,6499,90
3713,1,143,1438,100,21049,43
3595,6448,200413,1440,111149,410847,89264
23790,5247,144499,1171,94598,783857,49901
29556,3,95,1050,88,13392,7
20765,37,965,1221,689,46788,276
12036,34,2912,1358,1368,15527,1544
5653,33,1894,1414,1194,10646,700
66081,38,1181,187,889,10514,292
65816,1085,28775,194,19887,123177,8888
49042,879,9633,701,7682,82958,1951
3452,41,1495,1441,1047,27737,448
14301,19,724,1328,511,32613,213
6093,903,25040,1409,16365,85147,8675
7315,3428,85155,1393,53706,178249,31449
16859,5,876,1290,632,27392,244
22427,40,761,1195,667,15255,94
38432,58,1099,858,818,17430,281
19572,10,355,1242,241,9248,114
30495,43,862,1030,583,19205,279
37585,52,739,880,345,9192,394
53019,29,264,586,190,6893,74
21245,47,2763,1212,1412,18918,1351
25370,2412,71489,1136,47230,285492,24259
16539,788,37917,1295,22509,199172,15408
39705,1,41,839,23,1661,18
32603,69,2103,996,1455,9163,648
19983,219,9110,1234,5716,62941,3394
19314,0,0,1246,0,13869,0
57043,1,43,464,40,4290,3
34979,16,535,947,365,5407,170
50698,6303,133416,636,102872,573243,30544
40331,305,4407,829,3311,47901,1096
13350,69,2808,1341,1716,36023,1092
17257,2503,58392,1283,35008,109399,23384
62608,13,280,282,169,9222,111
15787,10,407,1308,290,13137,117
13299,73,2863,1342,1726,32291,1137
61105,2,40,330,16,6773,24
58334,997,25161,427,18829,86825,6332
35848,36,833,926,628,12509,205
49577,40,595,686,486,13738,109
12789,16,945,1349,456,16765,489
21218,30,1283,1212,749,9067,534
52099,29,374,617,329,11816,45
5314,86,3480,1418,2488,48658,992
8157,6166,181043,1383,109706,463712,71337
52933,74,1117,589,864,18292,253
22019,581,11042,1200,7711,65189,3331
8810,158,7763,1380,4450,43239,3313
24473,53,1046,1156,692,32576,354
24050,96,2926,1165,1838,13860,1088
13575,24,1076,1338,728,13604,348
63232,54,1103,267,912,12228,191
32406,12,153,999,111,11572,42
3174,12395,482165,1444,270165,1482009,212000
21243,43,1115,1212,741,12670,374
54169,187,3294,552,2602,29684,692
21874,35,1324,1202,1035,34080,289
19121,12,359,1249,278,12516,81
62149,771,16045,295,13259,86747,2786
67926,0,20,128,15,921,5
11414,404,19588,1364,11130,71920,8458
18508,5,617,1260,473,6482,144
64538,57,1059,229,819,11699,240
23356,9,364,1179,305,13195,59
32197,81,1293,1003,891,10444,402
63559,1178,17119,259,14158,123612,2961
67157,3,83,152,53,2831,30
37032,82,2543,896,1939,13254,604
23396,175,4368,1178,3051,53902,1317
33298,21,381,983,312,19947,69
22638,673,11541,1191,7501,49836,4040
29945,14,441,1041,259,7406,182
30936,73713,3075863,1022,2182907,16614172,892956
55652,86,1338,504,1062,8954,276
27184,33,608,1097,405,13756,203
19515,0,0,1243,0,18511,0
22184,1175,17479,1198,10145,76451,7334
35111,19,419,944,296,5457,123
16020,264,7641,1303,5453,79163,2188
24157,2115,49712,1163,42745,226728,6967
8394,5,232,1382,156,6732,76
35759,10,162,929,129,16081,33
10606,8,163,1371,111,8425,52
63679,3,65,255,36,4383,29
22407,2693,69389,1195,48257,354782,21132
2063,2645,136045,1453,76833,531828,59212
21299,16,515,1211,395,13813,120
32622,34,916,996,683,19141,233
49618,176,2882,674,2324,34864,558
33861,63,1090,973,711,15162,379
53923,8,66,561,54,2686,12
4910,8259,250895,1423,155024,576633,95871
20780,976,21621,1221,14449,224507,7172
66642,31,422,170,312,8325,110
36844,15,174,902,135,5430,39
47508,5,82,733,58,4546,24
56329,263,3404,485,2743,28523,661
17430,55,937,1280,776,17506,161
25696,3489,109452,1129,66652,463994,42800
31899,4314,74678,1007,48728,153730,25950
11169,161,2384,1366,1606,61059,778
57214,8,107,461,86,7248,21
8610,47,1967,1381,1152,22870,815
47063,2103,35643,738,29405,260738,6238
34034,123,1756,969,1350,26754,406
39140,165,3185,845,2376,17214,809
29429,88,1325,1052,894,10852,431
33620,46,946,977,685,23886,261
30661,33,438,1027,270,5295,168
21626,32,548,1205,364,9221,184
18691,128,2346,1257,1652,19893,694
29775,678,27383,1045,17252,137680,10131
24407,120,4571,1157,2795,43207,1776
23591,68,2036,1175,1571,26883,465
492,225,7935,1466,5570,83040,2365
8293,0,0,1383,0,5852,0
68585,16,150,105,118,2537,32
33210,343,4152,985,2961,30032,1191
23493,1,58,1176,50,7103,8
29218,51,1599,1055,1164,22703,435
3448,18,701,1441,503,18022,198
10414,45,1120,1372,735,26753,385
18101,5,290,1267,238,11275,52
56902,343,6795,469,5541,53333,1254
33790,8,187,974,127,7977,60
16792,11,323,1291,235,14339,88
56361,79,1583,484,1227,10464,356
34306,773,35848,964,27298,126571,8550
61351,9,102,322,86,3455,16
59502,25,279,388,204,13521,75
14152,15123,1073301,1330,611129,1991636,462172
6656,233,5181,1402,3243,16834,1938
11833,20,605,1360,320,26977,285
15960,3,164,1304,99,5813,65
32091,246,4282,1004,2775,19076,1507
37111,137,3027,893,2595,77954,432
52455,237,3580,605,3075,15711,505
22625,223,7658,1191,4452,65935,3206
5047,5,305,1421,97,321035,208
32158,20,429,1003,392,7957,37
4946,545,46021,1423,30329,207512,15692
30820,102,2474,1024,1630,21713,844
26308,2127,95511,1116,53860,323480,41651
18680,5,616,1258,407,13879,209
33233,259,5733,984,4473,57003,1260
35866,3,105,926,84,3753,21
52693,25,359,596,311,11974,48
37981,6385,89099,870,62723,438393,26376
6922,33,1011,1398,677,16207,334
17898,161,3815,1271,2512,19903,1303
30567,4,88,1029,54,1935,34
5665,513,10404,1414,7091,47386,3313
14983,0,48,1319,34,4429,14
46495,1794,50995,746,36012,127382,14983
30285,103,6813,1035,3796,31237,3017
15755,28,1316,1308,968,43359,348
63752,24,388,253,329,8738,59
32585,9,215,996,142,5386,73
31483,19,609,1014,383,15215,226
14224,21,783,1329,576,10992,207
11245,1,166,1366,98,11321,68
15620,12,347,1310,265,7806,82
285,347,6813,1467,4304,34246,2509
6407,31,743,1405,515,25815,228
53604,72,1529,571,1016,25913,513
10104,5,453,1374,198,20623,255
21355,8,119,1210,84,13783,35
61103,64,714,330,600,9999,114
64053,11,131,243,97,7978,34
68703,13,122,101,112,3418,10
3510,660,21231,1440,14654,54658,6577
12152,6,255,1357,128,10534,127
22216,10,219,1198,149,6597,70
12229,29,1550,1357,871,12819,679
68925,15,213,94,177,4338,36
65492,8,75,202,65,1807,10
21583,126,4166,1206,2740,52102,1426
25818,12,573,1127,362,9662,211
51187,24,276,644,258,7618,18
14836,12,361,1321,261,14189,100
57179,6730,132735,461,96341,586660,36394
37853,58,1103,873,860,9850,243
1010,2704,93922,1461,57283,244430,36639
50132,1973,28942,671,21744,119820,7198
938,68,3861,1462,2816,26567,1045
17110,7,180,1286,127,5565,53
8680,15,582,1381,407,11816,175
27991,60,980,1079,792,39860,188
61223,259,3004,325,2428,16883,576
7587,6494,248298,1389,165898,658454,82400
50526,46,591,661,474,11308,117
25528,125,2253,1134,1594,21836,659
17151,131,4130,1285,2679,43616,1451
27374,108,2372,1093,1587,26285,785
14777,4,146,1322,106,20399,40
65111,2,25,211,16,5002,9
20187,61,2085,1231,1477,30617,608
41556,33,846,810,605,19028,241
35668,48,703,931,620,11887,83
64544,28,341,228,258,4985,83
57947,9,88,440,66,5209,22
36301,354,3710,914,2804,31924,906
23599,31,388,1175,274,5265,114
61900,9,82,304,72,5452,10
63107,84,2029,270,1376,19870,653
17374,12,416,1281,329,21130,87
12263,1,391,1356,181,14830,210
45946,12,140,753,111,3006,29
10837,43,1800,1369,1203,23230,597
51013,3,99,649,74,3208,25
17910,16,1049,1270,849,9734,200
1151,74,5493,1460,3544,49670,1949
26426,54,1521,1114,1131,29369,390
42885,0,12,788,8,7657,4
51627,62,909,631,741,14324,168
24151,111,1631,1163,1241,13672,390
2529,16,482,1450,320,45926,162
52445,2303,28446,606,22667,224289,5779
14220,26,465,1329,376,13767,89
20235,88,1922,1230,1491,25791,431
30657,54,522,1027,354,9363,168
60180,5,120,357,80,5907,40
50097,3045,46142,672,36514,298628,9628
38582,14,177,853,120,13225,57
15623,13,501,1310,348,12950,153
24389,134,4177,1158,2634,29289,1543
4296,75,2615,1432,1820,34442,795
7495,1403,79627,1391,44580,272998,35047
33887,10,401,972,286,10775,115
62354,56,573,290,440,6199,133
32543,108,2222,982,1522,29791,700
37865,10064,237832,873,172598,724693,65234
52,146,10314,1471,6704,69108,3610
51687,1,14,630,14,1689,0
2454,150,4551,1450,3105,42025,1446
30156,22,694,1037,468,15386,226
13622,6,311,1338,175,11404,136
64611,1840,20909,226,16920,85821,3989
46050,72,1136,751,793,16100,343
33795,168,2940,974,1985,45066,955
7727,30,1660,1387,1083,18744,577
35524,365,15693,934,10560,58651,5133
22939,11,573,1185,448,14787,125
15422,1243,24260,1313,15422,193553,8838
55679,15,171,503,137,7835,34
38404,68,1067,859,854,34305,213
14125,1110,40243,1330,26386,90694,13857
51850,45,1033,625,767,14757,266
17621,12,485,1276,403,11031,82
29864,18,1045,1043,778,23907,267
12511,12,198,1353,111,6212,87
12451,3226,114332,1354,71320,215670,43012
3238,32,800,1443,477,8577,323
30730,0,86,1026,66,16698,20
5792,19,523,1412,365,27933,158
56131,179,1634,491,1312,12291,322
68659,5,71,103,56,3498,15
32876,196,3441,991,2428,28421,1013
55906,3,46,498,35,2870,11
2142,54,3265,1453,2258,30585,1007
8565,4556,171951,1382,111476,304983,60475
7186,91,4548,1394,3034,65373,1514
4874,217,7024,1424,4866,57232,2158
18503,17,1121,1260,735,14054,386
48668,31,567,712,416,13796,151
56014,30,243,494,189,9106,54
15707,445,14186,1309,9824,53321,4362
48035,134,1913,727,1533,14480,380
53156,15,200,582,164,7797,36
21985,124,2937,1201,1698,37999,1239
48554,4936,88609,715,58561,723718,30048
24920,164,3075,1146,2226,25900,849
27235,48,1677,1096,964,35836,713
13892,85,4227,1334,2509,22152,1718
36277,3416,96171,914,79165,417878,17006
3740,737,18302,1438,12274,103467,6028
55459,29,340,510,274,7697,66
59586,8,153,386,141,2636,12
24668,337,10157,1151,7541,53814,2616
67526,17,71,141,65,1803,6
30125,54,2933,1037,1680,19928,1253
18000,136,4879,1269,3115,36984,1764
31580,8,199,1012,150,16932,49
34676,72,1585,955,918,8608,667
21326,51,2525,1211,1647,18675,878
18368,23,1085,1263,711,18505,374
12697,656,17680,1351,10033,100541,7647
2376,16,1752,1451,1151,58830,601
28204,33,598,1075,373,19930,225
6366,174,4185,1406,2918,120920,1267
31942,99,1837,1007,1200,23318,637
32775,256,7522,993,5233,56157,2289
27840,303,6579,1082,4628,35660,1951
54242,1,18,497,12,2191,6
46389,58,819,748,641,9233,178
31713,11,617,1010,366,12880,251
6000,65,4780,1410,3267,66466,1513
41792,13,190,806,151,10008,39
9695,40,2762,1376,1725,18501,1037
16138,614,17582,1302,11534,154112,6048
68989,30,619,91,490,5292,129
38047,6,160,868,122,6157,38
32073,471,9914,1005,7202,49735,2712
39757,4,114,838,84,9023,30
4123,32,3602,1434,2608,29099,994
38355,2,101,861,83,3436,18
2599,133,4204,1449,2570,29692,1634
53946,30,400,560,298,10812,102
50291,4,64,667,52,3085,12
40912,346,4192,820,3259,25739,933
50125,287,4526,671,3339,61014,1187
21742,39,1471,1204,851,13825,620
54227,136,2070,550,1616,19939,454
7667,11,600,1388,441,41472,159
14269,25,1236,1328,818,33222,418
23472,6,92,1177,60,3917,32
67171,11,167,152,136,4961,31
24019,7312,169544,1166,103931,604415,65613
31628,11,273,1011,179,3850,94
6633,217,7043,1402,4612,36716,2431
24769,268,5913,1149,4481,60494,1432
31940,20,441,1007,304,12579,137
34606,1,71,957,46,3676,25
8102,60,1772,1383,1165,13201,607
34410,125,2314,961,1732,13042,582
63177,667,9644,267,8088,53348,1556
60518,252,4261,352,3460,43979,801
16820,81,3372,1291,2349,45897,1023
2973,6246,181071,1445,99137,513900,81934
54085,2056,31647,555,26453,106289,5194
16831,364,6711,1291,4508,45948,2203
55689,57,519,503,430,18429,89
51131,1169,64508,645,48156,161612,16352
7743,151,5303,1387,3496,45280,1807
51624,317,9175,631,7267,64453,1908
17746,11494,758884,1274,415294,1886518,343590
16086,8,373,1302,235,14458,138
28904,131,3417,1062,2363,19079,1054
16746,792,14061,1292,8278,74455,5783
63607,118,995,257,783,8368,212
61924,16,104,304,81,2489,23
5877,1077,23510,1412,15654,110382,7856
19566,7,805,1242,570,9243,235
30434,9,221,1031,145,6702,76
32693,11,345,995,234,25094,111
20384,91,2591,1228,1827,24937,764
4154,77,1497,1433,1034,16224,463
48738,11,266,710,217,8345,49
57,38,1116,1471,822,46025,294
6220,188,5813,1407,3994,48372,1819
5229,118,2509,1419,1838,24168,671
63353,2803,33873,263,26302,129922,7571
64573,9,36,227,32,1655,4
52030,37,420,620,370,11174,50
54375,75,908,545,719,8739,189
51183,3,31,644,27,2394,4
38208,287,3540,864,2814,27499,726
52654,1,33,598,16,3982,17
18032,13,441,1268,341,17768,100
58626,567,8588,417,6675,94022,1913
18862,0,0,1254,0,6493,0
35141,395,7403,943,5897,56780,1506
2520,59,1899,1450,1224,12354,675
4416,15,399,1430,257,6698,142
15278,10,303,1315,241,18311,62
67699,92,1251,135,1002,11714,249
11280,41,1761,1365,986,55705,775
47255,47,515,736,415,10052,100
9216,11,340,1379,220,7131,120
24846,779,23211,1147,13540,93940,9671
10033,207,4340,1374,2936,28940,1404
22621,502,23481,1191,15947,269850,7534
65375,27,92,205,74,4001,18
57897,6,67,441,51,4196,16
27106,2,134,1098,82,4243,52
23983,369,9298,1167,6603,129527,2695
13001,0,0,1346,0,10996,0
12822,64,2748,1349,1552,45719,1196
13112,26,735,1345,383,53936,352
805,11,345,1463,213,9751,132
63889,38,376,248,281,5106,95
59996,387,4915,371,3965,36271,950
59763,192,2565,379,2266,28082,299
58677,89,1222,415,1016,11445,206
9356,637,21053,1378,13417,71308,7636
860,6,177,1462,116,10355,61
1014,120,4612,1461,3260,68152,1352
10676,19,570,1370,358,10469,212
37047,7,122,892,97,3364,25
54440,43,542,542,406,10915,136
19716,131,2622,1239,2037,19802,585
50214,3212,83307,669,65010,626823,18297
53207,4,56,580,42,3994,14
35098,15,425,945,282,13437,143
51610,217,2279,632,1870,37539,409
62309,14,82,291,76,2734,6
18275,34,1128,1265,798,10252,330
30952,179,4045,1022,3493,67786,552
67597,28,291,138,253,8790,38
22462,50,952,1194,662,9180,290
61050,83,1173,332,853,12730,320
63713,143,1351,254,1079,18930,272
8582,0,0,1382,0,7696,0
3166,13,362,1444,253,6155,109
1983,2,171,1454,96,12313,75
14762,29,2381,1322,1617,22695,764
36337,168,1924,913,1330,11382,594
64661,10,198,225,168,4370,30
39786,46,910,838,704,7597,206
25493,1621,47750,1134,30801,211318,16949
34940,265,6662,946,4810,39819,1852
55811,478,5404,500,4414,36685,990
11471,159,2795,1364,1849,14480,946
22165,604,12243,1198,8127,72123,4116
33982,149,2572,970,1839,37053,733
50596,0,1,659,1,1543,0
31295,19,764,1016,584,20327,180
3604,18,553,1440,421,9440,132
31711,161,4422,1010,2687,14688,1735
12720,1722,69365,1350,42541,286975,26824
67214,3,36,150,28,998,8
26968,81,3515,1101,2202,22022,1313
30807,86,1751,1024,1191,23243,560
7752,315,15052,1387,9429,85297,5623
18343,16,731,1264,592,29278,139
5121,0,224,1420,154,8517,70
12356,89,1973,1355,1066,16432,907
21046,85,1100,1216,711,8522,389
1153,10,239,1460,184,14645,55
63692,12,164,254,128,5813,36
4004,125,4013,1435,2707,61347,1306
37210,0,25,888,19,2505,6
35969,79,1589,924,1314,33384,275
2591,421,12187,1449,8428,117288,3759
40138,5,70,832,55,8703,15
5191,11,569,1419,446,12821,123
48918,935,9323,688,7864,126117,1459
58212,1088,17072,431,12334,64277,4738
53739,59,784,567,632,13068,152
21145,327,3903,1214,2309,18672,1594
21426,3,271,1209,205,7398,66
28491,2341,44844,1070,28135,233967,16709
15391,132,3256,1314,2102,39873,1154
59881,9,70,375,63,4134,7
12673,851,43457,1351,25551,245984,17906
19495,67,3723,1243,2688,44543,1035
56742,21,433,473,271,10322,162
50469,768,9045,662,6883,58949,2162
30819,965,20877,1024,13707,57993,7170
24392,110,5561,1158,3517,72964,2044
20644,6,244,1223,159,8376,85
54718,6,50,532,49,2721,1
30067,4,112,1039,93,4257,19
55256,12,130,513,102,9781,28
16140,412,5078,1301,3275,18969,1803
31420,0,47,1015,35,3631,12
20130,337,7022,1232,4439,98270,2583
68604,2,34,105,26,1180,8
33022,60,1703,988,1040,11539,663
16972,104,8992,1288,7453,123813,1539
54174,168,2238,552,1745,22460,493
31065,39,1743,1019,1165,13134,578
60381,284,2238,358,1836,12999,402
32760,24,322,993,298,6356,24
60627,72,1360,348,1074,32040,286
41788,5,126,806,90,2826,36
59301,26,279,395,192,6404,87
35754,14,576,929,419,11048,157
15310,365,9214,1315,6244,72009,2970
62480,6,239,286,181,10416,58
62733,174,2061,279,1805,23739,256
36432,11,343,910,274,10598,69
61988,21,239,301,175,7267,64
29062,69,1514,1059,969,9522,545
42168,5,48,800,43,2685,5
66044,23,299,188,235,8111,64
57711,23,274,448,187,9518,87
11566,140,8868,1363,5132,62984,3736
16681,844,25383,1293,15926,288077,9457
54098,11,104,554,90,8130,14
16244,385,9403,1300,6232,60176,3171
38018,14,262,869,225,5224,37
15111,7,255,1317,163,16286,92
29294,14,231,1054,181,9517,50
28342,14,510,1072,321,25129,189
66408,1155,31838,177,25736,148522,6102
21367,661,13982,1210,9231,65269,4751
53566,84,743,572,598,21778,145
855,76,3918,1462,2606,34567,1312
15682,1,66,1309,41,7285,25
33057,1005,17603,988,12484,106622,5119
60013,38,569,371,409,6334,160
23595,1012,29798,1175,21562,152167,8236
15133,12,670,1317,478,18157,192
45235,2512,53718,761,40219,311762,13499
31306,18,817,1016,415,10685,402
54206,101,1361,548,1182,34348,179
41126,11,121,816,91,10782,30
21771,61,1745,1204,1289,39996,456
24049,0,46,1165,36,7593,10
5894,3,293,1412,186,9907,107
46515,424,6224,746,5041,42057,1183
50572,10,156,660,124,4252,32
65495,36,488,202,366,8489,122
55438,842,15366,510,11551,149504,3815
52979,471,6798,587,5105,48408,1693
54935,72,1560,524,1120,13722,440
18633,22,650,1258,497,9665,153
5048,135,8028,1421,5342,58882,2686
21053,86,2001,1216,1263,37621,738
60507,13,189,353,145,2313,44
11704,320,4636,1362,3004,23024,1632
18611,31,1882,1259,1401,20326,481
6966,5,251,1398,167,13176,84
6004,51,994,1410,665,12228,329
58981,56,647,406,476,13076,171
58181,84,903,432,687,28418,216
49516,248,4404,687,3438,19463,966
22,80,2885,1472,2310,33507,575
48481,3,102,719,81,3971,21
35051,1106,24053,946,18505,113510,5548
33219,5805,116851,985,84567,503154,32284
22408,28,707,1195,481,15083,226
58769,114,1442,412,1227,14362,215
7446,140,5876,1391,3393,20626,2483
33576,692,16983,978,12470,76983,4513
39343,6,123,843,92,16943,31
55568,2755,38413,507,30598,201221,7815
64895,61,646,217,518,6010,128
21864,163,4757,1202,2934,42853,1823
4657,8,259,1427,201,10347,58
15556,8,783,1311,566,67029,217
26044,3153,69804,1122,46841,143192,22963
60476,10,120,354,91,6040,29
6483,108,2367,1404,1693,62232,674
65663,1253,15572,198,12531,66046,3041
5137,355,16468,1420,9547,117083,6921
32113,84,1159,1004,873,23989,286
24241,9,535,1161,370,8686,165
56478,12,248,481,189,8887,59
12531,5,209,1353,107,9181,102
43485,28,310,780,253,7398,57
16431,953,19238,1297,11647,90154,7591
8579,576,12659,1382,8093,130795,4566
4622,24,1431,1427,1048,20788,383
21838,2,88,1203,60,5090,28
61221,8,106,326,83,4471,23
63551,891,12165,259,8856,31579,3309
51080,71,877,647,686,12877,191
54908,1864,36999,525,29046,226946,7953
65044,2256,33720,212,26754,193878,6966
56525,13,129,479,102,11816,27
13744,493,10993,1336,6729,72756,4264
40995,7,274,818,184,5354,90
61595,36,359,315,296,6334,63
24329,36,1100,1159,785,13265,315
19693,3,70,1239,51,5323,19
4728,42,1017,1425,693,23478,324
62218,81,1732,294,1432,20650,300
17823,2658,67137,1272,47269,373422,19868
59936,420,8659,373,6698,76756,1961
49948,15,235,676,178,4102,57
6318,68,2365,1406,1557,18832,808
48475,17,360,719,314,6223,46
19387,30,717,1245,543,20718,174
37665,3493,62019,878,48956,397404,13063
31890,160,3866,1007,2612,23245,1254
21548,19,219,1207,179,5827,40
28484,93,2435,1070,1468,28178,967
20281,74,1872,1229,1333,21858,539
10367,378,14188,1372,8671,65852,5517
55450,52,625,510,492,8902,133
37839,47,631,874,468,12453,163
55,233,8436,1471,4846,64376,3590
3087,2288,46428,1444,28914,193197,17514
24678,112,1299,1151,867,18904,432
4188,142,7412,1433,4493,37499,2919
32079,33,802,1005,552,29332,250
45073,13,274,762,226,9614,48
3706,109,3255,1438,2232,31417,1023
35546,5,147,933,102,4232,45
22670,26,533,1190,447,15077,86
25639,9,237,1131,165,6301,72
30269,60,1749,1035,1068,19006,681
25858,9,268,1126,184,14607,84
18818,4907,121745,1255,78910,325570,42835
17314,14,895,1282,669,33673,226
19833,500,12349,1237,8017,75139,4332
42424,49,454,796,338,4324,116
65887,9,471,192,325,13702,146
8530,1426,72730,1382,38328,198610,34402
11701,121,3329,1362,1935,27312,1394
56980,18909,314271,466,248005,868762,66266
34808,45,998,951,768,12995,230
46025,64,788,752,639,9449,149
36736,9,359,904,282,22284,77
61944,45,546,303,436,16211,110
19389,6713,129268,1245,71853,262408,57415
2797,476,8501,1447,5870,57678,2631
35816,1,32,928,27,2634,5
1216,33,1802,1460,1142,18507,660
53619,6,55,570,45,2241,10
65347,205,2853,205,2196,28304,657
5830,346,17380,1412,10106,82943,7274
52301,46,789,610,651,12783,138
37272,7,199,889,146,12050,53
16548,3,60,1295,40,10276,20
17778,107,5133,1273,3668,72456,1465
24349,0,0,1159,0,18914,0
7646,54,1275,1389,902,27396,373
24258,68,2530,1161,1713,28525,817
11540,127,1588,1363,916,10598,672
22534,101,3147,1193,2074,32412,1073
61907,18,309,304,199,6318,110
26841,224,4125,1104,2965,42987,1160
52679,26,333,597,199,10261,134
58542,8,104,420,44,3203,60
31885,185,3859,1007,2503,17592,1356
1707,20,1314,1456,871,50402,443
13824,40,1317,1335,726,31657,591
22965,129,3223,1185,2148,38273,1075
24401,30,580,1158,378,14307,202
34035,321,4974,969,3540,24025,1434
62522,42,638,285,504,10781,134
28464,48,2087,1070,1191,29172,896
44338,393,4926,770,3928,61917,998
4603,77,1210,1427,879,10897,331
52836,31,181,592,151,20138,30
21995,71,2413,1201,1521,24977,892
50364,17,154,665,109,2811,45
18114,833,19914,1267,12769,189054,7145
67433,31,320,144,266,4531,54
54687,18,239,533,201,5847,38
65414,60,839,204,572,10249,267
59937,435,23096,373,17547,52261,5549
4172,23,1520,1433,1178,31814,342
4261,21,1204,1432,743,16387,461
24583,28,933,1153,618,12562,315
58597,25,390,418,251,10801,139
60941,157,2528,336,2039,40399,489
33085,71,1016,987,700,7807,316
26371,0,128,1115,84,5128,44
15348,136,3840,1314,2518,18369,1322
29047,182,5554,1059,3615,68358,1939
24245,24,1040,1161,721,9076,319
23508,33,671,1176,491,18404,180
57996,2,29,438,24,3870,5
65622,18,345,199,281,7267,64
63978,23,209,245,162,9472,47
11157,403,14222,1366,8478,52162,5744
60841,170,7054,340,5216,45147,1838
65490,63,891,202,768,7386,123
35110,11,144,944,104,4986,40
5084,2096,64088,1421,46494,169125,17594
51523,251,3827,635,3074,59650,753
7093,6124,204000,1396,127508,718072,76492
11908,218,19404,1360,9386,142683,10018
40878,48,1264,821,1099,39894,165
6906,174,2433,1399,1701,18242,732
35202,19,321,942,229,4047,92
10228,77,1999,1373,1358,28166,641
4688,539,15258,1426,11522,100979,3736
53089,77,1568,584,1073,15758,495
68439,89,1794,110,1365,30985,429
19747,53,1292,1239,860,9692,432
65268,16,114,207,93,4421,21
21150,51,1700,1213,1327,12213,373
23296,24,1013,1180,668,10731,345
62963,24,188,273,156,6237,32
33179,548,18149,985,13087,151436,5062
36834,109,1333,902,1033,15791,300
8434,791,19030,1382,11969,67807,7061
13926,15,690,1333,431,11796,259
57266,7,68,459,48,3631,20
50522,20,189,661,165,4629,24
56871,16,731,469,610,4959,121
64559,1577,19813,228,15761,104598,4052
65487,10,576,202,464,9783,112
21976,117,2373,1201,1590,20146,783
21850,198,4094,1203,2598,48096,1496
50430,136,1553,663,1149,16955,404
12609,12,857,1352,443,9232,414
11559,0,122,1363,41,3972,81
34241,91,2421,965,1657,25425,764
61738,301,5976,310,4212,50736,1764
47395,35,522,734,417,13391,105
4815,14,696,1424,548,13757,148
28967,3,183,1060,112,5453,71
32024,58,974,1004,724,32944,250
21307,355,9961,1211,6779,64611,3182
7367,47,2693,1392,1790,28964,903
51995,5,75,621,66,3636,9
29182,105,4115,1056,2959,41791,1156
5133,110,4293,1420,2792,40337,1501
18893,172,3487,1254,2303,15061,1184
27084,114,1830,1099,1042,7826,788
31634,15,348,1011,218,12056,130
9481,2,119,1378,78,11980,41
62152,33,276,295,222,9646,54
20451,61,667,1226,451,10786,216
49009,45,322,702,244,4191,78
20515,2,171,1225,129,7635,42
12027,152,3303,1358,1819,26850,1484
3139,10,610,1444,383,18493,227
35278,1414,15519,940,10417,80473,5102
19694,89,2727,1239,1612,23103,1115
48618,1401,17869,714,14211,126621,3658
32917,1365,26619,990,20311,173194,6308
12366,82,2459,1355,1344,35019,1115
65694,11,123,195,101,2841,22
58037,107,1371,437,1130,17906,241
14705,227,4866,1323,3150,21392,1716
58903,33,319,408,241,5817,78
32093,25,557,1004,387,26162,170
55824,72,1049,500,696,139277,353
53862,57,524,562,441,8608,83
19046,0,0,1251,0,8663,0
14129,85,1811,1330,1470,11649,341
20792,5962,112247,1221,75438,417784,36809
20129,5,263,1232,208,13953,55
68556,30,423,107,373,11950,50
63902,2245,29687,248,22964,128524,6723
16685,41,817,1293,545,14318,272
19709,82,2145,1239,1652,33004,493
67428,136,2054,144,1779,13724,275
11025,1290,15160,1367,9965,46323,5195
27411,133,1368,1092,807,15025,561
13746,68,4346,1336,2579,65053,1767
22845,8,422,1187,284,6995,138
28531,431,7472,1069,5427,47358,2045
7857,64,3259,1386,1874,14018,1385
41531,44,934,811,749,12298,185
8035,342,10201,1384,6588,63133,3613
64867,33,974,218,358,11614,616
55894,18,263,498,217,18524,46
35303,32024,759352,939,476756,2008519,282596
56703,6,212,474,181,8218,31
19632,234,5411,1241,4205,64894,1206
43345,411,9161,782,7553,82350,1608
57345,73,697,457,620,15473,77
30385,399,6429,1032,4321,60808,2108
39774,14,223,838,185,5551,38
29587,191,4448,1049,2819,21203,1629
23794,15,614,1171,417,13793,197
21829,83,1668,1203,1160,30028,508
24814,6106,161125,1148,101545,913412,59580
21379,9,859,1210,730,40977,129
35567,46,222,797,170,22293,52
51271,8,204,642,174,6612,30
6016,27,798,1410,559,13921,239
17211,16,760,1284,582,17648,178
12521,4,508,1353,229,7407,279
17111,15,376,1286,242,13077,134
1439,536,23824,1458,16445,71241,7379
32018,20,531,1005,301,6958,230
61418,33,645,320,527,12577,118
6317,75,3468,1406,2232,34528,1236
20244,404,17642,1230,9905,68952,7737
19186,85,1876,1249,1417,55239,459
65091,47,734,211,556,5602,178
12593,45,888,1352,505,10416,383
25057,38,871,1143,613,22207,258
8368,18,639,1382,420,8812,219
37231,37,605,890,448,13145,157
32134,100,2302,1004,1387,15055,915
20456,95,1680,1226,1247,18174,433
51724,34,360,629,304,10559,56
57475,4,105,455,84,3028,21
44596,9360,151157,768,97622,524289,53535
16331,7,129,1299,81,7969,48
67627,26,303,137,244,3293,59
38851,48,1454,849,1187,24683,267
19710,187,4886,1239,3167,48328,1719
6744,1,160,1400,126,32851,34
30077,9,193,1039,126,19681,67
15399,91,1854,1313,1376,22712,478
34516,29,613,959,418,14070,195
3347,245,5104,1442,3505,55944,1599
56991,5,64,465,45,3691,19
16780,29,1230,1291,846,24755,384
32476,70,1834,998,1248,20255,586
21033,83,2496,1216,1884,43038,612
49925,5,155,676,134,8606,21
27679,1819,45476,1085,28771,227362,16705
36109,142,2457,920,2045,34264,412
20112,39,1351,1232,1000,76187,351
20418,606,14470,1227,8569,142645,5901
49087,160,2345,699,1944,19856,401
8359,83,3009,1382,1774,33150,1235
13616,35,1637,1338,990,24211,647
26200,27,1608,1119,948,6694,660
16369,2,40,1298,26,3277,14
16407,28,1453,1297,982,51912,471
38971,75,993,848,731,7857,262
36699,35,619,905,501,9108,118
7770,63,1507,1387,1013,9481,494
51649,453,6290,630,5194,34375,1096
55242,13,148,516,108,7595,40
68944,71,1078,93,919,10144,159
64070,18,153,242,102,5901,51
50748,3,94,656,77,2035,17
40731,378,8221,821,6437,51642,1784
11444,920,40244,1364,23276,164830,16968
20827,67,3123,1220,2175,49025,948
3194,1,84,1443,60,6096,24
55875,55,760,499,596,10452,164
15735,102,2831,1308,2089,36617,742
63804,1,27,252,21,3599,6
13507,12,805,1339,440,18607,365
48563,508,11006,715,9383,143011,1623
61770,31,376,309,307,4634,69
58688,43,487,415,340,8234,147
11618,635,6328,1362,3358,58013,2970
57163,657,15313,462,12661,59206,2652
4321,47,1427,1431,953,19577,474
56550,63,593,478,476,6021,117
18822,28,1215,1255,889,16220,326
53428,86,506,575,424,6611,82
15901,3,164,1305,119,13164,45
39995,38,864,835,680,6113,184
20395,21,880,1227,682,22762,198
26742,151,4132,1106,2468,28674,1664
67801,8,91,132,65,1975,26
17537,16,570,1278,379,21430,191
5859,167,3551,1412,2786,26580,765
7828,24,998,1386,692,37814,306
22654,540,8206,1191,5564,26991,2642
20976,13,168,1217,112,5481,56
54408,6,49,475,42,5861,7
55359,39,513,512,409,4859,104
8795,17,790,1381,520,8640,270
32873,106,1888,991,1343,22598,545
30010,296,6708,1040,4542,38130,2166
25572,46,644,1133,509,9274,135
10596,43,877,1371,543,12145,334
34949,4,90,948,55,5685,35
18338,593,29433,1264,19810,152454,9623
19066,219,3732,1251,2585,28477,1147
6164,218,11381,1408,8169,69200,3212
13891,80,2738,1334,1672,44767,1066
37953,46,459,871,401,6090,58
52843,13,166,591,125,6505,41
51470,8,146,636,118,10390,28
26970,0,54,1101,45,6842,9
10951,19,634,1368,426,14386,208
53564,230,1974,572,1584,48217,390
24091,24,1088,1164,765,13605,323
13286,3480,175941,1343,109672,433002,66269
21779,44,1763,1203,976,19747,787
15776,2630,102452,1308,63020,481992,39432
14267,1081,26241,1328,17119,84223,9122
44389,43,833,770,662,9160,171
13202,8559,207748,1344,131128,417817,76620
8234,1097,60674,1383,39622,234475,21052
13871,45,2648,1334,1831,36442,817
22849,723,22348,1187,16091,112987,6257
25363,2,37,1136,28,2682,9
55694,15,224,503,176,7218,48
62617,36,382,282,305,5605,77
53872,7492,124581,562,92468,396885,32113
61811,79,2493,300,1841,26131,652
62350,191,1818,290,1510,21641,308
53014,260,3249,586,2362,20521,887
5634,39,1017,1414,790,24972,227
16354,76,2282,1298,1555,22113,727
67551,4,74,140,60,2640,14
22069,105,1814,1200,1105,11555,709
52835,871,9038,592,7360,157497,1678
51084,23,543,646,383,19017,160
66375,7,143,178,123,5835,20
56731,1080,19300,473,15865,92994,3435
6967,23,921,1398,645,26062,276
12039,36,1004,1358,599,18019,405
52214,51,859,614,700,13579,159
5700,9,251,1414,176,10983,75
35308,61,915,939,663,11839,252
36068,311,4097,921,3233,25569,864
32151,433,6709,1003,4371,52005,2338
61807,1018,16366,307,13252,87377,3114
26982,4,104,1101,78,4163,26
17860,24,1081,1272,810,13376,271
15022,27,747,1319,583,11095,164
16679,190,6307,1293,4302,67257,2005
47150,2,30,738,21,3612,9
18517,8,147,1260,111,9014,36
39193,44,1293,845,1007,19790,286
67917,36,268,128,186,4440,82
30402,1,75,1032,34,5211,41
2526,6,238,1450,151,6701,87
34458,15,504,960,397,11570,107
66098,62,858,186,717,8196,141
10127,64,2118,1374,1248,17478,870
64790,245,4297,221,3852,18014,445
53850,2,41,563,28,2318,13
11698,42,1975,1362,1100,12729,875
69047,370,9652,90,8183,43511,1469
63561,46,426,259,339,6242,87
21277,994,44245,1211,31039,194910,13206
17181,126,2291,1284,1553,15623,738
6683,125,2184,1401,1371,17700,813
63563,19,316,258,225,7585,91
17885,7,111,1271,88,12061,23
61323,20,261,323,231,9835,30
66085,39,620,187,447,4209,173
51764,65,594,628,473,6388,121
30912,0,52,1022,33,3923,19
27709,204,13309,1085,7971,46449,5338
4197,104,5900,1433,3834,36373,2066
23239,50,1018,1181,737,23146,281
22527,1,86,1193,59,5315,27
55143,21,382,518,283,6464,99
46787,127,708,742,564,8463,144
65768,0,0,195,0,5072,0
32392,11,591,1000,343,5238,248
39955,298,3901,835,3045,35353,856
29277,25,645,1054,364,7227,281
22315,49,1452,1196,1023,12502,429
14102,11,527,1330,380,14697,147
14277,15,840,1328,666,23807,174
56126,1911,20640,491,15994,88771,4646
54160,63,669,553,471,8479,198
68651,19,269,103,186,3614,83
18536,8,400,1260,247,6927,153
23212,7,198,1181,139,7652,59
37283,33,1019,888,828,27961,191
67382,11,136,145,119,4521,17
10600,18,962,1371,614,24056,348
57520,5,62,454,52,7463,10
56695,8,152,475,122,3524,30
30995,4,61,1021,39,2248,22
12973,15,1149,1347,588,17161,561
61334,29,525,322,450,5784,75
11354,0,0,1365,0,6981,0
68916,46,351,94,300,3376,51
48904,7,119,705,86,3841,33
21799,34,1387,1203,969,11559,418
13632,2347,33913,1337,23287,185808,10626
28461,242,5422,1070,3778,71047,1644
29001,92,2586,1060,1731,19386,855
18344,24,1040,1263,625,8349,415
4952,116,7636,1422,4803,52720,2833
32181,247,5486,1003,3857,34736,1629
10825,157,6214,1369,3659,44051,2555
33961,95,2539,971,1726,22761,813
19410,30,1983,1244,1456,20058,527
50230,12,147,669,118,5774,29
66212,17,210,182,185,14122,25
55417,27,217,511,158,3749,59
49890,2310,79529,677,64230,435497,15299
21948,4,59,1201,55,9176,4
56049,1255,18485,493,15629,119872,2856
39323,39,927,843,714,44733,213
53275,41,288,579,234,4030,54
49192,78,1207,696,990,11333,217
21447,7,390,1208,251,12856,139
28887,5664,208569,1062,135684,888559,72885
48541,88,1535,716,1202,29174,333
55230,508,6359,516,5321,42852,1038
20075,15,438,1233,322,11182,116
31400,1,66,1015,34,3447,32
34273,162,2527,964,1958,43134,569
16602,52,2626,1295,1877,45250,749
46216,24,573,750,410,12231,163
14028,67,1699,1332,1007,15372,692
62433,77,1113,287,876,10641,237
10249,96,2073,1373,1367,28951,706
39269,8,95,844,84,5373,11
12070,5644,239296,1358,131350,1035655,107946
61077,77,3141,331,2513,20168,628
21047,38,1377,1216,1130,24476,247
58690,43,331,415,253,6874,78
58566,271,5431,419,3807,53559,1624
49764,12,280,680,220,9363,60
13791,70,1232,1335,760,7670,472
60885,22,454,338,356,12846,98
31039,5525,113747,1020,79361,216078,34386
23027,237,6090,1184,4086,141856,2004
18074,15,993,1268,759,24966,234
58389,722,18931,425,14600,94067,4331
13432,34,1296,1340,779,40785,517
5705,1533,35674,1414,21514,102689,14160
16101,459,14233,1302,9583,79911,4650
31187,95,2305,1018,1346,18167,959
48008,40,809,727,497,27302,312
11976,256,8237,1359,5151,51725,3086
23989,38,1946,1167,1583,15132,363
32189,82,894,1003,597,7846,297
20166,0,0,1231,0,8311,0
65641,47,485,199,394,24776,91
17271,9,275,1283,178,5345,97
52410,8,109,607,85,4448,24
32121,8,177,1004,118,9177,59
50618,10,200,659,140,5318,60
54086,8,104,554,59,4027,45
52742,493,6432,595,5289,51067,1143
53891,135,1028,561,842,17157,186
12294,0,0,1356,0,7639,0
18077,691,27412,1268,16584,142699,10828
62176,412,6250,295,5028,61080,1222
16621,203,4275,1294,3245,32055,1030
33535,6,178,979,131,4017,47
27525,2894,67625,1089,43848,254768,23777
11513,61,2984,1363,1773,26069,1211
39319,37,682,843,524,9858,158
34627,59,887,956,611,15317,276
4672,43,2568,1426,1699,31615,869
34242,3,30,965,23,2202,7
66361,22,333,179,228,2314,105
624,159,2343,1464,1618,10710,725
18637,2,70,1258,60,5457,10
43069,30,561,785,481,27868,80
66718,64,1341,167,1195,21514,146
32282,3186,125282,1002,80002,603067,45280
39855,23,764,837,617,17849,147
66664,3,27,169,18,987,9
57257,14,123,460,102,7822,21
18700,24,1122,1257,880,7675,242
65030,94,732,212,617,11166,115
22167,23,372,1198,288,5399,84
23570,51,1626,1175,1257,24523,369
35985,31,641,923,526,12310,115
50030,13,162,674,127,9394,35
30281,14,314,1035,214,6815,100
2481,13,358,1450,238,4805,120
11721,88,4087,1362,2347,42375,1740
11267,5,205,1366,108,3315,97
4482,936,48702,1429,31470,309447,17232
26260,44,1568,1118,1041,17809,527
58813,778,14414,411,10892,81231,3522
58908,17,173,408,132,4839,41
1084,148,5071,1461,3716,55199,1355
50371,140,1548,665,1243,11704,305
22261,9,246,1197,181,7526,65
4514,1857,143966,1429,92946,675379,51020
56460,73,1485,481,1219,8537,266
278,14,488,1467,314,31326,174
32660,87,2425,995,1696,17399,729
33958,66,1273,971,935,9613,338
46575,564,6900,745,5344,34032,1556
19544,31,1582,1242,1097,37028,485
31562,5,628,1012,405,19364,223
40,2,293,1471,151,15786,142
49605,1391,21214,685,16140,133965,5074
19688,52,1230,1240,904,45136,326
24813,5,220,1148,148,8996,72
4991,1196,24946,1422,19381,178809,5565
4596,3,561,1427,357,12841,204
18606,9,466,1259,303,7774,163
50547,24,358,660,231,11005,127
51050,61,485,648,408,5694,77
23592,48,934,1175,668,17083,266
37950,2817,64079,871,48239,164762,15840
61123,291,3557,329,2816,34136,741
14507,145,4597,1325,2538,23992,2059
67977,25,557,126,427,8569,130
67316,25,324,147,251,4776,73
20001,308,13921,1234,10467,128786,3454
10933,33,1828,1368,997,13043,831
35904,39,733,926,554,13255,179
62391,11,244,288,169,14412,75
31462,58,1097,1010,705,28073,392
9974,165,3846,1375,2276,27082,1570
27968,9,165,1079,101,12534,64
19412,55,1466,1244,1003,29386,463
58482,240,2790,421,2075,41158,715
40277,54,552,830,422,6379,130
57985,3,49,439,40,5557,9
54982,452,4546,490,3566,35668,980
57873,9650,146663,442,109661,405940,37002
2243,49,1622,1452,1174,26331,448
19794,10,505,1238,391,14015,114
65625,1,3,199,3,781,0
37817,11,658,874,505,14620,153
49407,108,1034,690,888,29004,146
542,212,8175,1465,5973,50998,2202
48630,28,299,714,221,6749,78
28684,123,2675,1066,1795,54872,880
59532,4,53,387,43,3686,10
56415,4,107,483,79,11050,28
60139,4,31,366,29,4354,2
40425,2673,28920,828,20704,101989,8216
40013,92,1216,834,925,18609,291
5421,9,1007,1417,628,35436,379
30226,14,336,1036,256,10277,80
21002,28,666,1217,468,13856,198
40750,32,415,823,326,15416,89
19475,75,1688,1243,1176,33004,512
29698,47,3191,1047,1906,21158,1285
37405,278,5624,885,4559,53969,1065
21642,365,9366,1205,5962,43880,3404
37867,1110,34394,873,24467,240514,9927
16351,9196,321254,1298,196755,890392,124499
55241,5,64,516,44,3045,20
54995,26,509,523,256,7339,253
54331,21,228,547,187,6264,41
36525,129,1987,907,1518,26271,469
66372,206,2126,178,1765,16721,361
63910,19,256,248,212,5718,44
25589,25,641,1132,433,12377,208
53467,9,208,575,137,3511,71
4681,98,5333,1426,3570,59472,1763
67616,10,192,138,166,5909,26
30250,5089,89256,1035,60083,387262,29173
18257,189,15309,1265,10712,77600,4597
26656,14,528,1108,342,21622,186
41710,21,471,807,372,17319,99
14482,50,963,1325,691,39077,272
34086,98,2239,968,1756,44821,483
11383,10,473,1365,319,15820,154
18217,43,1725,1265,1379,23417,346
58876,317,3884,409,3051,32124,833
66848,27,305,162,239,5617,66
63473,9592,172704,260,117949,651947,54755
41852,1528,22959,804,20166,133022,2793
36117,895,11187,919,7811,77954,3376
35113,32,424,944,288,14240,136
4817,28865,713985,1424,444622,1568291,269363
51890,21,290,624,237,10409,53
18624,112,2736,1258,1861,44738,875
67343,37,455,146,369,9273,86
57391,304,3036,456,2547,17348,489
12458,163,12148,1354,6975,104397,5173
2042,524,21941,1454,13118,160247,8823
61555,135,1706,316,1436,26320,270
11293,131,3375,1365,2252,24109,1123
7528,21,1196,1390,804,59454,392
44195,11,232,772,193,5821,39
61439,41,491,319,405,15256,86
21231,49,1659,1212,1188,28037,471
3409,40,2598,1441,1783,23510,815
19651,152,4443,1240,3088,38488,1355
37146,696,9101,893,7173,78484,1928
862,538,27363,1462,18558,133043,8805
43329,426,7380,782,5873,87251,1507
30121,2460,35188,1038,25584,125189,9604
52070,434,5467,617,4595,34270,872
486,19,736,1466,515,19658,221
22682,76,2317,1190,1585,56879,732
37360,13,300,886,261,10006,39
30718,131,4498,1026,3029,39235,1469
24817,18,793,1148,608,22245,185
51031,115,1081,645,941,31770,140
55719,35,680,503,562,18396,118
581,148,7007,1465,4903,111657,2104
9945,7,123,1375,72,10087,51
50793,6,167,506,139,14957,28
56384,14,202,484,160,5969,42
66491,3,84,175,63,9020,21
49783,16,237,680,201,6163,36
22739,6,259,1189,189,13591,70
65957,28,364,190,305,9800,59
55004,14,338,522,249,6975,89
55010,6,41,522,33,2860,8
40371,12,289,829,230,6322,59
49467,50,985,688,721,21637,264
67704,790,11617,135,9183,81136,2434
31077,5,269,1019,185,6022,84
42366,2959,59259,759,48553,316862,10706
2594,409,13894,1449,8328,44795,5566
49804,141,2121,678,1747,32196,374
15406,39,1725,1313,1068,10595,657
31620,107,5288,1011,3588,19058,1700
24754,4,192,1149,143,6551,49
56121,69,1078,491,860,12190,218
3536,13,240,1440,169,14138,71
54417,7,79,543,66,5662,13
55513,62,595,508,472,13331,123
32433,715,16807,999,11063,192109,5744
7523,635,22951,1390,13204,152309,9747
7070,25,2396,1396,1533,20118,863
1546,8985,255832,1457,142265,541442,113567
14444,68,1097,1325,793,17234,304
13883,0,162,1334,77,7094,85
40061,43,590,833,525,13539,65
26465,139,2958,1113,2191,46530,767
2497,167,4796,1450,3173,46112,1623
31507,19,307,802,247,5477,60
65697,22,256,197,219,3846,37
26727,620,7012,1106,4717,51026,2295
55131,21,227,519,194,7905,33
33868,50,613,973,430,6456,183
60081,49,726,369,592,6808,134
6192,1210,25720,1408,17416,149336,8304
25255,255,9535,1139,6209,43125,3326
66051,15,207,188,158,6243,49
66026,1337,18225,188,14123,77486,4102
1570,30,503,1457,348,12360,155
37766,294,4899,875,3892,79336,1007
62438,305,8342,287,6620,45455,1722
60554,37,540,351,461,9891,79
36260,69,2178,916,1470,38591,708
23938,0,0,1168,0,12983,0
49388,49,469,690,343,5311,126
4332,75,844,1431,587,12806,257
23802,201,5585,1170,4043,52787,1542
55050,23,258,521,178,6804,80
64274,61,758,236,603,6828,155
37391,9,217,885,168,11349,49
4794,97,1641,1425,1147,20518,494
2121,2075,55976,1453,34632,167043,21344
37879,128,1819,872,1485,19622,334
18744,57,981,1256,658,13521,323
15288,8,844,1315,540,20973,304
36072,13,439,921,341,5196,98
16641,7,179,1294,141,9917,38
61032,340,2587,333,1985,13068,602
20373,14,753,1228,563,34416,190
15577,356,10411,1311,6069,38417,4342
34290,239,7097,963,4896,59083,2201
57683,62,727,449,553,7879,174
51412,26,522,638,446,11376,76
9908,49,1765,1375,1071,14930,694
64203,7,153,238,96,3793,57
51537,114,1236,634,989,18744,247
30913,620,15989,1022,8909,73352,7080
12690,665,22342,1351,13843,86120,8499
53306,36,534,578,385,4975,149
66445,6,150,176,97,4130,53
22774,777,18429,1188,11848,154170,6581
12491,2654,119325,1353,66139,556611,53186
58765,100,1771,413,1440,13936,331
24899,5,279,1146,207,7419,72
44019,82,1099,774,922,17396,177
10983,300,5852,1368,4184,40092,1668
33881,65,1223,971,810,6641,413
54680,144,1081,533,872,21423,209
68983,2,63,92,54,3396,9
28133,110,1922,1076,1287,36629,635
47440,15,220,733,186,9429,34
17483,385,6312,1279,4152,41294,2160
35570,15,249,933,184,5262,65
20232,76,2824,1230,1843,14056,981
35455,3,196,936,136,11362,60
20690,54,1299,1222,913,21534,386
37277,2072,38122,889,31060,136455,7062
68492,8,46,109,39,2407,7
65028,36,506,210,427,7827,79
13840,13,785,1335,484,9505,301
50448,116,3086,662,2548,35869,538
58548,331,5276,419,4301,39843,975
59594,139,3509,385,2845,21803,664
58735,17,255,413,197,7148,58
11739,120,9181,1361,3852,25697,5329
2370,225,7524,1451,5207,59129,2317
241,16,1147,1468,829,82993,318
100,4462,161546,1470,101018,443670,60528
68862,20,647,96,529,2778,118
62620,123,1271,282,1007,7460,264
10535,42,2290,1371,1473,39237,817
51376,110,1129,638,960,20760,169
7832,264,6649,1386,3979,31167,2670
23915,46,853,1169,624,17072,229
66850,2,15,162,13,1201,2
47400,200,2491,734,2066,40674,425
56383,69,1184,484,904,6908,280
46619,6,121,744,78,5896,43
49424,19,434,689,368,10899,66
62719,19,119,279,108,3638,11
30044,42,750,1039,482,6848,268
178,73,6882,1469,4559,19579,2323
60787,73,815,339,664,12292,151
48053,298,5671,727,4519,29256,1152
68457,16,120,110,98,2142,22
66014,7,141,189,55,1258,86
8751,37,997,1381,653,12073,344
35333,310,5645,938,3840,106367,1805
12265,3,263,1356,138,5565,125
11048,56,1600,1367,933,16594,667
26275,63,2054,1117,1178,25961,876
8054,73,1468,1384,930,13353,538
32148,258,4925,1004,3572,51257,1353
47769,26,353,729,299,22137,54
34986,37,845,947,650,14813,195
28457,206,5118,1070,3340,42023,1778
838,255,8337,1463,5749,41525,2588
13795,111,1523,1335,909,16056,614
42666,22,615,792,522,28503,93
17185,116,3407,1284,2456,16811,951
32708,96,1974,994,1317,11612,657
10727,5,411,1370,247,6054,164
68595,31,429,105,311,6469,118
59011,45,990,300,814,24475,176
6914,193,8383,1399,5796,37665,2587
29448,2005,60995,1051,42998,325463,17997
37514,680,14718,882,11038,32597,3680
37017,263,6984,896,5506,58562,1478
30999,22,430,1021,281,11695,149
32715,45,877,993,608,26499,269
13679,239,8093,1337,4401,53687,3692
17580,23,897,1277,689,35832,208
12396,705,34934,1354,20330,112309,14604
53581,2708,29518,572,23689,253597,5829
62392,25,242,288,198,6211,44
30335,15,309,1033,263,36065,46
63083,43,395,270,339,13748,56
53904,36,230,561,189,6210,41
18522,44,2168,1260,1516,17472,652
28467,20500,546532,1070,321939,1498324,224593
58509,102,1767,421,1341,16517,426
15190,15,459,1316,327,6840,132
27786,27,1169,1083,665,21159,504
5728,9,287,1413,195,13956,92
29119,27,282,1057,255,11587,27
28729,63,2570,1065,1564,20010,1006
9549,13,725,1377,397,11646,328
62853,24,417,276,351,4525,66
29229,0,0,1055,0,7849,0
22692,85,1046,1190,688,7903,358
50064,2326,28733,673,21358,118947,7375
67549,12,208,140,164,8355,44
42078,2,93,801,86,9875,7
10675,1100,44951,1370,23681,109276,21270
3542,1404,70362,1440,40442,305429,29920
30219,10,285,1036,146,6978,139
17002,189,4207,1288,2529,31513,1678
54639,147,2310,521,1841,19872,469
16554,42,3568,1295,2273,40818,1295
988,26,1522,1461,1129,12846,393
16377,25,1712,1298,1024,15557,688
16161,106,2263,1301,1547,27262,716
61997,93,748,301,503,6021,245
12991,0,0,1347,0,7829,0
60362,1285,20581,341,15870,94459,4711
36958,982,17670,898,14277,106056,3393
23109,10,380,1183,281,7014,99
2862,6,108,1447,63,10036,45
55008,61,1153,522,963,9265,190
63882,23,183,249,172,2802,11
65991,595,6872,189,5819,68991,1053
10395,0,0,1372,0,7903,0
44896,350,4851,764,3764,79102,1087
67898,20,185,129,131,8335,54
19836,78,1520,1237,906,36418,614
54421,52,559,543,397,13356,162
26201,248,5871,1119,3727,35890,2144
32313,27,809,1000,500,6333,309
9850,300,11858,1376,8042,93106,3816
56783,69,1033,472,808,13313,225
68816,15,140,98,119,4815,21
3001,88,5786,1445,3629,49082,2157
11426,7,247,1364,153,5832,94
23435,8676,197669,1177,133231,556716,64438
11475,26,2054,1364,1044,22270,1010
59619,187,1768,384,1520,12761,248
2104,12,652,1453,491,29929,161
23381,17,373,1178,232,3305,141
5165,21,909,1420,554,14095,355
18961,82,4316,1253,2497,63082,1819
62737,15,190,279,138,5408,52
21078,1,131,1215,89,8642,42
55938,56,609,497,479,7897,130
13701,6,112,1337,67,4470,45
49091,302,3321,699,2433,23748,888
62407,10,133,288,96,3452,37
29776,50,2421,1045,1681,54477,740
25452,84,3318,1135,2179,13419,1139
52871,9657,150897,590,120039,757936,30858
49488,62,560,688,498,10921,62
63045,8,190,272,127,6793,63
8016,106,5428,1384,3233,41721,2195
50117,10,211,657,164,6445,47
49822,11,193,679,154,8555,39
59499,159,2760,388,2086,28226,674
8415,341,11620,1382,7556,61699,4064
35241,315,5179,936,3905,43652,1274
22610,2372,47310,1192,33526,167313,13784
22977,103,3592,1185,2370,28124,1222
11281,46,2468,1365,1421,36341,1047
1369,31,1402,1459,906,12836,496
38057,513,7755,867,6330,69743,1425
7657,248,7364,1388,4864,37193,2500
45234,73,883,761,719,13593,164
50693,846,10027,657,7540,48219,2487
49027,81,1075,701,803,8393,272
8072,89,4045,1384,2596,21772,1449
23291,79,4578,1180,2813,35489,1765
46420,9,66,747,55,4605,11
9563,356,11394,1377,7019,55075,4375
30378,97,2630,1033,1524,13455,1106
19402,34,661,1245,476,19289,185
65514,2,49,202,28,2468,21
24118,22,450,1164,331,10454,119
33499,130,3100,979,2174,26161,926
51726,111,1532,629,1211,21781,321
20653,4,195,1223,156,21921,39
52705,446,6297,596,4553,82058,1744
60129,29,715,367,463,16413,252
30513,28,780,1030,497,6444,283
45807,2198,98508,753,64148,394870,34360
3823,258,17798,1437,9958,72496,7840
11269,0,0,1366,0,32099,0
17319,100,8286,1282,5185,34861,3101
18065,4,460,1268,354,34317,106
13406,372,12897,1341,7267,132190,5630
33914,24492,606799,972,313429,1754949,293370
35534,40,877,934,659,9851,218
53547,10,147,573,107,6673,40
18723,52,1081,1257,762,27256,319
7177,34,1861,1394,1026,12599,835
62296,28,382,291,289,3994,93
68634,382,6595,103,5479,60529,1116
31247,5,301,1017,186,7221,115
57279,84,2736,459,1921,20621,815
52683,510,6502,596,5007,49338,1495
5100,332,8077,1421,5225,111535,2852
36756,154,3597,904,2692,19573,905
48841,4,50,707,38,1660,12
20243,19,654,1230,419,16667,235
35856,1,68,927,55,5145,13
21868,3,74,1202,60,9682,14
34991,21,347,947,221,8952,126
64920,3,33,217,27,1028,6
18092,33,837,1268,574,9023,263
13771,4,132,1336,84,14361,48
10777,92,1801,1369,1256,33259,545
49731,23,412,681,337,7670,75
8659,8,363,1381,237,8180,126
19536,748,20518,1242,14428,262519,6090
38146,101,2150,865,1515,21308,635
15163,33,694,1317,479,13196,215
427,146,17893,1466,12255,184595,5638
25173,23,533,1141,292,5251,241
32552,28,786,996,474,4407,312
48308,2,24,722,17,1622,7
46225,2,30,749,22,5165,8
10496,39,642,1371,400,6296,242
63832,120,1603,251,1299,32251,304
35615,20,461,932,320,9810,141
26799,23,259,1105,203,10688,56
39780,664,6919,838,5377,33593,1542
34962,20,819,948,547,13882,272
65966,2,47,190,24,3693,23
61074,16,266,331,189,3579,77
18883,89,2041,1254,1494,18253,547
58530,112,1434,420,1193,27243,241
7113,41,1294,1396,881,37198,413
24267,101,3178,1161,2053,21669,1125
3186,227,7341,1443,4816,123510,2525
12769,57,1222,1350,744,10981,478
58481,265,2318,422,1914,18717,404
15972,1395,37801,1304,22803,147075,14998
31644,66,2756,1000,2331,31096,425
51137,174,1884,645,1500,20051,384
17622,1252,38437,1276,27700,143166,10737
4641,0,116,1427,85,8920,31
10188,4,91,1373,59,8121,32
31717,948,17793,1010,12631,77368,5162
24243,203,8130,1161,5378,48306,2752
19600,16,684,1241,482,13796,202
64151,34,358,240,299,6999,59
32260,2,218,1002,135,6244,83
8453,37,896,1382,589,36157,307
38229,140,3147,863,2699,47899,448
6569,78,2821,1403,1700,50692,1121
3600,88,2640,1440,1809,15865,831
28399,18,367,1071,224,8318,143
23811,88,1249,1170,923,11716,326
36257,17,331,916,305,13646,26
15259,125,2733,1316,2002,22579,731
50198,2,69,669,48,6190,21
37749,267,3782,876,2918,22390,864
1016,76,2251,1461,1563,42456,688
11657,27,1632,1362,844,13843,788
36710,1,53,904,39,3408,14
16656,0,0,1294,0,7248,0
6669,83,2980,1401,1809,27326,1171
58896,43,610,408,451,7101,159
51304,19,385,640,298,12621,87
35982,11,230,924,177,6611,53
58647,5,65,416,46,6220,19
20772,182,5449,1221,3702,38256,1747
18070,7,322,1268,238,14762,84
14927,0,0,1320,0,8026,0
15896,212,3942,1306,2833,29419,1109
65621,19,277,199,231,6147,46
29397,5,397,1052,334,21031,63
26279,18,1516,1117,777,7062,739
11193,4758,170992,1366,101245,446565,69747
13343,91,4654,1342,2200,81424,2454
466,125,3934,1466,2735,33513,1199
31303,55,1540,1016,928,21960,612
57750,23,172,447,142,2425,30
4887,11,303,1423,231,14608,72
5745,375,29122,1413,16584,166786,12538
36910,8,253,900,197,4785,56
34708,505,7412,952,5729,57316,1683
57102,10,164,463,65,3649,99
48547,21,526,716,411,9203,115
6843,81,1088,1399,848,10303,240
4843,8,301,1424,201,8804,100
27477,11,415,1090,244,23694,171
22906,4,177,1186,131,8656,46
2055,111,6021,1454,3739,37403,2282
25325,126,3231,1137,1975,32275,1256
55699,6477,160354,498,112442,353989,47912
20321,123,3066,1229,1798,12987,1268
19027,143,4767,1251,3533,32038,1234
60562,19,388,351,289,7324,99
31802,52,1117,1008,786,22618,331
66784,17,383,165,300,11386,83
23783,53,1729,1171,1184,20054,545
36937,35,748,899,623,20511,125
20892,31,817,1219,580,29331,237
58438,72,901,423,625,11268,276
9476,41,1592,1378,971,10609,621
28392,272,4709,1071,3236,23376,1473
37148,21,593,888,432,14974,161
45764,376,6313,755,4920,52686,1393
50622,1161,14536,659,11545,144382,2991
31193,63,1265,1018,863,11780,402
53290,71,1041,579,794,9156,247
17673,35,991,1275,780,25455,211
55518,3417,87610,508,64056,261321,23554
49671,0,44,683,25,1941,19
68759,2,80,100,78,2524,2
25581,104,1490,1132,864,16858,626
14765,33,895,1322,671,17289,224
51941,68,968,623,776,13720,192
12813,269,6005,1349,3977,35911,2028
49047,29,453,701,356,3773,97
63246,154,2426,266,1913,23938,513
30468,254,5849,1031,3778,29924,2071
56427,2,104,483,74,4876,30
13495,11,440,1339,265,5933,175
35547,14,384,933,292,15245,92
40852,38,765,821,618,21579,147
64961,7,221,215,193,3992,28
52851,62,729,586,568,8167,161
4323,4931,269468,1431,170622,1049069,98846
18931,53,1199,1253,983,30820,216
41356,50,1008,813,848,20385,160
34666,2,183,955,122,7528,61
5081,77,2195,1421,1495,25224,700
9312,94,2901,1378,1991,27241,910
47996,2,91,727,70,6317,21
37813,35,974,874,783,8358,191
30244,95,2898,1035,2009,24896,889
36917,590,8911,896,6972,42370,1939
10733,126,4100,1370,2532,24530,1568
58075,6,67,436,52,6487,15
3681,15,537,1439,364,30146,173
21552,2655,51984,1207,31771,220992,20213
6197,21,472,1408,375,9496,97
33313,0,123,983,71,3263,52
61227,1370,26532,325,21146,136459,5386
15665,23,772,1309,588,16231,184
20768,18,807,1221,593,31098,214
30870,7,274,1023,188,5909,86
60609,7,476,349,311,7212,165
12923,10721,241362,1348,152719,711139,88643
55818,25,178,500,147,4674,31
25240,1,151,1139,98,10152,53
7162,25,765,1395,460,14931,305
32346,53,1913,1001,1329,37697,584
29788,14,436,1045,292,10534,144
25697,8,86,1129,70,8375,16
2772,176,6439,1448,4397,99856,2042
39493,22,507,841,347,5061,160
41717,19,640,807,474,11960,166
51699,542,9761,629,8201,58689,1560
6204,29,929,1408,644,14543,285
55251,28,252,516,203,4055,49
53228,915,8395,580,6622,61356,1773
30621,9,182,1028,118,5492,64
50119,323,5022,671,4129,109901,893
11244,1,149,1366,61,2713,88
49274,19,291,689,236,12938,55
19069,1920,68376,1251,46002,293750,22374
53005,28,213,586,191,13118,22
53141,88,840,582,704,15898,136
28475,29,616,1070,429,10938,187
48073,20,257,726,210,10575,47
15480,31,557,1312,379,26551,178
9417,99,3308,1378,2112,20548,1196
34715,273,7248,953,5322,93931,1926
34137,147,3230,967,2213,148555,1017
29816,70,1322,1044,1151,31805,171
19173,675,18889,1249,13023,208413,5866
50604,36,643,659,470,16169,173
60722,77,1076,344,859,10179,217
38308,8,254,862,182,16994,72
42940,82,1941,787,1354,30789,587
30052,199,4802,1039,3092,103084,1710
22405,26,828,1195,583,26812,245
66021,528,10799,189,8836,74322,1963
1171,28,1075,1460,793,31915,282
57336,40,473,458,359,4984,114
53854,8,95,561,75,4563,20
8437,70,3606,1382,2314,36834,1292
37695,126,3335,877,2572,56172,763
20045,112,1769,1233,1535,37916,234
21862,8,301,1202,207,20598,94
1459,214,6870,1458,4314,66095,2556
1868,2,269,1455,193,17298,76
17549,10,941,1278,684,18377,257
38509,29,862,856,654,14585,208
24995,156,4088,1144,2770,40944,1318
4227,8,155,1433,100,8022,55
11960,0,0,1359,0,8351,0
59642,15,457,384,246,8096,211
50276,18,233,665,202,12060,31
68319,32,617,115,551,8020,66
54432,342,3943,543,3318,42116,625
61660,12,92,313,67,2140,25
49256,142,1215,694,943,18583,272
66204,9,176,182,132,3157,44
20586,1915,32145,1224,23427,172493,8718
8288,228,14503,1383,8834,89205,5669
33738,216,2241,975,1665,19128,576
13065,14,496,1345,299,25722,197
67388,23,293,145,285,6120,8
11583,7,207,1363,119,4350,88
64899,11,69,217,65,11003,4
24720,55,1377,1150,927,23491,450
21385,8,306,1209,223,9360,83
32638,13,318,995,200,4733,118
33083,12,533,987,371,13789,162
21663,124,4935,1205,2707,18856,2228
1186,16,440,1460,332,21657,108
52320,2,29,610,23,3046,6
56619,265,2836,477,2330,23812,506
22143,0,0,1199,0,5843,0
7612,19,1191,1389,862,27457,329
356,64,2449,1467,1793,35358,656
35572,240,3311,932,2509,24547,802
4669,37,1091,1426,843,25494,248
13518,55,1155,1339,741,17399,414
25315,398,10995,1137,6493,65336,4502
32857,72,1114,991,913,18835,201
58007,20,97,438,67,6337,30
20139,281,6944,1231,5314,65933,1630
40017,29,871,834,685,11193,186
64834,8,65,219,48,1331,17
32827,23,523,992,341,8014,182
31,130,4998,1472,3524,96672,1474
41714,63,1514,807,1230,23511,284
26737,20,539,1106,315,14513,224
4967,8,296,1422,216,27687,80
20197,92,2592,1231,1780,35703,812
48089,53,1622,726,1285,6267,337
7462,86,3400,1391,2525,38860,875
61582,89,1700,315,1381,22436,319
26935,479,11797,1102,8489,361990,3308
27545,106,3983,1088,2540,34625,1443
19165,857,27518,1249,20007,170093,7511
348,1683,52272,1467,30309,146439,21963
57819,48,706,444,580,10866,126
17732,41,1557,1274,1038,17429,519
68996,14,299,91,233,5390,66
63209,63,804,267,677,9850,127
16344,6,139,1298,102,11889,37
4272,421,11696,1432,8151,57184,3545
36962,15,259,898,210,14065,49
36193,0,93,918,71,7272,22
1759,24,1267,1456,842,12583,425
61397,35,591,321,499,10497,92
63834,234,3740,251,2957,23502,783
28090,0,0,1077,0,11002,0
33305,216,6890,983,4819,54755,2071
12278,19,1089,1356,585,8961,504
40254,22,510,830,391,12729,119
20935,112,2739,1218,1912,26048,827
5046,33,1927,1421,1339,57216,588
67136,19,141,153,123,9054,18
16508,17,532,1296,363,9617,169
24393,111,8400,1158,5444,41301,2956
30490,25,799,1030,532,16341,267
7796,309,19138,1386,9982,157009,9156
68194,587,12420,120,10338,125424,2082
40703,48,1305,824,1071,17813,234
53242,29,226,580,183,4195,43
32132,168,3752,1004,2877,26736,875
30691,5,198,1026,115,7663,83
17533,22,305,1278,192,6812,113
64748,5,47,222,35,2758,12
50437,5,118,663,58,2920,60
38472,218,3285,857,2490,24976,795
27167,25,931,1097,547,6342,384
1760,410,15468,1456,11294,75136,4174
40236,73,1531,831,1186,8754,345
62786,382,7313,277,5772,48917,1541
19281,16460,515845,1247,298965,3671050,216880
18979,7,224,1252,134,8509,90
8314,39,1763,1383,1167,29075,596
31335,14,389,1015,252,20714,137
29345,18,414,1053,266,17522,148
27739,79,966,1084,610,13925,356
6357,3,52,1406,28,5504,24
27943,70,2794,1080,1540,22612,1254
23169,60,1322,1182,1054,18830,268
19698,7,331,1239,260,9622,71
25077,441,8248,1142,5454,29118,2794
21982,70,2431,1201,1506,14461,925
60125,97,661,367,498,9015,163
17425,58,1198,1281,941,21150,257
52997,55,1056,587,821,7655,235
32408,546,8380,999,5654,138947,2726
48893,37,457,706,325,7711,132
64708,15,130,224,106,6339,24
7199,24,1854,1394,1154,15149,700
31999,74,1416,1006,934,12585,482
37346,167,2238,887,1714,19844,524
31911,45,1012,1007,645,8811,367
6370,19,607,1406,430,29981,177
66761,9,85,166,79,3914,6
40439,7,141,828,127,5829,14
604,85,4335,1464,3203,34374,1132
11093,13,631,1367,344,5669,287
49269,596,11675,694,9741,56924,1934
56596,9,193,476,130,9923,63
2961,16,322,1446,219,19012,103
29897,47,1078,1042,695,8844,383
6429,1115,48195,1405,32698,241218,15497
22852,31,713,1187,479,8057,234
48836,669,7079,707,5893,93275,1186
37622,644,11771,879,9301,73774,2470
15761,44,889,1308,647,28242,242
53338,26,306,578,241,4003,65
38183,3,31,864,24,5113,7
53520,4,98,574,79,10862,19
59420,37,403,391,336,7098,67
66125,56,1295,185,929,10245,366
13997,322,10945,1332,6922,127180,4023
66520,9,90,173,68,1693,22
10950,43,1641,1368,990,22999,651
56585,11,80,478,61,4591,19
55474,684,4716,509,3521,25684,1195
55262,1,20,515,18,3439,2
409,675,29554,1466,17158,86130,12396
6830,762,23070,1400,13926,64488,9144
33003,17,373,988,270,12216,103
10939,65,5530,1368,3281,30697,2249
67903,2,43,129,29,1941,14
6024,847,27187,1410,16858,167245,10329
18286,10,353,1264,238,8314,115
8745,38,1313,1381,862,17190,451
16660,911,27236,1294,17892,180105,9344
17321,72,1435,1282,1052,12269,383
53293,5,20,579,20,2723,0
24006,27,574,1167,411,14546,163
29288,4,98,1054,75,10970,23
56146,19,236,490,179,7244,57
54179,19,205,552,141,7545,64
16209,853,23857,1300,14647,184636,9210
28149,22,522,1076,406,6671,116
45862,8451,243495,754,191702,963521,51793
7072,24,345,1396,250,10263,95
27416,18,815,1092,488,6073,327
60212,338,5116,364,4085,53822,1031
10252,6,445,1373,256,6978,189
16030,16,531,1303,375,8842,156
39177,19,321,845,279,6824,42
67946,37,305,127,256,7694,49
5358,47,2877,1417,1968,32344,909
24987,22,965,1144,690,10976,275
56906,19,409,468,231,5822,178
10478,14,531,1371,355,12369,176
40108,623,11378,833,8378,109944,3000
10380,712,27112,1372,17456,168176,9656
49695,16,248,682,202,6144,46
23853,50,2190,1170,1459,17724,731
10023,115,1750,1374,1075,19766,675
67626,19,175,137,156,7158,19
14153,307,5522,1330,4003,29040,1519
67138,13,232,153,158,5318,74
53637,9,157,570,119,4185,38
34347,16,461,963,370,24599,91
23116,10,316,1183,232,11141,84
57850,23,418,443,320,9887,98
30430,20,624,1032,391,14199,233
29831,4077,71276,1044,46023,345122,25253
18305,4,47,1264,40,2690,7
50259,1304,22749,668,16760,194831,5989
40537,149,1648,826,1261,15295,387
1050,702,17389,1461,11412,72348,5977
52947,148,2578,588,2087,11080,491
32398,30,269,1000,218,5404,51
1697,7,248,1456,168,14058,80
66919,679,15534,159,11936,79378,3598
13139,17,985,1344,512,14056,473
11860,27,1060,1360,598,18728,462
57919,28,393,441,317,11530,76
16252,11,443,1300,305,17689,138
33829,126,3276,973,2116,19467,1160
60602,177,3098,346,2582,21486,516
44115,1057,13579,773,10411,47758,3168
34763,5,67,952,62,10474,5
3210,79,1672,1443,1192,12001,480
28687,11,298,1066,182,8613,116
17723,18590,481623,1274,307226,1121101,174397
65584,800,15917,200,12916,90300,3001
37700,6,171,877,144,14679,27
15935,219,4778,1305,3136,20697,1642
56701,14,228,474,175,5638,53
4279,4,92,1432,61,17295,31
31154,33,1508,1018,929,22038,579
53625,28,651,570,242,8655,409
24918,11,636,1146,401,9683,235
57065,110,1940,464,1493,54193,447
65321,68,596,205,499,8824,97
35746,21,577,930,419,3648,158
66463,81,944,175,797,14727,147
2855,66,1501,1447,953,22649,548
19296,65,1795,1246,1089,39526,706
4658,12,793,1427,575,16326,218
54017,55,728,557,549,5771,179
14758,84,1243,1322,931,12208,312
59388,46,493,392,378,6344,115
40150,110,1824,832,1466,29697,358
22547,42,1020,1193,795,14290,225
52327,57,618,610,513,6983,105
20724,42,1197,1222,908,37979,289
56704,15,319,474,232,13725,87
32786,20,467,988,303,6482,164
67728,8,261,134,202,3375,59
1219,6,674,1460,435,18207,239
3024,23,723,1445,569,12465,154
52687,27,334,596,248,14407,86
10759,11,1108,1369,749,16866,359
68972,24,223,92,195,4018,28
52634,125,1787,598,1476,19108,311
12151,22,618,1357,360,20665,258
58681,320,5059,415,4173,19322,886
58176,70,1116,432,786,14027,330
37080,16,297,895,223,5243,74
18566,105,1209,1259,868,14754,341
4693,19,457,1426,328,27674,129
58045,238,2214,436,1767,24484,447
21898,16,696,1202,434,22660,262
30282,888,15107,1035,10993,87975,4114
15591,117,4361,1310,3047,31736,1314
1471,109,2360,1458,1409,37413,951
10191,47,1737,1373,1107,32892,630
63843,11,110,250,80,2659,30
61409,25,316,301,254,8060,62
50814,16898,363583,654,278696,1373546,84887
18787,995,27885,1256,18182,220416,9703
48560,164,1836,716,1544,17156,292
51464,39,827,636,706,9036,121
53051,3,143,585,113,2587,30
38078,227,3828,867,2885,26913,943
435,44,1921,1466,1350,33076,571
51555,21,325,634,237,9879,88
52120,7,85,616,68,4720,17
9000,404,6912,1380,4713,50934,2199
25886,134,2446,1126,1631,28531,815
16880,11,358,1290,272,15359,86
35101,46,1416,944,1113,28802,303
37522,30,897,882,689,26337,208
57286,101,2109,459,1609,25404,500
56517,128,2707,475,1964,21041,743
26770,5030,85371,1106,52778,282260,32593
67611,73,557,138,394,6717,163
21347,0,17,1210,16,4336,1
18399,14,198,1262,126,2684,72
22839,40,906,1187,643,9937,263
66312,59,1247,180,960,12081,287
61072,34,388,331,289,9355,99
13005,1136,37783,1346,23966,108634,13817
25980,253,9946,1123,6186,125391,3760
28688,717,18033,1066,11907,121265,6126
27865,73,702,1081,545,7318,157
19621,0,109,1241,76,6705,33
27409,248,3505,1092,2623,21898,882
37913,31,704,872,558,9482,146
59705,11,271,381,236,4685,35
4707,2076,65582,1426,40665,251146,24917
62567,5,131,284,87,5682,44
43377,491,7043,781,5495,84942,1548
31339,20,537,1015,310,6496,227
32191,28,425,1003,251,4862,174
19970,7,173,1235,124,6173,49
25428,83,1590,1135,990,21503,600
62584,17,240,283,144,3179,96
32124,85,1876,1004,1183,24950,693
31140,236,8467,1019,5647,95925,2820
793,33,761,1463,575,11431,186
20995,26,1250,1217,884,16658,366
19447,21744,561609,1244,333099,1649950,228510
57916,14,250,441,171,4027,79
40847,100,1405,821,1142,28996,263
68178,9,84,120,64,3492,20
29731,279,6009,1046,3901,63658,2108
36416,1275,19625,911,15102,142321,4523
52471,1961,21975,604,17948,180401,4027
13087,73,3001,1345,1811,20491,1190
12702,226,11094,1351,6535,158695,4559
27660,225,4136,1086,2716,14886,1420
58678,20,434,415,361,13996,73
6033,2,116,1409,81,8323,35
29061,291,7621,1059,4865,72670,2756
9891,2607,72716,1375,47660,199136,25056
54362,1709,47531,545,37456,271878,10075
45329,87,1425,760,1130,20722,295
24807,191,4016,1148,2549,25614,1467
38175,44,901,865,646,19949,255
33826,181,6903,973,4649,55901,2254
17731,94,1093,1274,786,6964,307
5462,90,2744,1416,2074,78923,670
983,57,1496,1461,1049,40688,447
55950,197,2393,497,1943,26041,450
40725,188,5194,824,3899,64921,1295
45725,46,550,755,455,10491,95
67358,657,14421,144,11131,78657,3290
64709,8,156,224,121,2340,35
40018,34,868,834,665,36409,203
37402,207,506,885,408,15485,98
64073,16,183,242,143,3714,40
28963,120,2991,1060,1931,14647,1060
27955,4286,114255,1079,69754,697324,44501
4438,364,9014,1430,6226,39378,2788
19041,20,832,1251,585,15617,247
8534,28,1141,1382,851,13455,290
37714,15,134,877,85,19261,49
40250,26,454,830,337,7902,117
26081,54,5510,1121,3771,19335,1739
19535,38,1064,1242,785,26533,279
65317,2408,45756,206,34067,220049,11689
10889,49,750,1368,512,10577,238
6634,16,521,1402,340,12842,181
29457,970,24143,1051,19816,83843,4327
13213,0,0,1344,0,6056,0
12233,166,3687,1356,2287,27914,1400
64800,36,406,193,328,9893,78
25044,11,476,1143,307,18512,169
50897,13,148,652,110,2897,38
36320,198,4200,913,3280,25275,920
37343,271,6156,887,4943,37536,1213
53910,55,920,561,705,13723,215
57672,36,394,449,284,8810,110
1407,33,1331,1458,945,22003,386
33183,49,2105,985,1695,64760,410
21723,596,14519,1204,9081,91105,5438
3469,34,764,1441,602,18235,162
32911,122,2825,990,1856,19136,969
34149,81,998,967,732,30182,266
11224,3,168,1366,128,8169,40
3183,286,7251,1443,4712,43066,2539
60756,425,6376,343,4855,20101,1521
22213,41,906,1198,535,34563,371
32099,57,1559,1004,969,9150,590
1099,7,341,1461,227,16330,114
13775,0,0,1336,0,13799,0
59822,30,495,377,310,10766,185
58465,175,2074,422,1672,26235,402
10015,35,1190,1374,800,20432,390
63669,62,1693,255,1440,17957,253
48253,22,464,724,310,17857,154
28363,24657,599769,1072,359762,1308603,240007
55866,16,256,499,190,4574,66
33081,105,2504,987,1851,62331,653
3096,2768,82066,1444,51485,200426,30581
16529,5,315,1296,224,8787,91
57451,100,1576,455,1399,43317,177
5602,17,874,1415,565,21175,309
57800,52,327,445,270,6487,57
40463,77,1313,827,1144,16132,169
48528,15,168,717,132,4092,36
39217,98,1186,845,860,13273,326
45315,108,3108,760,2237,18116,871
19335,31,1032,1246,726,15260,306
56104,17,161,492,149,13293,12
2270,0,200,1452,112,3550,88
47733,181,2514,730,1899,13916,615
36873,172,2754,901,2204,39099,550
11159,1815,60938,1366,36618,160983,24320
3900,28,973,1436,756,11383,217
11445,828,81236,1364,40102,279601,41134
17353,448,11418,1281,7239,118367,4179
32928,51,1851,990,1255,35159,596
54447,0,1275,542,978,12022,297
27790,354,9554,1083,6502,74181,3052
9555,696,12421,1377,8218,80286,4203
47688,127,1968,730,1572,13257,396
11936,47,1242,1359,770,21215,472
68654,44,598,103,507,9601,91
50490,54,784,662,625,13930,159
11009,326,10397,1367,6635,38868,3762
37006,803,12408,896,8756,71673,3652
52427,85,1331,606,1052,57681,279
3516,10,573,1440,381,23489,192
3074,10,554,1445,374,34726,180
25876,23,762,1126,647,15333,115
5322,103,2307,1418,1549,18152,758
58264,14,177,429,144,9742,33
25723,0,55,1129,35,4371,20
59232,31,617,398,514,14643,103
27120,24,582,1098,340,17714,242
59450,2875,35564,291,28355,134484,7209
20023,86,2275,1234,1604,24154,671
29142,74,2485,1057,1363,11985,1122
19760,21,994,1238,607,5972,387
35340,44,875,938,675,16278,200
64101,7,59,241,49,3931,10
32177,23,500,1003,450,32255,50
62678,47,508,280,357,6723,151
66773,10,217,165,184,2522,33
30446,108,1288,1031,929,18563,359
28337,41,2014,1072,1218,25279,796
8791,366,17003,1381,11243,268471,5760
53856,17,333,563,248,7916,85
17857,146,3271,1272,2154,119418,1117
43381,1394,39018,776,28400,208074,10618
45348,57,751,759,606,22832,145
19254,27,359,1247,260,10354,99
14950,78210,2113378,1320,1286760,4685483,826618
7257,7,454,1393,261,22410,193
58136,129,1895,434,1493,26213,402
5721,19,726,1413,550,10833,176
59063,3,44,404,32,1878,12
32500,18,561,998,348,15088,213
1746,62,1661,1456,1079,32869,582
13590,49,1712,1338,983,14432,729
29485,68,1280,1051,1170,14924,110
46046,207,3834,751,3235,53263,599
67555,91,2374,138,1865,22852,509
64910,427,4084,217,3346,32994,738
32089,180,2698,1004,2081,14122,617
399,22,1070,1466,739,23328,331
13103,114,5071,1345,3027,41234,2044
21537,246,13292,1207,8300,61170,4992
19958,20,998,1235,736,19480,262
21151,90,3542,1213,2413,60718,1129
32393,4,266,1000,160,3111,106
36234,2167,35206,916,28618,345414,6588
35087,21,346,945,225,7491,121
42805,8,198,783,130,7600,68
31523,44,1468,1013,972,41063,496
41629,473,5958,808,4600,54005,1358
17239,196,3357,1284,2218,23618,1139
29615,21,518,1049,271,6163,247
11126,126,5200,1366,3030,24007,2170
24067,93,2450,1165,1740,19590,710
2585,547,10306,1449,6999,107733,3307
35469,12,383,935,254,6807,129
3441,49,1555,1441,1084,14064,471
32695,18228,530006,995,344699,976206,185307
8601,37218,1178087,1381,729475,1909568,448612
34700,232,5878,954,4289,51298,1589
39352,0,25,843,17,2744,8
55213,76,1336,516,1076,22063,260
19009,706,21009,1252,14635,157082,6374
4699,41,1622,1426,1105,12700,517
3425,132,10712,1441,5423,69474,5289
16504,10,290,1296,187,10162,103
52409,96,1327,607,1110,14297,217
66973,1,63,158,48,4132,15
42326,18,272,798,211,10817,61
2582,105,4631,1449,3113,31103,1518
5577,3899,160406,1415,101522,1206502,58884
10971,121,4725,1368,2724,22266,2001
19752,122,4723,1238,3240,40383,1483
65398,27,212,204,183,5450,29
55279,54,745,514,536,15006,209
34092,149,3293,967,2083,17871,1210
9765,29,713,1376,452,15272,261
26215,5,347,1119,213,8740,134
17193,23,529,1284,374,5896,155
35582,275,8841,933,7219,74149,1622
30274,9,377,1035,245,11563,132
51585,123,1864,633,1486,24741,378
19470,392,11806,1244,8485,167779,3321
49232,112,1447,695,1218,36195,229
18268,79,2162,1265,1524,19331,638
2136,99,3139,1453,2178,56360,961
28352,81,1305,1072,893,18765,412
26277,7,600,1117,333,11338,267
54574,37,413,537,319,15763,94
27984,0,0,1079,0,11055,0
10851,10,292,1369,202,24014,90
63230,19,228,267,186,4555,42
13984,681,24141,1332,17510,229318,6631
21637,61,1606,1205,1045,62960,561
18735,4,123,1257,89,23812,34
60685,161,3846,346,3290,22739,556
11795,320,15291,1361,9814,98196,5477
28054,29,840,1078,513,6789,327
35458,293,4712,935,3663,70329,1049
52447,72,691,606,527,8935,164
8324,542,34255,1383,22910,95031,11345
5657,67,2190,1414,1414,34825,776
29116,13,1289,1058,778,13808,511
23876,10189,260273,1169,178149,803106,82124
15557,15,448,1311,323,55279,125
34881,739,11929,950,8488,77788,3441
66171,58,1988,183,1456,14753,532
50111,81,1061,671,841,14010,220
59835,24,404,377,250,4632,154
67568,12,195,139,127,3086,68
53108,493,6956,583,5211,40315,1745
959,15,806,1462,535,20619,271
60632,40,704,348,529,5750,175
62022,146,1993,300,1576,13955,417
53336,26,163,578,133,23460,30
31230,215,3420,1017,2409,34029,1011
17176,73,1072,1285,803,20302,269
59118,250,4664,401,3381,44916,1283
53481,7,184,574,151,12447,33
54,40,1110,1471,832,26516,278
60313,60,846,360,681,31240,165
752,4,286,1463,178,11677,108
42694,157,1480,791,1077,13644,403
16569,915,29873,1295,16730,114186,13143
30355,53,1133,1033,786,20572,347
32670,105,2456,995,1668,23107,788
36385,167,2171,912,1857,23682,314
61454,9,66,319,51,6644,15
45153,80,1047,762,814,15701,233
18841,9,184,1254,132,15031,52
64071,14,116,242,101,7561,15
5147,7,369,1420,246,23606,123
34434,38,1197,961,806,38402,391
1979,14,971,1454,675,39708,296
21181,840,17682,1213,12540,176838,5142
28546,25,523,1069,328,9070,195
9291,5,173,1379,117,4100,56
40571,69,1282,826,1011,12548,271
49006,14,280,702,218,4014,62
24081,28,819,1165,504,10158,315
50234,16,260,668,199,9006,61
17748,17,126,1274,82,5502,44
41889,196,1954,804,1386,25598,568
21821,86,4407,1203,3238,33708,1169
7471,24,634,1391,462,22959,172
4600,32,862,1427,609,17885,253
64117,27,430,241,358,5479,72
31790,1,151,1009,106,6394,45
54770,83,666,530,552,23160,114
46755,5,164,743,130,10053,34
53731,107,1833,567,1408,31108,425
53038,40,641,586,470,11584,171
29020,249,5052,1059,3495,33527,1557
38402,1288,21146,859,16940,183181,4206
25048,56,1082,1143,733,23916,349
52722,2,15,595,14,2301,1
9735,28,1354,1376,801,22134,553
22418,14,391,1195,328,12311,63
7375,111,3573,1392,2490,47728,1083
34083,1093,16734,968,12577,167067,4157
51462,1874,23823,637,19811,77059,4012
35383,172,2288,937,1745,15279,543
15569,27,952,1311,688,15365,264
60588,19,172,350,137,2709,35
31959,24,443,1006,273,8732,170
31225,92,2967,1017,1960,50027,1007
36444,123,3990,910,3164,45724,826
64056,27,382,243,320,7966,62
15876,337,6389,1306,4427,32861,1962
60942,159,2194,336,1658,11630,536
3134,23,657,1444,465,8464,192
54115,27,179,554,143,3069,36
56941,30,505,467,383,9177,122
64182,28,373,239,292,10125,81
10022,35,1565,1374,1066,60852,499
11487,1451,66485,1364,36068,382725,30417
15098,5,76,1318,49,9693,27
51747,39,621,628,555,10989,66
5169,284,17452,1420,10627,76559,6825
27113,8,327,1098,200,8058,127
29125,21,342,1057,197,4060,145
9362,92,2037,1378,1442,33982,595
2598,8,190,1449,143,11878,47
18048,4,254,1268,120,7748,134
11069,43,1694,1367,946,25385,748
53509,349,5983,574,4461,62464,1522
38311,5,124,862,101,3142,23
17843,51,1374,1272,972,39034,402
57295,5,63,459,47,3429,16
2487,12,552,1450,374,14324,178
22266,17,285,1197,223,5163,62
51415,3,60,638,47,3017,13
39050,308,20606,847,10687,89057,9919
20755,17,515,1221,391,18366,124
35577,1784,49534,933,35142,304220,14392
37289,13236,245869,888,171033,1219666,74836
50231,13,243,669,187,4578,56
16474,6471,244505,1296,128568,846498,115937
68030,0,46,124,40,1873,6
50163,3,81,670,59,6236,22
22108,93,6841,1199,3979,30970,2862
20894,22,421,1219,289,18751,132
61780,94,1239,308,968,13925,271
57847,5,53,443,46,3819,7
16471,1880,47992,1296,31227,184122,16765
67785,26,213,132,179,4076,34
22940,1399,32762,1185,24276,100083,8486
65261,14,72,208,58,7778,14
31559,55,3677,1013,2402,45069,1275
24633,7,199,1152,140,7596,59
24628,9,330,1152,280,4504,50
55479,70,932,509,744,24656,188
41052,2715,44923,818,33332,143870,11591
18791,4,90,1255,64,14185,26
15692,1966,67694,1309,47160,343645,20534
68272,147,3471,117,3015,28666,456
27467,66,2100,1091,1267,22126,833
22703,392,10327,1190,5930,25740,4397
25733,10,215,1129,154,12735,61
37245,87,1143,889,955,24860,188
19530,36,1643,1242,1185,67070,458
24054,15,336,1165,255,9712,81
26634,247,4976,1108,3474,55261,1502
15583,259,8443,1310,5750,62189,2693
800,100,3903,1463,2281,20592,1622
69045,3,46,90,30,1513,16
19414,4,136,1244,88,4517,48
53812,85,706,565,495,8582,211
55858,39,283,499,233,7428,50
10313,222,3284,1373,2423,32346,861
64753,484,9270,222,7514,54466,1756
34833,101,3167,951,2181,90851,986
63685,504,15491,254,11759,64382,3732
8444,1598,80762,1382,50341,298539,30421
67520,13,481,141,339,8330,142
62389,7,163,289,91,5217,72
49114,32,331,699,284,9154,47
6505,112,3129,1403,2179,19284,950
47196,82,1090,737,857,9301,233
10564,3,141,1371,84,4751,57
63991,1263,23329,245,18085,75441,5244
52270,10,219,612,168,10186,51
12778,25,608,1350,350,8532,258
29183,57,1425,1056,923,16136,502
24300,7,318,1160,223,12043,95
28276,84,2713,1074,1964,17301,749
31246,25,802,1017,511,13499,291
52543,51,962,602,763,12774,199
30669,18,413,1027,273,4637,140
9889,168,3582,1375,2402,22816,1180
60062,324,7653,369,6527,36154,1126
21162,34,536,1213,332,10593,204
34022,148,2026,969,1550,21514,476
67420,250,4952,144,4257,36207,695
68408,22,122,97,113,2608,9
16420,7,223,1297,152,8810,71
3511,186,8104,1440,5535,116920,2569
9425,1631,42471,1378,24586,207745,17885
17080,21,1724,1286,1348,16427,376
22045,7,211,1200,177,8705,34
16423,23,889,1297,603,8797,286
20955,11,251,1217,186,10917,65
27572,163,3052,1087,2111,27562,941
40245,5782,192080,830,141732,422255,50348
54403,84,1437,544,1179,17850,258
10210,6,304,1373,170,4413,134
54504,650,5737,540,4833,49285,904
59351,2,55,394,46,8469,9
2623,5,247,1449,148,16670,99
59491,272,3262,389,2574,32002,688
57454,27,287,455,241,18302,46
53793,10,177,565,125,13107,52
37547,28,554,881,429,9222,125
59772,710,9845,379,7241,40094,2604
50133,419,7941,671,6427,115192,1514
64212,6,54,236,42,3607,12
33379,409,11728,981,8176,74078,3552
24850,8,181,1147,131,5243,50
4966,52,3141,1422,2140,30859,1001
48147,8,134,725,103,7757,31
33688,216,4499,976,3163,37202,1336
21586,56,2465,1206,1569,12358,896
38451,20,302,857,269,4897,33
56482,32,416,481,313,9201,103
66441,319,4940,176,4137,64194,803
44024,5,197,774,148,6235,49
62125,1697,32305,296,24915,167839,7390
49643,9,183,684,131,4408,52
31894,14,261,1007,160,3696,101
47803,57,1050,729,903,20087,147
29865,11270,227017,1043,151179,614092,75838
67937,4,33,127,31,3619,2
2907,527,15048,1446,9687,50815,5361
30047,33,1230,1039,779,31549,451
35066,10,245,945,163,6871,82
19980,2,83,1234,65,4856,18
25974,25,621,1123,450,17863,171
10500,50,1320,1371,889,15304,431
66158,3,45,184,38,2832,7
50830,1,67,654,51,4844,16
32147,4,156,1004,102,14666,54
17652,18,263,1276,208,14408,55
60135,188,12874,366,9155,34896,3719
65818,28,394,194,320,12808,74
17498,17,264,1279,213,11085,51
65632,8,51,199,41,3203,10
25323,83,809,1137,467,6709,342
25119,116,2564,1142,1643,27107,921
64534,140,2093,229,1627,9496,466
18055,1065,26166,1268,18430,71335,7736
15891,242,4692,1306,3096,50174,1596
7348,61,1279,1393,782,10139,497
39792,6,246,838,164,10994,82
10264,1,93,1373,68,5971,25
30461,327,9431,1031,6577,63225,2854
6493,132,3754,1404,2735,17179,1019
18447,7,320,1261,211,12177,109
3145,1259,50383,1444,30539,121877,19844
7840,94,1658,1386,1059,16322,599
15145,65,1525,1317,910,8464,615
55234,10,242,516,166,7344,76
24409,188,3138,1157,1906,13540,1232
54427,6,44,543,33,1698,11
33431,9,320,981,183,4763,137
48700,26,325,711,248,12546,77
53299,41,526,579,381,6386,145
35695,25,591,931,449,19118,142
9490,18,638,1377,411,9453,227
8114,47,1417,1383,908,15878,509
63440,28,269,261,213,4016,56
8917,94,2999,1380,2119,35582,880
50360,4,338,665,166,8016,172
3985,40,857,1435,554,15414,303
62294,93,1361,291,1117,21234,244
27353,143,4169,1093,2674,32524,1495
47370,2,78,735,64,3646,14
9516,321,19579,1377,10639,82814,8940
49168,1606,33106,697,23754,92474,9352
1751,68,1033,1456,705,8580,328
12045,1435,49021,1358,32245,199499,16776
64477,102,1007,230,799,11846,208
28310,11,356,1073,218,19781,138
37211,107,1690,891,1420,21494,270
15462,12,398,1312,280,14344,118
68950,2233,63501,93,53795,253960,9706
57931,79,629,441,502,5727,127
8309,154,5571,1383,3593,35669,1978
67547,93,1327,140,1133,8517,194
18367,34,849,1263,598,10515,251
57355,790,14099,456,10907,69824,3192
32333,10,421,1001,272,26959,149
20774,12,300,1221,221,26288,79
25993,54,2678,1123,1652,23869,1026
31359,89,1685,1015,1062,21972,623
35440,22,1060,936,751,16158,309
11312,205,8441,1365,4969,50509,3472
53400,61,735,576,557,8204,178
64975,149,2755,214,2101,16300,654
30904,311,5268,1022,3715,58817,1553
55557,2,62,507,56,3654,6
25891,257,4596,1125,3079,36064,1517
54840,27,437,527,344,3903,93
249,6,273,1468,200,22855,73
16599,119,1719,1295,1142,23759,577
61576,36,374,315,305,7786,69
64934,191,2093,216,1608,12187,485
28650,216,5603,1066,3339,49949,2264
7536,57,2365,1390,1583,59851,782
35273,35,625,940,443,10436,182
25469,882,12537,1135,8657,95864,3880
24398,4741,80044,1158,55110,319080,24934
9982,185,10042,1375,6645,92607,3397
61079,12,146,331,126,3354,20
19087,1672,44987,1250,31949,221929,13038
50447,773,7979,663,5936,25922,2043
68213,15,169,119,140,3100,29
8277,314,5275,1383,3216,20938,2059
62655,607,7444,281,5416,30256,2028
40906,32,522,820,399,12509,123
20110,22,697,1232,531,13965,166
62282,14,300,292,242,8159,58
9841,22,682,1376,470,9312,212
12513,242,6331,1353,4014,33814,2317
27350,29,651,1093,489,14118,162
29778,4,700,1045,398,17804,302
65180,39,275,209,236,7086,39
18817,32,783,1255,605,14694,178
13135,77,4384,1344,2981,64180,1403
26811,669,16621,1105,10515,154964,6106
52079,13,126,618,105,5480,21
26842,2609,86979,1104,52317,592885,34662
18274,9,172,1265,136,10031,36
47513,334,4890,733,3749,59892,1141
25748,94,2483,1128,1576,40480,907
23180,41,878,1181,617,17041,261
52992,65,519,587,362,5803,157
27788,51,2348,1083,1376,38057,972
54780,9,96,530,65,3139,31
67534,41,320,140,268,5590,52
42894,346,8761,788,7283,52177,1478
17852,15,657,1272,499,14242,158
28717,9,391,1065,251,10768,140
15125,3969,109277,1317,68145,286708,41132
34026,58,1690,969,1309,22049,381
21230,8,223,1212,124,4820,99
16709,18,2019,1293,1250,14183,769
61124,221,3835,329,3054,17864,781
16942,150,4056,1289,2618,35423,1438
56758,2577,63106,473,46496,300492,16610
50492,6,128,662,105,12171,23
37713,4,103,877,90,11293,13
12506,2737,76133,1353,42069,470583,34064
18559,14,546,1260,385,10374,161
27833,395,9990,1082,6458,53848,3532
57150,13,205,462,132,6716,73
63446,164,1159,261,909,9553,250
36715,71,776,904,647,8301,129
42128,8,340,800,204,7892,136
37526,168,2427,882,1900,40167,527
58770,2,34,412,30,2533,4
28001,1257,11998,1078,8714,83514,3284
2643,22,728,1449,484,17188,244
63736,0,0,253,0,8482,0
66376,13,272,178,193,3496,79
34471,13,977,959,652,12268,325
11413,211,8133,1364,5023,70577,3110
49457,288,2533,689,2064,24221,469
50199,0,9,669,7,1481,2
33439,104,1268,980,896,38537,372
26503,467,16807,1112,11336,118698,5471
20412,180,8519,1227,5699,57721,2820
40832,11,152,819,140,18120,12
43385,17,242,781,177,7546,65
53398,135,1644,576,1290,17609,354
20560,12,608,1225,480,8425,128
18604,19,813,1259,578,27545,235
15489,3806,82039,1312,49158,281797,32881
39042,33,501,847,392,6677,109
54511,3,30,540,22,4233,8
33687,1,14,976,14,3101,0
14766,114,3373,1322,2146,39359,1227
52406,665,8365,607,6630,36915,1735
66882,66,1894,161,1606,11245,288
13866,72,3686,1334,2054,44664,1632
62732,62,400,279,284,6493,116
22423,286,4165,1195,2820,17198,1345
27830,11,261,1082,223,23242,38
5702,108,2829,1414,2101,33404,728
25668,154,3675,1130,2311,32280,1364
52553,264,4174,602,3245,23385,929
29389,18,1136,1052,870,32100,266
18957,85,1034,1253,871,48528,163
27620,1375,23785,1086,15331,149587,8454
37944,3,70,871,38,5804,32
38147,4,148,865,117,34173,31
10963,49,939,1368,613,12427,326
68762,4,92,100,65,3428,27
30875,13,498,1023,320,6682,178
13640,37,1073,1337,588,17156,485
36209,19,391,917,318,16588,73
64549,47,332,228,292,7733,40
6387,16047,1438693,1405,801169,1616275,637524
19936,1924,50192,1235,35201,188229,14991
15684,2,73,1309,49,3183,24
40747,15,232,823,181,8251,51
14616,344,10347,1324,7256,92801,3091
65005,3,64,213,53,3383,11
22151,85,3522,1199,2039,18618,1483
15319,23,530,1315,359,12920,171
62475,33,469,286,344,6088,125
33166,21,540,986,276,5647,264
38051,45,567,868,503,26912,64
18043,583,13818,1268,9467,126855,4351
66769,25,352,165,284,7275,68
2965,185,5972,1445,3979,53507,1993
30081,8,178,1038,130,8144,48
65960,12,73,190,62,5202,11
30856,106,2412,1023,2070,28576,342
14902,28,643,1320,522,11515,121
33662,21,320,976,278,11939,42
36491,338,4604,908,3299,30683,1305
57017,230,4922,466,3663,31426,1259
20506,37,1222,1225,736,9483,486
26781,12,199,1105,139,7955,60
12172,37,867,1357,511,5212,356
21855,50,1340,1202,946,23953,394
64370,7,133,233,99,3823,34
27754,94,1189,1084,834,15075,355
65117,163,2002,211,1566,10817,436
6591,94,2003,1402,1460,15870,543
6602,109,2441,1402,1742,24566,699
27821,6,108,1083,64,4404,44
2951,233,4870,1446,3338,54529,1532
38236,685,14764,863,11603,35032,3161
34951,227,2960,948,1950,48205,1010
49633,346,10766,684,8407,140628,2359
4775,27,756,1425,584,22740,172
34789,226,1621,952,1187,20233,434
8082,28,2225,1384,1491,23929,734
32261,41,452,1002,263,3943,189
65978,173,6318,190,5118,35768,1200
55305,1,22,514,21,3029,1
45530,974,11472,757,9854,159536,1618
51660,436,4022,631,2897,27548,1125
16488,22,508,1296,355,13859,153
9577,720,20974,1377,13138,75259,7836
30809,22,480,1024,367,16273,113
28328,50,1387,1072,888,9221,499
54075,225,1920,555,1393,36656,527
7756,27,1885,1387,1131,38719,754
43939,41,882,775,738,21721,144
27328,9,472,1093,307,25294,165
49267,29,380,694,274,4383,106
11954,24785,1065857,1359,689611,2885024,376246
57291,2507,27847,459,21725,123096,6122
30413,22,471,1032,295,4215,176
35261,2,103,940,77,8718,26
48826,34,507,661,407,13239,100
17159,26,496,1285,300,9265,196
35259,10,260,940,167,6890,93
13583,31,1215,1338,694,16204,521
27845,1372,23677,1082,14729,103613,8948
28357,21,642,1072,399,12029,243
38698,38,584,851,430,13802,154
30831,5,256,1024,163,9589,93
37927,246,6058,872,4482,105204,1576
14327,271,6678,1327,4870,56919,1808
2966,155,6069,1445,4039,31469,2030
34487,18,201,960,119,7477,82
16277,7,409,1300,274,27657,135
15783,6,382,1308,251,25037,131
56719,22,283,474,212,4697,71
13656,188,3418,1337,2594,26731,824
15558,26,1200,1311,788,10616,412
53906,353,6423,561,4333,54793,2090
26895,39,672,1103,585,12217,87
15386,1032,32037,1314,17410,206229,14627
25274,223,2518,1138,1526,20722,992
67227,60,1611,148,1302,11775,309
16913,59,1299,1289,792,12599,507
60858,2,9,339,8,3290,1
34177,26,968,966,628,17614,340
22314,221,4685,1196,3519,37162,1166
20051,18,322,1233,237,9933,85
68418,53,534,112,396,5428,138
51110,39,379,646,293,6352,86
33225,4,121,984,74,3861,47
13889,80,3375,1334,2003,20952,1372
48858,2189,40666,707,28489,140603,12177
68458,16,271,110,203,4690,68
19297,380,6904,1246,4389,64157,2515
35115,227,3613,944,2812,59933,801
20531,16,460,1225,329,5726,131
56200,591,4980,489,4425,47019,555
8397,96,1121,1382,743,10452,378
11551,328,8447,1363,4830,36122,3617
29681,119,3464,1047,2111,23058,1353
68769,3,127,99,55,4458,72
9170,12,423,1379,241,8211,182
11050,10172,335832,1367,187745,1328262,148087
21835,0,0,1203,0,7423,0
11401,43,2045,1364,1309,49331,736
55335,0,96,513,68,5541,28
53635,5,50,570,40,2666,10
50024,22,381,674,268,6833,113
16860,53,1949,1290,1384,53019,565
11168,70,802,1366,513,14374,289
57597,8,104,451,84,9805,20
17094,64,2340,1286,1790,35933,550
56106,0,13,492,13,1330,0
49727,466,4947,680,4006,42480,941
65997,12,104,189,86,4918,18
54545,207,2263,538,1823,30014,440
51865,47,641,625,493,12143,148
34576,171,5085,958,2886,22377,2199
37763,5,162,875,119,8141,43
45449,0,144,758,102,4232,42
56243,45,530,488,412,7663,118
47327,12764,228483,735,177213,904967,51270
56469,21,327,481,245,13643,82
52622,14,269,599,208,28198,61
11003,11,364,1367,213,9590,151
60446,34,373,355,283,5085,90
57868,925,15828,442,12243,55953,3585
26101,10,322,1120,291,21412,31
1487,10,814,1458,527,14058,287
49625,19,300,684,224,13007,76
53549,97,1142,573,861,11492,281
32429,144,1619,999,1041,12332,578
1419,160,5660,1458,4073,164892,1587
31635,115,4464,1011,3183,38507,1281
5822,55,1172,1412,820,19307,352
21706,55,1294,1204,830,14287,464
10821,20,1005,1369,649,14457,356
68053,270,4479,124,3875,33219,604
53627,49,581,570,476,12243,105
61233,786,10582,325,8579,44892,2003
65371,324,5062,205,4349,38527,713
37200,80,1434,891,1225,15445,209
40672,17,563,825,389,11415,174
35248,256,2405,941,1851,18037,554
26683,24,378,1107,217,8685,161
25261,4251,127507,1139,85719,505393,41788
43585,1,22,778,20,3090,2
42364,340,4495,794,3751,54666,744
29856,2,111,1043,56,4585,55
23024,101,2248,1184,1623,19908,625
62010,99,2112,301,1678,17816,434
11372,30,1553,1365,782,17655,771
29236,27,930,1055,670,8795,260
56354,182,1270,485,990,10945,280
64089,5,49,242,32,1244,17
14929,111,5085,1320,3332,78211,1753
26270,259,6198,1117,4230,96203,1968
18027,455,8638,1269,5195,43175,3443
42,272,15002,1471,9842,237008,5160
26439,30,635,1113,379,11896,256
61719,1023,31044,311,24949,129762,6095
7904,90,3567,1385,2454,63431,1113
24602,40,825,1153,573,11506,252
68914,8,106,94,68,2868,38
50228,15,180,669,142,6977,38
22565,8279,354291,1192,223297,842438,130994
30687,50,898,1027,788,16081,110
65539,4,87,201,71,4844,16
12123,40,1056,1358,708,19298,348
53504,15,264,574,201,3872,63
10916,0,22,1368,17,8887,5
67590,26,326,138,251,9418,75
8538,27,664,1382,433,8877,231
24506,249,5264,1155,3403,23661,1861
9786,49,2878,1376,1810,37863,1068
36761,788,13823,904,11222,89474,2601
60106,38,553,368,477,8449,76
58270,585,10151,429,8371,51410,1780
62132,246,4470,296,3389,57040,1081
5441,167,20698,1416,13770,69924,6928
23237,2,101,1181,78,5195,23
68237,87,1570,118,1291,27448,279
25822,97,3862,1127,2562,37210,1300
29973,146,3103,1041,1969,22024,1134
53002,24,272,587,212,7647,60
8771,178,4072,1381,2584,29726,1488
36420,50,1428,911,1106,17073,322
8223,416,8702,1383,5297,32309,3405
59220,215,2038,398,1726,20551,312
58558,30,312,419,253,6334,59
7201,275,14606,1394,8210,99340,6396
16279,4,84,1300,41,6068,43
31967,437,6203,1006,4392,41255,1811
52854,3,63,591,49,3999,14
31528,31,905,1013,526,14612,379
58510,3644,56001,420,43884,156624,12117
26118,40,1181,1120,782,22146,399
29224,84,2553,1055,1518,14449,1035
19628,88,2199,1241,1501,23301,698
3496,152,6902,1441,4774,77535,2128
19312,44,1156,1246,849,24571,307
1278,16,897,1459,589,22935,308
67436,57,2709,144,2178,35173,531
8979,570,11739,1380,7893,45445,3846
60489,100,1057,353,831,17732,226
32281,27,1157,1002,703,12464,454
16458,93,2597,1296,2052,47099,545
8958,165,5641,1380,3388,33164,2253
62597,7,65,283,55,4002,10
52966,60,1031,588,856,9117,175
60198,19,490,364,391,13919,99
65929,42,765,191,619,14604,146
58090,6,157,435,124,6437,33
63751,3,93,253,51,6527,42
63943,7,119,247,90,2007,29
28417,164,7406,1071,4971,21902,2435
2486,2,185,1450,113,13870,72
27713,28,846,1085,632,12474,214
16991,3515,88286,1288,59836,407511,28450
67300,3,138,147,53,3716,85
36551,17,517,906,404,8228,113
19282,0,0,1247,0,6326,0
23643,204,5422,1174,3499,38377,1923
25965,13,684,1124,396,7416,288
3674,11,186,1439,128,19943,58
18865,187,4220,1254,2848,51950,1372
66142,14,189,184,145,6529,44
13809,0,0,1335,0,20667,0
36973,45,667,898,499,12250,168
60607,73,1620,349,1306,17777,314
23402,45,1303,1178,862,13170,441
55538,108,1071,508,811,14726,260
41752,41,444,806,355,5190,89
28825,75,1292,1063,848,14925,444
22737,6,341,1189,237,16200,104
20893,93,1402,1219,1029,30629,373
43113,24,429,784,310,9576,119
13558,246,8716,1338,5588,63123,3128
35464,92,1186,935,888,14479,298
65201,54,490,209,391,14202,99
21997,189,3736,1200,2129,28197,1607
27810,4328,74947,1083,45295,305497,29652
67617,7,70,138,60,3111,10
24222,3183,69384,1162,44774,501406,24610
29377,136,4296,1053,2864,67011,1432
29488,14,985,1051,585,9638,400
36244,15,154,916,139,8646,15
15214,6,170,1316,124,12054,46
60127,223,4205,367,3334,36784,871
21340,10,744,1210,498,38056,246
64971,4,56,214,35,6184,21
4973,101,4069,1422,3070,40382,999
23978,22,914,1167,603,18372,311
24395,33,1020,1158,717,12518,303
30324,11,302,1034,195,10729,107
4185,161,4462,1433,2983,73388,1479
12760,117,3222,1350,1785,27402,1437
17326,146,4574,1282,3470,56685,1104
56600,27,347,477,298,10293,49
622,136,3582,1464,2334,37009,1248
19532,31,631,1242,421,12948,210
51184,279,2916,644,2314,24815,602
42013,4,166,802,130,4389,36
6543,45,2365,1403,1494,16464,871
24686,5,254,1151,182,18676,72
42001,343,5973,802,4722,99435,1251
63466,52,600,260,411,5795,189
9127,253,6607,1379,4638,35901,1969
50217,1175,22564,669,17222,76013,5342
34030,21,492,969,376,24008,116
7673,18,448,1388,277,13279,171
16129,86,1586,1302,1074,23884,512
36056,529,10520,921,8564,33664,1956
27233,8,177,1096,123,12316,54
8860,86,3945,1380,2499,40071,1446
29059,762,15273,1059,10456,81564,4817
31222,2361,46893,1017,31742,227415,15151
26327,53,891,1116,714,52675,177
9888,137,2562,1375,1695,33391,867
36791,18,338,903,208,15478,130
4745,44,833,1425,617,19303,216
23625,4222,120176,1174,74048,658177,46128
18983,61,1182,1252,838,10163,344
24911,44,1191,1146,801,39403,390
4420,479,19245,1430,12383,88077,6862
29361,6,330,1053,259,7577,71
63862,14,207,250,156,5427,51
33476,12,246,980,161,21990,85
39991,30,847,835,650,8981,197
21087,41,1103,1215,706,28832,397
41893,40,647,804,482,26386,165
35011,8,288,947,185,7141,103
36099,496,6745,920,5100,55473,1645
55470,74,1204,509,1033,14373,171
49040,5338,88393,701,60307,242622,28086
56456,475,3946,482,3562,38534,384
34545,16,400,959,258,9749,142
3182,410,16328,1443,9917,48828,6411
1450,438,12891,1458,7094,72649,5797
53121,251,6020,582,4911,36701,1109
65432,99,1182,203,1021,15269,161
58501,151,2097,421,1525,33256,572
10231,30,661,1373,396,27801,265
67344,336,5297,146,4526,74108,771
5446,4,394,1416,289,7191,105
45578,6092,149483,757,114256,748967,35227
53807,8,189,565,104,12746,85
40082,9,124,833,88,7159,36
21870,88,1251,1202,786,15719,465
34409,19,644,961,440,10486,204
2831,15,640,1447,428,22997,212
1133,17,436,1460,312,4937,124
54078,4587,54019,554,37598,153313,16421
22185,17,602,1198,349,9793,253
59512,42,539,388,423,9024,116
17244,21,650,1283,490,9587,160
7220,160,4044,1394,2726,27126,1318
32527,39,1399,997,958,28502,441
18738,3318,101996,1256,70398,245107,31598
64366,31,552,233,470,15789,82
21261,642,18775,1212,12595,95944,6180
63287,69,726,265,548,12210,178
48387,859,10742,721,7941,107226,2801
32511,17,496,997,302,7396,194
32020,10,380,999,273,31480,107
16571,67,968,1295,658,20697,310
62320,8,148,291,91,3703,57
18401,3,244,1262,167,7844,77
60671,35,419,346,275,4479,144
33004,30,667,988,475,11225,192
19293,230,3506,1246,2324,48793,1182
46141,49,551,748,396,13452,155
22864,42,1145,1187,891,19669,254
25908,129,1856,1125,1078,13609,778
66201,330,4241,182,3270,32630,971
4725,39,1189,1426,739,16464,450
18170,38,1348,1267,1046,23379,302
5027,818,17149,1421,10934,138575,6215
31416,65,872,1015,603,14982,269
32126,2622,48678,1004,31406,297351,17272
32996,28,877,989,580,7879,297
48732,8,240,711,175,7435,65
7084,523,12301,1396,7719,77433,4582
39799,32639,888120,838,588773,2362635,299347
55924,5847,103087,495,75884,574708,27203
44587,416,7862,768,5987,90821,1875
12415,11,617,1354,322,11467,295
365,209,8948,1467,5540,57188,3408
476,7,364,1466,229,15921,135
20163,23,1152,1231,869,13735,283
28786,109,2492,1064,1563,29830,929
28354,31,901,1072,575,30041,326
40376,3,89,828,69,3828,20
30559,0,67,1029,19,3321,48
59338,15,449,394,307,14610,142
39637,24,308,839,240,5255,68
32548,52,1199,997,805,46858,394
8851,30,1072,1380,656,34230,416
36431,2435,54329,910,41913,292351,12416
29728,141,3209,1046,1833,26715,1376
31600,34,889,1012,601,21389,288
39852,65,710,837,573,16588,137
28833,25,1028,1063,656,32922,372
49859,242,4129,678,3435,39871,694
55562,20,226,492,173,8401,53
3406,120,5870,1441,4007,124671,1863
7003,16,637,1397,394,26901,243
59070,61,811,403,617,19610,194
23832,641,38996,1170,24983,96337,14013
33023,29,848,988,599,9709,249
10938,352,17803,1368,10137,94245,7666
57235,2279,45650,460,35953,133790,9697
35048,1423,30867,946,22939,245002,7928
26187,145,3917,1119,2533,21695,1384
43581,24,440,778,294,5737,146
2537,26,734,1450,545,26232,189
15350,85,4473,1314,3429,18859,1044
52951,6,136,588,104,3506,32
37335,188,2316,887,1816,13220,500
29376,15,431,1053,348,24671,83
29732,60,1598,1046,879,17609,719
63367,2,5,263,5,1370,0
43077,95,1141,785,730,8609,411
408,171,5878,1466,4049,32799,1829
63912,48,874,248,672,6893,202
34792,82,1071,952,697,13534,374
20647,13,933,1223,584,14866,349
63467,22,383,260,279,5334,104
18709,7,331,1257,220,11076,111
3242,6,256,1443,197,7072,59
58622,300,4956,417,3853,11038,1103
13108,5,273,1345,139,5569,134
62556,521,7919,284,6577,49942,1342
59119,238,4639,401,3478,20666,1161
6156,112,4485,1408,3010,72481,1475
54422,22,225,543,188,8987,37
10282,7,345,1373,208,10210,137
63239,1,18,266,12,3504,6
59851,158,2374,377,1874,31244,500
53148,3588,69654,582,55641,271024,14013
32469,45,1011,991,676,14402,335
50057,3,113,673,91,6146,22
10677,211,10213,1370,6302,70231,3911
9650,283,7038,1377,4841,39180,2197
12414,0,0,1354,0,12555,0
42890,235,3863,788,3188,30010,675
29710,65,1182,1047,712,6216,470
61179,16,127,327,101,4377,26
40592,2819,39507,825,28361,210982,11146
20708,165,2559,1222,1744,25297,815
8638,87,3026,1381,2154,20406,872
15333,76,2663,1314,1739,35417,924
38688,50,1851,852,1380,25332,471
6658,29,889,1402,652,12331,237
22174,5,140,1198,104,3426,36
54914,254,5005,525,3876,42103,1129
1036,2700,63060,1461,43982,205827,19078
37020,45,910,896,723,14128,187
32290,53,1122,1001,823,13367,299
55837,2,44,500,31,3988,13
29014,36,1198,1060,749,8476,449
5208,124,2581,1419,1808,28117,773
54208,373,4218,551,3587,59060,631
28752,6,148,1065,88,2690,60
32563,220,3920,996,2588,18842,1332
9655,898,34532,1377,19555,122364,14977
67250,6,76,149,53,6989,23
12611,183,3818,1352,2253,51645,1565
55783,669,6264,501,5062,27972,1202
32448,6516,97543,999,62277,303704,35266
5224,20,1113,1419,687,16650,426
60080,61,865,366,655,8304,210
16235,268,5672,1300,3990,68242,1682
65607,279,3405,199,2790,26173,615
13090,124,4693,1345,2876,99939,1817
11417,6,852,1364,467,9939,385
34843,137,3087,951,2302,35754,785
22936,18,1092,1186,707,12323,385
30143,62,1383,1037,876,16620,507
30735,66,1148,1026,784,6906,364
4012,12,197,1435,138,5782,59
13408,0,39,1341,33,1838,6
11823,20,668,1361,393,9356,275
50506,7,117,661,85,5296,32
11108,306,15937,1367,8980,68987,6957
34647,34,795,956,602,10601,193
10090,15,392,1374,286,13675,106
699,160,4292,1464,3013,67195,1279
22317,23,710,1196,527,11561,183
22857,37,616,1187,392,4933,224
8506,223,17473,1382,10618,97802,6855
33822,437,7727,973,5782,73159,1945
5931,9,268,1411,188,21567,80
14502,75,4297,1325,2946,26184,1351
14065,533,14490,1331,10218,126177,4272
22420,1625,26167,1195,15711,120797,10456
24485,232,6839,1156,4664,54991,2175
53056,55,921,585,744,13321,177
4489,1504,40134,1429,25765,211861,14369
63995,10,263,245,205,7273,58
16259,104,2895,1300,1792,18963,1103
15809,121,1986,1307,1266,32000,720
30800,31,1035,1024,592,11413,443
5155,44,1193,1420,773,11416,420
23478,6,280,1177,184,7908,96
8698,304,12675,1381,7797,121269,4878
24450,206,1638,1157,1243,20880,395
16054,25,834,1303,567,9836,267
20511,4,98,1225,85,6013,13
8540,389,11930,1382,8279,91129,3651
4902,45,949,1423,590,19497,359
28781,199,3200,1064,1791,21246,1409
4406,293,15203,1430,8253,72399,6950
12196,3,236,1357,128,5753,108
10466,149,4053,1372,2908,45900,1145
4471,480,52132,1429,31010,161285,21122
66966,26,280,158,230,5711,50
44183,24,393,772,255,10860,138
53841,17,146,563,120,4322,26
22528,62,2492,1193,1607,46389,885
60832,29,301,340,235,2898,66
8770,6,229,1381,133,6428,96
33072,49,1589,987,1065,21527,524
3170,12,345,1444,204,11411,141
57576,23,344,439,266,19627,78
30154,903,18456,1037,11121,55544,7335
22942,11,352,1185,231,5519,121
63234,33,518,267,462,10586,56
10198,754,28362,1373,17675,147684,10687
46823,340,4438,742,3502,67986,936
23379,6,344,1178,230,20580,114
49104,54,708,699,510,8673,198
17866,10,262,1271,190,5511,72
28674,40,684,1066,462,15493,222
58662,4,160,416,73,11203,87
18373,73,2774,1263,1807,73691,967
52297,124,1369,610,1187,26604,182
22963,10,452,1185,273,11876,179
22052,7,135,1200,94,4327,41
28698,96,2694,1065,1944,32398,750
38386,10119,244056,859,179026,948089,65030
37113,91,676,893,535,14467,141
32619,189,6210,996,3621,28458,2589
23344,3,54,1179,39,8513,15
16916,520,15530,1289,9893,68269,5637
21491,24,938,1207,680,16198,258
31889,14,538,1007,332,4732,206
7190,11,523,1394,313,19551,210
34130,51,398,967,335,45801,63
33128,115,2032,986,1296,18413,736
29035,68,2229,1059,1249,14162,980
21994,134,3061,1201,2020,31666,1041
22508,9,372,1194,286,11518,86
216,60,2134,1468,1506,19264,628
39813,235,3489,837,2969,24999,520
60806,28,312,341,225,11027,87
32673,33,1517,995,924,12156,593
56716,25,240,474,170,9706,70
31934,11,375,1007,244,10718,131
21916,53,1750,1201,1068,36111,682
29443,1263,31237,1051,22058,163976,9179
68539,20,317,107,309,14307,8
205,18,1526,1469,990,31401,536
10624,14,663,1371,396,23891,267
48642,6,90,713,69,3128,21
54867,4873,91489,525,66162,425293,25327
48730,1066,33976,711,26828,203989,7148
26930,18,423,1102,291,22891,132
29499,9,182,1051,120,14836,62
2597,89,2400,1449,1546,26884,854
29512,2064,37246,1050,23358,100051,13888
5223,312,7919,1419,5198,40416,2721
13047,32,1485,1346,1050,53363,435
49145,7,85,698,66,2673,19
4424,555,24482,1430,15125,145599,9357
31724,8752,180983,1010,111096,665474,69887
9104,21,579,1379,404,6710,175
47052,267,2749,739,2228,36787,521
13223,317,20102,1344,12248,90804,7854
51748,52,989,628,832,16135,157
44601,63,1761,768,1430,19026,331
19381,4167,123162,1245,66328,344734,56834
19665,7054,260041,1240,161447,968185,98594
18806,12,354,1255,271,13870,83
29387,72,1984,1052,1635,72319,349
37238,87,2035,890,1574,21075,461
2246,35,1327,1452,959,22006,368
8327,49,880,1383,548,12087,332
56099,364,6578,492,5256,50411,1322
32308,305,5320,1000,3585,47084,1735
47532,215,5846,733,4927,51737,919
27672,87,2264,1085,1447,27518,817
33827,5,121,973,97,14201,24
15381,215,5418,1314,3866,50106,1552
31402,156,3406,1015,2185,39996,1221
37175,291,3256,892,2636,46744,620
7395,381,7039,1392,4258,42313,2781
21915,5,363,1202,226,16411,137
3780,1286,29533,1437,20209,180946,9324
1082,184,5475,1461,4165,45287,1310
17757,69,2741,1274,1977,51896,764
441,697,24966,1466,15823,117714,9143
56183,63,638,489,498,8091,140
34532,30,985,959,659,10617,326
55018,8,171,521,95,4797,76
34996,5343,87454,947,59073,320581,28381
15146,278,7358,1317,5123,40061,2235
30919,155,2437,1022,1634,23361,803
19615,6,290,1241,202,8453,88
17619,157,2529,1277,1874,17008,655
54346,2358,49443,541,41067,350149,8376
1307,77,3194,1459,1984,110290,1210
35653,1,30,932,25,3088,5
13537,23,815,1339,524,10093,291
16048,70,2190,1303,1341,10686,849
19939,13,489,1235,378,28077,111
5701,1119,71709,1414,38720,187684,32989
15744,5,211,1308,140,19325,71
25117,13,638,1142,413,26542,225
61532,10,106,317,63,4499,43
56188,85,815,489,698,12247,117
17650,15,432,1276,309,18445,123
29126,1,197,1057,120,6818,77
54962,578,6928,523,5478,75241,1450
21575,137,1816,1206,1212,19842,604
27801,0,0,1083,0,19766,0
55846,282,4723,499,3773,29187,950
50818,50,569,654,490,7469,79
56432,23,319,482,228,5715,91
23555,195,5474,1175,3628,48157,1846
22033,8508,277803,1200,159616,580348,118187
47616,12,178,732,138,6547,40
30178,46,2149,1036,1251,33083,898
37384,8,213,886,188,21307,25
56694,31,247,475,201,5276,46
44414,2,19,769,15,2275,4
48772,8,394,709,315,3276,79
60347,89,1189,359,841,14308,348
25478,224,3597,1134,2271,26944,1326
64307,6,89,235,70,5944,19
13808,54,818,1335,438,12161,380
66392,16,227,177,165,5953,62
55484,27,300,509,242,6768,58
53838,2,21,564,12,3999,9
5205,285,9926,1419,6248,80210,3678
37373,4,84,886,70,6050,14
28106,345,6553,1077,4245,57757,2308
53656,43,795,569,500,12280,295
67440,4,45,143,38,2317,7
10786,0,376,1369,214,14659,162
22421,289,6728,1195,4819,64699,1909
11137,51,1454,1366,788,26573,666
15178,47,1095,1316,735,6878,360
23956,244,5663,1168,3788,29430,1875
49010,304,4893,702,3469,26694,1424
34304,138,3801,963,3124,63227,677
56553,2,31,478,27,6103,4
21629,82,1379,1205,887,25786,492
4162,640,14989,1433,9948,67312,5041
26548,41,1122,1111,733,24036,389
14660,149,2918,1323,2129,35261,789
61028,231,3461,333,2805,26577,656
17491,10854,198778,1279,118031,440872,80747
58338,2385,81185,427,61766,395859,19419
67008,203,3496,157,2906,34603,590
211,53,6359,1469,3959,35487,2400
48164,21,226,725,170,10850,56
15315,0,0,1315,0,19768,0
27556,4,94,1088,63,9624,31
68040,45,346,124,279,4641,67
31181,971,27771,1018,17969,120651,9802
40726,46,1165,823,937,24505,228
18202,590,30697,1266,21871,182896,8826
29545,135,4418,1050,2864,23456,1554
26009,13,840,1122,532,9363,308
68493,903,10583,108,8392,33907,2191
41147,37,440,816,377,10750,63
43577,48,499,778,386,5979,113
16628,82,2832,1294,2053,49185,779
3710,6,277,1438,177,22340,100
44708,28,493,767,397,30756,96
42484,25,412,795,338,8436,74
12860,41,2334,1348,1295,56471,1039
14365,245,8096,1327,4700,40582,3396
237,138,3796,1468,2483,28251,1313
49843,48,376,679,268,3689,108
13610,128,4679,1338,2932,21004,1747
59213,17,300,399,237,4660,63
60601,74,1411,349,1138,26493,273
62807,62,493,277,389,4384,104
22721,13,740,1189,447,10182,293
14873,30,1530,1321,882,12162,648
52464,39,320,604,238,6376,82
60437,15,161,356,120,4980,41
51179,103,1879,644,1375,31913,504
64739,28,482,223,372,19041,110
9392,70,3688,1378,2397,36006,1291
58293,6,49,428,40,3937,9
21294,161,9615,1211,6080,111650,3535
3897,10,622,1436,447,13777,175
54011,52,854,558,677,14111,177
26521,59,2028,1112,1211,19312,817
27428,9,143,1091,108,6929,35
1647,3548,98483,1457,59825,181462,38658
8030,12,631,1384,331,7432,300
68147,6,37,121,25,3689,12
4460,14,1538,1430,975,35916,563
39979,32,476,835,393,21384,83
51469,906,11780,636,9023,76105,2757
17486,117,6218,1279,4267,55168,1951
25954,9,415,1124,225,9840,190
6285,109,7007,1407,4266,50585,2741
21542,2148,191934,1207,102887,193162,89047
57197,25,348,461,285,6330,63
1826,2083,42070,1455,26739,78933,15331
21643,219,5025,1205,3523,53621,1502
2964,64,2539,1445,1852,45021,687
14564,156,5856,1324,4225,30619,1631
22894,2429,82354,1186,56946,325626,25408
26005,10,723,1123,448,14108,275
9587,96,4368,1377,2748,35723,1620
51091,41,436,646,396,8360,40
37598,83,1070,879,837,19349,233
28896,14,919,1062,552,25680,367
12625,8784,197138,1351,116339,609785,80799
25326,243,8912,1137,6269,48574,2643
10464,24,1512,1372,914,16565,598
12392,59,2332,1354,1577,27958,755
62439,1,8,287,7,1521,1
22267,120,3472,1197,2511,33871,961
51175,86,974,644,852,22887,122
26468,1337,26264,1113,14734,156750,11530
59287,37,265,395,217,6502,48
55510,62,723,508,543,7121,180
15060,8,350,1318,239,16533,111
60399,79,895,357,652,14626,243
35805,58,1706,928,1279,17560,427
60696,27,160,345,125,6019,35
64329,73,1329,235,1074,12675,255
27716,73,1617,1085,844,10370,773
5182,8,345,1419,237,26863,108
1493,7,393,1458,284,14802,109
60287,126,3105,361,2196,26169,909
24475,1014,17820,1156,11997,100588,5823
4599,7,255,1427,193,8246,62
7638,454,13511,1389,10672,166543,2839
42676,10,147,791,125,6133,22
58518,14,263,420,161,3223,102
15814,10,294,1307,187,7831,107
16119,4,106,1302,82,10298,24
25637,14,300,1131,266,10738,34
66005,10,163,189,114,2939,49
27341,66,2908,1093,1609,60063,1299
49131,178,3624,698,2054,30001,1570
54618,26,140,535,104,4698,36
58650,5,103,416,61,4496,42
16838,202,10659,1290,7051,63351,3608
30177,18,427,1036,259,5888,168
49455,80,922,689,710,17146,212
52607,285,1945,600,1716,112465,229
65418,73,1154,204,1018,15382,136
64612,758,8701,226,7109,51749,1592
9720,4952,172231,1376,89911,349517,82320
55469,23,288,510,205,5812,83
50240,277,4727,668,3927,41674,800
62727,32,358,279,290,6097,68
58777,52,543,412,427,15665,116
16698,70,1839,1293,1456,20509,383
12900,66,1968,1348,1158,25751,810
23424,244,4239,1177,2790,14125,1449
38537,53,721,855,576,14151,145
60622,11,183,348,153,10768,30
31028,78,2510,1020,1544,19020,966
27804,27,595,1083,486,8604,109
9948,121,4289,1375,2715,36273,1574
33617,68,1275,977,990,28799,285
13596,202,6356,1338,4215,47880,2141
21576,837,18979,1206,10628,176507,8351
40235,77,798,831,631,7224,167
14849,6,591,1321,372,8469,219
34959,809,16245,948,12781,134660,3464
57253,37,599,460,458,10826,141
14455,153,5402,1325,3833,29607,1569
19989,174,3762,1234,2515,18255,1247
16078,99,2702,1302,1838,18106,864
10001,158,8214,1374,4746,24666,3468
19695,48,793,1239,542,15118,251
57921,13,183,441,134,5846,49
62265,9,149,292,89,8026,60
48537,21,294,717,203,5369,91
20929,134,3444,1218,2218,28171,1226
21422,237,4570,1209,3027,16909,1543
6359,14,602,1406,442,20260,160
7644,18,859,1389,551,27515,308
2466,17,257,1450,203,5053,54
2701,209,5180,1448,3373,47034,1807
19426,42,1248,1244,863,9249,385
51753,81,889,628,677,15321,212
37075,43,1102,895,872,21064,230
15566,7,324,1311,198,8562,126
58714,45,704,414,556,7093,148
10844,15,685,1369,419,34852,266
68065,58,667,123,512,6226,155
2366,38,915,1451,710,10283,205
31340,10,315,1015,203,26583,112
36795,103,1948,903,1681,27875,267
54111,64,859,554,663,9546,196
63552,1749,26044,259,20987,170400,5057
57296,458,7843,458,5771,60314,2072
41554,35,634,810,518,13572,116
30259,14,483,1035,335,18281,148
593,244,11707,1465,7694,57519,4013
25175,13,118,1141,89,3377,29
33,579,12106,1472,7237,102237,4869
22032,65,2066,1200,1238,17674,828
36309,71,1316,914,1051,23255,265
31135,39,2175,1019,1442,30738,733
1893,10,314,1455,219,16321,95
55917,95,1128,497,925,11538,203
33474,32,996,980,639,9592,357
5722,40,990,1413,608,41196,382
8065,9792,242028,1384,135397,608281,106631
66836,257,3459,163,2906,41309,553
50595,2427,57142,659,42483,119507,14659
16606,108,2840,1295,1768,31306,1072
37661,56,671,878,477,6979,194
21140,18,617,1214,417,16524,200
2187,77,4664,1452,3193,50894,1471
59657,53,651,383,566,7521,85
36396,383,6200,911,4926,41709,1274
24266,261,4704,1161,3006,26478,1698
66126,850,10005,185,8541,60751,1464
53583,18,202,572,154,7621,48
9278,39,1844,1379,1175,21236,669
60303,37,560,360,425,5773,135
45940,17,301,753,239,6206,62
29592,39,1668,1049,930,13723,738
4025,19,526,1435,332,27350,194
4201,194,4533,1433,3100,51191,1433
7669,1,101,1388,66,12272,35
13329,67,1539,1342,1025,25818,514
59087,7,114,403,86,5746,28
63604,43,478,257,359,7221,119
55551,440,7335,507,6089,58024,1246
58478,2719,89473,418,67349,235631,22124
22162,17,327,1198,249,5879,78
59635,15,119,384,107,4310,12
26692,17,776,1107,459,11405,317
32039,26,745,1005,462,5627,283
68757,215,4454,100,3795,35322,659
30933,362,9978,1022,6923,70296,3055
2313,220,7552,1451,5115,30412,2437
65766,64,918,195,793,14622,125
26783,130,2997,1105,1908,46645,1089
60153,76,1475,366,1160,20273,315
3375,2130,69660,1442,38211,138583,31449
11970,105,2056,1359,1307,15767,749
54149,1,23,553,20,2281,3
5609,13,503,1415,335,14872,168
30094,193,6116,1038,4360,54036,1756
15271,13,452,1315,285,19052,167
713,13,470,1464,329,25349,141
59334,70,1039,394,760,9289,279
56223,18,173,489,136,11086,37
51959,6,119,622,84,6073,35
52814,58,1419,592,875,13163,544
9129,60,2221,1379,1321,11971,900
2667,0,77,1449,60,18179,17
30290,481,12102,1034,8976,96613,3126
62571,41,289,283,233,4250,56
61108,52,812,330,668,21397,144
17479,6,324,1279,233,14722,91
26627,4,202,1108,113,4925,89
51823,790,18524,626,14876,68766,3648
53624,14,109,570,90,10116,19
28661,20,758,1066,490,16609,268
19779,39,830,1238,606,15048,224
63404,160,2315,262,1835,24706,480
6964,0,102,1398,66,14193,36
20504,18,501,1226,341,22168,160
63053,27,347,271,274,6309,73
5231,1108,24169,1419,15673,73751,8496
35752,1,22,929,14,2275,8
36188,1215,23242,918,19859,198444,3383
22200,12,585,1198,378,10797,207
53469,172,1752,575,1457,17898,295
433,18,332,1466,248,14261,84
28283,1774,23347,1074,17477,106749,5870
53664,352,3046,569,2212,20151,834
66261,3,67,181,50,4733,17
63802,102,1973,251,1591,21000,382
33789,3,66,974,43,8286,23
2799,75,1326,1447,958,28681,368
48779,8,236,709,190,6939,46
67910,16,218,128,173,8501,45
12352,33,1774,1355,1116,49504,658
67050,58,951,156,784,8614,167
92,381,10761,1470,5912,62067,4849
20043,49,1483,1233,875,10819,608
37821,33,917,874,706,19392,211
47173,1786,28774,736,24113,108824,4661
13977,32,484,1333,284,6305,200
21256,3876,118965,1212,85494,486574,33471
22915,20,955,1186,661,33305,294
66166,4,54,183,44,1533,10
2317,5408,115920,1451,59817,198035,56103
1834,13,745,1455,449,28410,296
38092,19,516,867,455,13654,61
12436,311,10035,1354,6328,101596,3707
16255,6,477,1300,308,31401,169
52975,18,260,587,208,5425,52
16793,3,185,1291,125,7341,60
59746,12,71,380,43,4754,28
52609,18,207,600,149,7415,58
50101,159,2076,672,1206,16564,870
14378,49,2674,1326,1798,41221,876
50507,61,1337,661,852,10383,485
28679,8,288,1066,187,12655,101
51231,97,1596,643,1160,14648,436
23791,440,11634,1171,7996,62543,3638
25751,21,511,1128,326,10614,185
59033,73,1335,404,1113,14575,222
20029,104,3853,1233,2614,28954,1239
55531,60,732,508,569,6884,163
62185,140,2329,294,1795,10144,534
64702,22,696,224,566,8365,130
64133,16,134,240,108,3826,26
61957,17,194,303,140,4968,54
53362,64,806,577,646,20731,160
67062,18,264,156,201,7262,63
22105,48,1010,1199,663,10321,347
32434,60,955,999,732,9907,223
58436,0,0,423,0,5862,0
3833,61,2320,1437,1689,25924,631
63638,3,48,256,32,1839,16
34421,47,754,959,493,12853,261
50509,4,136,661,109,8086,27
65365,43,475,205,390,3187,85
13491,501,21477,1339,14112,110506,7365
33025,21,609,988,428,7607,181
19990,263,12763,1234,7753,123902,5010
50865,23,517,653,388,8300,129
28455,83,2813,1070,1825,34583,988
15617,55,1384,1310,953,12779,431
9144,30,909,1379,598,20780,311
21614,9,482,1206,313,4811,169
20132,166,3702,1232,2620,22391,1082
8220,4,192,1383,135,7223,57
52720,42,368,595,315,8245,53
59377,20,263,392,186,9359,77
45011,67,1044,763,757,10758,287
5511,110,4907,1416,2876,33349,2031
10477,46,946,1371,626,13179,320
58521,325,2776,420,2263,21111,513
62384,725,16249,289,12888,83459,3361
60931,9,209,337,140,4249,69
63694,59,680,254,599,16916,81
58329,1229,39256,427,31549,137910,7707
33092,3,76,987,58,6525,18
29478,103,4092,1051,2629,37560,1463
20987,2,125,1217,90,10786,35
1478,17,492,1458,344,13570,148
37306,23,591,888,442,13520,149
64798,4021,64562,221,51588,330241,12974
46341,172,1917,748,1526,39172,391
24709,1934,60250,1150,35046,504449,25204
31006,33,1586,1020,1019,20151,567
29999,195,5627,1040,3665,46653,1962
57423,24,308,455,260,8866,48
29231,100,4081,1055,2529,29262,1552
9586,37,418,1377,227,9570,191
41998,38,874,802,565,6264,309
19815,180,9448,1237,6701,73648,2747
34880,13,388,950,265,17276,123
4520,9,440,1429,262,11063,178
35396,7,127,937,92,6496,35
28840,4,121,1063,77,4933,44
41343,112,2228,813,1776,31500,452
31321,85,1989,1016,1263,20991,726
60812,5,103,341,85,4267,18
28281,15,229,1074,156,4474,73
19110,66,3366,1250,2395,34705,971
23568,339,6525,1175,4885,75581,1640
2541,46,2917,1449,2007,49455,910
64262,1346,19058,236,15279,121055,3779
54948,7,158,524,101,6015,57
61076,61,953,331,819,14016,134
8713,1,135,1381,75,6729,60
4369,137,2913,1431,1835,20294,1078
21254,341,6964,1212,4546,47423,2418
14586,72,2995,1324,2165,21447,830
16525,1198,20473,1296,16328,143846,4145
29657,104,1821,1048,1124,12749,697
30388,15,802,1032,474,11700,328
56074,84,1162,493,859,22386,303
33054,329,8926,987,6391,83179,2535
32678,129,4375,995,2855,23997,1520
18068,8,712,1268,538,14797,174
15087,78,1935,1318,1440,16600,495
16460,0,0,1296,0,31522,0
7636,38,1998,1389,1356,26699,642
16534,37,562,1295,412,14434,150
29884,80,1292,1043,891,11949,401
761,103,4677,1463,2993,34719,1684
53526,6,57,573,49,5271,8
65403,24,309,204,226,3658,83
29205,20,617,1056,404,9261,213
5650,34,1458,1414,1013,20062,445
24811,8,185,1148,139,11178,46
6879,47,3197,1399,2334,29263,863
41645,206,1933,807,1547,33358,386
12945,36,1547,1347,917,84839,630
30507,3,166,1030,112,14893,54
9346,35,980,1378,626,12247,354
58393,206,2903,425,2293,34074,610
58544,71,762,417,627,14990,135
31151,66,1153,1018,731,7832,422
45624,3,68,756,54,10802,14
21709,337,8885,1204,6008,58665,2877
15983,8899,319199,1304,248199,1271360,71000
64755,2,69,222,46,2942,23
63596,134,2470,257,1925,24741,545
67021,752,10798,157,8279,78705,2519
17536,1955,75102,1278,44667,303372,30435
32835,134,2981,992,1839,23732,1142
47217,109,1204,737,938,9885,266
62269,133,1135,292,868,14389,267
20494,84,2713,1226,1918,20015,795
13127,18,1310,1344,573,16658,737
23167,6,148,1182,127,4065,21
2115,34,2947,1453,2190,27485,757
32620,2,233,995,145,11775,88
63965,23,415,246,334,9599,81
43697,115,1435,777,1137,12704,298
29144,70,1836,1057,1152,10866,684
38338,4,183,861,128,8193,55
58741,2,41,413,28,5951,13
32777,294,3302,993,2432,34562,870
65126,10,54,210,43,3531,11
51954,113,1108,623,919,17379,189
37842,134,1918,874,1536,20963,382
34508,21009,431892,959,299393,1244154,132499
52789,11,189,593,145,7027,44
49038,1836,27385,701,20439,125499,6946
10124,10,332,1374,200,5470,132
5849,71,1818,1412,1174,33637,644
8682,29,1131,1381,738,11432,393
17508,9,297,1279,213,8020,84
6570,23,659,1403,407,17615,252
62103,34,257,297,226,7997,31
57201,67,878,461,677,8614,201
43809,203,3253,777,2429,63033,824
16981,609,14927,1288,10201,131606,4726
57961,70,1326,440,1130,17053,196
13642,138,3408,1337,1906,46226,1502
58722,22,217,414,159,6312,58
54267,29,427,549,354,5529,73
37476,62,874,883,648,9224,226
56587,29,458,478,364,7053,94
26226,75,1302,1118,920,40103,382
13716,64,5579,1336,2990,18811,2589
64403,231,2511,232,2017,14791,494
57830,63,449,444,374,7215,75
15928,19,453,1305,352,22137,101
52150,115,1175,616,951,22403,224
29482,10,437,1051,362,10865,75
28380,1166,26592,1072,18189,131683,8403
1646,13,370,1457,271,18491,99
31366,59,966,1015,758,6455,208
33522,69,2061,979,1418,13682,643
28677,42,1095,1066,851,24340,244
7715,675,16214,1388,11052,110122,5162
5070,108,2373,1421,1695,17133,678
64213,58,710,238,559,9803,151
23540,23,357,1176,285,31355,72
2948,60,2139,1446,1494,37751,645
35313,87,2185,939,1614,7481,571
12487,77,2325,1353,1280,33506,1045
23943,268,16729,1168,10967,67991,5762
3253,47,991,1443,706,31935,285
49326,23,279,656,239,19169,40
8271,42,1229,1383,839,16404,390
29771,2,39,1045,38,2951,1
30400,5,220,1032,135,8023,85
4578,117,4018,1428,2522,18664,1496
36387,32,1061,910,765,14209,296
290,882,36343,1467,22390,86465,13953
54994,0,37,523,34,2984,3
21944,4,225,1201,161,5402,64
50950,729,13446,650,10236,84021,3210
62502,8,101,285,75,3064,26
19840,373,9219,1237,6439,86072,2780
6711,9,569,1401,416,8100,153
42522,1,35,795,22,1588,13
6300,73,2477,1407,1617,22817,860
67517,2,68,141,53,1814,15
41319,1,53,814,46,2054,7
48629,7630,205988,714,135206,800776,70782
5649,77,1814,1414,1222,12500,592
23363,108,1849,1179,1156,24354,693
24555,52,1760,1154,1126,19472,634
28025,339,10342,1078,7307,54503,3035
10544,29,1430,1371,902,28281,528
35800,21,292,881,234,8244,58
4649,7,449,1427,313,9029,136
60279,4,191,361,129,9020,62
30734,209,3320,1026,2337,29325,983
28568,23,360,1068,253,19216,107
51123,49,788,645,614,13530,174
5206,15,368,1419,257,11845,111
11077,103,3184,1367,1958,19129,1226
62135,24,591,296,421,8561,170
53585,38,496,572,430,8736,66
1076,96,5914,1461,4216,33140,1698
26810,5,168,1105,107,14665,61
51074,637,11752,647,9152,79159,2600
23359,39,866,1179,558,11129,308
56033,9,281,494,183,5973,98
66461,20,492,176,368,6281,124
28599,227,3404,1068,2018,22079,1386
19647,21,454,1240,328,11062,126
26331,2,267,1116,178,8701,89
21208,52,1942,1213,1264,15251,678
51427,16,434,637,365,10013,69
4645,39,777,1427,555,25378,222
19861,142,1964,1236,1563,20551,401
47133,24,208,738,176,7119,32
56047,137,1579,493,1123,17794,456
53876,198,2819,562,2369,21282,450
9040,12,2451,1380,1463,15581,988
68488,17,150,109,125,5711,25
64321,35,987,235,685,11028,302
55092,913,12986,520,10523,79065,2463
57398,19,179,456,121,4406,58
31917,17,292,1007,229,8790,63
62717,5,109,279,81,3392,28
64863,20,437,218,227,4401,210
1958,111,4647,1454,2858,20805,1789
17810,315,9486,1273,6154,67130,3332
3141,38,1032,1444,719,30903,313
38898,17,327,848,236,5572,91
62891,26,508,275,408,10079,100
61094,15,194,330,155,8295,39
6249,2778,112004,1407,70106,605461,41898
22480,12,577,1194,368,8588,209
17079,183,3864,1286,2874,34001,990
66776,13,346,165,303,2794,43
9900,142,3361,1375,2737,22059,624
11511,829,19338,1363,12000,58158,7338
52425,139,1431,607,1071,16376,360
6054,6,278,1409,195,18020,83
62033,7,94,300,84,3619,10
46542,6,92,745,76,10897,16
60911,108,1601,337,1361,15195,240
65858,12,141,193,109,2136,32
4444,17,714,1430,417,9849,297
41800,3,57,806,39,5839,18
68898,17,243,95,191,6808,52
66189,44,580,183,459,8905,121
9664,35,1689,1377,1028,40056,661
31578,108,1360,1012,923,15466,437
42774,8,200,790,157,12937,43
990,1750,92655,1461,54568,264667,38087
52801,59,777,589,611,7681,166
65143,41,866,210,526,7537,340
50674,698,11770,658,9435,114152,2335
17268,38,2020,1283,1417,32052,603
59782,6,60,378,45,3816,15
29154,18,852,1056,510,15329,342
62843,82,760,276,625,7056,135
27185,9,340,1097,233,4793,107
35287,103,1861,939,1277,12972,584
9797,300,4154,1376,3007,27835,1147
68009,194,2740,125,2021,13023,719
63495,9,63,260,54,4868,9
36538,16,396,907,306,12809,90
32303,213,3065,1001,2230,21518,835
5301,13,466,1418,278,13862,188
8571,13,908,1382,601,20044,307
26709,3,283,1107,182,11786,101
54382,517,7996,545,6048,32152,1948
8776,9,476,1381,299,6837,177
20889,7852,189201,1219,119807,607196,69394
18446,1,65,1261,55,4618,10
52905,488,9548,589,7105,94844,2443
53118,175,3566,583,2144,23771,1422
67145,178,4059,152,3069,25621,990
11283,453,10095,1365,5598,99129,4497
26565,88,1146,1110,709,10553,437
38491,8611,191842,856,132738,619708,59104
21578,13,527,1206,341,14205,186
64348,430,6643,234,5526,80410,1117
33141,1171,22938,986,17214,83593,5724
17946,164,2990,1270,2273,38720,717
9137,22,1095,1379,699,13512,396
419,809,39538,1466,25720,146578,13818
8956,30,822,1380,589,7390,233
3797,108,2292,1437,1624,14328,668
2345,124,2999,1451,2143,48339,856
54165,5,107,552,80,4227,27
8717,90,2644,1381,1711,26186,933
55785,100,851,501,686,11938,165
11644,146,7323,1362,4315,48878,3008
51847,112,2038,625,1590,33104,448
19899,30,842,1236,718,11803,124
62558,6,105,284,88,3171,17
37939,27,445,871,336,12453,109
67674,15,406,136,296,4387,110
32972,184,4325,989,3480,50866,845
69005,6,98,91,82,2992,16
38653,204,3212,852,2816,21328,396
11008,1414,46666,1367,28471,121251,18195
19011,40,3716,1252,2183,14720,1533
36739,1,173,904,133,19381,40
601,88149,2346191,1465,1286631,4818185,1059560
53147,61,538,582,460,7678,78
56994,32,418,466,337,9223,81
17392,6,289,1281,251,23173,38
8590,6,333,1382,228,13653,105
8050,27,726,1384,484,9519,242
18254,0,0,1265,0,10154,0
39392,634,12856,843,9614,63849,3242
59961,73,1601,373,1250,27820,351
27331,158,9092,1093,5756,50909,3336
60500,20,134,353,111,4082,23
1970,9,413,1454,282,15148,131
62064,19,306,299,243,7852,63
15,1897,52006,1472,31119,336394,20887
33418,2,83,981,52,7316,31
23624,6,154,1174,115,8719,39
29978,6,231,1041,143,6017,88
8019,8,651,1384,468,17846,183
10174,7,369,1373,242,25270,127
32868,42,1071,991,702,17530,369
29072,3,174,1058,105,5215,69
34481,140,3806,959,2675,26708,1131
26241,256,4603,1118,2790,15011,1813
64822,316,5974,220,4754,39889,1220
65902,217,6158,192,4764,39759,1394
32663,20,278,995,194,7263,84
67024,3,81,157,28,3303,53
8233,53,1298,1383,966,25571,332
2069,228,13781,1453,9947,102847,3834
48029,50,688,727,532,9823,156
68144,296,6093,121,4362,55022,1731
242,1449,43967,1468,28282,148182,15685
68263,0,20,117,20,1625,0
32411,1785,43735,926,34149,261511,9586
20698,50,1663,1222,1194,15280,469
58589,20,456,418,297,11512,159
28909,7,415,1062,246,11737,169
58054,39,460,436,332,11244,128
54761,69,1086,530,820,10769,266
33323,5001,88915,982,58391,276759,30524
64116,52,341,241,260,4413,81
13448,841,16682,1340,11512,53040,5170
42875,142,1330,788,1153,17177,177
18854,5,337,1254,251,5477,86
38337,12,526,861,285,5731,241
20757,24,760,1221,532,19505,228
61319,26,400,323,340,5407,60
55997,613,8027,495,6297,51654,1730
41123,127,1371,816,1039,16079,332
20615,10,895,1224,546,5313,349
49498,200,3210,688,2511,30019,699
68725,10,146,101,111,3159,35
600,17,609,1465,438,49322,171
32034,20,385,1005,235,8091,150
31346,131,1951,1015,1403,32491,548
41297,444,7342,814,6094,70905,1248
1640,41,879,1457,609,22940,270
14964,33,1095,1319,727,7824,368
24848,38,568,1147,503,7901,65
23302,117,2358,1180,1781,17627,577
6845,11,257,1399,197,11232,60
6504,21,675,1404,437,26120,238
15841,0,0,1307,0,6806,0
19175,8,494,1249,321,10647,173
34743,287,5044,952,3835,33607,1209
14420,27,877,1326,597,27613,280
25223,117,2861,1140,1898,20649,963
3894,340,12921,1436,6797,42248,6124
59227,1940,32512,398,25253,172935,7259
66778,395,6824,165,5365,55170,1459
26161,10,159,1120,108,5712,51
1870,64,2602,1455,1884,31455,718
1383,15,353,1459,259,28307,94
62323,48,1274,291,870,14472,404
61002,150,1917,334,1503,14452,414
29295,64,1365,1054,855,19623,510
67687,8,193,135,165,4179,28
33117,3208,86201,986,59543,308679,26658
57574,28,360,452,277,6954,83
50651,3,78,658,60,4165,18
61134,70,1311,329,899,35920,412
28846,209,2580,1063,2213,29922,367
20654,101,4061,1223,3254,40425,807
32223,30,475,1002,315,10241,160
51130,3910,63560,645,43510,217288,20050
37128,49,1155,893,810,7812,345
51812,112,1526,626,1237,17134,289
65546,14,144,201,128,6050,16
25448,4643,114623,1135,70436,556652,44187
50631,5,109,659,88,2643,21
1914,141,4126,1455,2694,30000,1432
31581,7577,154029,1004,119801,541745,34228
49793,6,42,680,33,3624,9
65538,88,1096,201,868,6000,228
30587,216,3752,1029,2411,24690,1341
6705,4,164,1401,111,18477,53
25926,9,557,1125,334,8275,223
56521,73,867,479,644,12303,223
4115,41,936,1434,699,24901,237
49495,67,829,688,627,20950,202
1111,54501,1988550,1461,1359306,3228842,629244
21729,7,285,1204,199,4522,86
29024,1,23,1059,16,3996,7
18125,80,4790,1267,2207,19651,2583
49427,25,339,689,292,11979,47
23815,36,1021,1170,772,25143,249
38343,16,303,860,238,23695,65
30998,272,3782,1021,2623,26177,1159
53522,28,228,574,181,4563,47
3298,46,1592,1442,1085,9801,507
14813,12,308,1321,212,12411,96
57813,50,649,444,536,17300,113
39137,13,209,845,175,9989,34
66198,10,297,182,241,4718,56
2177,4,242,1452,182,8901,60
60481,72,1162,354,880,18453,282
65129,4,27,210,17,5246,10
27497,354,5894,1090,4344,39577,1550
60394,55,858,357,655,8031,203
14569,8925,624199,1324,332695,1383683,291504
61845,101,1037,307,852,12222,185
53350,2953,42059,577,32889,234489,9170
36027,2,18,922,14,1524,4
17388,2,122,1281,91,7086,31
21700,1160,14288,1204,8883,105153,5405
38350,69,854,861,673,16813,181
25382,2231,59486,1136,34089,267064,25397
1128,69,1143,1460,854,20686,289
16452,192,3996,1296,2735,22481,1261
36073,210,2674,921,1983,19138,691
17320,58,2167,1282,1304,20894,863
38364,85,2006,860,1750,41339,256
25312,57,2137,1137,1451,23732,686
38856,69,1229,849,1001,19481,228
57294,14,195,459,152,3506,43
10336,1934,48514,1372,30934,188803,17580
595,14,669,1465,513,33608,156
29972,12,464,1041,297,22996,167
26702,2,457,1107,265,5883,192
30133,296,8894,1037,6335,53811,2559
43673,1367,24706,778,17334,151763,7372
11433,92,3251,1364,1894,23238,1357
20064,15,1006,1233,563,20578,443
2021,9,641,1454,426,21301,215
19233,1443,37522,1248,26421,126320,11101
58506,112,1629,421,1176,20369,453
583,94,3989,1465,2654,48255,1335
11741,12,253,1361,141,12100,112
34638,324,5408,956,3853,92333,1555
49217,9,225,695,135,6998,90
33693,21,898,976,590,9173,308
27062,66,3331,1099,2247,45179,1084
68472,12,224,110,189,4205,35
11981,1081,45831,1359,28400,198739,17431
7264,25,359,1393,217,6634,142
58222,10,135,431,102,9001,33
67178,31,560,151,461,4288,99
66049,73,1392,188,1164,28023,228
33018,3194,54636,988,34531,276877,20105
29178,71,2375,1056,1608,54033,767
67153,137,2116,152,1659,29843,457
7709,16,624,1388,369,35005,255
66681,15,393,168,317,6875,76
29232,247,5372,1055,3716,28258,1656
49157,55,1278,697,740,10696,538
8384,3,75,1382,53,12632,22
29542,64,535,1050,365,5126,170
15294,762,19056,1315,13527,187914,5529
51741,4,70,628,50,5015,20
17702,150,6451,1275,4807,57727,1644
58708,4740,111222,414,78521,497517,32701
8733,98,6043,1381,3612,31835,2431
3747,14,451,1438,330,8723,121
64343,15,270,234,199,7318,71
64126,726,27263,240,21640,94844,5623
26580,186,6413,1110,4345,28449,2068
28303,10,386,1073,240,22935,146
21577,530,20237,1206,11730,83826,8507
26061,30,1770,1121,1259,6237,511
35993,35,884,923,624,31844,260
31799,5358,164788,1008,113994,216249,50794
21560,6,1132,1206,821,18876,311
12450,2550,85880,1354,54148,403764,31732
37750,2,41,876,32,4450,9
63828,146,5017,251,3558,17020,1459
21544,444,15773,1207,10040,87419,5733
9157,641,31954,1379,20924,181791,11030
31864,225,4394,1008,2856,26570,1538
59638,31,447,384,374,5790,73
68928,167,2676,94,2340,26038,336
17657,16,942,1276,580,9262,362
25460,33,1254,1135,814,10061,440
14130,342,10703,1330,6432,58017,4271
37508,12,255,882,206,6726,49
39179,70,1073,845,938,18298,135
30993,12,213,1021,157,2561,56
63633,18,144,256,120,3561,24
20716,8,214,1222,164,14037,50
64866,8,125,218,88,6344,37
15625,331,7436,1310,5053,67344,2383
513,6,271,1465,186,25610,85
10003,911,19546,1374,14271,86805,5275
445,62,1942,1466,1409,27580,533
59729,40,763,381,460,11158,303
15292,7,536,1315,391,20526,145
56214,34,475,489,374,5839,101
66960,2,120,159,46,1402,74
38360,12,251,860,203,10505,48
26441,74,1190,1113,977,38480,213
18906,12,559,1253,359,26155,200
13915,5,504,1334,289,9174,215
62874,2,41,276,33,3324,8
34862,133,2464,950,1800,24111,664
25971,691,18038,1123,9789,131954,8249
6071,20,370,1409,263,8581,107
31261,10,387,1017,252,8811,135
51972,182,2204,620,1744,30154,460
25354,41,1106,1137,867,25849,239
54296,140,2020,548,1635,52218,385
10025,15,272,1374,183,5464,89
65875,8,148,192,94,4185,54
28086,14,184,1077,111,6792,73
29672,10,519,1048,323,19433,196
54864,22,416,526,279,8202,137
17441,2,212,1280,165,10565,47
15108,164,4513,1318,3051,31175,1462
30826,22,274,1024,195,7930,79
29762,77,1316,1045,778,9923,538
32509,31,589,997,414,10399,175
4935,307,12680,1423,6615,39803,6065
23110,117,4273,1183,3045,50328,1228
64317,47,429,235,374,7870,55
41405,309,2547,813,2129,23908,418
60034,27,168,370,128,4813,40
15273,18,593,1315,429,19711,164
52300,11,117,610,78,3200,39
49144,17,535,698,418,5080,117
4810,30,1306,1424,915,31581,391
56412,119,1344,483,1146,13071,198
24311,141,3485,1160,2209,21307,1276
57726,514,6891,446,5989,60397,902
8950,42,1663,1380,1061,14975,602
18395,6268,143611,1262,91157,349368,52454
68287,5,31,116,28,2606,3
10826,132,2667,1369,1673,23658,994
17245,98,3090,1283,2143,31086,947
16722,140,3019,1292,2142,62331,877
35398,67,1604,937,1164,13591,440
19649,0,43,1240,32,6022,11
36293,14,311,915,247,13458,64
41253,288,3605,815,2927,21953,678
41731,4674,70478,807,55567,312891,14911
61301,166,1474,323,1224,11519,250
18238,45,1729,1265,1297,33143,432
60375,15,128,358,100,1848,28
23589,20,549,1175,394,46949,155
760,53,3066,1463,2161,20784,905
47065,50,931,739,700,12255,231
43139,2,108,784,84,5517,24
26320,115,4056,1116,2317,20694,1739
64650,74,988,225,701,4693,287
68744,7,90,100,78,3641,12
55032,999,12329,521,9620,54107,2709
22075,4,215,1199,131,4386,84
49960,4,43,676,36,4786,7
30817,20,364,1024,260,25626,104
14134,726,6167,1330,4178,55806,1989
7079,186,7320,1396,4501,37836,2819
49962,51,520,676,408,11579,112
35168,86,1563,943,1133,17580,430
16329,2,101,1299,64,15299,37
58815,320,3219,411,2257,26833,962
27321,749,18933,1094,12814,67467,6119
68890,6,79,95,52,5389,27
66367,4,33,178,26,3344,7
19960,49,1016,1235,796,12462,220
12465,52,1916,1353,950,23448,966
60606,142,2103,349,1657,15966,446
12919,156,4644,1348,2628,19089,2016
7359,20,665,1392,479,13752,186
11681,35,787,1362,507,22388,280
43905,33,943,776,672,53038,271
11610,80,2375,1363,1394,54218,981
50162,17,183,670,138,6735,45
39437,30,576,842,431,8582,145
31143,193,3433,1019,2189,16825,1244
39200,0,169,845,140,7621,29
61788,1710,33545,301,24754,197485,8791
44449,28,260,769,214,7253,46
9856,198,5131,1375,3270,30107,1861
26913,639,11862,1102,7991,41783,3871
18095,31,2491,1268,1644,18910,847
24105,210,4426,1164,3224,41324,1202
3307,7,233,1442,168,15195,65
30766,8,214,1025,158,11164,56
32320,11,288,1001,203,8985,85
59616,27,227,384,177,4045,50
19231,237,9078,1248,5033,30975,4045
23960,17,793,1168,619,7569,174
60031,89,1760,371,1261,8045,499
17236,99,2130,1284,1543,39137,587
52077,265,3321,618,2843,53068,478
17451,8,208,1280,172,9763,36
30302,44,1335,1034,912,18418,423
28386,205,3312,1071,2199,52038,1113
11849,146,7738,1360,3102,23889,4636
22667,133,3402,1190,2317,30209,1085
9265,61,3276,1379,1989,25721,1287
11655,69,4054,1362,1617,14858,2437
8260,4,202,1383,132,14769,70
63934,36,453,247,363,7396,90
5762,71,1396,1413,922,15451,474
28122,89,2470,1077,1580,51441,890
64472,14,243,230,172,8645,71
66840,28,522,163,407,12954,115
67255,10,276,149,217,2263,59
295,124,8717,1467,5603,177040,3114
11985,133,2138,1359,1178,13924,960
2036,429,12107,1454,7671,51509,4436
2685,57,2294,1448,1573,56302,721
10373,141,4909,1372,2933,56415,1976
64066,24,194,242,157,3014,37
17259,409,7881,1283,5350,81131,2531
66288,28,172,180,151,3931,21
1305,81,3086,1459,2231,34890,855
33336,26,705,982,448,18533,257
3941,30,1400,1436,967,12848,433
17179,139,3910,1284,2729,55307,1181
30672,10,411,1027,242,8797,169
54027,63,873,557,687,11665,186
11971,68,1305,1359,703,12104,602
56016,35,388,494,313,5922,75
13454,661,14244,1340,8764,47037,5480
33656,855,11144,976,8032,98746,3112
59136,12,96,401,78,6657,18
50508,64,824,661,673,22246,151
2388,46,1389,1451,992,26083,397
38775,8,183,850,163,15663,20
61963,75,846,302,601,11412,245
44883,223,4717,764,3615,46637,1102
32721,44,1893,994,1182,23479,711
33469,119,2670,980,1797,27087,873
64901,11,107,217,101,4654,6
23520,3,193,1176,128,23057,65
7374,94,5905,1392,4075,81144,1830
34054,59,1384,968,911,8337,473
66147,22,263,184,218,4090,45
16883,86,3662,1290,2510,48157,1152
57326,50,822,458,646,8502,176
28488,647,40883,1070,27373,141544,13510
15458,29,756,1312,553,38292,203
60190,62,744,365,583,11181,161
38737,838,12924,851,10108,42778,2816
22597,9,234,1192,164,10067,70
22540,66,1097,1193,892,12321,205
19030,286,12931,1251,8887,60225,4044
37407,350,7006,885,5379,66610,1627
20421,5,539,1227,394,8837,145
27392,51,2524,1092,1634,28811,890
10306,2,109,1373,71,13391,38
6550,1,50,1403,40,6405,10
12262,109,1994,1356,1269,19541,725
27016,609,17325,1100,10450,85671,6875
13748,389,12710,1336,7971,139889,4739
26177,6,424,1119,283,11622,141
56913,58,1012,468,817,21645,195
10769,58,2988,1369,1864,24537,1124
61561,26,609,316,464,10062,145
58728,3228,54571,414,41259,178249,13312
52866,46,399,590,290,5306,109
51241,26,314,642,260,12284,54
36711,41,823,904,621,8379,202
23031,40,857,1184,562,7993,295
18404,6,337,1262,224,7173,113
1399,3,190,1459,127,13286,63
238,3675,223188,1468,153058,505542,70130
52596,48,754,600,596,8123,158
6244,4,264,1407,203,4638,61
3849,57,2206,1437,1504,58533,702
22023,3725,155975,1200,96889,929035,59086
9128,58,1963,1379,1201,25308,762
48496,22,435,718,338,29321,97
20524,69,1169,1225,851,22167,318
50849,17,120,653,94,2944,26
27649,12,988,1086,566,30482,422
22561,16,503,1193,369,6926,134
59970,736,12789,372,9417,82369,3372
52315,9,222,610,181,3921,41
48898,71,622,705,493,8866,129
53092,16,112,583,83,3056,29
67142,1,20,153,17,1603,3
16661,20,704,1294,459,11680,245
35791,35,1835,928,1101,11491,734
51763,162,2991,628,2184,46981,807
431,3,197,1466,114,14041,83
68790,10,99,99,81,2895,18
3904,106,6635,1436,4489,91393,2146
3672,2,80,1439,51,11454,29
5187,12,403,1419,293,8225,110
48025,285,8058,727,6122,26782,1936
15069,19,555,1318,374,16173,181
29423,0,0,1052,0,11154,0
9572,216,4471,1377,3032,32280,1439
41549,257,5574,810,3048,48992,2526
10724,5,284,1370,152,7681,132
58477,81,736,422,579,6902,157
32377,190,2893,1000,1957,13365,936
22234,471,11464,1197,7924,62619,3540
59982,88,1150,372,913,9281,237
4981,232,8248,1422,5028,50287,3220
24424,18,834,1157,566,9368,268
57594,48,868,451,704,17796,164
12987,1318,49798,1347,27512,305135,22286
68299,3,60,116,47,3770,13
35258,4,49,940,43,4760,6
56711,78,1039,474,861,13862,178
22809,0,0,1188,0,4858,0
68939,15,159,93,132,4573,27
22365,121,1161,1196,735,9356,426
67100,19,271,154,212,1610,59
58845,47,637,410,542,22510,95
59890,44,855,375,691,29778,164
4048,13,829,1435,572,40058,257
4473,2185,62169,1429,34738,161001,27431
33329,60,1085,982,718,25960,367
47126,1,90,738,72,6177,18
61667,16,203,313,153,3346,50
57024,5,49,466,36,2918,13
22664,23,562,1190,411,11515,151
37073,140,1469,895,1034,17874,435
25756,11,665,1128,596,16033,69
28508,71,1059,1069,734,12498,325
579,44,853,1465,610,34142,243
50375,99,2088,665,1765,29075,323
51990,14,278,621,216,4478,62
21950,25,437,1201,309,4869,128
36717,15,515,904,414,15323,101
18987,67,1609,1252,1121,17953,488
65369,11,226,205,160,4263,66
57280,25,286,459,205,3936,81
67399,13,276,145,227,6815,49
48840,0,45,707,35,6035,10
68158,42,675,120,507,13909,168
18902,313,7799,1253,5443,55752,2356
18599,18,855,1259,637,29430,218
37938,11,313,871,252,9404,61
47753,484,8129,730,6586,68673,1543
48706,82,1085,711,915,17775,170
57466,85,1359,455,1048,9170,311
68013,4,36,125,32,2199,4
19541,139,3085,1242,2195,36111,890
404,1246,51043,1466,28800,228580,22243
57390,12,177,456,126,4158,51
10516,6,177,1371,123,7915,54
2944,102,2510,1446,1864,20708,646
28317,17,531,1073,354,9030,177
13086,394,20858,1345,12347,110396,8511
28793,1225,31563,1064,22905,210585,8658
27673,364,5725,1085,3928,68186,1797
30839,11,219,1023,158,4514,61
23358,21,314,1179,228,7606,86
64281,148,3300,235,2773,23048,527
62583,115,1613,283,1190,28571,423
26008,32,992,1122,657,17770,335
64541,515,5042,229,4042,20020,1000
66751,0,10,166,9,1303,1
67079,28,670,155,506,12633,164
32921,524,7164,990,5345,63691,1819
26745,0,0,1106,0,8154,0
25092,0,0,1142,0,8165,0
63821,1188,15051,251,12393,60670,2658
57310,444,5706,458,4440,41100,1266
50767,54,529,655,423,9399,106
12171,121,3324,1357,2079,22160,1245
10524,36,1282,1371,863,27237,419
30574,96,2045,1029,1315,13185,730
15285,5,290,1315,215,12001,75
51549,1,12,634,10,2221,2
21748,16,360,1204,241,16311,119
21701,2230,54105,1204,34985,348248,19120
51281,54,713,639,587,10190,126
2224,1860,60498,1452,37040,259797,23458
51969,859,9515,622,7875,56983,1640
2875,2849,81194,1446,45373,137466,35821
16907,2807,66295,1289,44471,181565,21824
3324,65,1823,1442,1210,29908,613
37327,61,1234,887,1020,14586,214
16811,18,522,1291,306,10050,216
30643,102,1837,1028,1176,21322,661
26105,9,444,1120,265,8273,179
25769,20,937,1128,584,11117,353
20782,119,4751,1221,3410,65710,1341
31424,1105,31492,994,22519,123132,8973
59602,68,496,385,401,7340,95
54836,95,706,527,511,11695,195
35027,8,136,946,125,8082,11
58942,25,202,407,150,8174,52
35289,123,2584,940,1954,26815,630
5981,13,319,1410,208,9496,111
10868,174,4454,1368,2609,29869,1845
64884,15,239,218,207,2982,32
10091,22,755,1374,476,5755,279
50662,64,558,658,456,9478,102
34921,8,180,949,125,2363,55
53723,5,109,567,72,4073,37
15290,1,91,1315,61,4210,30
5405,231,5427,1417,3675,29189,1752
22318,587,11646,1196,8190,55641,3456
4878,27,1048,1424,768,12999,280
49854,246,2874,678,2192,24375,682
33466,394,8269,980,6180,56709,2089
29840,478,7357,1044,5270,29604,2087
22657,0,0,1191,0,6800,0
22034,72,2113,1200,1317,21131,796
58875,17,218,409,162,5035,56
2418,221,7728,1450,5795,35270,1933
68419,206,3565,112,2954,24906,611
59166,11,113,400,92,4471,21
23263,255,4579,1180,3524,61566,1055
7423,3,132,1392,85,32568,47
24585,2125,51165,1153,34395,277073,16770
16464,2134,70920,1296,37045,278212,33875
37282,63,1060,888,776,25571,284
59535,37,585,387,472,6775,113
50007,43,477,674,373,9124,104
9309,15,547,1378,367,8827,180
5289,18084,725884,1418,439464,1092735,286420
56266,16,251,487,211,3462,40
40627,5,219,825,155,12591,64
9301,121,2596,1379,1679,15112,917
56809,4,60,471,45,2740,15
19230,1,158,1248,96,4121,62
51019,245,3290,648,2877,31301,413
12981,170,7835,1347,3924,99369,3911
3088,79,2608,1444,1583,13933,1025
37740,12,532,876,420,12113,112
19168,7,434,1249,346,13060,88
35924,30,1019,925,706,5442,313
12337,338,6840,1355,4519,39416,2321
50712,128,1677,657,1388,16524,289
65822,33,349,189,280,7784,69
65530,43,785,202,620,12284,165
41265,76,1320,815,1152,24071,168
15904,49,2304,1305,1611,23213,693
60292,529,9251,361,7244,57778,2007
33198,78,888,985,586,7738,302
56578,47,582,478,445,6873,137
27088,7,333,1099,214,12856,119
2899,74,1522,1446,1157,47834,365
31427,54,1084,1014,644,10660,440
3745,502,21463,1438,13599,136156,7864
19616,404,8473,1241,5541,65782,2932
37329,15,158,887,117,7062,41
28050,3,293,1078,166,7452,127
57634,24,256,450,182,3472,74
56333,58,897,485,748,12012,149
58004,348,5959,438,4828,35862,1131
5612,5,275,1414,185,22197,90
5527,183,6543,1415,4503,50475,2040
25168,1,22,1141,21,5614,1
55526,12,125,508,104,6625,21
6291,81,1617,1407,1095,11686,522
62454,21,205,287,176,3585,29
60392,54,691,357,542,10623,149
1205,452,11465,1460,7496,146056,3969
35084,83,1625,945,1346,19327,279
10656,130,5487,1370,3137,57106,2350
9221,84,1897,1379,1359,69195,538
36,453,10737,1472,4819,64997,5918
13201,6,307,1344,163,8742,144
5416,67,4380,1417,3005,39106,1375
26423,142,4840,1114,2629,38798,2211
25367,104,2140,1136,1473,30141,667
31376,100,2054,1015,1685,21497,369
17734,44,1490,1274,952,29574,538
47439,106,1568,734,1356,13914,212
49102,811,18228,698,11433,290765,6795
18827,134,5549,1255,3870,115943,1679
7360,77,6186,1392,3608,34731,2578
8026,1004,105026,1384,53935,380364,51091
49296,134,3172,693,2369,34842,803
13173,1338,103202,1344,55700,263557,47502
42905,127,3017,787,2210,22810,807
49971,69,717,675,623,14124,94
60803,63,995,341,741,16227,254
34437,159,3406,961,2506,48346,900
64500,15,129,229,91,4557,38
54777,27,441,530,335,10679,106
54329,24,364,547,271,10297,93
51392,10,207,638,151,4060,56
33654,13,356,976,221,4110,135
21153,123,2955,1213,1743,28870,1212
26195,25,615,1119,407,17036,208
12897,0,0,1348,0,4526,0
20343,1575,60797,1228,36127,187081,24670
59017,28,341,405,268,13085,73
31674,134,1893,1011,1213,7488,680
23089,316,7113,1183,4921,49837,2192
66525,368,6954,173,5398,36391,1556
59947,2,61,373,48,2153,13
34393,36,989,962,756,20269,233
20903,1413,36978,1218,24667,154295,12311
49963,6723,117191,676,80592,341051,36599
59749,16,157,380,126,8996,31
4153,75,2566,1433,1734,14053,832
10594,2147,32079,1371,21353,140429,10726
6837,195,5348,1400,3760,34048,1588
22055,391,5620,1200,3727,41268,1893
5938,4,184,1411,133,4355,51
12135,125,5763,1358,2589,98271,3174
46429,30,1200,747,729,15733,471
26995,80,2628,1100,2155,27573,473
36772,9,309,892,231,14518,78
59544,3265,65986,387,51045,402412,14941
28928,111,3370,1061,1952,13873,1418
54373,26,247,545,208,9625,39
2613,17,996,1449,596,36425,400
50218,342,4220,669,3236,43899,984
27080,15,119,1099,83,16598,36
5713,39,834,1413,675,9811,159
22046,61,1020,1200,637,12318,383
51216,5,47,643,33,4759,14
54477,18,263,541,168,18201,95
16157,161,5618,1301,3738,100099,1880
57306,4,25,458,22,2509,3
11498,140,3843,1364,1908,21417,1935
62088,13,87,298,68,3437,19
55637,3,111,505,53,5454,58
57378,2,29,457,27,1478,2
32178,129,4547,1003,2951,28581,1596
11089,17,589,1367,346,10236,243
64310,4,189,235,110,3515,79
32501,19,221,998,126,4891,95
21900,95,1895,1202,1082,11796,813
53416,19,239,575,163,5516,76
49294,597,7287,693,5478,64180,1809
12086,32,1526,1358,882,9008,644
1768,2,305,1456,219,24750,86
57218,10,65,461,56,2865,9
9871,729,14888,1375,8636,49093,6252
10815,60,2111,1369,1391,31514,720
49560,42,370,686,277,7832,93
6186,184,6557,1408,3720,43194,2837
16847,146,16308,1290,9308,67337,7000
58995,4,81,405,64,3290,17
16459,6,528,1296,373,21246,155
27029,185,4660,1100,2771,43717,1889
29276,50,1964,1054,1204,25261,760
53136,2,30,582,23,4285,7
19396,51,2280,1245,1639,33937,641
305,232,16540,1467,10857,132345,5683
32843,17,383,992,266,9538,117
15666,743,20369,1309,13290,160673,7079
17793,6,345,1273,257,25992,88
37001,21,318,897,279,8593,39
58333,1607,39829,427,29634,171149,10195
7641,314,13368,1389,9084,98044,4284
62192,312,2319,294,1960,22267,359
50455,13,217,663,167,10310,50
19187,76,2731,1248,1752,24418,979
16107,294,6671,1302,4996,55049,1675
52710,47,533,596,407,23994,126
22502,31,610,1194,397,17438,213
50918,55,721,651,540,13502,181
34678,37,400,955,310,12628,90
44224,45,852,771,625,9559,227
42656,4265,137290,792,102840,373554,34450
35495,196,3882,934,3036,51416,846
56017,30,545,494,415,14693,130
29815,2359,43567,1044,25532,275147,18035
54593,1645,24412,536,19039,167996,5373
628,53,2304,1464,1644,76198,660
33870,3,137,973,100,13449,37
55253,23,237,515,188,9052,49
30403,5,374,1032,232,17330,142
39845,111,1866,835,1504,54799,362
59925,2621,56514,373,44120,254753,12394
37949,53,776,871,538,10187,238
29654,5,103,1048,67,12216,36
24825,8,610,1148,387,26312,223
53792,192,2696,565,2234,28153,462
29659,51,2571,1048,1459,19083,1112
60682,88,835,346,574,7016,261
13513,2,260,1339,150,17145,110
19265,259,5742,1247,3862,41917,1880
39929,18,332,836,255,9189,77
17641,159,1693,1276,1180,13849,513
12059,14,760,1358,375,20618,385
41065,21,306,817,258,15331,48
11419,24,534,1364,336,12967,198
22811,16,429,1188,267,4622,162
59786,43,333,378,253,5754,80
48551,53,1047,709,797,24256,250
65240,34,226,208,187,4928,39
26923,6,209,1102,164,2714,45
30619,609,12691,1028,8822,111779,3869
59955,0,42,373,33,1890,9
58979,27,300,406,227,9059,73
52190,396,2955,614,2577,25313,378
15415,7,127,1313,84,12328,43
34297,29,904,963,726,14323,178
65531,257,2912,202,2345,14389,567
14715,1412,46892,1322,31652,458509,15240
3729,451,25697,1438,16745,195594,8952
9153,657,25440,1379,15682,152493,9758
39555,340,3283,841,2419,24731,864
41866,62,1378,804,1097,21765,281
17523,39,1620,1278,1140,20987,480
51256,390,4248,635,3344,29713,904
26007,263,5052,1123,3494,37690,1558
22348,14,559,1196,387,15584,172
6053,345,14452,1409,9560,87856,4892
25020,836,56054,1143,38617,196714,17437
26956,391,7255,1101,4427,28945,2828
68291,0,0,116,0,1482,0
8312,18,1075,1383,699,27864,376
34594,3,90,957,64,2397,26
54966,357,4553,523,3690,47159,863
15942,222,4945,1305,2831,27989,2114
67352,20,248,146,192,5723,56
48195,4842,80284,699,59987,225743,20297
29619,35,1612,1049,1061,30144,551
13737,205,3300,1336,2004,12900,1296
29135,209,8009,1057,4513,26836,3496
26401,186,2864,1114,1742,19069,1122
29109,105,2332,1058,1410,19029,922
5997,23,455,1410,288,20089,167
68277,18,159,117,113,2517,46
17831,25,661,1272,473,8898,188
58634,14,96,417,84,3449,12
17367,10,265,1281,197,5778,68
9829,286,5900,1376,3795,22697,2105
8826,340,9540,1380,6099,54274,3441
60524,225,2926,352,2444,39126,482
14579,2,336,1324,233,14305,103
68669,8,89,103,73,4534,16
28103,308,5971,1077,4492,52951,1479
54004,35,543,558,461,8409,82
30169,256,7912,1037,4990,24377,2922
28243,575,14728,1074,9501,77042,5227
22551,12,323,1193,228,8028,95
59405,343,6701,392,5476,45871,1225
32207,401,9806,1003,7077,98077,2729
30947,19948,464987,1022,263407,881285,201580
3035,8,109,1445,83,6117,26
35280,16,346,940,298,45956,48
22974,58,1521,1185,950,20560,571
34052,33,518,968,319,4505,199
7399,2,111,1392,84,17196,27
19392,6,178,1245,115,8517,63
6702,27,977,1401,715,32453,262
51320,495,6940,640,5734,78608,1206
10134,35,913,1374,611,12238,302
60236,43,677,363,541,11863,136
18668,21,524,1258,381,19048,143
2534,93,1883,1450,1127,10195,756
15831,40,1241,1307,789,25756,452
68058,65,602,124,507,6446,95
67276,11,182,148,119,5900,63
2698,364,9224,1448,6488,135243,2736
17281,10,377,1283,285,6660,92
312,17,890,1467,667,49107,223
19611,5182,155025,1241,112044,557670,42981
6479,33,1109,1404,832,25607,277
10480,199,5162,1371,3129,53098,2033
51380,3,55,638,53,3257,2
19028,23,374,1251,259,13657,115
9273,11,468,1379,279,6642,189
27196,5,224,1096,141,4673,83
15970,18,314,1304,216,8796,98
32692,3,240,995,136,5835,104
68913,13,220,94,185,8066,35
26166,223,2728,1120,1773,21387,955
35907,3,76,925,58,4474,18
46911,54,1107,741,849,10387,258
13451,99,3572,1340,2099,56733,1473
52161,14,142,615,108,9962,34
58546,0,14,420,11,1748,3
64051,6,139,243,104,2973,35
44912,94,1626,764,1285,19050,341
36318,1070,30768,913,20814,105083,9954
8932,12,630,1380,413,18092,217
14514,133,2144,1325,1389,21351,755
31291,28,622,1016,376,13454,246
7716,3677,147999,1388,87355,452833,60644
50175,13,136,670,126,10416,10
65265,0,0,207,0,1795,0
5067,50,1222,1421,844,19246,378
49354,24,445,691,354,8577,91
54066,228,3030,556,2401,38584,629
43967,197,2741,775,2192,29953,549
35214,2,44,941,30,5644,14
3473,499,11940,1441,7579,44257,4361
26758,2,117,1106,77,5247,40
36267,5,45,915,36,3472,9
36091,4,87,920,77,10779,10
25402,136,2650,1136,1927,29992,723
2548,112,4698,1449,3027,50138,1671
5865,656,15735,1412,10310,180314,5425
5521,291,21731,1415,13787,163482,7944
943,18,521,1462,351,21712,170
19395,52,1585,1245,1073,15290,512
50152,275,4979,671,4103,37380,876
68481,10,255,110,190,5330,65
60584,2549,34358,349,23728,169392,10630
52211,8,78,614,56,2326,22
56808,33,433,471,361,10375,72
56940,10,178,467,137,8001,41
29915,2,176,1042,115,5957,61
61058,655,10821,332,8824,61543,1997
64043,73,593,243,460,9330,133
27930,253,7953,1080,5202,55630,2751
42512,31,553,795,435,13484,118
30575,118,2750,1029,1799,19102,951
52864,284,2642,590,2113,21075,529
33273,111,1634,983,1374,21748,260
8756,19,744,1381,491,9319,253
20988,14,279,1217,191,5094,88
17865,1015,34348,1271,22512,135171,11836
24557,505,14742,1154,9981,101092,4761
59403,71,1004,392,726,26662,278
52586,63,941,601,682,13328,259
3092,2,119,1444,83,4777,36
28720,5,211,1065,135,9902,76
8315,48,1263,1383,928,9405,335
6684,6034,282159,1401,165220,1708648,116939
55047,72,1028,521,728,24095,300
25608,1095,26014,1132,15851,192377,10163
2075,307,12724,1453,8275,93070,4449
48640,58,1335,713,893,33513,442
2791,8,491,1447,305,9587,186
28979,11,409,1060,246,8486,163
8937,173,2353,1380,1562,25937,791
9503,323,8971,1377,5592,69773,3379
32376,50,851,1000,544,7519,307
22701,7852,172551,1190,105202,579111,67349
9637,59,4438,1377,3016,61272,1422
3735,3,220,1438,162,13783,58
18677,15,401,1258,308,10836,93
3418,482,25848,1441,16891,172124,8957
10693,126,2746,1370,1749,32753,997
35855,23,519,927,379,14591,140
9926,72,4361,1375,2818,92697,1543
66221,31,511,182,387,4513,124
15529,4021,117172,1311,79452,744773,37720
13257,2,623,1343,270,12383,353
58137,2449,68235,434,52590,288686,15645
7049,13,396,1397,237,16731,159
6163,234,7047,1408,5279,63528,1768
16774,77,1993,1291,1354,18474,639
12315,12,469,1355,292,27989,177
63985,10,229,245,185,4843,44
35802,12,225,928,183,7258,42
22889,20,258,1186,193,23939,65
15200,27,1019,1316,714,20312,305
23377,23,820,1178,556,12520,264
2937,150,11901,1446,7580,84611,4321
18692,2,109,1257,79,4918,30
57640,336,4994,450,4076,75182,918
47715,538,7075,730,5497,59653,1578
33056,3,119,988,72,22236,47
5540,586,10004,1415,6158,53919,3846
22896,4,299,1186,169,7622,130
572,45,1765,1465,1307,22956,458
1159,66,3893,1460,2653,42529,1240
24758,992,28067,1149,17683,71337,10384
22172,12,396,1198,325,8607,71
66612,3811,77234,170,51686,253610,25548
17138,61,3852,1285,2135,16633,1717
54236,68,553,550,425,6039,128
28433,13,169,1071,120,2736,49
62621,10,105,282,94,3750,11
34101,280,5693,967,4018,101189,1675
732,39,2056,1463,1461,56564,595
65515,30,213,202,171,5683,42
188,226,5352,1469,3545,28447,1807
21970,258,10739,1201,6767,49737,3972
14497,157,2457,1325,1846,42786,611
5344,9,345,1418,251,13270,94
14763,88,2919,1322,2199,37774,720
65994,12,202,186,150,8326,52
40320,20,301,830,227,14144,74
18831,1,129,1255,96,6859,33
19782,25,300,1238,207,10847,93
63933,130,2018,247,1671,19680,347
37824,70,959,874,745,11725,214
14555,36,1053,1324,801,11537,252
6180,13,231,1408,157,12705,74
6660,255,4672,1402,3339,86986,1333
58691,25,271,415,220,7435,51
12549,1872,160625,1352,90899,511384,69726
22274,18300,356953,1197,191305,987301,165648
10115,5409,189629,1374,113744,548131,75885
25690,33,906,1129,588,24230,318
9357,18,326,1378,193,3746,133
65830,127,1354,194,1065,14542,289
6485,659,13755,1404,8448,76999,5307
22747,62,1068,1189,730,12567,338
10205,58,2342,1373,1406,22041,936
10831,31,1153,1369,780,23203,373
27316,317,7881,1094,5380,49106,2501
19718,2123,38696,1239,25988,211447,12708
4144,19,772,1434,585,27140,187
12909,103,3173,1348,1818,29622,1355
62396,119,638,288,512,9903,126
68179,167,3554,120,3032,31635,522
67818,627,9440,131,7691,67529,1749
4788,62,919,1425,642,13037,277
64945,2,21,216,8,2269,13
51339,4003,57794,640,42376,136984,15418
25948,7,98,1124,93,9092,5
50352,280,3509,665,2920,25864,589
923,30,1090,1462,813,37130,277
23386,309,6953,1178,3982,36446,2971
15806,139,5156,1307,3376,35633,1780
14316,24,344,1328,298,5240,46
56566,170,1588,478,1295,12151,293
33766,5290,98660,974,66834,386046,31826
16081,948,18835,1302,15018,167807,3817
37469,77,2386,883,1490,11442,896
533,125,3766,1465,2861,48940,905
39000,132,2269,847,1830,28991,439
5863,831,33490,1412,20956,176161,12534
3859,9,291,1437,192,12024,99
30554,1577,32391,1029,21107,147630,11284
52532,19,334,602,265,9764,69
50332,6,177,666,133,2901,44
31215,48,1452,1017,938,17061,514
46209,77,1622,750,1245,23446,377
13930,3328,120678,1333,71973,472644,48705
42648,150,2952,792,2532,32056,420
53441,209,2738,575,2200,67877,538
67676,58,974,136,732,11647,242
6764,80,1448,1400,1054,11202,394
19478,46,1446,1243,1023,15260,423
26711,10,218,1107,140,5204,78
648,955,53487,1464,29546,207272,23941
15199,70,894,1316,618,14212,276
58727,338,4732,414,3559,24162,1173
52625,118,970,599,831,22418,139
22815,0,19,1188,17,3274,2
61562,2,64,316,43,2447,21
61354,61,964,322,791,14220,173
51418,34,340,632,306,11315,34
22992,20,662,1185,481,17946,181
4779,980,24295,1425,15695,136527,8600
1168,30,1392,1460,1013,32698,379
39353,5,112,843,86,8480,26
33109,7,194,987,153,16108,41
24684,2984,146809,1151,96581,454072,50228
22459,23,352,1194,251,5813,101
28870,31,1814,1063,1046,22091,768
6309,6,57,1407,46,6810,11
1322,492,12983,1459,8475,144338,4508
11396,308,14869,1364,7844,77195,7025
18830,217,6177,1255,4335,39032,1842
27550,4,47,1088,42,5626,5
2394,412,12235,1451,8281,99385,3954
66332,8,223,179,186,4751,37
4430,29,1180,1430,868,19040,312
65941,156,4999,191,3673,36407,1326
21125,6934,236043,1214,152035,1184045,84008
37527,258,5696,882,4545,21984,1151
15198,94,2605,1316,1701,28293,904
17355,91,2247,1281,1725,61426,522
61898,10,51,305,42,3240,9
61144,23,584,329,489,10767,95
48964,4,55,703,43,4092,12
55321,10,97,513,52,8105,45
14537,10,188,1324,127,18121,61
19113,27,610,1250,534,6607,76
29922,602,6242,1042,4123,40428,2119
42829,25,475,789,319,12217,156
691,94,1338,1464,884,10136,454
54390,173,2489,544,2184,34431,305
68993,17,239,91,187,3732,52
23467,10,573,1177,402,9962,171
26724,55,2546,1106,1357,87628,1189
63482,1,29,260,19,4028,10
23510,15,511,1176,351,13549,160
59303,82,947,395,811,21436,136
37503,46,792,883,565,10197,227
8573,67,2071,1382,1360,16725,711
24235,4704,154049,1162,117645,828083,36404
18449,567,9685,1261,6070,73312,3615
61493,24,341,308,267,7607,74
55806,98,2121,500,1630,28331,491
23765,4258,136208,1171,102620,983901,33588
38319,1224,14763,861,11880,117086,2883
35345,10,235,938,153,6072,82
25810,25,399,1127,272,7136,127
30545,1798,40606,1029,26901,163737,13705
53995,1275,14358,558,10631,44899,3727
7722,180,4682,1388,3377,32085,1305
67945,18,195,127,134,6339,61
62224,115,1756,294,1523,16219,233
20932,89,2118,1218,1359,25524,759
66398,56,688,177,544,5318,144
42650,240,2345,792,1806,38352,539
1699,77,3593,1456,2340,99543,1253
44248,41,704,771,531,37249,173
31863,2,72,1008,55,3451,17
64970,10,164,214,130,3531,34
8422,170,8185,1382,5218,67373,2967
32042,8,197,1005,120,6123,77
12266,7,814,1356,376,10708,438
27289,2,133,1094,77,5643,56
31922,22,303,1007,177,3485,126
17345,14,266,1282,195,8148,71
8835,854,31081,1380,18291,117565,12790
14969,53,813,1319,574,12381,239
26052,7,359,1122,247,32579,112
5941,19268,811560,1411,452708,1418065,358852
66497,7,200,174,145,3637,55
19189,12,621,1248,430,15586,191
63223,245,2520,267,2065,30676,455
18993,186,5068,1252,3774,62928,1294
40381,38,922,828,732,13524,190
62798,20,332,277,245,5002,87
59435,7,86,391,57,5448,29
41677,17,257,808,218,11233,39
53390,50,1895,576,1533,13552,362
49561,427,10900,686,7821,51310,3079
31025,0,48,1020,34,3773,14
3971,67,1647,1435,1166,23123,481
27201,67,970,1096,686,15072,284
21677,1,103,1205,72,4633,31
495,46,1706,1466,1216,19415,490
14716,14,572,1322,420,44886,152
3207,16,790,1443,539,28469,251
65835,50,1104,193,866,18266,238
28209,23,941,1075,546,10063,395
6468,422,7456,1404,4917,68455,2539
24783,11,215,1149,138,6274,77
48739,36,927,710,487,12404,440
60431,8,144,356,70,6519,74
64294,16,120,235,86,6029,34
10183,17,637,1373,442,10868,195
30338,63,1287,1033,801,10617,486
15667,175,5378,1309,3369,29358,2009
3520,221,5444,1440,3417,27013,2027
9884,395,13994,1375,8914,64986,5080
67064,61,1176,156,911,15896,265
48283,3680,74548,708,57040,471780,17508
43111,6,95,784,71,4630,24
57068,12,171,464,152,8447,19
32424,338,12921,999,9235,76752,3686
64716,142,3626,223,2966,32081,660
8321,118,3199,1383,2096,17352,1103
50443,330,3382,663,2660,27940,722
31493,64,1797,1013,1319,17534,478
53602,1458,30969,571,22947,106269,8022
47512,13,180,733,135,7422,45
10149,26,469,1374,299,8617,170
4805,12421,424132,1425,276613,822673,147519
26967,13,239,1101,184,14585,55
39580,61,867,840,694,19904,173
50449,6,50,663,40,4038,10
19097,7,357,1250,224,18364,133
49847,685,9614,679,7527,53390,2087
18071,12,497,1268,349,7552,148
52813,67,888,592,745,8029,143
14725,118,3190,1322,2027,64651,1163
21749,175,5280,1204,3134,47895,2146
63471,89,748,259,638,18426,110
24467,447,14766,1156,10387,101540,4379
53368,1,66,577,45,7411,21
17934,102,3793,1270,2677,34004,1116
764,2,124,1463,72,14562,52
57159,2688,44674,459,33560,215515,11114
8480,112,1726,1382,1098,18719,628
36306,582,15606,914,12316,58915,3290
12942,41,1124,1347,698,19637,426
59812,22,213,378,175,6758,38
23310,589,16264,1180,9855,68035,6409
59578,73,461,386,379,9987,82
51097,669,7681,646,5453,57319,2228
26851,4661,53875,1104,38392,190662,15483
8479,3934,156554,1382,94262,363460,62292
3771,91,9537,1438,6049,46376,3488
17352,16,642,1281,456,26360,186
55016,43,496,522,357,12546,139
65649,26,444,198,370,6395,74
58959,355,3686,407,2767,19052,919
34623,834,13381,956,9426,52703,3955
10804,266,5223,1369,3118,18185,2105
18428,177,5563,1262,3981,94123,1582
62289,173,2160,292,1773,25266,387
11062,660,13982,1367,9132,39266,4850
55488,23,482,509,377,16333,105
35247,98,1776,941,1287,33849,489
530,26,998,1465,776,29337,222
13856,1,111,1334,70,7936,41
4396,2,133,1430,97,10510,36
52267,6,63,612,37,4494,26
57977,12,118,439,93,19978,25
27816,62,1476,1083,947,21422,529
10894,12,806,1368,525,22003,281
1120,168,5581,1460,3426,32138,2155
33551,14,174,978,156,11955,18
17677,24,550,1275,424,9108,126
26592,3,364,1110,227,7671,137
66531,17,188,173,132,17701,56
10931,34,2241,1368,1296,38307,945
39884,94,1915,836,1394,14704,521
37345,73,883,887,612,18274,271
6682,65,2042,1401,1561,21453,481
27478,5,207,1090,122,9496,85
33217,165,3426,985,2302,12383,1124
15042,64,1403,1318,1086,71595,317
39052,6,134,847,111,9148,23
35056,2631,76940,946,49969,212026,26971
19458,82,2698,1244,1901,22374,797
51345,92,982,639,803,24954,179
27240,1,62,1096,50,10145,12
30678,27,707,1027,491,11704,216
36141,22,983,918,773,50511,210
5626,2574,101110,1414,66111,640726,34999
64415,12,251,232,200,5716,51
10527,2843,112225,1371,69650,305108,42575
37542,226,3613,785,3134,99890,479
23270,5,327,1180,224,11319,103
50947,102,1763,650,1379,21529,384
34359,656,17210,962,12705,118749,4505
65426,248,6350,204,4647,58455,1703
15428,2330,28532,1313,20758,207953,7774
18626,146,5757,1258,4541,103133,1216
48041,15,404,727,323,18210,81
54699,7,65,533,48,6535,17
19428,2,45,1244,32,6868,13
13218,342,9807,1344,5729,73182,4078
43465,2,50,780,39,5683,11
41651,4,232,808,163,4219,69
34318,150,2774,963,1971,34081,803
13078,136,6601,1345,4272,51066,2329
21773,36,1648,1203,985,15245,663
372,8,480,1467,351,9632,129
42328,19,261,798,208,7275,53
15683,0,86,1309,61,4405,25
56449,5,77,482,54,5638,23
1655,43,2211,1457,1542,42640,669
4083,33,1162,1434,712,13984,450
40379,28,583,828,538,22613,45
31610,42,1720,1012,1275,13517,445
21454,6141,132836,1208,88244,391982,44592
11578,52,1056,1363,636,14474,420
36250,53,1606,916,1323,17778,283
22959,1656,51014,1185,33144,225765,17870
38152,33,703,865,594,17133,109
52718,2597,33753,595,21329,206722,12424
18833,26,1001,1255,726,14711,275
34509,121,2864,959,2465,30488,399
3876,25,984,1436,672,26228,312
19280,0,0,1247,0,24333,0
68546,23,526,107,297,9247,229
32266,29,1495,1002,1021,22317,474
37376,14,269,886,216,7324,53
39087,38,751,846,576,10736,175
17150,38,845,1285,538,7496,307
17935,3,63,1270,50,3337,13
65832,3,36,194,25,4031,11
62506,2045,27937,285,20984,71921,6953
59547,1887,68341,387,46695,121124,21646
9096,26,960,1379,581,11679,379
61164,10,142,328,104,5265,38
46513,7,109,746,85,6156,24
58308,28,258,428,207,6546,51
28710,25,221,1065,141,3032,80
14633,23,506,1323,346,14383,160
10657,92,3220,1370,2081,26717,1139
59606,7,219,385,154,7684,65
33231,34,2248,984,1623,49398,625
8591,45,2108,1382,1379,17117,729
40870,10,146,821,113,3563,33
38441,607,9445,858,7477,84616,1968
12713,32,1316,1351,747,13665,569
2861,48,841,1447,588,10358,253
12048,9,235,1358,139,7072,96
62000,35,509,301,393,4821,116
56257,22,379,487,295,17514,84
2843,26,1012,1447,745,14179,267
8421,216,4185,1382,2882,24663,1303
1805,30,1123,1456,700,14970,423
30503,44,685,1030,453,17675,232
21148,5258,134303,1214,89145,285602,45158
58193,75,538,432,432,17001,106
15446,48,973,1313,683,12123,290
26184,86,1922,1119,1208,16457,714
53569,56,1051,572,791,14078,260
53695,19,205,568,163,8640,42
48535,33,698,717,500,19504,198
61399,23,609,321,478,5677,131
26941,56,2203,1102,1331,22853,872
35618,205,3733,929,2865,35283,868
61311,3,46,323,40,7235,6
32072,84,1861,1004,1305,30858,556
20520,112,1874,1225,1473,41006,401
18966,13,355,1252,324,9886,31
54675,16,143,533,133,6424,10
52104,193,2554,617,2003,44928,551
28744,12,163,1065,109,3069,54
53608,394,4977,571,4229,93702,748
56797,177,1921,472,1524,15854,397
13303,24,540,1342,270,7961,270
31409,11,266,1015,182,7862,84
10412,12,219,1372,135,5091,84
39999,111,1578,834,1185,11034,393
58205,718,9907,424,7326,137307,2581
67263,108,1956,148,1699,23299,257
9459,22,532,1378,351,12349,181
30934,4,81,1022,62,3728,19
16933,49,1412,1289,884,12046,528
52967,50,749,588,596,30344,153
32114,138,6778,1004,4561,18559,2217
42945,133,2771,787,2082,28203,689
4359,141,4387,1431,3157,25882,1230
39930,30,608,836,446,8121,162
64162,4,58,239,41,4759,17
49356,246,3985,691,3406,51098,579
5371,21,339,1417,213,11867,126
15624,15,985,1310,601,13733,384
53543,9,158,573,137,5346,21
28390,1145,37333,1071,24205,161661,13128
14685,33,434,1323,287,10973,147
63307,5,29,265,20,1694,9
53345,148,1503,577,1255,29816,248
29661,20,327,1048,205,8647,122
19533,27,1139,1242,827,25772,312
24755,6,181,1149,132,5297,49
175,143,6200,1469,3974,56439,2226
25692,164,6009,1129,4414,55680,1595
29311,1574,22358,1054,16336,145439,6022
759,791,95899,1463,64510,574528,31389
19862,3,153,1236,135,20982,18
16080,6,279,1302,197,10909,82
4666,37,2239,1426,1551,39236,688
541,31,899,1465,624,22594,275
15634,53,741,1310,558,22263,183
17721,13,620,1275,424,21008,196
60275,57,348,362,255,4397,93
31474,55,900,1014,567,25618,333
1124,24,1104,1460,747,64114,357
55281,6,105,514,76,5577,29
61671,2,25,312,18,3088,7
64904,15,108,217,102,5220,6
16238,2023,56569,1300,36911,493496,19658
65203,77,1413,209,1130,12253,283
24862,50,602,1147,463,7962,139
58550,3,46,419,37,2370,9
30032,94,1726,1040,1258,23908,468
27273,16,559,1095,335,6377,224
65772,5,108,195,84,2644,24
60036,101,1088,370,935,18350,153
56748,54,1026,471,783,24047,243
38956,8,66,848,54,2527,12
65066,2,12,211,12,2075,0
62630,15,349,281,244,6140,105
14908,48,1060,1320,699,6412,361
53962,41,539,560,349,9680,190
65359,1237,21651,205,18714,89178,2937
18376,42,2751,1263,2024,49998,727
10834,456,14147,1369,9090,131876,5057
27325,2,174,1094,113,4716,61
54961,228,2442,523,1970,25674,472
14535,4,50,1324,43,6888,7
53698,351,3596,568,2719,51616,877
30859,4,88,1023,69,12132,19
37727,24,622,876,478,9899,144
22100,139,5523,1199,3866,56266,1657
25420,34,595,1135,391,11100,204
27867,566,12908,1081,8580,96916,4328
29497,34,1074,1051,692,12720,382
31532,4,92,1013,59,3859,33
59573,3,69,386,46,5758,23
49547,1541,38751,686,27374,268566,11377
9755,1244,93167,1376,51616,264449,41551
68462,14,147,104,129,4799,18
50597,18,228,659,167,4322,61
41950,67,2369,803,1865,19098,504
10974,58,2602,1368,1702,53408,900
66168,18,311,183,238,5375,73
10613,21,789,1371,537,29462,252
53488,18,240,574,187,4451,53
67231,25,275,150,214,2917,61
5066,110,2707,1421,1900,21925,807
59497,5,70,388,63,4556,7
38188,10,190,864,138,5016,52
18688,140,3466,1257,2477,65929,989
15089,46,2859,1318,1769,19130,1090
14298,0,0,1328,0,22169,0
11733,14,332,1361,149,18104,183
11268,0,0,1366,0,12375,0
18121,90,3308,1267,2132,17457,1176
27447,187,7385,1091,4307,31344,3078
34830,2,128,951,108,11251,20
45947,54,1073,753,870,20234,203
28058,0,0,1078,0,3964,0
14793,273,14670,1322,8734,53690,5936
58441,36,354,423,281,7178,73
19932,3,107,1235,94,6805,13
29379,11,214,1053,126,7271,88
52581,55,726,601,561,13628,165
35742,22,462,930,364,24140,98
1446,52,1557,1458,1104,30805,453
64181,8,49,239,35,4123,14
34444,299,4531,960,3484,29510,1047
20699,49,1688,1222,1392,22426,296
63700,6,60,254,43,4215,17
5099,45,1377,1421,951,91113,426
14547,472,18055,1324,11857,103746,6198
11004,100,3754,1367,2264,53728,1490
7014,11,323,1397,195,8107,128
17307,372,10599,1282,7517,80224,3082
68979,13,179,92,153,4844,26
53998,11,180,558,134,6260,46
54389,13,175,544,156,10973,19
69038,14,181,90,130,3828,51
50480,3134,36186,662,28593,219397,7593
55597,154,2224,506,1789,14938,435
3656,54,3476,1439,2314,60842,1162
57751,16,131,447,115,3127,16
15482,0,0,1312,0,13552,0
56614,6481,108080,476,83465,456551,24615
23828,244,2575,1170,1805,100141,770
59963,30,487,373,375,6052,112
17460,11,208,1280,158,5788,50
15021,181,5094,1319,3345,51915,1749
59266,57,564,396,474,8523,90
17978,676,10244,1269,7415,54914,2829
58152,31,404,433,324,6173,80
35205,13,326,941,259,7873,67
10016,8,322,1374,207,9121,115
14407,0,0,1326,0,11422,0
12185,233,10455,1357,6002,55243,4453
50292,317,3901,667,3171,26335,730
22066,101,2861,1200,1977,36410,884
1999,97,2020,1454,1500,63399,520
63191,60,1558,266,1198,15270,360
31880,89,1662,1007,1104,9268,558
61803,19,291,308,234,5248,57
37102,16,414,894,309,11464,105
787,16,945,1463,599,12876,346
41347,30,677,813,534,6643,143
67915,9,250,128,191,4256,59
63394,535,5463,262,4245,46191,1218
15944,48,794,1305,505,10271,289
58704,6917,122361,409,90712,438902,31649
52584,7,103,601,82,15067,21
1488,14,307,1458,216,8007,91
3341,170,4084,1442,2622,29944,1462
3216,1133,53654,1443,31934,312461,21720
42803,22,311,789,241,9021,70
20460,1252,33881,1226,22485,225944,11396
22673,7,68,1190,53,3102,15
3450,2,75,1441,60,5863,15
7730,116,2032,1387,1318,37451,714
49167,582,11300,697,8699,73338,2601
68832,15,171,97,155,6550,16
10853,74,4243,1369,2210,29101,2033
2195,10,385,1452,284,17457,101
21507,31,517,1207,420,12089,97
12441,1042,35805,1354,21786,118734,14019
37081,804,20461,895,15506,91570,4955
30187,67,1246,1036,877,24687,369
33714,91,1448,975,1049,11932,399
52050,24,343,619,257,11309,86
49116,124,1776,699,1517,11250,259
20489,24,658,1226,470,9922,188
26952,769,15326,1101,10492,172521,4834
61275,3,60,324,53,2065,7
17944,16,599,1270,486,8662,113
55592,71,1320,504,1124,30033,196
39847,79,2659,835,2138,20399,521
27715,14,323,1085,215,5922,108
53415,17,146,575,131,4238,15
21100,52,1963,1214,1451,18816,512
56034,43,777,494,572,18714,205
67723,13,157,135,111,5426,46
68565,9,197,106,152,4206,45
18711,10,852,1257,582,14139,270
52837,49,915,590,726,12571,189
55654,45,383,504,298,7536,85
26641,111,2225,1108,1543,26314,682
3205,346,10087,1443,6009,55774,4078
12199,12,358,1357,205,10649,153
10622,1089,45627,1371,29446,236138,16181
19454,141,6292,1244,4098,34708,2194
15737,9,540,1308,374,17266,166
8038,517,8517,1384,5790,84720,2727
12629,2975,104652,1351,58179,464921,46473
20582,3,190,1224,134,10121,56
19243,122,2548,1247,1711,32910,837
19197,3,262,1248,176,11109,86
9623,418,15770,1377,9720,68292,6050
44136,213,3451,773,2780,29645,671
34874,14,714,950,444,16179,270
2967,35,2172,1445,1566,55827,606
68321,32,666,115,550,12371,116
54261,38,448,549,396,16763,52
50640,164,3047,658,2475,21188,572
59533,182,3661,387,2896,25576,765
27980,335,11291,1079,7162,59072,4129
56021,96,1391,494,993,30272,398
64227,8,146,237,97,6264,49
49319,642,7738,692,6305,109555,1433
27475,7,463,1090,267,8158,196
5074,264,10104,1421,6953,59109,3151
16520,713,15245,1296,9295,54240,5950
5072,1281,84603,1421,40557,198382,44046
23606,56,1925,1175,1553,84800,372
6751,33,1065,1400,684,19152,381
36784,22,942,903,693,7612,249
31951,27,636,1007,443,20457,193
7835,18,926,1386,563,11780,363
58838,52,539,411,473,8383,66
20625,15,1019,1223,738,25828,281
7114,23,2533,1396,1608,77464,925
17054,97,3544,1287,2609,32568,935
44368,14,496,770,398,20653,98
49677,788,14331,683,11376,112402,2955
68475,25,503,110,406,10041,97
21766,15,356,1204,229,3758,127
30793,139,3409,1024,2572,35456,837
31113,241,8112,1019,4349,25034,3763
29570,134,3172,1049,1979,91763,1193
22425,350,18143,1195,12488,94128,5655
12798,16242,810016,1349,422863,1668317,387153
34396,141,2060,961,1548,25886,512
5094,16,789,1421,536,17977,253
36998,5,91,897,79,5515,12
11956,85,5306,1359,3271,44103,2035
17272,633,17147,1283,12155,157996,4992
54063,35,344,556,286,8987,58
17385,83,2378,1281,1904,22749,474
9440,10,599,1378,347,6545,252
20651,62,969,1223,727,16962,242
52507,56,1043,603,779,19450,264
40026,107,1959,834,1766,28168,193
62001,4,99,301,81,9415,18
50598,2408,37735,659,25640,227189,12095
31297,322,5945,1016,4119,105441,1826
30582,20,383,1029,249,3047,134
30488,623,14240,1030,10195,107153,4045
37180,6,122,892,99,6854,23
38342,206,3436,861,2695,44400,741
68716,3,99,101,65,1852,34
9955,88,2932,1375,2096,14049,836
52726,107,3559,595,2277,26361,1282
4545,13,387,1428,248,5756,139
15213,538,20031,1316,12744,95760,7287
14132,49,1210,1330,786,16163,424
17397,10,429,1281,282,12765,147
66299,837,10124,180,7890,71694,2234
19093,14,443,1250,318,10578,125
10494,1597,56458,1371,34330,188617,22128
52611,116,998,600,755,7313,243
44774,91,1229,766,867,16120,362
40790,200,3438,814,2462,60745,976
45430,6,252,759,199,8775,53
23713,899,46164,1172,31121,112455,15043
57435,163,1112,455,835,24573,277
11032,47,2157,1367,1257,30218,900
22624,2698,57867,1191,32531,139632,25336
19922,5926,149089,1236,100142,355581,48947
39918,408,9597,836,7539,57676,2058
17988,3,152,1269,116,10242,36
23569,85,3005,1175,2124,26462,881
31019,754,14597,1020,10245,124225,4352
53641,749,7123,569,5430,42284,1693
5897,12,487,1411,380,15776,107
34919,24,297,949,201,4790,96
28507,540,10178,1069,6936,48309,3242
60652,454,5001,347,4011,35747,990
64645,52,818,225,689,10543,129
57767,37,403,446,319,5138,84
30719,20,693,1026,464,10372,229
57799,6,89,445,70,1634,19
62395,10,149,288,117,2697,32
8984,3,181,1380,97,11470,84
31846,31,1627,1008,1033,11316,594
13902,16,382,1334,220,6829,162
12776,22,553,1350,306,18983,247
27864,22,1047,1082,655,6769,392
33162,7811,192432,984,144352,890215,48080
36363,417,9258,912,7365,70287,1893
53406,4,46,576,38,1188,8
43601,9,111,778,98,6086,13
30200,1334,29997,1036,20842,185256,9155
15905,133,3459,1305,2128,51119,1331
17554,81,1977,1278,1349,19571,628
65987,16,330,190,254,2792,76
18476,14,386,1261,274,12185,112
64838,49,754,219,537,11926,217
66705,3,34,168,24,2479,10
48753,5,89,710,74,3977,15
61724,0,0,305,0,5742,0
2259,5,268,1452,198,13091,70
65946,131,1902,191,1593,24660,309
20874,514,6287,1219,3536,33931,2751
50374,0,44,665,35,4238,9
50775,8,278,655,201,6913,77
14056,22,906,1331,569,26301,337
15545,703,12978,1311,8350,123066,4628
60454,462,5984,355,5046,50465,938
55936,66,536,497,416,9396,120
8129,37,1173,1383,754,9986,419
17301,14,545,1282,412,9974,133
8330,8,384,1383,256,9952,128
23868,19,510,1169,338,9613,172
21980,68,1440,1201,951,16773,489
51848,36,547,625,427,10032,120
58856,22,246,410,198,7787,48
11336,2584,92506,1365,57104,168631,35402
18210,48,930,1266,706,14904,224
52055,9,86,619,71,4753,15
49718,0,2620,682,1130,12018,1490
883,141,3625,1462,2551,52349,1074
42870,27,784,788,614,9001,170
16134,574,6847,1302,4983,71457,1864
59570,302,7727,386,6339,62509,1388
23153,48,1360,1182,1047,19331,313
11935,84,2198,1359,1309,13690,889
12507,141,3458,1353,1909,43468,1549
3213,23,659,1443,470,10029,189
59558,2525,50684,387,38676,310677,12008
17969,2946,80056,1270,48442,227226,31614
30325,9,351,1034,218,15319,133
28895,15,959,1062,599,11147,360
66942,20,274,159,190,9148,84
47759,10,183,730,148,2695,35
35354,61,1850,938,1496,13287,354
14631,206,8787,1323,5840,34857,2947
16759,149,5417,1292,4037,51739,1380
34369,43,855,962,542,4085,313
50994,1452,29278,649,21400,74763,7878
24384,26,610,1158,460,20368,150
21889,83,2029,1202,1484,22864,545
30924,5,116,1022,80,11085,36
60762,220,2577,343,2175,27720,402
35944,58,1527,924,1186,13058,341
34014,63,1125,969,800,16966,325
16296,104,5341,1299,3112,32233,2229
37171,54,1423,892,1191,37162,232
22249,31,756,1197,486,6641,270
25896,56,1162,1125,620,8368,542
58017,2,30,438,24,3957,6
19918,417,15397,1236,9846,45805,5551
10608,100,2770,1371,1701,28435,1069
21815,320,10244,1203,6909,55522,3335
34346,10867,333767,963,208007,757561,125760
23177,3,130,1182,100,6347,30
33047,29,452,988,247,5710,205
66647,10,142,169,122,6640,20
19479,1,230,1243,112,9044,118
12890,176,4044,1348,2611,48043,1433
9255,19,885,1379,621,14492,264
37650,13,156,879,127,2076,29
35192,574,13193,942,9230,169129,3963
33770,76,1740,963,1172,17938,568
12689,734,16406,1351,10058,111858,6348
26126,6201,173827,1120,109702,401404,64125
33862,180,3484,972,2595,28366,889
52391,900,12849,608,9436,59623,3413
36433,87,3447,910,2799,25768,648
29525,36,1034,1050,773,12577,261
29887,220,6247,1043,4674,56275,1573
41764,53,707,806,599,29007,108
53532,128,2041,573,1474,15512,567
37515,180,2980,882,2172,21558,808
7558,95,4731,1390,2930,49065,1801
11555,8770,327511,1363,207491,604037,120020
65577,85,868,200,779,10110,89
60305,78,1239,360,995,16679,244
55799,147,1595,501,1239,14683,356
7714,21,609,1388,453,23609,156
34464,11,507,960,315,14923,192
2335,212,4481,1451,3201,56525,1280
58833,21,192,411,158,5006,34
19538,2127,46162,1242,32018,136438,14144
60915,75,759,337,666,7431,93
38008,25,506,869,353,2809,153
13490,413,13920,1339,8862,81956,5058
38181,10,135,865,104,2328,31
14800,403,11972,1321,7918,46154,4054
19646,26,771,1240,579,11797,192
12260,36,1707,1356,865,24123,842
44627,12,268,768,224,5766,44
14592,33,1385,1324,986,36508,399
68981,55,742,91,601,6095,141
20573,305,7923,1224,5521,52527,2402
31076,96,3342,1019,2201,40116,1141
50935,28,277,651,229,6638,48
35047,9,193,946,135,7123,58
50243,458,7223,668,5482,34760,1741
57942,39,517,440,431,9483,86
27105,37,2296,1098,1303,19192,993
8132,360,5611,1383,3460,24741,2151
68035,172,3248,124,2683,10353,565
37425,81,2198,885,1919,54923,279
39067,9,237,846,198,5763,39
5088,34,1446,1421,878,27851,568
57156,58,1168,462,790,19914,378
54119,27,398,554,295,11061,103
28034,44,833,1078,550,9778,283
40685,153,2663,823,2275,54034,388
10599,145,5411,1371,3607,56329,1804
27646,511,12936,1086,9712,72704,3224
22428,24,694,1195,589,7035,105
57792,128,1925,445,1497,12890,428
12089,28,1096,1358,624,9197,472
60946,10,52,336,39,6914,13
64707,106,1287,223,980,13687,307
60887,106,1442,338,1054,11251,388
58502,174,1748,421,1378,16121,370
16874,2,114,1290,86,13763,28
37162,44,823,892,692,15003,131
28215,35,1036,1075,662,18726,374
21778,253,6805,1203,4734,51744,2071
55632,487,8533,505,6476,50162,2057
36187,564,11061,918,9221,70634,1840
27736,187,5464,1084,3595,15617,1869
48379,168,2293,721,1953,29189,340
11714,139,2427,1362,1541,17871,886
62920,24,362,274,278,5345,84
14600,33,742,1324,568,21530,174
23374,35,1134,1178,836,24644,298
7430,1072,28109,1392,18394,169954,9715
66551,4,88,172,61,3960,27
34515,748,9325,959,6409,39334,2916
65022,473,1414,213,1213,67486,201
32423,28,500,999,322,24804,178
31481,55,2498,1013,1316,16648,1182
19985,4,266,1234,190,12485,76
7565,8,597,1390,427,14961,170
11845,248,10317,1360,5937,50345,4380
2471,300,7316,1450,5141,83906,2175
46712,211,3542,743,2758,87431,784
62017,265,4886,300,4092,31997,794
17788,3,177,1273,120,8374,57
15619,79,2975,1310,2262,37144,713
57038,37,695,465,543,11880,152
67857,19,230,130,194,10179,36
15142,135,12378,1317,7920,43688,4458
11510,27,1423,1363,742,19857,681
47915,0,0,728,0,3203,0
17602,876,45631,1277,29736,101207,15895
1653,1822,59352,1457,39001,201467,20351
485,3,159,1466,99,9064,60
33537,24,505,979,338,12618,167
33768,1020,20071,974,12844,113145,7227
51490,8,164,636,122,8867,42
26852,118,1760,1104,1230,33750,530
23976,51,919,1167,619,19128,300
58214,342,5776,431,4886,39103,890
42680,82,1709,791,1347,14511,362
63947,1127,17767,246,14325,109090,3442
41180,602,18076,816,11974,115120,6102
16487,35,739,1296,540,7857,199
49738,22,312,680,202,8594,110
1376,304,17344,1459,12385,190321,4959
28984,142,6394,1060,4044,45289,2350
55901,53,591,498,445,12007,146
14900,50,2920,1320,2114,14194,806
63120,75,793,270,641,12800,152
28929,12,308,1061,184,11586,124
52883,310,5712,590,4433,95247,1279
28691,129,2827,1066,1964,19288,863
39662,10,227,839,188,4955,39
16214,1125,20788,1300,14197,97252,6591
61768,117,1746,309,1386,10759,360
31322,28,798,1016,486,6548,312
55347,447,5266,513,4418,50848,848
21686,356,8408,1205,5664,61193,2744
26974,27,681,1101,415,16770,266
60799,186,4812,342,3659,33980,1153
25458,6,190,1135,129,5579,61
42824,80,1279,789,1000,22394,279
24314,49,965,1160,674,15344,291
20895,5,163,1218,118,5857,45
61917,9,123,304,102,2412,21
7620,25,743,1389,494,20885,249
22264,620,16701,1197,10888,96931,5813
20280,136,2964,1229,1974,31533,990
38065,13,430,868,371,12587,59
30783,45,625,1025,506,11490,119
6266,13,973,1407,630,7042,343
15277,153,3069,1315,2172,31894,897
10213,499,16879,1373,10645,82654,6234
17775,52,1429,1273,1004,15319,425
61101,325,7453,330,6254,67010,1199
25165,69,757,1141,507,6721,250
63621,146,6700,257,4977,22284,1723
559,42,2301,1465,1630,34084,671
14653,7,231,1323,139,6671,92
26290,359,11828,1117,7885,95725,3943
61864,82,1045,306,898,15022,147
39021,169,2882,847,2169,23139,713
36189,1499,15877,918,13190,127237,2687
42724,24,398,791,315,5799,83
33932,18,1075,971,667,9655,408
34751,52,1449,953,971,6255,478
29817,0,157,1044,88,4880,69
8691,23,1132,1381,710,13602,422
55850,456,7212,499,6063,45932,1149
21440,46,1481,1208,922,36036,559
4019,256,6117,1435,4508,24108,1609
14855,84,2641,1321,1653,13926,988
58096,14,105,435,73,5197,32
28301,629,13427,1073,8092,71175,5335
34660,10,248,955,167,11478,81
61523,151,3128,317,2207,26397,921
23955,703,32553,1168,19594,269008,12959
52007,70,849,621,685,10226,164
63318,26,257,264,216,9379,41
37728,47,650,876,517,15528,133
57608,27,229,451,207,5148,22
39358,52,718,843,575,20256,143
26509,174,2912,1112,1734,16429,1178
29882,18,624,1043,410,7066,214
61428,52,944,320,769,11695,175
67453,78,969,143,778,10921,191
17360,14,228,1281,152,6607,76
29040,393,12149,1059,7551,73092,4598
59071,66,482,403,392,7418,90
29475,18,526,1051,297,15527,229
12960,0,0,1347,0,12613,0
66521,2,65,173,46,3100,19
58386,6,116,425,96,3617,20
23525,109,2624,1176,1829,27762,795
39866,13,341,837,294,9965,47
62540,35,315,284,243,8977,72
64502,7,146,229,119,1892,27
67264,14,126,149,88,2083,38
11631,172,7399,1362,4492,53483,2907
35023,52,1112,946,779,12263,333
66682,32,545,168,439,8330,106
47098,4,52,739,32,3338,20
54614,155,2225,536,1780,25872,445
67988,827,18804,126,15569,108692,3235
57765,1215,20453,446,15901,73987,4552
23556,11,491,1175,262,4810,229
63788,289,6058,252,3606,37996,2452
37932,1,13,872,13,6193,0
25622,364,8650,1131,5647,56966,3003
40466,215,2821,827,2201,29569,620
22145,19,772,1199,544,15195,228
27372,497,9707,1093,5974,56958,3733
17927,20,675,1270,505,8072,170
6497,916,53598,1404,32784,306673,20814
5171,42,3896,1420,2575,29076,1321
40775,259,3695,822,2990,40218,705
33249,808,13858,984,9599,60420,4259
14355,116,2993,1327,2122,66827,871
1761,227,8332,1456,4985,45847,3347
18874,5,526,1254,389,21974,137
17581,138,13418,1277,8858,67576,4560
67603,10,437,138,340,6053,97
40058,3,164,834,126,6652,38
24711,34,359,1150,292,12449,67
61087,10,230,331,175,4535,55
6062,72,1389,1409,887,14304,502
56493,10,85,480,61,4279,24
29790,89,3087,1045,1974,38622,1113
32162,6,410,1003,216,7222,194
49399,25,351,690,313,6399,38
5640,82,3121,1414,1824,34893,1297
14299,36,667,1328,451,12050,216
64055,80,1833,243,1299,21161,534
6673,28,2205,1401,1483,19791,722
37999,471,11250,864,8645,77254,2605
54463,27,351,541,301,11090,50
4259,8704,423384,1432,244967,531350,178417
28878,360,10075,1062,6628,75597,3447
9152,44,764,1379,539,8698,225
60372,15,168,358,113,5721,55
38665,156,7552,852,6057,62606,1495
20672,31,1005,1223,721,27403,284
58358,84,1400,426,1109,13074,291
65148,4,14,210,12,2248,2
34038,362,8441,969,5783,37158,2658
36262,0,0,916,0,3264,0
31588,6,115,1012,99,5063,16
59022,42,397,405,293,6048,104
3224,56,1148,1443,864,74925,284
8454,146,7626,1382,4598,171356,3028
1542,278,5835,1458,3842,43614,1993
37947,32,330,871,256,5419,74
21719,85,1627,1204,1165,27048,462
1669,3,50,1457,40,3981,10
8412,221,4139,1382,2680,32658,1459
57512,131,1530,454,1273,19109,257
51496,181,6897,635,5036,16814,1861
53068,3310,37325,584,25870,341393,11455
60243,673,9426,362,7595,74017,1831
35698,53,1232,931,907,7691,325
18996,283,15163,1252,8264,66154,6899
15674,11916,476227,1309,320462,1303164,155765
17904,230,8953,1271,6136,59617,2817
62404,11,106,288,82,3136,24
53713,35,211,567,162,10484,49
4831,112,4213,1424,2527,17434,1686
52684,15,131,596,102,8833,29
45739,49,759,755,553,6728,206
18518,19,580,1260,436,15377,144
40145,241,2221,832,1783,9695,438
6288,52,1926,1407,1361,17503,565
44798,33,403,765,286,5905,117
48901,19,526,705,379,11140,147
27,86,4912,1472,4159,102195,753
60000,71,1736,371,1287,44001,449
64459,29,256,230,204,8405,52
34451,196,3104,960,2162,16201,942
21328,80,1112,1211,771,6107,341
9001,88,2684,1380,1625,29235,1059
28985,775,12061,1060,8388,33091,3673
52254,308,4376,612,3705,30330,671
33332,2,189,982,113,5687,76
33021,36,1018,988,651,9926,367
63851,2,26,250,25,3683,1
44998,0,42,763,24,1789,18
13412,144,3654,1341,2232,18751,1422
26764,984,17482,1106,13034,93747,4448
64678,24,440,224,301,7957,139
64690,128,1556,224,1128,17835,428
10595,26,1134,1371,752,28409,382
4727,331,5632,1425,3882,43766,1750
55802,97,1705,501,1369,22262,336
53244,21,306,580,258,8857,48
57701,26,336,448,266,6137,70
4488,0,12323,1429,7610,95468,4713
54531,130,4909,539,3602,20373,1307
17270,236,7046,1283,4994,65911,2052
15597,19,589,1310,365,19230,224
9279,787,25771,1379,16369,425189,9402
64390,33,869,233,738,10749,131
20349,15,642,1228,426,7162,216
33258,8,265,984,189,9429,76
17285,206,2605,1283,1922,19579,683
48476,75,1329,719,1001,16018,328
41982,261,3847,796,2721,37640,1126
37918,36,411,872,331,5366,80
50376,7228,109436,665,82202,322692,27234
53976,8,106,559,73,3400,33
65252,21,347,208,263,3657,84
61679,30,277,312,229,4915,48
60311,435,4999,360,3810,59872,1189
57340,99,1566,457,1278,14702,288
8438,12,355,1382,248,5921,107
9054,31,1170,1379,801,13015,369
35338,29,545,938,393,7579,152
66844,12,229,162,180,5432,49
59715,164,2441,381,1908,29782,533
6235,176,6316,1407,4287,49955,2029
39689,232,3468,839,2824,51636,644
41419,161,2537,813,1939,17771,598
64542,0,4,229,4,1362,0
28972,91,2214,1060,1381,19451,833
53751,497,5904,566,4656,46057,1248
12714,39,1659,1350,826,14655,833
50706,30,250,657,166,3349,84
51349,291,3826,633,3270,38618,556
8342,224,3484,1383,2616,26116,868
16617,1451,31002,1294,21641,137097,9361
7269,76,3675,1393,2622,36626,1053
60436,81,1120,356,782,21897,338
26732,9,430,1106,247,7495,183
28197,29,950,1075,557,6074,393
28465,277,5013,1070,3563,27779,1450
16844,183,4656,1290,3301,66589,1355
66011,3,66,189,62,2173,4
51705,131,3718,629,2850,26684,868
39964,3172,49903,835,37455,357364,12448
38113,731,21839,866,15911,120224,5928
64608,23,187,226,153,8651,34
15113,6,199,1317,150,16111,49
43941,12,191,775,150,6676,41
27405,19,728,1092,448,12863,280
10638,138,3334,1370,2255,66506,1079
62068,125,1099,299,867,15142,232
62099,1869,35479,297,27430,190648,8049
56306,13,156,486,118,3393,38
22078,19,374,1199,263,6893,111
6561,23,1016,1403,721,26969,295
12656,246,8257,1351,4972,36804,3285
40448,7,228,827,181,7414,47
14560,10,402,1324,293,6804,109
33446,56,1520,980,1140,11696,380
34908,4,154,949,120,20179,34
3283,76,2452,1442,1720,23552,732
1300,114,4551,1459,3001,31376,1550
48287,9207,140912,723,98455,369774,42457
58885,40,553,409,445,11469,108
54201,16,173,551,138,5283,35
3989,58,1842,1435,1375,24910,467
66131,6,86,185,66,3530,20
61925,14,175,304,114,3771,61
34480,344,6903,960,5168,63579,1735
10796,8,637,1369,422,13685,215
51409,67,923,638,796,13760,127
16432,35,1097,1297,888,23993,209
20622,87,2973,1224,2186,27574,787
68695,1,33,102,24,2173,9
36555,81,1322,906,1062,15055,260
18799,10828,308104,1255,203324,665813,104780
23216,1125,19109,1181,13487,86983,5622
26998,686,15503,1100,9788,71532,5715
37270,98,1420,889,1072,17611,348
16843,26,748,1290,506,16410,242
30014,60,1676,1040,1049,12342,627
2339,20,768,1451,555,30651,213
63441,106,1496,261,1236,10935,260
24462,581,12192,1156,7912,78149,4280
14370,1,152,1327,81,3456,71
50800,189,2572,654,1919,16397,653
28594,10,253,1068,167,9286,86
49165,236,3824,697,2399,21721,1425
37596,13,385,880,304,11042,81
66,0,1,1471,0,54844,1
29245,20,506,1055,295,7883,211
52199,7,115,614,90,4600,25
14669,9,460,1323,332,11666,128
25521,100,1875,1134,1138,23623,737
10579,4000,183468,1371,98999,589881,84469
57684,22,248,449,173,7357,75
49691,19,342,682,282,15261,60
38055,357,5425,868,3995,31135,1430
6252,21,946,1407,597,29458,349
14023,23,651,1332,410,15387,241
41291,310,4425,814,3291,27752,1134
29036,2103,74060,1059,48167,216141,25893
4086,1438,20087,1434,15315,149134,4772
6398,98,2747,1405,1910,31133,837
33173,191,2980,985,2004,29369,976
52811,130,2151,593,1466,19292,685
29102,22,397,1058,262,12294,135
68554,10,112,107,80,1968,32
64749,2,27,222,16,2924,11
14122,401,13405,1330,9466,96233,3939
21335,85,2620,1210,1890,53091,730
13235,134,4900,1343,3060,57235,1840
3296,557,6084,1442,3836,266424,2248
68523,0,11,108,7,1658,4
29665,78,1284,1048,826,20818,458
21887,3102,94763,1202,62667,481783,32096
47487,70,1145,733,870,28856,275
24844,137,2682,1147,1817,37904,865
144,126,8604,1470,4390,32770,4214
16515,24,545,1296,387,13605,158
32722,43,1405,994,997,30034,408
6907,413,20769,1399,12459,64711,8310
30650,7,259,1027,155,8885,104
15242,137,3054,1316,2148,73552,906
10839,10,545,1369,296,14361,249
60731,23,263,344,174,4269,89
29454,13,221,1051,137,3346,84
45970,10300,188576,752,144125,768744,44451
37347,11535,196242,887,137005,635798,59237
25234,124,4850,1139,3286,44173,1564
64442,1189,18912,231,15632,109027,3280
34129,103,2484,967,1751,22566,733
22475,8,311,1194,235,8519,76
49984,83,1809,675,1435,16185,374
20934,20,535,1218,386,13147,149
65090,42,1190,211,909,23237,281
49156,20,279,698,208,5268,71
8572,23,927,1382,608,14644,319
63733,19,356,253,273,12627,83
55698,8,76,503,64,9565,12
15109,466,9693,1317,6198,89329,3495
33661,5660,101895,976,77027,406801,24868
12504,31,1445,1353,787,18869,658
22982,14,813,1185,523,27596,290
66827,60,892,163,701,8723,191
21382,68,2616,1210,1704,40615,912
29785,13,742,1045,417,15752,325
16824,5,141,1291,114,13303,27
49093,4,111,684,83,2092,28
1738,13,669,1456,448,14270,221
22088,10,313,1199,204,9014,109
521,598,31123,1465,20707,125331,10416
49519,167,2467,687,2061,33790,406
63044,56,1094,271,824,11512,270
23088,16,603,1183,467,12841,136
22755,73,1052,1189,815,29594,237
61977,32,405,302,324,5646,81
9941,78,1637,1375,1069,13984,568
28116,9,197,1077,135,8432,62
36204,4,138,917,118,4952,20
16810,34,1000,1291,739,14110,261
52907,5430,109463,589,83463,478344,26000
13475,255,13506,1340,8069,67489,5437
61890,111,778,305,632,5754,146
17830,102,3065,1272,2266,40560,799
25445,30,424,1135,275,4919,149
50941,1424,22887,651,16383,101300,6504
66294,11,189,180,159,14669,30
57412,65,382,456,288,3761,94
57638,42,434,450,312,16088,122
44425,0,25,769,20,7094,5
36107,62,544,920,394,6309,150
57984,27,467,439,372,24375,95
32553,152,4068,997,2691,21093,1377
35686,97,1419,931,1050,12609,369
26949,167,3067,1101,1916,31292,1151
67654,39,408,137,347,9100,61
38223,19,271,864,188,6664,83
62419,26,388,288,295,6603,93
51806,21,198,626,173,6857,25
11972,25,2557,1359,1242,25881,1315
62850,19,178,276,124,5556,54
49657,101,1635,683,1338,48311,297
24849,42,1568,1147,1000,18267,568
1901,77,3622,1455,2568,29109,1054
26132,355,4847,1120,3751,48242,1096
11052,1025,29099,1367,18050,114705,11049
18164,18,391,1267,304,8062,87
10970,24,981,1368,622,12005,359
22109,40,958,1199,602,32237,356
625,25,2739,1464,1659,30793,1080
63944,24,207,247,160,2834,47
49945,116,1599,676,1201,15871,398
62988,12,218,273,165,7085,53
36218,27,380,917,306,7663,74
17525,13,537,1278,390,12555,147
68775,0,4,99,3,708,1
4462,101,4660,1430,3175,99194,1485
19242,637,7803,1247,5814,33875,1989
54654,14,113,534,69,6674,44
30419,33,954,1032,546,10742,408
50049,2,41,673,38,2660,3
56181,11,133,489,79,5298,54
17064,36,1133,1287,905,39566,228
60488,6,23,353,19,2551,4
36132,1383,22981,919,16507,93431,6474
15571,24,1643,1311,1190,24074,453
28714,3938,93526,1065,57548,563672,35978
34634,20,640,956,429,13291,211
16410,438,11632,1297,7725,126147,3907
53518,3320,35208,574,27105,247162,8103
45626,11,151,756,99,11066,52
19637,1,47,1241,33,5972,14
50192,14,193,670,147,8413,46
11476,37,2910,1364,1788,18392,1122
28773,14,239,1065,209,6891,30
62686,33,573,280,401,7581,172
62321,0,3,291,3,1479,0
20613,0,33,1224,26,4179,7
24661,26,837,1151,564,24402,273
38114,29,276,866,210,4646,66
55035,332,12242,521,8962,77205,3280
65107,83,905,211,802,12572,103
19966,52,1397,1235,1094,12736,303
15048,34,657,1318,490,14695,167
26228,47848,1234288,1118,725926,3315838,508362
26024,41,1351,1122,798,39130,553
65918,28,566,191,387,10956,179
55974,286,3938,496,2776,27588,1162
65760,4,77,195,57,6385,20
31229,12291,344811,1017,208396,1442782,136415
13717,85,2096,1336,1355,11475,741
12343,28,2706,1355,1374,17984,1332
6128,8,139,1408,87,12192,52
5964,81,2513,1410,1676,59935,837
29246,9,197,1055,132,6345,65
12705,420,21772,1351,13510,100869,8262
57108,3,111,463,56,7753,55
61375,16,213,321,124,3791,89
9208,157,6011,1379,3708,49435,2303
49907,12,205,677,155,2711,50
29629,27,830,1048,538,12207,292
10734,12,260,1370,179,4936,81
55391,52,528,511,377,15933,151
50023,1,29,674,26,2211,3
15888,12,512,1306,357,17398,155
17068,78,2436,1287,1870,29135,566
55695,10,158,503,125,5124,33
40075,14,149,833,131,4894,18
68359,0,8,114,8,1693,0
24981,14,304,1144,256,8187,48
61950,6,58,303,44,1795,14
17104,42,1973,1286,1614,23883,359
32697,408,12476,995,7825,115748,4651
34776,376,5970,952,4372,47933,1598
54156,105,963,553,796,10461,167
27587,182,5018,1087,2977,20596,2041
58059,126,2962,436,2444,14522,518
26230,20153,887876,1118,519716,1846758,368160
65291,11,146,207,105,2961,41
50377,4024,66889,665,46635,343960,20254
54013,38,348,557,285,10768,63
40031,27,424,834,297,11345,127
51236,18,218,643,178,7934,40
7016,39,855,1397,573,10318,282
9396,52,1436,1378,883,32348,553
56894,2006,22730,469,11783,459034,10947
60848,12,202,340,165,2498,37
29524,60,1492,1050,1030,26840,462
10523,29,702,1371,460,14265,242
21668,10,349,1205,237,4613,112
64561,113,2131,227,1324,18938,807
65557,27,309,201,255,6074,54
50887,5975,89045,652,62600,258439,26445
36836,52,598,902,481,11057,117
52537,188,3182,602,2560,58397,622
66089,56,1149,186,991,15075,158
38935,57,847,848,664,9046,183
15563,14,655,1311,480,22445,175
66874,11,259,162,229,6183,30
1048,186,2727,1461,1654,12802,1073
17835,2124,52982,1272,31718,233291,21264
62667,400,8866,281,7183,66652,1683
50808,93,1651,654,1141,30722,510
34133,32,1011,967,577,10959,434
53774,492,4728,566,3867,36425,861
59550,645,16242,387,12524,79816,3718
23190,15,376,1181,312,26946,64
54450,129,1388,542,1101,13417,287
34445,3,98,960,66,7486,32
55033,45,548,521,458,5516,90
14982,36,1396,1319,974,19093,422
33276,239,3790,983,2759,27163,1031
24722,2,188,1150,137,17619,51
62796,66,663,278,569,6058,94
61059,23,373,332,214,7877,159
34913,748,18139,949,13366,166628,4773
52303,41,473,610,354,9440,119
47364,46,1001,735,873,45682,128
4324,3,80,1431,57,12681,23
66426,10,130,176,97,2580,33
22808,351,11547,1188,8339,109505,3208
5850,181,8100,1412,5459,126891,2641
49226,12,237,695,175,4751,62
67031,4,60,157,49,1827,11
16690,35,823,1293,606,42064,217
43081,530,5748,785,4550,52886,1198
11756,3608,187462,1361,92701,772550,94761
11263,165,3128,1366,2108,30405,1020
462,3,297,1466,212,14359,85
2590,131,3465,1449,2230,13102,1235
42084,2257,39185,797,31221,221345,7964
4717,6,212,1426,137,23497,75
24819,17,216,1148,160,7249,56
1523,5,285,1458,194,8102,91
16867,13,581,1290,422,18388,159
39640,175,3407,839,2750,20525,657
8068,44,983,1384,615,13582,368
374,36,1752,1467,1074,20598,678
62995,3,69,273,44,3022,25
22449,20,1055,1194,726,33300,329
52394,2,27,608,21,3606,6
66852,14,283,162,197,5925,86
3398,112,2648,1442,1911,23342,737
6840,109,5067,1399,3276,81396,1791
17092,113,13250,1286,7869,41150,5381
52239,9046,138498,613,100158,427070,38340
62753,67,932,277,779,10851,153
49315,5,84,692,55,2964,29
20834,508,6668,1220,3652,24734,3016
61183,19,410,327,321,7667,89
60705,10,122,345,85,6393,37
63390,2,41,263,27,2250,14
43012,15,250,786,190,12310,60
46624,15,472,744,312,8550,160
4711,16,397,1426,282,12850,115
54468,41,214,541,162,4214,52
28346,11,684,1072,399,7598,285
20356,37,622,1228,416,11550,206
19208,183,5984,1248,4025,64830,1959
10663,313,10650,1370,6532,102995,4118
21438,76,3053,1208,2254,66001,799
39006,5,84,847,67,1833,17
66616,7,90,170,69,3714,21
57034,46,514,465,409,5486,105
37045,46,723,896,576,9458,147
21674,14,634,1205,396,5951,238
65379,4,41,205,33,5709,8
2379,48,1259,1451,880,16983,379
18952,4936,128020,1253,84631,292682,43389
53966,18,103,559,88,5055,15
30529,15,427,1029,286,11010,141
49964,992,20224,674,14702,166907,5522
59760,391,6638,379,5599,30505,1039
41735,782,24725,807,20946,229929,3779
6646,47,1801,1402,1052,18298,749
59003,4,77,405,61,4756,16
50365,496,6364,663,4984,67900,1380
26144,19,517,1120,342,8227,175
32750,14,355,993,214,6169,141
60174,3,52,365,45,2310,7
36313,23,716,914,604,12221,112
38650,20,315,852,233,3447,82
36012,439,6670,923,5402,77179,1268
29610,36,727,1049,614,16243,113
36333,221,6702,913,5076,23659,1626
60579,7,77,350,58,2937,19
28237,4,262,1074,133,5859,129
38362,1368,33359,860,25664,236388,7695
61173,14,137,328,133,7731,4
36360,71,703,913,607,16385,96
31168,613,12515,1018,8182,120271,4333
66899,12,270,161,158,4993,112
7812,60,2128,1386,1427,31308,701
60586,8,130,350,95,4140,35
58100,1436,45466,435,35743,111390,9723
26189,106,1437,1119,934,8978,503
3993,10,350,1435,251,7332,99
27824,13,201,1082,171,15527,30
46586,11,242,745,213,9577,29
19031,55,1950,1251,1481,38650,469
58584,32,502,418,400,8994,102
15986,3,93,1304,70,13360,23
59893,223,3207,375,2572,17779,635
780,219,7104,1463,4141,114212,2963
48835,81,833,707,596,17328,237
7611,69,2267,1389,1583,34308,684
44804,101,1435,765,1164,17432,271
33885,83,2789,972,1989,29382,800
52927,794,11288,589,8783,50199,2505
57503,137,1494,454,1227,9006,267
21986,13,600,1201,356,4413,244
63537,136,1133,243,1021,11127,112
5488,12,796,1416,570,12542,226
39782,8,138,838,104,3564,34
4068,42,1024,1434,715,14771,309
1821,36,1568,1455,1098,56281,470
12869,24,1663,1348,765,11825,898
13474,9,755,1340,518,12685,237
56452,86,997,482,818,11702,179
24941,7666,142949,1145,95320,687041,47629
38482,40,656,857,500,10404,156
17871,29,789,1271,527,11985,262
24289,42,1204,1160,733,6267,471
54851,145,1248,527,1009,14008,239
17767,36,1387,1274,1004,20830,383
22307,5045,144185,1197,78346,303446,65839
60508,508,10656,353,7819,46060,2837
60575,196,3456,350,2552,27392,904
67441,185,5236,143,4026,41356,1210
64550,29,449,228,338,8944,111
54397,103,1431,544,1125,20291,306
55139,58,789,518,667,14258,122
65655,45,1128,198,768,14551,360
59520,5,37,388,29,2363,8
19858,151,2813,1236,1966,18083,847
54684,801,13644,533,11014,107543,2630
27960,1589,85356,1079,55957,171770,29399
66287,12,215,181,182,6199,33
66526,9,75,173,71,4223,4
63087,11,96,270,77,3800,19
13637,990,23514,1337,15125,136590,8389
36202,4,63,917,44,3430,19
55845,18,352,500,284,7281,68
37922,22,213,872,169,63799,44
38440,2602,49061,858,34315,93012,14746
68825,23,240,97,200,5642,40
12350,54,1707,1355,1096,20152,611
39980,13,300,835,215,7318,85
21988,569,15520,1201,10850,116718,4670
7845,122,3205,1386,2149,41141,1056
68186,558,6617,120,5447,24452,1170
17457,97,1841,1280,1493,59860,348
13316,65,4232,1342,2206,36583,2026
19490,16,906,1243,672,30667,234
16108,108,1938,1302,1269,13586,669
411,30,701,1466,445,11360,256
62610,63,731,282,574,10595,157
59196,12,169,399,121,5179,48
14200,7,285,1329,189,15503,96
5642,783,39506,1414,25102,203580,14404
35597,36,554,932,406,9476,148
20444,23,1703,1226,1130,27559,573
10909,11,434,1368,239,11927,195
29899,71,1744,1042,1118,16814,626
38351,22,334,861,265,6002,69
5179,49,1986,1420,1340,13107,646
1045,69,1694,1461,1221,21058,473
30767,16,534,1025,340,4698,194
18346,122,4305,1263,3081,40482,1224
28826,24,443,1063,389,18888,54
25800,36,963,1127,580,31699,383
9645,5062,112433,1377,78648,528169,33785
54942,1,14,524,11,2459,3
18988,25,799,1252,497,15306,302
11021,149,2969,1367,1866,21524,1103
3620,402,26440,1439,17671,295790,8769
36840,30,588,902,443,7840,145
51375,56,581,638,448,8959,133
36324,36,842,913,748,11346,94
9111,110,2956,1379,1992,30402,964
24550,17,358,1154,252,4812,106
1097,5,162,1461,126,6796,36
31832,48,753,1008,540,16305,213
26246,74,2044,1118,1524,14013,520
17381,7,134,1281,84,3396,50
17749,0,99,1274,86,8035,13
50862,102,1244,653,950,20245,294
64218,24,202,238,168,1934,34
46973,10,432,740,268,17568,164
54665,22,190,533,160,5321,30
34091,3,82,968,62,2788,20
41424,26,799,813,593,8258,206
68038,68,1169,124,865,8425,304
39659,13,154,839,119,4726,35
20393,29,725,1227,529,10714,196
29419,4659,119836,1052,80098,694274,39738
28742,16,239,1065,180,2922,59
27751,41,851,1084,552,16051,299
42764,9,226,790,187,11426,39
51164,66,646,644,534,10193,112
61796,78,877,302,768,14100,109
64799,21,150,221,129,2871,21
63247,80,759,266,603,11061,156
50282,147,1667,667,1329,24322,338
27964,1349,29271,1079,19495,219798,9776
53178,16,240,581,195,4671,45
61252,2575,31327,324,26098,100026,5229
19472,6,154,1243,119,21638,35
15618,276,5762,1310,4382,33436,1380
28719,19,593,1065,355,14864,238
61126,47,429,329,331,5989,98
23418,2020,32754,1177,22135,130594,10619
4755,189,11310,1425,5784,96366,5526
25438,142,5820,1135,3566,90664,2254
41594,49,433,809,353,7906,80
49153,0,206,698,163,8568,43
64342,129,2126,234,1567,11358,559
20179,10,430,1231,258,6697,172
56303,21,376,486,301,9944,75
17256,323,8974,1283,6046,62469,2928
27054,2215,52871,1099,32842,392093,20029
28595,73,1287,1068,793,15190,494
55620,7,297,505,215,7003,82
20090,24,949,1232,625,27129,324
49965,19,410,675,332,26279,78
4839,5,104,1424,70,3942,34
49714,66,421,682,358,15683,63
34671,175,3530,947,2780,29296,750
25968,1406,35558,1123,21817,204606,13741
18702,25,804,1257,580,14672,224
38445,10,184,858,117,5651,67
7820,44,1942,1386,1345,32828,597
19376,2,61,1245,38,3589,23
28524,15,404,1069,279,11949,125
36502,3,150,896,108,4659,42
51880,311,3740,624,3325,28590,415
32165,306,11570,1003,6883,50315,4687
44282,31,683,771,556,13516,127
32120,927,19158,1004,12838,110856,6320
48813,12,233,708,164,10023,69
21667,157,6823,1205,4167,71408,2656
28810,8,404,1064,224,4540,180
17413,78,2536,1281,1905,31110,631
60170,112,1608,363,1288,9874,320
27680,2247,99583,1085,59019,439642,40564
37631,153,3759,879,3150,49820,609
42917,88,1549,787,1353,33104,196
23303,27,595,1180,465,17951,130
51247,928,10713,642,8478,41203,2235
65094,9,323,211,235,4400,88
47777,169,2683,729,2018,31585,665
8960,63,2552,1380,1590,36142,962
66964,69,1418,158,1239,16421,179
49667,92,2069,683,1453,25135,616
31619,7,236,1011,171,12797,65
66665,11,73,169,50,10436,23
14219,828,28652,1329,18019,165974,10633
12050,244,8021,1358,5179,140323,2842
59002,40,405,405,300,8804,105
7754,163,8947,1387,5663,74487,3284
3244,9,349,1443,250,16348,99
23262,13,301,1180,264,18007,37
29693,748,14687,1047,12769,102526,1918
31071,8,148,1019,97,4853,51
63630,19,313,256,203,5074,110
52403,2049,37763,607,29115,117631,8648
35378,926,13944,937,10949,157719,2995
6799,17,555,1400,412,31768,143
11366,35,1770,1365,944,11411,826
52220,0,20,613,16,3297,4
35346,21,318,938,227,10353,91
17393,12,149,1281,110,8883,39
22969,14,530,1185,382,11671,148
37033,54,1101,896,750,11077,351
61100,2,37,330,27,2321,10
7650,57,1829,1389,1313,16825,516
24894,582,11594,1146,7736,88762,3858
5065,37,958,1421,666,31868,292
53461,186,1933,575,1519,20966,414
67484,6,61,142,44,2498,17
50281,1068,21076,667,16259,100089,4817
68431,7,92,112,71,2819,21
22248,10,267,1197,177,4103,90
32931,20,499,990,247,8448,252
1073,102,3443,1461,2320,46844,1123
46873,2740,75266,741,54174,220985,21092
2266,59,2931,1452,2094,34916,837
23531,26,1273,1176,1017,16784,256
26218,8,621,1118,317,6057,304
48583,61,1995,715,1616,9207,379
49719,48,667,682,547,12464,120
10472,13,1372,1372,759,12593,613
67067,8,150,156,100,4197,50
33717,104,2591,975,1804,24424,787
66938,22,542,160,482,7317,60
23082,5,235,1183,159,15788,76
20374,424,8675,1228,6347,71202,2328
28791,14,281,1064,172,7630,109
66715,75,1369,167,1012,29070,357
49811,21,402,679,299,7718,103
37301,12,149,887,120,5350,29
65503,4,22,202,15,1909,7
50155,17,243,670,183,8378,60
35365,52,1969,938,1583,25837,386
35121,58,1099,944,891,32041,208
52505,226,1873,603,1333,15039,540
36322,650,9720,913,6182,50050,3538
11991,4,261,1359,136,12355,125
64644,3,38,225,34,2409,4
35069,138,1731,945,1270,13970,461
11013,29,1121,1367,685,15343,436
9875,16,905,1375,591,10144,314
7353,72,1581,1393,1046,28469,535
2508,90,2050,1450,1335,22886,715
64944,4,68,216,65,8005,3
35562,28,1002,933,681,9389,321
34152,0,1847,967,1155,18923,692
5045,168,8395,1421,5121,54302,3274
24890,444,8700,1146,5941,50346,2759
29573,221,7324,1049,5138,102405,2186
8763,32,2358,1381,1426,19575,932
9642,305,12179,1377,7569,42554,4610
27278,46,799,1095,642,9435,157
18674,27,482,1258,341,9170,141
66417,645,7951,177,6474,54217,1477
5827,1429,36715,1412,21438,99073,15277
4548,458,7003,1428,3966,29553,3037
57410,8,153,456,117,6617,36
18570,14,245,1259,198,23929,47
2779,10,481,1448,333,21671,148
44846,27,731,765,522,13379,209
12004,6,445,1359,218,3878,227
43221,8873,513619,782,370398,608663,143221
15978,4,437,1304,263,8376,174
16648,210,3263,1294,2195,46563,1068
20211,1481,36552,1230,25813,209630,10739
26188,14,485,1119,318,13746,167
10812,42,1109,1369,547,42099,562
35080,334,2899,945,2172,27088,727
27775,227,4683,1084,3024,46550,1659
3519,137,2857,1440,1897,18631,960
10751,370,13410,1369,8379,102270,5031
18623,59,2473,1259,1541,27129,932
32675,25,620,995,368,6049,252
12669,316,10527,1351,6030,36499,4497
14720,43,1780,1322,1271,15982,509
61082,276,11193,331,8745,56907,2448
23998,62,1488,1167,1017,14567,471
30346,436,13067,1033,8822,106816,4245
12483,20,874,1353,457,11952,417
50700,21,224,657,195,13126,29
22599,72,1917,1192,1412,30740,505
3414,50,2424,1441,1716,58189,708
26169,3,120,1120,79,5674,41
13113,7,107,1345,73,4431,34
49459,217,2988,689,2526,30509,462
59366,105,1703,393,1324,12028,379
1823,47,889,1455,623,31061,266
22854,15,338,1187,202,7722,136
44962,10,133,763,111,6889,22
24387,57,1273,1158,848,10297,425
11306,70,2629,1365,1491,17805,1138
64085,0,19,242,15,966,4
5467,5,160,1416,100,26499,60
33300,100,1858,983,1351,9309,507
39986,38,456,835,343,12274,113
38165,24,638,865,432,22186,206
50725,4,137,657,96,9371,41
49151,75,1243,698,917,24704,326
53999,15,142,558,98,4031,44
4214,240,4406,1433,3191,33635,1215
23695,104,1851,1173,1539,43348,312
27237,5,443,1096,284,10377,159
54659,26,226,533,208,9898,18
55212,31,438,517,328,9056,110
55883,55,964,498,723,17954,241
15367,110,3596,1314,2482,43695,1114
7046,140,5947,1397,4171,49970,1776
54600,207,2373,536,1967,42577,406
64338,7,115,234,92,6153,23
8340,165,13471,1383,8420,37896,5051
41408,13,228,813,197,7513,31
15598,15,519,1310,380,10374,139
38180,82,957,865,696,7207,261
8769,88,3202,1381,2179,54751,1023
32880,90,1865,991,1288,14382,577
53047,2086,35431,585,26333,186898,9098
22379,88,2627,1195,1811,37713,816
55136,16,211,519,175,6191,36
4467,99,4020,1430,2207,27116,1813
8355,129,2592,1383,1712,21170,880
28239,40,1530,1074,935,28295,595
59884,8,77,375,64,4654,13
1596,61,2094,1457,1466,49495,628
42658,194,2710,791,2028,39602,682
54890,375,6106,525,5292,41532,814
52156,3275,55206,616,42138,217569,13068
5008,211,5619,1422,3600,90378,2019
41794,79,1631,806,1336,31818,295
63727,62,738,253,524,9312,214
46489,76,1023,746,797,32225,226
50474,823,32074,662,16834,95128,15240
3225,76,1891,1443,1249,13906,642
31883,43,1877,1007,1177,13395,700
9052,79,1702,1379,1049,15844,653
8491,52,1983,1382,1178,32876,805
1452,5,236,1458,170,9944,66
54656,100,1236,534,859,9788,377
57817,689,7227,444,5247,39080,1980
31162,35,1501,1018,906,24723,595
21018,95,1566,1216,1038,15857,528
20789,6,341,1221,216,7586,125
24882,22,734,1146,524,17049,210
34459,28,830,960,567,5558,263
7697,3,200,1388,126,16938,74
65157,32,90,210,74,6402,16
67535,6,103,140,77,4260,26
49056,708,7759,700,6058,34503,1701
29648,128,2655,1048,1791,18698,864
10329,258,7887,1372,4858,50219,3029
59771,9,158,379,133,4107,25
6084,13,940,1409,619,13672,321
27513,5,177,1089,119,3283,58
31165,20,358,1018,233,7921,125
42284,59,1436,799,1140,12328,296
32150,93,2869,1004,1971,15307,898
9410,23,1161,1378,814,14664,347
50237,68,1572,668,1208,27102,364
28686,494,7994,1066,5344,28418,2650
27435,24,943,1091,670,11523,273
17276,239,4507,1283,3368,45003,1139
3500,10,282,1441,199,19585,83
30104,3,193,1038,117,6747,76
35561,218,4084,933,3165,14757,919
17888,4,109,1271,79,4118,30
40188,33,287,831,238,6154,49
28982,59,1286,1060,799,16947,487
62347,96,2355,290,1686,23423,669
2654,30,1837,1449,1227,28138,610
2169,12,411,1453,283,15453,128
48685,490,10621,711,8728,55989,1893
61080,190,2578,331,2076,11166,502
58427,1137,13114,424,10271,44659,2843
50244,3543,38146,668,29761,598735,8385
49196,26,562,696,471,20504,91
46693,3486,43390,743,32874,152972,10516
55598,874,8104,506,7423,55004,681
14386,78,2976,1326,2015,46396,961
61429,327,5841,319,4820,64720,1021
33066,29,640,987,416,19354,224
38461,135,3172,857,2566,34928,606
38040,170,3838,868,2202,68066,1636
16593,105,1857,1295,1278,21055,579
64318,31,459,235,396,7132,63
57111,33,418,463,296,3990,122
15913,8,349,1305,193,8865,156
60658,35,515,347,394,8505,121
29859,30,1218,1043,726,32058,492
66172,30,269,183,210,3824,59
21522,88,1978,1207,1327,23236,651
11627,1,200,1362,123,6825,77
52832,0,17,592,15,2323,2
8374,106,4868,1382,3112,53188,1756
4102,389,12805,1434,8582,101929,4223
49575,806,16063,686,13086,164941,2977
1245,254,9360,1460,6428,90382,2932
811,12,473,1463,316,26463,157
60649,219,3796,347,3310,41560,486
66686,13,273,168,214,4059,59
2247,27,599,1452,441,13327,158
8070,713,23047,1384,14035,77016,9012
60836,758,12837,340,9996,63708,2841
36334,26474,620784,913,485010,1626378,135774
34828,20,297,951,246,12516,51
20936,23,499,1218,364,14306,135
3789,52,1116,1437,788,27269,328
32314,17,361,1001,231,6854,130
40482,27,584,827,526,11869,58
54484,100,1123,541,888,9856,235
22259,15,244,1197,214,8298,30
5186,3021,93220,1419,58281,301827,34939
7863,216,8378,1385,5386,105633,2992
16016,38,1533,1303,1062,19530,471
66244,6,86,181,67,4573,19
4038,40,492,1435,360,14422,132
20878,7,241,1219,175,7357,66
23968,22,587,1167,500,20999,87
68434,21,286,112,254,9610,32
39582,13,349,840,269,9359,80
49089,33,482,699,396,16114,86
389,2177,81962,1466,51209,356917,30753
66252,5,62,181,34,3470,28
45540,164,973,757,722,10561,251
27039,72,1264,1099,850,15014,414
6312,76,2820,1407,1970,23995,850
34453,11,155,960,115,6319,40
14768,41,869,1322,629,21650,240
16304,41,1729,1299,1241,79561,488
28588,27,586,1068,356,11808,230
53330,292,3013,578,2304,24895,709
32309,1365,29760,1001,22020,61071,7740
9625,352,10921,1377,6032,24674,4889
2761,359,7657,1448,5441,57252,2216
67873,118,1912,129,1679,13306,233
28079,122,4977,1077,3355,50518,1622
58251,14,109,430,99,10420,10
57127,101,1494,463,1021,18126,473
26221,23,453,1118,295,7528,158
65482,9,165,203,143,4964,22
28986,87,2123,1060,1277,16537,846
23070,11,483,1183,303,10653,180
17813,153,6167,1273,4177,34436,1990
1338,180,4231,1459,2716,19420,1515
36006,10716,247580,923,182770,1012577,64810
61247,72,1042,325,865,25030,177
47311,74,2300,735,2053,14239,247
36168,57,1391,790,1041,15597,350
40055,49,1040,834,790,7291,250
36865,555,13209,901,8328,101644,4881
56138,0,20,491,16,2906,4
49018,9,340,701,278,12242,62
26835,885,18214,1104,15472,171000,2742
61941,60,580,303,448,6583,132
18045,25819,555015,1268,326053,1447934,228962
28591,1320,27233,1068,16713,97414,10520
60155,712,17799,366,13303,82861,4496
41715,39,350,807,241,10620,109
438,189,7228,1466,5214,46979,2014
35429,97,1022,936,821,13504,201
26175,3,322,1119,193,11334,129
64473,207,3534,230,2659,25963,875
30253,158,3752,1035,2876,62941,876
7237,41,1674,1394,1130,27042,544
24698,188,5627,1150,3702,41889,1925
44995,4,83,761,65,7550,18
49272,51,510,694,387,20703,123
14013,344,7488,1332,4863,59343,2625
56561,53,912,478,647,19887,265
68063,4,31,123,25,2286,6
10201,184,5712,1373,3471,62133,2241
48798,42,440,708,360,10648,80
56305,92,2106,486,1711,14260,395
36101,191,5320,920,3868,28156,1452
42360,4545,85181,795,60217,321033,24964
60597,64,905,350,699,11931,206
47371,33,732,734,573,19025,159
28593,138,2504,1068,1670,27249,834
48366,1155,14049,722,10922,108810,3127
60382,157,1984,358,1689,36567,295
67038,2742,170026,150,92467,1471161,77559
61840,68,801,307,665,12496,136
3653,2,126,1439,84,15542,42
52964,171,2501,588,1864,18285,637
20190,65,5131,1231,3610,63879,1521
1098,263,10446,1461,5777,71123,4669
31423,149,3905,1014,2855,30526,1050
19644,529,11588,1241,7847,110017,3741
18185,6,367,1266,274,18794,93
26254,47,2451,1118,1541,26412,910
66989,32,362,157,254,15151,108
1327,2142,101522,1459,63053,374886,38469
36402,3,82,910,66,7792,16
5647,24,1143,1414,629,8416,514
34155,42653,2061335,966,1236817,4792351,824518
20824,5,159,1220,125,5643,34
26826,1922,52521,1104,31029,294824,21492
34239,168,3318,964,2439,27146,879
6061,40,2443,1409,1579,55169,864
22330,6946,201814,1196,125605,894249,76209
471,228,2939,1466,1857,18198,1082
55757,18,138,502,109,6190,29
61436,216,1714,320,1444,44850,270
48635,162,3174,714,2603,33842,571
10626,1021,78434,1370,47827,343482,30607
34993,177,6146,947,4359,76606,1787
3247,439,18349,1443,12294,99872,6055
1181,63,1066,1460,821,18117,245
22541,21,627,1193,448,7621,179
31399,78,1019,1015,677,11417,342
50589,738,8802,659,6927,77630,1875
63298,165,2150,265,1737,19512,413
24630,1025,50682,1152,35063,189294,15619
1425,32,1593,1458,1100,20959,493
12595,1585,68307,1352,39214,394499,29093
14613,18,491,1324,346,18294,145
68672,138,2137,102,1858,18357,279
50128,117,1490,671,1250,10053,240
40109,26,406,833,316,5568,90
11275,8,686,1365,406,25949,280
58749,5,137,413,84,4202,53
67361,3,52,146,49,1721,3
30923,54,1333,1013,905,12485,428
51591,19,232,632,195,3567,37
37677,938,17733,878,14128,147041,3605
2249,61,4081,1452,2724,41611,1357
4819,465,12451,1424,8198,204971,4253
14774,6,246,1322,186,29869,60
67852,134,3928,130,2951,27677,977
58432,19,149,424,123,7077,26
45641,2020,58778,756,44113,170439,14665
15703,20232,982923,1309,688240,2379672,294683
24828,5718,234758,1148,178793,1092678,55965
29892,37,878,1043,510,8483,368
7178,9213,253207,1394,143215,588098,109992
55908,198,3681,498,2726,29606,955
34037,98,2768,969,1859,14324,909
34144,16,383,967,248,9039,135
8339,361,10735,1383,7076,31721,3659
7092,45,1273,1396,863,16923,410
10262,125,3206,1373,1927,42391,1279
28788,2339,70941,1064,45423,434789,25518
42608,17,349,793,189,5628,160
68578,6,109,106,84,2308,25
29918,7,245,1042,181,10399,64
20481,24,550,1226,415,7575,135
38023,30,614,868,498,12793,116
2929,1051,25433,1446,16088,159578,9345
37580,3,32,880,26,2018,6
5945,69,4191,1411,2797,67562,1394
24377,244,7971,1158,5443,104924,2528
24351,2051,47909,1159,32367,217098,15542
12397,36,1203,1354,693,9526,510
60504,16,276,353,216,7633,60
57186,115,1304,461,997,19080,307
15525,79,1958,1311,1421,17848,537
58486,75,874,421,709,10346,165
30482,22,299,1030,193,9273,106
19159,1079,17587,1249,11462,125958,6125
67413,8,91,144,70,2679,21
10255,510,11730,1373,6569,67155,5161
24411,35,868,1157,533,7564,335
30638,4576,128129,1028,89643,529502,38486
29863,4,159,1043,92,4798,67
19814,139,8526,1237,5563,69767,2963
31812,3,78,1008,55,6199,23
49833,38,663,679,528,13028,135
30772,7,244,1025,170,3465,74
33529,7,129,979,110,10943,19
64015,25,378,244,316,4987,62
54896,33,194,525,168,5631,26
21735,75,1991,1204,1349,27408,642
20659,10,347,1223,246,11163,101
50431,153,2221,663,1536,9157,685
31794,18,324,1008,211,7868,113
26291,23,867,1117,526,10141,341
5556,59,3550,1415,2330,25467,1220
32125,49,627,1004,428,14846,199
13476,31,1721,1340,901,14315,820
5589,2961,118827,1415,71125,484849,47702
20035,18,197,1233,166,8290,31
60829,92,2359,340,1656,41888,703
59721,1795,45473,381,36193,264589,9280
69011,17,448,91,383,2852,65
33414,19,490,981,323,9768,167
28548,8,282,1069,162,7918,120
28883,5,131,1062,63,15436,68
63051,166,5403,271,3894,33963,1509
38277,270,3999,862,3120,64229,879
23022,4,105,1184,73,4424,32
14632,68,1650,1323,1431,24370,219
23066,3,202,1183,157,13680,45
67332,10,79,147,66,5402,13
397,232,14853,1466,10188,190830,4665
28466,50,812,1070,488,9147,324
1254,3,223,1460,144,33412,79
27614,1300,43391,1086,30090,185454,13301
12124,124,2609,1358,1631,8976,978
33653,64,1497,976,1137,16713,360
52736,23,211,595,188,7550,23
40994,35,798,818,633,10350,165
60349,153,2769,359,2248,12627,521
54028,144,2137,557,1795,42975,342
62986,42,343,273,255,6004,88
63723,10,269,253,196,9270,73
68095,19,320,122,277,5042,43
16852,170,6003,1290,3859,29425,2144
20787,15413,446788,1221,266292,1686019,180496
51686,5,120,630,97,7323,23
8160,263,5572,1383,3586,30805,1986
24333,60,830,1159,497,7511,333
1622,3313,94697,1457,59447,296350,35250
9677,15,540,1377,331,33034,209
65455,17,314,203,228,8867,86
29303,66,1725,1054,1162,9414,563
5151,159,4629,1420,3210,39080,1419
19276,43,1384,1247,890,8321,494
3724,35,808,1438,578,40975,230
68625,11,147,104,101,4071,46
3263,23,617,1443,447,18239,170
23797,11,351,1171,245,10360,106
3827,9,165,1437,115,5706,50
31122,18,522,1019,412,11460,110
61168,316,8503,328,6932,62486,1571
37342,0,0,870,0,5396,0
60992,89,788,334,619,9768,169
58990,397,6933,405,5090,37916,1843
21239,0,0,1212,0,14299,0
41727,2,56,807,35,8307,21
9977,94,1530,1375,1029,12925,501
55373,224,1781,512,1357,17809,424
68605,395,5268,105,4293,51409,975
23959,319,11578,1168,7546,39581,4032
59590,9,65,386,54,3974,11
4616,26,641,1427,451,7927,190
37029,1,12,896,6,3810,6
22762,4,495,1189,353,8935,142
63423,375,17828,262,14445,54820,3383
25932,10,755,1124,436,30785,319
5006,39,1729,1422,1137,24031,592
37363,3,108,886,80,4729,28
4344,65,2450,1431,1858,42409,592
52089,15,244,618,165,13212,79
51539,97,1139,632,992,21892,147
11548,1889,73383,1363,41085,571000,32298
11,12432,492622,1472,325781,4399130,166841
19342,52,2605,1246,1408,12908,1197
65534,48,765,201,532,8226,233
5280,79,2449,1418,1683,53357,766
7689,75,5208,1388,3095,24773,2113
62918,191,1632,274,1273,13068,359
13400,25,917,1341,519,7632,398
25823,521,10345,1127,6043,98157,4302
54256,19,195,549,141,3877,54
62478,11,115,286,97,2601,18
36446,25,871,910,659,11476,212
49911,6,57,677,45,2199,12
11695,11,478,1362,175,10508,303
19267,123,6307,1247,4384,60318,1923
131,12925,845158,1470,473894,3588066,371264
32628,200,7229,996,4732,47927,2497
23469,52,1303,1177,886,26254,417
60176,76,1068,365,645,9099,423
3983,322,13306,1435,9001,143501,4305
45082,2,33,761,29,2128,4
62673,49,628,280,507,11716,121
38779,98,2755,849,2234,20862,521
56320,35,472,485,390,6505,82
33809,34,868,974,654,16890,214
17489,76,1549,1279,1256,19031,293
68712,414,9033,101,7687,49079,1346
24097,138,5707,1164,3724,38969,1983
65257,51,533,208,425,6984,108
12148,6,867,1357,511,17694,356
62635,45,593,281,451,10834,142
66994,18,247,157,182,4546,65
31007,21,801,1021,512,8034,289
40999,45,932,818,785,13119,147
2223,318,11260,1452,7487,98527,3773
30954,310,5880,1022,3929,36880,1951
38140,29,551,866,415,5791,136
54287,1522,24245,548,19888,127953,4357
22512,19,1050,1193,787,20037,263
7158,3,161,1395,100,8522,61
7775,5,163,1387,118,20369,45
27298,43,1536,1094,918,31304,618
63643,4,39,256,30,3201,9
55409,12,166,511,125,10637,41
42376,884,13223,797,10390,106093,2833
21665,19,424,1205,294,11808,130
59920,97,2085,374,1392,21597,693
1055,29,693,1461,525,17809,168
9380,1586,90614,1378,60584,397366,30030
22025,49,833,1200,562,16855,271
51440,1,69,637,41,2072,28
34703,56,568,954,394,5941,174
52959,95,749,588,625,11668,124
15136,22,379,1317,250,11250,129
26909,899,29970,1102,20844,175844,9126
60218,68,789,363,690,22478,99
37062,366,7318,895,4870,51492,2448
14203,7,225,1329,160,6347,65
51369,141,1315,639,1053,19948,262
58734,20,384,413,317,9645,67
43946,22,347,775,294,11655,53
14079,76,4078,1331,2529,29188,1549
6650,53,2027,1402,1260,42942,767
37399,4,125,885,93,6123,32
51292,5,130,641,84,7675,46
58014,16,157,438,126,6887,31
27230,0,0,1096,0,3014,0
807,23,613,1463,487,31791,126
23464,1083,37092,1177,25439,220296,11653
20148,1,135,1231,97,3479,38
50209,30,627,669,452,14382,175
32186,120,3963,996,2486,43898,1477
21081,1202,29234,1215,18400,165536,10834
5031,22,760,1421,510,25315,250
7325,8,270,1393,170,22582,100
1510,17,286,1458,193,14560,93
49887,55,599,677,489,24246,110
29453,324,12806,1051,8965,125783,3841
61871,114,1123,305,953,11626,170
17262,801,20970,1283,13893,61250,7077
56308,11,166,486,125,5015,41
64628,1364,23956,225,20434,176096,3522
37645,4912,78637,879,62970,382617,15667
24892,2,51,1146,47,7413,4
17336,185,6857,1282,4487,36466,2370
66988,77,946,156,696,15582,250
58767,66,1925,413,1407,17936,518
27887,106,1632,1081,980,8670,652
29106,72,1418,1058,915,34253,503
5194,35,1310,1419,795,18741,515
17545,1113,39918,1278,27237,254962,12681
11620,24,591,1362,333,5953,258
2043,949,23923,1454,16563,82303,7360
68275,37,572,117,476,9208,96
20329,23,967,1228,626,24419,341
34222,752,12900,965,8946,87221,3954
25558,97,2181,1133,1501,16580,680
29431,250,10095,1052,5671,45510,4424
46033,29,646,752,537,8817,109
40445,8,208,827,148,7525,60
43701,6564,80667,777,66076,293120,14591
21514,5,136,1207,93,17474,43
34210,13,529,965,383,17684,146
22412,32,702,1195,518,8659,184
7544,48,801,1390,516,10672,285
36775,14,849,903,727,14579,122
38778,496,4538,850,3686,45785,852
51710,31,291,629,256,12288,35
57073,11,165,464,114,3386,51
26448,8,146,1113,113,8385,33
64668,11,215,224,149,6654,66
33974,201,3180,971,2105,26028,1075
15478,57,1497,1312,1068,17066,429
56953,31,415,467,334,6607,81
33288,13,199,983,165,5903,34
24771,13,867,1149,598,8379,269
56477,7,86,481,80,22487,6
56770,37,288,472,204,4794,84
43813,6,58,777,49,6459,9
30467,7,314,1031,208,4169,106
15295,27,955,1315,686,29958,269
55418,13,192,511,146,4460,46
3578,21,578,1440,377,30513,201
26099,51,2027,1120,1195,19823,832
60618,11,75,349,60,1940,15
49630,9,126,684,98,3929,28
35016,13,528,946,312,9037,216
10428,314,5894,1372,4059,35223,1835
68075,59,643,123,504,15257,139
23614,738,21079,1174,15098,82309,5981
1317,42,2169,1459,1540,14286,629
6348,8105,468089,1406,287717,1226222,180372
67877,6,109,129,74,2413,35
6441,3,115,1405,81,15346,34
42362,258,1757,765,1341,19794,416
20474,40,673,1226,473,15919,200
9276,48,1405,1379,902,18066,503
43093,4260,102195,785,79894,491886,22301
67237,1,36,150,22,2731,14
12655,65,2515,1351,1529,43836,986
53151,20,356,582,259,7608,97
31506,189,2673,1013,1631,12741,1042
34736,384,7676,950,5434,81665,2242
15314,4,260,1315,192,8625,68
50528,17722,346555,660,258705,1019471,87850
53153,179,2034,582,1663,22786,371
30360,24,851,1033,537,10538,314
54884,6,53,526,39,9748,14
39046,170,2284,847,1658,28369,626
9840,1472,35323,1376,22792,212614,12531
29501,5,474,1051,297,6716,177
65814,461,7448,194,6150,43104,1298
22150,57,2311,1199,1569,15802,742
48877,38,411,706,321,19369,90
68660,377,5072,103,3924,32718,1148
29070,48,1204,1058,745,12031,459
56571,20,306,478,246,6479,60
33855,21,152,973,100,2722,52
17332,104,987,1282,744,17052,243
34333,100,2258,963,1381,18518,877
38544,3,176,855,111,6663,65
36131,9,250,919,166,8848,84
58795,35,381,412,304,3974,77
10765,35,3663,1369,2132,16942,1531
54097,137,1529,552,1249,23345,280
63538,148,2468,259,2117,18361,351
60,139176,5660747,1471,3705395,9111182,1955352
9718,259,13689,1376,6713,122912,6976
51767,12,145,628,121,8753,24
25789,11,578,1128,385,23033,193
23128,37,795,1182,555,11012,240
18644,7,198,1258,160,8272,38
66028,34,523,188,417,10583,106
3165,578,13625,1444,9348,86612,4277
58913,23,265,408,218,19155,47
6134,23,885,1408,589,28683,296
42626,135,1325,792,966,17076,359
59109,9,65,402,49,3287,16
19101,62,1179,1250,805,19079,374
22954,2,96,1185,77,11281,19
27146,381,7350,1097,5200,63086,2150
33517,2,122,979,70,7249,52
59417,788,13656,391,11348,81804,2308
64397,15,296,232,209,4746,87
51333,39,565,640,473,10060,92
34654,25,1160,955,751,17409,409
46939,2,111,740,87,5334,24
67334,6,192,146,144,6115,48
57914,11,183,441,155,7674,28
33765,26,729,974,479,11749,250
28084,5,145,1077,68,6574,77
22662,3,259,1190,162,5161,97
27683,6,273,1085,165,6681,108
12604,108,1822,1352,1210,17914,612
25220,110,2027,1140,1355,23850,672
2016,45,1635,1454,1239,21364,396
42925,0,430,787,341,21126,89
46257,60,1265,749,940,11206,325
33050,74,2708,988,2039,34167,669
62034,51,462,256,349,8539,113
41316,32,434,814,334,8295,100
42646,56,758,792,617,22927,141
528,385,15277,1465,10445,117887,4832
6036,110,4005,1409,2271,57321,1734
5571,31,1417,1415,963,66436,454
25064,37,1372,1142,910,32088,462
62577,25,239,283,149,6543,90
59539,548,6135,387,4934,34653,1201
45780,154,2205,755,1699,21699,506
28450,503,15030,1070,9750,43858,5280
56532,221,1721,479,1547,29433,174
9183,55,2287,1379,1465,22256,822
6319,205,5729,1406,3941,33393,1788
65406,32,548,204,462,11300,86
18096,1162,22829,1268,15465,78957,7364
68785,75,840,99,771,13695,69
27429,98,3214,1091,2108,58999,1106
33733,17,485,975,313,8147,172
11980,3,319,1359,166,12468,153
57335,5035,57561,458,46369,173786,11192
17853,58,2099,1272,1681,61514,418
35980,143,4585,924,3771,55640,814
25279,170,1603,1138,1206,27715,397
20969,59,3259,1217,2162,58004,1097
35126,424,12529,944,9613,70209,2916
27135,36,870,1098,728,18997,142
9282,532,9166,1379,5811,57433,3355
18749,8,581,1256,385,18183,196
55012,9,61,522,43,5551,18
68893,3,53,95,40,1681,13
48391,12,66,721,53,3038,13
65114,13,265,211,150,4784,115
51775,33,505,560,383,11465,122
16861,8,230,1290,162,22216,68
31411,4,105,1013,72,2674,33
30059,139,2652,1039,1903,48877,749
65988,10,178,190,107,4380,71
34179,13,483,966,306,5997,177
33386,41,829,981,572,15084,257
15958,378,3920,1304,2884,30392,1036
61969,48,926,302,786,30222,140
17447,22,308,1280,242,17769,66
14248,96,3485,1328,2418,37894,1067
55277,30,332,515,250,6759,82
6517,55,3538,1403,2461,53660,1077
53403,54,1118,576,774,18228,344
11587,161,7601,1363,4804,161902,2797
30278,88,2673,1035,1897,43623,776
52834,259,2406,592,1943,17652,463
13396,175,3906,1341,2300,27033,1606
58874,27,296,409,216,3171,80
62699,93,1574,280,1413,20948,161
18589,2,76,1259,61,24440,15
2785,179,5099,1448,3016,33609,2083
5189,189,9950,1419,6225,101008,3725
34569,98,2237,958,1648,25974,589
10862,140,3852,1369,2528,24308,1324
43261,133,1892,782,1597,29995,295
35327,14349,397893,938,218151,810543,179742
48667,18,185,712,154,8616,31
47343,15,213,735,161,6531,52
28753,2,86,1065,75,6533,11
49656,20,296,683,232,12413,64
31754,21,527,1009,349,12954,178
11862,745,14237,1360,9290,48031,4947
8729,870,41453,1381,23352,165251,18101
48674,14,340,712,218,9571,122
35350,0,45,938,35,6895,10
17311,19,626,1282,495,13900,131
2079,26,544,1453,374,18741,170
63052,31,244,271,207,9477,37
50402,167,1648,664,1237,13922,411
53618,15,202,570,150,14981,52
66875,6,90,162,68,2992,22
47919,8,218,728,175,2881,43
39764,135,2015,838,1622,20168,393
22549,5,130,1193,96,6922,34
61847,15,183,307,140,6006,43
40246,27,444,831,356,32203,88
63919,32,541,247,403,3528,138
60429,6,105,356,72,4728,33
28800,82,4876,1064,3006,29027,1870
60523,206,2437,352,2122,45408,315
33771,13,225,974,168,7373,57
9762,699,20979,1376,14719,82344,6260
18474,3041,88525,1261,50724,336166,37801
7180,5,233,1394,154,34987,79
25390,115,5804,1136,3678,29143,2126
58559,120,728,419,597,11280,131
62434,126,2372,287,1950,14859,422
68482,541,13230,109,11121,80938,2109
10559,351,17529,1371,9539,55103,7990
28483,3,71,1070,47,5293,24
2125,9,500,1453,309,31883,191
22964,65,1185,1185,837,12231,348
24656,47,857,1151,640,13624,217
60612,82,1051,349,867,13151,184
66618,48,821,170,667,12525,154
2260,3228,126550,1452,79151,525177,47399
57254,285,4842,460,3685,12068,1157
31820,602,6061,1008,4205,30774,1856
30585,47,2215,1029,1409,17235,806
29481,27,386,1051,318,7967,68
68772,0,9,99,7,738,2
26224,69,759,1118,521,7772,238
26578,40,1275,1110,823,14776,452
1877,31,1460,1455,1072,36545,388
15646,164,4178,1310,2840,30995,1338
57227,17,304,460,244,7451,60
66136,7,86,185,71,1699,15
62960,299,5275,274,4107,68256,1168
6779,16,672,1400,415,13464,257
49271,173,2923,693,2369,35761,554
51605,42,728,632,669,16188,59
11314,211,5784,1365,3570,56615,2214
17684,0,0,1275,0,19169,0
34856,30,976,950,572,14112,404
34788,18,330,952,239,28859,91
68102,10,68,122,55,2385,13
57174,11,232,462,154,2463,78
7327,1464,71572,1393,47608,637176,23964
68576,19,396,106,337,6699,59
7577,137,4152,1390,2725,121223,1427
9538,161,4243,1377,2839,23320,1404
30953,345,13930,1021,9329,59455,4601
12620,348,7417,1352,4692,36156,2725
15030,151,4548,1319,2640,23059,1908
50105,95,1346,671,1081,10226,265
32947,22,1077,990,615,9874,462
52360,86,1818,609,1420,22417,398
37065,20,374,895,289,7343,85
31845,36,635,1008,388,11759,247
21567,28,678,1206,498,32982,180
4882,65,1421,1424,1102,32705,319
23429,2,32,1177,22,2319,10
28208,9,200,1075,160,10700,40
34541,16,723,959,412,7677,311
63675,18,336,255,250,6256,86
52614,220,2315,599,1668,30537,647
67127,389,10484,153,8436,73086,2048
54277,162,3352,548,2736,42709,616
47047,17,228,739,179,9717,49
26490,544,12785,1113,8660,68191,4125
35049,250,5937,946,4306,59185,1631
51643,47,761,631,613,19666,148
5735,46,1236,1413,807,41092,429
41877,86,1907,804,1172,20658,735
7431,84,2492,1392,1843,26305,649
6124,15,589,1408,411,17665,178
14953,18,819,1320,535,15447,284
54841,939,10271,527,8300,90802,1971
668,9,380,1464,266,14069,114
10781,134,4084,1369,2761,59404,1323
33229,148,2603,984,1924,19184,679
25060,0,0,1142,0,12794,0
37838,2,88,874,50,9518,38
46937,967,14315,740,11255,104732,3060
57713,127,950,448,766,12341,184
22235,62,2359,1197,1564,40097,795
41138,25,500,816,398,7019,102
60972,56,494,335,404,11101,90
50620,15,143,659,130,7184,13
11642,134,3530,1362,2533,18772,997
35086,4,212,945,181,12749,31
6341,34,837,1406,578,20158,259
50564,117,1800,660,1519,17465,281
16010,76,2935,1303,2117,49426,818
14781,14,442,1322,320,10492,122
2438,18,908,1450,664,16341,244
2682,342,9955,1448,6764,57845,3191
34559,1,33,958,32,2808,1
52400,208,2365,607,1837,10959,528
23800,29,447,1170,320,11519,127
47632,0,69,732,63,10571,6
30984,127,3389,1021,2078,19235,1311
10060,171,4817,1374,3321,24441,1496
2302,35,3039,1451,2083,33171,956
376,37,1465,1467,1062,54583,403
23007,29,435,1184,290,7454,145
63993,30,575,245,481,10974,94
64487,2,37,230,33,2707,4
33949,75,2049,971,1347,22872,702
1712,55,1989,1456,1439,41091,550
66472,567,8534,175,6815,71415,1719
30520,164,8521,1029,6079,36883,2442
64341,2,19,234,15,1280,4
29966,16,515,1041,362,11624,153
4331,179,8117,1431,5932,70427,2185
24402,2953,83893,1158,58023,243286,25870
5442,143,5038,1416,3077,50850,1961
22107,32,815,1199,660,21535,155
61143,3,72,329,55,2434,17
68258,64,821,117,631,7941,190
9344,94,4061,1378,2250,20409,1811
61412,2,47,320,32,4507,15
66365,12,227,179,154,9502,73
15110,17,407,1317,290,6432,117
49302,27,396,693,330,8782,66
19788,379,9952,1238,7075,114502,2877
58369,160,3855,426,2865,25186,990
50409,14,271,664,202,2339,69
11337,61,1732,1365,1100,32913,632
61902,110,1826,304,1484,28956,342
46813,121,2424,742,1886,17966,538
31061,891,22261,1019,14947,109339,7314
36063,4,131,918,119,9284,12
66891,5,77,161,71,6996,6
52688,91,819,596,673,10355,146
62937,14,206,274,153,3943,53
60778,26,233,342,201,5310,32
62675,24,345,280,263,6187,82
16378,622,10410,1298,7601,62405,2809
58354,52,750,426,566,41360,184
3189,5,368,1443,235,9756,133
28136,13,239,1076,161,4887,78
11049,733,46645,1367,26519,167451,20126
12420,64,2211,1354,1128,16750,1083
34684,26,660,954,430,34411,230
46364,128,1408,748,1038,17064,370
11813,255,12542,1361,6692,57175,5850
9262,751,20464,1379,13015,143027,7449
62521,30,492,285,393,5684,99
14030,870,35895,1332,23842,192932,12053
8887,13,873,1380,547,31320,326
67694,0,0,135,0,1314,0
15678,271,7972,1309,5237,100057,2735
13917,303,9868,1334,7241,74611,2627
27107,74,2557,1098,1545,32627,1012
68221,721,10103,118,7761,62551,2342
58658,25,392,416,303,5797,89
38476,26,808,857,586,14006,222
12473,107,3310,1353,1851,35430,1459
56984,65,1272,466,984,46172,288
48398,28,460,721,316,5260,144
4426,195,6821,1430,4890,33544,1931
26262,39,1240,1117,764,10747,476
55223,20,272,516,208,7848,64
1141,1,253,1460,180,18907,73
67905,29,270,129,198,3858,72
5939,18,908,1411,563,8638,345
43881,6,168,776,108,3329,60
6717,31,605,1401,395,13222,210
16312,2,148,1299,99,8167,49
10723,223,10501,1370,7156,49792,3345
23230,209,2574,1181,1755,70587,819
14286,48,1320,1328,966,29943,354
26442,1031,34521,1113,21470,89238,13051
7521,0,0,1390,0,37436,0
36529,263,3812,907,3062,37356,750
22339,67,1714,1196,1060,31325,654
51313,48,711,640,550,12607,161
24596,331,13234,1153,8029,77222,5205
35466,27,504,935,351,12395,153
6566,294,6324,1403,4759,48473,1565
64543,3,69,228,58,4388,11
49208,37,336,695,254,7909,82
60595,9,96,350,80,2454,16
2368,397,12565,1451,9598,84540,2967
52513,415,3774,603,3236,37746,538
38123,62,1948,866,1178,36836,770
5934,39,1171,1411,875,17588,296
55306,193,1781,514,1346,13904,435
3338,69,4176,1442,2857,56290,1319
29735,1758,44436,1046,27262,98591,17174
2554,328,24314,1449,17028,160627,7286
52058,7,78,619,61,5171,17
36473,24,659,909,578,25032,81
18574,11,571,1259,448,12949,123
10339,149,4495,1372,2730,32995,1765
10126,336,10957,1374,7014,56221,3943
12490,0,0,1353,0,6968,0
19098,79,1223,1250,864,14305,359
49036,25942,567693,701,437664,2155180,130029
23771,12617,328600,1171,207675,816853,120925
54459,18,170,539,129,7690,41
66362,125,1263,179,1065,14006,198
42183,514,6549,800,5686,45233,863
64191,53,839,239,640,12495,199
66610,3,116,170,87,5763,29
24030,35,986,1166,678,32450,308
36379,6,209,912,150,5594,59
35890,137,3025,926,2366,72535,659
5833,216,3608,1412,2666,21685,942
19043,8,350,1251,203,6974,147
38163,0,30,865,28,2915,2
17851,131,2255,1272,1574,16787,681
59276,33,427,396,345,9244,82
1731,1999,47189,1456,30196,117342,16993
24306,1,84,1160,65,5856,19
4751,16,386,1425,270,12029,116
68900,109,1455,95,1333,20191,122
58247,202,3627,430,2825,18520,802
9749,114,2782,1376,1653,29261,1129
58124,2,13,434,6,4996,7
35318,2448,48081,939,36150,201962,11931
6143,44,1257,1408,839,29621,418
2874,76,3071,1446,2050,54775,1021
64587,4,50,227,27,1198,23
49749,69,699,681,587,14241,112
34473,194,3627,960,2508,28838,1119
49828,316,5003,679,4164,115939,839
21314,216,7411,1211,5177,73490,2234
48152,23,322,725,232,8897,90
64113,12,225,241,142,2909,83
56,91,4212,1471,2496,23828,1716
50439,188,3064,663,2533,28375,531
25510,69,1912,1134,1217,12639,695
21800,15,521,1203,275,18031,246
61185,337,5983,327,4726,32544,1257
29600,1190,27934,1049,18930,163143,9004
61431,481,4375,320,3432,25045,943
10537,347,9764,1371,7073,59323,2691
23361,10,319,1179,219,7600,100
23210,17,446,1181,394,19850,52
56334,5,60,485,42,2503,18
52743,59,1020,595,725,17135,295
59769,268,2832,379,2334,19791,498
1844,180,6010,1455,4071,74429,1939
9812,2,67,1376,51,5179,16
55767,672,8929,501,7474,56172,1455
6588,175,5316,1402,3533,40779,1783
4515,28,1390,1429,1037,22303,353
1465,16,890,1458,632,21821,258
16719,10,351,1292,228,14859,123
22725,45,1164,1189,780,15178,384
4512,32,738,1429,551,18193,187
1985,26,844,1454,643,33986,201
25074,23,697,1142,507,12161,190
19859,63,1006,1236,659,16311,347
8630,8,775,1381,526,16887,249
63344,5,128,264,88,4668,40
11828,94,2824,1361,1632,32415,1192
62885,10,265,275,232,6165,33
22646,251,5778,1191,3720,137626,2058
8725,497,10704,1381,6550,32958,4154
65975,333,4007,190,3187,16039,820
27555,77,2494,1088,1622,24588,872
29162,10,312,1056,198,20482,114
16430,117,1410,1297,1111,20212,299
30099,147,2452,1038,1730,29473,722
50121,4767,64329,671,48172,355844,16157
14393,136,4305,1326,2856,24097,1449
13860,1885,51083,1334,29728,177853,21355
53576,25,342,572,288,4561,54
66822,50,1110,163,924,15563,186
34280,28,573,963,445,4098,128
40934,82,878,819,676,18807,202
52931,21,283,589,224,10344,59
68000,6060,150536,115,122220,572790,28316
31221,2452,53466,1017,37594,172567,15872
67767,4,80,133,64,3316,16
19160,3,185,1249,139,9268,46
49608,344,5395,685,4242,60468,1153
29413,31,1236,1052,791,29426,445
67165,45,480,152,373,5244,107
57898,82,810,440,598,9893,212
67865,13,132,129,113,1910,19
58170,114,2625,432,2085,17103,540
35860,5,116,927,82,2223,34
54108,64,546,554,447,12056,99
58052,34,248,437,214,9223,34
21304,37,1258,1211,970,15512,288
56912,60,1121,468,930,14704,191
20282,5,197,1229,132,6140,65
15233,3,198,1316,139,15294,59
17633,21,962,1276,695,20490,267
59883,22,363,375,267,5104,96
53450,38,352,575,280,5961,72
18695,44,1064,1257,769,18340,295
25729,2,99,1129,65,8055,34
32791,134,2622,993,1703,35642,919
17805,3414,74428,1273,44860,239592,29568
16122,774,17173,1302,11778,81045,5395
26286,328,9329,1117,6547,97741,2782
66537,8,76,173,74,2354,2
62851,50,567,276,471,6904,96
35505,18,622,935,416,6187,206
54014,157,1545,557,1301,24897,244
45342,84,601,759,480,16600,121
16494,118,2548,1296,1959,43320,589
30570,59,874,1029,562,8278,312
53412,421,5077,575,4023,39269,1054
38712,5031,174152,851,126048,592350,48104
27999,87,2675,1078,1786,20081,889
24089,8,247,1164,169,12032,78
45515,16,866,757,663,20143,203
30750,13,806,1025,443,13797,363
6508,805,17907,1403,11733,117483,6174
27277,882,12669,1095,8781,42345,3888
20011,46,2231,1234,1715,32471,516
68097,5,105,122,84,2613,21
36953,552,14344,898,11808,111570,2536
52228,1610,35131,613,25917,197923,9214
4866,1735,35124,1424,20945,188973,14179
24489,83,3021,1156,1858,19827,1163
68245,4,60,118,34,3586,26
68632,8,105,104,84,3106,21
52594,13,191,600,143,7422,48
35733,259,4089,930,3099,39754,990
5029,5,411,1421,339,36239,72
7517,138,3963,1390,2650,85900,1313
3127,43,1274,1444,1002,12071,272
53849,11,106,563,80,7093,26
61652,136,1615,313,1385,17928,230
10351,43,2109,1372,1349,59465,760
59747,9,156,380,129,9406,27
23971,1040,13602,1167,9282,69711,4320
68264,9,255,117,183,5966,72
9807,219,3735,1376,2075,41453,1660
35894,7,409,926,276,9231,133
56094,116,973,492,776,7565,197
879,14,886,1462,622,32574,264
22860,1,45,1187,35,2282,10
11670,16,503,1362,288,20261,215
32671,11,572,995,382,10880,190
25147,12,620,1141,372,11186,248
20830,39,976,1220,726,13628,250
11046,193,13695,1367,8577,85398,5118
54722,6,63,532,54,3847,9
38844,5,164,849,127,7147,37
22130,377,7658,1199,5369,62462,2289
9305,11,368,1379,246,10748,122
59757,166,8756,380,6488,49338,2268
6259,19,656,1407,475,32298,181
5851,43,978,1412,635,10394,343
68037,75,886,124,643,15536,243
19870,39,1218,1236,856,20836,362
32045,316,5869,1005,4019,54076,1850
61368,5,50,321,37,3794,13
55725,383,8276,503,6731,44838,1545
34550,295,4867,958,3435,28840,1432
57682,28,289,449,204,3246,85
856,8,683,1462,466,17348,217
4480,143,5548,1429,3694,53523,1854
6362,590,16361,1406,9628,119883,6733
5520,92,4435,1415,2844,20950,1591
8472,95,2977,1382,2213,23726,764
584,109,2801,1465,2086,32358,715
24003,72,3393,1167,2153,51628,1240
62585,48,820,283,726,16395,94
15222,24,767,1316,518,18492,249
2403,39,1242,1451,819,14305,423
24035,11,532,1166,384,9247,148
63071,14,193,271,150,2758,43
8181,21,653,1383,425,7346,228
68376,17,253,114,199,7656,54
16761,156,3843,1292,2489,30376,1354
50857,347,3224,653,2460,28260,764
39355,1519,22433,842,17219,148047,5214
29331,34,872,1053,597,12378,275
39881,28,935,836,686,11235,249
33533,41,956,979,782,26503,174
56824,98,1843,471,1378,9023,465
1150,25,413,1460,330,16518,83
7270,1509,73546,1393,42180,374075,31366
33591,112,3758,978,2343,23651,1415
15664,2244,99145,1309,63520,225325,35625
14550,93,2310,1324,1691,36119,619
54681,148,1058,533,854,12012,204
37000,1444,29337,897,23406,256715,5931
8097,48,1123,1383,767,13630,356
59203,95,963,399,758,6623,205
65521,35,980,202,614,9676,366
42254,266,3260,798,2636,31497,624
7871,681,18842,1385,13186,120345,5656
53512,12,133,574,111,6901,22
34051,1901,41883,968,29344,278197,12539
49617,909,12528,685,10115,59880,2413
14702,9,280,1323,190,13989,90
738,143,6513,1463,4484,31844,2029
62504,16,239,285,172,4966,67
40710,46,515,824,408,4760,107
46474,35,492,747,405,6864,87
6401,19,523,1405,375,11107,148
66093,12,96,186,79,4204,17
7728,113,1803,1387,1047,13625,756
35979,99,1184,923,894,25924,290
29335,561,20118,1053,13493,86127,6625
3420,87,3202,1441,2383,45075,819
24507,9,172,1155,122,13848,50
44398,3,42,770,33,3107,9
30327,80,2345,1034,1268,15525,1077
33984,13,95,970,87,12793,8
25673,1742,28895,1130,21756,143043,7139
18302,14,1031,1264,843,66875,188
59627,1052,22894,384,16851,117772,6043
61743,14,191,310,156,13228,35
35060,36,881,946,614,12226,267
55043,9,161,521,135,5785,26
37252,29,423,889,315,4341,108
23084,60,2507,1183,1645,41478,862
58633,30,387,417,291,6154,96
3184,26,550,1443,413,9797,137
65158,22,219,210,191,3165,28
48876,19,306,706,237,8878,69
30132,262,6933,1037,5812,53358,1121
57852,373,7201,442,5552,48876,1649
3507,397,10544,1440,7173,52489,3371
54972,53,357,523,276,5410,81
21115,81,1922,1214,1445,21780,477
31671,44,1367,1011,1112,14155,255
2033,5,351,1454,288,29877,63
34182,18,1086,966,751,22116,335
67367,172,2704,145,2066,17355,638
38785,1152,17075,850,14297,183745,2778
7289,28,1234,1393,949,40339,285
12035,315,6860,1358,4392,50430,2468
42124,3,161,800,65,3155,96
17219,14,545,1284,347,10452,198
27457,36,894,1091,585,9660,309
845,223,6971,1463,4860,45533,2111
62171,17,175,295,148,8840,27
41247,12,86,815,74,8552,12
39873,54,1525,836,1259,20878,266
32769,3074,105692,993,72656,244992,33036
23176,37,952,1182,710,11908,242
52111,22,205,617,171,4598,34
19080,0,0,1250,0,9072,0
69012,11,154,91,150,2872,4
7312,5,285,1393,192,12035,93
33679,92,1402,976,1009,20593,393
24046,6,151,1166,127,4273,24
57542,7,82,453,60,3588,22
23880,69,1323,1169,932,14403,391
3090,145,5105,1444,3814,45281,1291
50977,304,3265,650,2476,25810,789
26746,43,1549,1106,1016,22417,533
7160,41,1622,1395,1030,40454,592
60561,55,911,351,747,15086,164
21045,49,1162,1216,880,21128,282
41376,8848,277164,813,208454,816305,68710
44151,38,1157,772,917,46307,240
65681,101,1374,197,1143,12263,231
34368,877,9229,962,7603,112495,1626
67225,1,114,150,82,2076,32
41333,77,1440,813,1171,18456,269
67692,54,540,135,441,3855,99
22197,229,4660,1198,2583,33597,2077
52182,11,125,615,98,6751,27
34523,12,180,959,127,8779,53
24809,0,52,1148,43,3768,9
59694,6,52,382,45,3973,7
54758,266,2798,530,2081,61659,717
15159,1,107,1317,78,9211,29
64198,64,554,238,486,13387,68
48446,5085,103834,720,77163,646887,26671
18897,176,5225,1254,4506,60908,719
12647,1860,58082,1351,39913,228010,18169
48047,0,41,727,31,8182,10
9408,79,1474,1378,958,9046,516
60714,5,89,345,63,4061,26
20089,8,334,1232,261,23181,73
9381,48,2129,1378,1435,45361,694
54001,60,578,558,518,18232,60
66695,38,539,168,459,7639,80
36726,11,285,904,226,13066,59
59316,26,431,395,348,8207,83
37197,18,302,891,257,11862,45
3381,80,1925,1442,1255,17594,670
2988,201,7211,1445,5202,55970,2009
61908,6,78,304,71,2819,7
5050,312,7477,1421,4845,75406,2632
28016,430,8855,1078,6267,44125,2588
17109,284,6175,1286,4627,31299,1548
1444,21,545,1458,369,24008,176
34395,748,14549,961,11312,85917,3237
38808,26,281,849,193,5026,88
62147,110,1445,295,1138,14206,307
607,132671,17112581,1464,8224648,19251164,8887933
29018,150,2816,1059,2497,13496,319
37218,47,1074,891,880,26464,194
62297,69,873,291,686,5657,187
57904,166,1838,441,1304,25925,534
13237,16,1063,1343,533,12477,530
6380,64,6946,1405,4325,24789,2621
40891,9,247,820,174,7176,73
66720,17,277,167,187,7723,90
62629,0,57,281,41,3404,16
13778,114,4262,1336,2873,37865,1389
64491,7,197,230,160,3032,37
18076,18,357,1268,250,9267,107
42302,125,1806,798,1338,27715,468
65667,53,714,197,556,10614,158
60643,6,154,347,86,5129,68
28274,41,674,1074,554,10530,120
25297,12,518,1138,338,12614,180
45115,38,485,762,349,3747,136
66208,912,17476,182,13829,104331,3647
68452,13,233,111,183,5583,50
3701,5,469,1438,294,32276,175
29409,25,766,1052,460,20107,306
1069,473,9823,1461,6874,103021,2949
14133,497,4179,1330,2792,42177,1387
5490,237,6663,1416,4559,64941,2104
12781,46,1213,1350,669,13692,544
40696,235,2117,824,1777,33453,340
21334,39,876,1210,586,15234,290
25417,32,398,1136,367,26545,31
12944,1044,92914,1347,51416,304696,41498
12925,523,14794,1348,8502,44676,6292
8406,16,723,1382,456,17185,267
22543,41,1908,1193,1385,30266,523
31189,67,1478,1018,1019,27102,459
65170,43,552,209,431,4732,121
61292,10,143,323,109,5598,34
5711,10569,364603,1413,225964,747076,138639
2946,27,690,1446,471,22819,219
7252,706,19959,1393,13975,127912,5984
18085,5,234,1268,165,4301,69
37725,142,2228,876,1946,21976,282
1628,1317,63997,1457,39642,122601,24355
8310,7,158,1383,96,5388,62
58603,177,1788,418,1427,10886,361
9836,150,5054,1376,3274,20674,1780
15033,37,839,1318,551,14202,288
35021,31,442,946,337,7990,105
191,452,24059,1469,17406,185585,6653
48956,422,5967,703,4572,86427,1395
43621,46,502,778,384,7731,118
36517,657,26872,907,21741,134288,5131
11100,396,7520,1367,4751,42309,2769
57955,5,113,440,63,8516,50
61829,8,191,307,150,5304,41
20161,115,6293,1231,4294,67198,1999
56762,11,179,473,149,4389,30
61154,44,531,328,464,9966,67
412,8,849,1466,555,10795,294
39055,150,2512,846,2179,31987,333
28075,19,471,1078,309,6649,162
29754,1276,37152,1046,26821,243711,10331
16996,58,2215,1288,1615,18134,600
46169,3,212,750,148,11257,64
13170,1068,36345,1344,19746,191597,16599
716,4,181,1464,129,15096,52
48643,951,13338,702,10531,59902,2807
1402,174,7600,1459,5841,62216,1759
35299,43,1978,939,1301,13544,677
36100,243,5124,920,3874,49964,1250
15237,0,0,1316,0,14963,0
24379,7,263,1158,170,9300,93
49426,0,18,689,13,2241,5
35725,33,313,930,256,8560,57
54771,57,591,530,445,11809,146
33505,27,559,979,364,6919,195
65519,122,1544,201,1214,13325,330
5603,2739,81037,1415,54019,265659,27018
3049,64,1405,1445,824,18146,581
41838,335,5016,805,3914,97428,1102
55548,1017,16833,507,13932,86110,2901
20559,30,1204,1225,847,30080,357
4496,79,2202,1429,1557,81561,645
36796,33,944,903,764,12358,180
20370,108,5307,1228,3257,44165,2050
16748,43,875,1292,598,16671,277
3025,52,3161,1445,2121,54048,1040
62865,1245,23113,276,18848,132758,4265
37617,7,455,879,273,12674,182
22642,126,1905,1191,1287,13322,618
15717,12,301,1309,250,16870,51
3066,295,9696,1445,6891,103684,2805
27276,860,13778,1095,9693,56586,4085
52698,4,27,596,22,2399,5
36349,22,294,913,243,14821,51
53435,817,11425,575,9196,105693,2229
27380,7,487,1093,278,28756,209
50895,11,378,652,277,9297,101
46406,935,17522,748,12919,178303,4603
30741,263,10037,1025,7244,58438,2793
67528,42,511,140,414,3964,97
54855,25,220,526,181,7069,39
72,159,4753,1471,2959,56367,1794
38234,253,6239,863,5276,32470,963
10935,147,2584,1368,1691,17668,893
28915,45,1110,1061,696,10140,414
30492,15,298,1030,195,13054,103
67562,6,66,139,50,2898,16
55892,19,216,498,167,5851,49
17706,66,3432,1275,1330,40316,2102
27249,26,912,1095,582,14452,330
141,85873,4861309,1470,3145607,9678126,1715702
68047,15,167,124,124,4294,43
19394,82,2912,1245,2201,37609,711
1020,9647,364995,1461,214320,1168517,150675
8286,20,1032,1383,715,22543,317
64072,22,324,242,239,4445,85
64114,9,135,241,101,3427,34
59819,41,408,377,303,12432,105
21842,0,0,1203,0,5502,0
53978,8,132,559,102,9750,30
33941,26,1046,971,750,14844,296
57663,20,262,449,219,5395,43
22491,37,1477,1194,979,11857,498
56227,33,479,488,356,13960,123
34229,275,3540,965,2489,24892,1051
22758,154,3931,1189,2905,28929,1026
26814,182,2590,1104,1531,19360,1059
22905,8,469,1186,329,15527,140
30648,21,604,1027,391,6676,213
29197,12,670,1056,379,22570,291
11639,150,6064,1362,4045,42185,2019
50434,52,688,663,503,8541,185
53650,126,1417,569,1170,18662,247
57637,17,272,450,182,12315,90
31971,34,952,1006,645,16356,307
8503,68,3631,1382,2258,29011,1373
37971,105,1671,870,1333,17122,338
30714,91,2100,1026,1729,34180,371
67527,16,69,140,62,1561,7
34642,238,4419,956,3428,46282,991
47708,69,755,730,571,8838,184
27371,41756,861306,1093,415628,1654656,445678
58948,8,65,407,55,4848,10
58304,5,32,428,28,5026,4
4580,41,1122,1428,779,12603,343
11982,26,900,1359,441,8693,459
14051,6,691,1331,445,35653,246
34737,103,1290,953,871,10217,419
52677,2475,48715,597,34461,137458,14254
12861,53,1335,1348,765,16220,570
10368,0,10,1372,5,13017,5
15967,5,241,1304,174,5877,67
64655,92,554,225,458,6045,96
29067,14,469,1058,302,7330,167
10148,1,102,1374,65,4733,37
58618,590,7935,417,6219,69944,1716
64597,69,1286,227,1093,14035,193
10225,33,1710,1373,971,25845,739
23793,5103,113389,1171,59490,267778,53899
34724,63,1392,953,999,12937,393
41693,14,338,807,272,7413,66
4899,126,3718,1423,2668,62529,1050
51883,78,1115,624,956,11801,159
53865,23,307,562,247,9929,60
1528,6,224,1458,155,23382,69
10363,300,7013,1372,4425,99607,2588
53506,268,3347,574,2564,13902,783
59685,215,4027,382,3265,45569,762
57627,103,1818,450,1480,20456,338
27337,53,1155,1093,820,22928,335
6268,6,388,1407,274,13280,114
5374,62,2850,1417,2148,27207,702
50535,48,585,660,449,10877,136
25356,103,1948,1137,1426,35425,522
37036,143,2620,890,2184,32482,436
22568,55,2064,1192,1356,61380,708
37594,30,858,880,674,14617,184
60464,14,125,355,90,3925,35
19085,327,13996,1250,9004,43810,4992
26484,14,630,1113,372,5638,258
9835,244,4391,1376,2316,18586,2075
66540,33,615,173,514,6567,101
34987,132,2432,947,1627,30183,805
6051,119,1798,1409,1280,38241,518
6178,1898,77594,1408,51955,181168,25639
17102,2,105,1286,83,24672,22
56052,33,264,493,222,6630,42
50919,22,220,651,175,7825,45
25395,4177,95546,1136,57789,475446,37757
7473,70,3008,1391,1858,57008,1150
36317,3443,71623,913,55990,316683,15633
13732,3813,109051,1336,67616,384432,41435
8099,208,4460,1383,3193,26353,1267
2118,16,1144,1453,839,39997,305
18181,6,146,1266,113,7853,33
17711,727,17144,1275,12714,86572,4430
49669,552,8496,683,7044,115492,1452
59404,14,210,392,154,7622,56
52274,6,118,611,103,7317,15
40284,34,506,830,437,9687,69
58211,906,20155,431,14610,126576,5545
52495,98,1086,604,932,22786,154
31955,267,3443,1006,2211,47612,1232
57848,43,1005,443,874,18764,131
60369,29,309,358,254,7699,55
48687,170,4837,712,3562,35462,1275
3339,198,7410,1442,4861,64420,2549
33666,17,586,976,368,9519,218
5858,2,211,1412,139,4882,72
11260,55,3308,1366,1897,64117,1411
2986,117,3596,1445,2553,38534,1043
44882,61,1040,765,749,16163,291
11696,52,3862,1362,1432,13202,2430
15752,94,3580,1308,2645,74673,935
62863,2031,37695,276,30563,190961,7132
60979,40,805,335,621,6333,184
41295,74,479,814,419,29608,60
32505,30355,852963,997,544542,1900118,308421
15332,126,3862,1314,2669,42156,1193
33126,53,1237,986,888,17532,349
40579,1289,36881,826,22010,90386,14871
9084,31,1660,1379,1073,19803,587
1851,1,53,1455,36,3792,17
8227,211,4672,1383,3334,28179,1338
33860,460,5980,968,3862,71047,2118
66700,26,776,168,568,12391,208
42752,357,7026,790,5576,28181,1450
30299,406,9739,1034,6756,108625,2983
56901,45,560,469,418,9065,142
2349,34,1304,1451,913,11173,391
31031,215,5576,1020,3940,22713,1636
44382,10,353,770,281,8470,72
35244,89,945,941,688,32476,257
21201,89,2022,1213,1451,38886,571
34000,44,656,970,521,13058,135
31784,21,441,1009,332,4218,109
26844,121,4316,1104,3007,80049,1309
13345,20,491,1342,270,9471,221
58666,1455,48540,415,35976,95291,12564
11836,1347,34576,1360,20966,163155,13610
27609,41,995,1087,550,9477,445
64291,47,571,235,445,15436,126
42031,75,1017,802,750,6181,267
22608,4885,126051,1192,83710,248427,42341
26135,145,5275,1120,3665,48780,1610
40352,6,136,829,97,2022,39
30445,18,207,1031,160,6998,47
36888,107,1938,901,1525,26215,413
6894,26,697,1399,453,28051,244
33036,12,367,988,245,7952,122
56642,11,162,476,116,5170,46
68676,7,115,101,99,3500,16
67083,27,600,155,455,8681,145
63603,7,140,257,96,7541,44
2166,9,579,1453,365,36521,214
34491,28,944,960,602,8888,342
32755,32,939,993,584,9560,355
6442,227,10367,1405,6175,98243,4192
15291,3,70,1315,42,3038,28
35094,10283,216258,945,143448,1353344,72810
46481,61,696,747,467,12704,229
518,23,1072,1465,775,20007,297
14731,7,112,1322,82,7238,30
63489,3,15,260,11,3236,4
2998,421,10045,1445,5910,33353,4135
48534,9,184,717,153,7989,31
22134,6226,126421,1199,86163,405655,40258
50336,5981,71541,666,57513,263176,14028
48927,146,2619,704,1992,25054,627
56907,11,113,468,91,3367,22
20491,509,7709,1226,4814,63861,2895
34800,133,1846,951,1256,21942,590
62948,78,1210,274,1054,20646,156
23547,161,2770,1176,1800,25953,970
6012,18,346,1410,227,9792,119
15153,103,4661,1317,3336,36628,1325
42035,91,2378,802,1638,15111,740
7043,8,268,1397,165,9156,103
57436,48,498,455,381,6000,117
17422,23,822,1281,571,13704,251
22971,934,19372,1185,12798,167822,6574
62997,2,55,273,43,3191,12
22260,334,7290,1197,5211,75299,2079
283,994,29800,1467,22836,296512,6964
14988,18,804,1319,549,28211,255
34205,61,816,965,591,15500,225
41237,26,461,815,405,10459,56
50524,51,628,661,456,9053,172
25916,170,4761,1125,3127,62456,1634
17474,79,5827,1279,3901,38654,1926
9416,39,1682,1378,1053,23259,629
33511,0,0,684,0,2038,0
31337,16,556,1015,359,7155,197
35871,0,41,926,27,2461,14
2120,5,106,1453,65,14307,41
37710,839,9588,870,7438,69684,2150
55158,230,2722,518,2208,21856,514
8800,5,198,1380,130,5360,68
5854,5,268,1412,191,22707,77
64261,1,8,236,8,1342,0
1986,44,1261,1454,930,32889,331
16418,1,150,1297,107,15387,43
32214,145,2363,1003,1510,14329,853
1892,222,9986,1455,6550,50898,3436
66685,13,200,168,136,3704,64
27382,64,1682,1092,1017,21377,665
59817,33,378,378,318,12429,60
18788,150,4477,1256,3262,23435,1215
11165,1024,20050,1366,13080,75244,6970
64520,263,3438,229,2913,24072,525
19956,103,1418,1235,955,45980,463
18934,6,676,1253,463,6211,213
46537,20,416,745,374,7510,42
7080,940,64486,1396,38684,335245,25802
57351,26,425,457,328,12925,97
30443,25,968,1031,663,14320,305
51557,24,211,634,181,6095,30
24497,89,1883,1155,1248,12790,635
32705,15,443,994,334,7015,109
32062,90,1583,1005,1265,14313,318
29594,3,99,1049,81,3571,18
61415,7,134,320,112,3875,22
31892,112,1507,990,1081,19083,426
58759,1978,44438,412,36122,193266,8316
23798,2264,83705,1171,61669,166261,22036
62014,30,614,300,458,5234,156
6959,77,5573,1398,3664,36867,1909
55813,2,73,500,24,2713,49
11893,8,422,1360,190,7640,232
13341,31,1341,1342,817,33722,524
23946,17,347,1168,208,13196,139
20034,12,326,1233,235,19755,91
51063,53,767,647,588,12542,179
30581,72,2646,1029,1475,9423,1171
38139,161,2686,866,1957,14548,729
8196,844,16085,1383,10261,59513,5824
58156,79,960,433,758,12052,202
32297,27,418,1000,352,5705,66
26505,100,1982,1112,1315,28616,667
65186,21,213,209,163,4332,50
33504,1569,39003,979,26520,217107,12483
34143,21,628,967,451,15575,177
10295,5,234,1373,167,22274,67
31857,34,603,1008,373,7085,230
11236,45,2223,1366,1248,38676,975
2399,16,236,1451,143,28867,93
17,3454,162884,1472,86302,449291,76582
25555,55,1531,1133,1017,11680,514
63635,1642,29944,256,24715,170733,5229
59837,13,167,377,107,7716,60
20609,6,248,1224,190,5719,58
32956,2,117,989,72,2412,45
53778,14,362,566,238,10189,124
14120,10,557,1330,402,17589,155
5898,10651,493005,1411,323493,1431457,169512
55248,167,2201,516,1708,30149,493
49943,101,1689,676,1303,50366,386
4097,11,632,1434,467,10508,165
29794,65,2635,1045,1517,19366,1118
20355,47,1952,1228,1253,19367,699
23939,47,1695,1168,1137,10459,558
20079,0,137,1233,107,9039,30
52787,146,2504,593,2047,19814,457
66112,24,484,183,373,3956,111
63352,4,50,263,42,1635,8
29492,501,8098,1051,5011,74081,3087
52020,4,93,620,80,7237,13
26910,39,1054,1102,832,29653,222
20866,142,3125,1219,2217,33500,908
47433,112,1867,734,1565,25828,302
63853,1,32,250,24,3446,8
59,36,1079,1471,809,23726,270
62056,5,34,299,29,2657,5
21599,16,863,1206,609,9121,254
64008,30,297,244,234,5263,63
9663,3,227,1377,139,8101,88
62139,2,75,296,44,3200,31
3708,8564,270316,1438,186266,717969,84050
6250,179,7290,1407,4948,52199,2342
51551,78,1739,634,1336,18757,403
23443,11,301,1177,212,9770,89
27568,59,778,1088,460,7064,318
48623,53,562,714,493,9306,69
32691,442,11995,995,8819,138949,3176
30205,67,1904,1036,1497,62729,407
32963,55,1213,989,715,20133,498
48857,3,73,707,54,4297,19
114,2269,127825,1470,81373,805162,46452
46310,5,70,749,50,4042,20
50212,49,597,669,521,9422,76
29140,275,8956,1057,5731,30383,3225
32366,9,421,1000,282,6516,139
65698,22,185,196,142,5334,43
23792,14,393,1171,264,5395,129
12929,231,7665,1348,4735,41873,2930
27701,46,1236,1085,763,8162,473
43409,249,3896,781,2935,24914,961
67932,22,474,128,377,7715,97
23107,275,11689,1183,7389,61196,4300
34158,3,138,966,94,6759,44
25525,6,806,1134,498,7515,308
35,671,25036,1472,18488,125968,6548
18684,43,2846,1257,2108,43168,738
34377,2,169,962,109,8681,60
26080,139,4824,1121,4092,39869,732
16484,86,590,1296,401,44985,189
51484,91,1541,636,1239,11568,302
11712,131,2790,1362,1615,41022,1175
38356,272,3288,861,2818,18984,470
24529,20,512,1155,317,7493,195
61932,17,243,303,194,6296,49
32095,27,396,1004,288,17746,108
56372,43,560,484,450,11240,110
22367,55,2703,1196,1922,22745,781
27274,7,331,1095,210,8202,121
60590,17,270,350,220,12829,50
8283,12,609,1383,374,8247,235
68693,11,130,102,91,3952,39
25459,1032,23665,1135,17727,84997,5938
41229,29,326,815,265,9098,61
11517,511,19583,1363,12149,130582,7434
1418,298,8907,1458,6350,129504,2557
32397,14,180,1000,111,3780,69
6363,29,1280,1406,889,26527,391
25283,189,2205,1138,1371,14348,834
10687,22,1269,1370,820,32998,449
23966,124,3602,1167,2524,35448,1078
68124,6,117,122,94,3704,23
60340,1150,13295,359,9746,58010,3549
33220,33,675,985,425,22691,250
63582,121,1390,258,1123,19715,267
15115,4,103,1317,81,11698,22
68293,7,48,116,39,2617,9
66943,25,246,159,211,6807,35
30893,22,948,1023,608,11748,340
27383,3,218,1092,120,7562,98
25331,736,18366,1137,12817,112868,5549
24293,261,4879,1160,3051,41883,1828
56580,38,654,478,507,18306,147
53215,21,282,580,258,24526,24
8967,13,1133,1380,740,13421,393
54442,63,821,542,619,9135,202
1623,29,965,1457,659,13250,306
52561,0,940,601,752,9428,188
11012,33,1311,1367,758,12599,553
30876,18,851,1023,572,6967,279
38058,63,523,868,415,11083,108
56687,0,6,475,6,1814,0
54833,10,52,527,43,7468,9
35426,0,1,936,0,10845,1
33856,49,602,973,369,6288,233
1720,474,16336,1456,12000,61893,4336
58920,28,450,407,350,16790,100
41750,29,440,806,361,10843,79
4953,42,1284,1422,919,19866,365
35399,27780,661609,937,495703,1573231,165906
23240,59,1984,1181,1693,36674,291
14491,7,241,1325,172,15774,69
61942,42,480,303,394,6724,86
26395,67,4660,1114,2887,28922,1773
53541,4001,50552,573,40263,281025,10289
34309,25,542,964,360,9630,182
4527,120,6930,1428,3993,36872,2937
48228,10,85,724,75,2636,10
48491,9,160,719,130,4447,30
66544,47,494,173,406,7012,88
24831,44,902,1148,625,11566,277
32831,5,384,992,224,3883,160
65742,70,1893,196,1402,16785,491
50038,22,249,673,196,13136,53
6138,4,151,1408,98,9207,53
15805,119,3230,1307,2369,25159,861
1974,2,339,1454,235,20123,104
22041,823,15472,1200,10045,136251,5427
15669,38,1353,1309,856,7733,497
59352,52,717,394,528,17996,189
35538,3,133,934,67,4642,66
64956,10,265,215,192,8282,73
63938,6,37,247,29,1409,8
38638,550,28527,853,21329,67305,7198
11616,599,12312,1362,8425,87822,3887
64256,3,54,236,32,15647,22
64796,3,54,221,44,2275,10
3178,112,6873,1443,4474,47441,2399
49647,538,6741,684,5106,101662,1635
143,6,297,1470,186,14843,111
23058,6,324,1183,284,18865,40
55169,54,919,518,614,14603,305
27726,4851,84856,1085,47839,273286,37017
20599,303,10670,1224,7339,90871,3331
69024,2,29,90,27,913,2
7625,2461,168565,1389,91979,409854,76586
21892,310,3369,1202,2010,14977,1359
8703,17,307,1381,193,5738,114
45882,122,2204,753,1684,26200,520
34284,10,324,964,219,7557,105
68575,3,62,106,46,2300,16
65345,8,76,206,64,2299,12
39879,4,202,836,167,11589,35
33186,19,696,985,397,9622,299
10431,1217,36656,1372,21942,182425,14714
38082,40,657,867,489,9380,168
11178,37,1581,1366,890,21617,691
33951,377,5695,971,4722,24812,973
50493,194,3012,662,2573,38326,439
9534,2165,74201,1377,44288,212533,29913
67118,7,47,154,39,1575,8
3016,23,710,1445,497,31789,213
55348,235,2566,513,2019,24098,547
26760,53,1673,1106,1387,41272,286
52700,12533,184628,596,146432,762412,38196
31616,65,2740,1012,1896,14222,844
60418,22,268,357,237,8032,31
55693,3,33,503,33,5912,0
9200,66,2450,1379,1617,16326,833
67834,9,207,130,182,2512,25
67914,9,157,128,104,4083,53
40755,84,2793,823,2325,57231,468
41607,15,393,809,287,9212,106
6454,4,356,1404,235,34583,121
3015,51,2636,1445,1682,46133,954
17300,9,115,1282,92,7319,23
64517,8,74,229,53,4391,21
36102,35,825,920,641,7899,184
16737,395,5887,1292,4062,21941,1825
51996,11,218,621,183,7219,35
1774,6,331,1456,228,19424,103
57587,320,7613,451,5786,38976,1827
42742,6,180,790,136,6869,44
28144,9,106,1076,85,3680,21
13192,115,1752,1344,987,11114,765
28716,4,428,1065,240,11756,188
5140,166,6757,1420,3649,25122,3108
13811,5274,208848,1335,125002,551001,83846
7299,51,1126,1393,773,32309,353
31854,165,2765,1008,1896,30083,869
1025,61,3100,1461,2138,44572,962
48259,254,4448,724,3492,96282,956
1393,213,4881,1459,3777,167995,1104
60491,25,174,353,141,2611,33
55287,61,745,514,571,37370,174
50224,565,8600,669,7070,110384,1530
55520,31,326,508,295,12999,31
67320,0,14,147,10,2716,4
54904,23,306,525,200,6444,106
54506,221,3444,540,2916,43584,528
5160,8,1230,1420,845,18145,385
28330,20,738,1072,507,11467,231
62849,83,1081,276,861,9124,220
10913,0,15,1368,10,8101,5
56327,24,404,485,249,8044,155
67026,5,114,157,76,3124,38
21431,226,5553,1209,3870,62118,1683
19048,29,1571,1251,1080,32509,491
53880,77,553,562,363,7049,190
20041,8,486,1233,338,16633,148
8483,41,1217,1382,789,11895,428
9696,4,214,1376,166,8473,48
67447,744,9953,143,7373,43979,2580
58619,103,2170,417,1712,8884,458
16559,4,325,1295,215,12467,110
27336,248,4567,1093,3215,65760,1352
64279,6,107,235,73,4767,34
5239,25,1443,1419,1100,12134,343
30164,13606,410475,1037,270719,873850,139756
57321,47,658,458,474,13451,184
50159,72,616,670,471,7286,145
53574,54,653,572,479,10933,174
21456,470,12599,1208,9002,77579,3597
65057,4,96,211,80,3553,16
2308,70,3033,1451,2114,27735,919
68932,4,50,94,36,2496,14
9042,11,613,1380,417,32835,196
22718,25,2177,1189,1374,26564,803
42103,585,20760,799,16012,113841,4748
35762,1448,28283,929,21142,96605,7141
67659,203,3592,136,2569,51227,1023
34497,49,943,959,681,11712,262
32228,94,2348,1002,1650,20128,698
53295,42,731,579,512,7508,219
25207,61,2968,1140,1986,42756,982
18844,4,125,1254,111,8963,14
62594,80,715,283,537,8889,178
49661,1939,761137,683,465689,431002,295448
64989,4,36,214,28,1945,8
17639,81,1963,1276,1366,25575,597
4299,4,279,1432,142,17458,137
36019,117,3151,923,2162,22155,989
12472,0,0,1353,0,6712,0
502,13,509,1466,361,22457,148
58636,53,1099,417,774,10815,325
6564,527,26126,1403,15223,90261,10903
6214,23,636,1407,415,8797,221
44943,101,1380,764,1098,9397,282
56249,161,5505,488,4449,34242,1056
34807,8,164,952,112,3163,52
17273,260,10387,1283,6407,66715,3980
48965,406,6664,703,5359,71171,1305
154,495,17607,1469,12164,73167,5443
65972,8,122,190,106,8828,16
26520,3,193,1112,139,6841,54
18426,39,1308,1262,980,21501,328
65951,10,91,191,77,6976,14
5131,47,2673,1420,1775,15606,898
28654,14,105,1066,60,3112,45
25481,33,655,1134,441,8609,214
61010,9,75,334,63,5735,12
12784,14,871,1349,435,8188,436
42004,21,313,802,257,9645,56
43917,5,49,776,42,1440,7
17559,489,13036,1278,9120,68231,3916
61527,34,301,317,243,4206,58
15733,101,2883,1308,1876,29420,1007
67180,1339,33715,150,25195,190331,8520
66820,68,806,163,628,20011,178
53169,372,3921,581,3148,32527,773
59870,32,771,376,493,20243,278
8022,38,1662,1384,1230,31078,432
14992,0,0,1319,0,5848,0
51112,982,16834,646,13049,133584,3785
53323,19,147,578,118,5361,29
57957,17,201,440,164,17613,37
51289,530,6869,641,5613,54329,1256
30894,200,2498,1023,1729,34054,769
39805,131,3452,837,2351,18485,1101
35681,9,340,931,222,5481,118
1281,130,1823,1459,1289,13451,534
51445,669,6464,637,4880,24915,1584
35832,40,585,927,413,6252,172
21658,9,479,1205,262,10444,217
55726,27,375,503,305,6086,70
17906,58,2682,1271,2030,40943,652
655,323,15404,1464,9304,52754,6100
38579,74,1818,854,1317,15757,501
18157,20,398,1267,317,8106,81
50824,46,797,654,624,11243,173
56531,18,215,479,178,5839,37
51226,245,2480,635,1963,20893,517
59115,77,1214,402,940,10299,274
45042,1173,24841,762,19539,141346,5302
37012,1208,23467,897,19023,228026,4444
59458,2,120,390,94,5795,26
68881,232,8447,95,6934,43868,1513
65566,5,366,200,272,9434,94
15511,5,167,1312,127,12091,40
34879,18,539,950,358,9053,181
31180,796,17094,971,13160,86913,3934
44044,19,378,774,287,9759,91
57140,96,1075,463,890,14971,185
19205,76,1317,1248,890,8644,427
66292,9,76,180,60,2812,16
51658,68,1133,630,915,13801,218
65164,37,689,210,565,10046,124
53257,0,4,580,3,1612,1
56582,24,280,478,215,7143,65
57881,23,420,442,307,8634,113
55186,77,1282,518,1116,14519,166
51466,2,59,636,37,13922,22
50457,158,2632,663,2104,62259,528
38382,8,196,860,100,3816,96
9590,143,3892,1377,2575,46828,1317
31405,4,114,1015,91,4580,23
64422,4,48,232,36,2639,12
2037,99,2299,1454,1742,33227,557
67859,38,433,129,333,7612,100
37449,41,854,884,714,15671,140
44481,34,610,769,488,18809,122
35486,466,5973,935,4565,106331,1408
56446,37,366,482,315,9517,51
17145,118,2379,1285,1613,27706,766
21831,126,3187,1203,1973,53795,1214
49758,19,460,680,371,10189,89
25433,31,761,1135,417,6393,344
9448,26,1041,1378,762,12879,279
63922,268,4598,247,3988,36504,610
3658,13,683,1439,485,10486,198
62205,15,182,294,127,5312,55
20938,33,603,1218,384,34012,219
52460,1791,18431,605,15597,146702,2834
18694,4,219,1257,198,8499,21
27988,28,855,1079,526,11018,329
33571,337,7433,978,4875,64907,2558
2711,25,1226,1448,903,15829,323
51998,112,998,621,771,15317,227
14095,24,1794,1331,1390,22653,404
13278,316,15816,1343,8965,85015,6851
6101,4,223,1409,152,22515,71
20099,12,480,1232,367,18744,113
43025,80,995,786,834,16489,161
51316,69,789,640,626,17063,163
68461,49,945,110,800,16394,145
51079,0,153,647,102,6856,51
17324,58,1294,1282,908,15491,386
7588,115,3340,1389,2401,46869,939
48829,11,633,707,497,13455,136
62534,147,2208,284,1946,29575,262
28013,118,2702,1078,1992,23991,710
20705,33,1083,1222,803,13129,280
49103,35,701,699,609,17195,92
2657,70,2802,1449,1836,103389,966
33613,94,3433,977,2203,22936,1230
63062,18,281,271,225,5840,56
38392,3539,45762,846,34972,253692,10790
5548,67,2311,1415,1479,13205,832
18910,25,1138,1253,739,8269,399
2877,222,5694,1446,4040,24244,1654
31389,304,8232,1015,5630,55262,2602
41984,185,3084,803,2413,35619,671
12523,97,3340,1353,1901,28578,1439
19941,69,1977,1235,1377,21830,600
40004,16,255,834,179,5127,76
57467,1830,28427,455,22190,187064,6237
27427,1575,40107,1091,23991,248548,16116
52506,3854,80220,603,63600,318771,16620
26676,8,360,1107,216,10222,144
9799,764,27067,1376,17734,112157,9333
64683,8,68,224,56,3569,12
67075,734,8448,154,6339,41661,2109
31804,28,896,1008,718,12587,178
8084,21,624,1384,415,18104,209
16732,36,655,1292,524,28651,131
46081,381,5832,743,4465,47146,1367
6585,134,3201,1402,1942,50274,1259
4940,22,559,1423,393,16135,166
30827,6,397,1024,234,4745,163
19192,68,2509,1248,1844,110600,665
54326,586,19788,437,10627,123349,9161
48492,54,894,718,737,20740,157
64635,63,1064,226,875,14459,189
44086,22,473,773,398,28657,75
9095,34,1086,1379,746,14649,340
30212,30951,629293,1036,372695,1396830,256598
19587,442,6124,1241,3873,49820,2251
1610,80,3906,1457,2347,28893,1559
34089,25,400,968,259,10197,141
27982,340,5612,1079,3173,46020,2439
39317,42,638,843,510,12236,128
65753,2,38,196,32,3434,6
16655,85,2989,1294,1951,60392,1038
21397,21,781,1209,608,11084,173
31055,359,13064,1020,6241,37977,6823
17278,10,291,1283,232,10647,59
34537,37,475,959,295,6724,180
9212,31,1782,1379,1159,63145,623
37994,73932,1534622,863,1053386,5979502,481236
18397,0,0,1262,0,20468,0
21110,22,1016,1214,746,19843,270
51860,1198,14023,625,10743,75120,3280
24793,4,198,1149,127,11565,71
33697,124,3738,975,2489,22153,1249
18480,24264,795152,1261,489137,2904495,306015
59222,3009,45523,398,37084,210922,8439
42500,575,15920,795,12390,90298,3530
7273,27,1854,1393,1155,23370,699
51006,18,177,649,156,6245,21
28487,15,405,1070,223,7263,182
37570,25,637,880,483,13227,154
40213,222,3911,831,3313,38117,598
34925,1988,46802,949,32050,161862,14752
6028,316,5618,1410,3640,52737,1978
61677,10,151,312,120,3468,31
27480,24,995,1090,562,8333,433
16767,5,43,1291,33,3929,10
66903,11,124,161,93,3069,31
19299,13,224,1246,142,6565,82
60289,95,1447,361,1167,21301,280
54558,29,326,538,268,4335,58
60566,1356,24662,351,19653,86015,5009
2809,98,3822,1447,2817,40474,1005
22012,33,1061,1200,696,24315,365
15693,146,3231,1309,2290,26961,941
56840,85,1102,469,952,20835,150
34717,7,135,953,95,7027,40
56413,36,361,483,273,8482,88
2889,5460,355807,1446,195633,572778,160174
67499,12,203,141,167,3246,36
5123,1933,76654,1420,41920,315449,34734
56505,1,30,480,24,6382,6
14581,98,4871,1324,3180,85510,1691
29279,38,789,1054,557,14558,232
19826,6872,272619,1237,168603,733630,104016
57599,176,2311,451,1835,19122,476
55645,60,749,504,637,21030,112
7020,26,932,1397,673,41234,259
18310,694,20684,1264,14509,176392,6175
22018,357,3898,1200,2870,40396,1028
18340,5185,88178,1264,58855,335706,29323
34876,42,756,950,669,12292,87
65662,15,294,198,224,9763,70
64805,30,277,221,243,5356,34
51836,29,297,626,265,10441,32
33312,15,696,983,369,9937,327
6486,166,8159,1404,5084,81206,3075
2696,252,6649,1448,4753,75492,1896
64927,109,1036,208,763,7003,273
24695,15,455,1151,274,8523,181
67461,156,3306,143,2592,32674,714
45919,557,6092,753,4907,40036,1185
41120,14,215,817,169,4799,46
15487,511,18474,1312,12731,154672,5743
1166,4,229,1460,147,25392,82
29566,25,583,1049,348,17758,235
5251,4,292,1419,168,5170,124
9594,4,240,1377,145,8114,95
56709,33,293,474,225,3881,68
67630,4,84,137,69,2074,15
52884,117,1400,590,1134,14312,266
33007,59,1432,988,972,9477,460
43733,6,141,777,95,3771,46
12777,11,545,1350,257,8224,288
5217,70,2403,1419,1580,18191,823
32547,85,1601,997,1118,28010,483
35114,102,1526,944,1090,17556,436
16498,0,40,1296,27,5106,13
27149,10,219,1097,147,5383,72
18117,8,722,1267,503,14653,219
28829,332,7221,1063,4610,60675,2611
51913,19,293,624,240,6216,53
32841,158,9531,991,6221,54687,3310
8965,31,1427,1380,929,30363,498
49355,54,331,691,250,3647,81
15324,191,10723,1315,5814,60230,4909
32354,241,6019,1000,3611,74805,2408
52087,19,429,618,272,15762,157
35861,39,536,927,403,3860,133
68029,4,30,125,25,2372,5
35092,17808,642923,945,440041,1701363,202882
11646,148,3274,1362,2231,49002,1043
19821,116,1723,1237,1172,13308,551
63768,11,86,252,62,1301,24
16796,137,2452,1291,1702,28704,750
23298,16,534,1180,385,5906,149
50956,231,2596,650,2018,20868,578
13404,185,6405,1341,3540,33146,2865
35710,8,526,930,356,10306,170
13298,4283,86351,1342,52031,239380,34320
17594,416,15463,1277,11385,131679,4078
36198,27,994,918,677,27326,317
60768,44,723,343,573,15777,150
3574,1608,33585,1440,20365,176612,13220
19063,309,4743,1251,3366,25017,1377
64467,17,295,230,225,5555,70
52644,18,238,598,209,16322,29
31333,82,839,1016,576,11286,263
64784,4,92,221,75,1957,17
55702,64,896,503,795,12764,101
4802,6,455,1425,309,12626,146
32878,698,12819,987,9633,94378,3186
30425,46,1164,1032,685,16609,479
63327,21,293,261,239,4950,54
63783,27,207,252,152,4337,55
36058,2217,72482,921,56368,326678,16114
55064,23,159,520,138,8169,21
33098,43,722,987,506,8782,216
9533,1312,59321,1377,35933,191717,23388
68894,137,2393,95,2077,17647,316
9746,5,128,1376,87,7998,41
34636,23,894,956,671,15608,223
2551,154,8115,1449,5364,62189,2751
6692,2359,105969,1401,68006,222908,37963
37902,818,16772,872,13336,127067,3436
49075,121,1417,700,1269,21144,148
52347,15,317,609,232,10191,85
3921,83,2403,1436,1732,37292,671
62087,30,334,298,238,4948,96
22136,26,1585,1199,971,22366,614
26464,25,2075,1113,1027,7307,1048
58219,62,575,431,432,11020,143
24748,151,3837,1149,2554,31134,1283
37593,83,2020,880,1821,16965,199
60487,16,203,353,160,3196,43
64824,93,719,220,562,5441,157
65351,12,73,205,60,3429,13
53062,25,259,585,207,3019,52
14086,14,508,1331,319,12120,189
21059,1492,32272,1215,26449,255606,5823
42310,3412,42816,798,33737,198084,9079
31102,997,31826,1019,22744,160727,9082
22727,1632,25553,1189,14850,107406,10703
24187,274,3771,1162,2493,23610,1278
22885,1092,29119,1187,21550,172325,7569
5936,487,15761,1411,9175,60512,6586
44522,94,3661,768,2477,27854,1184
42782,21,399,790,306,12670,93
49610,53,787,685,418,9947,369
12773,70,2606,1350,1319,17248,1287
10857,53,2326,1369,1175,18695,1151
7578,19,450,1390,353,11287,97
38309,6,273,862,230,7839,43
52442,21,381,606,307,5559,74
65332,57,764,205,669,16614,95
30351,102,1867,1033,1331,38362,536
33950,52,830,971,545,12348,285
17333,11,580,1282,410,20256,170
27779,713,16844,1084,12047,43368,4797
20992,114,4387,1217,3193,57123,1194
21946,11,430,1201,303,9054,127
280,753,30777,1467,21212,116455,9565
5693,69,2410,1414,1580,39897,830
51904,216,2762,624,2235,24347,527
55849,116,1142,499,980,23910,162
61854,11,222,306,180,5793,42
54318,5,83,547,63,3094,20
21301,12,369,1211,294,10815,75
66114,1,6,186,5,1160,1
50825,164,5560,654,4183,33936,1377
32391,5,177,1000,117,2372,60
7342,10,261,1393,181,9361,80
31127,23,234,1019,154,2581,80
58802,6,97,412,66,3648,31
41790,13,335,806,227,4848,108
26657,79,1087,1108,878,18863,209
13508,89,4258,1339,1957,40935,2301
60252,44,699,362,607,12939,92
65135,28,472,210,404,11445,68
28053,96,3531,1078,2025,20431,1506
57320,26,429,458,340,7907,89
10631,356,14715,1370,8312,76441,6403
7205,703,28453,1394,17867,152358,10586
49458,8,181,689,132,5873,49
67330,8,215,147,155,7425,60
29063,473,13188,1059,7800,83942,5388
17402,31,1092,1281,902,18267,190
9247,14446,444027,1379,294953,1357971,149074
55911,247,2555,498,2116,23608,439
30799,1,126,1024,82,8143,44
22833,26,1157,1187,880,20098,277
19040,12,332,1251,243,13779,89
19212,5954,176582,1248,124700,900561,51882
22304,14,1047,1197,680,8588,367
33133,63,1721,986,1185,17600,536
34402,415,6906,961,4788,48184,2118
58261,132,1691,429,1247,14999,444
64670,2,50,210,46,2672,4
5120,14,521,1420,381,11763,140
66575,5,27,171,19,3226,8
53913,61,827,561,703,11427,124
52121,68,1218,616,941,20899,277
33424,1,66,981,41,3050,25
54257,23,138,549,105,7373,33
68466,0,30,110,16,3734,14
68895,9,249,95,184,5118,65
21639,231,9992,1205,6285,133683,3707
61157,83,1344,328,1115,10713,229
15902,6,270,1305,183,23851,87
16889,568,18631,1290,13389,172735,5242
62536,24,698,285,528,13120,170
14451,23,505,1325,331,15256,174
19026,122,3452,1251,2253,25522,1199
56652,191,2398,476,1889,26572,509
66333,99,1695,179,1415,28369,280
35578,10,241,933,182,5875,59
64736,48,582,223,458,4172,124
23658,1,159,1173,102,15361,57
50555,2,76,660,58,3166,18
65897,64,638,192,573,8811,65
32066,14,288,1005,253,7806,35
27368,115,1737,1093,1193,19289,544
65580,99,1010,200,767,6630,243
22273,882,16860,1197,11085,38507,5775
8547,123,2724,1382,1596,20958,1128
42223,193,3889,799,2971,68580,918
67879,6,85,129,60,7702,25
15307,1179,28312,1315,17763,157792,10549
40779,53,747,822,574,17085,173
19287,16,357,1247,294,12466,63
33934,18,350,969,251,5534,99
16324,1,130,1299,77,6528,53
26022,603,8186,1122,4536,35158,3650
23511,50,2077,1176,1477,40310,600
5068,4,225,1421,160,17625,65
52908,38,662,589,460,17819,202
36266,63,1390,915,1241,21824,149
43991,4,70,775,56,4680,14
65393,875,19643,203,15523,118283,4120
19024,48,728,1251,499,16791,229
22649,14,489,1191,334,7041,155
65380,0,14,205,13,661,1
50294,139,2529,667,1882,22631,647
46024,22,307,752,225,14104,82
5560,66,1424,1415,960,26783,464
30214,17,540,1036,321,19868,219
15690,249,3865,1309,2800,79055,1065
57932,251,3679,441,2636,43347,1043
29275,316,7078,1054,4414,62140,2664
48473,2179,29749,720,23476,149656,6273
50739,8,104,656,96,6512,8
30666,830,25843,1027,17154,200784,8689
12575,219,5000,1352,2900,37056,2100
52114,174,2886,617,2450,16982,436
10260,3,321,1373,198,15619,123
50329,954,13989,666,10888,91333,3101
60469,5,43,354,37,5508,6
38119,157,3197,866,2649,51536,548
20287,205,9510,1229,5693,64713,3817
56019,34,416,494,331,7544,85
51701,145,1388,629,1151,17195,237
20533,56,934,1225,717,20994,217
51512,110,2180,635,1506,15138,674
56177,21,422,489,242,6203,180
22560,15,430,1193,306,11165,124
50786,9,73,655,60,3688,13
25199,170,8318,1140,4820,43470,3498
36934,54,1097,899,851,17286,246
30124,132,2268,1037,1598,14503,670
9207,794,19103,1379,13605,47500,5498
16371,12,275,1298,185,4660,90
13550,82,2225,1338,1362,11618,863
53499,106,1581,574,1195,20659,386
35339,11287,218181,938,172232,876960,45949
20378,15,710,1228,505,25095,205
50540,173,1930,660,1443,20758,487
23522,33,1567,1176,1006,8877,561
4305,16,1005,1432,676,58498,329
46323,5,73,749,54,4795,19
13204,33,959,1344,667,22869,292
8090,320,4689,1384,3125,22740,1564
35688,96,2985,931,1962,28259,1023
46561,59,1086,745,880,19040,206
19288,0,0,1247,0,4880,0
22124,1227,11577,1199,8350,47135,3227
32007,883,20668,1006,13871,71831,6797
61712,360,3687,311,2892,17550,795
57656,19,202,449,172,3931,30
34420,4,69,961,57,6608,12
19974,397,8029,1235,5045,64553,2984
61116,11,234,330,96,3558,138
15135,30,522,1317,366,11707,156
12746,233,6719,1350,3782,86745,2937
58060,6,142,436,70,3938,72
59361,293,4832,393,3351,34103,1481
19757,44,1525,1238,1038,35010,487
66925,13,210,160,129,3782,81
9596,96,2644,1377,1672,13644,972
2173,62,2586,1453,1739,44231,847
60699,53,872,345,669,19213,203
29078,5,493,1058,263,7802,230
53232,77,797,580,583,11324,214
48817,22,352,708,244,4791,108
38333,1,50,861,35,3255,15
22770,189,4302,1189,2735,16229,1567
30602,484,3509,1028,2462,27170,1047
9582,57,2157,1377,1362,33209,795
61013,6300,162903,332,115569,617744,47334
13619,10,657,1338,372,21485,285
21073,3,127,1215,88,4467,39
55428,77,692,511,608,19751,84
12273,29972,1098973,1356,607125,3277097,491848
25520,30,748,1134,571,12470,177
44278,197,1888,771,1419,17131,469
60527,7,109,352,88,2741,21
42710,69,1227,791,933,11781,294
4389,26,574,1430,408,62148,166
64706,35,184,224,146,3331,38
26813,36,1120,1104,671,28441,449
2593,102,4222,1449,2977,68088,1245
40454,13,104,827,84,5973,20
27505,407,17494,1089,9363,123008,8131
7068,13,500,1396,378,21719,122
6355,103,1749,1406,1065,25316,684
20105,1,97,1232,81,6460,16
17635,26,1627,1276,1145,44048,482
8636,506,27842,1381,15528,88166,12314
56990,2,44,466,31,3627,13
21365,312,12944,1210,7904,27149,5040
41272,12,195,814,171,4143,24
35633,461,23327,932,18932,97278,4395
15747,1,74,1308,47,5895,27
68924,36,588,94,514,12410,74
67205,26,549,150,443,6347,106
36191,297,3366,918,2319,34242,1047
16316,28,507,1299,347,14558,160
22840,48,970,1187,701,21917,269
57465,56,426,455,343,10155,83
28348,355,15905,1072,10189,124543,5716
18669,7,147,1258,100,18060,47
26282,360,12581,1117,7965,166973,4616
30489,10,268,1030,155,4885,113
28718,2,476,1065,269,11970,207
26397,75,1823,1114,1274,21140,549
27223,30,752,1096,448,12939,304
4916,58,6695,1423,4410,25129,2285
10374,37,2088,1372,1347,25855,741
536,17,684,1465,444,19645,240
60439,4109,55601,355,44856,191143,10745
31371,782,11685,1015,7803,37781,3882
17310,18,389,1282,287,7520,102
55194,4,64,517,42,6671,22
23044,235,4470,1184,3136,32094,1334
35417,18,255,936,187,7235,68
21040,197,3404,1216,2371,21117,1033
3765,908,21514,1438,14330,128122,7184
20473,531,6771,1226,5380,94698,1391
38291,48,689,862,536,6811,153
8592,27,1403,1382,866,24074,537
31491,1004,12379,1014,8586,59808,3793
35024,27,725,946,605,12776,120
8819,106,1915,1380,1237,16583,678
3543,120,6186,1440,4536,33409,1650
9573,927,30164,1377,20129,90729,10035
16328,0,73,1299,47,6682,26
6710,2,68,1401,43,8220,25
10184,36,1128,1373,730,39360,398
64312,54,550,235,438,4369,112
68198,18,248,120,206,11234,42
63338,6,59,264,41,6716,18
6948,11,646,1398,463,31697,183
51671,1,54,630,39,5598,15
21939,139,2077,1201,1382,19839,695
17640,4,104,1276,79,7264,25
6690,322,8565,1401,5445,39670,3120
25759,35,1076,1128,611,11193,465
403,50,3930,1466,2680,30023,1250
36512,174,1817,907,1407,15044,410
57427,219,10305,456,7517,48397,2788
7081,50,1511,1396,926,14139,585
63357,30,1059,263,849,15378,210
1978,84,1809,1454,1270,52435,539
50042,78,739,673,602,16491,137
8010,433,12621,1384,8505,92244,4116
26688,108,2924,1107,1950,17658,974
23519,5,199,1176,146,9776,53
13580,5,517,1338,291,14861,226
31697,3077,75712,1010,45141,372460,30571
47871,6,113,729,82,3655,31
5415,19,514,1417,387,13027,127
18985,75,4005,1252,2874,23557,1131
53636,3,10,570,8,1546,2
7574,14,916,1390,688,19610,228
21805,128,3137,1203,2111,28151,1026
3029,21,948,1445,667,19636,281
30974,42,525,1021,331,5344,194
17123,8,200,1286,150,6962,50
14029,120,4722,1332,2972,33588,1750
60061,138,1672,369,1370,17377,302
55298,7,143,514,110,6523,33
35680,73,1159,920,949,13895,210
56289,27,392,486,308,10040,84
40605,30,412,826,307,8798,105
53689,3611,69333,568,53070,163515,16263
64640,8,173,225,98,8465,75
23617,19,509,1174,433,16279,76
48524,39,433,717,361,8817,72
29216,39,972,1056,658,44453,314
23779,257,6870,1171,4292,74346,2578
67563,93,1553,139,1248,24113,305
54739,15,128,531,90,8543,38
12234,4753,68767,1356,43337,303252,25430
7819,303,12869,1386,8033,90713,4836
50641,61,360,658,258,6230,102
51140,27,222,645,174,4558,48
59830,16,150,377,122,3047,28
12525,22457,655866,1353,337313,1655714,318553
67456,3,20,143,18,2137,2
52053,89,1194,619,892,13338,302
48853,6,155,707,120,2840,35
40817,538,5070,822,4069,39526,1001
61892,10,133,305,92,4463,41
53847,172,1296,563,993,11410,303
11415,14,511,1364,293,4779,218
33201,23509,426357,985,305210,1335790,121147
66216,5,144,182,115,1755,29
52257,118,1131,612,996,35192,135
37990,4576,83637,869,63390,242219,20247
65967,48,1127,190,779,12280,348
27565,79,3357,1088,2078,42507,1279
49352,52,927,690,547,18215,380
34946,16,420,948,272,8107,148
16264,73,2610,1300,1790,75665,820
38141,301,6840,866,5340,51051,1500
18393,245,10534,1262,6866,100522,3668
23758,3,78,1171,62,9333,16
64301,22,223,235,201,8576,22
53917,972,9397,561,7766,46640,1631
13163,211,9419,1344,6324,60301,3095
65634,31,320,199,252,6465,68
30794,74,920,1024,602,11224,318
6119,190,9509,1408,5998,85020,3511
64902,1,31,217,8,3278,23
12133,6,281,1358,111,11985,170
36955,3,37,899,33,2512,4
19161,449,8746,1249,6667,104801,2079
47383,79,2836,734,1996,37424,840
30881,17,932,1023,604,10433,328
1710,250,5868,1456,3646,56380,2222
1068,13,866,1461,500,13856,366
23141,48,1158,1182,811,26145,347
29381,2452,57847,1053,38016,247720,19831
20363,22,680,1228,458,13099,222
52515,52,603,603,508,11307,95
34064,204,4287,968,3237,30206,1050
51432,32,836,637,696,12745,140
58669,1144,18798,415,14837,92453,3961
19608,226,8756,1241,6718,101018,2038
59406,684,8007,392,6243,48097,1764
22720,3,214,1189,158,5911,56
9793,110,5744,1376,3699,74573,2045
23313,28,634,1180,445,12807,189
9522,15,459,1377,277,12878,182
59799,130,1307,378,1036,12510,271
51824,24,393,571,334,15836,59
19590,29,547,1241,351,6910,196
31563,42,1321,1013,856,7874,465
37556,1888,47352,881,35206,96907,12146
15054,684,11552,1318,8588,62512,2964
19442,14,678,1244,544,20711,134
60920,7,123,337,51,6342,72
49839,84,960,679,840,49068,120
24988,19,439,1144,373,18549,66
3248,5,131,1443,96,26909,35
5828,962,57336,1412,35362,315941,21974
54870,28,175,526,139,7137,36
38895,2,74,846,64,21532,10
2858,602,23542,1447,15494,151893,8048
627,2120,75654,1464,44531,214300,31123
66211,13,169,182,143,10058,26
19730,6840,194298,1239,142058,413879,52240
65441,74,657,203,518,5727,139
24727,142,8485,1150,5911,43373,2574
14898,192,4466,1320,2998,22979,1468
455,17,1226,1466,875,21773,351
21429,67,1665,1209,871,26084,794
5591,12,1166,1415,628,42126,538
29051,0,37,1059,35,5553,2
68788,84,1612,99,1263,15882,349
29890,8,703,1043,421,11872,282
39196,397,5304,845,3952,39962,1352
14237,52,2401,1329,1583,18270,818
2873,615,18792,1446,12561,72688,6231
8159,6,247,1383,145,4335,102
10973,7,639,1368,381,20000,258
48764,81,1440,709,1173,19660,267
25913,5,275,1125,132,5628,143
48477,27,312,719,216,11144,96
24338,35,801,1159,507,7457,294
13198,43,1810,1344,1057,16260,753
30519,22,744,1030,451,16322,293
27375,221,2977,1093,2035,20763,942
51141,11,315,645,246,10063,69
49682,133,1409,682,1064,42142,345
58344,70,606,427,491,11523,115
48906,40,442,705,344,12361,98
36017,952,11764,923,9119,72926,2645
63817,50,699,251,593,8584,106
20676,13,561,1223,381,8708,180
14449,1872,53673,1325,34345,174624,19328
36849,15361,316719,899,229987,1034947,86732
17847,133,2267,1272,1516,22949,751
28806,82,1497,1064,1177,31193,320
2289,19,625,1452,440,9308,185
6063,413,17301,1409,12541,88638,4760
61979,310,7157,302,5386,38924,1771
5573,12,430,1415,294,10266,136
17605,9386,367196,1277,214634,1068026,152562
17604,67,1545,1277,1208,21038,337
65318,68,1107,206,902,12437,205
8492,78,1158,1382,757,7849,401
62701,2180,28562,280,20788,73123,7774
18235,9,343,1265,285,9986,58
6103,27,469,1409,392,9597,77
9690,928,30485,1376,19748,156051,10737
17484,16,322,1279,251,11692,71
20055,3,77,1233,68,4813,9
30850,84,1987,1023,1320,16614,667
12807,47,2868,1349,1783,31788,1085
25043,7,124,1143,75,4557,49
65245,44,854,208,665,11539,189
41850,6,150,805,126,7969,24
59941,7,130,373,98,5372,32
58989,0,16885,405,12324,84869,4561
65807,8,130,194,104,4552,26
20638,121,5264,1223,3752,27857,1512
18172,1774,40826,1267,28720,129074,12106
52389,45,911,608,697,13544,214
21943,1,126,1201,103,5167,23
17255,449,16426,1283,12264,125933,4162
21209,55,1512,1213,1075,16272,437
37618,40,572,879,451,17187,121
15187,11,835,1316,476,13984,359
35272,98,1407,940,1140,19329,267
49343,39,334,691,299,8310,35
43924,36,729,776,643,18841,86
35457,30,723,935,534,22555,189
38743,42,760,851,615,10330,145
18520,7,413,1260,329,11280,84
3757,8,114,1438,83,10130,31
68410,21,188,111,174,2572,14
11140,671,13721,1366,9219,61971,4502
62778,22,175,278,131,3513,44
18282,105,2284,1264,1759,32708,525
56870,12,125,469,85,3262,40
15722,70,2097,1309,1465,23440,632
56952,6,53,467,37,3641,16
12548,11,1017,1352,482,11599,535
61244,85,1062,325,788,9976,274
21740,14,505,1204,294,7143,211
4785,87,2369,1425,1530,17579,839
67374,8,86,145,69,3343,17
12017,674,23104,1359,13952,87708,9152
43549,3,166,779,134,9809,32
36904,68,1476,900,1194,11484,282
59167,12,174,400,146,7040,28
55102,61,671,519,515,10631,156
57935,197,3165,440,2190,27143,975
57424,627,8983,456,7060,63341,1923
63060,65,565,271,436,7170,129
58580,20,568,418,436,9755,132
67991,78,817,126,682,12257,135
15149,168,3154,1317,2207,51190,947
28845,39,1384,1063,915,10515,469
66900,31,450,161,363,6447,87
34499,39,3606,959,2131,15860,1475
52516,3858,86758,603,64626,447713,22132
36829,13,211,902,141,4242,70
50487,62,822,662,518,31687,304
20486,0,111,1226,64,7735,47
47272,69,660,736,514,10153,146
57959,1618,19864,439,16532,72110,3332
28724,210,4931,1065,3028,71519,1903
29384,4,213,1053,151,8058,62
5608,20,539,1415,384,8916,155
17664,1995,55682,1276,38517,454916,17165
38310,277,3547,862,2669,16388,878
16560,6,129,1295,70,2869,59
68267,164,4191,117,3739,36424,452
14648,11,564,1323,368,11831,196
49916,5,65,676,49,2885,16
6573,54,792,1403,512,7353,280
29608,20909,618825,1049,381764,964897,237061
37921,37,868,872,662,11610,206
9165,46,1202,1379,834,12650,368
56948,5,102,467,73,6528,29
32201,349,7082,1003,4397,37753,2685
51357,48,761,639,615,12220,146
27365,730,14922,1093,11125,96155,3797
62308,5,137,291,108,4571,29
67653,3,28,137,15,2703,13
30818,85,1928,1024,1295,15506,633
13863,301,14884,1334,9017,99699,5867
28170,31022,553562,1076,286731,1037516,266831
29609,8,240,1049,145,18071,95
3601,4,100,1440,61,6662,39
28367,28,600,1072,400,19046,200
54754,25,168,530,131,4074,37
31289,98,2552,1016,1904,18887,648
32533,0,55,997,44,4171,11
37606,34,619,880,511,7145,108
17215,34,629,1284,498,24329,131
39671,603,4970,839,3834,32271,1136
44613,83,686,768,542,8555,144
68308,169,2336,116,1979,23160,357
49174,3,60,697,50,7988,10
57160,1180,16172,462,12284,91938,3888
8750,78,3174,1381,1993,21979,1181
13276,27,297,1343,170,17084,127
21023,32,1676,1216,1122,24946,554
20208,100,4190,1230,2877,22497,1313
17063,11,922,1287,674,31940,248
30332,425,5599,1034,3492,23370,2107
56151,31,278,490,203,9951,75
14991,37,701,1319,507,7566,194
3501,87,2379,1440,1595,58071,784
7053,363,16458,1397,10973,86987,5485
18621,0,0,1259,0,12917,0
10254,814,24073,1373,14864,69678,9209
7073,21,819,1396,520,18416,299
21512,1052,27208,1207,19923,142804,7285
55746,0,0,502,0,3097,0
33060,19,552,987,375,31624,177
26381,34,844,1114,511,9305,333
64315,36,349,235,285,5385,64
66607,25,378,170,321,8946,57
7191,23,2004,1394,1227,28723,777
13881,26,1060,1334,782,36695,278
65443,26,498,203,407,7698,91
3863,351178,10423322,1436,5275613,24564770,5147709
49534,32,986,687,691,21754,295
48231,31,496,724,416,8791,80
26719,3,237,1107,143,8187,94
49118,6,115,699,92,9576,23
33481,30,567,980,389,13795,178
58583,5,100,418,73,3634,27
11455,36,1507,1364,939,19903,568
52154,1,97,615,49,6102,48
59653,61,999,383,775,12004,224
18498,41,3590,1261,2703,47499,887
57003,5,91,466,69,3450,22
54554,229,4804,538,3950,36779,854
32908,40,933,990,793,19426,140
22938,74,2068,1185,1467,21213,601
22563,24,377,1192,259,9029,118
12057,36,1752,1358,957,36587,795
66506,23,333,174,254,5213,79
24337,21,649,1159,500,9933,149
12878,52,2195,1348,1271,19080,924
55411,71,1006,511,789,6455,217
2196,4,406,1452,264,27479,142
49121,50,726,698,596,10573,130
60286,6,46,361,40,6355,6
53782,8,76,566,70,7427,6
9557,115612,3010861,1377,2167278,7007584,843583
18779,109,3012,1256,2234,25910,778
41093,48,1400,817,924,26680,476
6339,20,430,1406,294,8307,136
37849,70,634,873,485,6882,149
39951,563,5991,835,4488,69586,1503
27101,70,1883,1098,1475,38077,408
7051,10,246,1397,169,6818,77
7109,3572,103282,1396,60878,639131,42404
19519,29,1466,1243,993,16396,473
24657,16,366,1151,230,5427,136
37194,0,0,891,0,1694,0
47815,71,1661,729,1137,45496,524
11895,41,1656,1360,803,24726,853
54923,22,185,524,156,3294,29
20525,439,8350,1225,5745,80566,2605
57165,16,172,462,132,5604,40
7140,1,80,1395,50,17148,30
56793,417,4393,472,3671,34525,722
906,4,230,1462,167,11690,63
36913,6881,115513,868,85604,439928,29909
19847,9,746,1237,516,15931,230
47339,14,287,735,228,8877,59
10679,0,81,1370,53,2797,28
26865,30,459,1103,309,10372,150
23674,478,21214,1173,14003,97769,7211
53826,110,2683,557,1762,10709,921
11007,373,12546,1367,7920,85582,4626
29779,119,2752,1045,1630,36207,1122
63368,7,158,263,132,6211,26
36841,14,179,902,164,4609,15
292,72,2971,1467,2091,29212,880
832,67,7387,1463,4188,54246,3199
61856,49,493,306,361,5717,132
36749,89,1433,904,1191,17957,242
55496,181,3352,509,2841,16592,511
3958,31,1120,1435,881,30609,239
24696,12,422,1151,275,14599,147
35825,5,127,927,98,4055,29
30155,17,313,1037,200,6132,113
62266,35,592,292,494,11692,98
65100,5,255,211,107,3759,148
25698,823,27865,1129,15739,124661,12126
1597,123,6846,1457,4680,79968,2166
21009,260,8986,1216,6074,100478,2912
34316,119,2555,963,1527,17976,1028
1148,1417,39605,1460,26159,302940,13446
6867,8,404,1399,282,7973,122
63366,8,139,263,99,8117,40
26849,90,2939,1104,2055,37122,884
25636,714,23139,1131,14132,200276,9007
41036,177,1497,818,1177,30196,320
2813,140,5019,1447,3037,26836,1982
65568,21,106,200,88,2624,18
15317,2411,50594,1315,36455,208875,14139
3785,97,3183,1437,2258,23483,925
1763,159,5579,1456,3910,45698,1669
16167,380,6622,1301,4662,69699,1960
30053,95,2682,1039,1897,21180,785
45684,2,102,756,78,6815,24
29465,22,546,1051,317,15237,229
1466,127,3317,1458,2361,20948,956
3020,14,1383,1445,973,50460,410
46030,31,527,752,413,18332,114
17269,12,304,1283,249,24754,55
41830,241,4984,805,3861,36058,1123
20756,773,29245,1221,21159,152241,8086
51015,1083,20053,649,16028,70065,4025
21662,1033,29702,1205,18837,243614,10865
61231,1781,31733,325,25032,169533,6701
21297,73,4346,1211,1524,34950,2822
62971,177,3234,273,2386,36133,848
30368,1887,33157,1033,24503,177185,8654
10855,354,14186,1369,8961,76779,5225
15853,24,850,1306,610,26770,240
17546,6,191,1278,143,17544,48
37825,41,1914,874,1391,22595,523
21554,8,155,1207,139,7788,16
22065,4406,74060,1200,46096,289408,27964
66749,6,219,166,122,2655,97
14292,267,8259,1328,5744,46853,2515
39425,31,610,842,482,12969,128
8343,194,6830,1383,4251,43269,2579
12803,836,23265,1349,13584,177814,9681
10159,223,7736,1374,5414,66635,2322
28500,24,1135,1069,745,11406,390
52140,126,2622,616,2229,16243,393
63078,33,929,270,681,6442,248
2222,83,3044,1452,2115,20325,929
2692,17206,582408,1448,388623,1308097,193785
24074,137,3889,1165,2861,39856,1028
67470,37,479,142,382,4558,97
59669,6,124,383,97,7860,27
4248,7,339,1432,248,20586,91
63710,27,201,254,181,8511,20
61984,2,40,302,34,2041,6
14085,758,15838,1331,10018,122771,5820
37497,34,875,883,750,39241,125
620,6,356,1464,218,46595,138
26667,49,1090,1107,651,10973,439
61040,147,1613,333,1241,18196,372
37786,6,168,875,120,2305,48
64037,11,124,244,105,3632,19
10118,1173,46927,1374,28252,162634,18675
3163,8,187,1444,94,5501,93
15494,8819,247309,1312,148788,1029920,98521
7543,3,114,1390,83,7479,31
25122,78,1659,1142,1079,30013,580
30962,110,3370,1017,2395,42730,975
56669,12,240,475,219,12684,21
16188,520,14198,1301,9470,74562,4728
34852,12,224,950,147,7913,77
38001,88,1299,869,889,20563,410
171,387,9126,1469,5412,265106,3714
35360,30,814,938,694,35064,120
67303,181,3074,147,2526,23863,548
59239,38,637,398,510,8881,127
28854,8,356,1063,161,11936,195
33253,1008,14827,984,10278,53088,4549
24863,115,4141,1147,3001,31611,1140
47356,390,6507,735,5165,53605,1342
59734,460,5232,380,4392,30282,840
24096,32,1324,1164,879,18687,445
37198,0,57,891,43,4217,14
15202,51,1186,1316,855,13074,331
45295,129,2253,760,1929,24323,324
12292,40,1227,1356,677,26899,550
24499,39,968,1155,773,23931,195
29010,29,877,1060,559,32208,318
43401,139,3004,781,2534,62048,470
56857,3,19,466,14,4297,5
3059,7,185,1445,109,5479,76
7809,37,1398,1386,905,40540,493
14398,460,18619,1326,12865,195484,5754
9741,17,900,1376,493,11774,407
52823,149,1927,592,1621,19022,306
31241,1,61,1017,43,3023,18
29344,1,56,1053,36,3471,20
67294,35,390,147,324,2582,66
1365,7,378,1459,284,20500,94
47621,1935,21922,731,17795,97366,4127
29489,28,374,1051,316,8250,58
27682,18,707,1085,446,8538,261
65294,21,278,207,200,6388,78
39511,307,5863,841,4290,88489,1573
66401,0,39,177,25,1941,14
24340,2124,53395,1159,33179,260278,20216
62290,4,110,291,95,2158,15
64689,35,478,224,337,19325,141
63236,6,87,267,67,6838,20
29578,123,2999,1049,1899,35534,1100
52025,21,199,620,148,2724,51
10101,56,915,1374,609,19229,306
66144,34,508,184,427,27306,81
51612,1961,30807,625,24248,238059,6559
29200,9,467,1056,294,7553,173
35208,6,141,941,96,6487,45
51936,398,5705,623,4404,30258,1301
68739,63,1078,100,885,11849,193
3106,62,2339,1444,1713,17053,626
38060,109,2057,868,1603,28108,454
10065,9,244,1374,138,5970,106
16339,105,2252,1299,1604,26059,648
18977,183,4398,1252,3226,42394,1172
23222,485,11091,1181,7032,40344,4059
57573,11,157,452,118,3973,39
61192,23,287,327,212,4837,75
17739,16,357,1274,273,12675,84
33808,669,10216,974,7155,36927,3061
3711,13,433,1438,273,15010,160
686,1728,48459,1464,33033,153744,15426
21392,3054,80087,1209,58705,376080,21382
63217,10,213,267,168,4912,45
54827,50,443,528,318,9600,125
28423,6,453,1071,255,14228,198
29830,70,2712,1044,1730,20262,982
7203,85,2135,1394,1551,48299,584
18625,46,4564,1258,3220,51337,1344
41225,19,394,815,351,6881,43
17049,0,146,1287,114,6244,32
26312,2043,56889,1116,34184,418514,22705
5610,154,4240,1415,2417,15804,1823
37312,18,458,888,349,9187,109
4932,127,3907,1423,2445,76550,1462
25620,61,1993,1131,1203,21046,790
14429,277,4253,1326,2914,57348,1339
22708,19,336,1190,244,3366,92
23748,413,6440,1172,4514,62872,1926
67904,29,479,129,394,10671,85
9151,33,1828,1379,1167,20806,661
61248,67,849,325,658,10246,191
18834,4,135,1255,96,8628,39
18886,2,86,1254,72,7834,14
20209,211,3991,1230,2812,84832,1179
49220,92,1528,695,1263,18816,265
34616,45,1203,956,689,18485,514
8587,78,2564,1382,1543,19925,1021
30869,143,4830,1023,3481,43329,1349
13214,125,5123,1344,3197,90681,1926
59205,7,148,399,119,23295,29
4236,248,4832,1433,3030,47499,1802
28210,20,468,1075,285,21704,183
32656,583,10317,995,7666,88268,2651
58326,10,180,427,141,4853,39
35175,66,979,942,638,12987,341
4021,29,928,1435,723,16465,205
40822,83,1243,822,956,10969,287
15223,1136,39683,1316,29570,186278,10113
65141,518,6718,209,5876,47025,842
1848,10,801,1455,478,9852,323
35370,19,573,938,437,6450,136
67140,4,53,153,48,2758,5
1197,1392,72937,1460,44952,195630,27985
54807,28,470,528,327,11064,143
22099,41,1884,1199,1252,30768,632
29509,4,262,1050,173,5881,89
9304,97,2809,1379,1943,43643,866
66422,89,949,176,778,8969,171
30061,47,1469,1039,974,19862,495
25967,41,2795,1123,1439,24661,1356
26434,19,772,1113,501,15726,271
8583,9188,658233,1382,365972,1928476,292261
24445,12785,246116,1157,144019,1249261,102097
10109,70,6740,1374,4200,43851,2540
7464,72,3227,1391,2342,63017,885
23247,190,9080,1181,6146,55604,2934
63674,99,1145,255,926,16559,219
21993,45,1141,1201,624,9124,517
27880,15,770,1081,494,7145,276
56083,1386,16173,492,13240,64943,2933
59430,1,59,391,43,2022,16
38217,502,7413,864,6107,84654,1306
9798,669,15911,1376,11343,38637,4568
13232,119,3250,1343,2029,29645,1221
22513,24,1192,1193,807,19803,385
68069,10,128,123,88,3704,40
937,3046,117287,1462,72857,249690,44430
31336,19,734,1015,405,27364,329
11499,28,1272,1364,773,34145,499
60902,5,71,337,57,3759,14
6873,162,5132,1399,3255,47587,1877
49033,141,3860,701,2960,17892,900
32048,23,1155,1005,812,13626,343
54553,262,6157,538,4064,34404,2093
53707,222,3210,567,2625,26126,585
11968,23,1032,1359,496,12084,536
36713,57,1789,904,1493,39561,296
38485,15,372,856,295,10345,77
64383,66,1120,233,908,27186,212
4663,166,3732,1426,2562,30281,1170
14825,95,3032,1321,2016,28187,1016
22159,16,412,1198,284,16161,128
33297,75,863,983,552,8564,311
27043,81249,3705799,1099,2293531,5605184,1412268
64820,3109,49160,219,35254,146372,13906
22058,20,513,1200,355,8681,158
49993,17,489,675,389,7875,100
34547,7,191,958,139,3478,52
11342,44,2161,1365,1232,15019,929
54496,7,132,540,99,5954,33
59599,46,778,385,605,18917,173
16505,2,255,1296,186,11170,69
34105,259,6848,967,4957,40121,1891
57551,90,901,448,734,11773,167
8469,73,1762,1382,1124,15769,638
36215,128,2602,917,1998,38507,604
35061,1,35,944,28,3533,7
31633,203,5956,1011,4055,41068,1901
35718,2930,38281,930,28446,105520,9835
40638,36,347,824,263,4796,84
14640,10,308,1323,208,11389,100
11001,16,729,1367,428,10491,301
2969,14,448,1445,325,11871,123
49482,645,8372,687,7191,80190,1181
16898,6,452,1289,311,9302,141
1380,66,1657,1459,1208,20846,449
19801,43,1570,1238,1102,11200,468
58452,1181,16872,423,13570,50435,3302
23000,26,1052,1185,707,40016,345
13900,4,558,1334,318,6621,240
66404,233,3643,177,3063,21841,580
36707,121,2357,904,1847,22446,510
58965,20,351,406,239,6640,112
28865,4,197,1063,125,12386,72
19135,92,3170,1249,2162,28594,1008
39983,10414,224834,835,163290,948278,61544
64563,14,102,228,86,1720,16
13080,0,0,1345,0,7687,0
27963,0,0,1079,0,5845,0
12175,1743,64027,1357,37554,182541,26473
60278,0,81,361,62,3048,19
10643,54,1793,1370,1172,23739,621
30695,125,2699,1026,1798,30684,901
21720,21102,359728,1204,255665,805076,104063
53875,70,1038,535,939,10012,99
27638,103,3579,1086,1984,20274,1595
60152,7,69,366,58,4727,11
55121,457,5701,519,4769,32282,932
62860,18,277,276,199,7065,78
68628,59,831,104,698,9487,133
10988,66,2272,1368,1428,63545,844
57795,890,9103,445,6851,36648,2252
39788,63,826,838,678,7214,148
5297,82,1790,1418,1307,17732,483
66922,41,404,160,325,7722,79
4999,8,212,1422,157,9616,55
25399,67,1849,1136,1216,27329,633
31654,40,768,1011,559,6132,209
31741,1531,19616,1009,11988,95007,7628
17574,481,7235,1277,5658,48851,1577
7884,46,977,1385,639,23049,338
4216,48,1090,1433,776,23151,314
49944,34,569,676,319,9387,250
28062,173,2015,1078,1475,19304,540
30937,103,2064,1022,1305,22878,759
67703,23,152,135,139,2456,13
29836,201,3944,1044,2394,33034,1550
7214,74,1703,1394,1176,36235,527
13817,4,169,1335,110,8045,59
56001,5,51,495,39,4533,12
14089,9,761,1331,534,21105,227
36040,1,128,922,98,1943,30
33240,34,653,984,459,16592,194
3257,21,491,1443,351,35170,140
38361,4817,72121,860,52555,161401,19566
12299,100,3045,1356,1728,29741,1317
51600,32,451,632,370,7455,81
18321,155,3865,1264,3040,47714,825
13252,114,5661,1343,2917,24376,2744
17337,10,125,1282,99,5408,26
9953,232,17210,1375,11617,132325,5593
34892,30,968,949,672,24059,296
32658,46,1969,995,1301,24076,668
8812,77,3866,1380,2483,54467,1383
2578,20,1470,1449,931,27710,539
6003,25,422,1410,300,12277,122
53630,0,69,570,61,4419,8
29964,105,2402,1041,1675,16624,727
18,2135,155359,1472,90386,648551,64973
60002,189,6688,371,3952,47847,2736
35328,63,1185,938,888,16508,297
68897,33,422,95,359,11862,63
53387,32,627,576,493,6346,134
10370,1596,63547,1372,34627,237019,28920
21836,135,3637,1203,2388,30433,1249
21745,264,3364,1204,2303,35229,1061
5627,13,589,1414,395,37423,194
29791,12789,361362,1045,251085,997831,110277
52200,103,1065,613,797,17494,268
33202,126,3824,985,2831,50067,993
55066,26,242,520,176,4883,66
58627,176,1186,417,890,8430,296
67095,19,314,155,244,2077,70
2328,7,186,1451,138,19321,48
2324,141,5255,1451,3902,23687,1353
3201,5061,152480,1443,86654,520758,65826
27377,2037,38025,1093,24371,125375,13654
59552,460,5038,387,3785,41112,1253
14606,2,138,1324,88,2777,50
55879,71,980,498,810,13684,170
48785,4110,59073,709,43118,217946,15955
37441,21,427,884,347,5738,80
13588,51,749,1338,474,16678,275
14258,131,3079,1328,2321,43702,758
33998,109,1924,970,1038,10384,886
10499,133,2494,1371,1799,41152,695
36330,6,81,913,67,4747,14
5940,950,33835,1411,22138,317911,11697
35889,38,607,925,472,21212,135
22651,157,1801,1191,1148,21785,653
18960,56,603,1253,464,18977,139
11621,942,24220,1362,15444,160921,8776
8827,10,489,1380,346,13171,143
69028,3,68,90,56,2837,12
33277,33,1085,983,717,18571,368
5839,15,504,1412,378,11482,126
24599,16,265,1153,187,9436,78
33536,2,118,979,71,6544,47
18072,203,7872,1268,5802,78765,2070
27445,132,5864,1091,4542,67217,1322
43238,20,439,782,318,15719,121
13056,455,14896,1345,9456,73601,5440
49185,5,61,696,52,2333,9
57236,1280,30742,460,24617,89880,6125
57221,350,4154,461,3209,23799,945
68497,234,6881,109,5990,34526,891
32063,59,2033,1005,1386,25933,647
68687,2,59,102,47,2528,12
454,283,25590,1466,16281,171399,9309
58695,2268,36374,415,29234,122097,7140
68843,65,1152,97,935,13196,217
13768,51,1401,1336,935,11323,466
84,79,3040,1470,2105,26219,935
40858,23,571,821,420,18599,151
51758,15,198,628,134,4493,64
14712,2,119,1322,84,15264,35
2753,110,4647,1448,2896,29603,1751
4625,15,406,1427,283,15488,123
16170,78,2819,1301,1919,43480,900
16708,74,4435,1293,2795,26648,1640
19457,42,1330,1244,982,22075,348
724,248,15475,1464,10034,148562,5441
20436,854,11214,1227,7827,94111,3387
12584,25,669,1352,412,25395,257
29185,1730,35581,1056,23451,106275,12130
14020,739,28040,1332,19156,147651,8884
34056,68,1976,968,1199,16909,777
56530,381,8984,479,6857,70916,2127
50207,188,3114,669,2466,43541,648
4528,7013,210418,1428,131526,623045,78892
3670,43,725,1439,464,12574,261
49410,344,6685,690,5531,44821,1154
2803,1350,47814,1447,28779,116643,19035
6352,20,788,1406,523,26158,265
29298,255,8975,1054,6347,71406,2628
28033,23,483,1078,323,11272,160
1462,29,1400,1458,983,23892,417
13083,54,2322,1345,1490,25030,832
56244,4,67,488,43,6504,24
58718,2,46,414,35,2479,11
640,69,3798,1464,2817,68430,981
20264,9,335,1230,266,34052,69
900,0,70,1462,52,10382,18
56618,50,412,477,310,6578,102
8792,39,1798,1381,1235,45633,563
5605,27,932,1415,724,19965,208
320,8,674,1467,475,39937,199
27489,3426,96428,1090,64733,320486,31695
47268,27,231,448,207,5135,24
57105,52,1046,463,700,8342,346
67055,29,503,156,391,4828,112
15205,359,12500,1316,7785,45260,4715
38728,1032,14932,851,12368,104047,2564
41144,3,64,816,55,14952,9
17429,310,18955,1280,13401,115814,5554
1810,401,8384,1455,5131,48046,3253
51502,25,349,635,274,9943,75
51548,98,1206,634,884,17298,322
7760,194,17206,1387,10179,125240,7027
35088,1170,21752,945,15979,199054,5773
31827,3,82,1008,55,4287,27
11177,413,18352,1366,10978,44083,7374
30066,20,481,1039,291,9600,190
26097,53,4068,1120,2878,9335,1190
50735,113,1467,656,1069,10930,398
37958,452,5652,870,4674,50807,978
59256,57,590,397,485,10115,105
61129,37,417,329,322,12066,95
5448,29,993,1416,724,31232,269
17668,261,9230,1275,6342,54801,2888
15065,12,798,1318,555,31203,243
51182,28,395,644,252,7134,143
34040,112,2199,969,1633,53477,566
2199,17,380,1452,284,58169,96
38685,9,156,852,113,5661,43
61388,6,127,211,85,3808,42
66386,65,999,177,762,16130,237
63743,158,2260,253,1919,16661,341
39871,20,416,837,330,12276,86
44121,1,36,773,21,2654,15
49076,62,669,700,535,8164,134
34735,2,182,953,108,7713,74
49553,23,398,686,329,9745,69
27266,176,5597,1095,3743,53547,1854
26599,259,3937,1109,2479,37391,1458
21274,402,10979,1211,7629,56783,3350
20970,20,322,1217,208,7305,114
57372,173,2891,457,2214,42600,677
56134,96,1506,491,1129,12877,377
19702,33,2186,1239,1511,19827,675
1946,881,37744,1454,22259,152533,15485
36738,3333,90528,904,70419,434039,20109
33163,77,777,986,716,7123,61
28037,16,391,1078,259,22944,132
55333,8,65,513,57,5665,8
11901,19,1141,1360,489,13436,652
61765,31,403,309,314,4301,89
44592,1725,23528,755,19383,190706,4145
26306,41,1034,1116,611,9813,423
20397,34,1252,1227,836,19246,416
68116,14,221,122,173,6456,48
40737,138,1567,823,1205,12471,362
67628,6,49,136,32,2058,17
57231,82,1088,460,863,10949,225
45671,43,643,756,446,10281,197
19795,15,941,1238,653,20402,288
39681,8,145,839,118,5370,27
10239,145,4903,1373,3242,51504,1661
23842,60,2786,1170,1689,26787,1097
53745,1299,17378,565,13399,125191,3979
5227,5,279,1419,208,6767,71
12192,150,5834,1357,3192,33658,2642
1009,6141,210637,1461,123011,559937,87626
7693,110,5765,1388,3746,93297,2019
37502,1,172,883,127,6198,45
47904,9,184,728,142,11459,42
59441,1,100,391,59,5239,41
40467,13,365,827,304,7029,61
36845,161,3425,902,2997,58122,428
31460,44,837,986,551,11669,286
26674,25,597,1107,418,11916,179
14804,37,1837,1321,1231,16494,606
17603,24,882,1277,660,28227,222
25355,7,270,1137,172,7583,98
17651,238,6652,1276,4750,63391,1902
20738,53,2804,1222,1754,24268,1050
47672,80,1165,731,942,17414,223
27812,266,6403,1083,4381,65829,2022
35311,1236,25896,939,19326,96084,6570
40899,2817,71881,820,44688,335499,27193
60926,51,468,337,400,8066,68
4169,1,196,1433,109,12965,87
20143,327,10800,1231,7196,85782,3604
10772,80,2390,1369,1534,27618,856
20360,104,2896,1228,1962,40695,934
30652,17,513,1027,349,15878,164
27908,226,6320,1080,4350,75757,1970
25618,184,6957,1131,4597,70901,2360
51221,23,343,643,240,3418,103
33042,61,1118,987,758,7084,360
1509,76,2643,1458,1872,12766,771
21595,176,5069,1206,3309,29689,1760
29765,3,261,1045,166,9314,95
32595,210,3172,996,2174,14666,998
58866,16,152,410,117,4918,35
57018,511,10386,466,8078,32509,2308
13152,8,368,1344,210,12437,158
67540,36,339,140,268,3866,71
26825,44,1808,1104,1141,32311,667
15105,21002,1353992,1318,745034,3942251,608958
34493,693,12780,960,10647,152917,2133
68580,4,153,106,107,10307,46
52575,288,2995,601,2435,22366,560
49821,0,1639,679,1036,7646,603
27153,881,14114,1097,10403,64349,3711
29346,4,112,1053,76,11468,36
29644,43,1871,1048,1111,15944,760
11711,123,4822,1362,3109,39691,1713
42660,9,385,792,259,9098,126
62187,27,145,294,124,4794,21
39975,461,8185,835,6848,68991,1337
5733,1793,64177,1413,41946,296978,22231
22630,14,663,1191,458,12676,205
23905,8,221,1169,163,7685,58
56974,33,324,466,289,5970,35
52891,37,426,590,364,6706,62
23350,421,6788,1179,4736,52132,2052
31094,57,1055,1019,763,15824,292
62538,10,109,284,86,3623,23
53217,33,360,580,264,11700,96
56897,36,458,469,360,18333,98
27918,27,899,1080,601,14668,298
12357,175,5226,1355,2972,22263,2254
41653,29,720,808,521,9033,199
61160,71,1471,328,1122,11774,349
63581,391,5255,258,4256,53849,999
30633,107,1685,1028,1003,17383,682
22691,3506,99254,1190,67073,405032,32181
53115,41,703,583,538,10999,165
51589,51,598,632,508,10731,90
30533,10845,201532,1029,151694,641576,49838
13865,58,1232,1334,856,13551,376
18250,4640,144286,1265,90507,374707,53779
7791,97,1565,1387,967,13562,598
23440,61,700,1177,437,7537,263
27517,2,118,1089,67,3412,51
25765,71,1202,1128,782,11043,420
58032,24,183,437,155,4919,28
65913,40,352,192,290,6335,62
6290,391,14882,1407,10298,102611,4584
17942,11,408,1270,315,14992,93
19131,51,1523,1249,1204,21893,319
10164,35,1256,1374,814,15551,442
13906,0,0,1334,0,17823,0
31141,64,1515,1019,1312,28976,203
23136,37,1281,1182,897,11781,384
493,534,20686,1466,13903,170864,6783
29520,8,611,1050,360,19349,251
22879,107,2000,1187,1454,19038,546
24320,159,2517,1160,1631,19551,886
14235,9,328,1329,222,21388,106
62130,46,1751,296,1289,11891,462
50043,996,12103,673,9618,45878,2485
33720,80,1491,975,950,15490,541
21158,62,1561,1213,1106,20222,455
52921,2,44,589,38,10688,6
41171,104,1095,814,890,15127,205
56473,45,669,481,545,10402,124
11953,109,4804,1359,2793,40835,2011
38466,167,1616,857,1292,41114,324
39184,43,1520,845,1128,27693,392
15849,1924,53514,1307,36728,296752,16786
4930,14,556,1423,386,15809,170
14956,78,678,1320,457,7241,221
3360,38,1108,1442,797,23990,311
34108,2560,58380,967,37076,107527,21304
68912,179,4196,94,3618,22525,578
35694,23,681,931,479,7784,202
23801,92,2540,1170,1741,35405,799
9756,8,504,1376,338,6081,166
46516,7,364,746,277,8554,87
15155,678,18504,1317,12724,194043,5780
62896,2,35,275,26,2269,9
5216,9,168,1419,132,12694,36
60376,194,6423,358,3055,27712,3368
21486,33,419,1208,291,6709,128
30364,32,689,1033,425,4315,264
27010,97,4435,1100,3788,38799,647
68289,53,840,116,689,13447,151
4240,1214,24159,1432,16168,110397,7991
33460,24,1124,980,766,12756,358
53816,109,1231,564,1066,18899,165
17703,500,14156,1275,9404,98187,4752
15517,202,9742,1311,6243,66280,3499
5694,2,323,1414,200,21194,123
25514,243,4796,1134,3154,28933,1642
20859,22,499,1219,341,12396,158
1604,33,1576,1457,1095,29623,481
21692,2,202,1204,135,10899,67
54462,61,819,541,660,9760,159
19225,23,668,1248,476,25960,192
50940,23,352,651,289,12666,63
37873,18659,345336,873,250899,800780,94437
52680,71,1317,597,1074,11671,243
11071,154,4379,1367,2604,28405,1775
34250,88,1964,965,1352,16188,612
33241,214,3527,984,2392,19187,1135
45001,49,592,762,469,18954,123
24381,58,1566,1158,1057,45018,509
509,88,2024,1465,1389,15601,635
23506,409,8242,1176,5566,53210,2676
58682,10,72,415,45,18393,27
35961,5,63,924,59,4067,4
18649,161,2792,1258,1821,28532,971
14395,29,793,1326,532,25710,261
5969,16,582,1410,413,14502,169
66440,98,1536,166,1326,18752,210
9959,1401,55794,1375,32944,283428,22850
140,2296,150554,1470,101094,561820,49460
47036,694,8234,739,6586,45167,1648
10133,7,216,1374,132,20506,84
39591,271,7257,840,5823,53202,1434
20862,238,6733,1219,5007,45708,1726
37196,146,4231,891,3370,41428,861
47763,0,32,730,23,2640,9
21679,73,1369,1205,862,43078,507
55665,20,418,504,336,6762,82
40216,5400,81355,831,64372,446540,16983
3972,34,1299,1435,924,33517,375
51499,57,599,635,515,10447,84
31068,19,967,1019,643,9015,324
62106,57,862,297,657,22033,205
65289,13,221,207,175,6892,46
9428,23,2509,1378,1506,19970,1003
34281,53,1561,964,1076,10199,485
57312,30,237,458,176,5439,61
28089,18,322,1077,240,8294,82
48986,93,875,703,659,12414,216
31472,188,2429,1014,1633,15035,796
63716,23,222,254,171,4720,51
14918,13,985,1320,667,22340,318
30493,679,13021,1030,8019,92021,5002
20989,120,2814,1217,1912,24727,902
52735,63,1059,595,667,18049,392
56699,442,7169,474,5946,67243,1223
17494,176,5600,1279,3784,44080,1816
33589,118,2355,977,1625,87739,730
2091,15,675,1453,445,22318,230
14870,31,1088,1321,787,15976,301
20620,262,3956,1224,2626,17862,1330
15481,22,552,1312,376,7497,176
6699,6,165,1401,117,5257,48
68085,14,274,123,185,5562,89
33032,2,61,988,46,7173,15
21580,401,9858,1206,6549,76518,3309
23850,86,2260,1170,1380,10279,880
35605,101,2561,932,1989,37841,572
112,34,2003,1470,1323,36864,680
34049,25,569,968,417,9981,152
30511,6,378,1030,214,8565,164
48157,23,506,725,422,16039,84
37011,15,467,897,350,9806,117
67105,13,175,154,133,2606,42
29469,1174,29396,1051,17956,269065,11440
63419,18,318,262,275,2881,43
4968,21,2447,1422,1702,27969,745
47723,58,666,730,569,11891,97
18193,12,573,1266,413,17357,160
4933,10,311,1423,228,13586,83
34723,647,7161,953,5300,51076,1861
24308,2,175,1160,117,7069,58
31116,596,9424,1019,6238,65005,3186
33526,59553,1468675,979,771839,2679141,696836
7504,158,4171,1391,2887,36102,1284
26292,1,36,1117,30,6084,6
14106,19,1352,1330,893,66101,459
26885,23,343,1103,241,9541,102
29044,16,1083,1059,547,19800,536
53975,2048,34044,559,25155,160861,8889
47712,2180,29062,730,23351,161079,5711
9532,43,1031,1377,660,11723,371
17744,9,415,1274,336,13289,79
12355,9,337,1355,195,16402,142
17833,18,646,1272,477,12974,169
63887,3,62,248,52,4962,10
23416,3764,118406,1177,68196,376511,50210
53026,4,127,586,51,3652,76
34565,52,990,958,677,12365,313
10972,13,312,1368,200,14902,112
17519,1729,78303,1278,56933,365563,21370
6297,22,355,1407,253,7152,102
8782,117,3207,1381,2057,27872,1150
42286,670,9847,799,8096,55937,1751
38324,15,386,861,339,27022,47
12828,184,3245,1349,2137,28786,1108
41494,7,281,811,201,13733,80
43020,37,619,786,486,14015,133
46548,50,585,745,496,12934,89
18215,110,5327,1266,4175,60080,1152
8696,72,1238,1381,805,12048,433
11144,7,427,1366,275,6215,152
36457,730,11579,910,8418,29048,3161
259,876,33175,1468,18206,125635,14969
29543,24,793,1050,506,9320,287
36842,9,273,902,229,19298,44
52412,55,657,607,555,31780,102
13851,54,1640,1334,975,30273,665
23727,88,2253,1172,1643,23651,610
32561,666,14935,997,10893,47958,4042
53705,4960,70861,567,57208,338748,13653
38997,21,528,847,434,30071,94
26057,8,167,1121,141,11218,26
51005,22,208,649,185,12592,23
9148,36,1476,1379,922,25804,554
50961,27,437,650,337,7783,100
52560,13,202,602,165,10579,37
63863,34,514,250,416,11576,98
16057,25,894,1303,664,31146,230
66146,286,3137,184,2311,13229,826
57736,3,39,447,33,1575,6
20369,506,13422,1228,9459,99891,3963
31381,17,466,1015,315,3945,151
36126,31,351,920,280,8629,71
67106,31,508,154,392,11136,116
21770,577,12079,1204,8760,63827,3319
51077,4304,46213,645,38994,196376,7219
22460,4,345,1194,256,14302,89
34059,36,786,968,449,8666,337
22927,634,18731,1186,14541,173893,4190
61322,3,106,323,78,3463,28
29552,49,989,1050,598,13377,391
10281,2086,43319,1373,28968,177405,14351
30150,20,648,1037,441,7828,207
36516,56,1083,907,939,17043,144
20721,2453,73819,1222,52798,491990,21021
13347,45,753,1342,457,7954,296
30754,262,4722,1025,3530,51717,1192
50835,667,12062,654,9405,150860,2657
56474,373,5344,481,4281,28747,1063
34886,1078,14533,949,11708,91453,2825
57166,28,340,462,255,6568,85
59101,45,414,402,327,10812,87
68606,133,1688,105,1503,12547,185
50308,29,475,667,388,5185,87
63836,21,416,250,275,12107,141
9062,87,4285,1379,2621,23323,1664
68043,111,1481,124,1153,11863,328
67708,76,687,135,534,7323,153
44016,16,310,774,222,8947,88
8902,24,1222,1380,792,11694,430
68456,83,1309,110,1037,22600,272
19618,3769,118133,1241,74677,317206,43456
13028,37,721,1346,603,18282,118
11378,95,3061,1365,1943,34655,1118
19614,199,1804,1241,1123,20835,681
24224,908,11420,1162,7195,68245,4225
40918,95,2659,820,2102,27691,557
8651,1189,36009,1381,22712,196095,13297
56516,24,241,479,187,5169,54
30725,9,125,1026,88,5967,37
6609,60,2093,1402,1526,30510,567
54032,37,707,557,540,9489,167
60677,12,97,346,75,5608,22
52198,4,47,614,42,5315,5
63354,2540,39734,260,30622,353830,9112
20485,15,386,1226,289,11171,97
63883,0,24,249,14,2055,10
29759,40,495,1046,414,12016,81
42965,46,467,787,350,8308,117
6449,119,3370,1404,2476,92257,894
26645,5,256,1108,164,8283,92
3164,16,1016,1444,713,32428,303
13363,743,23091,1341,13160,181442,9931
18970,535,13704,1252,9584,78001,4120
12481,513,20154,1353,13301,83310,6853
25868,374,8607,1126,4969,53169,3638
55489,223,2909,508,2111,19455,798
69007,1735,41579,91,34759,172398,6820
16576,184,17433,1295,9213,41669,8220
38651,391,5704,852,4386,41704,1318
56091,43,614,492,415,7209,199
30821,128,3722,1024,2394,26520,1328
57004,9,168,466,128,7318,40
51335,172,2537,640,2029,19152,508
22579,32,799,1192,557,23068,242
821,7,452,1463,340,11061,112
18356,7,144,1263,123,14144,21
36229,1,38,917,25,3934,13
18403,5,373,1262,255,13608,118
61209,138,1325,326,955,9659,370
26425,2,99,1114,61,4660,38
49904,0,5,677,5,2019,0
42398,5383,166648,797,127468,805097,39180
59921,24,447,374,355,13350,92
63803,53,831,252,692,6573,139
4372,4,640,1431,454,6527,186
60093,9,246,368,177,8828,69
27618,77,2077,1086,1343,17061,734
33245,87,2643,984,1729,29502,914
64767,4,145,222,105,2651,40
2290,41,2110,1452,1384,48616,726
8821,4,280,1380,180,9031,100
61837,349,5141,307,3953,20415,1188
24253,4446,152475,1161,101274,592982,51201
606,29,1109,1464,815,36966,294
59878,340,5538,375,3258,51215,2280
60466,127,2160,354,1501,18865,659
29455,5,225,1051,140,7634,85
36819,8,247,902,185,8274,62
33863,27,691,972,399,14211,292
43055,1265,23474,785,17362,69314,6112
19945,2,91,1235,73,11487,18
26900,225,7092,1103,4561,31319,2531
7420,6,256,1392,174,13616,82
3444,13,289,1441,236,11328,53
22947,25,891,1185,676,15638,215
27832,92,1621,1082,1115,28146,506
22812,177,4319,1188,2736,81925,1583
27738,37,531,1084,338,12775,193
3697,11,264,1438,185,11251,79
31206,282,6828,1017,5195,74660,1633
5656,13,344,1414,238,16321,106
35664,186,2182,931,1705,20365,477
44467,107,1426,765,1153,49975,273
23481,36,402,1177,272,6787,130
38730,4,195,851,144,7152,51
52794,303,2609,593,2060,19884,549
50585,9,121,659,82,8696,39
44797,18,305,759,229,7565,76
57182,336,4296,461,3468,36796,828
23834,65,5579,1170,3744,48240,1835
59848,88,1188,374,1003,11703,185
650,393,6752,1464,4692,43141,2060
65543,17,213,201,180,3842,33
40615,1251,46372,824,31766,317228,14606
7616,51,1272,1389,859,24867,413
16032,7,457,1303,348,10483,109
35434,37,603,936,431,12856,172
63460,5,70,260,58,4552,12
13444,110,7031,1340,3918,29405,3113
50796,4,53,655,44,6476,9
31641,59,1152,1011,718,13984,434
56995,24,375,463,257,15314,118
39370,18,356,843,294,10844,62
7542,43,1338,1390,924,20953,414
21890,9,691,1202,442,12460,249
12924,98,5229,1348,3391,26000,1838
710,93,3445,1464,2456,29290,989
29782,12665,405782,1045,279268,962132,126514
14975,359,11698,1319,8755,81712,2943
46365,21,349,748,255,7885,94
50643,101,1446,658,1141,23354,305
17408,3,112,1281,87,3589,25
50252,209,2685,668,2058,18641,627
37435,56,1136,884,841,16315,295
55713,18,381,503,285,8193,96
66429,51,1406,176,980,15540,426
29328,227,7838,1053,5473,29551,2365
62069,9,91,299,77,4946,14
10884,8,610,1368,363,19920,247
54964,304,3967,523,2714,17783,1253
55990,29,484,495,372,4152,112
35579,3,40,933,31,4700,9
9495,8,218,1377,167,12572,51
50269,234,2993,667,2345,45541,648
5180,73,2931,1419,2009,27054,922
32399,562,10881,1000,6881,90978,4000
40943,9,297,819,220,8407,77
22585,11,392,1192,264,6005,128
38396,13,252,859,195,6261,57
68949,2,89,93,83,5141,6
64651,6408,111940,225,83677,562022,28263
43934,68,1773,775,1245,32955,528
26937,35,441,1102,388,10758,53
56395,1249,16199,478,13146,172879,3053
54847,25,226,527,156,4676,70
50227,71,942,669,749,16621,193
2810,2690,64454,1447,46583,133054,17871
8798,0,107762,1381,67777,197970,39985
32531,388,7371,997,5398,35375,1973
9717,38961,1156063,1376,765264,3747079,390799
68380,99,1653,114,1423,17830,230
142,11,732,1470,515,17539,217
2325,773,24251,1451,15329,67188,8922
37256,7738,200796,889,160042,514636,40754
25851,49,586,1126,338,10309,248
9716,728,29212,1376,18738,198092,10474
16570,11,140,1295,102,9678,38
16896,4,180,1289,134,10668,46
59370,65,1390,393,829,15621,561
21193,169,5372,1213,4566,50103,806
68355,32,719,114,547,8667,172
20301,82,1194,1229,869,12578,325
7023,65,2391,1397,1723,47423,668
63019,8,45,272,36,2848,9
48538,2039,38020,717,28142,123584,9878
51732,2,135,629,53,3762,82
6123,8,260,1408,180,12121,80
15906,3047,155247,1305,87390,400989,67857
8581,7,339,1382,226,5469,113
27068,1420,29341,1099,18823,203508,10518
29839,107,2974,1044,1754,18796,1220
22753,1320,35633,1189,25489,147651,10144
47473,0,65,734,43,2202,22
67524,614,13039,140,10690,89656,2349
21211,721,19310,1212,12233,106360,7077
30357,29,715,1033,491,9379,224
4741,183,4523,1425,2955,26532,1568
37642,192,3952,879,2825,74633,1127
39373,24,822,843,608,19603,214
8548,116,2031,1382,1337,10974,694
33001,405,13915,988,9732,82004,4183
30303,73,2482,1034,1600,21144,882
61037,53,413,333,346,6811,67
64418,18,216,232,180,7374,36
10980,124,1615,1368,1147,26937,468
38185,804,13211,864,10705,73000,2506
35793,1935,38425,928,27607,313052,10818
60361,29,395,358,326,7935,69
14417,38,717,1326,533,12561,184
31596,10,592,1012,357,10510,235
6574,142,6285,1403,3821,26842,2464
11145,45,1464,1366,850,24060,614
35513,145,4703,934,3733,59178,970
31568,780,18246,1012,12918,245443,5328
60570,290,5382,350,4254,26989,1128
8348,1651,58818,1383,34739,120964,24079
60467,1,25,354,14,3027,11
3123,15,527,1444,358,21332,169
42133,31,708,800,507,12223,201
61920,114,1203,304,887,13849,316
67781,5,168,132,71,7104,97
59815,39,510,378,383,10160,127
59603,261,4946,385,3623,19053,1323
63156,14,183,268,137,3274,46
43321,8,294,782,221,6324,73
871,45,1342,1462,903,34600,439
27589,19,865,1087,511,11014,354
61463,42,409,319,299,7742,110
2647,26,997,1449,677,10457,320
4918,622,25417,1423,15939,107797,9478
55870,1,451,499,274,2523,177
3265,1559,70142,1443,39876,227104,30266
12735,22,1230,1350,777,17950,453
22696,175,7908,1190,5446,32832,2462
66485,13,225,175,148,3841,77
9992,38,1126,1374,712,19652,414
43689,106,1759,777,1296,13986,463
65423,13,77,204,62,2717,15
53375,19,226,577,183,7434,43
21888,6,366,1202,273,8525,93
3730,126,6313,1438,4197,66436,2116
15807,40,1012,1307,767,14786,245
56595,1016,25260,477,20522,115755,4738
1480,16,531,1458,402,8644,129
25195,132,4291,1140,2778,27098,1513
60179,342,5355,364,4393,67170,962
35679,12,419,931,291,5572,128
40551,337,2935,826,1954,17945,981
67706,1,19,135,15,2963,4
19670,40,902,1240,670,23004,232
62479,3,45,286,27,4317,18
4330,243,6195,1431,4494,50292,1701
55718,1182,16825,503,14065,104686,2760
45795,8,87,754,67,7195,20
64189,113,2247,239,1737,12309,510
33603,3815,43558,977,31518,115512,12040
54425,306,6204,543,5013,47960,1191
33206,142,4721,985,3211,29230,1510
18184,13,563,1266,439,14745,124
6136,232,5599,1408,3704,67095,1895
67404,246,4745,145,4107,28059,638
1639,100,2931,1457,2037,60872,894
58276,381,10640,429,8000,44446,2640
8246,228,4736,1383,3109,29740,1627
5846,18,596,1412,462,20579,134
25554,1118,25365,1133,18535,75032,6830
42518,6,51,795,32,1330,19
5957,4,360,1411,276,9155,84
50889,28,470,651,362,9632,108
67539,28,432,140,334,4222,98
48887,10,117,706,100,5139,17
16017,648,22660,1303,16250,140721,6410
67130,0,7,154,4,2006,3
1994,3030,68938,1454,47890,333805,21048
1033,4,579,1461,375,11676,204
55478,1,28,509,26,3317,2
56737,165,2343,473,1849,25537,494
68259,78,2158,117,1439,20648,719
60371,8,185,358,160,8485,25
62828,17,172,276,146,3283,26
1482,4,275,1458,208,9099,67
8161,197,3016,1383,2018,14006,998
26231,229,6507,1118,4111,37317,2396
32097,20,517,1004,319,7641,198
60265,22,194,362,179,4547,15
38413,139,2565,859,2092,23137,473
11949,94,7240,1359,3778,49899,3462
8707,592,28920,1381,15864,118281,13056
28607,209,4915,1068,3232,14414,1683
11083,50,1297,1367,858,13486,439
22295,12,184,1197,118,12102,66
67961,4,67,127,55,2336,12
27384,113,3325,1092,2031,24359,1294
65630,7,66,199,48,3392,18
40415,3,48,828,22,1744,26
62197,7,181,294,131,5064,50
21715,99,3378,1204,2170,66394,1208
34524,56,863,959,623,15657,240
55555,27311,681107,506,429414,1807573,251693
22569,67,1186,1192,802,15234,384
55352,345,12640,512,6208,400709,6432
19163,228,5800,1249,4119,51006,1681
11243,34,1479,1366,813,25065,666
45746,316,4391,755,3345,30747,1046
37428,19,270,885,223,7366,47
28817,74,3035,1064,1827,19420,1208
49637,32,444,684,290,3821,154
14241,6,227,1329,175,7171,52
18122,34,586,1267,397,15511,189
44000,282,6525,774,5166,40058,1359
11261,51,2633,1366,1394,17599,1239
23067,140,6850,1183,4372,44886,2478
10427,14,750,1372,472,12254,278
27013,35,1054,1100,896,37375,158
3048,134,5828,1445,4193,49271,1635
14744,11,219,1322,178,9687,41
9892,546,21796,1375,14365,98707,7431
63665,8,95,255,65,2401,30
56496,2,28,480,22,6472,6
32584,22,484,996,317,13480,167
23174,7,321,1182,234,6963,87
36889,97,1575,901,987,15971,588
34850,58,1067,951,747,21804,320
5242,34,495,1419,365,9024,130
29988,75,1500,1041,929,21454,571
58605,76,1547,418,1113,26475,434
22214,173,2780,1198,1725,34584,1055
55499,98,1158,509,1002,10635,156
30140,38,919,1037,820,57076,99
66504,11,157,174,115,4065,42
49687,395,7255,682,6196,79382,1059
65712,0,0,196,0,1456,0
38908,19,357,848,265,7264,92
23898,297,7799,1169,5332,29878,2467
4685,69,1360,1426,1025,45877,335
30179,4710,135630,1036,82385,427691,53245
3766,19,556,1438,419,11040,137
56152,1,20,490,19,3586,1
26700,41,822,1107,533,8449,289
34226,58,721,965,525,7988,196
61610,80,1345,314,1116,9752,229
29368,132,3687,1053,2574,30086,1113
32403,73,1472,1000,1012,16480,460
19953,10,554,1235,399,10219,155
6335,4033,108048,1406,73818,267451,34230
55123,52,659,519,575,10087,84
48666,105,1448,712,1138,54375,310
5750,69,1561,1413,1101,20474,460
30635,21,704,1028,396,6819,308
30530,167,4147,1029,2662,32669,1485
51742,144,2682,628,2217,40906,465
63412,254,6552,262,5410,40373,1142
1172,20,982,1460,769,27021,213
53078,323,5502,584,4771,56693,731
8326,105,932,1383,593,11736,339
62791,36,641,277,483,8329,158
6642,12,372,1402,258,20357,114
63242,123,2066,266,1677,25408,389
24902,11,482,1146,338,9307,144
61392,28,632,321,487,5299,145
63456,476,6685,261,4483,26746,2202
23459,195,5159,1177,3569,64494,1590
54093,15,165,554,129,6155,36
5737,5819,148654,1413,100897,821802,47757
12927,0,0,1348,0,5708,0
63931,13,104,247,88,2799,16
37431,0,17,884,16,6471,1
25594,127,2868,1132,1917,48976,951
11399,57,5694,1364,2876,18058,2818
5177,203,10161,1420,6765,123159,3396
6418,95,1137,1405,741,9264,396
66041,57,916,188,739,18013,177
35002,4965,151420,947,108973,684007,42447
9258,11,811,1379,558,10813,253
58873,1077,26139,409,20406,124454,5733
28400,22,795,1071,410,6136,385
56655,18,233,476,207,10888,26
44608,18,849,768,522,9303,327
128,412,19385,1470,12778,108746,6607
20962,85,4282,1217,2031,32520,2251
52748,181,3538,595,2668,29008,870
47068,4,64,739,52,3625,12
23102,6,147,1183,125,4920,22
3377,1147,27658,1442,18429,239009,9229
4694,36,993,1426,679,22417,314
20592,19,992,1224,644,7318,348
21229,2,285,1212,201,15683,84
50246,1619,24556,668,18045,58766,6511
3357,14,329,1442,226,13116,103
5228,20,432,1419,333,15100,99
50268,4,76,667,62,5999,14
63121,17,249,270,186,3020,63
9446,103,5119,1378,3068,19447,2051
37517,9,438,882,334,22170,104
62965,60,1047,273,907,18822,140
24296,1065,23757,1160,17078,199119,6679
53143,11,167,582,135,5427,32
66890,3,17,161,14,3779,3
33882,0,31,972,20,6212,11
3774,390,21886,1438,14512,172573,7374
9057,29,1785,1379,1112,16520,673
47667,21,548,731,421,5289,127
18033,50,2391,1268,1698,30085,693
50361,48,557,665,411,6958,146
35231,39,1482,941,1020,19293,462
62327,59,745,290,676,10491,69
65896,744,8486,192,6912,69790,1574
66864,3,18,162,11,1294,7
8918,232,8177,1380,4999,40551,3178
42586,164,4572,793,3716,75818,856
33393,12314,235338,981,169210,460248,66128
1431,59,2111,1458,1430,15705,681
55126,51,487,519,377,9772,110
51639,61,610,631,461,8352,149
57069,158,1756,464,1310,14305,446
56563,20,380,478,291,11621,89
48990,106,1419,702,1238,29317,181
1933,3,169,1455,125,20655,44
8024,62,2219,1384,1412,13351,807
25453,37,1089,1135,728,11170,361
28372,8,318,1072,198,6982,120
16770,28,1073,1291,781,23387,292
55514,3,50,508,45,3030,5
48572,609,5650,714,4455,36762,1195
4020,14692,401910,1435,240530,768748,161380
32589,58,1348,996,890,20796,458
16856,67,1128,1290,788,19205,340
35797,49,988,928,746,10714,242
33516,21,454,979,306,7782,148
1246,9,377,1460,277,37253,100
25541,35,2226,1133,1453,25314,773
42744,57,1408,790,1023,20709,385
429,13,626,1466,510,10372,116
31810,33,790,1008,488,12403,302
23621,16,580,1174,433,39763,147
55604,168,2641,506,2129,13176,512
36183,44,1071,918,854,14257,217
38256,16,443,863,337,6225,106
61024,77,896,333,683,11254,213
22133,82,1505,1199,1013,17090,492
55482,9,107,509,84,3327,23
50667,58,808,658,650,10719,158
1037,1770,56427,1461,30935,152331,25492
43781,17,519,777,375,12667,144
53109,85,905,583,722,10390,183
58426,130,1683,424,1311,29019,372
4036,23,415,1435,296,16200,119
14844,254,7548,1321,5267,51098,2281
37992,18,290,869,231,8221,59
667,6042,311887,1464,176771,1444265,135116
49044,47,586,701,499,8933,87
53874,292,2521,548,2241,24678,280
61744,127,1727,310,1306,23785,421
5666,871,11624,1414,7903,45113,3721
13725,941,48756,1336,34214,211716,14542
30193,5,333,1036,198,4283,135
18661,12,470,1258,345,9102,125
54585,15,227,537,179,11006,48
54193,4,68,551,55,4095,13
14003,263,5204,1332,3415,81575,1789
64508,17,344,229,256,9250,88
7856,9,505,1386,369,29440,136
31698,5,188,1010,101,4833,87
23579,66,921,1175,653,29403,268
62016,39,1559,300,1205,35808,354
37021,273,3788,896,2994,18702,794
55351,56,867,513,647,7126,220
56819,17,215,471,176,5386,39
61459,84,1360,319,932,22258,428
35912,60,1830,925,1439,18985,391
64816,98,1041,220,908,21088,133
12554,10,780,1352,427,9019,353
45058,27,335,762,253,12683,82
45309,140,4063,760,2809,37737,1254
25940,17,323,1124,220,10124,103
8208,11,548,1383,415,14881,133
5440,131,3525,1416,2323,60172,1202
3612,130,8607,1440,5686,52709,2921
36918,74,1279,900,1001,10356,278
2674,28098,1335764,1448,746237,2748417,589527
24469,431,11715,1156,7800,94242,3915
61120,6,39,329,29,3797,10
10912,116,5542,1368,3440,123591,2102
43497,68,622,780,473,5648,149
58831,21,164,411,112,4173,52
334,479,13387,1467,8480,73033,4907
9971,90,1990,1375,1338,25071,652
53867,10001,156098,561,123747,936089,32351
29908,28,981,1042,605,15273,376
30017,755,12842,1040,9774,80630,3068
53015,106,1224,586,972,21103,252
21056,43,1379,1215,864,29659,515
9567,34,1844,1377,971,15024,873
28522,1496,103628,1069,73056,338089,30572
13793,18,962,1335,606,49255,356
37775,57,865,875,621,9981,244
36280,5,65,915,60,6450,5
66115,13,96,186,86,5695,10
30677,14,293,1027,190,3152,103
32939,15,128,990,76,3198,52
24145,182,3698,1163,2641,39232,1057
5695,6263,204522,1414,120853,652283,83669
38980,4,79,848,63,4795,16
64953,5,56,215,40,1804,16
31712,3,98,1010,82,7744,16
31709,5,115,1010,74,6669,41
36375,6,343,912,258,7143,85
41175,132,2252,816,1951,44812,301
18863,560,14838,1254,10113,123619,4725
24608,11,538,1153,345,12829,193
37478,389,11205,883,8507,125778,2698
35089,2018,28841,945,20974,139155,7867
60598,19,457,350,157,7664,300
29098,41,2024,1058,1308,47842,716
43087,24,242,785,206,6133,36
33908,529,8296,972,5967,59898,2329
8654,348,20822,1381,12857,79676,7965
36051,32,374,921,310,13373,64
63525,14,101,259,71,6668,30
13247,158,2517,1343,1775,26424,742
35767,315,8389,929,6525,68213,1864
11022,100,2008,1367,1197,29988,811
38917,942,26829,848,22179,174128,4650
2903,661,20297,1446,13053,78837,7244
8237,5,413,1383,278,21065,135
8934,363,7936,1380,5274,95890,2662
60293,5,75,361,41,1405,34
22126,276,9225,1199,6613,54349,2612
35265,40,930,940,641,19084,289
7421,98,1950,1392,1323,10690,627
28419,119,4255,1071,2601,20124,1654
45860,30,419,754,338,8947,81
36490,278,5066,907,3954,21892,1112
37554,64,1075,879,836,15032,239
14557,16,459,1324,288,20919,171
11864,61,6561,1360,2883,59406,3678
13994,78,1902,1332,1104,16779,798
27950,12,237,1080,175,5708,62
13673,20,429,1337,278,6091,151
68882,4,35,95,27,876,8
37605,3391,47936,880,35567,251873,12369
28726,29,469,1065,330,6220,139
15837,146,4040,1307,2935,51620,1105
16130,271,7910,1302,4645,129338,3265
33034,1269,17893,988,13398,88483,4495
26515,17,790,1112,480,7820,310
67529,7,45,140,45,2449,0
38009,1118,16912,869,14068,109521,2844
13779,19328,757629,1336,452647,1269907,304982
30441,279,8696,1031,6048,42893,2648
29184,33,757,1056,482,17868,275
40374,27,320,829,283,8399,37
41702,257,3285,807,2471,20037,814
15656,242,6239,1309,3797,67503,2442
4008,489,12391,1435,8688,68874,3703
66792,9,158,165,108,5230,50
34193,280,8088,965,6188,58462,1900
53397,26,440,576,345,6511,95
32217,71,2074,1003,1342,46868,732
1624,94,972,1457,601,8844,371
60140,28,511,366,409,9464,102
58230,34,530,430,373,15095,157
7341,3,139,1393,99,11177,40
10860,80,1734,1369,1117,13043,617
69040,30,267,90,200,3511,67
27482,239,6112,1090,3882,41833,2230
32927,21,662,990,443,10265,219
42044,243,2489,802,1746,28605,743
19239,164,3062,1248,2229,29512,833
34081,1235,25005,968,18855,103206,6150
18514,15,478,1260,372,13379,106
31823,22,682,1008,482,15593,200
26355,1516,18004,1115,12894,65929,5110
60163,3,64,366,36,3302,28
29477,63,1754,1051,1211,28162,543
8502,3405,125172,1382,76620,303851,48552
33110,1,93,987,67,5266,26
61507,29,423,317,378,12218,45
36086,14,249,920,172,15898,77
50997,18,297,649,246,7816,51
65331,12,177,206,141,3838,36
8033,17,640,1384,392,8448,248
56143,13,169,491,125,8526,44
31368,406,8739,1015,6563,72829,2176
12949,29,1165,1347,663,11976,502
33116,58,565,400,430,7856,135
48540,48,628,713,528,16230,100
8228,1085,38033,1383,24209,259480,13824
5247,537,15107,1419,9650,55746,5457
38109,3,158,866,128,7792,30
37726,5,61,876,48,3372,13
31891,66,2585,1007,1659,30455,926
42596,6,144,793,106,4237,38
35978,77,1253,924,917,24459,336
57639,64,1063,450,771,8259,292
9846,620,28825,1376,17141,66577,11684
58165,1456,35995,433,26470,167026,9525
25217,197,3638,1140,2517,17891,1121
60001,1958,34997,366,26823,175133,8174
34798,22,332,952,236,4462,96
4037,1,55,1435,37,13465,18
26043,47,1059,1122,668,9943,391
66514,41,232,174,178,4973,54
1806,71,3253,1455,2086,21675,1167
14959,30,1934,1320,1256,10907,678
35936,43,737,925,524,11922,213
19715,58,904,1239,675,18210,229
2072,82,3405,1453,2402,29413,1003
14218,51,2909,1329,2007,75995,902
56643,11,189,476,156,6894,33
34063,4578,219581,968,143283,600796,76298
24163,10,519,1163,351,18423,168
4987,49,1491,1422,1006,46809,485
24573,7,289,1154,195,4050,94
13802,68,3122,1335,2010,29993,1112
63775,4,131,252,85,2198,46
43191,15,431,783,320,10633,111
53070,16,223,584,198,11024,25
65922,127,1846,191,1561,24154,285
42520,11,347,795,249,11973,98
45063,29,225,762,187,6029,38
8135,60,1718,1383,1175,21419,543
65055,1,100,212,89,3481,11
14687,282,9619,1323,6746,63847,2873
25095,1766,59316,1142,38220,341747,21096
62991,114,1122,273,926,5701,196
29013,239,10120,1060,6795,51824,3325
51637,5,83,631,68,7355,15
58970,100,1614,406,1230,13058,384
30268,64,1540,1035,1010,27003,530
14516,73,2069,1325,1476,11000,593
28416,172,2468,1071,1596,42431,872
26222,574,13356,1118,8381,56504,4975
4113,68,2429,1434,1729,52861,700
24309,6,202,1160,138,12679,64
44381,53,1185,770,923,20982,262
9767,56,1244,1376,801,21628,443
56720,873,11985,474,9219,141938,2766
7413,6,515,1392,330,8234,185
25873,1613,41454,1126,25877,279566,15577
14532,1283,36975,1324,27104,99518,9871
25884,196,4350,1126,2989,30219,1361
61693,223,2594,312,2173,28437,421
68146,7,116,121,90,3895,26
68797,2,33,98,24,2092,9
15268,26,1056,1315,791,41889,265
24039,254,8284,1166,5860,70172,2424
37552,351,5960,881,4728,43646,1232
7761,76,4337,1387,2769,53817,1568
851,61,2125,1463,1428,34182,697
61635,32,660,313,437,8406,223
18676,1,95,1258,54,7941,41
28093,1199,26904,1077,17406,137188,9498
56647,66,574,476,476,7117,98
50104,1,46,672,38,3032,8
38325,6,189,861,142,7766,47
68110,9,193,122,147,3535,46
66670,15,60,169,45,3391,15
65045,282,3674,211,3032,59771,642
52449,41,266,605,189,8399,77
15903,19,474,1305,322,10495,152
52524,10,131,602,84,7343,47
64129,12,109,240,87,1929,22
62563,49,765,284,595,10208,170
40964,50,664,819,436,7057,228
21581,1,95,1206,64,3680,31
51027,221,3525,648,3083,40850,442
62304,50,796,291,616,9434,180
35651,22,530,929,373,10031,157
37685,5,225,877,173,4245,52
15432,74,1506,1313,1040,9973,466
62614,4,138,282,121,5410,17
51430,28,348,637,299,9718,49
16261,3,114,1300,85,17812,29
56672,11,180,475,130,6649,50
51575,815,14503,633,11273,116173,3230
3704,29,938,1438,667,14581,271
63729,41,548,253,411,4467,137
48805,31,391,708,289,6739,102
20402,109,2231,1227,1666,17248,565
29166,71,1244,1056,722,18785,522
57867,126,5600,442,3556,23051,2044
17849,3458,96025,1272,65885,247832,30140
5353,11,881,1417,584,23339,297
21911,83,1185,1202,821,12825,364
62418,50,521,288,442,9434,79
9638,92,1938,1377,1237,25864,701
64031,55,1071,244,769,28959,302
42390,12,198,797,123,8775,75
55239,64,887,511,655,9065,232
16483,47,1421,1296,893,16096,528
52357,19,359,609,297,16088,62
33760,9,389,974,252,6661,137
65304,57,1208,207,914,14001,294
36966,9,946,890,788,9107,158
45072,1,56,762,44,2971,12
10284,0,180,1373,115,3693,65
18494,64,2603,1261,1909,34636,694
21621,179,5280,1206,3489,51032,1791
55618,148,2800,505,2037,52596,763
26891,39,1289,1103,810,18317,479
68392,19,127,113,86,4701,41
51920,52,676,624,502,7832,174
50196,86,1596,669,1298,26408,298
20362,25,952,1228,713,13726,239
31378,0,0,1015,0,5777,0
58265,61,992,429,569,10801,423
26466,3,200,1113,124,8023,76
34707,15,550,954,386,14642,164
35307,524,7017,939,5829,34610,1188
7310,11,367,1393,277,22844,90
48961,74,578,703,464,7720,114
50166,13,98,670,78,4433,20
56035,44,687,494,574,18892,113
16374,11646,416028,1298,259566,1845877,156462
28009,202,4320,1078,2939,25284,1381
4988,68,2991,1422,2070,51142,921
13287,148,6751,1343,3986,59735,2765
26561,77,2984,1110,1834,22181,1150
68105,18,350,122,326,9792,24
29763,557,14281,1045,9230,135811,5051
62411,1011,17731,288,13454,161864,4277
63454,248,6001,260,2540,28070,3461
39526,2,41,841,34,1679,7
64283,2512,62813,235,43773,318369,19040
21455,9,348,1208,258,11698,90
11998,1,103,1359,47,5011,56
60983,157,3670,335,2824,35442,846
21017,3,198,1216,135,7751,63
51853,243,2612,625,2198,49632,414
1053,2,88,1461,52,7594,36
25041,6,124,1143,107,5740,17
9895,255,7216,1375,4737,71647,2479
19891,7,170,1236,125,27936,45
23549,16,310,1176,251,11486,59
7533,47,3199,1390,1865,68960,1334
16496,76,2188,1296,1591,77609,597
63133,19,176,269,144,4304,32
59077,42,420,403,342,11228,78
1062,13,908,1461,707,13968,201
21370,34,311,1210,238,24150,73
42025,0,106,802,80,4245,26
64519,7,64,229,55,5955,9
18605,11,645,1259,505,7517,140
56537,97,1377,479,1199,30784,178
18753,481,12773,1256,9144,158328,3629
18766,14,737,1256,548,21960,189
68962,1,27,93,19,1280,8
21460,96,3590,1208,2376,14398,1214
37408,102,1986,885,1493,15500,493
17265,15,333,1283,250,6157,83
49734,152,3644,681,2562,20067,1082
26350,67,1726,1115,992,24299,734
10415,6,364,1372,238,7461,126
15714,43,1742,1309,1269,27325,473
55410,17,255,511,180,3038,75
6989,32,2522,1397,1544,23127,978
64065,80,815,242,701,8020,114
56555,37,457,478,355,5523,102
48809,20,301,708,276,17852,25
65647,28,204,198,178,6948,26
64000,32,625,245,528,9756,97
23028,18,656,1184,462,11239,194
15236,1035,34213,1316,22169,98898,12044
60097,218,3231,368,2339,15160,892
65468,123,2048,203,1720,21886,328
23514,6,271,1176,205,9845,66
21291,103,1616,1211,1099,30669,517
17583,68,947,1277,737,36084,210
31636,37,1013,1011,561,16404,452
9849,12,791,1376,506,18644,285
7793,118,4532,1387,2610,20238,1922
20858,11,426,1219,257,13167,169
64272,10,75,236,70,3065,5
62365,132,1889,289,1479,15409,410
48485,20,304,719,238,7788,66
18726,145,5109,1257,3499,76939,1610
30949,27,949,1022,512,8412,437
34699,3,101,954,66,3746,35
23542,53,1095,1176,795,20053,300
60331,145,1176,359,948,30591,228
21851,3,147,1203,99,4784,48
21530,399,21591,1207,13581,90374,8010
28774,13,425,1064,310,8897,115
38839,1946,28954,849,22276,106980,6678
24292,84,1736,1160,1069,15767,667
21513,6,118,1207,77,9084,41
7320,20,461,1393,323,20537,138
1656,18,934,1457,688,25504,246
59146,487,7136,401,5671,28018,1465
44807,1774,21192,765,15058,124238,6134
18363,3,204,1263,146,10788,58
56958,10,150,467,108,3840,42
18253,0,0,1265,0,9375,0
19559,48,1823,1242,1266,15422,557
5952,21,938,1411,658,14697,280
36930,37,944,899,774,25295,170
18912,1785,53664,1253,35857,341730,17807
43337,535,6929,782,5397,34123,1532
47489,44,841,733,584,9742,257
11930,553,40551,1359,21909,190933,18642
65133,5,72,210,50,4717,22
43389,2,90,781,62,3933,28
37962,421,6996,870,5410,95959,1586
68087,4,120,123,80,3930,40
57239,1209,14819,460,11999,82582,2820
15374,106,1647,1314,1254,60327,393
33425,74,2440,981,1602,45470,838
9339,32,1531,1378,1039,38270,492
15974,752,17434,1304,12285,133811,5149
60430,1428,22078,354,18471,166406,3607
36440,48,1100,910,837,10262,263
8556,296,8124,1382,4939,75282,3185
24342,6496,160723,1159,106077,805360,54646
24895,9,513,1146,376,11346,137
62691,122,1782,280,1455,16773,327
65754,17,255,196,208,2778,47
37745,124,2257,876,1744,14466,513
15812,353,9122,1307,6222,95816,2900
29147,22,475,1057,322,11020,153
50513,62,1004,661,757,13408,247
60166,29,298,365,218,8170,80
53787,64,647,565,508,9250,139
38247,29,789,863,572,29420,217
15177,23,473,1316,327,9208,146
1373,32,948,1459,643,12794,305
56807,105,2145,471,1797,24811,348
22302,41,1660,1197,1057,15633,603
29783,26,396,1045,274,8466,122
47831,157,3929,729,3365,36416,564
28542,55,759,1069,486,14216,273
66764,1,14,165,10,2000,4
26113,11412,418206,1120,291782,1184461,126424
26140,86,2129,1120,1317,13032,812
55848,261,8171,499,6512,51275,1659
57974,21,247,439,192,9627,55
47249,702,18281,736,14862,104970,3419
62565,110,1402,283,1072,12304,330
19846,48,549,1237,431,29626,118
16105,1,47,1302,34,5292,13
33616,19,229,977,198,3927,31
9169,551,16286,1379,9907,61485,6379
8786,6,508,1381,302,16184,206
54029,119,1392,555,1249,18209,143
24590,170,2847,1153,1963,21069,884
31219,334,8576,1017,5517,50845,3059
21518,177,6476,1207,4334,42475,2142
62077,4,42,298,29,1465,13
35935,33,723,925,570,10941,153
5109,117,4846,1420,3087,21616,1759
15420,10,394,1313,292,15995,102
20998,12,567,1217,406,12693,161
17163,1128,26669,1285,17446,152990,9223
9147,21,370,1379,228,10341,142
23175,73,2428,1182,1693,53947,735
20224,76,1834,1230,1294,30635,540
48703,94,1171,711,950,14924,221
26116,1767,26563,1120,17918,70776,8645
29569,37,1177,1049,658,10341,519
54650,684,10693,534,7883,79427,2810
30252,253,10655,1035,6630,63742,4025
28012,330,8635,1078,5769,93416,2866
65803,12,157,194,128,4788,29
9826,53,2396,1376,1470,14328,926
66867,17,327,162,259,2883,68
8116,3,173,1383,102,10585,71
35898,0,0,926,0,5046,0
67619,3,38,138,37,2293,1
17829,292,4962,1272,3435,35256,1527
50870,158,1249,653,970,14604,279
16927,522,10654,1289,7073,66436,3581
26652,24,1863,1108,1213,17298,650
34650,688,20818,955,15402,110326,5416
9238,4,91,1379,52,5112,39
68885,2,65,95,22,6252,43
25079,203,3329,1142,2113,18749,1216
8695,34,816,1381,519,18533,297
34521,15,298,959,264,3997,34
35153,556,11105,943,8491,87667,2614
9676,380,14841,1377,9468,82720,5373
66490,9,214,175,164,9445,50
8401,23,556,1382,365,8110,191
31304,64,2318,1016,1594,22975,724
62622,28,142,282,114,4921,28
56985,47,519,466,387,8163,132
41165,37,734,816,614,5756,120
29420,127,3119,1052,1799,15589,1320
8039,302,4892,1384,3685,42838,1207
15084,0,0,1318,0,6136,0
40533,4,157,826,121,7887,36
65215,250,8000,209,6842,44246,1158
50847,717,10957,653,9203,56018,1754
50401,73,1042,664,845,8664,197
576,94,3203,1465,2294,28176,909
59506,291,5942,388,4327,31878,1615
23803,71,1282,1170,846,15766,436
49897,11,135,677,106,5297,29
8969,104,2225,1380,1599,21288,626
3532,317,17541,1440,12448,109877,5093
63872,16,200,249,149,9273,51
42634,13,146,792,106,7540,40
37688,135,1850,877,1548,10990,302
35470,20695,393331,935,251053,1705540,142278
56096,45,575,492,435,6015,140
20890,11,280,1219,214,7164,66
18618,6,444,1259,351,15941,93
18891,1,107,1254,76,6227,31
9837,73,1988,1376,1424,56512,564
21266,68,2916,1212,1984,38117,932
50760,76,855,656,681,8825,174
56230,322,8313,488,5955,52946,2358
60971,113,2137,334,1937,25029,200
13464,7,380,1340,168,6122,212
27891,11,298,1081,215,17365,83
54573,105,1553,537,1202,9303,351
49445,27,414,689,341,10188,73
3872,4,254,1436,174,10251,80
29947,16,741,1041,418,12394,323
15991,121,1559,1304,1084,32551,475
31978,108,2711,1006,1794,36218,917
37486,1539,34441,883,26466,129226,7975
56313,23,364,485,256,7321,108
1715,71,3893,1456,2748,22817,1145
66573,0,6,171,3,663,3
9227,514,21271,1379,12823,109877,8448
33008,177,3204,988,2282,33649,922
61471,1725,27964,311,21416,159784,6548
21934,68,1820,1201,1089,11155,731
5943,126,10633,1411,7242,47309,3391
25106,23,705,1142,482,15534,223
39917,723,10176,836,8617,122791,1559
31985,584,9180,1006,6663,110252,2517
27755,1484,38275,1084,23567,114659,14708
17769,81,3164,1274,2311,61057,853
68815,1,61,98,41,3579,20
22447,35,715,1194,529,15817,186
39613,35,398,840,345,10562,53
52613,57,740,600,599,11156,141
38014,19,443,869,335,2898,108
17207,67,1652,1284,1346,17040,306
56603,8,67,477,54,5336,13
20730,7,285,1222,207,8449,78
50062,74,750,673,568,7132,182
57538,2254,51542,453,39905,232962,11637
43365,440,8051,781,6308,107847,1743
66245,1014,12369,181,10146,76177,2223
13057,806,12443,1345,8617,92937,3826
62490,74,958,286,807,15749,151
17396,89,5343,1281,3852,34392,1491
12316,111,1876,1355,1112,12980,764
20555,488,18213,1225,10176,66408,8037
64040,48,638,243,476,7678,162
52879,223,2145,590,1715,15178,430
38016,33,768,869,662,17095,106
26777,405,8960,1106,6059,90365,2901
9931,466,16818,1375,10942,140716,5876
7681,1697,92047,1388,50811,383332,41236
1067,12,675,1461,475,21097,200
14759,9,372,1322,236,7911,136
60039,88,2323,370,1512,46897,811
35717,20557,430274,930,270132,1054894,160142
48843,36,563,707,395,12485,168
6445,5,168,1404,130,16934,38
64747,21,326,222,212,10662,114
49149,7,102,698,76,5011,26
14210,776,12411,1329,7750,59359,4661
49900,12,107,677,91,4895,16
1162,33,911,1460,639,38870,272
31902,74,1746,1007,1318,40476,428
3386,82,4523,1442,3296,96696,1227
4400,1001,70032,1430,43604,354329,26428
17001,4,155,1288,122,9615,33
27827,24,1581,1082,883,37491,698
54999,6,46,522,33,3922,13
44949,45,1517,763,927,19843,590
54082,96,1569,553,1407,21929,162
20294,40,541,1229,409,23198,132
14310,1,78,1328,50,18556,28
27625,28,897,1086,482,10735,415
16715,380,11604,1292,7914,106620,3690
21044,38,1229,1216,861,32707,368
21124,16,860,1214,445,15700,415
57121,52,747,463,572,20311,175
48620,8,133,714,101,5769,32
17515,394,9092,1278,6739,76541,2353
8697,54,1312,1381,781,17555,531
31514,28,478,1013,371,9660,107
56917,12,108,468,91,7805,17
39308,4,116,844,93,3036,23
29957,5,239,1041,150,11821,89
50670,25,450,658,372,10773,78
9389,15,1046,1378,662,23082,384
31771,18,635,1009,443,12566,192
1582,17,486,1457,337,34414,149
32441,18,810,999,499,8138,311
61405,70,1012,321,825,12272,187
52638,10,226,598,164,13444,62
23806,2,201,1170,153,16899,48
62714,0,27,280,27,1340,0
35436,113,3130,936,2729,38696,401
56185,10,104,489,81,2869,23
21695,635,17781,1204,10264,79553,7517
57506,204,3243,454,2624,23568,619
49771,459,6805,680,5468,81483,1337
20457,18,659,1226,538,14448,121
35678,1417,25104,931,17693,168214,7411
49371,305,4446,691,3490,98784,956
28775,3,121,1064,105,5450,16
27850,2,101,1082,78,4244,23
35776,816,14925,929,12081,114841,2844
19791,9,380,1238,279,26597,101
61709,34,363,311,308,5892,55
7179,3,152,1394,110,7089,42
63566,31,418,258,349,10210,69
29077,45,1272,1058,796,14773,476
37495,763,8792,883,6432,35792,2360
28369,53,1630,1072,1115,24209,515
49712,36,589,670,525,14075,64
52793,7,168,593,129,12343,39
63102,60,561,270,494,8622,67
43545,179,2257,779,1767,18557,490
37088,6,121,894,100,4347,21
2201,244,9358,1452,6047,71373,3311
25535,108,2563,1133,1443,20155,1120
55933,61,953,497,680,12753,273
21681,196,13641,1205,8404,105149,5237
42850,24,795,788,523,15350,272
22613,312,14023,1191,9377,81803,4646
17419,18,451,1281,320,10964,131
46278,27,463,748,372,12626,91
20925,2276,173895,1218,115021,961116,58874
47347,24,398,735,310,9596,88
20109,24,1070,1232,733,18577,337
13566,2,259,1338,132,21729,127
49127,42,415,698,350,4854,65
34272,302,4156,964,2993,41163,1163
49881,48,739,677,532,12596,207
68123,10,183,122,130,7252,53
8647,1,127,1381,103,7313,24
4637,8,165,1427,121,13648,44
3466,112,3838,1441,2780,54686,1058
25032,8,384,1143,275,7139,109
50164,30,714,670,485,18409,229
46356,220,3274,748,2216,16918,1058
30095,149,2025,1038,1227,15922,798
67727,166,3703,134,3157,25715,546
66641,0,54,170,39,9634,15
35974,18,402,924,298,18084,104
47660,9,217,731,190,25015,27
22688,132,1687,1190,1135,16490,552
12539,298,17819,1353,10158,55872,7661
6680,18,387,1401,287,7433,100
67968,43,408,126,342,10264,66
68385,12,356,113,270,9735,86
55388,86,1262,511,977,15661,285
28312,478,10261,1073,7017,62677,3244
25787,14,363,1128,248,13889,115
62541,4,27,284,23,1866,4
29286,191,5086,1054,3146,40241,1940
57876,110,1959,442,1631,26888,328
43833,1650,26263,776,20353,145081,5910
38790,92,2720,850,2155,39302,565
61985,94,1099,302,832,21101,267
33177,693,10860,985,7626,91306,3234
21117,1156,26789,1214,17575,199193,9214
24685,63,1001,1151,706,12885,295
67966,344,2999,126,2284,15579,715
58887,9,180,409,147,4242,33
30465,7,187,1031,177,7979,10
55420,66,895,511,634,15176,261
1167,6271,171727,1460,106587,548673,65140
67775,11,219,133,192,3478,27
57665,403,4051,449,2796,24095,1255
40944,3170,57608,819,36366,124268,21242
55440,5,117,510,74,4078,43
26303,2,189,1116,122,6686,67
64552,167,4215,228,2760,19685,1455
45532,55,932,757,673,21439,259
34698,491,8430,954,5580,90889,2850
51546,69,335,634,288,13983,47
51476,331,5806,636,4540,37834,1266
21332,283,4187,1211,3092,23149,1095
18999,2,69,1252,50,16664,19
68397,13,376,113,300,13496,76
44496,2682,32132,769,25555,235668,6577
23360,36,2043,1179,1707,19598,336
33494,10,465,979,314,5863,151
38847,113,2585,849,2280,46249,305
53644,54,640,569,451,13364,189
799,6097,299107,1463,189374,900837,109733
40651,328,5455,820,4595,75831,860
25875,52,1177,1126,1053,22033,124
4146,14,467,1434,288,8265,179
67419,15,123,144,90,2743,33
51791,2972,46721,627,37283,258080,9438
29272,15,518,1054,311,7196,207
35154,6475,144065,943,92023,486066,52042
39748,73,765,838,603,17591,162
28888,207,3791,1062,2499,15280,1292
36142,5,165,554,127,3928,38
17895,42,1655,1271,1229,16875,426
53615,123,2485,570,1921,22921,564
30738,38,823,1026,718,37725,105
16018,370,8072,1303,5050,26197,3022
20974,11,435,1217,313,10438,122
50876,98,1741,652,1414,30609,327
32479,9,441,998,262,15030,179
68378,16,180,114,138,2870,42
34983,211,2827,947,2095,68096,732
56287,17,339,486,275,5979,64
26365,24,627,1115,525,13127,102
30329,43,909,1034,631,11447,278
2856,368,10527,1447,7801,79570,2726
64942,6,85,216,65,4299,20
5658,43,733,1414,516,11974,217
66360,12,107,179,65,2828,42
16449,577,17967,1296,12524,103015,5443
9833,45,2597,1376,1798,41274,799
26067,6,303,1121,198,10453,105
12469,70,2172,1353,1186,12768,986
54987,23,179,523,121,3694,58
39761,10,273,838,227,5731,46
32138,3,125,1004,83,4588,42
35059,17,374,946,270,10729,104
25573,2,71,1133,54,10807,17
32571,62,929,996,658,10090,271
65494,45,452,202,380,5784,72
4099,308,13293,1434,8786,128102,4507
1316,14,232,1459,165,13444,67
10137,37,1109,1374,745,21867,364
57276,56,581,458,443,17348,138
14249,0,0,1328,0,10126,0
35960,101,1615,924,1239,7672,376
50074,63,549,672,474,16080,75
20020,5525,114367,1234,72571,200429,41796
23970,8,153,1167,115,4493,38
26626,2,61,1108,48,8987,13
12264,1,518,1356,191,16893,327
28470,5,212,1070,123,13900,89
11624,25,2105,1362,1148,20726,957
54315,19,340,547,238,6571,102
6015,152,12231,1410,7921,85299,4310
65381,28,311,205,271,9376,40
40088,1049,26972,833,20358,173121,6614
32373,28,551,1000,334,6889,217
3718,31,716,1438,535,23332,181
17390,0,33,1281,26,5023,7
1223,39,1360,1460,849,39340,511
54305,706,20067,547,16163,115858,3904
18365,30,1015,1263,741,12336,274
51569,3480,58773,633,48369,351169,10404
1035,58,1955,1461,1388,45172,567
5451,243,23571,1416,12386,75112,11185
59689,7,178,382,138,3853,40
65410,16,229,204,189,8239,40
35747,56,1677,929,1212,8748,465
39338,26,354,843,304,15575,50
49581,90,1009,686,786,10006,223
24512,182,6719,1155,4386,47426,2333
58892,15,224,409,159,5755,65
39054,60,973,846,761,18584,212
32569,25,331,996,205,5937,126
21442,10,313,1208,205,6204,108
33876,21,756,973,512,19633,244
57616,11,187,451,153,6017,34
54544,822,12305,538,10210,49039,2095
44582,81,1912,768,1237,10616,675
28020,11,651,1078,409,9980,242
68807,15,255,98,219,5005,36
67372,1,12,145,7,1248,5
14682,34,927,1323,597,8602,330
29002,7,228,1060,188,15120,40
37009,11,191,897,151,3972,40
28435,40,2185,1071,1435,12896,750
23093,178,3051,1183,2053,41424,998
34187,210,4511,966,3099,41567,1412
48847,200,2484,707,1933,32837,551
24715,10,255,1150,177,11241,78
23178,18,642,1182,439,14099,203
23103,8,290,1183,204,8138,86
5278,246,7523,1418,5127,132166,2396
47541,12,286,733,203,5533,83
68109,31,326,122,226,2620,100
53757,10,50,566,44,7217,6
49080,12,115,700,104,10959,11
43977,13,231,774,179,12701,52
10698,428,11286,1370,7263,39660,4023
60310,6,103,360,79,2077,24
4956,13,580,1422,388,26659,192
34340,132,6786,962,4777,77369,2009
7228,117,3618,1394,2443,32985,1175
34231,393,4821,965,3443,34467,1378
21907,16,522,1202,348,24909,174
9447,6,385,1378,226,5795,159
29932,16,365,1042,249,9927,116
35738,35,899,930,605,8544,294
4026,23,1283,1435,891,17653,392
26237,3,195,1118,132,4203,63
6011,44,1791,1410,1215,57122,576
59453,14,104,390,82,3611,22
50722,66,868,657,752,22376,116
30476,5,235,1031,146,11758,89
60582,76,1370,350,1096,11012,274
59364,60,646,393,497,15784,149
13393,12,710,1341,397,26503,313
61358,27,473,322,376,10239,97
49808,1002,20181,679,14695,52909,5486
27599,19,589,1087,336,6517,253
26476,14,417,1113,272,5720,145
18251,1,100,1265,78,7338,22
20605,69,950,1224,648,14638,302
18007,5,399,1269,262,10912,137
19378,37,833,1245,631,8103,202
13784,118,4521,1335,2839,34139,1682
62030,5,142,300,98,8853,44
28131,628,16284,1076,11187,53069,5097
7174,150,7821,1394,5458,77745,2363
64733,28,222,222,170,4589,52
8777,15,503,1381,294,20021,209
18066,27,1107,1268,842,26008,265
60577,20,273,350,225,4767,48
61469,28,463,318,386,9354,77
54378,81,2735,545,2047,14452,688
32586,440,7788,996,5508,44516,2280
54297,36,195,548,157,4613,38
28893,87,2168,1062,1195,20826,973
7800,126,4053,1386,2705,29631,1348
8996,11,365,1380,243,21992,122
65898,9,135,192,106,3866,29
51114,8,138,646,119,11268,19
28983,28,923,1060,566,15826,357
42209,185,2655,800,2163,25321,492
31227,242,6228,1017,4123,144578,2105
21327,31,594,1211,463,9268,131
64673,15,164,224,124,2926,40
40030,2,84,834,76,7472,8
61019,6,126,333,98,4535,28
54127,301,4486,553,3648,33040,838
1042,1942,48629,1461,33578,288690,15051
49644,61,707,684,556,14209,151
35215,22,402,941,308,9094,94
34851,20,733,950,461,10028,272
39939,155,2096,836,1708,23144,388
49357,23,234,691,183,6469,51
63655,4,22,255,18,1991,4
11447,27313,1238445,1364,687373,2860444,551072
36975,193,2338,898,1906,27030,432
6832,5,178,1400,125,17562,53
65525,37,626,202,456,10374,170
22038,47,1454,1200,975,16788,479
68323,117,736,115,683,6556,53
2030,12,448,1454,326,20766,122
14842,9,446,1321,325,41803,121
23527,57,2406,1176,1621,20332,785
35234,30,494,941,340,7370,154
33800,24,685,974,480,17729,205
32361,46,743,1000,399,9787,344
29709,1,100,1047,61,4761,39
30789,11,218,1024,144,4542,74
51311,1474,14773,640,12630,61643,2143
48790,17,203,709,161,2983,42
38569,22,522,854,432,19824,90
26296,30,840,1117,570,16761,270
3845,28,452,1437,275,8811,177
14760,5,184,1322,138,7277,46
34637,503,8413,956,6795,124802,1618
50416,4338,87889,664,65261,398387,22628
58701,52,404,414,309,8486,95
22005,70,1883,1200,1341,42407,542
19213,31,780,1248,555,24864,225
1355,112,3996,1459,2986,34467,1010
34710,52,930,953,656,13406,274
35943,483,11678,924,8893,116928,2785
26840,1056,33920,1104,20206,234158,13714
2718,21,1360,1448,1009,37410,351
51681,1398,26178,630,20625,103512,5553
20272,2,91,1229,76,4825,15
30431,20,804,1032,519,21056,285
4955,16375,437732,1422,257268,976714,180464
49853,1018,12837,678,9788,93516,3049
2845,3255,92647,1447,54067,250312,38580
24624,38,1782,1152,1105,12723,677
17052,92,2177,1287,1563,29139,614
32442,25,345,998,241,9328,104
21882,20,721,1202,507,14894,214
27917,199,3929,1080,2418,34950,1511
17530,1145,35401,1278,24659,172863,10742
27601,250,5668,1087,3754,43394,1914
16462,5,188,1296,133,13841,55
64155,8,143,240,110,3580,33
56931,552,9260,468,7285,58987,1975
53511,61,1290,574,1016,13535,274
46121,1996,42165,751,32923,198263,9242
9003,23,1232,1380,708,21709,524
43061,156,2297,785,1637,28171,660
34686,37,1123,954,562,10991,561
27829,855,10062,1082,7730,68309,2332
63084,156,3408,270,2546,32660,862
27778,30,675,1084,470,18406,205
37562,21,223,881,165,4159,58
27195,15,732,1096,438,10617,294
6183,91,3642,1408,2390,16142,1252
48581,20,595,715,383,10489,212
58776,92,1280,412,790,16347,490
54106,68,540,554,442,7366,98
46636,1,25,744,20,2067,5
12187,39,2914,1357,1390,19365,1524
68066,30,302,123,246,6891,56
64855,66,747,217,638,9758,109
36833,100,1899,902,1650,24933,249
23268,10,322,1180,247,9518,75
58188,32,491,432,372,13349,119
9048,663,13318,1379,7872,137332,5446
55629,1,10,505,8,2090,2
7623,30,1390,1389,986,30187,404
34655,100,2699,955,1751,18964,948
9672,202,5125,1377,3312,15232,1813
56359,949,13425,484,10850,85823,2575
29663,31,748,1048,486,5228,262
36662,92,1503,904,1024,15123,479
12736,54,1452,1350,745,15887,707
18567,133,3408,1259,2556,33275,852
59748,25,321,380,248,7280,73
27631,87,1535,1086,923,15907,612
13337,2,95,1342,64,6842,31
68946,0,11,93,7,740,4
65433,76,907,203,746,11312,161
35437,78,1189,936,897,42345,292
61879,112,3186,305,2544,15581,642
9497,22,791,1377,492,15675,299
24879,39,755,1147,484,10164,271
37418,957,17380,885,13928,146642,3452
58068,8,61,436,51,4669,10
53710,19,211,567,176,6209,35
11018,867,27095,1367,14446,85604,12649
8522,58,2248,1382,1508,32688,740
12212,104,5691,1357,3098,29898,2593
36548,1,84,907,65,3260,19
54377,1549,21465,545,17150,110206,4315
60344,14,297,359,256,7072,41
18488,314,11639,1261,8263,42450,3376
15698,890,15788,1309,12169,127428,3619
42043,3871,95830,802,62756,316102,33074
37094,43,1035,894,852,9418,183
21234,121,2308,1212,1648,32581,660
61288,148,2096,324,1733,29394,363
12709,705,19203,1351,13178,81876,6025
47967,31,398,728,284,8696,114
28993,12,319,1060,246,13152,73
34106,1256,27116,967,20073,106248,7043
17984,4203,102440,1269,71537,287869,30903
55465,307,3729,510,3201,48950,528
42610,5,153,793,120,17711,33
18926,29,1407,1253,934,20770,473
50586,45,491,659,358,21211,133
48579,61,602,715,477,9278,125
4983,5,383,1422,278,6451,105
7497,90,2588,1391,1819,35775,769
4929,190157,5818378,1423,3033905,11066995,2784473
67175,1,20,151,13,2043,7
51057,893,23257,647,18906,104598,4351
58805,59,531,412,464,9445,67
9100,2,212,1379,153,20282,59
2729,100,4876,1448,3775,64553,1101
28193,24,990,1075,626,10617,364
32336,95,3640,1001,2462,11449,1178
56157,34,418,490,367,8662,51
51122,44,572,645,464,16343,108
40851,35,518,821,429,9029,89
8533,2525,157379,1382,96691,485930,60688
52548,376,4895,602,3819,30301,1076
33254,24,595,984,429,14074,166
10032,39,2216,1374,1313,21095,903
59280,18,315,396,231,6077,84
40538,165,2439,826,1877,14086,562
8249,22,1288,1383,842,22233,446
48682,11,292,712,213,6618,79
3624,245,20706,1439,12841,77204,7865
14188,265,5407,1329,3861,31554,1546
49155,132,1492,698,1244,20855,248
52298,507,6345,610,5266,76234,1079
34246,17,1698,965,916,22058,782
64814,14,134,220,121,2574,13
24974,308,8279,1144,5526,66907,2753
10253,26,993,1373,680,16630,313
46486,35,733,746,520,12173,213
10541,170,3659,1371,2513,19762,1146
15543,39,1123,1311,808,33700,315
27509,143,4227,1089,2541,86934,1686
26821,5,206,1104,121,17617,85
38991,4,41,847,35,11141,6
36001,3,99,923,73,7965,26
37773,95,1707,875,1207,21319,500
8092,177,4298,1384,2866,32920,1432
2525,958,15163,1450,10674,105079,4489
38515,51,919,855,628,9583,291
10028,10,556,1374,312,9527,244
20802,83,2698,1220,1888,17788,810
27139,97,3537,1098,2146,75425,1391
53224,216,2785,580,2328,16325,457
49186,3,68,696,49,6616,19
62731,0,29,279,26,2353,3
6241,210,3534,1407,2694,20310,840
26436,13,457,1113,289,11417,168
66768,18,413,165,368,3053,45
26701,43,1574,1107,892,15086,682
42930,27,481,787,374,8985,107
9984,150,5010,1375,3476,45160,1534
52682,231,3144,596,2516,28863,628
14594,16,324,1324,239,18884,85
11564,24,744,1363,476,27805,268
33759,7,149,974,121,6412,28
9133,61,2736,1379,1617,32732,1119
28315,182,2981,1073,1711,19252,1270
39963,4,98,835,84,6048,14
58126,179,2753,434,2200,27794,553
18396,5,102,1262,80,7896,22
39119,126,1064,846,850,16702,214
12544,27,2048,1352,1035,11215,1013
6770,3644,154038,1400,87792,467503,66246
35022,46,1285,946,825,12028,460
66465,86,1476,174,976,19791,500
28513,72,1189,1069,731,28914,458
20025,4,166,1234,113,4756,53
62351,1,28,290,14,5120,14
67964,184,3178,127,2602,17092,576
62274,9,183,292,132,5399,51
51909,51,443,624,388,13722,55
6677,200,3158,1401,2430,43611,728
55789,26,232,500,187,7508,45
52160,40,444,615,343,35796,101
15239,0,0,1316,0,20733,0
67823,262,4400,131,3347,32441,1053
40056,16,283,833,228,9656,55
6747,226,11002,1400,6241,328905,4761
14326,67,1905,1327,1372,28495,533
28396,17,397,1071,263,12113,134
27369,1048,30534,1093,22476,179819,8058
48955,51,1054,703,780,16216,274
11519,167,2592,1363,1651,14699,941
61609,221,2854,314,2403,23912,451
20249,114,1508,1230,1074,21297,434
66077,18,60,187,50,2434,10
16195,121,3663,1301,2460,30857,1203
62718,0,26,279,22,3116,4
48626,143,1659,714,1291,20182,368
37721,98,2022,876,1740,24893,282
61760,134,3565,310,2930,25008,635
2207,944,71278,1452,48228,316588,23050
68858,10,80,94,75,1498,5
8169,375,17100,1383,10634,68949,6466
28547,170,3145,1069,2305,21693,840
45662,343,4682,756,3904,62339,778
1263,5,306,1459,218,18453,88
20624,258,6146,1224,4183,25398,1963
14434,2,190,1325,138,7258,52
36438,72,777,910,610,16303,167
53204,21,508,580,390,22236,118
22741,2088,47916,1189,32625,243781,15291
37488,39,731,883,575,11519,156
40604,559,9241,826,7580,89879,1661
24438,71,2388,1157,1670,64600,718
32029,114,3555,1005,2335,29596,1220
44337,97,1354,770,1063,6531,291
64526,17,180,229,147,4365,33
10848,52,922,1369,551,6124,371
25112,82,3666,1142,2551,30066,1115
13380,0,0,1341,0,4844,0
17133,339,7848,1285,5077,85493,2771
51553,47,594,634,484,11757,110
52938,8,79,588,55,5270,24
11242,4,94,1366,57,11388,37
24774,88,918,1149,791,32219,127
21866,863,17240,1202,10943,86685,6297
22633,33,686,1191,587,11665,99
49674,40,590,683,471,18353,119
11574,31,855,1363,524,33900,331
59245,18,198,397,165,7106,33
6931,75,8517,1398,5215,49701,3302
43301,41,906,782,678,9347,228
16968,13,202,1288,157,11224,45
21028,9,399,1216,289,23795,110
51950,528,6152,620,4562,80778,1590
17406,4901,142515,1281,85445,386826,57070
65583,17,177,200,143,3831,34
25338,22,655,1137,446,10245,209
52526,264,2600,602,2145,70755,455
68789,396,6551,99,5582,57393,969
46009,219,7974,752,6153,23756,1821
51065,134,1750,647,1438,51795,312
8664,10,645,1381,454,11458,191
29806,454,9333,1044,6801,76243,2532
2990,40,815,1445,590,16414,225
66779,9,211,165,103,9567,108
65676,1,50,197,13,2993,37
68068,73,1506,123,1200,6780,306
36390,104,2591,911,2174,24176,417
33307,372,6141,983,4323,17841,1818
5578,61,1290,1415,861,34778,429
55724,16,185,503,137,7885,48
67790,484,11398,132,9174,89297,2224
53900,0,281,561,228,12678,53
65786,544,5237,195,4446,40083,791
18269,35,2043,1265,1065,12070,978
13395,7,488,1341,283,21709,205
5325,6,198,1418,151,7728,47
4274,6,245,1432,181,10805,64
39185,18,656,845,542,10472,114
8046,42,415,1384,252,4299,163
68891,7,64,95,45,4108,19
60861,41,448,324,342,8575,106
14548,0,0,1324,0,11743,0
68496,873,17570,109,13804,89159,3766
9228,844,45600,1379,30077,109005,15523
28094,6,388,1077,248,6832,140
24752,22,494,1149,351,10194,143
3717,382,17501,1438,11254,92721,6247
30840,7,224,1023,150,3688,74
33157,11,403,986,274,10037,129
33531,53,1561,869,1249,25738,312
55272,10,104,515,60,2402,44
2365,966,45037,1451,26928,309018,18109
19247,182,2837,1247,2040,22840,797
7449,14,515,1391,305,15859,210
8693,23,1336,1381,877,17117,459
58047,281,3939,437,3333,25924,606
4244,0,101,1432,50,10002,51
36121,35,924,920,841,23975,83
42404,2439,68113,796,44845,170569,23268
39391,63,1449,843,1280,24844,169
49791,20236,686306,677,455580,1543154,230726
27797,51,1067,1083,710,17097,357
4911,208,12026,1423,7263,107870,4763
13850,5574,150717,1334,94993,450409,55724
63773,48,365,252,297,7522,68
29173,5,372,1056,234,9338,138
13870,36,1363,1334,824,13250,539
22225,309,5329,1197,3388,24010,1941
5587,870,42769,1415,26092,240195,16677
2473,37,1624,1450,1151,33786,473
2128,21,318,1453,223,11888,95
63202,23,252,267,220,12560,32
33995,4162,87458,970,54401,391734,33057
20194,23,643,1231,521,23880,122
19167,35,927,1249,759,52732,168
16591,47,560,1295,383,33341,177
29517,47,1869,1050,1052,14620,817
33263,320,16523,983,11805,68982,4718
19473,131,4175,1243,3029,117330,1146
58087,36,528,435,451,8832,77
9842,846,31104,1376,18024,112230,13080
31569,38,600,1012,401,8882,199
55340,131,2494,513,1987,33170,507
68818,37,570,98,408,4710,162
11617,1282,22790,1362,15262,68948,7528
64441,7,124,231,86,5539,38
4427,1601,37320,1430,24789,225437,12531
59514,19,327,388,248,6999,79
68023,70,733,125,680,10232,53
50348,3,67,666,55,5033,12
45520,171,2792,757,2233,15603,559
53472,61,587,575,494,16244,93
27476,89,3055,1090,2040,27849,1015
24418,18,485,1157,331,15981,154
67471,24,609,142,488,16203,121
20641,297,5962,1223,4138,55313,1824
52396,20,454,608,322,13654,132
65808,94,1676,194,1437,14966,239
57838,11,118,443,93,3839,25
36179,1,20,918,16,2821,4
38458,1464,23753,857,18459,155634,5294
20141,97,2250,1231,1529,30234,721
41667,36,622,808,420,2976,202
52185,23,285,614,171,13742,114
48355,77,2322,722,1703,18262,619
58,682,27716,1471,19304,261605,8412
35970,139,1952,924,1556,16138,396
7117,84,1943,1395,1563,20729,380
12401,11,392,1354,218,8750,174
46142,941,10641,751,7531,39923,3110
27706,13,126,1085,89,5530,37
19783,83,1693,1238,1105,10473,588
24966,23,470,1145,283,4596,187
17315,2,142,1282,127,14940,15
8029,259,7817,1384,5185,127100,2632
63774,1143,25359,252,21085,169869,4274
32859,60,1442,991,982,15798,460
7772,46,1717,1387,1173,46156,544
32979,2698,47382,989,31716,114203,15666
25562,395,6569,1133,4489,46491,2080
67063,401,6149,152,4955,41158,1194
67501,8,113,140,87,3457,26
58899,10,143,408,115,9851,28
24767,163,3005,1149,1886,16468,1119
52818,56,861,592,669,12332,192
61708,15,166,311,151,3204,15
6556,1,55,1403,37,6178,18
10790,5779,226928,1369,123383,882431,103545
14769,8,270,1322,173,5444,97
40660,1,110,825,92,4199,18
33683,25,374,976,270,6320,104
24367,1216,21329,1158,15022,114778,6307
26197,31,1425,1119,866,12669,559
204,183,8493,1469,5844,47336,2649
15380,582,18312,1314,12958,49777,5354
15165,4,234,1317,181,11300,53
30790,575,7852,1023,5246,25236,2606
18292,21,818,1264,593,21746,225
43210,89,3361,783,2593,34747,768
32866,292,8082,991,5834,75961,2248
8101,369,13374,1383,8702,44537,4672
61449,18,184,319,157,5104,27
10587,31,1194,1371,817,15086,377
58383,41,486,426,408,8594,78
54799,12,116,529,95,5396,21
12608,3574,88373,1352,48477,146892,39896
28234,2,95,1074,64,7101,31
2094,235,8141,1453,5511,101082,2630
17282,279,4269,1283,3038,23810,1231
5269,59,973,1418,686,21606,287
48015,20,951,727,839,19368,112
61539,83,1148,316,886,16987,262
31134,25,909,1019,603,6493,306
2632,1022,28739,1449,20474,63847,8265
13212,1055,22203,1344,16558,66761,5645
18814,1680,63851,1255,41976,180929,21875
14915,7555,174313,1320,100385,505926,73928
39802,26,330,838,282,9557,48
55628,2494,35304,500,26408,144804,8896
35596,43,1110,932,797,20471,313
2975,388,8772,1445,5696,33967,3076
67510,32,441,141,320,5905,121
12887,67,1528,1348,980,85100,548
15464,57,2075,1312,1438,21198,637
35999,96,1648,923,1430,18187,218
41590,25,707,809,563,15805,144
16382,71,1770,1298,1167,13817,603
4777,28,1094,1425,807,13944,287
61824,97,771,307,599,6690,172
59903,84,2037,374,1574,22388,463
34726,49,949,953,784,12507,165
64498,9,131,230,98,5507,33
19302,19,353,1246,242,13826,111
34,4289,184015,1472,85485,689446,98530
27200,10,457,1096,239,14470,218
14403,76,1326,1326,841,13323,485
57502,46,647,454,519,6814,128
24120,35,523,1164,346,6612,177
33061,3569,77844,987,62487,278771,15357
59631,43,474,384,381,9677,93
59244,135,2605,397,1915,13735,690
57368,7,184,456,131,3975,53
39718,1344,24653,839,21096,128370,3557
40386,925,8293,828,6580,74386,1713
1718,190,10447,1456,6938,72896,3509
32802,78,1225,992,805,9346,420
13723,117,5817,1336,3406,61195,2411
28014,2992,82943,1078,53420,323282,29523
68553,597,10539,101,9113,70340,1426
25398,61,1914,1136,1443,13342,471
4696,16,423,1426,308,7169,115
33513,423,32959,979,24630,96309,8329
56336,2,41,485,29,2609,12
919,75,2391,1462,1698,40138,693
55384,11,182,512,144,8688,38
48943,291,4937,704,3620,23439,1317
18360,123,3764,1263,2474,41675,1290
17699,2387,63762,1275,44136,365415,19626
10235,1952,67489,1373,43279,368332,24210
51564,33,637,633,537,16289,100
15049,10,379,1318,248,16948,131
4913,19,491,1423,372,21184,119
60732,36,513,344,428,9894,85
382,192,9962,1466,6941,72646,3021
29327,3,200,1053,120,4639,80
66838,64,1007,163,764,14256,243
9819,91,3561,1376,2071,33786,1490
8452,245,5618,1382,3719,47713,1899
3712,41,1743,1438,1304,38421,439
64210,87,2043,238,1260,28864,783
26033,783,20425,1122,12932,144919,7493
40634,621,11002,824,8708,91639,2294
36140,9,63,919,58,12244,5
62295,2,64,152,45,2249,19
27656,40,2168,1086,1282,15473,886
61321,4,166,323,110,5755,56
42070,35,399,801,311,3549,88
6872,23,484,1399,348,8777,136
32471,74,890,998,558,14712,332
36147,3121,86217,919,70282,285316,15935
7799,5,122,1386,77,5917,45
57006,33,661,466,497,12409,164
37013,8,421,896,305,8815,116
35810,40,767,928,559,7979,208
54195,11,168,551,115,12425,53
22031,59,2865,1200,1941,32835,924
29099,20,1135,1058,665,15151,470
16072,3801,212843,1302,117378,304811,95465
36265,141,3319,915,2839,35109,480
21979,15,302,1201,194,23073,108
25345,86,1056,1137,633,11212,423
52676,24,464,597,389,18107,75
28891,229,4613,1062,2829,38691,1784
64277,56,1040,235,692,11801,348
4834,8185,295526,1424,173089,725602,122437
58314,9,94,428,57,5220,37
35014,20,591,946,409,10169,182
7846,34,2031,1386,1302,59764,729
63020,62,856,272,669,4824,187
19079,45,1663,1250,1090,16839,573
33681,12,157,976,108,5873,49
65293,16,74,206,68,3498,6
65280,62,911,205,766,14019,145
65307,33,520,207,433,21435,87
51098,14,150,646,126,6186,24
29435,19,739,1052,435,7959,304
26926,38,963,1102,863,24650,100
24582,6,317,1153,274,7098,43
6491,8473,147425,1404,114115,581834,33310
27323,6,123,1094,110,12009,13
52761,54,688,594,557,10410,131
1301,13,675,1459,486,16950,189
37121,7592,142055,893,110838,565871,31217
28501,339,9262,1069,6747,90893,2515
38190,15,168,864,133,4970,35
1313,11,692,1459,450,12977,242
50587,1003,13685,659,10641,89964,3044
18660,28,646,1258,475,11654,171
31630,20,337,1011,213,4974,124
31677,41,602,1011,418,12666,184
40028,15,320,834,229,8097,91
64492,2,56,230,49,2686,7
53821,7,112,564,82,3908,30
23649,181,6265,1174,4453,107337,1812
55580,54,394,506,315,5134,79
9654,95,2586,1377,1718,38388,868
53198,4,98,581,70,8755,28
65348,36,319,205,244,3774,75
306,220,9683,1467,7369,90388,2314
21293,14,366,1211,308,18396,58
49834,1808,56354,623,42290,223475,14064
28954,111,1485,1061,1173,23617,312
31401,74,4149,1015,2472,17893,1677
21135,42,1052,1214,690,11124,362
8758,192,4630,1381,2607,27855,2023
30111,3,234,1038,120,4238,114
23217,10,751,1181,485,9404,266
432,3,229,1466,133,14003,96
32558,699,11505,996,9022,64336,2483
57434,26,899,455,763,8696,136
38374,924,13829,860,10974,61789,2855
7358,5,166,1392,110,19545,56
61640,12,106,313,93,5416,13
46618,0,0,744,0,2967,0
26387,3280,65486,1114,45315,196364,20171
16037,55,1355,1303,1025,20418,330
9864,95,1832,1375,1256,24307,576
28951,2692,52128,1061,38132,178206,13996
8194,1,167,1383,103,18145,64
17966,102,2994,1270,1863,19462,1131
44353,41,471,770,340,11120,131
21573,36,866,1206,599,8102,267
64309,49,529,235,425,4588,104
65319,218,1775,206,1397,10703,378
23523,77,4596,1176,2940,54743,1656
11918,6,243,1360,103,8331,140
28862,135,3471,1063,2089,49009,1382
5438,5,88,1416,77,4417,11
35286,3114,100477,940,71636,157501,28841
40864,45,731,821,650,18011,81
29086,3201,127823,1058,85052,252600,42771
10920,0,17,1368,13,7282,4
47110,49,1088,738,910,16765,178
9467,6,104,1378,72,7769,32
55366,29,311,512,249,11175,62
36808,46,1280,903,837,21279,443
20291,43,1199,1229,900,39330,299
46958,864,19961,722,15258,98332,4703
48250,80,1647,724,1328,15888,319
4447,29,694,1430,534,17478,160
10814,34,2370,1369,1518,56101,852
64177,17,348,239,264,6659,84
63591,104,2015,258,1601,23968,414
31251,13,353,1017,233,13357,120
7771,6,234,1387,151,7741,83
3045,38,531,1445,363,4254,168
30377,23,454,1033,368,5605,86
52281,24,395,611,278,5574,117
41515,46,952,810,745,10386,207
8096,10,112,1383,83,18072,29
876,18,1295,1462,880,46187,415
5878,71,2276,1412,1633,40431,643
20984,112,2075,1217,1406,38801,669
37964,12,241,870,202,8104,39
35774,2773,51860,927,39992,341046,11868
67306,53,752,147,583,10308,169
23219,106,2724,1181,1954,42011,770
59733,2478,60498,380,42136,226045,18362
24170,66,2288,1163,1487,71470,801
25251,1934,50639,1139,28335,146358,22304
64047,3,93,243,73,2974,20
24521,1815,74811,1155,47624,177223,27187
36821,255,5521,902,3811,19494,1710
16024,24,668,1303,464,12527,204
52159,20,331,615,267,11234,64
40093,14,257,833,201,6804,56
54380,22,504,545,382,6903,122
66645,11,116,170,94,2299,22
10345,716,16712,1372,9839,84525,6873
47807,387,4316,729,3403,29872,913
11331,28,1778,1365,764,19077,1014
12083,17,832,1358,428,15272,404
3497,3,124,1441,73,6152,51
20334,35,642,1228,420,9510,222
53024,457,6900,586,5675,27242,1225
37302,2267,37437,879,29513,282531,7924
58840,131,2058,410,1579,14160,479
19869,629,19418,1236,13429,158827,5989
35539,12,188,934,144,4110,44
54137,24,357,553,250,55325,107
23474,9,295,1177,219,10426,76
24913,45807,1292787,1146,725361,4197738,567426
17458,88,5278,1280,3379,74735,1899
1681,63,1725,1456,1204,25435,521
59463,4621,82667,386,59713,445073,22954
62697,11,94,280,67,2788,27
30624,64,1700,1028,1132,8790,568
20101,36,1622,1232,1141,44031,481
1541,31,1107,1458,796,28222,311
4121,100,3561,1434,1891,29488,1670
14651,904,42211,1323,27934,276257,14277
45079,124,1386,762,1036,18202,350
4058,169,2954,1434,2440,16954,514
62144,353,4901,295,3958,42876,943
32372,714,26956,1000,18002,161243,8954
12963,248,6707,1347,4108,74018,2599
15116,74,3132,1317,2160,35453,972
14910,4,419,1320,293,9949,126
29855,26,621,1043,374,13177,247
61999,22,287,301,219,9812,68
38470,1162,16755,857,13465,41444,3290
20054,3174,97843,1233,63071,311365,34772
21689,5277,141036,1205,90218,415659,50818
28146,45,860,1076,593,13846,267
56576,14,164,478,141,6907,23
17344,59,1041,1282,800,23996,241
4714,119,2796,1426,2042,19695,754
702,77,4307,1464,3053,35108,1254
7135,54,2590,1395,1696,66206,894
56255,8,97,487,74,3319,23
36231,726,18680,916,14073,149274,4607
40662,8,109,825,78,3783,31
34956,102,2309,948,1470,20470,839
67536,6,109,140,82,2046,27
21788,39,763,1203,541,22992,222
8865,346,6965,1380,4310,37128,2655
44928,71,1264,764,904,12762,360
15426,19,862,1313,538,17817,324
63501,183,5398,258,3862,41181,1536
13618,23,1176,1338,821,31204,355
57617,1,33,451,27,4851,6
8455,11,414,1382,293,6960,121
20435,24,442,1227,282,7010,160
29330,42,465,1053,374,10120,91
49461,79,1460,689,1208,23741,252
40802,8,269,822,194,8261,75
25447,45,2122,1135,1237,16088,885
65761,729,10684,195,8780,96360,1904
33713,1150,29289,975,20564,69580,8725
38134,102,1759,866,1362,17231,397
14538,5,66,1324,47,4866,19
23505,5,354,1176,256,10994,98
27562,2038,38375,1088,25343,193257,13032
62450,804,9566,287,7923,68701,1643
19602,9,257,1241,160,6477,97
34217,15,493,965,318,10143,175
59910,3,295,374,232,9475,63
36954,608,10869,899,7843,60735,3026
4753,470,18699,1425,12271,138659,6428
14692,11179,442947,1323,274594,771474,168353
58588,25,434,418,345,10846,89
60738,1096,16573,344,13990,132315,2583
2684,4,210,1448,147,12926,63
15344,46,1306,1314,916,11613,390
55697,4,109,503,90,14255,19
5766,16,478,1413,330,23007,148
4638,25,810,1427,589,14844,221
24734,27,453,1150,327,4421,126
57059,50,1097,464,718,20219,379
21656,1490,36215,1205,25380,259315,10835
63272,16,165,266,137,3126,28
17499,560,12407,1279,8178,52718,4229
6314,5,347,1406,260,22668,87
57530,2495,47080,453,36654,293952,10426
9652,25,1196,1377,746,14447,450
54164,11,163,553,136,8225,27
13509,34,1113,1339,693,12662,420
14246,412,13067,1328,8403,70015,4664
23129,198,4227,1182,2828,49250,1399
12865,563,20717,1348,11990,114565,8727
58204,7,140,432,116,7819,24
33155,54,1134,986,765,14787,369
52844,11,131,591,90,5084,41
43449,9,194,780,140,16654,54
47845,96,1710,729,1247,13199,463
18008,9120,244414,1269,160624,1357932,83790
16620,52,4727,1294,2585,36380,2142
24565,1344,140497,1154,95839,318527,44658
34045,64,2080,969,1363,32480,717
35775,64,1592,929,1216,25230,376
28043,472,22639,1078,15613,131288,7026
7866,85,954,1385,644,11402,310
66121,49,449,185,387,5255,62
19180,4448,114434,1249,75102,435393,39332
29432,1160,21786,1052,14859,117359,6927
87,976,44433,1470,26419,171305,18014
21901,97,4519,1202,2926,19486,1593
42794,187,3528,789,2654,40066,874
21790,965,22574,1203,13482,88764,9092
68940,3,14,93,11,1913,3
63871,1,7,249,4,2380,3
10552,261,8984,1371,5649,43335,3335
36287,23,331,915,283,8900,48
5515,16,242,1416,176,7913,66
21337,177,5185,1210,3773,32736,1412
49199,95,934,696,750,17743,184
53022,173,5718,586,4589,17237,1129
284,20,696,1467,463,74212,233
42972,14,236,787,179,12443,57
49852,168,2120,678,1584,19065,536
37276,19,539,888,377,8933,162
14947,1708,32566,1320,21849,129757,10717
43468,32,352,780,279,5584,73
841,49,1772,1463,1287,20836,485
40316,981,14251,830,10993,171452,3258
37525,11,268,882,204,11689,64
38841,86,1284,849,1030,19980,254
37680,14,433,878,359,10007,74
51162,143,1240,644,1051,27967,189
1615,8,212,1457,158,9511,54
1866,5,165,1455,129,10143,36
16544,62,2031,1295,1365,28827,666
6478,83,3242,1404,2235,21436,1007
35519,12,275,934,152,5292,123
38477,10,210,857,162,4731,48
52565,29,658,601,482,16536,176
4056,425,14919,1435,9549,46936,5370
12173,27,1127,1357,614,14037,513
11299,45,1078,1365,709,12331,369
24165,46,1845,1163,1189,19820,656
3076,11,177,1445,120,15136,57
11507,81,2131,1364,1341,18750,790
52261,63,1198,612,821,24854,377
66078,9,100,187,73,2834,27
58271,14,210,429,162,3269,48
55368,434,6044,512,4690,67928,1354
34067,159,2713,968,1965,37586,748
56601,69,1364,477,1023,10494,341
8056,116,6042,1384,3219,51444,2823
38366,91,1126,860,873,13638,253
32941,0,39,990,28,3636,11
10457,19,702,1372,454,16004,248
62927,5,52,274,33,5846,19
47685,25,495,731,383,6926,112
27635,417,4614,1086,4031,52961,583
4270,38,858,1432,542,18743,316
18596,264,4821,1259,3390,60789,1431
24415,161,4450,1157,2951,25811,1499
765,92,6554,1463,4096,88983,2458
10854,0,1828,1369,1085,48747,743
50716,11,238,657,167,6713,71
23290,11,378,1180,240,4888,138
67460,43,627,143,579,6635,48
27944,35,1280,1080,753,13981,527
7168,30,642,1395,386,10300,256
37351,261,3837,886,3044,27837,793
61398,64,2338,321,1705,14121,633
62233,152,3975,293,2830,32721,1145
61882,4,88,304,71,11935,17
3599,3,123,1440,93,8396,30
11272,72,2439,1365,1468,33309,971
54967,1673,26762,521,21096,210556,5666
58252,4,75,430,61,3911,14
33178,15,414,985,278,7046,136
64286,181,2069,231,1798,17154,271
7163,601,10766,1395,7688,106788,3078
34818,6,176,951,124,4824,52
51138,4,49,645,39,2255,10
26618,21,1127,1109,718,16603,409
30749,6,175,1025,108,5544,67
67092,40,686,155,601,13691,85
27422,183,4430,1091,2703,30165,1727
20744,47,1702,1222,1105,28419,597
59398,11,196,392,161,7717,35
36153,23,776,919,628,13901,148
6279,99,8017,1407,4885,39143,3132
40676,149,1091,825,784,12356,307
66283,4,64,181,36,3460,28
41177,27,383,816,277,6726,106
9173,21,928,1379,505,7648,423
33570,7,138,978,115,7662,23
9250,55,1359,1379,837,25114,522
64614,15,136,226,122,5309,14
1104,282,10366,1461,7150,63522,3216
31688,20,569,1010,346,4111,223
68779,7,151,99,112,2412,39
65800,10,80,194,60,2982,20
4341,171,3997,1431,2704,47077,1293
14921,29,1363,1320,991,27003,372
61721,35,396,311,324,10414,72
8198,143,2881,1383,1686,20840,1195
17960,178,3084,1270,2159,40553,925
7700,517,10367,1388,6791,86979,3576
40631,38,951,825,663,20304,288
60262,20,236,362,206,18935,30
5085,84,1189,1421,857,11877,332
51667,0,471,630,421,10432,50
57827,8,81,444,69,2103,12
61822,20,187,307,142,2252,45
32719,16,598,994,368,10583,230
35335,23,610,938,466,20051,144
2611,6,220,1449,149,18737,71
32871,77,1567,991,1133,16914,434
65658,172,2863,198,2482,35615,381
60032,4,75,370,53,6553,22
833,29,764,1463,557,29874,207
33477,167,5379,980,3295,20904,2084
1285,19,823,1459,560,10391,263
19117,0,0,1250,0,22514,0
9949,10,620,1375,393,10848,227
3317,80,4164,1442,2529,19644,1635
41278,8,303,814,224,5610,79
20901,49,1811,1218,1233,37240,578
1441,8,651,1458,475,12923,176
57583,13,134,452,107,8708,27
6736,16,718,1401,479,11418,239
62140,113,1061,293,820,12374,241
57721,203,4265,447,3344,39151,921
37440,6268,229999,881,172155,853707,57844
49777,501,5774,680,4384,36372,1390
43617,62,714,778,561,12928,153
67545,121,1742,140,1516,19959,226
53652,10,124,569,87,9262,37
332,43,1479,1467,1054,23613,425
41277,23,525,814,443,13448,82
21731,18,420,1204,300,10533,120
19656,135,5128,1240,3617,44999,1511
22816,2293,66623,1188,44183,362978,22440
55921,596,6262,497,4563,146714,1699
2367,14,449,1451,332,9620,117
17469,9,363,1280,271,6698,92
38289,5,164,862,126,9209,38
28572,91,1398,1068,911,14775,487
17129,26,356,1286,289,8053,67
20365,21,442,1228,286,19435,156
16103,3476,75047,1302,54270,449050,20777
19901,6,215,1236,168,11950,47
55174,25,212,518,167,3293,45
21769,15,251,1204,161,6475,90
49419,182,3026,688,2559,39946,467
35109,99,2585,944,1900,30618,685
52269,583,24954,611,20019,94518,4935
62090,1034,17275,298,14153,121253,3122
5033,8,119,1421,63,8037,56
32435,5,445,999,264,8847,181
58980,4246,119329,406,86248,228805,33081
8081,5,215,1384,126,6061,89
4914,37,1885,1423,1193,9636,692
64726,32,439,223,310,5570,129
3552,97,3397,1440,2564,44585,833
38085,180,2490,867,2077,30629,413
67426,9,34,144,30,1247,4
33207,23,498,985,345,7997,153
36769,346,4816,903,3895,37221,921
22743,227,7881,1189,5285,91188,2596
43333,90,1042,782,859,36376,183
49206,1891,21110,696,15942,72463,5168
19393,11,352,1245,275,12463,77
62319,39,360,291,289,6439,71
60471,33,315,354,281,6097,34
54325,596,13816,547,10862,37055,2954
61022,934,19677,334,16843,80552,2834
67745,22,518,134,382,13845,136
8974,32,844,1380,531,8749,313
43873,128,1761,776,1272,14194,489
20528,212,8169,1225,5827,56583,2342
58751,53,743,413,601,8434,142
47051,14,377,739,300,8008,77
22865,4,492,1187,325,9710,167
63831,29,290,251,234,6643,56
58972,28,212,406,165,4177,47
54579,42,709,537,527,28843,182
29337,5,131,1053,84,8387,47
24993,31,1157,1144,812,15918,345
11250,6,634,1366,340,10768,294
66508,106,1100,174,908,13107,192
34452,267,6918,960,4823,62521,2095
24341,314,7395,1159,5402,40006,1993
21063,41,944,1215,638,16197,306
32598,5929,129562,996,95235,531672,34327
29151,20,648,1057,388,14191,260
1828,158,9514,1455,6788,44673,2726
623,54,1605,1464,1170,20817,435
59272,522,6769,396,5670,48790,1099
64453,9,227,231,162,7007,65
23072,265,4105,1183,2602,37563,1503
31822,1480,34368,1008,23714,143179,10654
1426,39,702,1458,484,25372,218
19339,0,66,1246,36,4565,30
26336,447,15637,1116,10284,67144,5353
64125,1238,13901,240,11014,63534,2887
1750,99,2490,1456,1767,26190,723
60098,109,875,365,660,9952,215
47195,174,1822,737,1339,11896,483
13822,23,656,1335,388,30341,268
23097,28,796,1183,527,37696,269
62510,20,175,285,139,2643,36
62833,77,707,277,557,5505,150
29299,10,384,1054,246,9426,138
29706,92,3254,1047,2167,42372,1087
15356,58,1258,1314,884,26337,374
42915,28,738,787,581,19738,157
22531,3,202,1193,150,7777,52
56203,34,323,489,253,3847,70
37840,2,24,874,23,9277,1
6530,9,398,1403,302,21792,96
15322,105,3329,1315,2091,31556,1238
3416,63,1226,1441,838,14999,388
39182,5,103,845,75,3891,28
59331,2166,31475,394,26193,166453,5282
34712,11,550,948,404,9908,146
31017,47,1896,1020,1173,15397,723
64039,18,188,244,143,6933,45
62564,83,847,284,699,12843,148
66543,61,559,173,489,10738,70
10632,91,2021,1370,1305,13716,716
49025,53,555,701,512,11820,43
11219,912,25952,1366,16855,83315,9097
3099,22,667,1444,433,46747,234
23754,51,854,1171,597,29400,257
62138,239,4714,296,3678,44320,1036
33405,78,1627,981,1071,15175,556
38050,6,154,868,110,8507,44
25656,2,83,1130,50,6466,33
6166,2005,103467,1408,66633,472580,36834
34728,33,709,953,500,15886,209
58302,8,133,428,117,20002,16
7274,485,8643,1393,5729,39309,2914
17576,4,274,1277,209,6439,65
9323,1321,42808,1378,23608,174242,19200
50305,24989,501387,667,273567,1726591,227820
68250,9,75,118,68,2401,7
30768,10,310,1025,211,4798,99
57016,14,167,466,129,5984,38
27953,120,1788,1079,1126,19045,662
5193,117,2974,1419,1997,53376,977
32803,38,694,992,452,14102,242
68926,19,297,94,260,6342,37
49398,36,574,690,456,19564,118
68720,232,5161,101,4706,19426,455
26309,16,671,1116,351,6219,320
24643,79,1604,1152,968,7974,636
40522,41,363,826,300,5551,63
66799,1,14,164,11,1429,3
14313,6,183,1328,122,7134,61
64699,437,8632,224,6669,84834,1963
22884,129,7095,1187,4765,68415,2330
2985,94,2421,1445,1656,22666,765
31431,430,9220,1014,6206,74829,3014
37271,132,1821,889,1266,26642,555
14998,47,1754,1319,1315,22578,439
32592,2041,22845,996,15774,71815,7071
8146,13,412,1383,251,14572,161
24025,100,1867,1166,1345,50601,522
19016,75,1980,1252,1453,56255,527
68005,584,8027,125,6181,45833,1846
38219,76,1386,863,1064,18294,322
45759,41,617,755,494,12424,123
12230,549,25031,1356,12707,136478,12324
14312,35,905,1328,669,30156,236
35377,19,343,938,271,4985,72
68205,5,116,119,90,2377,26
31958,130,1998,1006,1306,24666,692
65343,9,92,206,68,4483,24
16562,29,1637,1295,1038,12743,599
26767,63,2527,1106,1435,44888,1092
16197,2005,40776,1301,28953,177413,11823
16971,97,2846,1288,1898,49663,948
61962,233,8588,303,7029,44042,1559
9619,24,1209,1377,807,13867,402
33884,95,2243,972,1409,16480,834
68562,13,235,106,201,4195,34
6626,36,1578,1402,1127,37600,451
49472,4838,76037,688,57341,294086,18696
62785,9,132,278,98,5552,34
1894,40,820,1455,585,29028,235
36737,14,202,902,165,7567,37
20332,1,102,1228,74,3697,28
50293,5,70,667,60,2747,10
18554,32,557,1260,408,12021,149
770,351,11814,1463,6752,34323,5062
62021,14,325,300,252,5146,73
21452,76,2092,1208,1317,35933,775
67576,4,101,139,81,3111,20
26568,756,19453,1110,11326,102730,8127
46299,14,269,749,195,9090,74
182,141,3761,1469,2737,42450,1024
54204,107,1399,551,1283,20532,116
18658,95,1688,1258,1218,20555,470
34771,19,690,952,493,10404,197
25098,580,7944,1142,5011,46874,2933
5632,523,15929,1414,9959,69572,5970
55112,5,46,519,37,2931,9
55199,14,227,517,142,7076,85
51054,7,76,647,64,4829,12
6193,33,1112,1408,729,12233,383
67777,53,782,133,643,13351,139
28991,1727,50282,1060,30215,210989,20067
61620,125,1565,313,1219,14977,346
17157,79,1759,1285,1384,19316,375
48737,11,538,711,339,10879,199
27231,52,1866,1096,996,26462,870
65575,19,178,200,119,5638,59
34146,22,657,967,428,6283,229
54826,195,1374,528,1061,12630,313
578,154,9673,1465,7422,114691,2251
33627,33,1869,977,1037,15809,832
949,62,3771,1462,2529,23238,1242
9552,33,1141,1377,815,40071,326
9458,1149,27872,1378,17137,124532,10735
46685,350,6515,743,4531,40728,1984
4234,9,170,1433,130,17844,40
31768,17,383,1009,235,5605,148
47149,53,875,738,673,17744,202
39018,2177,43753,847,34613,239843,9140
7175,5,429,1394,260,10048,169
1306,2486,71670,1459,39577,132381,32093
34180,76,1481,966,1090,24131,391
24208,6,214,1162,155,8102,59
50379,374,6090,664,4710,54574,1380
68404,6,94,113,68,4874,26
15152,4226,151669,1317,98662,256841,53007
22155,1168,35692,1198,22185,183951,13507
31852,23,445,1008,383,14372,62
19720,4,152,1239,127,11780,25
34860,7,270,950,185,8850,85
49663,18,98,683,75,6131,23
35739,9,614,929,411,10741,203
68244,5,43,118,39,3628,4
38393,739,26811,859,19396,109099,7415
42089,3014,69377,801,55098,207665,14279
64012,10,87,244,78,5696,9
22212,33,1163,1198,765,13050,398
27893,5,186,1081,126,14934,60
63488,4,62,260,43,4413,19
54364,345,3214,546,2521,12351,693
53492,50,791,574,577,7263,214
52289,130,824,611,652,14264,172
63878,71,422,249,325,6571,97
16854,100,1911,1290,1224,16885,687
33796,181,5178,974,3707,44227,1471
20191,55,2684,1231,1902,22361,782
23353,2325,38244,1179,25762,141494,12482
36541,6,184,907,153,7994,31
19534,527,22672,1242,16396,141041,6276
13248,473,9492,1343,7175,52624,2317
62229,1,86,293,58,1440,28
60156,20,361,366,283,6987,78
9514,5479,100490,1377,64739,310858,35751
23972,823,19671,1167,16345,106826,3326
56039,21,325,493,253,3968,72
20377,8,494,1228,382,12081,112
59998,23,172,371,145,5030,27
63381,1,19,263,17,6603,2
26133,9,197,1120,130,5242,67
57275,3,88,459,74,2990,14
40022,12,388,834,345,9126,43
54252,113,990,549,757,36150,233
14798,15,502,1321,329,6986,173
29536,13,310,1050,284,15945,26
15289,8,602,1315,396,20818,206
15688,21,438,1309,340,9441,98
16799,105,2054,1291,1510,24971,544
26555,16,766,1110,517,22692,249
23764,12,877,1171,696,10779,181
59386,861,19727,392,16212,121646,3515
18786,34,760,1256,452,8498,308
28356,11,506,1072,321,13178,185
27229,70,1380,1096,907,75272,473
39365,22,437,843,303,11618,134
55099,46,981,517,761,23579,220
14111,42,1101,1330,788,17426,313
2501,9,308,1450,232,15410,76
3967,97,3813,1435,2624,26118,1189
4950,202,5708,1423,3838,51240,1870
18525,75,2868,1260,2054,26707,814
717,6,512,1464,341,5884,171
49100,11,219,699,170,5242,49
22925,8,287,1186,197,6955,90
7065,44,1652,1396,1163,22747,489
9023,42,1006,1380,646,14154,360
22768,63,2481,1189,1805,29690,676
25768,68,1939,1128,1184,16360,755
6038,18,1107,1409,783,35649,324
25499,415,14276,1134,9343,76517,4933
19462,9,158,1244,133,7640,25
66495,47,435,174,367,9192,68
4592,4,156,1427,101,7035,55
66763,3,148,165,56,2538,92
1351,16,839,1459,596,17441,243
12684,675,17120,1351,10261,107587,6859
58341,645,10377,427,8150,81230,2227
2263,5,168,1452,118,19606,50
36370,388,4634,912,3858,53325,776
22054,244,8335,1200,5030,94936,3305
62115,2,39,297,33,3219,6
25869,2285,66333,1126,42011,395530,24322
5266,206,4289,1418,2873,34315,1416
56798,53,972,472,748,24737,224
35336,31,789,938,552,9972,237
67567,248,4254,139,3537,52906,717
56184,25,328,489,239,6664,89
9939,8,396,1375,242,12600,154
12157,410,31294,1357,18113,167849,13181
51135,101,1545,645,1263,17309,282
17229,138,2828,1284,2051,22579,777
16585,30,624,1295,444,17676,180
32833,185,2811,992,1798,23474,1013
809,596,17232,1463,11124,73030,6108
27869,752,19986,1081,13718,150940,6268
1661,433,11416,1457,7806,53227,3610
68984,2,23,92,19,4662,4
20495,69,1097,1226,834,11360,263
26294,17,786,1117,503,13610,283
22087,33,1180,1199,845,27517,335
42704,85,1366,787,1195,23287,171
45642,4174,96138,755,76091,313700,20047
24355,212,4374,1159,2820,31357,1554
18223,14,1385,1265,1024,36825,361
22164,21,1729,1198,1313,21636,416
18634,1,107,1258,91,14614,16
15066,16,1049,1318,711,47921,338
31078,34,925,1019,561,17820,364
54366,41,548,545,441,7591,107
63111,1024,12491,270,9687,92156,2804
31682,34,870,1010,691,11688,179
21446,0,0,1208,0,4826,0
25834,118,3944,1127,2320,14294,1624
5277,8,157,1418,112,8304,45
57213,88,749,461,595,17633,154
17539,1188,46190,1278,30812,226878,15378
10977,11,499,1368,295,9804,204
9701,407,7064,1376,5018,36613,2046
55153,258,2504,518,1959,16537,545
26969,24,401,1101,259,10980,142
56723,12,223,474,166,7634,57
56833,49,351,471,290,4604,61
57251,39,701,460,486,13043,215
13849,172,7587,1334,5229,56415,2358
19298,43,1166,1246,774,20902,392
23186,29,1173,1181,797,11364,376
29624,127312,3735954,1048,2613280,8739773,1122674
64431,50,684,231,573,7370,111
1242,1,107,1460,76,16586,31
15509,7,349,1312,250,12792,99
30712,23,1327,1026,942,16364,385
40121,36,380,832,279,5622,101
27465,15,380,1091,226,3305,154
15257,28,857,1316,608,13291,249
26337,36,1165,1116,970,28861,195
9689,97,2896,1376,1838,29580,1058
25230,39,526,1140,335,8235,191
24864,70,1480,1147,1005,15366,475
2610,157,9633,1449,5836,47279,3797
29834,22,519,1044,329,15195,190
42558,5,209,794,121,17062,88
57547,179,2849,453,2369,17092,480
46301,54,473,749,366,9822,107
49923,71,1199,676,958,11572,241
44737,9,128,766,84,4115,44
36894,23,356,900,265,16125,91
763,10,423,1463,289,12893,134
39012,191,3084,847,2366,14839,718
32503,149,2101,997,1480,34014,621
67773,48,522,133,424,7628,98
19606,130,2639,1241,1611,13674,1028
3115,25,926,1444,729,9766,197
61489,66,958,318,794,10490,164
31248,19,572,1017,381,10425,191
24324,21,780,1159,522,9798,258
58028,233,1922,436,1417,14935,505
5933,92,2734,1411,2162,57225,572
53100,2685,82606,583,59805,470573,22801
55864,2,36,499,23,2906,13
557,8,536,1465,374,22008,162
7189,281,5842,1394,3911,73719,1931
30685,90,1058,1027,751,17165,307
67624,5,37,137,32,2881,5
37474,43,731,883,651,31449,80
18527,16,395,1260,302,6184,93
35873,21,559,926,437,13563,122
28653,27,835,1066,544,13819,291
8676,609,42748,1381,25077,302133,17671
22542,322,5905,1193,4289,69973,1616
68577,40,926,106,793,15862,133
54819,308,12041,528,6178,41228,5863
40960,25493,345264,819,233571,1802404,111693
44536,22,702,768,518,10579,184
22911,95,1932,1186,1358,19799,574
16085,210,5674,1302,3774,60309,1900
55983,94,1839,493,1393,13551,446
24086,3,164,1164,116,11925,48
1366,2,290,1459,196,11934,94
68698,20,355,102,281,3445,74
1854,487,18361,1455,12900,129116,5461
17859,115,3840,1272,2807,47819,1033
53490,13,286,574,218,6787,68
27714,98,2258,1085,1510,44529,748
11675,12,858,1362,431,11706,427
66359,12,107,179,100,4025,7
41621,16,444,809,351,7416,93
51875,28,454,625,336,10751,118
64396,6,154,232,111,2567,43
1886,13,684,1455,454,15983,230
587,227,7705,1465,5243,89552,2462
51194,216,2007,643,1597,50890,410
30906,156,3425,1022,1940,27559,1485
49086,11,155,699,126,4822,29
36434,8,118,910,85,3466,33
33082,311,6910,986,5066,67792,1844
67791,53,744,132,586,11099,158
27853,879,16654,1082,11378,199695,5276
8189,44,1174,1383,779,25690,395
46344,2,80,749,53,3639,27
63273,103,1482,266,1226,17476,256
32785,390,14577,993,9787,48684,4790
23198,13,288,1181,184,4800,104
55926,6,33,497,29,4327,4
18252,5,104,1265,78,16479,26
29122,3,301,1057,189,5476,112
20462,3,69,1226,57,7229,12
59480,62,1607,389,1310,11328,297
39202,558,13160,844,10641,34104,2519
57215,9,71,461,61,1838,10
62721,42,384,279,288,7060,96
51104,101,2395,646,1819,35208,576
48946,19,174,704,156,8290,18
3037,3,382,1445,286,27885,96
14500,2,95,1325,73,10464,22
16181,295,6282,1301,4377,51344,1905
4778,700,16365,1425,11099,48114,5266
65194,31,562,209,486,8363,76
3943,92,2401,1436,1669,16203,732
22037,526,16465,1200,11176,164436,5289
32747,270,6873,994,4653,44008,2220
52508,4,79,603,51,5018,28
21631,3603,104572,1205,65229,294512,39343
52365,57,904,609,683,21212,221
1094,459,20784,1461,11422,120482,9362
50837,16,375,654,312,10138,63
66030,16,201,188,180,4565,21
52541,872,30818,602,24295,181071,6523
21068,6,441,1215,283,7240,158
59651,43,378,383,292,5401,86
63267,7,56,266,47,2292,9
10110,74,1513,1374,901,10895,612
32208,5,214,1003,144,6122,70
47200,184,3262,737,2542,68776,720
38636,190,2113,853,1767,23379,346
9486,609,11324,1378,7306,40316,4018
56733,11,117,473,95,3496,22
7685,26,1215,1388,778,49476,437
66954,6,97,159,66,4901,31
4626,54,1768,1427,1225,28693,543
5782,35,1726,1413,1140,10093,586
41460,400,5224,812,4083,39443,1141
309,20,1201,1467,844,25764,357
26686,30,717,1107,442,11690,275
20923,7338,264167,1218,184314,731845,79853
65238,1186,17186,208,13861,54172,3325
62211,30,401,294,348,10585,53
44298,33,569,771,414,10660,155
21272,100,2626,1211,1908,20351,718
28570,26,317,1068,205,5775,112
12183,114,9684,1357,4800,100753,4884
25832,3950,169903,1127,102162,598086,67741
68547,17,307,107,210,4362,97
32949,2007,37480,990,23783,114971,13697
8987,1709,56112,1380,34925,148238,21187
51197,12,110,643,79,3630,31
5089,63,1105,1421,729,30334,376
53681,341,4528,568,3765,41176,763
27116,206,4504,1098,3120,29433,1384
68211,193,7004,119,5456,40814,1548
11677,101,2702,1362,1713,13494,989
3130,0,154,1444,118,14829,36
62966,13,72,273,57,8386,15
15395,49,856,1313,590,12996,266
2342,35,1386,1451,1052,26576,334
23476,568,10650,1177,7433,106275,3217
51581,0,51,633,32,6055,19
8952,0,0,1380,0,9321,0
18014,1282,66803,1269,43339,436246,23464
33482,1624,26657,980,18603,126704,8054
33215,136,4196,985,2736,26491,1460
27308,723,24605,1094,15719,161955,8886
36044,81,1278,921,1000,11463,278
3011,306,7176,1445,4634,65923,2542
31282,145,3526,1016,2188,30742,1338
63555,14,260,259,219,7263,41
57009,93,1132,460,853,7316,279
20053,1,51,1233,35,8234,16
35147,44,1339,943,895,27937,444
64493,33,345,230,287,5999,58
23140,60,961,1182,823,39294,138
61668,20,125,313,94,6467,31
20726,40,1019,1222,722,12435,297
5600,4776,239526,1415,141061,1325009,98465
48754,0,43,710,28,5098,15
21617,215,4394,1206,2880,38141,1514
9494,25975,1189416,1377,678759,3352158,510657
62222,3,115,294,84,1810,31
11536,234,16678,1363,8399,74820,8279
63960,41,437,246,350,5449,87
48645,278,2585,713,1909,17511,676
31450,2393,40187,1014,23777,187189,16410
31965,21,588,1006,393,6740,195
27413,1568,30421,1092,21556,147174,8865
51771,151,1267,627,1047,20135,220
56013,56,1092,495,808,27874,284
64896,43,588,217,468,11273,120
23197,29,590,1181,460,11527,130
25742,19,541,1128,330,15596,211
55677,3949,60557,504,47920,347436,12637
10320,12,415,1373,262,36456,153
20572,71,2480,1225,1741,14290,739
26087,637,12200,1121,7708,32789,4492
5785,89,3758,1413,2979,63027,779
17990,16,455,1269,343,19735,112
65177,27,393,209,324,7510,69
55396,291,3468,511,2659,31282,809
27855,303,2153,1082,1375,22228,778
55095,98,1207,520,1052,16799,155
36794,211,3517,903,2895,37276,622
65992,9,69,189,52,3069,17
50210,36,376,669,294,7297,82
58880,37,645,409,512,10760,133
25960,22,244,1124,208,5874,36
8737,8,378,1381,259,58638,119
13438,2,136,1340,73,6741,63
51870,296,2012,625,1535,21623,477
1752,638,35233,1456,24847,187954,10386
960,213,6641,1462,4169,44563,2472
21112,8,579,1214,408,11883,171
52363,15886,234892,609,170473,833860,64419
59700,2676,50618,381,40528,277436,10090
37066,6,144,895,108,2787,36
34906,13,392,949,262,3522,130
33378,159,2036,982,1430,11567,606
60496,29,341,353,310,14778,31
46640,4,45,744,32,3767,13
18099,1,87,1268,65,5442,22
898,73,1555,1462,1170,77666,385
1673,0,67,1457,54,13355,13
2706,2843,54648,1448,37210,149799,17438
10652,8199,221010,1370,135162,581764,85848
23821,10,328,1170,238,8005,90
4456,65,3023,1430,2151,41340,872
63049,69,1732,271,637,10790,1095
60144,198,3031,366,2333,29092,698
26774,35,2218,1106,1325,24229,893
35446,22,505,936,360,11238,145
38488,184,3637,856,3007,47678,630
6758,24,570,1400,402,9295,168
53823,10,174,564,130,6657,44
50153,16,309,671,237,9003,72
17907,16,543,1271,354,15678,189
16151,41,1389,1301,939,16555,450
38320,26,389,861,284,7473,105
29688,1533,85690,1047,59576,186814,26114
31096,379,10932,1019,6807,51496,4125
53786,26,352,565,285,15605,67
22141,58,1596,1199,1171,21924,425
6527,3,65,1403,52,13686,13
60701,11,134,345,116,8467,18
22063,32,1084,1200,709,45796,375
21138,605,14870,1214,10455,96767,4415
52093,646,9868,617,8151,91598,1717
56890,21,421,469,341,9291,80
13371,139,3434,1341,2127,20902,1307
50826,13,174,654,149,5481,25
23919,240,8560,1168,6105,69708,2455
12812,319,8006,1349,5183,42474,2823
32227,340,8120,1002,5791,60255,2329
33544,203,3046,979,2204,23056,842
9583,954,38955,1377,25206,140252,13749
3858,40,995,1437,638,51379,357
49740,144,2808,681,2395,26445,413
54301,12,126,547,102,4266,24
4088,16,903,1434,615,15667,288
15270,25,884,1315,621,31134,263
35496,1116,24109,935,18932,156173,5177
21116,14,266,1214,214,13617,52
62340,304,3672,290,2843,27983,829
24792,25,1404,1149,882,16079,522
15468,5,374,1312,279,7751,95
2869,61,2214,1446,1497,42314,717
68003,1,12,125,10,1031,2
38797,2,23,849,20,1717,3
66767,8,182,165,145,5466,37
6450,419,20372,1404,12703,86762,7669
33314,128,3783,983,2725,31122,1058
58620,210,3208,416,2033,29531,1175
4769,149,7603,1425,5181,27353,2422
15385,6,186,1314,120,2979,66
1332,254,9767,1459,7088,56174,2679
68709,31,404,101,333,8609,71
9011,157,5462,1380,3962,31048,1500
41897,81,1825,804,1468,52812,357
58160,52,574,433,471,5360,103
33900,8,279,972,183,7158,96
23339,10,371,1179,274,12756,97
19029,35,1602,1251,1140,66576,462
15150,6,566,1317,449,9947,117
57125,54,1212,463,944,13376,268
63830,3,69,251,47,2355,22
35252,1295,30026,941,20484,182970,9542
23062,111,2191,1183,1460,33303,731
12382,7,519,1355,273,6958,246
21869,60,2149,1202,1390,22369,759
1913,47,1398,1455,963,25004,435
8001,15,441,1385,271,12996,170
23179,6539,132564,1182,88579,386674,43985
53107,79,1332,583,1046,12003,286
54131,12,96,553,82,2435,14
33053,20,524,988,370,5319,154
49803,23,248,679,190,6024,58
26981,92,1197,1101,677,10079,520
38231,40,697,863,599,16087,98
49870,22,1066,678,602,6816,464
15377,0,0,1314,0,12756,0
27264,15,830,1095,494,23168,336
37204,2411,50897,888,41627,398796,9270
32846,2167,56682,992,39103,402157,17579
40915,2304,89568,820,72494,386422,17074
53226,930,9663,580,7714,74079,1949
67724,11,68,135,60,1506,8
53655,85,686,569,512,7850,174
49846,36,906,679,701,12952,205
52110,27,303,617,243,5203,60
11358,44,1888,1365,1315,27232,573
55363,51,833,512,686,20066,147
11784,3220,172926,1361,81993,800444,90933
8457,115,3713,1382,2379,20728,1334
21673,63,2116,1205,1203,18468,913
20689,5,133,1222,94,7686,39
43115,169,2346,784,1993,27846,353
870,66,3190,1462,2262,50186,928
20910,960,19119,1218,12468,65799,6651
3477,3,147,1441,107,13468,40
25344,373,10627,1137,6253,30058,4374
60619,260,4168,349,3510,23820,658
48923,52,499,704,380,9655,119
55899,209,3372,498,2568,23579,804
12633,59,2405,1351,1415,26842,990
61361,935,12587,321,9928,138256,2659
63096,12,102,270,85,3433,17
17688,26,355,1275,268,8687,87
39962,234,3154,835,2779,34725,375
53252,4,174,580,133,4661,41
67315,19,315,147,255,11879,60
2850,71,4522,1447,2922,26634,1600
18543,189,11022,1260,6831,49206,4191
11322,244,3607,1365,2595,29923,1012
26659,21,631,1108,360,9050,271
14412,251,6653,1326,4394,45908,2259
31352,96,1905,1015,1371,17171,534
7643,3728,116133,1389,73336,277871,42797
61936,75,1240,303,1013,21934,227
6217,14,472,1407,332,4253,140
6384,143,3318,1405,2318,66496,1000
38179,55,851,865,677,10082,174
60172,34,444,365,393,12027,51
11321,10,598,1365,337,13103,261
31986,139,2025,1006,1473,9504,552
67783,17,444,132,310,8845,134
51243,6,50,642,40,3229,10
64501,31,253,229,208,4043,45
4667,6,556,1426,359,21021,197
23728,28,467,1172,295,5433,172
22644,1343,27240,1191,18760,102013,8480
1421,336,11677,1458,7887,65337,3790
51443,72,990,637,611,8188,379
24037,14,437,1166,352,12281,85
21131,42,1693,1214,1170,24206,523
16465,455,11337,1296,7895,96146,3442
7706,3,228,1388,161,7831,67
2507,425,20212,1450,12586,72500,7626
33136,40,1299,986,829,16394,470
48334,167,6174,722,5017,66480,1157
65278,252,847,207,735,27831,112
55887,30,302,498,219,4603,83
59223,27,503,131,386,6230,117
54535,976,32091,539,25690,140082,6401
7514,27,631,1390,496,8602,135
47077,28,557,739,389,23820,168
64903,7,68,217,52,5241,16
28563,37,842,1068,550,31895,292
20488,26,1025,1226,718,9180,307
32659,47,624,995,406,9352,218
13654,41,2224,1337,1379,27872,845
11957,1397,68600,1359,40899,433450,27701
60726,24,256,341,211,4546,45
36199,7,140,918,124,7450,16
4948,116,5131,1423,3110,28648,2021
55170,14,160,518,122,2993,38
10760,12,215,1369,130,4868,85
36492,18,335,908,271,9308,64
12566,51,5678,1352,3050,36054,2628
14077,63,1953,1331,1345,22770,608
2976,185,9452,1445,6838,93059,2614
19511,97,2797,1243,2048,22825,749
15139,111,2031,1317,1343,16218,688
58642,43,1290,416,888,12200,402
61866,14,125,306,97,7386,28
58867,1464,24483,410,17558,114717,6925
41224,17,429,815,371,11561,58
15492,392,10991,1312,8165,79212,2826
25949,192,9040,1124,5492,44579,3548
61573,154,1584,315,1205,11170,379
38814,99,3498,849,2079,29220,1419
35689,50,1609,929,1204,23183,405
9061,12,560,1379,359,20909,201
29724,67,2284,1046,1522,29691,762
32808,164,4905,992,3352,32642,1553
15323,5,143,1315,100,11950,43
15204,49,1415,1316,958,20048,457
57382,23,324,456,258,4435,66
32155,5294,90709,1003,59349,313684,31360
38769,50,886,850,663,7176,223
62627,41,371,281,292,4966,79
30207,139,2919,1036,1679,10787,1240
2140,32,560,1453,396,34383,164
67478,1268,31552,142,25017,115261,6535
18935,48,1437,1253,1047,19086,390
5562,65,1964,1415,1196,13226,768
314,8,221,1467,173,14402,48
4232,627,21194,1433,14218,139922,6976
10274,71,2453,1373,1728,38911,725
60589,74,688,350,517,11804,171
60835,524,7749,340,6012,45338,1737
16143,68,1657,1301,1152,30067,505
65536,20,319,201,275,4557,44
37259,99,1993,889,1419,24764,574
41816,90,1667,805,1397,20734,270
21724,505,17003,1204,10824,97814,6179
458,15,1341,1466,969,26626,372
61933,16,131,303,95,3252,36
33271,21,128,983,100,2803,28
39299,120,2865,844,2440,25855,425
56368,537,7923,484,6891,90113,1032
42054,17,196,802,163,5093,33
32182,420,7033,1003,4954,25690,2079
24431,189,1846,1157,1339,14659,507
54747,3,57,531,44,4752,13
28052,6,242,1078,176,10949,66
24787,22,735,1149,511,9100,224
13978,50,1928,1333,1300,58604,628
62869,47,374,276,331,5171,43
66235,7,218,182,161,9373,57
54441,95,900,542,626,8120,274
60578,92,940,277,786,9947,154
56485,5,92,480,75,4668,17
31388,237,5433,1015,3646,40317,1787
58140,19,394,434,253,5443,141
54388,17,207,545,161,4792,46
9423,977,25487,1378,16471,124783,9016
31831,44,889,1008,556,20204,333
61004,346,9289,334,7016,32975,2273
54791,97,1381,529,955,26950,426
64631,10,103,226,81,7347,22
6672,4,344,1401,253,16108,91
51536,94,1276,634,1017,17484,259
55646,13,102,504,93,12440,9
64868,9,294,218,200,4562,94
65779,7,81,195,53,5970,28
33442,202,4958,980,3339,22441,1619
17598,79,2213,1277,1626,28535,587
36488,70,536,908,410,7758,126
3799,7126,143536,1437,96102,316786,47434
14681,24,722,1323,518,19410,204
24125,721,14199,1164,9853,33116,4346
37532,25,516,881,482,15196,34
27228,19,547,1096,350,4892,197
54012,96,749,558,642,25814,107
7370,46,1697,1392,1239,32613,458
33810,396,13809,974,9410,61114,4399
3689,49,1043,1438,731,17866,312
15939,0,121,1305,93,12260,28
25300,2625,43700,1138,29660,117883,14040
19423,10,476,1244,328,15141,148
7510,76,1054,1391,694,18181,360
40192,13,137,831,118,5644,19
8289,56,1354,1383,869,18033,485
36323,40,735,913,624,9062,111
61841,19,277,307,208,4456,69
32265,122,3252,1001,2770,57935,482
3607,59,1763,1440,1197,7349,566
57834,30,467,443,411,10498,56
37423,3,179,885,86,2698,93
67115,7,126,154,85,5007,41
18115,24,304,1267,229,9535,75
18016,53,1539,1269,1060,32832,479
57809,5,22,444,19,3728,3
29083,3,137,1058,87,7345,50
23375,1146,26877,1178,15569,123103,11308
37655,192,3538,878,2474,17608,1064
46824,16,419,742,313,10513,106
8206,112,3956,1383,2453,13024,1503
19037,749,36648,1251,23308,181185,13340
20776,14,808,1221,616,22499,192
24542,35,1638,1154,1155,18292,483
27606,20,1269,1087,839,30150,430
57228,87,955,460,697,9493,258
54514,31,315,540,262,8664,53
37676,170,6331,878,4718,30070,1613
32473,40,1497,998,938,24829,559
286,9,335,1467,250,16905,85
17286,38,1356,1283,931,24404,425
48846,704,9617,707,6745,64318,2872
7403,19517,495777,1392,325072,1812290,170705
5676,19,1427,1414,998,20201,429
61628,76,1291,313,1012,14667,279
17093,161,7990,1286,6076,79474,1914
12118,92,1157,1358,596,11134,561
58275,5336,92212,429,67056,331092,25156
54547,43,789,538,635,6290,154
27260,14,259,1095,169,4994,90
15925,16,264,1305,157,7872,107
55357,29,871,512,693,20918,178
67928,75,1236,128,1006,7387,230
55127,1,64,519,46,3161,18
29604,16,858,1049,541,18573,317
44526,22,328,768,253,7156,75
14743,1,39,1322,31,9069,8
18435,48,1882,1262,1405,60666,477
34121,192,3961,967,2961,45813,1000
5091,51,2203,1421,1461,32468,742
2469,33,897,1450,587,15612,310
16977,1763,58224,1288,41185,400459,17039
42740,1,102,790,81,6490,21
49992,4,60,675,51,4034,9
21369,352,7774,1210,4972,63978,2802
64478,15,111,230,83,5251,28
53908,323,10965,561,8830,41861,2135
68218,44,813,119,669,14289,144
66444,3,26,176,17,1112,9
12395,229,9482,1354,5530,32719,3952
59752,20,364,379,286,19592,78
39690,12,362,839,279,21670,83
7438,33,1788,1392,1278,34184,510
47701,52,850,730,659,16985,191
7642,47,1274,1389,831,38380,443
39108,12,451,846,328,5548,123
30681,117,2278,1027,1476,17762,802
52255,10,97,612,62,3602,35
68449,21,166,111,120,2849,46
26983,2671,90808,1101,60656,402236,30152
58201,134,1893,430,1628,19199,265
61196,13,133,327,116,7860,17
44866,112,1623,765,1313,16128,310
18374,70,1519,1263,1000,23461,519
16886,2153,32618,1290,21108,146953,11510
52311,69,1395,610,1112,12882,283
5159,24,1535,1420,994,25736,541
19701,175,6298,1239,4413,30394,1885
33140,4,37,986,30,1893,7
20835,26,276,1220,207,10152,69
24357,21,507,1159,387,34183,120
20031,47,860,1233,529,15713,331
18220,166,6917,1265,4725,106479,2192
35553,31,728,933,489,8312,239
29271,5,207,1054,152,10757,55
60753,36,564,343,403,6011,161
54482,52,582,541,436,5396,146
34450,23,658,960,392,13220,266
68108,157,2450,122,2047,17847,403
22866,36,985,1187,734,24517,251
51249,46,519,642,388,6814,131
47316,6,175,735,141,6132,34
50283,41,672,667,523,9183,149
4996,46,914,1422,699,28648,215
38108,53,521,866,461,16497,60
21212,83,1978,1212,1319,10013,659
51933,29,305,623,213,12055,92
29974,9,381,1041,237,24007,144
22329,436,9922,1196,7410,87383,2512
59009,97,3153,405,2496,14512,657
24034,198,4443,1166,3157,57383,1286
55425,34,531,511,415,5166,116
64548,5,94,228,73,4323,21
51640,14,147,631,117,6007,30
55611,379,7706,505,6453,34745,1253
43753,566,9682,777,7961,72478,1721
37877,43,626,873,538,11936,88
48449,110,1074,720,832,21677,242
26103,8,310,1120,204,4858,106
83,667,24984,1471,12764,68497,12220
13909,18,830,1334,572,28060,258
5625,36,2280,1414,1444,34382,836
51011,1777,22545,649,18629,69567,3916
10389,4,154,1372,84,4049,70
4900,205,8470,1423,5580,123435,2890
27945,15,599,1080,357,20617,242
8674,71,3267,1381,2066,23791,1201
65904,25,387,192,326,13217,61
29953,405,7461,1041,5506,98350,1955
19424,2,92,1244,74,8989,18
35559,49,687,933,492,10170,195
37634,2,95,879,78,27551,17
41868,354,4648,804,3851,22898,797
29097,8,91,1058,66,4729,25
54479,3559,44125,541,34964,222784,9161
28725,1173,26274,1065,16465,77793,9809
65672,6,105,197,83,2670,22
6590,33,781,1402,559,17214,222
68786,2,11,99,7,717,4
64837,111,1103,219,891,14400,212
64091,0,19,242,15,1704,4
69000,11,97,91,96,6311,1
54281,3,30,548,27,2591,3
9126,41,1410,1379,884,34341,526
9643,17,691,1377,472,25045,219
24629,0,16,1152,11,5116,5
37055,51,870,895,690,12703,180
46688,29,673,743,560,21765,113
34842,5408,79695,951,49102,215601,30593
55060,92,675,520,544,11384,131
28156,34,634,1076,474,5196,160
65258,125,2439,206,1902,22634,537
51566,83,794,633,621,15664,173
61602,242,3505,315,2799,26618,706
27448,45,1972,1091,1101,14026,871
20052,381,11298,1233,6838,34776,4460
44762,15,426,766,289,7250,137
13253,28,790,1343,567,10960,223
37689,52,1156,877,1000,24674,156
36811,7,212,903,172,5162,40
30242,1,80,1035,56,10029,24
32507,20,439,997,297,7468,142
57297,5,75,458,51,3838,24
41780,246,5636,806,4431,44962,1205
65142,15,333,210,240,5642,93
18361,68,1446,1263,1020,23819,426
29503,6,207,1051,126,5370,81
19496,15,587,1243,466,15294,121
5320,12,571,1418,368,21986,203
14506,71,2171,1325,1539,30634,632
18466,4308,74857,1261,49980,281805,24877
17719,9,261,1275,217,12165,44
12126,14,593,1358,352,16330,241
26253,496,11057,1118,6892,77693,4165
1114,913,44597,1461,24369,187732,20228
253,248,5443,1468,3780,64285,1663
9196,1410,58300,1379,35827,238289,22473
37830,106,1948,874,1519,13589,429
11357,147,7749,1365,4102,64693,3647
14558,27,777,1324,573,9302,204
55389,2,44,511,35,6075,9
17945,8,888,1270,355,16484,533
49074,971,15366,700,12363,99555,3003
38177,148,3339,865,2173,26084,1166
18526,2891,40919,1260,27837,216032,13082
23285,57,3260,1180,2394,25893,866
26299,34,1233,1116,741,24062,492
57132,16,370,463,286,4879,84
53123,1,132,582,99,2965,33
806,504,22508,1463,16034,139763,6474
38419,7,302,858,235,17162,67
37741,16,303,876,269,6570,34
52499,25,237,604,217,6054,20
18389,14,819,1262,630,15490,189
65959,903,14138,190,10251,84828,3887
3621,18951,689950,1439,398713,1700158,291237
11686,45,2195,1362,1187,12809,1008
64649,74,1115,225,812,11287,303
20471,11,271,1226,204,12234,67
9233,14,444,1379,262,11142,182
30656,13,416,1027,246,10254,170
3650,15,728,1439,533,21300,195
25757,54,2036,1128,1305,11701,731
59340,2806,48888,394,39204,197098,9684
23114,554,9770,1183,6967,80188,2803
1074,178,12517,1461,8761,119304,3756
7763,2,66,1387,39,3286,27
62151,306,4408,295,3605,53845,803
17997,40,610,1269,457,7138,153
66770,807,10071,163,7763,51306,2308
27199,13,574,1096,368,16043,206
11723,0,0,1362,0,8274,0
54116,897,12926,554,9890,72624,3036
9564,7,242,1377,161,8334,81
49004,40,869,697,742,23779,127
13289,0,0,1343,0,5734,0
36964,62,2502,898,1663,36601,839
64856,571,23002,219,15035,59153,7967
53175,16,208,581,161,6843,47
12177,23,885,1357,527,12032,358
29879,1685,26261,1043,18126,77326,8135
10432,0,0,1372,0,10249,0
16921,13,637,1289,471,20573,166
51646,62,1133,631,908,21531,225
30358,36,713,1033,469,4670,244
62045,2260,65384,299,50086,353570,15298
16941,55,1627,1289,1118,18790,509
37933,6,92,872,71,13102,21
2511,127,3000,1450,1974,50109,1026
57469,93,1787,455,1493,14833,294
50258,13,225,668,186,6100,39
10177,156,6286,1373,4518,53965,1768
26039,78,1700,1122,1011,19150,689
7864,12,498,1385,297,7901,201
32496,34,1097,998,732,21261,365
31731,853,19039,1009,13494,48111,5545
35724,7,185,930,125,13940,60
65440,28,340,203,260,9126,80
54592,217,2191,536,1852,22188,339
66962,24,495,158,381,14617,114
33349,71,2946,980,2174,36628,772
41711,4,152,807,122,7116,30
21558,60,2192,1206,1440,30938,752
28329,165,2958,1072,2229,26134,729
10014,715,39710,1374,23731,172372,15979
26879,15,405,1103,261,5691,144
29829,199,3147,1044,2121,42249,1026
6668,62,1879,1401,1224,34988,655
34796,47,762,952,591,17107,171
21981,36,903,1201,598,16936,305
61572,55,773,315,685,7813,88
24592,333,5255,1153,4188,33574,1067
60905,18,222,337,169,6191,53
62402,12,122,288,90,7351,32
29563,703,12726,1049,8807,84684,3919
23486,7,261,1176,195,6421,66
11323,5,416,1365,217,7167,199
36477,25,691,909,604,21019,87
60888,179,3746,338,3014,48169,732
35616,21,391,932,282,5489,109
25795,446,10620,1127,6115,41484,4505
12795,122,3772,1349,2570,68128,1202
4565,16,444,1428,306,14746,138
35556,819,8592,932,5943,41059,2649
31202,3102,64578,1017,42675,149571,21903
14906,816,39797,1320,26981,248449,12816
6755,2,142,1400,86,10062,56
50004,38,429,674,362,13389,67
62109,70,662,297,525,6379,137
15899,437,9656,1305,5468,39065,4188
38255,25,304,863,265,6096,39
4252,530,17574,1432,12262,58406,5312
20005,17,1270,1234,939,28034,331
31582,1842,24198,1012,16467,110766,7731
38568,42,563,854,437,17821,126
24226,248,4784,1162,3454,45373,1330
18056,2172,65976,1268,43309,445017,22667
52166,26,705,615,565,10761,140
13831,97,4566,1335,2873,29938,1693
18218,2,120,1265,97,9308,23
36232,47,587,916,469,7095,118
52345,10,132,609,102,4363,30
33956,42,955,971,719,18439,236
21109,65,3225,1214,2012,36226,1213
49201,131,1521,696,1059,16450,462
21828,495,11544,1203,8538,52361,3006
25343,252,10687,1137,6725,56734,3962
10493,1235,37214,1371,24364,215062,12850
13151,24,1778,1344,991,12686,787
3675,4,182,1439,133,15611,49
24136,56,1297,1163,840,19960,457
12444,1,130,1354,74,5221,56
17334,51,1223,1282,899,18966,324
7801,6905,125028,1386,76838,288300,48190
11881,10,647,1360,327,15534,320
26661,188,3951,1107,2350,14167,1601
63061,4,48,269,41,3330,7
32690,136,2525,995,1826,21771,699
27472,6,363,1090,225,8779,138
19740,10,327,1239,259,13507,68
63317,182,6507,264,5430,28386,1077
61256,10,163,324,132,6054,31
41053,210,2406,817,1930,16413,476
38061,14,368,868,268,6243,100
61800,11,120,308,93,6345,27
56935,150,2867,468,2246,14437,621
15732,24,1004,1308,673,19676,331
20750,35,1049,1221,714,16487,335
66729,171,3508,167,2865,25545,643
14775,17,242,1322,145,10657,97
64914,19,237,217,196,3180,41
67824,57,979,131,830,11380,149
14330,216,6262,1327,4202,30007,2060
2658,1615,83134,1449,54755,546310,28379
632,28,2159,1464,1546,15495,613
52958,33,416,588,298,4913,118
23900,169,3720,1169,2299,44937,1421
37507,18,366,882,272,20975,94
8267,2,193,1383,135,3762,58
5386,9,708,1417,454,8317,254
29304,106,1396,1054,1144,19494,252
9463,784,26549,1378,16759,130736,9790
63362,19,226,263,185,9152,41
307,11,452,1467,278,15169,174
12700,1477,98041,1351,52387,311049,45654
59179,23,249,400,187,5524,62
65335,100,473,206,420,5187,53
5348,66,1343,1418,879,23706,464
60400,34,496,357,279,7813,217
11079,56,1278,1367,836,18879,442
32457,38,857,998,512,18311,345
3046,19,916,1445,630,32997,286
66824,22,371,163,283,6360,88
53714,54,501,567,343,5992,158
19162,4,101,1249,87,8669,14
15910,1508,62554,1305,41872,337285,20682
11533,166,3171,1363,1613,28343,1558
22684,1594,26719,1190,17999,153291,8720
52451,62,1186,605,880,13597,306
56504,25,456,480,226,3783,230
5966,3,181,1410,125,6669,56
21811,6,176,1203,125,3484,51
1088,199,7418,1461,5140,47247,2278
56492,629,7621,480,6183,62065,1438
58454,21,138,423,111,4911,27
68607,57,650,105,550,14253,100
12837,12,449,1349,228,6389,221
62964,17,265,273,205,4708,60
32065,236,7150,1005,5262,26603,1888
37417,29,486,885,413,18891,73
64988,52,451,213,361,8307,90
23808,78,2930,1170,2055,22183,875
25861,37,1158,1126,781,23257,377
30542,14,197,1029,111,6718,86
50578,80,1712,659,1281,19340,431
38755,24,394,851,321,12907,73
8204,21,343,1383,273,5782,70
3068,1031,44944,1445,29173,164900,15771
38988,9,184,847,141,4141,43
18260,141,2265,1265,1664,26931,601
32636,18,518,995,326,10386,192
28910,103,2887,1061,1953,20507,934
8699,49,2597,1381,1548,17604,1049
57439,2,33,455,28,2791,5
53829,58,1134,564,885,23123,249
22674,671,15298,1190,9729,119923,5569
60451,34,1229,355,829,12231,400
54561,25,293,538,222,7984,71
61689,72,1046,312,811,7697,235
66858,24,404,162,325,11250,79
2452,21,571,1450,373,13323,198
55745,8,182,502,168,5879,14
7440,42,1340,1392,807,16906,533
49146,64,714,698,571,12728,143
34518,56,3136,959,2141,30426,995
59824,31,292,377,198,3785,94
13335,342,15011,1342,9368,44554,5643
2734,15,1347,1448,925,28500,422
16376,533,16440,1298,10826,136870,5614
21408,3,61,1209,51,15852,10
63249,11,242,266,189,5453,53
65809,14,127,194,102,4418,25
21130,31,1053,1214,714,30471,339
29421,10,243,1052,177,20539,66
43987,227,5252,774,3451,52846,1801
31040,40,546,1020,364,9005,182
6267,9,84,1407,53,2459,31
35246,2,24,941,21,5888,3
59000,2,35,405,24,3271,11
55978,71,868,496,726,14109,142
49830,344,5488,679,4349,47116,1139
10027,11,606,1374,400,26339,206
66033,554,9299,188,7284,74457,2015
63422,47,646,262,510,21524,136
12986,6,246,1347,131,9444,115
36528,49,884,907,745,21052,139
9806,24,422,1376,324,8457,98
14353,10073,184738,1327,120214,519642,64524
66020,1,37,189,27,4695,10
12320,374,11250,1355,7211,97099,4039
33367,485,12464,982,8728,66729,3736
6489,22,890,1404,560,20131,330
61490,262,2790,318,2218,22738,572
57859,23870,454012,442,324487,1246019,129525
31326,6,517,1016,306,10821,211
25404,10273,241241,1136,138019,680238,103222
1992,784,19443,1454,12877,149116,6566
51696,316,4127,630,3374,24370,753
61336,1041,18150,322,14175,114772,3975
19124,10,323,1249,282,32797,41
16615,1781,27786,1294,18882,108142,8904
23152,2,132,1182,90,4251,42
162,147,4914,1469,3415,56610,1499
58448,201,2101,423,1709,12063,392
30851,43,1492,1023,950,10550,542
58844,22,230,410,184,4425,46
50916,23,229,651,203,5864,26
33815,7,189,974,155,11449,34
57219,31,278,461,233,13568,45
18382,19,709,1263,507,8273,202
37229,94,1244,890,942,20371,302
29367,446,14237,1053,9683,113499,4554
57290,156,1893,458,1434,13713,459
35230,13,127,941,87,2945,40
33569,4,65,978,46,1766,19
23163,10,427,1182,300,10309,127
55025,17,399,522,289,10453,110
55971,4,139,496,93,6023,46
12574,32,4567,1352,2716,18836,1851
5847,23,680,1412,492,22535,188
57031,48,1340,465,1007,37321,333
20847,19,880,1220,650,13847,230
39730,526,8348,838,6296,100585,2052
20162,86,2800,1231,1881,26145,919
54947,31,386,524,303,9630,83
14593,34,454,1324,353,16160,101
27876,2,124,1081,86,7591,38
22997,33,1152,1185,752,12374,400
63523,184,1764,259,1476,25956,288
30640,29,460,1028,303,21991,157
15014,191,5690,1319,4159,47717,1531
1247,35,1275,1460,921,36089,354
19068,1909,63246,1251,44210,204858,19036
64505,20,483,229,374,3633,109
51576,98,1578,633,1249,13202,329
15280,80,1947,1315,1330,14859,617
29339,24,749,1053,512,33820,237
68892,17,209,95,161,2573,48
9441,13,746,1378,504,26175,242
50160,21,297,670,223,14082,74
12668,3401,96808,1351,58470,335909,38338
21075,54,1371,1215,1071,21932,300
33787,607,12520,974,9326,69879,3194
41665,38,642,808,432,3305,210
15647,119,5326,1310,3900,29972,1426
7390,137,6735,1392,4460,84921,2275
12197,182,8284,1357,5009,43340,3275
25157,0,0,1141,0,9486,0
58667,4,51,416,37,4482,14
5727,23788,780138,1413,458391,2165834,321747
68738,37,345,100,281,8680,64
35650,50,1810,932,1311,22067,499
40626,2453,46479,825,37745,321422,8734
29745,155,5923,1046,3669,32863,2254
17010,1326,42670,1287,27609,147642,15061
35821,70,2360,928,1958,32778,402
9201,10163,309054,1379,191334,793219,117720
36787,41,907,903,748,15823,159
11355,140,2526,1365,1653,40436,873
51100,98,1491,646,1031,28747,460
50295,13,157,667,138,6632,19
23009,31,1031,1184,703,18861,328
53626,71,987,570,758,32032,229
13925,40,1743,1333,1056,21788,687
7637,94,3514,1389,2284,50221,1230
63592,45,687,257,537,12211,150
25610,13,500,1132,327,7567,173
66771,157,1884,165,1613,8444,271
63806,28,349,251,292,8542,57
8513,642,11630,1382,8312,46767,3318
13807,12,325,1335,173,13706,152
1034,12,460,1461,301,17758,159
23181,0,0,1181,0,13647,0
14263,1085,26005,1328,16081,103184,9924
38074,13,359,866,324,14384,35
29860,650,25535,1043,18169,131691,7366
1183,91,1858,1460,1334,21825,524
56981,20,214,466,156,5789,58
35770,3736,64161,929,44730,357775,19431
51695,160,2072,630,1706,29438,366
9723,410,10197,1376,6486,29992,3711
11225,1,115,1366,66,4983,49
68887,10,123,95,89,3016,34
58443,5250,159081,423,114057,461061,45024
25470,0,0,1135,0,23879,0
38793,132,2726,850,2126,20133,600
19107,2368,49175,1250,31435,187983,17740
18006,85,2476,1269,1692,66178,784
25563,129,4307,1133,2726,22558,1581
8495,17,440,1382,291,9042,149
60150,201,4274,247,3532,39016,742
49621,2,59,684,47,5325,12
56269,82,1701,487,1403,19359,298
39314,297,3762,843,3017,23824,745
28379,19,523,1072,330,16916,193
19825,28,197,1237,163,9892,34
56538,608,7535,479,5666,25735,1869
32674,8,229,995,178,8137,51
38132,128,2830,866,2064,26315,766
8929,13,448,1380,307,6178,141
61626,5,42,314,31,1777,11
46852,6,127,741,102,11757,25
22285,8,232,1197,152,7809,80
24290,1110,21498,1160,15257,49656,6241
48639,9,210,713,170,9860,40
2750,7,268,1448,168,5772,100
30760,446,13430,1025,9737,190508,3693
62543,2,58,284,35,7495,23
19032,16,730,1251,554,15213,176
25253,53,1654,1139,1062,56239,592
13456,0,0,1340,0,68612,0
26928,20,717,1102,434,36287,283
26402,902,20009,1114,12656,89505,7353
20746,99,5015,1222,3643,74419,1372
52216,332,2486,614,2073,24953,413
23448,82,2571,1177,1562,42388,1009
10465,114,5464,1372,2858,50428,2606
14817,5,274,1321,185,7331,89
49130,3157,39531,698,33137,276179,6394
50637,594,11938,658,8033,93649,3905
9868,87,5048,1375,2788,31818,2260
30877,1088,17683,1023,11479,61444,6204
65759,199,2451,196,1847,29287,604
1303,44,1413,1459,969,16194,444
15695,0,0,1309,0,5154,0
11182,542,29910,1366,16807,93889,13103
27425,2150,41866,1091,26287,140974,15579
58328,152,1986,427,1476,13838,510
18756,46,700,1256,438,14294,262
8809,22,763,1380,517,13159,246
52520,123,1591,600,1259,85689,332
51896,20,326,624,262,6374,64
44782,2040,27473,765,19385,109499,8088
67525,773,9347,140,7152,61812,2195
19138,3,99,1249,83,8510,16
17607,170,2555,1277,1750,42462,805
21350,532,8831,1210,6384,106151,2447
19115,27,1073,1250,683,26859,390
34483,17,811,960,506,21326,305
42674,104,1985,791,1623,41621,362
66137,4,76,185,54,3796,22
55988,1487,19937,470,15418,123562,4519
27759,259,5108,1084,3442,39403,1666
12122,21,606,1358,311,10319,295
59727,5,28,381,26,2758,2
19262,116,2248,1247,1616,40194,632
57571,6,113,452,74,2874,39
11000,12,142,1367,97,10494,45
34079,1030,23886,968,18441,133334,5445
2662,78,5512,1449,4539,37243,973
17631,8,206,1276,146,9257,60
31301,38,556,1016,372,14527,184
22636,3,117,1191,95,11837,22
17399,132,2350,1281,1553,9145,797
54283,18,302,548,234,7011,68
66929,3,51,160,44,1252,7
53188,20,214,581,169,9916,45
57404,652,9295,455,7705,37169,1590
20785,49,1132,1221,699,23548,433
11549,49,3154,1363,1793,21610,1361
4623,5,298,1427,194,13870,104
1586,26,1458,1457,1020,20994,438
11141,72,1806,1366,1165,19560,641
64569,34,399,227,330,5030,69
66016,249,2879,188,2523,16039,356
19554,69,1485,1242,1078,21961,407
54692,242,3075,533,2018,74048,1057
64958,41,278,215,245,4457,33
4138,58,3257,1434,2298,68705,959
19668,757,30868,1240,18666,127429,12202
66687,601,9922,168,8565,61076,1357
52437,405,4425,606,3399,32101,1026
10692,31,1206,1370,753,13564,453
79,160,7361,1471,4319,75343,3042
41928,61,1616,803,1247,42835,369
14627,18,1090,1323,810,26903,280
6477,7,388,1404,222,4798,166
41005,30,570,818,464,8340,106
54745,171,1992,531,1523,20533,469
20245,6,666,1230,462,22815,204
9733,1684,41904,1376,28591,170230,13313
28794,32,932,1064,687,27915,245
63709,59,806,253,617,6725,189
17005,47,735,1288,525,11678,210
36378,13,343,912,279,7152,64
60940,20,258,336,196,4833,62
2198,312,21749,1452,11762,170470,9987
49203,49,950,696,716,30743,234
57374,41,553,457,475,17162,78
4031,166,3431,1435,2217,41566,1214
58479,5,82,422,51,6784,31
15407,68,2158,1313,1572,27838,586
49101,321,4901,699,3741,48305,1160
27332,12,661,1093,396,8533,265
47635,1268,14488,732,10341,61173,4147
6733,16,905,1401,642,15067,263
24180,115,2712,1163,1814,12740,898
3984,7,296,1435,209,36613,87
23098,141,3123,1183,2010,63443,1113
63164,77,767,268,661,14616,106
64446,162,3987,231,3414,39203,573
30048,83,3118,1039,1706,16522,1412
55261,55,1040,515,826,13296,214
53931,85,705,561,593,9698,112
19743,11,417,1239,301,8979,116
14180,21,1033,1330,613,9205,420
33108,8263,150686,987,99720,521823,50966
28267,71,5466,1074,3989,67069,1477
487,107,4515,1466,3120,54923,1395
35176,19,596,942,413,20204,183
27034,460,14507,1099,8937,129834,5570
51029,338,3559,648,2864,31428,695
69053,38,786,90,716,11483,70
17212,171,4235,1284,3109,71817,1126
62967,44,616,273,479,8648,137
18278,184,6910,1265,4392,49852,2518
46681,34,797,743,649,18806,148
33077,26,525,987,342,7443,183
28517,80,2100,1069,1706,13462,394
16088,7,91,1302,81,9145,10
55133,161,1866,519,1618,47432,248
60813,47,735,341,616,8698,119
34053,4,263,968,159,5690,104
10605,43,2356,1371,1514,48356,842
57349,11,206,457,139,4731,67
20042,71,2058,1233,1285,47974,773
21290,1,91,1211,69,3022,22
6280,77,2102,1407,1465,33555,637
1284,4,133,1459,80,23468,53
7540,140,4153,1390,2894,28532,1259
68185,213,4454,119,3884,23434,570
16546,359,15442,1295,10007,83112,5435
57061,13,153,464,115,10763,38
10850,20,1330,1369,693,17085,637
12578,127,4619,1352,2980,45529,1639
12695,42,1160,1351,696,6339,464
31659,27,410,1011,331,7397,79
50932,9,242,650,192,7915,50
32813,2197,44266,992,33191,184931,11075
52465,48,352,604,273,5271,79
9685,34,998,1376,688,14218,310
66012,30,201,189,174,5464,27
17113,4,198,1286,158,6678,40
15148,74,1825,1317,1387,19497,438
17468,6,157,1280,109,4447,48
20767,17,431,1221,314,36386,117
60704,21,175,345,133,10006,42
2101,6079,125688,1453,78283,406277,47405
8353,76,3614,1383,2444,58741,1170
32179,9,477,1003,301,6330,176
3805,11,199,1437,135,17943,64
54869,22,242,526,169,7286,73
65548,87,1128,201,798,12030,330
43171,49,608,783,463,7574,145
51810,45,492,626,424,16695,68
42496,36,525,795,379,10264,146
28304,2,169,1073,100,4267,69
47953,486,9165,728,7210,103034,1955
57787,272,3416,444,2748,31426,668
51295,85,853,641,676,8099,177
42546,342,4436,794,3840,45537,596
12232,323,6173,1356,3822,42478,2351
23924,386,7137,1168,4829,58055,2308
21999,7,192,1200,145,37674,47
23283,4,305,1180,247,11298,58
28296,121,3667,1073,2342,54507,1325
50001,34,358,674,277,5732,81
17204,36,1766,1284,1364,17895,402
21839,4975,139138,1203,73274,404235,65864
30980,636,17825,1021,12075,151386,5750
68136,35,481,121,383,9188,98
8559,65,2417,1382,1713,45499,704
64885,139,2707,218,2184,26636,523
51690,233,2962,630,2454,29160,508
41842,23,2082,805,1351,12817,731
2532,5886,179049,1450,111292,404554,67757
61249,2618,44434,321,33921,237764,10513
17254,105,3566,1283,2543,31967,1023
47853,16,364,729,278,5293,86
23326,122,2668,1180,1886,34933,782
51599,24,323,632,261,30392,62
35309,80,1226,939,1039,18368,187
37130,334,8995,893,7374,44515,1621
37686,106,3495,877,2718,18623,777
20468,17,1049,1226,701,21414,348
27798,11,484,1083,306,14665,178
7506,84,3572,1391,2387,16182,1185
60711,21,212,345,156,9854,56
29199,15,469,1056,351,18508,118
25788,13,294,1128,208,5961,86
4523,31,1591,1429,986,25067,605
35315,12,632,939,439,8062,193
37711,38,899,877,697,21276,202
20440,12,331,1227,258,6948,73
5867,51,1217,1412,796,23457,421
64931,13,105,216,76,2663,29
56335,7,48,485,36,2622,12
5362,38,2487,1417,1655,16262,832
8678,47,1396,1381,935,19085,461
31623,49,1720,1011,1341,9577,379
54309,521,5328,547,4314,53028,1014
35013,3,28,947,22,3330,6
310,204,5180,1467,3159,40083,2021
9566,265,11041,1377,6354,235752,4687
68219,71,1186,119,956,9427,230
56513,10,144,480,83,3608,61
58425,39,490,424,401,11541,89
53018,53,1117,586,935,15968,182
19322,0,0,1246,0,7777,0
50427,45,654,664,521,8017,133
53884,94,836,562,691,9471,145
65069,3,21,211,19,4528,2
18948,49,971,1253,734,16415,237
59612,301,5776,385,4471,35838,1305
45542,213,2022,757,1589,26864,433
64099,41,264,241,205,3682,59
55625,55,465,505,395,10465,70
37392,53,825,885,622,15266,203
19,192492,4907703,1472,3336676,11292152,1571027
25666,10471,233838,1130,149421,528081,84417
30022,61,1945,1040,1270,29802,675
26564,14,508,1110,327,19887,181
49641,61,645,684,472,5332,173
9852,1172,15791,1376,11618,108542,4173
63701,2,9,254,7,1374,2
4522,24,826,1429,522,27666,304
30491,15,433,1030,180,4565,253
56095,118,1900,492,1423,12043,477
51751,69,862,628,713,13001,149
53201,51,1329,581,1094,11571,235
16479,161,2989,1296,2184,80735,805
47376,6478,191589,735,149614,637542,41975
65604,214,6011,200,4977,58307,1034
33695,11,263,975,205,9578,58
54520,237,3762,539,2934,26722,828
60118,1060,27720,367,21913,152731,5807
62329,24,159,290,116,6148,43
7267,18,458,1393,287,19251,171
51994,77,1269,621,1118,28188,151
55509,39,533,508,400,13609,133
59226,209,5750,398,4851,43994,899
30414,17,974,1032,623,17661,351
10686,188,6642,1370,3748,41057,2894
3992,3,182,1435,126,9060,56
58257,512,8066,429,6694,49664,1372
61672,110,1543,312,1194,15944,349
59241,44,466,398,377,5534,89
2164,38,1592,1453,1008,12026,584
9092,9,193,1379,138,9329,55
426,91,2251,1466,1526,21960,725
58494,29,381,421,301,12428,80
30764,1830,50644,1025,32723,195104,17921
69,252,13441,1471,7034,147014,6407
60121,6,194,367,153,5419,41
16399,3121,147473,1297,82741,713782,64732
67710,49,615,135,488,5664,127
9470,16,478,1378,325,13929,153
29386,49,1453,1052,1162,62600,291
40206,106,1674,831,1448,28319,226
49367,39,581,690,439,4866,142
31571,23,374,1012,237,8717,137
49082,40,352,699,311,5558,41
9349,623,26678,1378,16673,102474,10005
68153,49,567,121,499,7196,68
53157,26,204,582,173,5565,31
63941,18,225,247,189,5148,36
4198,512,20274,1433,13726,134936,6548
23655,0,0,1173,0,8804,0
50221,71,1637,669,957,19121,680
25349,22,834,1137,604,25988,230
52872,254,3032,590,2249,38934,783
826,5,136,1463,83,15244,53
68122,23,712,122,513,7991,199
51976,290,3470,622,2906,32336,564
52969,31,236,588,185,2656,51
4139,1503,51552,1434,29192,212679,22360
27265,82,1763,1095,1342,38422,421
19251,30,916,1247,722,13083,194
29383,41,886,1053,540,14136,346
31387,31,1150,1015,699,10117,451
54282,32,344,548,271,7806,73
47988,234,3340,728,2611,29562,729
21832,44,597,1203,446,12641,151
62802,11,62,277,52,4905,10
63474,42,402,260,308,4316,94
5732,22,1155,1413,655,29701,500
63207,67,802,267,625,10143,177
38409,2842,55093,859,43108,468593,11985
51868,74,769,625,607,6542,162
4574,15,529,1428,368,15148,161
6307,149,2813,1407,1877,21465,936
3082,14,1257,1445,851,20649,406
37097,27,346,894,262,8434,84
24322,3,145,1159,103,6846,42
57452,20,264,455,217,5466,47
49826,216,2881,679,2324,53969,557
58450,1487,15553,423,12618,56532,2935
52021,55,557,620,498,11941,59
7723,54,1329,1388,952,17929,377
49054,47,576,700,456,6139,120
33963,244,1882,971,1162,18629,720
60071,96,1213,369,911,16046,302
52407,572,8454,607,6630,84379,1824
19109,0,0,1250,0,17243,0
22464,17,429,1194,296,8135,133
5450,53,1912,1416,1441,19694,471
5473,620,22104,1416,14804,72924,7300
63731,420,6673,239,5503,52049,1170
41304,3057,77961,814,58549,217253,19412
60363,25,463,358,351,6279,112
28306,183,7616,1073,5431,21159,2185
52362,11,149,609,135,8476,14
19973,53,2109,1235,1450,26283,659
38368,1051,19755,859,16304,142874,3451
56459,125,1342,482,1121,16266,221
20583,162,3956,1224,2708,30993,1248
29905,408,8887,1042,6214,94892,2673
14957,3,435,1320,317,21687,118
2531,1423,60913,1450,38844,331288,22069
56041,74,953,494,784,22316,169
13652,13283,329154,1337,190875,834341,138279
10161,9,718,1374,403,16273,315
37924,0,34,872,27,17291,7
48824,39,703,708,573,27611,130
20537,176,7352,1225,5167,47345,2185
35253,1101,19915,941,15210,151706,4705
7400,528,41274,1392,23645,190804,17629
64026,79,3660,244,2441,23701,1219
37255,13,258,889,232,6206,26
18315,125,4129,1264,2983,80335,1146
53449,10,212,575,154,9843,58
15860,164,2092,1306,1368,32488,724
53979,99,1297,559,1049,29385,248
67532,2,17,140,16,866,1
53942,65,1494,560,1270,12178,224
28004,21,1105,1078,702,5616,403
3702,2,121,1438,83,17860,38
58418,3893,85980,414,63231,328093,22749
28105,7,186,1077,156,4484,30
57994,14,127,439,119,4579,8
10418,0,1337,1372,869,10465,468
24939,22,473,1145,339,6225,134
32238,128,1674,1002,1200,16773,474
7410,33,1036,1392,718,21820,318
30321,4,250,1034,216,9488,34
14848,7,1021,1321,599,14830,422
44661,20,374,767,287,11693,87
10877,27,714,1368,457,10775,257
56690,25,280,475,238,5968,42
36365,797,18127,912,13704,98701,4423
50850,16,385,653,236,10044,149
33483,116,4205,980,2712,34892,1493
17792,9,220,1273,135,4656,85
67065,20,206,156,148,2521,58
62787,112,1128,278,971,8936,157
52339,38,486,609,408,11691,78
38048,285,8350,868,5971,57744,2379
4814,49,3959,1424,2733,23220,1226
16245,11,235,1300,181,18579,54
17722,19,741,1274,634,42996,107
13138,49,1467,1344,840,39734,627
25294,118,1871,1138,1361,13284,510
38423,8,176,858,144,7905,32
45113,81,749,762,544,18775,205
48065,26,239,726,207,8505,32
31170,1807,36605,1018,26285,482212,10320
10944,1,41,1368,21,15417,20
51938,183,1897,621,1634,22588,263
63506,42,454,259,349,8013,105
11992,221,2186,1359,1220,14526,966
30710,277,4335,1026,3021,28752,1314
67722,18,243,135,181,2593,62
49782,9,243,680,190,6975,53
56429,4,120,482,97,9719,23
36854,60,829,902,638,12091,191
24912,87,2743,1146,1841,24392,902
35598,810,12914,932,9700,82556,3214
29089,623,13764,1058,9670,75455,4094
29826,81,1817,1044,1146,22151,671
54528,24,220,539,148,4224,72
14733,152,3929,1322,2640,32038,1289
48907,693,10010,705,7138,47349,2872
10030,54,1451,1374,875,9575,576
57554,16,571,453,455,6011,116
22493,38,790,1194,585,15729,205
29267,56,2222,1055,1489,26598,733
55491,11,181,509,139,4980,42
9308,180,8485,1378,5267,33867,3218
18729,102,2784,1257,2022,45448,762
25289,477,8464,1138,5661,41495,2803
34470,41,936,960,626,11281,310
37454,29,482,884,367,9461,115
45100,2,107,762,48,2607,59
15576,104,2154,1311,1477,38143,677
57308,348,4664,458,3410,34591,1254
63384,0,6,263,5,1279,1
14829,271,10229,1321,7533,128374,2696
53407,143,1665,576,1283,19221,382
55432,261,3756,503,3025,53094,731
13140,200,14897,1344,8660,51472,6237
17667,4,161,1275,127,7242,34
14551,38,974,1324,679,41712,295
29308,22,592,1054,471,21903,121
15852,30,1205,1306,847,18967,358
13857,9,264,1334,156,8704,108
34672,270,6105,953,4830,117918,1275
55642,5,59,505,43,4302,16
20921,95,2228,1218,1508,17294,720
34291,45,1310,964,857,10035,453
18832,179,4781,1255,3352,64574,1429
45962,131,1984,752,1679,28342,305
10702,46,1655,1370,1095,26854,560
57923,9,118,441,85,2328,33
5947,71,2768,1411,1822,26867,946
9198,3150,116278,1379,61755,748039,54523
25647,10,566,1130,382,11612,184
47596,180,2877,732,2357,47761,520
12127,0,0,1358,0,9013,0
59488,28,184,389,147,4911,37
38545,192,3603,855,2671,52722,932
28959,93,2463,1060,1581,27212,882
60978,364,4517,335,3839,84359,678
23878,202,3286,1169,2681,42323,605
15057,18,789,1318,564,53418,225
38371,94,2811,860,2203,34602,608
54068,358,3471,556,2680,24074,791
37718,520,22540,876,17665,60050,4875
8459,2,192,1382,89,8625,103
1250,25,738,1460,562,21818,176
59549,31,459,387,334,7638,125
53457,54,431,575,320,9958,111
14123,138,1768,1330,1199,17536,569
27218,5,270,1096,180,5335,90
32710,83,1310,994,851,15815,459
38430,34,344,858,273,5559,71
28499,61,2108,1069,1325,16392,783
30442,25,1909,1031,1086,15871,823
14919,14,350,1320,223,9775,127
60797,29,520,342,422,12807,98
4316,73,1642,1431,1263,15728,379
62322,13,117,291,100,4204,17
322,153,11749,1467,6837,92401,4912
23201,857,29802,1181,18113,150959,11689
7551,41,1388,1390,940,11797,448
29284,13,275,1054,196,5376,79
29809,752,15810,1044,12629,137230,3181
42678,85,1921,791,1511,47388,410
67564,15,329,139,252,3591,77
48095,378,4600,726,3668,74886,932
20796,53,1401,1221,1036,27841,365
55951,25,272,496,224,8688,48
11978,23,1209,1359,627,11921,582
65274,24,377,207,320,5722,57
57783,99,3234,445,2473,32476,761
62852,35,723,276,553,3147,170
18752,27,677,1256,420,14861,257
65471,115,1350,203,1084,11647,266
58108,3,180,435,111,3193,69
40229,47,854,831,645,17695,209
39874,10682,635442,836,449357,990674,186085
63826,26,353,251,299,5686,54
62906,355,3870,274,2928,37365,942
10994,94,2637,1368,1673,32486,964
4710,222,6862,1426,4716,33791,2146
30013,445,15285,1040,8821,69609,6464
61264,22,160,324,131,2526,29
5789,35,580,1413,460,12526,120
3014,30,947,1445,722,9387,225
18725,1,271,1257,199,8330,72
26609,28,335,1109,319,6480,16
22043,859,17487,1200,11982,92117,5505
19568,1242,27242,1242,17209,192067,10033
67215,7,40,150,30,1060,10
55567,101,913,507,725,24290,188
18597,728,14229,1259,9395,129659,4834
36990,50,1146,897,1009,19309,137
8244,112,1393,1383,906,18902,487
63341,1,38,264,22,1762,16
15173,14,590,1317,405,18251,185
25410,5,153,1136,92,6390,61
5219,18,2029,1419,1331,21525,698
2800,20,777,1447,463,17011,314
62061,136,2110,290,1766,12186,344
5913,9,140,1411,110,4126,30
37166,98,1502,892,1275,34538,227
21952,209,6136,1201,4161,23664,1975
15006,8,440,1319,304,15628,136
19690,309,5688,1240,3530,67137,2158
12202,268,8853,1357,4917,56169,3936
55633,25,472,505,308,16403,164
1416,253,7785,1458,5463,74043,2322
42036,12,394,802,297,10052,97
17634,93,1592,1276,1088,35793,504
11333,33,1056,1365,595,14052,461
67705,11,301,135,192,4174,109
29923,335,6439,1042,4977,44312,1462
54049,34,445,556,297,4213,148
19199,66,1158,1248,837,8603,321
60673,47,587,346,477,10386,110
13832,23,794,1335,565,24236,229
2906,2631,86683,1446,58593,218902,28090
21250,34,2006,1212,1344,10066,662
10132,44,1494,1374,1018,15140,476
64770,15,57,222,51,1309,6
7373,35,957,1392,664,33615,293
51765,94,996,627,850,19921,146
21794,3,125,1203,90,4798,35
33139,3,31,986,26,1861,5
13536,20,1155,1339,767,43616,388
37705,7,112,877,89,5570,23
57698,97,2965,448,2366,18910,599
3948,42,2051,1436,1455,32407,596
59646,9,84,384,68,5016,16
22668,7,312,1190,249,13690,63
49061,74,1288,700,1020,14323,268
10756,137,3583,1369,2171,37139,1412
5624,4512,127032,1414,72444,426455,54588
38826,63,901,849,680,9503,221
43161,335,5820,784,4949,58860,871
37576,2723,55115,880,38693,277623,16422
61246,136,2944,325,2460,21255,484
55545,10,157,507,139,7905,18
16705,122,3911,1293,2583,29267,1328
14962,25,906,1319,581,5773,325
9240,84,1987,1379,1189,21853,798
11035,14,357,1367,202,5360,155
51873,8,108,625,66,6858,42
35097,4,110,945,64,4342,46
24137,373,17858,1163,11560,128330,6298
10707,45,2415,1370,1434,43370,981
33772,128,3670,974,2499,64975,1171
35854,1527,23955,927,17857,178545,6098
65043,10,54,212,43,4380,11
1028,132,3412,1461,2416,68570,996
32964,84,3792,989,2695,26845,1097
54957,97,1607,524,1238,17752,369
53784,7,92,565,80,6609,12
55301,6,120,514,57,4521,63
62324,52,462,291,414,7652,48
893,13,592,1462,370,7589,222
59231,1395,29004,398,23174,149981,5830
52361,109,2565,609,2281,19055,284
20487,21,1474,1226,1110,26068,364
8017,1,160,1384,90,11871,70
62422,436,4783,287,3710,52885,1073
58244,233,4843,430,3799,25364,1044
23952,17,622,1168,361,7152,261
13774,21,1293,1336,726,15821,567
34781,39,429,952,318,9618,111
34358,26,605,962,404,10340,201
27628,83,2947,1086,1749,21301,1198
22518,41,1432,1193,1100,36141,332
16391,184,2651,1297,1910,23147,741
16242,13,1462,1300,815,20369,647
6006,1901,67062,1410,42703,412101,24359
33711,823,12927,975,9484,50137,3443
30834,43,868,1024,519,7774,349
68428,30,572,112,471,27111,101
1626,5,75,1457,52,5507,23
67522,13,218,141,203,3480,15
3888,39,1185,1436,811,10898,374
64225,109,1171,238,989,7529,182
28388,126,4170,1071,2754,22487,1416
31543,85,2761,1013,1911,67922,850
57861,1503,50682,442,40159,188354,10523
17799,4,150,1273,126,7436,24
28078,573,8428,1077,4979,52772,3449
48823,41,446,708,336,8146,110
64921,3,55,217,44,3042,11
24229,4,247,1162,171,5908,76
19365,143,6452,1245,4518,53911,1934
45714,137,2895,756,2214,16477,681
22406,70,3989,1195,2339,14713,1650
5518,2456,53335,1415,33614,567257,19721
6571,35,1106,1403,812,41025,294
4665,33,719,1426,515,26169,204
23030,1944,39363,1184,26056,156859,13307
14518,26,567,1325,403,9543,164
17679,4,199,1275,162,11425,37
4646,418,20009,1427,11498,73110,8511
4112,18,683,1434,436,22623,247
57991,110,1022,439,821,21991,201
33044,10,746,988,479,13190,267
53333,42,520,578,418,18755,102
57358,50,1020,457,772,15454,248
56310,60,862,486,752,19027,110
19635,87,3931,1241,2800,29273,1131
36050,64,1145,921,990,22027,155
8599,29,862,1381,544,7879,318
18550,24,860,1260,581,21488,279
68014,312,5399,125,4533,29120,866
11346,0,0,1365,0,11072,0
58738,45,480,413,379,6831,101
27843,40,2065,1082,1234,28802,831
17210,10,593,1284,392,6581,201
8341,853,23107,1383,15733,239178,7374
18591,0,0,1259,0,7029,0
63240,439,9752,266,7849,50069,1903
28428,15720,442851,1071,271196,1473553,171655
16735,17,582,1292,469,11567,113
14812,74,1115,1321,884,15311,231
5197,53,2657,1419,1949,29030,708
37220,21,397,891,358,16506,39
53746,260,3748,567,2863,38328,885
16416,41,1074,1297,729,31485,345
10438,70,2674,1372,1848,18769,826
11852,33,946,1360,592,10227,354
9712,32,2441,1376,1553,45271,888
23238,64,2310,1181,1563,20984,747
61948,30,684,303,555,8224,129
55001,14,124,522,117,8983,7
17504,32,1333,1279,1019,22775,314
5235,29,877,1419,591,14377,286
43693,49,571,777,439,14372,132
31056,64,1843,1020,1238,26500,605
31302,5,33,1016,23,8234,10
55668,2815,92846,504,62753,181552,30093
66406,4,56,177,47,2601,9
62101,68,1494,297,1140,15966,354
17965,282,7019,1270,5000,50241,2019
8527,126,5246,1382,2990,42951,2256
15359,18,353,1314,273,11381,80
30227,3,64,1036,39,3739,25
31516,30,612,1013,310,10395,302
53413,11,142,575,125,4670,17
59863,18,208,376,156,4781,52
44308,123,1489,771,1221,12254,268
18034,20,466,1268,304,9655,162
59028,415,5652,404,4368,57628,1284
21941,198,4076,1201,2978,43963,1098
19481,138,5169,1243,3152,57313,2017
33745,36,1324,975,987,15911,337
62184,55,899,294,683,13338,216
14724,7,174,1322,123,12837,51
27730,21,267,1085,242,6606,25
27685,96,2449,1085,1664,22040,785
19619,14,616,1241,442,13921,174
32489,85,2352,998,1408,28088,944
32641,311,11953,995,8042,79194,3911
2498,125,3168,1450,2268,47765,900
39965,203,6691,835,4832,43691,1859
51494,11,244,635,198,5321,46
37442,40,894,884,592,10874,302
35957,225,6265,924,4694,35343,1571
55325,9,138,513,89,10794,49
36731,1,68,904,53,7076,15
34139,199,2189,967,1581,8626,608
15709,50,1304,1309,920,14342,384
56822,21,235,471,180,5514,55
29674,312,13396,1048,9358,100381,4038
58295,83,716,428,577,14968,139
2272,57,2715,1452,1820,39493,895
49323,254,2785,692,2182,35739,603
61025,10,103,333,82,5524,21
64157,14,122,239,106,5661,16
54705,147,1765,532,1364,20748,401
45443,46,583,758,439,8309,144
18067,12,969,1268,685,12557,284
66342,5,58,179,44,9644,14
12662,3,336,1351,163,11969,173
68091,157,2632,121,1671,35536,961
31395,14,415,1015,253,6914,162
24712,31,1095,1150,776,13931,319
3332,19,885,1442,573,18087,312
45054,689,10025,762,7504,100135,2521
62658,10,101,281,89,9028,12
34622,19,448,956,306,9541,142
50867,7,143,653,119,7298,24
9965,55,845,1375,604,13827,241
67176,56,757,119,608,13467,149
36997,26,781,897,603,7910,178
11727,411,24927,1362,13285,117949,11642
38087,4,109,867,69,4406,40
53479,242,3846,575,2162,63990,1684
5331,180,8771,1418,5579,101365,3192
1770,247,5660,1456,3960,42683,1700
53971,2037,22101,559,18083,84403,4018
49068,240,6380,700,5153,45406,1227
26210,27,720,1119,440,10708,280
54941,0,16,524,13,3547,3
31800,133,2107,1008,1467,18502,640
36154,179,4976,919,3653,41235,1323
30363,19,290,1033,215,5986,75
38271,3,64,862,50,2126,14
37242,35,680,889,534,8666,146
28664,123,11345,1066,6644,35080,4701
52189,85,1074,614,971,16987,103
8961,46,1591,1380,1053,40198,538
34085,17,432,968,253,7628,179
16618,17,515,1294,295,9149,220
28569,72,1696,1068,1110,9897,586
34871,6,343,950,210,8032,133
62076,107,1718,298,1397,25926,321
30228,24,741,1036,484,7007,257
36776,739,11179,903,8861,85911,2318
2331,83,5870,1451,4122,87899,1748
57816,91,1316,444,1102,28211,214
13351,115,2082,1341,1365,12853,717
51597,171,1930,632,1641,22914,289
41019,24,364,818,260,7151,104
57420,18,183,456,159,4078,24
11556,21,789,1363,529,30820,260
26223,40,858,1118,545,12215,313
21636,8,228,1205,153,4224,75
32897,34,1114,991,712,13629,402
3417,85,3760,1441,2656,35046,1104
16438,50885,1239113,1297,704999,2871659,534114
60522,12,89,352,82,6266,7
12399,198,8915,1354,4579,53001,4336
46546,40,1072,745,911,22059,161
1117,5855,157509,1461,96079,336212,61430
19000,0,0,1252,0,6277,0
66448,0,23,176,15,3706,8
18255,534,12183,1265,8805,67258,3378
21331,62,1707,1211,1078,23444,629
16457,21,688,1296,531,24907,157
57224,33,220,461,188,3640,32
24681,156,3089,1151,1786,11415,1303
68648,277,3199,103,2540,16069,659
9929,412,11953,1375,6663,68911,5290
7242,36,1579,1394,1029,20967,550
15584,17,914,1310,631,33831,283
17646,60,2820,1276,2123,16012,697
16626,125,12334,1294,7501,49841,4833
49698,268,5772,682,4499,43811,1273
31980,233,5072,1006,3086,17152,1986
12439,78,1401,1354,813,16029,588
21027,34,1268,1216,976,18020,292
56491,37,447,480,367,5458,80
58000,43,449,438,340,8615,109
5284,1084,42668,1418,27459,203397,15209
37394,92,1849,885,1295,14140,554
51064,73,1412,647,1034,23278,378
63339,22,130,261,118,3666,12
15933,38,558,1305,422,24362,136
4524,232,9048,1429,6525,110079,2523
52858,223,2269,591,1550,7425,719
10538,2,89,1371,56,9817,33
25871,137,2949,1126,1917,47738,1032
26459,53,761,1113,598,22256,163
61650,33,603,313,436,7231,167
4720,113,4577,1426,3087,28178,1490
31095,39,755,1019,482,11343,273
3908,17,1009,1436,698,25402,311
20388,7,404,1227,329,28031,75
66646,4,27,169,24,1187,3
23930,7,166,1168,117,4355,49
29111,502,12897,1058,8639,111381,4258
49589,14,241,685,214,8792,27
11750,4427,109755,1361,73922,491864,35833
59443,172,2323,391,1917,36163,406
29196,3528,126824,1056,80888,449576,45936
67269,20,610,149,341,9315,269
53818,11,131,564,99,4969,32
9464,2744,152819,1378,98279,520492,54540
10323,64,1734,1372,1076,16977,658
58963,182,1991,406,1566,14114,425
13246,469,13155,1343,9616,106966,3539
8524,117,6586,1382,4298,60789,2288
12628,57,2750,1351,1621,26927,1129
67340,5,65,146,53,3076,12
50928,17,162,651,134,3067,28
67387,78,1069,145,775,8447,294
11119,1516,27754,1367,16099,75522,11655
37671,0,28,878,25,4282,3
14615,62,1269,1324,907,14697,362
2549,24,942,1449,611,23028,331
1679,13,363,1456,279,8891,84
34176,7,62,966,55,3533,7
7271,800,16626,1393,10368,74327,6258
8148,2,249,1383,172,9962,77
53104,6,101,583,74,5648,27
62947,4,51,274,21,5029,30
39517,51,471,841,367,10215,104
18149,8,236,1267,186,13465,50
38172,16,560,865,382,15642,178
20472,24,1271,1226,872,16623,399
14467,49,1179,1325,766,11531,413
66176,437,5949,183,4992,57226,957
9181,27,1934,1379,1277,22460,657
11187,2647,97657,1366,55004,536404,42653
32635,1664,30960,995,22838,80014,8122
67161,5,136,152,121,6750,15
18762,125,6546,1256,4355,46363,2191
43421,110,1769,781,1382,22098,387
33419,159,2827,981,1901,15947,926
67,12,942,1471,711,50744,231
65200,14,197,209,155,2281,42
51981,26,475,622,341,11847,134
15483,20,624,1312,461,38114,163
34380,36,782,962,550,8650,232
773,2,111,1463,70,3828,41
59447,18,199,390,162,6432,37
29221,10,234,1055,152,7931,82
42406,249,4008,796,3128,69894,880
43195,25,626,783,488,30714,138
53726,337,4334,567,3442,29695,892
29579,70,3462,1049,2317,49109,1145
48430,149,2460,721,1851,32593,609
37984,11,490,870,403,7534,87
61111,13,200,330,146,2379,54
22309,15,425,1197,308,33880,117
68821,79,1505,98,1267,6955,238
3356,7,148,1442,108,7022,40
57383,30,488,456,377,16468,111
14137,1354,42944,1330,28138,394457,14806
11660,53,3061,1362,1550,25663,1511
5756,53,2327,1413,1534,47479,793
5122,9,132,1420,95,20724,37
38427,276,3323,858,2702,26348,621
55317,0,24,513,19,1733,5
20351,846,33463,1228,27294,241813,6169
26356,20,572,1115,374,10593,198
11932,1576,41574,1359,26866,145172,14708
67376,29,184,145,135,2754,49
58555,419,3093,419,2328,15468,765
16840,8,280,1290,206,16019,74
34159,629,61283,966,48469,89185,12814
65125,68,1140,210,912,13936,228
3514,23,659,1440,455,22414,204
26754,37,1053,1106,613,10535,440
58053,43,486,437,371,8762,115
18040,109,4181,1268,3029,42030,1152
31609,18,565,1012,344,10609,221
67700,53,1084,135,882,12739,202
15741,9,168,1308,109,9063,59
2746,779,16654,1448,10677,51416,5977
60853,19,348,339,287,6010,61
37151,293,4734,893,3927,41665,807
25475,183,2927,1134,1824,27494,1103
4205,21,395,1433,283,16789,112
18148,185,3264,1267,2188,22027,1076
60019,44,961,371,647,15315,314
56328,226,3826,485,2960,48054,866
23318,272,7149,1180,4766,41769,2383
49974,615,10203,675,8346,118486,1857
49073,31,621,700,526,11883,95
60141,12,129,366,94,8045,35
39622,68,1595,839,952,23916,643
25389,16748,457766,1136,283214,2060098,174552
3277,103,6962,1443,4529,39712,2433
43117,322,4311,784,3438,34694,873
1255,81,3189,1460,2226,30609,963
3522,64,1606,1440,1252,23614,354
11265,56,2337,1366,1433,23007,904
340,95,5750,1467,3844,36157,1906
50343,1899,29426,665,20468,123722,8958
7024,232,4840,1397,3258,36972,1582
56625,96,1131,477,894,18317,237
9081,40,713,1379,478,23650,235
20754,19,776,1221,607,17402,169
57566,17,211,452,175,6597,36
51044,53,390,648,307,8656,83
6375,48,1410,1406,884,21901,526
31621,94,3210,1011,2131,37245,1079
22338,90,1765,1196,1135,16202,630
2093,52,2070,1453,1337,31349,733
20095,44,1130,1232,800,20114,330
9887,1017,31944,1375,22185,162195,9759
22631,195,8280,1191,6194,37314,2086
27792,228,3517,1083,2386,29978,1131
68845,23,380,97,287,6709,93
39928,2994,39047,553,30693,221381,8354
18083,141,3337,1268,2449,41247,888
36130,149,1911,919,1553,23211,358
4401,51,1146,1430,753,30435,393
37159,86,2032,734,1421,29022,611
29023,47,1407,1059,909,42659,498
28083,13,335,1077,221,5965,114
17323,2,158,1282,108,4026,50
63157,23,185,268,138,7748,47
50909,38,538,652,390,9493,148
569,289,8390,1465,5991,58297,2399
53980,13,122,559,104,5155,18
12319,6,245,1355,135,6748,110
18879,23,694,1254,499,21506,195
52667,3155,44167,595,35068,336892,9099
46851,525,11246,741,7963,67990,3283
64002,13,202,245,169,4099,33
57756,657,6654,446,5379,40467,1275
22079,35,812,1199,542,11049,270
7631,81,1338,1389,824,24783,514
20120,248,7503,1232,5369,55093,2134
35157,8,132,943,87,9428,45
61414,5,42,320,35,2571,7
31372,19,537,1015,358,11511,179
36493,71,1166,908,1041,29606,125
41741,351,4553,807,3302,41004,1251
32355,65,1284,998,861,12079,423
58894,2255,27539,409,22215,163847,5324
48594,21,406,714,298,13574,108
27357,3190,90842,1093,65198,325333,25644
60270,95,1320,362,937,9376,383
67788,31,467,132,398,6986,69
22457,14,502,1194,369,12171,133
54784,243,2295,529,1769,34228,526
9402,138,3015,1378,2038,12853,977
7144,5,209,1395,129,13601,80
349,14,578,1467,341,15742,237
58696,135,2201,415,1714,12043,487
19325,7,292,1246,218,11894,74
2440,82,4002,1450,2675,75869,1327
4192,867,29404,1433,14834,218539,14570
2395,141,3428,1451,2488,21559,940
68798,2,10,98,9,2464,1
67934,9,140,128,95,2677,45
35675,7,103,931,98,4701,5
46201,5,141,750,85,5351,56
26211,35,330,1119,205,4803,125
63162,1,8,268,6,2642,2
7491,9,236,1391,166,6004,70
50542,6,199,660,157,3894,42
68015,59,1188,125,919,15556,269
34721,76,1385,953,956,14341,429
29243,623,13406,1055,9588,32380,3818
59834,17,116,377,89,5191,27
57447,105,1179,455,921,11259,258
17095,106,4075,1286,2586,49444,1489
9218,69,1734,1379,1075,11122,659
28339,43,1164,1072,694,18026,470
5963,6,144,1410,98,7725,46
21338,11,540,1210,447,11949,93
909,5,537,1462,354,21193,183
26694,5,112,1107,90,4206,22
7529,137,3107,1390,2065,21675,1042
416,16,467,1466,325,38056,142
12226,55,4118,1357,2098,19496,2020
8118,475,16599,1383,9757,61831,6842
58488,258,12241,421,9948,87294,2293
17403,8,296,1281,254,18803,42
20650,13,401,1223,280,12726,121
20323,50,1044,1229,713,44605,331
64346,8,223,231,185,4897,38
33962,16,316,971,201,11536,115
39534,6,167,841,113,2407,54
5417,175,7159,1417,4882,92397,2277
16196,42,916,1301,684,22694,232
59172,65,739,400,588,8525,151
57311,145,1726,247,1393,21303,333
67817,1,120,131,46,1990,74
48991,298,3251,702,2616,37561,635
49293,21,343,693,265,8775,78
40495,1412,26479,826,20540,211193,5939
9626,0,0,1377,0,11387,0
5460,111,7080,1416,4657,65145,2423
29302,6,264,1054,205,12005,59
19268,457,10174,1247,7201,77066,2973
61552,1434,21874,316,18265,137723,3609
54211,14,128,551,108,4388,20
38242,18,363,863,305,10986,58
28265,145,6551,1074,4895,66491,1656
55460,3217,76284,510,62289,350329,13995
18708,3,226,1257,147,5384,79
14019,2176,90526,1332,57509,220751,33017
626,48,1381,1464,914,23423,467
50853,0,30,653,23,2695,7
17638,73,1556,1276,1114,12484,442
63117,23,254,270,197,4183,57
64081,1,49,241,31,3906,18
53286,35,312,579,251,10455,61
55485,311,5620,509,4107,52125,1513
21660,767,24704,1205,13688,126776,11016
60907,11,255,337,190,11133,65
35361,364,9275,937,6790,65181,2485
27450,202,4703,1091,3224,29831,1479
19955,40,1417,1235,1069,26849,348
56286,65,864,486,636,15394,228
58991,103,760,405,631,6545,129
61852,1,10,306,7,1754,3
24790,37,885,1149,569,13447,316
13009,19,866,1346,526,31391,340
57272,89,898,459,735,10407,163
18576,34,1604,1259,1255,32807,349
1961,156,5939,1454,4126,59776,1813
41692,2988,61894,808,45154,174817,16740
14530,70,3862,1324,2549,33012,1313
12984,14,596,1347,292,11271,304
8278,35,1278,1383,751,10669,527
7419,139,3988,1392,2586,41755,1402
57293,8,78,459,58,4186,20
49161,252,2480,697,1993,26690,487
24830,80,2101,1148,1572,17726,529
13772,11,265,1336,161,10497,104
3639,34,1045,1439,800,13010,245
52388,18,242,608,192,11162,50
57685,123,1817,449,1372,23287,445
18736,37,1921,1256,1333,24723,588
25865,102,2169,1126,1401,36726,768
9317,32,1374,1378,983,30759,391
40884,1,28,821,20,5397,8
41860,70,784,804,547,15633,237
60104,14,213,368,159,5609,54
2122,792,21145,1453,14135,154355,7010
34514,776,38563,959,29724,225730,8839
17453,75,1127,1280,926,26687,201
16283,96,4291,1299,2732,46991,1559
24119,22,225,1164,171,4229,54
36520,982,18849,907,12710,119611,6139
49543,232,3347,686,2728,26345,619
37782,318,3851,875,2863,34482,988
30617,82,3658,1028,2173,19692,1485
5630,157,4573,1414,2930,31991,1643
14409,0,0,1326,0,8514,0
8796,227,9820,1381,6024,95869,3796
28648,15,503,1066,340,9454,163
59688,24,308,382,224,9113,84
67086,24,427,155,339,3700,88
39815,330,7877,837,6671,87834,1206
57113,519,7109,463,5882,40085,1227
38385,58,1014,859,903,20871,111
66309,20,155,180,124,3625,31
58611,150,2217,414,1816,41498,401
64042,18,414,243,336,15897,78
36120,302,5671,920,4545,70372,1126
54398,180,1437,544,1186,15173,251
61068,1368,24034,331,18570,79453,5464
65260,98,1031,208,844,10893,187
26975,51,986,1101,590,21912,396
16435,59,1310,1297,803,12687,507
23015,16,799,1184,567,24947,232
53889,89,1942,561,1190,11262,752
51400,19,341,638,220,8570,121
65550,24,160,201,121,5178,39
49369,5287,89017,690,66487,397950,22530
23301,10,313,1180,214,8063,99
64950,18,244,215,197,6822,47
34005,707,13601,970,9568,71829,4033
35387,62,757,937,555,10804,202
30697,491,9701,1026,7094,43829,2607
2820,92,5437,1447,3781,30708,1656
53768,5,85,566,72,5233,13
15922,12,148,1305,99,8186,49
11803,9923,502071,1361,271667,1884281,230404
59158,44,2186,400,1750,14584,436
31038,6,59,1020,43,8533,16
61534,27,325,317,240,6211,85
58834,83,833,411,692,10036,141
5533,75,2364,1415,1627,55538,737
59456,7,112,390,92,4858,20
30353,658,15957,1033,10796,120209,5161
20068,39,1177,1233,808,18258,369
30287,54,4044,1035,2261,50364,1783
4722,41,1381,1426,957,19156,424
18486,36,830,1261,592,19517,238
17149,54,1439,1285,874,8379,565
8757,27,781,1381,495,11197,286
29528,38,1932,1050,1242,18100,690
4647,43,1312,1427,834,32133,478
50435,457,5359,663,4192,47632,1167
3890,123,4781,1436,2927,137796,1854
65205,3,119,209,93,13548,26
32649,13,364,980,255,11600,109
29285,7,279,1054,250,12240,29
48641,291,6899,713,5774,48251,1125
4789,141,6879,1425,4690,34815,2189
27902,13,321,1081,188,5002,133
31572,27,663,1012,436,29830,227
28988,160,3183,1060,2186,49564,997
1690,2580,81014,1456,52196,346991,28818
61318,147,3425,323,2837,17299,588
31030,434,8935,1020,6266,41929,2669
33113,164,5334,987,3574,43098,1760
15298,555,15676,1315,10807,99689,4869
17694,466,22862,1275,15095,168536,7767
12303,14,836,1356,488,17652,348
34663,11,350,955,236,6477,114
61271,146,2097,324,1801,40204,296
23192,20,609,1181,515,53371,94
58615,43,407,417,317,9654,90
31015,1,47,1020,37,5760,10
13534,302,10258,1339,5919,46007,4339
35712,114,1245,930,1016,13604,229
12728,72,3299,1350,1644,16328,1655
16361,13,271,1298,207,7873,64
43677,554,11015,778,8961,65398,2054
24765,83,2507,1149,1695,20916,812
49654,1382,24117,683,16763,153955,7354
2157,253,9278,1453,5442,76125,3836
37450,2497,56000,884,47168,304690,8832
11575,176,7636,1363,4558,42302,3078
49138,99,2715,698,1869,25039,846
11151,32,718,1366,488,7121,230
23787,78,1831,1171,1211,30621,620
65323,7,149,206,122,3980,27
48697,42,1333,711,934,18558,399
36112,144,2490,920,2106,70645,384
41390,21,523,813,396,11272,127
12314,195,3473,1355,1980,21858,1493
64889,59,1001,218,914,18761,87
1895,25,604,1455,447,13563,157
32676,612,8794,995,6647,44533,2147
27591,36,760,1087,429,7245,331
24375,19,587,1158,418,11929,169
59103,42,479,402,349,13534,130
4340,6,119,1431,88,10576,31
15431,1657,48632,1313,31695,195590,16937
59784,44,518,378,425,7370,93
66449,30,402,176,320,9294,82
18112,1705,51976,1267,35606,255781,16370
34727,627,15211,950,11537,118904,3674
301,114,3047,1467,2139,17928,908
33432,107,1946,981,1439,16156,507
60980,2,52,335,33,4225,19
28631,5,119,1067,81,14507,38
33338,5,155,982,121,9848,34
6173,3357,249798,1408,145882,814280,103916
24002,66,2397,1167,1699,36809,698
4277,461,21877,1432,12971,72628,8906
6261,192,6828,1407,4827,63349,2001
15570,38,752,1311,497,18294,255
61606,5,43,315,35,4133,8
54706,76,683,532,484,7492,199
11010,532,18900,1367,11145,108000,7755
40893,115,2062,820,1690,20119,372
11994,2,274,1359,140,5019,134
28007,8,442,1078,263,9991,179
1520,92,2173,1458,1303,55929,870
35107,121,2492,944,1837,19621,655
26370,9,490,1115,293,10466,197
30810,98,2569,1023,2141,27629,428
59252,86,744,397,602,6637,142
45934,35,1376,753,1069,7113,307
6936,523,11192,1398,7609,41924,3583
57418,7,65,456,55,2593,10
7583,8486,223900,1390,126870,738170,97030
16983,1130,40597,1288,28593,274056,12004
51481,22,279,636,232,7807,47
35986,464,10364,923,7868,51543,2496
29312,742,15768,1054,10976,113248,4792
29571,187,4270,1049,2769,20349,1501
59882,4,22,375,16,1592,6
12,29,1112,1472,667,64174,445
17648,398,6319,1276,4302,61374,2017
64744,189,2288,223,1989,30470,299
53927,66,662,561,397,6843,265
55353,171,2637,512,1991,27342,646
26533,50,1595,1111,1305,23058,290
19456,193,8290,1244,5162,33448,3128
34449,27,845,960,569,24015,276
4408,1308,46173,1430,31480,158002,14693
54243,61,534,550,413,8041,121
67658,7,64,136,61,2541,3
32139,34,839,1004,531,20188,308
261,120,5183,1468,3135,37837,2048
24087,79,2583,1164,1707,17471,876
28961,32,1708,1060,994,27158,714
58900,78,514,408,433,7496,81
7060,67,1432,1396,1035,21645,397
65901,3,62,192,40,1571,22
62640,103,2780,281,2132,29681,648
54493,1381,20179,492,16250,150644,3929
11133,19,496,1366,291,6919,205
30606,31,736,1028,443,11765,293
5618,42,1392,1414,854,15465,538
4213,30,1319,1433,888,38568,431
54956,3094,49205,522,39497,265474,9708
29810,845,16735,1044,11477,115291,5258
22934,28,562,1186,407,26832,155
63444,10,202,261,158,5075,44
20216,81,1427,1230,956,24869,471
31469,170,3022,1012,2269,65601,753
53069,457,4411,522,3514,56883,897
45122,0,0,762,0,28809,0
46465,36082,720665,747,425841,1848025,294824
34454,68,2484,960,1751,32592,733
33006,179,2803,988,2366,23709,437
30860,64,892,1023,626,17450,266
51879,44,455,622,357,13009,98
38452,74,1057,857,840,9183,217
63313,111,2013,265,1452,29574,561
15739,9,267,1308,193,9410,74
13309,43,709,1342,440,6732,269
4298,5,151,1432,104,18485,47
36823,78,1369,902,1091,12266,278
2608,38,1502,1449,1015,21328,487
5708,9,237,1414,154,8554,83
19975,41,1190,1235,922,15935,268
35040,53,800,946,564,19814,236
28091,96,884,1077,637,13373,247
32047,63,1553,1005,978,21687,575
150,64,2746,1469,1557,70401,1189
65771,3,58,195,49,3995,9
60591,6,76,350,62,1817,14
51062,111,899,647,742,16651,157
10780,1520,22611,1369,14894,102387,7717
62582,16,133,283,97,3194,36
63557,8,146,259,109,4785,37
10691,21,1714,1370,979,12692,735
1178,2856,98027,1460,62625,327811,35402
60317,404,5776,360,4474,19496,1302
705,2610,99371,1464,68958,211714,30413
22137,15,496,1199,346,15907,150
48929,201,3275,704,2597,29772,678
219,30674,948804,1468,434485,1892141,514319
24622,14,415,1152,271,8743,144
14479,369,12445,1325,8038,144772,4407
36059,1220,14323,921,10572,50291,3751
29007,9,722,1060,429,16951,293
25783,7,139,1128,106,6561,33
23548,544,36891,1176,23485,143268,13406
27208,10180,232293,1096,140726,480162,91567
62054,8,174,299,147,8297,27
59652,46,878,383,611,16116,267
58499,7,90,421,73,1869,17
19380,44,1089,1245,737,24563,352
38508,24,520,856,364,14140,156
68415,4,104,112,75,3084,29
13349,48,1526,1342,864,10502,662
56705,255,3046,474,2573,27601,473
15594,784,24189,1310,16447,108355,7742
10985,6,222,1368,127,5947,95
2077,41,1033,1453,661,18960,372
1636,145,5001,1457,3489,43965,1512
60648,20,216,347,180,13595,36
49372,31,529,691,371,6693,158
23306,10,343,1180,276,29652,67
25182,93,734,1141,539,12407,195
50758,118,2011,656,1460,11602,551
9307,351,6215,1378,4128,31776,2087
33244,61,1790,984,1205,21861,585
24173,10,309,1163,253,10483,56
10685,33,1797,1370,1286,14005,511
8058,25358,714415,1384,531047,1895424,183368
33389,13,113,981,90,5741,23
21205,1119,36955,1213,28017,159833,8938
20146,41,1247,1231,947,18598,300
8107,8,658,1383,408,13155,250
61347,57,1682,322,857,23681,825
61732,150,2071,310,1639,7521,432
39455,33,640,842,486,14021,154
10408,11,509,1372,308,4343,201
25747,22,312,1128,246,5985,66
4266,12,727,1432,404,28016,323
3526,34,825,1440,620,21214,205
28324,177,6062,1072,3902,46957,2160
40411,10,334,828,266,5723,68
18585,475,10549,1259,7580,98334,2969
2518,457,13252,1450,8754,73529,4498
31284,99,1516,1016,1108,13597,408
4309,12,384,1431,290,5505,94
49755,11,150,680,106,3968,44
8740,222,4591,1381,2980,49398,1611
51268,9,121,642,92,7014,29
30837,850,15492,1024,10071,49029,5421
1987,688,21571,1454,13183,153816,8388
38154,9,183,865,151,8406,32
26380,48,1725,1114,1226,50735,499
9008,627,18559,1380,11722,55731,6837
45460,49,940,758,827,21341,113
16066,64,1187,1302,817,42943,370
12951,62589,2284568,1347,1275131,6292971,1009437
41524,3609,48136,811,36997,246391,11139
29388,71,2524,1052,2009,81658,515
52791,35,462,593,391,10805,71
30770,1591,59264,1025,38603,355539,20661
336,35,1922,1467,1379,72291,543
46458,3286,62178,746,47440,325885,14738
58123,56,934,430,734,13326,200
27633,57,1573,1086,1029,17501,544
3752,15,661,1438,483,9212,178
62925,73,1061,274,838,11838,223
46555,370,13627,745,10953,74041,2674
67446,19,117,143,95,3605,22
50949,3,98,640,58,3844,40
31458,125,1456,1010,1074,26610,382
63017,100,1006,272,863,19817,143
36527,225,3635,907,2544,15768,1091
40167,88,1565,832,997,28802,568
21867,694,30641,1202,17430,253682,13211
22726,149,2289,1189,1616,34703,673
36350,92,967,913,802,16343,165
59030,29,466,404,376,6317,90
35880,2369,38556,926,29620,230925,8936
67782,7,103,132,53,6375,50
28805,39,969,1064,616,31782,353
38468,51,1545,857,1130,24166,415
31672,66,2305,1011,1491,28707,814
9942,29,1024,1375,637,7948,387
51786,28,389,627,295,12013,94
13435,23,1039,1340,534,10359,505
59367,52,1714,393,831,12178,883
2132,58,928,1453,660,18812,268
22760,63,1331,1189,1014,33026,317
12286,19,919,1356,562,14152,357
26017,4209,120876,1122,73165,293779,47711
35363,39,920,938,632,6417,288
18922,0,0,1253,0,17534,0
11393,14,446,1364,289,8670,157
6326,82,2934,1406,1905,15414,1029
25257,10,301,1139,225,13432,76
9726,386,6852,1376,4349,53507,2503
27262,119,2648,1095,1897,16219,751
14052,31,2072,1331,1335,34658,737
12056,33,1488,1358,838,21101,650
66193,31,358,183,280,4909,78
9791,35,1555,1376,962,25715,593
15011,600,34951,1319,22971,218279,11980
31509,56,1652,1013,1070,28320,582
63457,6,98,261,75,4480,23
43373,20,319,781,242,9476,77
9580,67,1815,1377,1244,17997,571
461,348,9447,1466,6424,126128,3023
65702,10,116,196,97,4269,19
35884,10,440,926,330,8724,110
63924,37,611,247,521,10077,90
23295,10,227,1180,134,4038,93
52662,0,17,598,10,1187,7
36305,360,8638,914,6852,42281,1786
14396,58,1902,1326,1322,40252,580
51975,45,906,622,732,22139,174
67636,24,183,137,173,3134,10
6422,148,3871,1405,2291,27532,1580
6255,205,5167,1407,3552,31650,1615
34939,157,2949,948,2099,13343,850
401,32,858,1466,576,21375,282
61575,36,425,315,339,8024,86
37206,23,989,891,856,12614,133
60893,229,4171,338,3539,57635,632
19340,4914,87968,1246,59700,253778,28268
17558,8,177,1278,149,14814,28
63885,4,88,248,65,4320,23
6137,319,12122,1408,8066,160144,4056
39190,17818,473089,845,314562,962015,158527
53832,7,71,564,51,9004,20
23012,0,62,1184,42,8282,20
63720,8,159,254,121,2594,38
30114,0,0,1038,0,4915,0
17571,147,5808,1277,4198,34426,1610
15188,57,2755,1316,1891,60290,864
20517,519,10628,1225,7220,116027,3408
24354,89,2511,1159,1635,16637,876
22572,347,20194,1192,13922,45847,6272
43167,62,1198,783,956,11853,242
62887,18,218,275,186,8005,32
20945,140,6005,1217,4175,45904,1830
64404,2,21,232,16,3576,5
3437,6,222,1441,139,19523,83
59679,128,1804,382,1512,19851,292
62202,43,335,294,285,9374,50
9083,740,13088,1379,8343,42718,4745
54674,15,189,533,143,11104,46
12404,40,1424,1354,948,13416,476
232,7,407,1468,278,21024,129
34595,17,441,957,338,8539,103
13426,26,2269,1340,1114,16758,1155
59414,62,1262,391,921,14986,341
17158,392,20949,1285,10913,98990,10036
2168,22,525,1453,407,18719,118
61686,11,165,312,117,4711,48
67515,37,546,141,395,7824,151
26382,1345,31855,1114,22436,252262,9419
59706,16,198,381,166,5273,32
51689,22,232,630,193,13905,39
65411,27,230,204,179,4531,51
5403,8,199,1417,145,10137,54
58635,8451,195372,417,157770,607055,37602
2192,129,3785,1452,2643,20372,1142
47975,22,324,728,272,14958,52
66305,9,163,180,138,3832,25
26729,167,2075,1106,1435,54519,640
68758,11,164,100,119,3130,45
13340,15,549,1342,321,14886,228
32287,21,659,1001,377,10277,282
37487,7542,135275,883,107789,508778,27486
51901,17,437,624,342,6905,95
50995,529,16801,649,13438,91702,3363
57577,18,440,452,274,23831,166
26066,120,11116,1121,6472,36096,4644
15608,2,210,1310,126,4914,84
6052,21,537,1409,352,19343,185
67094,10,236,155,177,5933,59
64981,1097,10099,214,8239,57860,1860
52712,305,2748,596,2255,19776,493
26393,32660,1346710,1114,828020,3853056,518690
27837,5,107,1082,67,4966,40
62676,802,23852,280,19151,80734,4701
25978,12,183,1123,130,7038,53
10807,92,3765,1369,2107,13326,1658
68930,7,49,94,44,2511,5
7319,155,4197,1393,2871,59360,1326
33239,140,4655,983,3176,79784,1479
16662,16,577,1294,387,11218,190
55852,41,351,499,261,7869,90
52946,23,588,588,480,18207,108
3328,1453,25723,1442,18703,100381,7020
34174,8,101,966,84,9249,17
21120,10742,381922,1214,265180,1175493,116742
28635,22,321,1067,186,8516,135
22950,1274,25639,1185,17243,174837,8396
29557,49,994,1050,813,18085,181
39677,9,198,839,165,7112,33
24130,43,724,1164,524,10154,200
5078,64,1160,1421,816,40779,344
56804,27,233,471,180,9483,53
66546,26,424,173,320,4048,104
49901,21,305,677,245,6507,60
23628,330,8852,1174,5874,33846,2978
60165,76,427,365,349,7009,78
46907,605,7983,741,6455,33093,1528
9232,8,404,1379,278,5492,126
52819,125,1173,592,1040,19970,133
64243,45,566,237,395,4599,171
16680,28,901,1293,602,4916,299
18001,7,620,1269,509,41444,111
31779,33,947,1009,648,9315,299
28119,125,3331,1077,2200,20414,1131
53692,1911,54622,568,40389,119171,14233
40218,487,7138,831,5661,42948,1477
43505,84,1275,779,1058,17314,217
30473,2915,72064,1030,50697,214098,21367
44377,75,1244,770,1012,17594,232
11362,79,1785,1365,1024,17441,761
11200,59,1150,1366,744,9812,406
25714,6,492,1129,327,11700,165
15082,5,89,1318,64,12165,25
58411,13,312,425,220,10461,92
24426,349,8626,1157,5914,67394,2712
67893,1,26,129,15,1756,11
7790,14,289,1387,177,10666,112
321,4,295,1467,239,21996,56
6239,2192,68232,1407,41614,367409,26618
27767,6,127,1084,84,2367,43
38811,121,5307,849,3949,40865,1358
26316,244,11252,1116,7726,61535,3526
12827,4,344,1349,136,28151,208
6274,2,63,1407,47,5767,16
4377,46,1781,1430,1295,47852,486
61378,1,30,321,20,3696,10
57939,174,1620,438,1255,21296,365
17776,50,1271,1273,907,26161,364
68696,15,219,91,201,13316,18
3550,10,392,1440,278,15971,114
48872,15,360,706,293,5869,67
8122,9,594,1383,366,11862,228
6141,1,91,1408,60,8079,31
16982,6,227,1288,159,8666,68
58902,6,56,408,40,7507,16
8155,2,91,1383,69,7905,22
57528,116,1568,453,1141,19652,427
27571,661,19586,1087,13360,116983,6226
52610,118,1446,600,1122,12101,324
30100,1502,22519,1038,14515,135198,8004
35381,4,115,937,75,3323,40
9751,72,6163,1376,3932,47728,2231
66105,383,9406,186,7105,64246,2301
60419,46,418,357,362,9142,56
26720,590,9347,1107,6219,120063,3128
8449,13,912,1382,652,9256,260
60991,31,835,334,533,16085,302
2153,108,3168,1453,2146,41887,1022
68609,42,442,105,342,8957,100
20539,28,1265,1225,801,26552,464
11815,18,580,1361,333,19972,247
4858,46,823,1424,573,9665,250
48318,105,2882,722,2094,38517,788
18915,104,3799,1253,2551,70038,1248
57414,73,708,456,560,7297,148
21569,176,2934,1206,2505,40521,429
32542,83,1298,996,946,8224,352
25591,23,857,1132,566,6602,291
21210,8,374,1212,260,11639,114
5375,34,679,1417,494,18183,185
13120,75,2346,1345,1262,21305,1084
24662,413,13912,1151,7756,48236,6156
12261,158,10769,1356,6418,32789,4351
67967,35,375,126,280,5460,95
32234,458,17932,1002,13212,137751,4720
35927,680,22483,925,16621,153079,5862
27092,6517,197910,1099,109291,557842,88619
57367,461,6244,457,5104,39257,1140
65277,154,1486,207,1205,13618,281
57644,188,2170,450,1671,23927,499
9141,102,1505,1379,1170,18374,335
51039,13,222,648,209,20664,13
60933,33,440,336,316,5629,124
22810,23,1028,1188,696,34429,332
39625,3171,59410,839,44221,254587,15189
52322,4651,87202,609,57338,367210,29864
3018,6628,165437,1445,93642,301619,71795
10087,248,7653,1374,5130,58300,2523
57513,1000,11535,454,9648,53423,1887
28414,99,4132,1071,2616,36241,1516
68811,501,11652,97,9506,74646,2146
20771,135,2945,1221,2043,38484,902
45508,6,61,758,46,3536,15
60318,4,49,360,37,5428,12
2963,10,139,1445,92,5372,47
68827,16,153,97,145,7054,8
68937,22,559,94,426,11444,133
63082,57,891,270,764,10560,127
32021,1,65,1005,41,8618,24
59312,63,608,395,513,8902,95
21316,5,164,1211,118,15303,46
1165,33,1686,1460,1138,25570,548
57722,29,382,447,258,3227,124
50346,621,9383,666,6759,36399,2624
22672,21,654,1190,469,9723,185
47557,766,10777,732,8565,84564,2212
31108,6,58,1019,44,2596,14
19125,285,4521,1249,3137,45416,1384
5157,71,2223,1420,1497,36722,726
31735,87,1187,1009,1001,44247,186
68235,27,355,119,241,8404,114
19810,14,215,1237,157,18620,58
754,14,850,1463,556,26758,294
56759,6,66,473,46,4361,20
16817,8,442,1291,294,13506,148
23709,17,511,1172,351,7166,160
65748,21,277,196,243,6466,34
53572,20,234,572,167,9626,67
11361,39,962,1365,544,7944,418
4442,41,1104,1430,757,27133,347
13672,78,2521,1337,1660,18492,861
32491,106,3086,998,1784,17848,1302
30604,99,764,1028,569,13051,195
63079,3,34,270,21,1638,13
5622,2071,73514,1414,34631,199315,38883
68010,10,108,125,78,4511,30
3378,166,4388,1442,3139,49394,1249
65308,120,4103,207,3306,23236,797
68177,38,429,120,349,5524,80
29450,413,8195,1051,5342,42237,2853
68036,22,547,124,433,5959,114
28018,18,178,1078,137,7666,41
31606,60,1279,1011,814,7262,465
50672,28,371,658,301,3770,70
5142,244,7023,1420,4596,28729,2427
28331,32,1299,1072,578,17827,721
22071,360,9051,1200,6243,55591,2808
43597,270,7508,778,6045,45930,1463
48983,14,281,703,205,5488,76
9687,650,15759,1376,9339,58171,6420
17067,158,3022,1287,2064,20392,958
4879,6,261,1424,202,14719,59
52036,25,468,618,374,14518,94
22086,11,399,1199,303,20740,96
19653,48,3477,1240,1918,29369,1559
1988,79,1555,1454,999,29788,556
11416,187,6124,1364,3821,44856,2303
517,26,761,1465,455,21943,306
8867,250,11358,1380,7865,74797,3493
25273,0,676,1138,491,8210,185
16434,84,1572,1297,1053,26017,519
10639,4508,153518,1370,87099,676709,66419
50649,317,4440,658,3426,67739,1014
3268,29,986,1443,673,9221,313
41854,324,3147,805,2226,32622,921
3558,44,1576,1440,1072,48378,504
16113,29,440,1302,337,6809,103
58073,30,492,435,334,6577,158
56350,12,243,485,169,7399,74
5509,75,1513,1416,946,10042,567
1280,4,157,1459,96,26174,61
40539,259,4026,826,3314,50716,712
9432,28,978,1378,675,20817,303
49710,3724,60550,682,45365,199230,15185
54271,60,997,548,757,19498,240
54005,2,16,558,14,3091,2
16782,884,22438,1291,16877,125294,5561
56376,233,2408,484,1916,31521,492
51410,69,1113,638,812,18610,301
64393,5,164,232,120,7052,44
447,25,632,1466,503,30893,129
26035,123,974,1122,799,10737,175
13604,89,1504,1338,1019,17680,485
45836,31,816,754,630,11895,186
66487,6,90,175,50,1635,40
4390,778,16921,1430,9799,80103,7122
21375,3,199,1210,137,8501,62
17316,3,239,1282,181,22054,58
44966,234,2123,763,1665,16802,458
6007,137,6045,1410,3346,36315,2699
16225,57584,2053755,1300,1558006,4532766,495749
29027,19,449,1059,269,10798,180
22678,182,5695,1190,3504,20522,2191
13782,54,1307,1335,662,17650,645
50615,132,2052,659,1640,37009,412
37926,70,1396,872,1199,35455,197
19301,11,367,1246,275,12312,92
6368,19,1087,1406,782,10575,305
49115,18,217,699,158,5787,59
10763,18,662,1369,434,11316,228
15394,144,5623,1314,3735,48004,1888
50248,28,297,668,231,5667,66
41338,25,467,813,391,28906,76
55676,19,243,504,189,5827,54
49827,3500,50557,679,39980,577651,10577
29630,66,1602,1048,968,52500,634
21797,32,1566,1203,989,18836,577
50311,60,987,666,743,24896,244
18900,59,3171,1254,1745,22222,1426
54275,57,715,548,539,11811,176
57222,15,174,461,109,7656,65
40589,23,367,826,277,9052,90
54412,1272,13579,543,11312,128757,2267
11944,259,6511,1359,3736,53193,2775
727,735,31015,1464,18375,127173,12640
12624,988,31929,1351,21487,195645,10442
5409,130,4982,1417,3334,31631,1648
66391,39,301,177,241,2496,60
8911,62,1818,1380,1237,14889,581
57314,14,298,458,201,7567,97
35868,37,522,925,350,5693,172
192,203,8797,1469,5254,75707,3543
506,11,349,1466,244,15265,105
51105,722,11067,646,8993,57340,2074
43183,41,513,783,408,6128,105
56486,1,8,481,7,5054,1
33404,19,272,981,216,6680,56
48439,94,2681,720,2090,61602,591
33925,91,2190,972,1586,55325,604
2720,76,3616,1448,2267,26057,1349
25394,56,3225,1136,2125,37335,1100
44312,43,2248,771,1725,14249,523
60445,6791,120154,355,93918,352388,26236
62832,18,227,277,183,2827,44
6781,20,1304,1400,885,34609,419
63784,2,36,252,35,3102,1
2754,51,1791,1448,1275,47110,516
42706,52,830,791,662,25964,168
1903,17,428,1455,299,9676,129
14369,14,503,1327,388,18387,115
27747,689,28577,1084,21272,144020,7305
14694,23,670,1323,442,5994,228
12111,340,16855,1358,8780,167835,8075
65833,0,25,194,19,1803,6
16923,4,96,1289,67,4056,29
62837,6,73,277,41,4115,32
62,2052,114380,1471,70381,404014,43999
8344,28,1280,1383,759,14868,521
45199,43,841,761,600,12926,241
7422,208,3888,1392,2525,39991,1363
54416,4554,62059,543,45611,196386,16448
68499,6,90,109,69,6967,21
66635,23,218,170,180,5606,38
37400,366,17317,885,12989,75517,4328
19542,21,676,1242,496,14706,180
64077,8,166,242,110,6220,56
57605,11,161,451,134,8845,27
63620,23,520,257,439,6191,81
29371,72,1050,1053,925,48143,125
62942,35,241,274,191,4128,50
59274,112,1206,396,869,8274,337
11762,7,477,1361,224,21844,253
16673,3,183,1293,131,10485,52
51769,2896,48543,627,31571,102662,16972
10035,607,9536,1374,6823,38730,2713
60783,160,5113,342,3937,42969,1176
35334,69,805,938,608,4984,197
43493,8608,102385,780,66227,219265,36158
56893,115,1579,469,1272,12339,307
68749,3,21,100,16,2027,5
19310,278,7695,1246,4818,93227,2877
23633,153,3865,1174,2786,72710,1079
56747,72,892,473,710,7246,182
64674,1,16,224,15,2239,1
65909,29,190,191,166,8201,24
49,104,3417,1471,2011,50604,1406
2663,49,2747,1449,1872,27419,875
44172,347,4339,772,3645,102658,694
6584,16,882,1403,585,38975,297
68991,4,19,91,14,1483,5
55178,42,464,518,375,8981,89
7900,11,714,1385,565,19120,149
13072,61,2541,1345,1473,11050,1068
10513,32,2095,1371,1359,34851,736
31118,564,14869,1019,9604,71704,5265
56745,103,1605,473,1118,15898,487
59461,139,2090,390,1624,12199,466
59478,21,246,389,177,9017,69
34579,0,52,958,31,1931,21
10241,151,5770,1373,3344,80023,2426
11749,35,958,1361,425,13343,533
38171,33,421,865,344,7886,77
65810,8,91,194,72,6592,19
69014,5,171,91,140,4289,31
25857,76,1896,1126,1231,13934,665
35174,950,16632,942,10769,234736,5863
8625,8,258,1381,169,4161,89
57797,9,133,445,112,5928,21
13024,44,1297,1346,788,10318,509
34953,13,306,948,217,3509,89
47961,53,841,728,668,6110,173
47303,66,1092,735,836,21841,256
547,1464,36275,1465,21388,87743,14887
60774,329,3760,342,3291,23005,469
8045,578,7706,1384,5279,70827,2427
26539,124,2936,1111,1960,39124,976
42380,710,10324,797,8505,113109,1819
47445,71,1409,734,1104,12719,305
45420,12,208,759,147,5356,61
66182,0,0,183,0,2751,0
40675,415,6000,825,4455,56846,1545
60743,15,164,343,140,5386,24
45687,52,826,756,647,14189,179
34829,161,4416,951,3349,81747,1067
35142,191,3321,943,2410,24875,911
32627,43,1007,996,717,10052,290
50976,97,1966,650,1487,10369,479
49160,14,210,697,166,14789,44
1910,1,70,1455,52,6195,18
45224,6,110,761,78,2670,32
58033,55,713,437,569,12053,144
35711,40,1022,930,725,14540,297
64826,18,251,220,214,9577,37
66371,14,293,178,234,8596,59
61033,204,5703,333,4204,39327,1499
65153,16,208,210,163,3123,45
51656,380,5258,630,4364,65106,894
53181,97,1238,581,987,10534,251
57115,7,118,463,77,9043,41
48362,29,527,722,412,18575,115
52579,63,701,601,567,13021,134
27752,20,483,1084,335,23382,148
26106,63,1227,1120,737,18518,490
25055,23,549,1143,347,10077,202
9167,189,5398,1379,3434,35534,1964
11706,36,1612,1362,892,13904,720
54986,4,25,523,25,3738,0
52224,257,2515,613,2117,29425,398
29720,238,5502,1047,3705,32458,1797
17665,11,341,1276,246,14379,95
48748,231,3819,710,2518,26377,1301
17975,12,486,1269,285,6546,201
68061,0,0,124,0,2217,0
29393,8,310,1052,179,20056,131
6645,38,724,1402,469,15388,255
33588,135,3917,978,2390,17321,1527
27122,239,5266,1098,3408,55850,1858
15501,3555,133807,1312,92891,313464,40916
15671,45,1035,1309,738,17905,297
32858,10,201,991,138,9853,63
9811,165,4250,1376,3003,28568,1247
67475,0,0,142,0,1512,0
5259,73,2763,1418,1898,27618,865
9646,152,5070,1377,2553,24644,2517
969,12,602,1462,430,13463,172
5021,25,1052,1422,696,22533,356
41626,829,13863,809,10329,57262,3534
35500,133,2366,935,1668,12247,698
54620,29,244,535,218,5966,26
36504,4,127,908,97,15193,30
417,45,2031,1466,1459,71699,572
49497,12,316,688,219,8402,97
13521,391,16333,1339,9427,159812,6906
58661,11,111,416,71,3143,40
3114,1,136,1444,110,10110,26
16258,61,1511,1300,1003,23706,508
2014,5,284,1454,223,16624,61
32698,155,3274,994,2118,79539,1156
26552,0,0,1111,0,9585,0
6174,37,918,1408,631,18841,287
10947,66,2830,1368,1889,26840,941
15448,49,1163,1313,867,19446,296
63676,69,623,255,490,4726,133
1779,1062,45243,1456,28135,293978,17108
57845,164,2210,443,1828,17395,382
58279,6,122,429,100,3792,22
45283,328,5783,760,4866,35082,917
60304,61,1395,360,1155,14811,240
16582,25,634,1295,423,12564,211
68163,12,214,120,189,4135,25
23533,65,1228,1176,790,16766,438
43649,2828,56643,778,39594,369075,17049
1583,5,399,1457,233,11426,166
6674,20,2413,1401,1638,15654,775
31029,164,4174,1020,2245,22770,1929
21317,10,292,1211,195,9219,97
60298,81,1364,360,1060,7792,304
57301,147,2369,458,1762,28870,607
57269,26,323,459,246,7585,77
36321,272,3476,913,2701,36336,775
66870,39,413,162,336,8521,77
31315,17,334,1016,224,12369,110
30508,16,583,1030,361,7963,222
4352,38,1742,1431,1213,25301,529
56812,352,10132,466,7447,48828,2685
18194,13,215,1266,159,11924,56
2334,6,399,1451,266,29990,133
1578,13,902,1457,629,10224,273
33791,1189,30470,974,21700,128876,8770
37127,158,2358,893,1876,15479,482
6328,85,4312,1406,2534,25661,1778
39858,51,1098,837,930,12909,168
21357,22,525,1210,401,13341,124
36353,28,587,913,478,8402,109
52296,3752,76548,611,56835,190637,19713
62367,59,777,289,594,7416,183
11897,87,4283,1360,2327,20574,1956
58177,66,1032,432,839,14575,193
66913,47,671,160,530,11709,141
59114,1678,42593,402,34270,160161,8323
3874,252,5583,1436,3960,26763,1623
35412,0,0,512,0,7447,0
22603,164,7058,1192,4940,56418,2118
17488,1188,48274,1279,35744,427357,12530
3623,329,8564,1439,6021,53647,2543
57377,7,73,457,66,14724,7
19749,356,7493,1239,5238,62325,2255
7755,239,9885,1387,6728,139941,3157
24742,122,3067,1149,2199,30226,868
34945,9,330,948,230,14146,100
67565,0,30,139,23,2886,7
58476,6,111,422,89,3832,22
33543,12,279,979,202,5612,77
11301,53,2220,1365,1306,13752,914
22650,6669,124132,1191,89053,650107,35079
6132,50,1759,1408,1207,48749,552
41072,132,2568,817,2005,49454,563
23439,42,2706,1177,1739,46397,967
26470,491,12331,1113,8698,65838,3633
36970,556,15710,898,13460,89155,2250
17274,3,152,1283,108,15606,44
18047,41,1430,1268,1004,19700,426
49555,460,17923,686,13664,100315,4259
25969,385,7856,1123,5179,44346,2677
8982,29,995,1380,633,27351,362
58686,21,327,415,237,4259,90
61503,5,102,317,75,3632,27
32869,14,380,991,243,13836,137
45545,292,5313,757,3960,32502,1353
50262,5,106,666,67,5053,39
14652,49,1312,1323,988,16995,324
36386,286,2257,912,1732,27963,525
63305,11,152,265,109,4123,43
5873,319,7548,1412,4974,40799,2574
60772,573,10815,342,8446,55919,2369
24216,38,1089,1162,664,7642,425
5724,354,13081,1413,8644,58592,4437
28709,45,1017,1065,647,9470,370
16798,14,386,1291,266,4382,120
40602,45,883,826,779,38493,104
464,81,2753,1466,1665,26185,1088
47216,6,120,737,85,5414,35
67772,11,327,133,269,6514,58
63260,90,1491,238,1238,19958,253
31586,12,612,1012,423,10118,189
30948,1957,42844,1022,32479,248173,10365
44834,53,666,764,516,18441,150
11309,5,111,1365,82,10612,29
14176,4237,168279,1330,119253,489708,49026
11450,3461,68663,1364,45896,578185,22767
9435,37,1438,1378,926,22190,512
59716,145,2386,381,1648,11757,738
12114,4,234,1358,114,6262,120
6428,236,11292,1405,7508,66968,3784
56557,503,10493,478,8301,134027,2192
52694,5675,87737,581,68837,260265,18900
55703,279,5087,503,4044,44393,1043
4901,10,305,1423,228,25936,77
20372,618,17628,1228,12606,97379,5022
54371,189,1620,545,1295,11399,325
23323,185,6224,1180,3876,44621,2348
11123,86,2250,1366,1433,19684,817
51731,0,0,629,0,3227,0
12130,27,1769,1358,964,14115,805
29881,96,1979,1043,1326,9924,653
13606,4159,112204,1338,73623,393245,38581
24121,115,3616,1164,2536,98820,1080
10338,14,1229,1372,735,16092,494
39057,21,451,846,396,15676,55
5003,82,3305,1422,1963,16533,1342
68520,17,217,108,167,6585,50
36483,7,211,908,170,5814,41
64127,47,622,237,514,4960,108
49139,48,911,698,633,14339,278
18800,29,1202,1255,865,15995,337
7045,2574,68106,1397,45063,248481,23043
52071,218,2114,617,1550,38589,564
13559,292,8685,1338,5665,31995,3020
11154,0,12,1366,11,343,1
33353,232,4730,982,2725,19351,2005
76,307,12590,1471,8098,89843,4492
49164,124,2245,697,1702,28224,543
940,255,13529,1462,9179,72468,4350
18385,11,275,1262,196,9305,79
55222,33,515,516,383,3860,132
45659,17,210,756,187,6889,23
55707,684,8764,503,6910,57059,1854
35587,26,729,933,581,24181,148
32459,13,270,995,197,7547,73
23252,9,343,1180,263,8770,80
5359,14,903,1417,585,11246,318
51116,8,147,646,115,6313,32
2727,910,63959,1448,41507,241316,22452
46265,51,1035,749,870,13566,165
30172,70,1185,1037,734,17613,451
9340,76,3393,1378,2312,45477,1081
18348,2,205,1263,168,6931,37
5114,23,377,1420,258,16014,119
15769,36,1167,1308,831,42296,336
33308,29,1423,983,951,13497,472
59529,11,284,388,197,8191,87
40465,56,761,827,587,12307,174
64682,6,52,224,39,3030,13
2624,302,12066,1449,7729,132557,4337
66100,9,168,186,118,4060,50
52299,108,872,610,701,14919,171
234,12,973,1468,704,16909,269
28320,9,429,1073,285,9361,144
4558,45,1119,1428,698,14765,421
1605,31,1040,1457,777,5848,263
48751,38,626,710,440,15406,186
54605,26,462,536,193,11277,269
37380,1,22,886,16,1846,6
47881,5,91,729,75,11161,16
67467,90,1348,142,953,11031,395
27644,136332,3485710,1086,1690407,7951082,1795303
27994,27,957,1079,664,28024,293
7106,5,225,1396,157,10343,68
13222,7,255,1344,136,6804,119
17733,92,3289,1274,2348,54899,941
13790,175,8604,1335,5199,38806,3405
51886,1295,15237,624,12201,67019,3036
15092,11,214,1318,147,6641,67
66518,78,999,174,860,10375,139
16164,76,3536,1301,2411,33479,1125
11783,10,590,1361,209,8815,381
22751,89,1759,1189,1354,15255,405
22945,19,557,1185,389,6502,168
46877,7,79,740,67,4906,12
63391,36,578,263,439,6785,139
60226,46,810,363,644,29730,166
58186,17,277,432,223,5609,54
51227,13,199,643,165,4409,34
10998,54,3133,1368,1988,31420,1145
21812,474,10561,1203,7217,40720,3344
50073,14,240,672,187,12386,53
34863,68,856,950,505,7518,351
49683,34,548,667,452,8441,96
29223,383,5865,1055,4108,22740,1757
25454,0,322,1135,201,23663,121
53539,37,590,573,507,14585,83
56139,31,391,491,320,13678,71
36974,36,901,898,728,20814,173
36785,17,470,903,385,7755,85
38465,3200,44408,856,32471,170262,11937
1614,91,3894,1457,2706,27699,1188
53892,88,2212,561,1809,14802,403
20396,23,847,1227,590,27944,257
3769,12,452,1438,305,19909,147
14215,327,6075,1329,4204,41398,1871
34109,32,254,967,204,3801,50
24703,14,1187,1150,762,33995,425
48780,315,9126,709,6896,86664,2230
4137,10,122,1434,83,5935,39
41669,83,2947,805,1994,27266,953
66209,20,202,182,157,17684,45
28110,3408,110740,1077,78405,225760,32335
19588,37,1281,1241,839,11981,442
33492,39,1006,979,642,11882,364
23696,130,4012,1173,2603,19135,1409
4127,18,603,1434,405,12607,198
14255,4,66,1328,46,3421,20
18743,39,1284,1256,1012,19207,272
4030,97,4060,1435,2483,27593,1577
52039,52,690,620,484,14737,206
21853,29,584,1203,355,12851,229
15045,631,34839,1318,20739,193376,14100
5803,4277,138626,1412,83980,557239,54646
37674,29,867,878,726,33253,141
5014,619,23061,1422,15748,236396,7313
31492,31,501,1014,381,12419,120
66621,15,443,170,282,9510,161
43099,19,420,785,353,11158,67
40298,41,580,830,432,5781,148
48662,52,450,713,356,7276,94
10773,293,8384,1369,5088,42753,3296
21287,7,147,1211,117,5775,30
20183,117,2060,1231,1464,9951,596
18682,24,842,1258,634,24662,208
6225,170,5589,1407,3897,33834,1692
57183,550,7079,461,5149,38024,1930
5332,11,775,1418,465,17884,310
11694,0,0,1362,0,13613,0
46348,59,1390,748,1207,32331,183
8124,474,23958,1383,15110,72400,8848
37294,17,213,888,165,5521,48
25050,25,750,1143,622,11180,128
65602,1669,17552,200,13098,67790,4454
61430,676,9345,320,7291,38847,2054
60201,9,78,364,54,7116,24
66910,31,421,160,337,7399,84
18245,27,499,1265,378,12561,121
52800,1529,37071,593,24163,265842,12908
65234,14,235,208,200,6190,35
67546,2,64,140,43,1821,21
31060,21,612,1019,342,6052,270
35952,93,5311,924,3442,37617,1869
42504,7,215,795,189,7422,26
14970,51,1130,1319,849,14430,281
31836,11,670,1008,337,12400,333
66569,7,257,171,175,2581,82
5507,162,4572,1416,3139,59265,1433
8905,749,15569,1380,10324,63418,5245
55091,21,294,520,238,6798,56
37254,2,104,889,80,4036,24
27914,131,2687,1080,1630,18561,1057
49517,114,877,687,682,11140,195
21894,656,17199,1202,10509,56702,6690
25982,235,4693,1123,3215,48116,1478
35843,1502,41168,927,32462,188614,8706
35715,32,936,930,742,21125,194
57527,9,120,453,95,5129,25
54917,233,4357,525,3494,24973,863
53929,120,1108,561,1008,20430,100
59144,32,476,401,350,8138,126
14361,80,1363,1327,938,12802,425
58322,295,2438,427,2008,18667,430
53009,41,468,586,391,6688,77
64938,62,710,216,608,4805,102
44185,8,266,772,208,7780,58
2871,7,365,1446,264,7417,101
28287,7955,195448,1073,123728,1020710,71720
28544,129,3397,1069,3030,38450,367
24090,434,10203,1164,6465,85886,3738
27133,7,206,1098,149,7431,57
57884,34,382,442,270,8033,112
11451,29,1305,1364,804,13756,501
3295,2,49,1442,37,4739,12
9692,22,697,1376,473,24622,224
38313,13,235,862,176,5558,59
12055,19,713,1358,427,13863,286
40758,311,4932,823,4027,68489,905
39284,8,110,844,85,2053,25
26670,23,605,1107,383,23665,222
64439,170,1910,231,1625,10816,285
35201,98,919,942,686,7592,233
48657,117,1087,706,872,14350,215
33257,23,489,984,317,5361,172
60706,193,3466,345,2569,15591,897
49329,51,726,692,640,26260,86
32109,12,226,1004,183,5712,43
25814,66,1385,1127,950,15127,435
1388,19,734,1459,533,15944,201
29761,24,664,1045,384,26591,280
12841,5,245,1349,128,10509,117
48423,7,214,721,170,16161,44
68875,25,568,94,515,9544,53
41452,134,2985,812,2145,14722,840
66084,71,797,187,613,11980,184
37266,382,8523,812,7050,59816,1473
23340,88,1340,1179,1011,11962,329
34815,227,3206,951,2227,17402,979
52790,444,5470,593,4465,39785,1005
3851,65,2337,1437,1653,32617,684
54216,239,2249,550,1785,24279,464
3345,199,9603,1442,6565,110379,3038
17686,6,225,1275,173,13807,52
63812,5,53,251,42,9843,11
59823,34,446,377,276,15836,170
10545,70,2156,1371,1590,52087,566
25952,9,276,1124,196,14942,80
5396,16,1227,1417,934,8991,293
32989,34,371,989,256,3317,115
31053,52,1429,1020,1162,10033,267
61207,86,1097,219,910,9306,187
50026,4,35,674,31,2184,4
38543,36,636,855,532,11592,104
34057,36,533,968,348,9178,185
5330,22,1345,1418,1007,22899,338
67139,6,100,153,72,9831,28
69025,31,548,90,480,6810,68
10502,95,3755,1371,2326,24839,1429
54537,31,607,539,409,19607,198
66389,257,2534,177,2145,15648,389
32604,3,43,996,38,6839,5
26932,24,224,1102,165,10885,59
59785,113,1547,378,1308,26892,239
40468,850,15874,827,12240,54477,3634
67929,13,180,128,138,3334,42
17303,324,2913,1282,1992,29373,921
29319,100,8444,1054,4988,30577,3456
46756,34,411,742,351,9408,60
64036,11,161,244,129,3322,32
43229,7,107,782,67,5958,40
12691,12,839,1351,448,10001,391
29682,11,568,1047,342,11976,226
276,27,739,1467,484,31965,255
23463,44,1176,1177,821,18414,355
27414,67,1584,1092,983,9265,601
43369,12,329,781,241,6506,88
16839,113,4414,1290,2955,69632,1459
61707,17,188,311,143,4088,45
41759,3,273,806,92,4972,181
41231,10,359,815,267,6853,92
34138,64,1140,967,836,26953,304
48701,342,5903,711,4353,36279,1550
18297,38,915,1264,746,48008,169
61981,22,673,302,333,15089,340
15934,23,693,1305,473,12825,220
60206,431,13944,364,11813,40580,2131
28527,451,19652,1069,14728,47182,4924
31344,6,375,1015,241,11461,134
19564,12,475,1242,357,32204,118
31873,3,50,1007,41,5917,9
27516,9,483,1089,285,19259,198
41638,239,3033,808,2284,38549,749
22732,1173,23435,1189,15515,125615,7920
53988,131,773,558,666,14282,107
44512,3,36,768,28,2001,8
65089,19,172,211,122,5396,50
703,515,11773,1464,7250,81076,4523
60089,5,37,368,30,2635,7
31173,459,12130,1018,7232,33491,4898
67644,9,275,128,189,6118,86
36243,6,184,916,122,17265,62
2588,272,17250,1449,8649,129409,8601
2552,2433,73627,1449,47327,181419,26300
36108,19,474,920,351,15910,123
53612,10,127,570,107,8816,20
21471,8,385,1208,266,13992,119
28187,174,5964,1075,4147,26298,1817
56070,12,48,493,46,3537,2
11804,189,3770,1361,2117,23064,1653
27929,22,316,1080,205,11883,111
4314,24,1282,1431,959,18380,323
35271,5,137,940,103,6805,34
25328,39,1022,1137,668,6788,354
9195,48,1427,1379,882,23209,545
60434,24,396,355,308,5341,88
27257,3,102,1095,91,7573,11
34878,142,1542,950,1085,18647,457
35920,1596,38658,925,30610,182968,8048
56267,15,156,487,99,2455,57
55606,4,45,506,36,1900,9
29844,62,3062,1044,1833,37185,1229
730,96,3691,1463,2390,23106,1301
30901,9,440,1023,276,5283,164
15076,10,605,1318,422,10667,183
67483,614,11181,142,9633,104042,1548
5337,2,87,1418,72,14216,15
7702,459,14956,1388,10841,46790,4115
35490,197,5156,935,3529,90374,1627
63175,48,511,268,415,5297,96
65102,10,345,211,244,9707,101
58679,21,218,415,153,4072,65
15151,27,1848,1317,1269,24717,579
40480,1,36,827,33,4449,3
58404,8,85,425,59,6086,26
56454,42,632,482,482,29856,150
2699,3119,164064,1448,98057,532913,66007
51526,68,898,635,701,27908,197
62788,6,67,278,54,2687,13
62615,5,85,282,65,3224,20
45921,47,832,753,539,9153,293
4680,182,9248,1426,5706,71761,3542
31286,112,3528,1016,1844,15784,1684
35239,22,312,941,234,9547,78
66578,225,2395,171,2114,18938,281
5279,25,1101,1418,711,19661,390
22377,2,44,1195,35,5224,9
21528,37,2644,1207,1701,22257,943
9747,117,4941,1376,2624,17490,2317
52052,30,468,619,330,7361,138
22546,21,518,1193,366,9367,152
10899,40,1390,1368,755,22109,635
24965,53,1589,1145,983,7794,606
14629,426,13281,1323,9148,64958,4133
33906,2,127,972,90,2916,37
67432,19,231,144,172,5010,59
49851,30,458,678,364,7784,94
14318,138,4760,1327,3333,109853,1427
46107,15,322,751,268,10411,54
29730,3845,82798,1046,53420,293841,29378
23051,2,84,1184,66,30640,18
28880,2338,49145,1062,32402,292849,16743
41815,61,1420,805,1053,15388,367
51120,6,91,645,84,12014,7
20331,14,441,1228,329,5543,112
61317,215,5211,323,4265,36963,946
10240,352,5464,1373,3685,63040,1779
28885,35,2636,1062,1518,44959,1118
53023,190,1661,586,1232,15992,429
21258,20,1023,1212,688,13170,335
20926,2031,32946,1218,20426,93475,12520
26364,9,242,1115,154,9639,88
66745,56,954,166,841,9901,113
27689,9,321,1085,184,10312,137
35684,326,6791,931,4789,26584,2002
19126,22,1543,1249,1094,39863,449
5696,28828,1067418,1414,589830,4237220,477588
14159,121,2250,1330,1467,14811,783
41101,163,2444,817,2045,49364,399
6623,118,7518,1402,5133,87320,2385
49510,9,156,687,144,7528,12
40914,3966,63481,819,48740,481755,14741
57518,11,229,454,115,8376,114
10902,1389,49703,1368,29558,241810,20145
14487,47,1033,1325,797,9114,236
65811,7,71,194,41,4490,30
38011,122,2083,869,1591,14208,492
55678,4,35,504,32,7317,3
15867,3,157,1306,113,4063,44
50389,324,4648,664,3673,50677,975
15275,72,2580,1315,1872,29620,708
63167,88,1242,268,1020,11727,222
38974,52,1004,848,796,28601,208
54345,9,87,546,69,6173,18
50129,95,1485,671,1172,23839,313
25116,38,861,1142,501,9364,360
11460,70,3541,1364,1680,32735,1861
8272,32,699,1383,436,8075,263
5385,22,921,1417,646,14702,275
60864,2,20,339,13,4882,7
65824,22,204,194,162,3050,42
20466,3,139,1226,113,11762,26
22521,78,3175,1193,2202,25330,973
58857,221,4412,410,3496,60735,916
31051,33,480,1020,300,5795,180
34997,24,444,947,303,10541,141
19642,56,2477,1241,1556,105369,921
22817,1,145,1188,110,10809,35
29777,17,704,1045,458,16017,246
10830,10,1535,1369,716,9111,819
63311,29,176,265,141,4064,35
31694,1,147,1010,98,14278,49
34662,229,4634,955,3091,24636,1543
15027,20,272,1319,225,20286,47
8256,352,7672,1383,5043,31248,2629
2202,29,861,1452,616,10857,245
27292,126,3112,1094,2159,27131,953
26088,5,61,1121,44,4773,17
5020,56,1695,1422,1316,25197,379
51708,23,250,629,208,2826,42
53678,115,906,568,727,10171,179
34670,137,2181,954,1516,32919,665
26114,19,1272,1120,761,37315,511
48602,14,280,714,210,4732,70
19929,115,5097,1235,3790,67765,1307
64423,20,183,231,145,5863,38
52461,3,71,605,57,4512,14
5469,61,1699,1416,1141,19586,558
30703,131,2414,1026,1597,13844,817
5334,16,704,1418,501,11359,203
31417,35,1125,1015,752,21937,373
17187,26,714,1284,548,10002,166
38523,114,3027,855,2356,29822,671
24898,2820,103059,1146,64526,267573,38533
61253,144,2047,324,1779,21639,268
10364,6,273,1372,173,6351,100
51017,106,2190,649,1648,30860,542
19214,63,3195,1248,2253,39689,942
15789,15,251,1308,176,7133,75
25727,71,3089,1129,2149,36145,940
31774,367,7148,1009,4722,37938,2426
14577,4,291,1324,190,11419,101
31878,4,257,1007,168,6893,89
2401,74,3833,1451,2478,55177,1355
37267,30,1088,889,668,12545,420
12344,24,2350,1355,1148,24016,1202
36760,31,427,904,331,20008,96
42628,38,1108,792,813,14268,295
11945,510,10440,1359,6308,88119,4132
34093,23926,543884,967,360770,1306170,183114
27997,790,22160,1079,14611,161784,7549
30537,43,1836,1029,1067,17069,769
65473,7,218,203,164,3567,54
65155,1836,57853,210,45182,202055,12671
12866,6889,233409,1348,147942,555864,85467
26603,12,262,1109,177,12741,85
20292,95,3382,1229,2746,33173,636
57796,37,675,445,487,12650,188
25067,7,191,1142,149,7733,42
25685,847,14493,1130,9420,57110,5073
34501,6,56,959,38,2094,18
29399,181,3593,1052,2517,49601,1076
42770,1,33,790,24,4684,9
18868,19,1178,1254,741,11482,437
13887,52,1737,1334,1123,41254,614
64613,26,620,226,467,16923,153
13281,1576,69308,1343,45783,344799,23525
51776,41,370,627,313,6547,57
26818,106,3359,1104,2190,55613,1169
6240,8,313,1407,202,26678,111
21922,2879,116354,1201,68426,181118,47928
67128,0,11,154,7,2051,4
32280,63,2341,1002,1716,21459,625
52940,38,404,588,338,16723,66
49746,491,6235,681,5038,88178,1197
15612,55,757,1310,490,11749,267
3576,9,448,1440,336,17918,112
11565,52,1992,1363,1209,17907,783
38323,50,481,861,359,8053,122
4780,170,8079,1425,5457,148201,2622
23979,115,1702,1167,1337,23290,365
18225,204,11416,1265,7268,42052,4148
61735,23,311,310,227,5401,84
10024,14,1314,1374,911,14784,403
14315,4,51,1328,32,6115,19
4632,731,29940,1427,17426,342532,12514
57283,409,9148,459,6301,28474,2847
21188,60,2466,1213,1519,18422,947
32741,1318,36167,994,25630,78356,10537
58236,41,557,430,457,25236,100
66680,15,264,168,210,7937,54
58417,348,4012,424,3060,32719,952
60850,155,1862,340,1218,16610,644
38012,233,6644,869,5610,52433,1034
22862,18,735,1187,515,10867,220
9280,251,6925,1379,4415,31917,2510
30532,22,625,1029,399,15815,226
10490,2,194,1371,126,12051,68
41700,16,524,807,410,8235,114
29696,23,305,1047,252,7356,53
11710,62,1815,1362,1001,15967,814
45740,64,783,755,668,31995,115
1339,392,13431,1459,8409,45586,5022
203,39,2137,1469,1557,28449,580
2762,610,13993,1448,7777,67742,6216
46872,16,290,741,200,10817,90
22095,16,441,1199,308,7253,133
52648,989,10922,597,7319,46453,3603
423,0,1962,1466,1166,22243,796
22147,30,668,1199,450,13803,218
62004,1,17,301,12,1953,5
26550,45,1358,1111,744,13265,614
10212,151,5001,1373,3494,66579,1507
9787,66,3282,1376,1851,21580,1431
56369,118,1567,484,1192,17170,375
51648,21,186,631,150,3434,36
6748,119,5147,1400,3346,104608,1801
29406,92,2886,1052,2228,96375,658
10820,62,3212,1369,2149,15186,1063
19761,43,1464,1238,1071,34006,393
16220,3,139,1300,86,5823,53
34145,48,1863,967,1363,15603,500
8226,39,1026,1383,676,15278,350
18277,288,12264,1265,8277,76207,3987
40785,384,3677,822,2917,21205,760
19206,577,17967,1248,12829,127594,5138
32319,5,305,1001,196,5344,109
33282,46,680,983,420,13152,260
59640,10,159,384,105,3126,54
34558,26,542,958,425,13171,117
5975,129,6617,1410,3868,27253,2749
30788,175,3484,1024,2396,26732,1088
34899,13,310,949,227,10175,83
69048,26,180,90,158,3634,22
61605,1044,21666,315,15518,58942,6148
31989,85,1562,1006,996,25543,566
32712,203,5016,994,3157,27379,1859
1964,53,979,1454,734,22608,245
10761,62,1021,1369,613,15572,408
34401,2,110,961,80,5588,30
37755,12,163,876,130,15490,33
24794,485,12902,1149,8665,105980,4237
42632,28,356,792,277,5896,79
68435,28,561,112,479,2731,82
19571,145,2285,1242,1562,15511,723
63888,4,102,248,88,3238,14
60030,6,107,371,79,2628,28
33497,2,246,979,177,4578,69
44201,12699,358605,771,240193,665024,118412
35050,835,14735,945,11049,106037,3686
64273,64,1240,236,1075,9142,165
19451,61,1064,1244,719,11048,345
61400,33,738,321,513,7313,225
63314,86,1436,223,1140,7141,296
13545,5,414,1339,213,25552,201
30796,14,469,1024,329,7436,140
52143,32,319,616,253,2897,66
52386,6,98,608,83,7493,15
52284,53,711,611,587,8612,124
50636,3,169,658,128,5157,41
40970,552,12854,819,9994,58634,2860
64011,103,1247,244,902,9670,345
42338,35,539,798,405,17049,134
45259,217,1809,760,1582,50628,227
27346,79,1873,1093,1209,25119,664
38467,535,14407,857,11131,94729,3276
8,89,5043,1473,2694,88023,2349
13049,14445,342543,1346,185773,1047392,156770
8490,9,327,1382,200,6089,127
1836,152,5801,1455,3835,24421,1966
55977,6,159,496,110,6517,49
12558,1280,17182,1352,10397,66171,6785
10471,69,1736,1372,1047,16395,689
29700,63,1391,1047,780,12457,611
17869,3,127,1271,78,6669,49
22085,27,690,1199,482,38836,208
27727,573,11346,1085,7095,50407,4251
20725,21,1182,1222,853,16290,329
5128,113,3304,1420,2401,24022,903
52054,0,22,619,19,2148,3
66179,8,53,183,41,1433,12
24976,5,315,1144,251,7739,64
24166,3,96,1163,71,5816,25
4432,238,3883,1430,2802,41801,1081
30815,109,1824,1024,1208,36327,616
65804,86,736,194,584,8420,152
61423,1,27,320,22,4365,5
16935,161,7911,1289,5953,67958,1958
35545,16,707,933,518,12738,189
16385,25,1478,1297,885,13714,593
18809,20,865,1255,602,9235,263
10770,253,6335,1369,4085,26881,2250
62230,7,265,293,218,3376,47
34922,17,512,949,342,11179,170
16131,6,138,1302,105,4902,33
13032,18,819,1346,425,9880,394
28655,258,5260,1066,3273,63458,1987
6935,153,4125,1398,2666,70793,1459
51239,29,644,642,516,15465,128
15816,45,1081,1307,815,32497,266
50683,84,1081,657,842,16744,239
30255,14,565,1035,345,25637,220
62417,5,93,288,57,6678,36
33919,2049,59453,972,39345,209422,20108
13986,303,12393,1332,7711,93925,4682
28534,11,236,1069,170,6770,66
51647,102,1573,631,1267,19088,306
41437,5,59,812,45,6821,14
49505,67,885,687,730,23497,155
48810,23,309,708,258,15420,51
39430,13,466,842,335,7083,131
58190,80,2928,432,2414,35077,514
42498,54,1220,795,947,13415,273
13963,3044,121489,1333,75136,792609,46353
8110,202,3800,1383,2295,19082,1505
67970,36,426,126,333,4655,93
7098,11,516,1396,347,33733,169
9318,556,35033,1378,21521,198106,13512
23933,4,191,1168,89,5523,102
38824,5,83,849,72,2971,11
48944,95,1050,704,875,15557,175
66488,111,1767,175,1439,25608,328
9077,28,900,1379,621,15478,279
61315,34,428,323,346,8191,82
35673,584,9009,931,7488,78975,1521
2909,641,10451,1446,8350,49764,2101
15754,15,506,1308,352,13609,154
61614,1132,21822,314,16835,110539,4987
33274,32,666,983,465,10679,201
32154,137,4258,1003,2887,65192,1371
66464,11,194,175,153,6009,41
32816,23,583,992,370,16871,213
22759,22,455,1189,327,11765,128
20007,17,339,1234,250,8024,89
37911,259,4137,872,3543,71424,594
7885,87,2059,1385,1521,29444,538
15889,9,431,1306,335,5903,96
34533,10,190,959,126,7702,64
33031,22,376,988,259,3649,117
39760,22,1225,838,836,13317,389
13738,7,757,1336,452,19966,305
35448,121,2602,931,1878,21058,724
24093,51,1107,1164,774,20451,333
68681,3,29,102,19,3852,10
21538,15,391,1207,275,13652,116
11134,116,4915,1366,3111,34542,1804
65446,63,819,203,709,15799,110
65907,102,1171,191,882,6097,289
1433,108,4418,1458,2812,50710,1606
32575,11,240,996,143,4499,97
14126,218,5262,1330,3012,27515,2250
2638,19,1645,1449,1106,34655,539
10445,4613,120276,1372,70985,277356,49291
6880,69,7092,1399,4381,64031,2711
57545,53,551,453,464,8891,87
17050,89,2275,1287,1644,35808,631
4457,4499,145872,1430,100320,253461,45552
22349,23,738,1196,579,32743,159
5972,30,688,1410,479,6957,209
13027,28,1247,1346,602,14553,645
59170,82,963,400,798,21490,165
9004,98,3363,1380,2312,33884,1051
61371,5,91,321,61,4639,30
66678,15,335,168,258,7027,77
5944,73,1075,1411,739,13762,336
13901,745,19569,1334,11219,57931,8350
34641,144,1146,956,881,11257,265
65993,4,102,189,82,4817,20
60675,5,62,346,51,3149,11
20915,7,412,1218,263,11825,149
56671,12,233,475,181,9237,52
15075,10,286,1318,196,6915,90
54793,1019,12465,529,9995,142656,2470
68657,25,330,103,245,5244,85
54002,27,307,558,248,7842,59
6882,309,5430,1399,3995,30315,1435
35078,234,5011,945,3489,75639,1522
11488,109,5411,1364,2841,35472,2570
52177,9,110,615,87,4913,23
57107,22,236,463,134,4862,102
6264,11,736,1407,521,21868,215
19198,63,1381,1248,989,18464,392
56309,21,289,485,242,11845,47
26147,10,324,1120,207,9173,117
49005,52,785,702,539,5643,246
3249,118,5445,1443,3852,78708,1593
56115,922,16661,491,14058,162904,2603
37153,34,1103,893,857,21482,246
30911,221,2711,1022,1846,31196,865
53912,283,4451,561,3445,17858,1006
40194,134,3273,831,2141,67447,1132
3340,96,4321,1442,2602,31207,1719
37466,9,78,883,64,12455,14
6231,7,145,1407,96,19766,49
31214,23,770,1017,477,6792,293
48811,30,994,708,679,15547,315
26563,5,422,1110,255,8973,167
19341,83,2113,1246,1376,32832,737
23371,18,370,1178,253,10800,117
42900,22,447,788,321,14139,126
15881,16,639,1306,517,15691,122
51984,14,211,622,170,11296,41
14626,1583,93219,1323,52329,432924,40890
26059,859,17745,1121,12817,83212,4928
35017,74,1252,947,924,24285,328
24740,943,18208,1150,12821,53156,5387
29868,476,16046,1043,11804,74249,4242
33598,3121,58318,974,47793,281784,10525
6207,140,6470,1407,4147,80280,2323
8779,312,16166,1381,10208,76790,5958
63418,5,37,262,30,3132,7
47939,22,658,728,520,24029,138
37569,23,278,880,247,7055,31
54090,4280,49925,555,39106,222290,10819
39532,1225,25853,841,19949,135879,5904
17932,101,1389,1270,992,20168,397
1930,73,2312,1455,1665,56121,647
55437,5,61,510,45,4591,16
36195,578,7152,916,5612,69464,1540
7029,231,22713,1397,13027,104900,9686
67487,24,355,142,277,7890,78
32856,62,1409,991,966,20633,443
4383,60,2082,1430,1483,19913,599
27669,277,4094,1085,2440,20611,1654
68776,97,1609,99,1325,13775,284
5406,38,829,1417,607,18922,222
32317,37,384,1001,246,3070,138
38979,33,494,848,413,4797,81
6149,303,16146,1408,10782,309860,5364
62326,109,1277,290,1025,11720,252
53706,19,148,567,136,7036,12
5543,7,278,1415,187,9756,91
26615,31,1303,1109,975,12081,328
21339,3,79,1210,59,3891,20
13786,69,847,1335,437,12285,410
19320,47,1810,1246,1175,33961,635
27440,22,565,1091,384,4906,181
21386,19,481,1209,334,17806,147
59634,12,96,384,79,4548,17
24458,83,1723,1156,1203,16812,520
46568,8,94,745,66,4644,28
42203,12,274,800,214,8016,60
24600,2386,76905,1153,44156,247684,32749
14334,4,163,1327,107,7253,56
60761,26,390,343,290,5676,100
55274,13,202,515,169,7324,33
18119,6,419,1267,298,17841,121
67133,2,19,153,16,2770,3
8679,11,400,1381,247,11989,153
58897,131,1825,408,1423,31090,402
45,768,24815,1471,14857,369950,9958
35813,290,5513,928,4390,110957,1123
35262,203,7515,940,4842,54460,2673
56187,107,1217,489,925,16899,292
55885,211,1851,498,1432,12095,419
8473,23,1093,1382,686,12686,407
38548,894,12161,855,10054,105812,2107
64949,15,168,215,120,14306,48
40110,84,1626,832,1305,21935,321
11248,3,210,1366,124,17125,86
61508,41,516,317,422,6971,94
11459,1743,37741,1364,23604,157938,14137
57048,51,782,461,599,9559,183
56518,8,142,479,109,5171,33
40305,985,14811,830,10600,88710,4211
6940,232,3718,1398,2496,46202,1222
35831,12,291,927,194,3639,97
67856,4,104,130,50,2470,54
874,6984,300806,1462,172814,931729,127992
64104,7,142,241,109,4330,33
27455,203,4746,1091,3330,24783,1416
23648,31,759,1174,543,15261,216
16884,71,2528,1290,1703,33701,825
29718,203,5644,1047,4145,42479,1499
53376,180,3103,576,2375,13861,728
63055,1,20,271,7,5169,13
9597,221,6679,1377,4680,92845,1999
38294,4,479,862,280,8651,199
42728,450,6691,791,5104,32070,1587
51486,536,6658,636,5384,32065,1274
13647,39,1707,1337,1061,44639,646
4731,53,861,1425,586,11233,275
16579,7,345,1295,261,13121,84
24736,1343,34649,1150,23964,147707,10685
18541,7,453,1260,372,7373,81
36960,793,11892,898,9448,93997,2444
23275,53,1630,1180,1386,69743,244
40835,18,279,821,242,9635,37
15508,10714,236008,1312,156870,649928,79138
9069,59,2491,1379,1567,36189,924
63833,2,84,251,54,3412,30
4612,12,472,1427,326,14908,146
61835,109,1697,306,1302,13209,395
7482,8,531,1391,379,15870,152
52046,5,160,619,112,6680,48
54219,340,8201,550,6386,58125,1815
24572,98,3737,1154,2411,38021,1326
57686,200,2944,449,2385,12034,559
57484,21,239,454,157,3967,82
58145,121,4678,434,3716,28602,962
50300,18,157,666,127,7021,30
9640,16,740,1377,482,10529,258
23875,173,7302,1169,5479,89552,1823
61763,5,74,309,50,6521,24
26438,20,668,1113,394,6682,274
48825,9,199,708,163,5927,36
33624,1,77,977,67,3865,10
26965,11,491,1101,315,7079,176
43053,13972,300769,726,206232,638963,94537
11235,1159,22971,1366,14862,74453,8109
6548,219,7101,1403,4439,34425,2662
402,110,4206,1466,2675,59447,1531
13116,2677,75380,1345,50635,157574,24745
12725,59,1664,1350,974,30509,690
20303,85,2077,1229,1478,32344,599
59918,39,705,374,571,12621,134
5902,131,4206,1411,2869,40624,1337
8385,220,6092,1382,3712,31386,2380
66936,4,153,160,112,2518,41
25291,14,660,1138,508,4077,152
61993,8,92,301,70,5333,22
30522,596,10679,1029,6661,73489,4018
23529,76,2806,1176,1609,22827,1197
65924,74,773,191,596,5404,177
27396,40,1453,1092,970,26519,483
24210,84,2625,1162,1876,20524,749
37496,5676,115973,883,83705,306011,32268
7172,6,431,1394,279,11275,152
13251,21,1185,1343,646,15692,539
30771,33,694,1025,443,13756,251
8648,137,6392,1381,3917,24745,2475
2250,167,4399,1452,3018,46178,1381
15218,112,2579,1316,2080,42310,499
67462,8,77,143,60,2384,17
11221,5,324,1366,177,5893,147
15007,244,14790,1319,9690,100831,5100
21630,80,2269,1205,1430,37859,839
49520,34,384,687,278,4864,106
16669,629,16973,1293,11044,109344,5929
11751,4,467,1361,241,14884,226
52430,6,161,606,128,7713,33
28262,182,5449,1074,3706,45657,1743
58403,115,1925,425,1508,21252,417
54350,362,3459,546,2828,66632,631
67560,3,40,139,32,3344,8
15687,28,1970,1309,1405,21672,565
13968,369,10749,1333,6643,114316,4106
1767,328,19586,1456,14226,141136,5360
37599,154,2024,880,1543,15437,481
43725,201,4233,777,3274,51684,959
64386,4,71,233,44,4151,27
51940,13,173,623,132,9220,41
8446,11,977,1382,614,20653,363
57050,1218,19446,465,16515,122939,2931
41226,13,573,815,389,13674,184
19480,122,3676,1243,2414,21044,1262
12510,207,4439,1353,3076,36806,1363
51606,336,4996,632,4172,35824,824
30183,38,1984,1036,1297,34786,687
23205,157,2864,1181,1864,22721,1000
57146,31,475,462,414,10099,61
43127,696,14499,784,11436,176189,3063
64139,21,306,240,223,3896,83
32810,81,1935,992,1306,9469,629
17335,16,427,1282,318,12150,109
60776,6,52,340,42,2831,10
33106,794,9061,987,7575,54867,1486
50093,474,5436,672,4424,58181,1012
5340,90,2474,1418,1631,37967,843
62653,21,271,281,191,6034,80
55574,168,1549,507,1305,28574,244
23612,208,7967,1174,5495,85883,2472
61844,27,336,307,271,12364,65
48695,61,643,711,501,7615,142
35541,21,434,934,312,3859,122
37403,670,13392,885,10837,67287,2555
49528,138,2730,687,1877,32767,853
13098,1703,82791,1345,44043,420289,38748
32299,27,925,1001,613,6297,312
2383,2,127,1451,90,9635,37
50315,32,478,666,378,12817,100
44843,47,769,765,625,10060,144
17620,124,3323,1276,2354,35844,969
50356,131,2107,665,1693,18781,414
31778,52,902,1009,616,12169,286
65058,6,100,211,80,2343,20
59212,270,4360,399,3594,26916,766
60810,35,375,341,339,7328,36
53844,77,1362,563,1071,14485,291
68118,74,1857,117,1533,13308,324
34651,24,288,955,194,6191,94
33125,89,3276,986,2332,48659,944
28393,3,112,1071,93,13859,19
61812,91,1243,298,1041,14868,202
55145,15,164,518,96,4171,68
8645,6,751,1381,486,22590,265
61688,44,473,312,392,14394,81
12371,55,3144,1355,1523,25524,1621
64224,10,90,238,73,3943,17
59999,156,1729,371,1387,12818,342
48179,6,46,725,38,3797,8
17433,133,1972,1280,1474,20523,498
67836,8,119,130,97,6842,22
30636,3050,66206,1028,43394,124921,22812
39790,1056,15150,837,10682,42073,4468
25848,43,1889,1127,1126,17318,763
17529,34,1360,1278,973,23953,387
1941,2,130,1455,101,16080,29
9518,9,246,1377,173,8432,73
65510,121,1248,202,1022,16149,226
35379,23,494,937,338,6814,156
17434,2,320,1280,228,32891,92
53334,20,266,577,212,8567,54
22931,143,3004,1186,2091,23709,913
49342,393,8897,690,7005,66599,1892
67936,31,400,128,353,5001,47
26558,1413,26928,1110,14350,97068,12578
5299,57,1019,1418,727,26733,292
66730,19,126,166,108,4351,18
24718,87,1504,1150,987,8205,517
37632,26,299,879,243,7924,56
35857,505,5194,926,3884,27704,1310
59091,3592,84359,402,59442,165594,24917
13911,108,3327,1334,2158,61490,1169
4461,62,2218,1430,1595,14521,623
35171,52,716,942,559,16254,157
32316,3,91,1001,54,6913,37
14503,268,8013,1325,5341,122444,2672
18524,18,529,1260,384,8308,145
64057,47,628,243,538,8606,90
18746,22,565,1256,479,8164,86
18290,123,3133,1264,2235,44055,898
20597,33,583,1224,409,7146,174
26947,3,122,1102,92,8797,30
37586,174,2799,880,2340,21963,459
5962,78,3641,1411,2379,39799,1262
40646,211,5723,825,4457,46636,1266
29253,8898,277990,1055,176969,471355,101021
41482,899,23327,811,18886,159019,4441
60822,101,1723,341,1358,7438,365
12974,3515,146450,1347,103421,402628,43029
24909,50387,4308870,1146,2306127,5429334,2002743
48759,145,1851,710,1411,30758,440
37673,1136,40364,878,28756,134801,11608
59418,45,500,391,394,5269,106
62844,3787,100518,276,72598,443141,27920
24654,10,428,1152,283,9986,145
16422,23,455,1297,302,9272,153
24423,10,380,1157,236,7900,144
5780,64,2150,1413,1459,26159,691
56773,33,377,472,304,8073,73
30153,48,1577,1037,1085,28853,492
48673,8,102,712,70,16864,32
67899,10,79,129,65,2175,14
13130,564,20703,1344,12427,75805,8276
56430,6,67,482,52,2699,15
34632,213,2755,956,2356,63746,399
27152,51,1043,1097,607,22325,436
51813,3093,54018,626,39902,348717,14116
58975,89,1147,406,948,7428,199
6537,2054,61199,1403,40156,420511,21043
27802,29,1715,1083,1097,31684,618
31083,130757,2790503,1019,2068426,4545281,722077
65491,237,3873,202,3211,13361,662
6946,43,610,1398,452,10572,158
8007,277,5484,1384,3374,50275,2110
21987,161,3820,1201,2275,16915,1545
25314,40,2283,1137,1322,41164,961
20469,91,2617,1226,1825,33212,792
68306,21,221,116,172,4419,49
20443,13,336,1226,255,12860,81
63400,61,838,262,746,10266,92
64692,8,142,224,90,3654,52
23846,11,263,1170,225,6089,38
67894,0,10,129,5,1192,5
22851,15,396,1187,270,7708,126
37581,5,84,880,73,6139,11
12452,6134,227601,1354,163118,1274815,64483
54464,37,411,541,274,23804,137
8362,41,1129,1382,735,23639,394
48257,389,8251,724,6413,49473,1838
53442,10627,221049,575,161499,911688,59550
39214,8,315,845,236,8592,79
56379,1033,22131,484,17819,153731,4312
27104,13,996,1098,574,15383,422
63961,27,370,246,268,8923,102
30868,70,6835,1023,4366,32664,2469
67309,1509,19132,136,14643,109410,4489
67278,8,97,148,82,5948,15
4269,3,237,1432,154,28050,83
5139,57,1448,1420,1011,33329,437
58471,211,3524,422,2742,28941,782
17678,96,2640,1275,1921,52506,719
68782,755,18185,99,12679,168128,5506
30655,192,3176,1027,1845,22618,1331
17361,0,0,1281,0,8268,0
58278,22,186,429,147,7930,39
7699,25,1829,1388,1203,18790,626
37299,81,1832,888,1458,27525,374
58700,20,207,415,170,2168,37
47551,84,806,732,566,6654,240
35958,14,591,924,432,6687,159
50571,48,953,660,655,4317,298
17625,158,2616,1276,1708,12752,908
35433,11,87,936,56,2665,31
33462,1638,42455,980,30600,220009,11855
26046,37,1388,1122,833,14055,555
53071,1642,21414,584,14797,66107,6617
12522,87,1971,1353,1160,24813,811
12965,53,2636,1347,1423,12165,1213
23389,59,1892,1178,1393,34764,499
45474,30,348,758,287,6302,61
41160,45,1281,816,1093,16731,188
24651,22,427,1152,301,12547,126
26590,75,3038,1110,1735,25822,1303
63286,17,225,265,183,8046,42
14783,31,929,1322,649,19151,280
32576,129,2978,996,1871,21773,1107
12398,14,343,1354,222,10682,121
29704,16,605,1047,343,6787,262
25252,17,354,1139,257,6400,97
23079,47,1207,1183,879,17905,328
51594,128,1903,632,1523,23351,380
38299,0,0,721,0,2237,0
31328,442,12630,1016,7891,100073,4739
12001,13,489,1359,245,6315,244
20536,3,260,1225,196,5032,64
60137,0,16,367,14,1430,2
33677,181,4437,976,3261,84669,1176
795,12,265,1463,174,32574,91
48591,317,5143,714,4268,53402,875
58102,38,433,435,372,14715,61
52002,265,2571,621,2066,31791,505
47397,45,566,734,461,10858,105
34332,25,549,963,374,10586,175
40394,27,277,828,195,4152,82
23851,0,0,1170,0,13460,0
30220,7,243,1036,154,15791,89
41007,35,702,818,570,9538,132
16638,271,4255,1294,3005,24950,1250
13459,33,1517,1340,955,13639,562
848,51,1855,1463,1389,36322,466
57546,66,792,453,534,9022,258
54655,36,594,534,397,5734,197
3777,9,536,1437,393,20739,143
24378,10,269,1158,202,8743,67
363,180,9736,1467,7372,55455,2364
67586,12,202,138,180,5060,22
51805,8,70,623,57,3119,13
5512,34,1582,1416,1052,20197,530
28759,42,1072,1065,623,8082,449
25136,246,4458,1141,2999,40360,1459
14177,7,145,1330,104,4852,41
10384,94,1732,1372,1222,8840,510
3538,46,1788,1440,1200,62947,588
41809,326,3027,806,2222,20898,805
32088,87,2094,1004,1306,43608,788
6579,14,315,1403,209,8450,106
12881,21,746,1348,402,7433,344
9739,1,232,1376,165,10655,67
38240,2,16,863,11,1490,5
6592,10,555,1402,374,10011,181
8489,4532,118156,1382,81148,378803,37008
54613,135,1895,536,1590,17343,305
68679,4,92,100,56,6203,36
58689,681,8179,415,5820,61737,2359
14457,1848,35791,1325,23560,128469,12231
14376,13,377,1326,303,19753,74
68076,0,115,123,103,3579,12
52210,85,1055,614,845,16130,210
4081,1367,45014,1434,29494,280418,15520
27486,43,2597,1090,1530,17943,1067
14350,16,1448,1327,954,25747,494
49254,18,586,693,388,16664,198
17153,266,5462,1285,3714,50622,1748
30857,115,1889,1023,1408,22974,481
7054,379,6967,1397,5005,48183,1962
57755,62,957,446,639,30949,318
19961,1548,57094,1235,41142,320222,15952
41298,133,2110,814,1648,21863,462
33879,474,9499,972,6949,76425,2550
24587,1067,27311,1153,19078,169009,8233
49920,3,121,676,75,13368,46
52833,441,5474,592,4443,91833,1031
26506,111,2131,1112,1385,14784,746
1095,277,12959,1461,9532,93566,3427
49995,178,2497,675,1943,19818,554
59871,5208,119188,375,92008,342095,27180
63123,10,343,270,252,8426,91
23456,52,1000,1177,703,20687,297
49893,12,105,677,82,6859,23
22015,164,3361,1200,2120,31309,1241
733,91,3023,1463,2090,76316,933
11374,21,1505,1365,857,9469,648
20740,438,9982,1222,7073,83298,2909
13274,862,13588,1343,9751,78053,3837
25597,15,958,1132,534,8763,424
5163,8,165,1420,113,8448,52
16791,1586,25711,1291,16714,103789,8997
54854,3,34,527,26,2999,8
11457,2,115,1364,58,10225,57
51688,27,429,630,323,7171,106
61260,119,1859,324,1493,17503,366
31803,280,5938,1008,4119,54597,1819
50261,2,47,668,37,2649,10
8554,16,992,1382,615,18170,377
32269,124,2550,1002,1786,21876,764
50036,1,90,673,62,2742,28
34692,29,562,954,364,9914,198
28493,166,2636,1070,1701,37833,935
54963,89,1540,523,1165,18656,375
60777,52,665,342,511,9649,154
63090,464,9558,270,7671,55206,1887
2218,63,1269,1452,774,8646,495
19418,96,2728,1244,2188,19466,540
37790,299,5431,874,4367,42548,1064
53337,7,189,578,129,3037,60
38883,1,46,849,37,2272,9
6969,29,712,1398,492,31508,220
2119,808,21930,1453,13245,833446,8685
12468,813,17910,1353,11271,110207,6639
7503,102,3063,1391,2038,13327,1025
41817,136,1579,805,1131,23517,448
61287,841,9362,323,8129,78710,1233
51467,1933,60393,636,45934,333265,14459
56502,2,51,480,31,1525,20
23338,14,585,1179,395,8819,190
8661,15,558,1381,316,8755,242
52591,39,528,600,440,10911,88
55939,17,360,497,285,5874,75
64107,1,17,241,13,1477,4
52987,120,1181,587,1044,17388,137
6818,49,2233,1400,1432,12736,801
25007,4,68,1144,57,8111,11
14620,3,232,1323,130,4134,102
28689,84,1657,1066,1018,17108,639
19887,164,4217,1236,3179,219155,1038
12080,19,817,1358,407,11133,410
7405,5273,161861,1392,108565,330138,53296
28472,76,1545,1070,1025,23921,520
48120,118,1799,726,1393,18675,406
3000,15,844,1445,579,22101,265
52323,236,3536,610,2817,33342,719
3486,56,1134,1441,752,23436,382
64349,5,74,234,65,5865,9
14874,45,2228,1321,1432,48796,796
58643,55,1959,416,1493,11440,466
40767,5,86,823,54,6038,32
30423,48,366,1032,287,12959,79
37427,26,313,885,260,6623,53
20430,10,362,1227,278,11613,84
59356,93,1397,393,1207,18622,190
35648,207,2724,931,2027,16532,697
60563,50,1176,351,807,18294,369
65600,98,1870,200,1521,31171,349
52418,216,2673,607,2161,33804,512
14260,13,322,1328,205,25350,117
43892,29,490,775,384,11191,106
37607,45,966,880,779,9241,187
59200,51,409,399,322,9998,87
18785,48,1268,1256,848,49952,420
60958,18,394,335,298,8397,96
68602,217,5079,105,4139,18489,940
27756,0,1961,1084,1373,96484,588
68813,14,261,98,231,4510,30
55900,745,17086,498,13308,95692,3778
28587,65,1080,1068,790,11564,290
67053,10,101,156,69,3598,32
13099,140,5290,1345,2767,40736,2523
68183,11,103,120,91,5784,12
31876,15,267,1007,182,4664,85
26429,499,21130,1113,13154,80348,7976
46092,132,2031,751,1606,46716,425
49468,4,113,688,80,6279,33
48838,8,293,707,208,2625,85
45369,59,2023,759,1602,23646,421
14453,109,3293,1325,2093,21522,1200
6722,19,770,1401,486,54498,284
53128,33,572,582,438,34224,134
9647,370,9630,1377,5463,58640,4167
6651,21,1018,1402,696,45657,322
65527,939,19614,202,14801,67019,4813
31829,4,272,1008,172,3518,100
62400,4,91,288,52,3220,39
38216,137,1610,864,1095,21051,515
30031,282,6291,1040,3819,56700,2472
17784,878,77892,1273,29087,143318,48805
17801,192,4776,1273,3780,42565,996
33368,1001,17547,982,12700,145242,4847
18629,82,3501,1258,1894,56937,1607
23405,17,581,1178,473,11673,108
60219,3913,106947,363,84139,412504,22808
56439,55,983,482,780,15500,203
46205,596,20227,750,11257,51007,8970
62954,43,259,274,222,4016,37
6430,12,185,1405,136,9526,49
41227,224,2544,815,2066,13789,478
20470,138,3846,1226,2633,30212,1213
57607,163,3558,451,2836,33101,722
51874,110,915,625,767,12630,148
31761,31,1492,1009,1003,14265,489
27433,21,625,1091,394,20306,231
8520,1462,26773,1382,15104,64377,11669
66709,8,181,167,146,3098,35
39422,267,3588,842,2833,23522,755
30969,225,6760,1021,4025,27990,2735
24291,7,136,1160,84,3826,52
6438,4,166,1405,101,17014,65
28327,41,2316,1072,1427,25829,889
60932,15,203,337,171,9264,32
23008,10,233,1184,184,7320,49
50331,146,2452,666,1797,22169,655
39229,121,1628,845,1338,47781,290
6720,493,49634,1401,28047,241379,21587
5012,9,316,1422,225,9756,91
17105,174,5940,1286,3431,19644,2509
22504,25,435,1194,300,8624,135
5582,4,152,1415,109,7222,43
35298,80,1189,939,818,11402,371
2900,282,10570,1446,6196,57634,4374
43641,1549,26937,778,20173,177882,6764
30373,2,252,1033,150,5093,102
54292,43,596,548,420,10005,176
5146,138,5887,1420,3850,18352,2037
17267,11,380,1283,297,6000,83
7207,69,2622,1394,1704,19264,918
28511,584,13105,1069,9412,52520,3693
28515,1222,32072,1069,20832,158222,11240
10800,4,200,1369,113,11900,87
17228,243,6353,1284,3940,47241,2413
49666,7,75,683,50,10641,25
31394,40,459,1015,371,7317,88
32915,186,3009,990,1997,29122,1012
48099,53,1661,726,1238,19343,423
42590,203,1865,793,1444,18348,421
54352,12,211,546,160,7428,51
55098,97,730,519,605,15276,125
27053,2348,47708,1099,28848,152072,18860
68463,17,324,110,278,6473,46
37764,2139,26969,875,20174,112905,6795
62517,21,410,285,335,4061,75
38287,19,271,862,227,7256,44
49382,5,59,690,51,5039,8
44562,292,4976,768,3896,35279,1080
7218,8,514,1394,320,11700,194
67881,8,201,129,164,2826,37
14041,11,362,1331,226,13739,136
64449,21,240,231,201,3259,39
21921,2577,66257,1201,35433,221168,30824
48850,90,832,707,659,12664,173
26322,153,3681,1116,2548,23709,1133
30028,19,626,1040,364,8235,262
53921,34,312,561,254,16585,58
2723,3700,120143,1448,75110,258139,45033
48870,21,297,706,248,6304,49
39453,373,3654,746,2876,50625,778
49284,2,66,693,54,7338,12
42454,103,1975,795,1265,7481,710
25270,118,2273,1139,1536,37817,737
19906,12,695,1236,512,8338,183
67443,4,101,143,76,3332,25
68295,6,92,116,73,5678,19
17461,102,2161,1280,1629,32143,532
24058,32,685,1165,497,12168,188
65588,4,63,200,32,2549,31
63846,3,68,250,51,7750,17
46741,1606,34598,743,23391,72853,11207
61225,51,503,325,415,8717,88
21813,39,1079,1203,755,24424,324
27075,128,1961,1099,1267,32662,694
25362,116,1994,1136,941,20465,1053
25246,16,1119,1139,767,19909,352
32387,10,228,1000,171,7580,57
66630,231,3741,170,3322,17439,419
65555,30,478,201,394,7738,84
62498,5,88,286,76,4976,12
17432,74,1900,1280,1352,19073,548
38167,453,6332,865,4995,28076,1337
68618,20,163,104,125,3251,38
43201,4,97,783,42,2091,55
19272,19,307,1247,210,12606,97
5684,60,2172,1414,1450,29301,722
16853,9,370,1290,280,10705,90
59948,9,103,373,86,2736,17
20195,9,423,1231,317,14472,106
4510,227,10668,1429,7088,60549,3580
44988,87,1253,763,1038,16596,215
60320,7,158,360,100,5033,58
1808,10,349,1455,256,10356,93
14980,24,816,1319,597,17899,219
26989,7,686,1101,408,18191,278
59181,0,381,400,296,6288,85
55686,32,434,504,339,8308,95
56869,11,109,469,94,4776,15
22773,17,546,1188,424,7947,122
444,69,2201,1466,1556,49841,645
7142,54,1523,1395,1019,18794,504
57187,5,41,461,36,4604,5
7112,73,2119,1396,1269,33147,850
38390,8,272,859,203,9434,69
27205,64,2156,1096,1352,20963,804
1741,29,1672,1456,1091,22382,581
2757,115,3235,1448,2253,16719,982
27976,16,285,1079,173,5971,112
59006,94,2275,404,1744,22136,531
1259,73,3493,1459,2525,39077,968
7066,0,0,1396,0,4417,0
20116,33,593,1232,398,18641,195
32160,6,346,1003,199,4658,147
18643,38,985,1258,738,24070,247
49095,97,1595,699,1237,11610,358
65244,19,283,208,236,3309,47
62501,29,237,285,188,2629,49
18971,199,8197,1252,4885,118916,3312
34693,231,3227,954,2387,16298,840
66693,26,230,168,158,5305,72
23524,3,173,1176,118,14431,55
5200,16,839,1419,580,22934,259
36723,7,163,904,150,9452,13
14809,343,9329,1321,6320,76198,3009
8152,29,965,1383,685,13356,280
34387,3,390,955,220,10616,170
60173,16,318,365,189,4544,129
25368,90,1379,1136,1080,22225,299
781,92,6098,1463,4287,115079,1811
4847,17,816,1424,544,10668,272
30328,96,2385,1034,2064,47014,321
40154,301,6906,832,5639,47725,1267
8978,7997,230138,1380,149266,745973,80872
71,769,31775,1471,20885,197376,10890
67072,61,1070,155,816,19915,254
49646,10,127,683,94,4825,33
35465,341,7539,935,4210,89635,3329
34872,217,4512,950,3272,38783,1240
21930,200,5686,1201,3623,51830,2063
17327,23,616,1282,434,11877,182
58399,64,1354,425,1056,24245,298
2651,133,4746,1449,3387,101667,1359
60497,325,6164,353,4784,29246,1380
22930,1574,52369,1186,37602,221792,14767
34574,30,816,958,548,23052,268
20933,20,479,1218,318,7503,161
54118,2465,45540,554,35803,175082,9737
36539,13,361,907,267,7159,94
67812,629,11549,131,9325,72799,2224
34335,60,1178,963,775,30380,403
42895,21,266,788,223,6888,43
7589,18,1031,1389,676,30013,355
4160,342,8717,1433,6290,67338,2427
12158,4,271,1357,144,4894,127
16221,80,2900,1300,1875,23095,1025
36042,6,187,922,139,2751,48
37551,136,2126,881,1654,23802,472
18615,0,0,1259,0,8251,0
36933,139,2606,899,2056,35637,550
51794,125,1338,627,968,8936,370
2189,85,3907,1452,2901,28091,1006
4297,43,1711,1432,1146,37227,565
15808,1818,48208,1307,29980,275248,18228
45500,1287,70504,758,54746,257457,15758
55812,413,7462,500,5438,40442,2024
34288,37,768,963,540,4237,228
25386,1485,30467,1136,20662,212545,9805
31520,193,2968,1013,2126,32765,842
32806,28,698,992,441,7330,257
29713,15,310,1047,204,3919,106
36255,55,551,916,429,6195,122
24150,3,101,1163,79,5641,22
5710,26,606,1414,400,16947,206
17033,16,346,1287,259,11067,87
19992,28,1747,1234,1318,18456,429
6500,20,641,1404,454,8376,187
27872,172,4822,1081,3420,46207,1402
8875,35,1775,1380,1180,23851,595
56382,108,1061,484,851,14719,210
21464,4,182,1208,158,23558,24
45538,925,22907,757,19018,152017,3889
17745,180,9275,1274,6361,76149,2914
61408,90,1607,320,1184,13030,423
40686,86,1485,824,1321,22827,164
38244,26,329,863,250,4591,79
20825,60,1485,1220,1052,34651,433
29760,16,1418,1046,803,32313,615
6480,33,929,1404,609,7670,320
37459,54,857,884,683,13410,174
60899,10,57,338,43,5547,14
34244,51,781,965,554,9286,227
48910,272,4793,705,3796,58193,997
49317,14,197,692,166,10168,31
18398,227,35667,1262,21921,94637,13746
34357,15,265,962,194,7583,71
64029,1385,14552,244,11978,52269,2574
484,35,1187,1466,849,42845,338
31086,3,51,1019,34,3248,17
50898,207,3858,652,3203,49738,655
20623,145,4175,1224,2637,34962,1538
35566,18,426,933,323,15781,103
46273,57,699,749,618,10586,81
10121,0,0,1374,0,5025,0
50344,5,77,666,65,2856,12
11691,858,20762,1362,13579,119404,7183
37437,29,633,884,504,14820,129
35160,23,513,943,357,11056,156
48509,16,241,718,162,12066,79
58396,237,4789,425,3791,27457,998
56064,134,2617,493,2227,25810,390
64119,13,148,241,113,2206,35
22539,12,329,1193,250,30241,79
67736,14,58,134,54,5139,4
25557,120,5537,1133,3463,45682,2074
17513,3,141,1278,114,4786,27
30300,55,1597,1034,1069,16045,528
5768,4,154,1413,81,10796,73
56488,40,746,480,584,8000,162
27385,51,911,1092,608,21426,303
37404,1286,41323,885,32272,190340,9051
61546,609,19030,316,14796,127370,4234
42698,23,390,791,331,12907,59
35343,60,1522,938,1109,19148,413
58535,17,103,420,88,5895,15
57770,31,605,446,532,16132,73
34805,1,32,952,24,2250,8
12955,298,12947,1347,7739,86888,5208
98,17086,469241,1470,244789,1074694,224452
63805,35,910,251,757,7656,153
53831,9,61,564,55,5699,6
30603,143,1008,1028,756,13239,252
14406,32,1161,1326,790,18108,371
391,175,4755,1466,3088,29708,1667
6514,134,3113,1403,2100,43172,1013
64156,25,398,240,345,10563,53
11167,62,1759,1366,1157,23241,602
68884,751,9030,95,7299,43561,1731
17705,79,3330,1275,2340,33661,990
58250,14,136,430,92,9678,44
63819,231,3209,251,2678,28212,531
20422,27,1561,1227,1073,13892,488
59271,147,5533,396,4366,54962,1167
67308,11,113,147,66,4347,47
49316,13,172,692,148,6214,24
21502,24,1006,1207,832,16558,174
36014,162,3855,923,3274,28934,581
49935,1141,61321,676,53565,146856,7756
20510,6,200,1225,146,10415,54
65392,5,76,202,48,2619,28
1333,9,293,1459,210,11899,83
11497,127,3111,1364,1519,19590,1592
16132,133,1757,1302,1248,16844,509
40820,35,841,822,647,10532,194
7833,95,4010,1386,2596,31215,1414
49297,57,1741,693,1338,7168,403
49709,5,92,682,65,10662,27
63168,741,8451,268,6812,75940,1639
62880,47,780,276,553,9141,227
34525,18,417,959,276,11425,141
42158,7,257,800,176,8513,81
59866,40,419,376,317,7330,102
20643,130,3390,1223,2368,37369,1022
13034,49,1831,1346,961,22641,870
9036,36,872,1380,557,8958,315
30090,146,3763,1038,2534,37880,1229
9987,27,1186,1375,738,20248,448
39416,19,294,842,198,3968,96
42218,214,4379,799,3289,37015,1090
14753,51,2147,1322,1622,39272,525
36892,32,345,900,288,9616,57
67862,121,1551,130,1269,10765,282
68645,30,216,103,164,4289,52
21384,366,8221,1209,5184,50484,3037
55454,45,402,510,338,12388,64
20967,24,722,1217,537,13910,185
31239,424,11315,1017,7392,87780,3923
59813,19,492,378,312,6113,180
28370,39,1383,1072,847,13432,536
56560,5,86,478,76,9703,10
49858,2,18,678,14,2361,4
64529,2,66,229,49,9352,17
14303,43,2613,1328,1496,25632,1117
30068,5,52,1039,43,3345,9
27575,201,3694,1087,2603,44879,1091
18483,1,81,1261,58,4560,23
1950,2,87,1454,53,17681,34
37669,75,1215,878,1074,25256,141
40535,8,444,826,342,11775,102
13965,102,2868,1333,2179,41026,689
25113,5457,118634,1142,74865,575550,43769
25286,28,678,1138,471,11002,207
56749,38,428,473,322,6707,106
23630,79,1670,1174,1073,11319,597
15596,140,2349,1310,1633,42689,716
8450,40,794,1382,489,7465,305
11912,54,4550,1360,2314,25543,2236
8749,33,1078,1381,661,6850,417
8627,399,16585,1381,8423,42910,8162
62930,48,568,274,442,11146,126
13579,0,22,1338,11,11577,11
36023,9,221,922,186,11610,35
29950,1998,49353,1041,36393,276087,12960
50150,24,327,671,286,13994,41
53783,32,281,566,233,3962,48
50588,93,863,659,664,9578,199
9406,99,4986,1378,2813,46003,2173
51613,33,349,632,276,10433,73
48744,41,639,710,457,6702,182
63839,1753,34555,250,22016,220483,12539
2680,29,1041,1448,703,34860,338
3226,349,30233,1443,19540,129981,10693
41914,6,125,804,81,3299,44
3631,4,120,1439,75,6640,45
38144,30,482,866,265,6785,217
50902,953,11196,652,7905,39024,3291
25626,87,1709,1131,922,8199,787
58962,28,448,407,381,10430,67
21282,63,1002,1211,740,14738,262
46415,3,35,748,28,4512,7
7452,229,17531,1391,10495,132615,7036
53237,1694,18997,580,15286,102785,3711
19246,62,1391,1247,1077,16956,314
22239,4413,95130,1197,54619,522462,40511
65790,16,281,195,218,2977,63
55100,1116,17600,519,12450,45234,5150
50544,109,1147,660,933,29622,214
26955,795,22884,1101,15942,93992,6942
32987,83,2003,988,1369,16688,634
38019,11,541,869,452,12637,89
30909,39,1417,1022,793,17320,624
66343,46,694,179,595,9132,99
27772,26,827,1084,465,10160,362
34125,21,640,967,418,10007,222
23421,336,4466,1177,2708,21127,1758
6903,40,990,1399,676,32189,314
27283,87,2295,1095,1599,26635,696
15920,42,801,1305,601,7001,200
54683,4,72,533,48,3013,24
4034,905,37953,1435,24688,191099,13265
50318,10,250,666,185,3215,65
36783,32,288,903,221,6490,67
53538,75,540,573,423,14435,117
59117,115,1221,402,874,7914,347
67840,6,77,130,63,4288,14
25282,336,4392,1138,2670,27124,1722
47765,119,1942,730,1412,20371,530
36468,2,58,904,46,6776,12
14103,31,963,1330,711,51185,252
35817,1194,19368,928,15444,151709,3924
61702,24,271,311,216,5370,55
64187,20,278,238,224,8737,54
20367,408,7252,1228,5031,41867,2221
64006,31,240,245,163,4481,77
24967,540,9274,1145,6465,75856,2809
30896,1,47,1023,32,3347,15
60224,115,1789,363,1385,22091,404
1428,426,26543,1458,17568,241255,8975
32241,16,291,1002,181,6661,110
37616,29,494,879,393,6923,101
59371,13,248,393,141,4267,107
4661,65,2870,1426,1877,43728,993
14371,60,1933,1327,1190,26584,743
52626,25,271,599,228,7828,43
53437,19,187,575,148,4805,39
49748,37,883,681,677,23213,206
29646,232,7719,1048,5038,92231,2681
26469,93,1857,1113,1159,18233,698
39754,12,201,838,157,13349,44
31325,2518,61389,1016,36128,230334,25261
21085,217,8271,1215,5406,44188,2865
60415,26,280,357,240,10296,40
10648,120,4684,1370,2606,29094,2078
4033,288,13404,1435,9140,48314,4264
61208,48,547,326,453,12136,94
46831,259,3879,723,3012,34471,867
49540,1,63,687,48,3140,15
14146,3621,96356,1330,63821,696632,32535
59611,118,1653,385,1297,30542,356
10150,1,137,1374,90,4503,47
64779,46,568,221,447,5836,121
37712,83,1932,877,1406,23040,526
21775,6,302,1203,201,9932,101
12850,175,4690,1349,3048,28178,1642
66754,4,39,166,30,4971,9
32983,58,2337,989,1608,19841,729
16322,45,2536,1299,1730,33782,806
55591,13,237,506,177,13559,60
66527,23,560,173,435,10601,125
11180,56,1482,1366,810,18695,672
4242,3,318,1432,231,27532,87
1038,24,1496,1461,1041,40441,455
12462,9,826,1353,465,10833,361
25462,1375,28865,1135,22374,164317,6491
67637,213,4740,137,4001,29687,739
26744,717,33751,1106,22839,135628,10912
25127,125771,2645514,1141,1951675,4026225,693839
62058,9,186,298,154,7629,32
32340,13,540,1001,319,7938,221
10969,2,248,1368,128,8883,120
27270,109,2079,1095,1353,13765,726
20186,21,589,1231,422,7484,167
10907,3,123,1368,77,5415,46
69022,31,259,90,219,2124,40
45975,2,25,752,21,3047,4
45487,210,2582,757,2116,24337,466
68331,19,271,115,191,5144,80
8964,5,140,1380,92,3652,48
54565,18,223,537,153,5910,70
11831,0,0,1361,0,9713,0
11943,1,358,1359,118,8743,240
35909,7,303,925,236,37305,67
32632,41,709,995,483,9163,226
21767,145,3078,1204,1744,17294,1334
3155,229,12634,1444,8675,44993,3959
10619,130,2622,1371,1753,23783,869
9996,28,1388,1374,857,36454,531
20793,2,531,1221,371,18973,160
26090,45,1404,1121,808,16733,596
53086,286,4062,584,3242,24971,820
4704,44,1687,1426,1086,41639,601
23530,6116,150786,1176,94592,736952,56194
7513,20,565,1390,409,23265,156
54334,46,544,546,437,11231,107
65140,106,800,210,642,6287,158
3688,21,716,1438,524,16795,192
65653,11,613,198,429,6013,184
55561,1,52,507,38,2835,14
55670,292,3992,503,3256,315828,736
35161,666,11688,943,7729,62231,3959
17511,133,2786,1279,2233,68068,553
32624,13,595,990,378,9552,217
1129,60,1577,1460,1067,27394,510
53628,126,1861,570,1365,28829,496
41488,150,3686,811,3271,30268,415
11811,127186,8445609,1361,4651809,15751104,3793800
34834,9188,207000,951,135037,793377,71963
47773,142,1502,729,1292,32048,210
58746,44,670,413,534,10195,136
57208,35,461,461,366,10372,95
60330,17,367,359,266,9754,101
12119,11,433,1358,252,8152,181
56987,72,795,466,616,7291,179
63558,1,41,259,29,1156,12
21048,46,747,1216,508,8829,239
56078,52,769,493,677,14481,92
31797,15681,334605,1008,220359,882228,114246
11088,7,211,1367,130,17935,81
14827,130,2170,1321,1494,65658,676
11894,366,13145,1360,7158,118137,5987
59327,385,3745,394,3264,25570,481
32315,1,34,1001,21,2427,13
43729,134,2045,777,1506,8572,539
51439,3,87,637,57,4899,30
35306,40,658,939,456,9847,202
14100,32,1321,1331,953,28406,368
27938,7,193,1080,109,3162,84
11606,66,3279,1363,2053,35621,1226
14256,165,3254,1328,2177,25123,1077
3121,780,16403,1444,10890,127084,5513
19158,153,2618,1249,1828,39094,790
58758,0,143,413,99,2702,44
36049,952,11115,921,8989,85718,2126
40433,30,355,828,302,7253,53
35765,22,1825,929,1099,7684,726
25646,50,1301,1130,743,17776,558
8649,178,8628,1381,5576,64916,3052
53483,2,63,574,55,4482,8
4766,182,2990,1425,2169,41931,821
3102,595,16838,1444,11849,50624,4989
13643,1483,33635,1337,22372,182786,11263
21902,56,1982,1202,1444,15724,538
2472,69,2205,1450,1544,55836,661
28181,40,632,1076,492,13405,140
18989,0,123,1252,93,5558,30
34112,177,5018,967,3438,28247,1580
18464,736,49151,1261,31128,88693,18023
66563,24,250,172,203,6212,47
67412,37,531,144,409,6586,122
30188,3,224,1036,133,5094,91
35375,23,498,938,427,14621,71
25676,2298,69229,1130,48668,250108,20561
41047,147,4600,818,2303,21143,2297
30196,205,6151,1036,4444,114706,1707
49313,84,972,692,784,13420,188
40356,0,0,829,0,9786,0
25225,78,1464,1140,958,35990,506
5592,3,326,1415,217,16914,109
49276,0,0,693,0,12300,0
56423,8,141,483,114,4975,27
29220,33,1254,1055,769,10213,485
14515,41,1166,1325,836,27211,330
27510,43,909,1089,617,16353,292
2363,23,866,1451,617,23986,249
42386,15,405,797,266,7092,139
28521,75,2064,1069,1602,14427,462
21750,88,2482,1204,1861,31309,621
34134,32,1031,967,754,17132,277
7306,151,4241,1393,2820,55469,1421
68286,62,1256,117,1096,23144,160
4196,144,5175,1433,3794,90239,1381
68690,25,295,102,233,3985,62
13384,13,549,1341,254,9977,295
28350,27,1131,1072,610,7866,521
58906,20,262,408,211,6593,51
56063,188,2123,493,1487,10296,636
67301,0,15,147,10,3008,5
20505,29,774,1226,464,22223,310
59402,25,327,392,259,10466,68
52469,21,535,604,391,8402,144
33068,143,2366,987,1641,10103,725
63151,28,281,268,211,4637,70
22202,0,490,1198,304,11375,186
37875,152,2136,873,1810,32629,326
2232,67,1219,1452,800,16392,419
16537,124,7630,1295,4760,22123,2870
20231,8,291,1230,217,21738,74
27399,429,6862,1092,4841,34768,2021
51324,56,530,640,415,13499,115
28574,32,832,1068,643,8378,189
64444,65,1864,231,1511,19357,353
31776,74,3520,1009,2148,40238,1372
60600,10,97,349,81,5990,16
7137,75,2807,1395,1848,49608,959
18222,2,79,1265,70,20266,9
68442,12,220,111,172,5643,48
62455,12,196,287,146,4062,50
33947,58,1294,971,915,10584,379
28452,205,2091,1070,1397,14063,694
63396,9,115,262,91,6741,24
58493,59,501,421,387,9812,114
21696,59,1110,1204,712,27146,398
30243,74,1262,1035,786,34596,476
11375,934,36028,1365,25021,197030,11007
24971,66,1955,1145,1117,17622,838
15996,10,467,1304,312,6770,155
16421,2050,85561,1297,47676,321258,37885
61007,41,360,334,275,10026,85
5130,538,13057,1420,8161,102015,4896
28512,11,256,1069,157,9528,99
2881,117,8561,1446,5713,106090,2848
58537,302,7145,420,5720,37462,1425
24936,367,6388,1145,5363,161826,1025
8463,785,35908,1382,21041,232851,14867
64530,20,287,229,213,4662,74
9286,55628,2430737,1379,1216032,8742227,1214705
61178,4185,113495,327,80102,518483,33393
9252,45,644,1379,431,6660,213
8121,289,4620,1383,3007,53037,1613
65501,104,1411,202,1241,17499,170
31783,70,1868,1009,1306,14421,562
24044,5,208,1166,176,2928,32
12958,25,1645,1347,995,32434,650
28017,21,303,1078,222,7685,81
56290,20,427,486,280,9776,147
4366,432,14713,1431,8870,41360,5843
40575,45,1332,826,1037,17505,295
2938,69,4551,1446,2904,52837,1647
19130,22,413,1249,334,23018,79
12672,81,1901,1351,1077,33576,824
55415,0,0,511,0,4463,0
59684,14,194,382,161,22326,33
19127,3,422,1249,322,18714,100
28912,12,197,1061,135,8335,62
43537,22,407,779,310,8836,97
22186,383,5205,1198,3041,33776,2164
41028,56,711,818,549,20426,162
21076,4,216,1215,157,6953,59
6552,9,270,1403,185,46502,85
38300,4,146,862,101,5439,45
56018,5,125,494,94,7216,31
32188,18,504,1002,310,4825,194
39410,67,1012,843,877,18035,135
31240,129,7919,1017,4696,44335,3223
56594,49,515,477,417,3850,98
33703,103,1315,975,1013,8425,302
47993,912,13656,727,10067,143184,3589
8723,1362,58807,1381,38575,299670,20232
64741,26,244,223,192,4535,52
21717,210,8500,1204,5801,89102,2699
40588,411,21475,820,17065,112913,4410
52295,275,2304,611,1866,56233,438
9379,0,0,1378,0,5512,0
2318,286,9646,1451,6531,82733,3115
5176,712,23812,1420,16221,110452,7591
21246,2,156,1212,101,6104,55
5111,94,3573,1420,2431,113248,1142
37856,132,3434,873,2192,35688,1242
26486,2503,58545,1113,39239,298253,19306
22494,6,138,1194,88,8726,50
23194,42,921,1181,822,55360,99
11465,930,31265,1364,20532,93810,10733
65272,7,32,207,27,2895,5
37498,152,4112,883,3356,42995,756
13639,137,6923,1337,4425,85591,2498
1832,53,878,1455,645,11075,233
50491,4303,58692,662,49361,234340,9331
58533,84,934,420,705,17446,229
32239,0,88,1002,61,4845,27
11142,50,2692,1366,1613,24252,1079
28040,31,783,1078,516,10841,267
21963,1,223,1201,109,10862,114
46511,10,153,746,109,10199,44
24070,16,416,1165,294,10519,122
61530,342,4166,317,3539,38970,627
21275,3,301,1211,198,8764,103
12387,98,4542,1355,2448,34146,2094
35883,6,77,926,54,7768,23
62782,58,509,278,413,11196,96
48749,3,46,710,34,2560,12
47548,20,325,732,262,5235,63
15008,90,3035,1319,2358,39952,677
42524,4,56,795,42,2726,14
29000,67,2717,1060,1653,16187,1064
68253,9,151,118,111,5767,40
22887,14,534,1186,408,21410,126
13058,372,25015,1345,13848,56641,11167
54057,20,266,556,216,7079,50
7120,86,2464,1395,1884,44969,580
2766,839,56199,1448,36635,339600,19564
32458,3835,80652,998,55152,416177,25500
67337,87,1325,146,1022,13830,303
39504,14,247,840,221,7303,26
20050,140,5957,1233,3519,34028,2438
59498,15,99,388,80,8398,19
38836,39,796,849,607,8809,189
10037,10698,388529,1374,237874,1616962,150655
23258,7,179,1180,139,16010,40
68978,142,1837,92,1678,20234,159
27548,45,1372,1088,818,15505,554
14226,75,3266,1329,2250,53344,1016
35575,24,170,933,160,11426,10
53794,24,185,565,141,9237,44
32804,202,2758,992,1867,21702,891
40752,36,710,823,531,7589,179
10588,2,60,1371,28,4146,32
2180,14,282,1452,199,10660,83
11183,151,3950,1366,2346,21160,1604
44757,5,122,766,89,4022,33
10742,45,1392,1370,906,18300,486
63869,229,2082,249,1531,10458,551
38377,7,194,860,156,3668,38
9288,373,9409,1379,6756,58673,2653
56141,13,128,491,97,3987,31
28693,20,520,1065,287,7225,233
50877,180,2232,652,1852,23929,380
57614,10,277,451,218,8688,59
36703,113,737,905,569,13120,168
63491,31,315,260,250,8569,65
43921,4330,74165,771,53013,276597,21152
113,715,61057,1470,40167,258148,20890
24183,53,646,1162,524,54904,122
1671,44,1150,1457,809,36287,341
16240,159,8291,1300,5460,68870,2831
26642,907,33993,1108,22967,231004,11026
68804,4,61,98,53,4014,8
63900,266,2901,248,2362,20315,539
48580,26,351,715,274,10999,77
31872,6,222,1007,160,5103,62
34431,0,0,961,0,4116,0
29814,45,1555,1044,996,15605,559
33159,7,204,986,146,8681,58
52324,145,4107,610,3569,19732,538
30152,51,1025,1037,621,13374,404
44767,13,192,766,158,12708,34
61442,50,478,319,348,6183,130
31935,181,5366,1007,4313,45420,1053
39830,27,400,837,368,11853,32
4570,3,158,1428,112,8938,46
2635,7,192,1449,128,24204,64
25042,8,358,1143,255,8126,103
19108,76,2182,1250,1431,18753,751
29640,120,1308,1048,871,7540,437
30297,636,25870,1034,16211,157117,9659
27820,93,1574,1083,1307,48814,267
68477,68,1342,110,1111,8110,231
3252,499,9462,1443,6788,99509,2674
49240,225,3482,694,2690,34204,792
15282,38,1059,1315,819,10921,240
50275,15,152,667,119,5802,33
33574,10,217,977,191,9487,26
15361,24,521,1314,355,24153,166
15347,85,1561,1314,1153,29866,408
42099,96,1055,801,850,8931,205
4225,4,111,1433,71,12745,40
5484,45,1539,1416,1098,18083,441
25393,1294,23438,1136,15212,140437,8226
12418,26,1166,1354,730,30392,436
41381,7768,237146,813,166625,903600,70521
56111,581,4548,492,4164,40440,384
35235,133,2696,941,2071,23952,625
43057,203,2479,785,1895,32571,584
54152,85,514,553,401,12049,113
19409,240,6012,1244,4061,57434,1951
5174,780,40694,1420,25949,200373,14745
58149,15,194,434,151,6350,43
51511,0,2019,635,1594,9046,425
27744,42,804,1084,607,7346,197
19982,7,303,1234,199,15367,104
53819,6,141,564,91,4632,50
31817,165,2552,1007,1647,46569,905
49096,5,104,699,85,10292,19
12305,47,1362,1356,743,12848,619
58999,58,598,405,486,8150,112
68544,27,329,107,269,4334,60
39404,719,7477,843,6046,85474,1431
33264,17,463,983,311,12566,152
25701,36,621,1129,527,11734,94
34361,44,644,962,439,6087,205
51387,9139,131802,638,105605,660504,26197
49766,981,15381,680,12192,109384,3189
49754,25,450,680,379,10898,71
65878,8,58,192,48,1438,10
21786,23,666,1203,425,17036,241
13488,7,236,1339,153,16638,83
56479,409,2981,481,2684,28161,297
3232,35,670,1443,456,14968,214
11173,6158,443191,1366,221805,942098,221386
7498,67,1839,1391,1306,37413,533
27490,56,1020,1090,665,13537,355
66702,30,341,168,263,3584,78
1789,49,1907,1456,1381,18064,526
2484,34,1478,1450,971,43231,507
48984,139,1747,703,1388,23715,359
12297,58,3190,1356,2100,42087,1090
51048,14,192,648,152,9557,40
24440,22,297,1157,215,8827,82
60917,6,34,337,33,2959,1
17289,1254,28526,1282,19046,245339,9480
14675,19,605,1323,396,7915,209
22384,112,2488,1195,1753,41970,735
57826,3,57,444,42,3382,15
5425,51,3023,1417,1873,63301,1150
35937,88,1374,925,1036,15782,338
46104,35,329,751,229,4440,100
23061,188,3086,1183,2104,64500,982
40380,33,300,608,200,4268,100
887,19,840,1462,656,21925,184
45533,1123,25534,757,20290,163381,5244
10914,774,107366,1368,58595,323869,48771
48373,40,524,721,388,10436,136
58756,8,71,413,53,3877,18
17077,3676,151722,1286,88893,765297,62829
33618,272,4786,977,3526,44127,1260
34096,406,8204,965,5268,63527,2936
5637,5,265,1414,170,8618,95
55535,378,8801,508,6950,56742,1851
25361,348,6283,1136,4810,51511,1473
8109,27,433,1383,305,6841,128
4119,36,1646,1434,1104,52975,542
3478,4,89,1441,58,16821,31
62038,53,678,300,494,9755,184
4790,117,2512,1425,1478,12731,1034
37699,2172,32584,877,21489,109977,11095
33792,64,1883,974,1215,28998,668
17714,75,3515,1275,1997,13883,1518
50170,332,6778,670,5403,35148,1375
67001,11,127,157,95,4308,32
10279,9,451,1373,275,6770,176
44286,92,1667,771,1287,24810,380
2932,131,6085,1446,4217,48883,1868
53230,10,175,580,139,6621,36
66227,7,91,182,82,2389,9
20127,72,1797,1232,1336,12705,461
13000,26,3326,1346,1808,37431,1518
55259,33,536,515,439,33497,97
7151,11,374,1395,264,10678,110
64883,27,222,218,197,4741,25
59069,26,332,403,280,4156,52
31638,53,1852,1011,1305,29993,547
8363,10,332,1382,237,11126,95
27657,133,1837,1086,1116,31394,721
34648,19,195,955,190,7366,5
32378,1911,61239,1000,40198,114049,21041
59661,1664,37815,379,30514,192013,7301
55714,9,88,503,73,3944,15
27103,53,1789,1098,1069,30482,720
17135,14,336,1285,257,7373,79
55486,105,873,509,685,13546,188
1559,23,858,1457,648,11598,210
15419,708,20113,1313,14503,126723,5610
53101,51,396,583,334,9690,62
53126,618,6098,582,4987,43770,1111
4155,20,454,1433,313,8051,141
63218,153,2131,267,1583,15852,548
5615,81,1837,1414,1258,16865,579
29110,40,2386,1058,1484,35463,902
2771,50,2116,1448,1394,48004,722
67147,164,1738,152,1301,9562,437
36061,1550,25310,921,20841,136424,4469
59116,147,1697,402,1351,8528,346
39419,3,82,842,64,6857,18
37804,28,460,874,356,7065,104
9700,949,83652,1376,46917,297639,36735
26321,847,20600,1116,13017,182711,7583
52878,111,1508,590,1220,49367,288
30079,42,737,1039,485,10983,252
61929,926,174688,299,125137,148201,49551
66944,4,81,158,54,3475,27
32244,70,1009,1002,682,13279,327
7313,12,388,1393,265,12537,123
56670,1695,44939,475,35138,151022,9801
8970,25,621,1380,416,6597,205
21606,171,3450,1206,2443,20870,1007
61383,1,49,321,38,3672,11
17795,3,185,1273,133,9061,52
37015,90,2278,896,1820,49711,458
30086,1215,17191,1038,11213,69151,5978
16118,25,867,1302,536,8505,331
21852,77,1074,1203,714,12580,360
19808,269,12860,1237,8950,54778,3910
61047,7,73,333,51,4170,22
31521,389,8305,1013,5630,124634,2675
12583,1320,39178,1352,22212,219103,16966
60720,2857,35414,344,29431,112453,5983
67625,5,217,137,201,4410,16
18595,32,1140,1259,827,55330,313
48495,16,352,718,243,16448,109
64378,291,4529,204,3037,18873,1492
40923,24,694,820,495,6458,199
26890,38,1335,1103,850,13696,485
35124,227,3585,938,2559,27769,1026
19905,703,22971,1236,13827,277698,9144
30293,23,787,1034,452,13022,335
8221,1215,55374,1383,36402,274331,18972
34968,81,1928,946,1591,38012,337
61853,20,393,306,330,5063,63
33443,24,1236,980,735,20521,501
5538,19,441,1415,342,11627,99
15138,21,596,1317,413,13485,183
27065,119,3940,1099,2560,20113,1380
54107,45,431,554,275,8901,156
53194,17,198,581,157,7363,41
39959,10215,224406,835,168498,897204,55908
29980,6,775,1041,387,8826,388
41620,663,10269,807,8157,80556,2112
13156,56,1970,1344,1253,28289,717
40712,362,4726,824,3167,26507,1559
1754,12221,576437,1456,342891,1820805,233546
33641,124,1663,977,1079,32454,584
61499,135,1083,318,887,16849,196
55314,262,4031,513,3333,44467,698
49998,5,79,674,67,3708,12
61011,10,98,334,77,1864,21
49071,38,524,700,437,6669,87
20607,148,10927,1224,6919,67404,4008
60077,416,6853,368,5712,74148,1141
12723,112,1578,1350,991,12834,587
17940,8,163,1270,122,12502,41
9660,37,2779,1377,1637,17285,1142
45796,368,4908,754,3773,34988,1135
56971,12,152,467,125,4002,27
65054,125,2221,212,1909,16150,312
1991,0,2642,1454,1699,39484,943
62236,3,20,293,18,2841,2
33124,322,5689,986,4069,56457,1620
68931,17,320,94,249,1979,71
20543,170,5804,1225,3965,36713,1839
11637,52,1189,1362,758,9543,431
60264,1490,31694,362,25978,172242,5716
56895,24,319,469,241,4190,78
34718,493,10949,953,8612,75613,2337
3651,14,487,1439,344,29445,143
54337,298,4423,546,3018,23824,1405
26540,835,28806,1111,20063,124739,8743
52118,8,184,617,133,5853,51
66582,2,37,171,28,1154,9
61335,56,472,322,384,21618,88
37244,1129,11729,889,9034,58876,2695
7225,29,1032,1394,656,17418,376
43341,12,265,782,222,7191,43
29202,19,740,1056,437,9110,303
34423,67,2773,959,1962,22946,811
57322,78,1051,458,858,33318,193
2065,32,1491,1453,1076,15505,415
4890,15,1057,1423,758,18225,299
6181,2,105,1408,72,6532,33
61115,9,219,330,160,4466,59
65937,36,562,191,452,6498,110
53525,167,2036,573,1689,53571,347
26597,9,103,1109,98,8494,5
23288,3,51,1180,31,2281,20
67384,175,8575,145,7273,19161,1302
54498,1352,29402,540,24213,131995,5189
34586,18,286,958,213,5816,73
25985,9,451,1123,283,11573,168
62154,53,1131,295,961,15113,170
22574,23,810,1192,552,11729,258
18051,19,397,1268,291,4852,106
27916,7,453,1080,283,18042,170
51454,113,977,637,772,15185,205
31766,676,6982,1009,4729,33294,2253
52976,276,4629,587,3479,63135,1150
33585,42,1713,978,952,8514,761
61201,6,66,327,51,4169,15
11446,535,23473,1364,13607,250999,9866
51157,30,588,644,460,15570,128
53344,36,506,577,424,14199,82
45751,177,2137,755,1489,15660,648
65948,19,225,191,204,4383,21
12480,208,4678,1353,3349,44608,1329
2715,476,17924,1448,12249,164395,5675
66400,45,997,126,684,8797,313
12174,117,3596,1357,1972,11801,1624
28675,125,4076,1066,2491,47496,1585
450,94,11903,1466,8310,53824,3593
20940,22,1284,1218,762,10888,522
27574,3903,92300,1087,68838,229833,23462
28702,6,132,1065,80,10525,52
24436,83,1376,1157,899,17054,477
32944,171,3934,990,2867,44190,1067
48696,40,252,712,200,6662,52
12502,207,5907,1353,3591,41598,2316
15143,4653,240244,1317,148726,835832,91518
63022,643,7950,272,5988,51440,1962
23378,16,341,1178,230,7170,111
24215,97,2384,1162,1576,9800,808
26857,8,238,1104,147,6240,91
54191,56,612,551,480,10976,132
67363,7,106,146,75,3682,31
90,88,2605,1470,1786,45529,819
67354,4,36,146,26,1591,10
26856,444,5617,1104,3729,36577,1888
8730,48,1094,1381,783,25417,311
17155,71,2060,1285,1451,31268,609
22290,203,3422,1197,2185,22351,1237
582,99,4845,1465,3258,121448,1587
4577,1047,48166,1428,33373,286625,14793
62660,15,158,281,129,11577,29
51334,54,598,640,511,10838,87
57072,40,381,464,257,3461,124
3537,6,130,1440,90,12781,40
28277,34,1170,1074,722,23088,448
10843,6120,221840,1369,124023,723752,97817
40727,5,97,823,75,5778,22
31305,82,4527,1016,2642,21213,1885
12755,12,589,1350,296,5919,293
6804,68,3020,1400,1950,33579,1070
31208,954,17842,1017,12615,54131,5227
61736,21,261,310,210,8340,51
63706,597,9125,254,7323,66790,1802
6034,190,7283,1409,4688,90230,2595
55529,19,142,508,127,8358,15
29278,1,115,1054,105,8163,10
60763,1065,19123,343,15009,133045,4114
58272,217,4777,429,3904,26947,873
2371,30,1522,1451,1129,19184,393
16999,19,1353,1288,912,42415,441
63409,26,234,262,174,4073,60
61131,2,63,329,50,2749,13
16257,45,423,1300,307,14743,116
67070,50,702,156,540,13054,162
4562,34,2888,1428,1838,66642,1050
2176,579,50094,1452,32832,280325,17262
25054,21,1165,1143,903,26577,262
1021,266,13528,1461,8264,112304,5264
4260,5915,191056,1432,110353,302417,80703
3492,164,5711,1441,4000,74445,1711
63189,46,929,268,681,8313,248
41592,16910,348311,809,192319,900238,155992
28444,52,1598,1071,889,8751,709
14198,4630,156430,1329,97918,742733,58512
56738,53,507,473,438,10068,69
6157,306,6943,1408,4671,100731,2272
25902,92,2873,1125,1733,21744,1140
19916,71,2164,1236,1512,20844,652
32826,12,684,992,396,8814,288
36304,9,168,914,118,9234,50
59337,55,746,394,582,12093,164
28051,25,1216,1078,804,16332,412
24893,44,730,1146,523,14492,207
35998,24,353,923,256,5504,97
63923,62,1072,247,780,11642,292
48052,221,2760,727,2123,35789,637
32103,144,1826,1004,1279,19806,547
63393,4,43,263,26,1959,17
58258,29,570,429,443,10448,127
28273,9,205,1074,142,3761,63
62452,2,21,287,20,3619,1
52167,928,13899,615,10786,52579,3113
60018,233,3801,371,2916,24347,885
2589,84,2062,1449,1358,19819,704
22525,60,3028,1193,2159,57922,869
51407,10,194,637,149,8205,45
10405,11,308,1372,190,10360,118
7847,1355,100733,1386,57255,354006,43478
20522,7,713,1225,549,10392,164
248,3822,146405,1468,82817,532624,63588
41470,1757,48963,811,36002,326708,12961
55902,40,550,498,424,16420,126
31977,46,1090,1006,709,10720,381
48482,15,225,719,180,6123,45
16492,3,157,1296,98,6062,59
10719,9,488,1370,318,6186,170
67037,25,315,156,245,5464,70
22207,99,2946,1198,2032,28602,914
50,42,1378,1471,984,45801,394
49137,152,2037,698,1771,19250,266
18173,62,2104,1267,1671,37833,433
50498,17,245,662,182,7535,63
47233,43,780,736,568,6348,212
9759,983,45178,1376,27275,138311,17903
13409,26,456,1341,296,21336,160
66559,304,6936,170,5467,40319,1469
53421,26,206,575,176,8684,30
28824,41,1920,1064,1259,15864,661
34136,56,893,967,607,23898,286
16427,7,277,1297,183,11129,94
23281,14,600,1180,438,18651,162
65431,119,3077,203,2449,14378,628
4752,12,216,1425,141,19781,75
11613,245,6980,1362,4511,29432,2469
60874,24,152,339,117,3317,35
48172,967,10785,725,8242,57625,2543
18765,23,411,1256,275,11955,136
1996,69,2802,1454,1904,34242,898
2818,266,13299,1447,8448,76597,4851
27592,181,5100,1087,3064,29735,2036
53302,37,576,578,457,13471,119
54474,225,4489,541,3477,21176,1012
17606,5,304,1277,241,21855,63
35031,91,1947,946,1501,22621,446
53717,127,1302,567,1067,17327,235
41088,22,297,817,222,8640,75
19904,663,28849,1236,18376,234423,10473
43461,49,1305,780,900,15811,405
66498,13,285,174,203,5016,82
15246,4,456,1316,114,11663,342
23366,75,4772,1179,3399,34762,1373
44445,237,3851,769,3131,30448,720
67890,1,45,129,35,2019,10
67286,23,407,147,284,5289,123
67173,6,148,151,113,6512,35
15628,137,5774,1310,4158,113561,1616
32566,61,1073,996,652,15215,421
29680,1,61,1048,42,11580,19
1561,69,1088,1457,748,15961,340
24990,42,1304,1144,862,7650,442
15697,12,484,1309,345,15708,139
40740,444,7193,823,5800,92969,1393
3909,80,3183,1436,2238,21528,945
4544,12,352,1428,239,11123,113
48934,251,3120,704,2413,26260,707
62336,0,5,290,3,1872,2
49981,327,5506,675,4379,63257,1127
30074,12,478,1039,324,17450,154
31109,16,414,1019,381,26174,33
25645,71,2838,1130,1987,26682,851
68034,3,83,124,56,3066,27
49750,98,1829,681,1571,35276,258
59395,41,641,392,540,7314,101
1499,20,666,1458,489,20690,177
36253,52,1095,916,835,13140,260
36458,39,1247,907,882,33010,365
66923,8,159,160,119,5478,40
42259,18,315,799,244,10814,71
35544,64,1633,933,1153,11212,480
22754,618,14430,1189,9362,64750,5068
66816,12,136,164,106,5164,30
4552,12,357,1428,260,13970,97
2045,4,337,1454,224,12238,113
33608,30,774,977,507,8344,267
21042,27,546,1216,360,11748,186
11404,173,5299,1364,3274,40202,2025
51577,144,1185,633,1027,18556,158
25617,38,1657,1131,964,28662,693
24103,8,138,1164,82,11255,56
33793,185,2527,974,1662,18688,865
21199,5731,165433,1213,112329,789639,53104
48619,43,499,714,378,12922,121
4636,301,6206,1427,4176,23825,2030
16675,7,178,1293,139,8300,39
1485,341,17019,1458,11293,110688,5726
24556,17,497,1154,337,5999,160
842,40,1521,1463,1062,29626,459
68027,7,368,122,332,2530,36
7071,155,10497,1396,7033,56149,3464
13226,46,753,1343,477,14752,276
1948,33,589,1454,411,12146,178
7292,17,671,1393,477,20725,194
66917,59,825,160,607,7005,218
34822,59,886,951,641,17606,245
55896,38,363,498,293,10114,70
36351,1005,20097,913,16521,158246,3576
58374,411,5813,426,4889,42200,924
68613,2,22,105,19,2616,3
11377,59,2189,1365,1359,47855,830
50407,561,8972,664,6726,68781,2246
52487,5100,84663,604,64526,844412,20137
561,40,1236,1465,879,17489,357
60145,120,1808,366,1424,12001,384
23399,6,189,1178,141,9585,48
53514,48,626,574,505,13894,121
7249,57,1635,1393,955,16673,680
1565,40,1355,1457,974,49928,381
375,17,868,1467,654,16342,214
61529,0,4,317,3,1759,1
545,742,38238,1465,24681,93874,13557
32640,11,609,995,461,13449,148
5645,63,2615,1414,1866,68119,749
20452,9,216,1226,142,11952,74
34912,27,1086,949,615,35786,471
20691,518,18844,1222,12622,73391,6222
47374,14,341,735,247,11474,94
24723,15639,342901,1150,220928,1508698,121973
55705,480,7167,503,5263,100867,1904
52886,91,920,590,728,13407,192
4765,174,7673,1425,5105,44971,2568
60718,842,8097,344,6543,32022,1554
57727,614,10177,447,8463,46751,1714
19202,7,299,1248,225,8964,74
4708,17610,638698,1426,355014,2576766,283684
34585,40,2484,957,1632,24916,852
13897,40,1351,1334,875,43326,476
19655,973,18065,1240,12116,178982,5949
59192,4551,84601,399,64355,252191,20246
64774,53,815,222,391,5086,424
17018,902,16783,1287,10750,124255,6033
11697,7,289,1362,146,9700,143
22144,14,302,1199,218,6638,84
9024,5,210,1380,111,9701,99
30134,192,3848,1037,2891,26094,957
19122,550,25293,1249,17792,221782,7501
1558,1487,53638,1457,28542,109427,25096
52692,28,427,596,333,14159,94
53582,8,100,572,82,4907,18
54330,35,371,547,300,5608,71
8287,23,568,1383,357,23087,211
35709,11,299,930,232,8415,67
50381,43,714,665,556,19040,158
36118,154,3371,920,2899,30678,472
428,39,3363,1466,2358,23174,1005
31535,19,153,1013,93,5220,60
24808,41,810,1148,620,25170,190
61873,21,299,306,236,3671,63
66275,5,78,181,60,4916,18
45299,4,48,760,39,4608,9
67329,6,86,147,63,2333,23
37426,1,56,885,43,2769,13
48339,329,4836,722,3875,63298,961
25351,28,1621,1137,1037,13741,584
9916,157,3116,1375,2054,44089,1062
9171,23,821,1379,519,12091,302
21180,12,366,1213,329,24236,37
48916,68,1117,705,800,11574,317
59597,54,505,385,401,8087,104
25507,21,894,1134,588,34365,306
5611,87,2777,1414,1766,29651,1011
19313,99,4101,1246,3088,45478,1013
13391,189,8617,1341,5396,49131,3221
3524,1571,32164,1440,19199,759260,12965
29824,3616,80828,1044,55930,272816,24898
67792,9,71,126,68,1184,3
59236,29,703,398,522,13281,181
34631,75,1498,956,1075,10576,423
60027,10,152,371,126,8924,26
1899,145,6824,1455,4323,43955,2501
8807,137,3038,1380,1871,19930,1167
44668,62,930,767,752,13055,178
8557,27,534,1382,340,8577,194
52065,636,10020,618,7951,72323,2069
56977,33,585,466,440,9293,145
995,72,4661,1461,3137,29967,1524
27227,5,268,1096,149,4117,119
64088,55,740,241,551,13773,189
45790,100,1695,755,1267,13492,428
17502,11,294,1279,242,7175,52
32230,276,4882,1002,3414,44231,1468
23573,5,312,1175,169,4136,143
38754,680,7918,851,6064,76518,1854
49582,34,242,686,172,3802,70
2103,159,6268,1453,4313,63835,1955
32467,15,527,998,324,10798,203
33748,67,807,975,558,8192,249
67593,23,230,138,176,5667,54
6334,7,384,1406,253,15137,131
28518,493,6025,1069,3720,27701,2305
21168,1309,38103,1213,24683,279993,13420
7138,9,610,1395,383,31430,227
64337,34,540,234,437,5795,103
18657,550,16224,1258,10012,66665,6212
56998,6124,124205,465,85636,594757,38569
13660,25,1139,1337,677,12051,462
57925,132,5399,441,1137,29288,4262
19508,10,408,1243,333,34264,75
12225,0,0,1357,0,19718,0
49848,72,854,679,628,7831,226
60866,233,3787,339,3185,30597,602
7328,972,29567,1393,18182,147219,11385
24471,2,226,1156,159,7144,67
48885,110,1689,705,1398,20514,291
22917,20,890,1186,618,19152,272
28431,102,3006,1071,1849,50725,1157
8407,153,1909,1382,1220,34500,689
26304,33,1499,1116,950,18891,549
25022,13601,312743,1143,200308,711018,112435
56741,373,6156,473,4597,42314,1559
1479,57,3225,1458,2146,58260,1079
64815,21,255,220,225,7923,30
38982,484,9890,848,7402,95475,2488
42630,32,888,792,663,11457,225
34555,968,17213,958,12849,108936,4364
25549,111,2670,1133,1723,30949,947
51052,256,2122,647,1602,35442,520
27460,39,476,1091,440,11368,36
59384,95,1772,391,1417,14532,355
38039,328,3932,868,3194,43131,738
4035,5,259,1435,147,14128,112
63425,54,816,261,475,8806,341
64436,43,1032,231,833,11670,199
19086,3,277,1250,198,15045,79
30361,69,1763,1033,1098,16625,665
67533,96,1530,140,1246,8410,284
21005,21,983,1216,700,12298,283
32161,23,1060,1003,629,24495,431
8622,550,32093,1381,19069,243485,13024
64804,23,663,196,526,16017,137
14868,1,74,1321,46,7297,28
6354,34,775,1406,525,19099,250
65154,8,49,210,33,4339,16
8804,36,2405,1380,1507,52344,898
16470,0,41,1296,27,5462,14
7753,6,355,1387,253,34771,102
65136,103,736,210,595,5389,141
34414,4,99,961,78,5605,21
20703,375,14942,1222,10262,124518,4680
38645,195,5478,852,4325,62943,1153
41535,44,1278,811,1064,18261,214
23071,5,194,1183,132,8521,62
28143,171,4895,1076,2852,20503,2043
51519,127,1124,635,978,38398,146
25658,470,5492,1130,3381,28548,2111
38514,153,4375,856,3575,45157,800
30867,45,833,1023,544,7702,289
1233,962,34245,1460,23312,328403,10933
18022,324,12064,1269,8010,88053,4054
63838,5,75,250,63,2403,12
5675,94,2984,1414,1894,43002,1090
53744,9,174,567,146,5726,28
56982,32,822,466,652,8335,170
53535,34,452,573,405,23268,47
6594,5764,128086,1402,77852,366491,50234
36902,64,921,900,737,12776,184
14748,8,556,1322,368,11325,188
19768,134,4835,1238,3492,44683,1343
53510,3,76,574,58,4131,18
43709,331,6967,777,6124,55597,843
42412,18,506,796,386,11032,120
35178,165,1888,940,1539,17758,349
34416,278,4968,961,4206,54640,762
24444,3178,86758,1157,59017,458698,27741
55651,54,484,504,381,8697,103
68501,10,110,109,81,1883,29
13710,31,562,1336,382,16613,180
10332,218,7367,1372,4351,32795,3016
58331,313,5305,427,4293,35862,1012
15297,2,268,1315,176,11099,92
12903,5,105,1348,58,3099,47
14642,3576,113087,1323,76079,604712,37008
1822,181,4381,1455,3273,25541,1108
11472,14,713,1364,431,11082,282
48733,7,98,711,84,2186,14
30494,99,919,1030,761,26912,158
9972,278,5163,1375,3432,34082,1731
39958,9,118,835,93,3843,25
34928,1515,43489,949,36077,217128,7412
26991,159,6809,1101,4011,54278,2798
49332,142,1609,692,1105,10765,504
56830,234,3493,471,2588,26122,905
56944,7,70,467,41,6611,29
10131,134,3771,1374,2505,28476,1266
1579,339,5300,1457,3734,24264,1566
51230,733,9300,643,7880,69180,1420
45952,6,332,752,188,6475,144
30,44227,1763685,1472,967504,4323724,796181
994,313,19170,1461,13663,61341,5507
1573,131,5118,1457,3716,58846,1402
57833,487,9543,444,7673,55647,1870
5475,29,930,1416,652,32492,278
63180,27,421,268,334,5821,87
8817,40,1326,1380,836,14312,490
2076,45,2363,1453,1785,61540,578
49268,12,252,694,197,5168,55
43971,1401,35232,775,25097,210273,10135
65132,10,111,210,94,3060,17
34234,991,13705,965,10144,56543,3561
52169,22,402,615,300,9939,102
33084,32,1021,987,619,15843,402
8833,25,1024,1380,679,14419,345
68224,346,7287,119,6116,68650,1171
62200,19,203,294,160,5682,43
63852,262,4851,250,4000,35927,851
5271,232,4220,1418,3018,27227,1202
50219,489,9114,669,7273,45868,1841
8462,655,35608,1382,22089,72196,13519
23912,56,1305,1169,1047,67948,258
15460,37,548,1312,359,7585,189
68150,148,4001,121,3325,23038,676
20200,62,2379,1231,1769,28837,610
35428,569,6311,936,5364,39235,947
57741,937,8773,447,7020,70143,1753
11132,26,602,1366,366,7990,236
10237,7,196,1373,126,7939,70
23627,57,964,1174,660,11591,304
62774,54,946,278,640,6111,306
19258,618,21673,1247,15002,178804,6671
16027,28,372,1303,275,22926,97
67058,13,173,156,132,4122,41
28059,15,518,1078,350,13441,168
37300,2,35,887,31,2945,4
5427,5,366,1417,250,8253,116
21940,15,297,1201,190,6688,107
7731,9,303,1387,204,11123,99
18686,14,466,1257,343,15127,123
55821,94,1342,500,1075,36102,267
33799,278,6400,974,4560,61960,1840
66777,8,140,165,104,4804,36
19216,11,332,1248,216,6399,116
2604,483,14234,1449,8852,49303,5382
41086,41,511,817,390,11395,121
18191,11,326,1266,261,10006,65
41776,62,490,806,357,6285,133
33330,2065,33866,982,22462,75325,11404
59585,29,312,386,257,8058,55
7196,34,1861,1394,1242,21889,619
35893,564,7540,926,5813,75510,1727
30232,6,155,1036,98,5345,57
29998,9,363,1040,236,10635,127
65163,1060,3619,210,3262,241228,357
26083,4,209,1121,124,5647,85
13813,11,381,1335,234,18355,147
49919,10,262,676,188,10759,74
11650,581,52552,1362,25333,199675,27219
3592,3349,282312,1440,128464,2576551,153848
5119,84,3368,1420,2223,38250,1145
61331,50,685,322,468,9560,217
20733,4,300,1222,213,14425,87
35279,109,2699,940,1747,32746,952
52147,286,4980,616,3583,36453,1397
3495,8,223,1441,140,9414,83
30122,44,1582,1038,1023,15380,559
23453,30,1807,1177,805,14755,1002
48859,3,63,707,47,3321,16
22853,34,1045,1187,738,8590,307
58952,13,90,407,74,4183,16
58787,226,4112,412,3169,81744,943
40494,535,9895,827,7294,49082,2601
27932,59,1383,1080,902,18613,481
17844,18,577,1272,485,38910,92
45601,7,173,757,131,4365,42
60948,179,3373,336,2455,15282,918
61290,26,393,323,307,7707,86
39875,8,67,836,50,3160,17
21996,235,4804,1201,3135,41649,1669
35910,16,232,899,158,7873,74
52576,803,8504,601,6784,49984,1720
1403,4,457,1459,330,10679,127
54698,0,258,533,197,5141,61
27998,6,90,1079,67,4718,23
35155,1330,49903,943,35391,146912,14512
35781,42,697,929,552,10631,145
13082,1769,64688,1345,37591,316895,27097
18509,29,706,1260,542,9402,164
28107,21,210,1077,129,5075,81
17404,12,395,1281,270,8958,125
18778,7,466,1256,373,35790,93
6904,109,2053,1399,1498,80970,555
57887,145,2074,442,1773,38637,301
48543,97,2290,716,1578,37366,712
11550,1553,71080,1363,39803,386546,31277
2808,1449,53919,1447,22551,128413,31368
57596,9,52,451,46,7041,6
33718,1151,25045,975,14685,87704,10360
1387,623,23145,1459,14562,356937,8583
66347,29,375,179,284,6280,91
34784,38,1244,952,780,16569,464
32881,45,1258,991,931,15175,327
60536,251,3515,352,2755,38790,760
55211,69,679,517,574,12759,105
48584,18,255,715,188,10098,67
50975,23,281,650,176,4909,105
15798,177,3784,1307,2629,48342,1155
27956,24,810,1079,526,11164,284
11226,20,1289,1366,627,18780,662
31385,3,95,1015,65,15881,30
29555,39,545,1050,350,13006,195
55634,2,58,505,51,5743,7
25704,34254,708398,1129,500205,2124682,208193
9314,61,1108,1378,709,19830,399
33659,48,1143,976,809,18663,334
49875,67,774,678,625,11959,149
5986,32,1444,1410,962,10584,482
59928,43,679,374,561,8841,118
14589,0,2919,1324,1979,32056,940
53638,2442,44084,570,27920,83340,16164
13552,259,8429,1338,4955,78436,3474
59294,149,1594,395,1346,14662,248
48570,938,13943,715,10685,118627,3258
52436,865,14653,606,12144,42037,2509
51641,0,24,631,18,2641,6
65623,82,1068,199,923,18596,145
20948,183,3120,1217,2392,38792,728
56746,76,998,473,650,10980,348
51720,3,45,629,39,9721,6
54609,658,5696,295,5228,45392,468
64714,44,527,223,466,20054,61
65544,52,722,201,608,8370,114
56933,131,1449,468,1033,17502,416
20751,1054,28218,1221,19298,162464,8920
28063,51,1525,1078,982,16585,543
30599,420,3091,1028,2170,27665,921
52136,62,699,616,523,15358,176
49776,1093,14742,680,11326,132452,3416
13916,15,319,1334,217,13720,102
48265,6370,94021,724,68635,260732,25386
21565,11,381,1206,196,12351,185
20221,30,630,1230,495,17635,135
24204,5,967,1162,624,19675,343
1749,109,3869,1456,2550,62978,1319
15331,110,3384,1314,2380,41382,1004
1799,57,1387,1456,1008,13885,379
15725,2193,71581,1309,47570,465414,24011
27144,177,4893,1097,3293,66229,1600
63063,41,395,271,328,7158,67
68361,12,110,114,81,3664,29
6002,11186,580564,1410,402156,2070593,178408
7694,88,6427,1388,4501,43980,1926
9386,21,585,1378,436,12876,149
55232,115,3925,516,3056,44913,869
12701,4,476,1351,218,5518,258
58807,9,114,411,102,4699,12
56226,11,81,488,63,2946,18
51802,22,188,626,160,10402,28
18094,27,633,1268,452,8924,181
40370,4,47,829,40,2801,7
37611,3,48,879,36,3341,12
42560,46,536,794,399,11508,137
26167,10,481,1120,261,6289,220
57790,49,670,445,565,10902,105
50590,26,286,659,208,9386,78
23839,17,338,1170,263,10713,75
25641,7,199,1131,119,4334,80
14614,291,8392,1324,5575,117216,2817
14671,29,1227,1323,894,33449,333
57481,131,1432,454,1108,11719,324
24716,152,3176,1150,2089,24631,1087
26092,77,2044,1121,1256,10353,788
47055,2,41,647,28,3976,13
55877,35,426,499,323,5577,103
14556,0,0,1324,0,7270,0
28815,18,577,1064,337,6069,240
17379,5,152,1281,93,3330,59
21360,21,977,1210,591,7314,386
18552,52,1277,1260,916,15035,361
46585,613,8217,745,6168,97534,2049
213,3782,72681,1468,46710,350291,25971
30978,13,423,1021,251,8497,172
18327,7,307,1264,203,10279,104
34839,19,397,951,261,10425,136
2893,111,2851,1446,2059,30016,792
68471,2,32,110,26,2597,6
23937,65,1268,1168,885,26735,383
65695,3,110,197,81,5832,29
54248,61,537,549,422,10262,115
49706,59,843,682,729,13358,114
66140,35,345,184,281,7053,64
57344,93,846,457,686,10576,160
40451,248,5083,827,3485,24353,1598
19671,86,2829,1240,1954,43896,875
13399,1331,69121,1341,40407,219958,28714
60824,2,99,341,76,5763,23
48615,18,355,714,305,19610,50
13100,8,671,1345,352,5851,319
22598,4172,139470,1192,87225,447169,52245
20675,15,931,1223,607,20133,324
33248,50,1424,984,941,11531,483
68597,370,7850,105,6663,50799,1187
19576,13,496,1242,389,16582,107
11752,24,1281,1361,637,26235,644
20920,311,9660,1218,6352,97146,3308
14850,10,441,1321,313,9835,128
19520,82,1679,1243,1356,15770,323
16947,4,148,1288,85,4033,63
17013,196,14237,1287,8963,69594,5274
11373,18,1153,1365,639,17552,514
67853,22,804,130,661,14715,143
33260,161,3544,984,2451,22443,1093
8468,107,3341,1382,2009,48165,1332
23726,142,2746,1172,2013,36506,733
68960,4,50,93,39,9160,11
27588,335,4952,1087,3278,37959,1674
49195,169,1945,696,1488,14079,457
52893,43,792,590,587,10723,205
28980,325,6421,1060,4078,59477,2343
63333,39,291,264,234,4276,57
57144,6,93,463,72,5557,21
16974,111,4538,1288,3187,28170,1351
52855,50,914,591,707,8583,207
58125,12,55,434,54,3509,1
52888,357,4840,590,3766,33773,1074
7826,303,8058,1386,4613,94292,3445
26313,1499,38214,1116,24474,313092,13740
46440,19,316,747,260,11249,56
36429,195,3401,910,2604,26483,797
27226,6,178,1096,118,4066,60
19241,25,910,1247,618,9791,292
49767,3,42,680,40,2558,2
53166,14,185,581,151,2930,34
25603,1277,22633,1132,14471,82886,8162
3918,84,5940,1436,3899,58293,2041
8624,343,5389,1381,3326,42808,2063
9714,37,790,1376,476,13841,314
25482,3,169,1134,134,10879,35
26628,200,3872,1108,2165,18333,1707
5470,7,104,1416,75,25432,29
16466,13,471,1296,361,24799,110
24400,10,179,1158,124,9048,55
35542,10,189,934,130,12727,59
11176,218,13257,1366,8671,62741,4586
59674,95,1201,382,1036,15777,165
22544,16,1108,1193,814,20703,294
10462,827,14254,1372,9357,71607,4897
8652,63,2353,1381,1653,24248,700
23231,1948,70916,1181,41516,500252,29400
52603,17,107,600,74,3963,33
54294,151,2949,548,2170,32149,779
62093,115,1631,298,1333,17193,298
29153,15,1168,1056,675,17218,493
4806,1278,26054,1424,17138,121465,8916
20036,145,4483,1233,2954,57495,1529
13308,10,462,1342,281,11026,181
16989,132,5742,1288,3519,28065,2223
36408,36,754,911,627,13214,127
5547,325,15024,1415,10281,45842,4743
52775,8,80,594,58,6353,22
30525,176,6275,1029,3563,23083,2712
4865,126,3293,1424,2350,69084,943
40990,411,5390,818,3980,49546,1410
26500,124,3241,1112,1931,18211,1310
41967,43,455,803,331,4641,124
51359,4,153,639,122,4254,31
38279,24,485,862,322,12574,163
59001,8,44,405,36,1995,8
60410,121,2287,357,1762,25050,525
67707,25,377,135,310,2977,67
61,43,1466,1471,942,26725,524
27674,10,210,1085,118,5892,92
60416,50,843,357,729,13205,114
50358,2,31,665,22,5228,9
64803,27,401,221,325,4649,76
44143,7,198,773,157,5036,41
27176,1,88,1097,50,3476,38
30757,25,654,1025,507,9711,147
61441,651,8194,319,6573,72746,1621
58072,21,170,436,144,9624,26
65532,92,845,201,742,12045,103
25009,28,1448,1144,959,24790,489
24757,43,860,1149,538,8898,322
12486,6,493,1353,272,30475,221
15768,216,4642,1308,3232,37112,1410
51085,2,34,647,24,4633,10
60309,70,830,344,642,8537,188
49041,169,3218,701,2612,17614,606
8243,1218,30048,1383,18054,77547,11994
48646,17,194,713,139,7538,55
54460,38,350,541,303,10666,47
10447,5,164,1372,110,7327,54
50470,153,1871,662,1590,25361,281
36456,19,324,910,251,9581,73
11316,307,7501,1365,5289,60193,2212
37385,361,8689,886,7294,136437,1395
58551,60,1253,419,975,14670,278
65535,26,581,201,508,8687,73
47467,26,349,734,288,7536,61
548,215,7399,1465,5315,47976,2084
46460,1696,25660,747,19632,184969,6028
50993,243,2797,649,2156,13414,641
14329,59,1441,1327,1028,24650,413
4679,1147,23447,1426,14747,97159,8700
14265,326,7077,1328,4608,44198,2469
13720,83,2406,1336,1560,17607,846
37980,38,843,870,741,38220,102
25936,3,181,1124,151,10245,30
15603,72,793,1310,524,9114,269
35388,7,115,937,85,6630,30
22746,4,208,1189,157,9725,51
9299,30,806,1379,563,13008,243
38484,277,3639,856,2998,31496,641
17376,6,76,1281,64,6419,12
51625,70,872,631,671,12997,201
24024,366,10547,1166,7302,80730,3245
14031,422,7641,1332,5109,126437,2532
40383,19,226,828,157,4641,69
14490,63,1822,1325,1534,52758,288
19211,0,184,1248,135,11849,49
57067,469,5062,464,4099,37592,963
22001,67,2078,1200,1354,27711,724
17036,866,53841,1287,38353,346997,15488
22011,9,414,1200,310,25379,104
38463,13,294,857,266,11996,28
49209,233,2811,695,2212,17710,599
10259,20,675,1373,461,9468,214
22482,56,735,1194,531,12399,204
64484,10,89,229,76,4424,13
35392,14,235,937,212,9982,23
134,972,54787,1470,35168,697014,19619
1744,146,4512,1456,3452,52173,1060
64893,8,135,218,114,6231,21
21457,833,34870,1208,23040,241984,11830
36289,95,2468,914,1937,26223,531
61237,1040,13069,323,10218,71428,2851
23142,32,1220,1182,914,47414,306
37129,1052,20386,893,15127,239017,5259
28038,1,284,1078,216,12741,68
18002,8,218,1269,139,5249,79
57703,1404,30017,443,20245,109938,9772
56903,7,143,469,99,3990,44
7692,544,11494,1388,7486,71624,4008
58883,0,755,409,530,11272,225
12402,272,15610,1354,7707,101626,7903
29550,199,4581,1050,3207,28201,1374
51491,30,233,636,165,8487,68
56590,28,346,477,263,7335,83
15373,1719,129904,1314,82865,470793,47039
64440,4209,79748,231,60466,353853,19282
37132,16,308,893,264,22990,44
54332,145,1869,547,1550,18434,319
13696,113,3188,1337,2055,22554,1133
53810,111,1426,565,1289,8130,137
39063,34,1103,846,792,9135,311
32707,65,2503,994,1416,17044,1087
11909,14,589,1360,303,7524,286
11139,3402,106447,1366,73126,492357,33321
30246,18,407,1035,232,6623,175
6218,111,4590,1407,3054,48334,1536
32046,38,1744,1005,1152,24585,592
29032,12,336,1059,200,8079,136
29869,54,1123,1043,773,25161,350
47288,4,38,736,29,4930,9
14722,23,672,1322,539,6857,133
3818,2,267,1437,205,21648,62
65952,718,37637,190,32164,70063,5473
4787,0,0,1425,0,24672,0
20960,1,109,1217,87,6708,22
22068,0,0,1200,0,5405,0
36139,106,1351,919,1135,19659,216
32001,26,593,1005,386,3064,207
49341,484,8450,691,6992,48170,1458
16390,24,1049,1297,731,32587,318
46152,71,897,751,722,23693,175
28697,398,9062,1065,6201,34135,2861
52978,17,355,587,325,9972,30
782,20,568,1463,389,6593,179
34677,42,675,955,458,9220,217
18665,620,32049,1258,19618,225533,12431
669,2038,104092,1464,67492,561614,36600
15096,339,6996,1318,5184,59971,1812
22893,53,2228,1186,1492,27896,736
16366,152,2508,1298,1796,30181,712
11886,132,6428,1360,3715,105063,2713
14784,0,0,1322,0,13342,0
29428,5,281,1052,164,6881,117
67078,101,1578,153,1297,10048,281
11526,2698,67455,1363,38950,241547,28505
13974,51,1670,1333,1046,33424,624
33812,363,4595,974,3417,43850,1178
66116,12,193,186,153,4677,40
3705,58,1577,1438,1102,24479,475
10473,94,2287,1372,1599,33338,688
59088,30,476,403,380,4866,96
39628,7,85,839,61,2496,24
23987,1355,35004,1167,24307,170418,10697
12075,3,173,1358,89,10557,84
56999,12,200,466,148,6735,52
22748,5,147,1189,89,6099,58
20727,67,1390,1222,868,21056,522
65416,191,5408,204,4406,36031,1002
23743,14,372,1172,281,14630,91
8318,94,3433,1383,2287,25109,1146
7401,9,467,1392,309,24564,158
7330,137,3672,1393,2725,21722,947
499,271,15175,1466,10649,95512,4526
10419,93,4758,1372,2974,34360,1784
13996,6,174,1332,119,10815,55
55302,46,1011,513,826,14395,185
27690,6,491,1085,301,16652,190
4388,783,24121,1430,16699,134566,7422
7245,1399,45341,1394,26330,253897,19011
49612,663,8893,685,6915,37341,1978
33078,154,5208,987,3783,50733,1425
46421,43,838,748,702,37374,136
6394,1016,56495,1405,36834,293491,19661
22481,89,2864,1194,2008,27732,856
13285,2,161,1343,112,6156,49
35674,22,355,931,251,8459,104
66218,14,224,182,186,7439,38
63220,35,555,267,399,10631,156
12161,541,12696,1357,8018,83034,4678
38238,462,5461,863,3543,35768,1918
37777,51,869,875,533,9559,336
67598,8,81,138,47,6722,34
68540,0,36,107,25,4782,11
49059,45,674,700,569,12012,105
47787,97,1686,729,1342,27650,344
49124,95,784,698,599,9740,185
11940,15,794,1359,474,24611,320
35009,53,1609,947,1169,13299,440
62848,198,2306,276,1836,14000,470
11106,92,2517,1367,1379,18292,1138
29085,3747,76111,1058,48897,509873,27214
63429,20,178,261,136,3108,42
49049,59,707,701,551,7008,156
11570,0,0,1363,0,9984,0
32748,31,882,993,598,8903,284
13097,25,847,1345,470,67039,377
24593,101,3496,1153,2396,56880,1100
4105,7,197,1434,140,11356,57
61625,801,15549,311,12133,123833,3416
47751,45,361,730,274,6460,87
40478,2062,22659,827,16421,131818,6238
61681,13,89,312,71,3292,18
7453,45,2535,1391,1473,40822,1062
6528,8,330,1403,237,28934,93
2980,30,731,1445,551,8666,180
28242,1,107,1074,65,6162,42
13443,137,5278,1340,2833,34924,2445
22831,2,282,1187,191,20170,91
34900,25,587,949,540,17115,47
136,899,35786,1470,23304,239598,12482
4692,231,10770,1426,6992,60550,3778
37701,27,464,877,326,5289,138
62949,1,145,274,108,3005,37
65162,102,1208,210,1011,13553,197
26478,13,221,1113,176,16525,45
54355,14,143,545,102,4216,41
20185,5470,153443,1231,94079,326035,59364
60784,104,1196,342,948,14847,248
40945,2,56,819,36,3588,20
17968,163,2081,1270,1401,19555,680
47949,40,685,728,544,11364,141
17637,8,270,1276,209,8258,61
12386,2,127,1355,79,7373,48
3202,2,76,1443,48,9931,28
58810,165,2569,411,1990,16208,579
67277,9,93,148,73,4129,20
4581,1267,43849,1428,29421,129622,14428
57588,23,229,451,179,5897,50
53808,29,356,565,304,11911,52
15582,89,1279,1310,810,14029,469
64556,6,140,228,112,2859,28
30339,2659,47015,1033,34319,189753,12696
40962,58,922,818,812,23054,110
55717,25,301,503,210,10484,91
16580,157,5310,1295,3384,24727,1926
50380,28,438,662,361,6849,77
32567,68,702,996,492,10885,210
20939,497,18644,1218,12324,80088,6320
57958,109,1013,440,742,10137,271
34625,2,131,956,94,9624,37
9857,919,38970,1375,27945,249550,11025
58466,233,2881,422,2478,26792,403
23962,945,32073,1168,20321,182794,11752
30005,11,250,1040,147,12367,103
21095,32,773,1215,521,12317,252
38469,24,633,857,515,25206,118
24127,0,20,1164,11,2515,9
29174,8,255,1056,176,10679,79
26529,3,206,1111,130,6156,76
65920,10,223,191,143,7201,80
43877,32,775,776,631,11006,144
17712,188,9473,1275,6394,54364,3079
42444,46,1857,796,1383,37300,474
6150,787,37699,1408,22916,234438,14783
30216,40,1839,1036,1248,15392,591
51233,74,867,642,627,15163,240
23999,146,3929,1167,2541,25198,1388
58066,44,524,434,441,16487,83
37421,2,107,885,87,4031,20
15498,6,154,1312,108,5849,46
51835,84,1512,626,1244,21259,268
65520,3,81,202,73,4388,8
34609,35,465,957,291,12775,174
22620,675,19035,1191,10928,105652,8107
60249,7,167,362,119,9590,48
27198,435,17695,1096,11872,103810,5823
48,639,42863,1471,24031,179876,18832
67994,16,199,126,163,6770,36
23271,11,290,1180,199,6067,91
61075,1960,42980,331,32763,190815,10217
4283,1677,42937,1432,24838,194155,18099
11907,184,5426,1360,3069,18531,2357
3433,82,2420,1441,1774,22955,646
3618,9,233,1439,189,10647,44
32274,25,1062,1002,720,20538,342
33541,6,243,979,152,4749,91
14690,21,804,1323,548,14538,256
55524,1291,20971,508,17649,89758,3322
62062,30,572,299,346,11074,226
59105,40,305,402,236,10906,69
29055,55,5501,1059,3678,36058,1823
46785,166,1049,742,815,10721,234
52364,396,4722,577,4060,30460,662
34882,70,442,950,329,12938,113
49732,215,4484,680,3770,32597,714
20118,501,9467,1232,6383,56207,3084
36076,6,60,921,47,4075,13
62562,38,365,284,292,9096,73
30515,16,545,1030,387,9829,158
1112,16,550,1461,405,42367,145
46845,27,263,741,226,6720,37
37077,9,100,895,83,4351,17
62950,20,317,274,223,4351,94
8891,7,268,1380,189,10051,79
57745,169,2900,447,2123,22724,777
10990,81,3019,1368,1816,36839,1203
24422,266,5401,1157,3282,34200,2119
60901,1740,25820,337,21174,94056,4646
51617,959,11972,631,9810,67259,2162
60826,17,163,339,136,6287,27
17225,14,394,1284,301,16446,93
9869,11,570,1375,342,9167,228
58324,37,358,427,262,11028,96
25623,10,305,1131,223,15285,82
2953,200,6965,1446,5022,30189,1943
47423,41,1392,734,1011,29291,381
47212,114,2810,737,2258,23233,552
34893,16,463,949,341,6007,122
2006,2540,62590,1454,41001,233824,21589
6925,28,1448,1398,1073,28969,375
40129,798,21042,832,15625,70405,5417
60269,41,562,362,452,10109,110
52781,13,350,594,252,25064,98
16317,9,246,1299,149,16240,97
40409,7,157,828,141,6935,16
66515,9,107,174,102,6915,5
35120,130,1597,944,1235,42723,362
39271,126,1580,844,1211,18435,369
68324,31,326,115,256,9501,70
16701,8,747,1293,522,19511,225
42708,101,763,791,618,12494,145
48553,10,124,715,96,3247,28
37318,4,38,888,33,2807,5
16914,26,505,1289,371,13081,134
1529,19,541,1458,385,17168,156
18571,30,408,1259,310,16733,98
50810,16,261,654,199,5615,62
50161,49,731,670,604,21309,127
54260,0,629,549,304,5164,325
11771,39,1704,1361,697,16511,1007
37903,99,3640,873,2887,31163,753
28256,8,121,1074,84,6815,37
64474,38,534,230,442,3952,92
12617,17,1266,1352,678,41028,588
7768,26,627,1387,375,7455,252
60513,32,366,352,260,11057,106
66503,120,2011,174,1742,16841,269
19678,71,3809,1240,2754,32235,1055
46399,46,887,748,659,15465,228
9145,11,903,1379,550,17425,353
62020,76,1114,300,954,16402,160
17516,1128,33569,1278,21746,153138,11823
16097,486,13553,1302,8553,104186,5000
17632,161,4621,1276,3211,33095,1410
12090,30,857,1358,431,6541,426
43789,14,394,777,313,7920,81
34967,34,613,948,404,10893,209
67431,11,104,144,79,3698,25
66937,48,728,159,525,10753,203
36045,45,748,921,656,12897,92
9530,14,645,1377,400,8483,245
50973,18,279,650,215,6542,64
44434,101,785,769,620,14039,165
16609,12,340,1294,214,5733,126
39413,47,1082,842,799,12844,283
1676,12,680,1456,539,16421,141
296,3297,175831,1467,115826,377164,60005
30298,36,1286,1034,788,31372,498
9421,4075,251833,1378,149056,661403,102777
42664,88,1282,792,960,31116,322
59681,2,49,382,38,5409,11
60438,923,12755,356,9576,51420,3179
9862,172,7585,1375,4357,53125,3228
21322,64,1515,1211,1053,9172,462
31008,160,3234,1021,2135,29388,1099
28947,1,51,1061,38,3245,13
63605,35,540,257,451,12983,89
49966,28,506,675,410,6446,96
23224,8,348,1181,255,9471,93
23927,136,2704,1168,2004,19364,700
23977,398,15000,1167,10590,142748,4410
50485,15,238,662,181,4294,57
22706,1155,43223,1190,31843,202716,11380
58547,71,801,420,546,9423,255
46769,168,2212,742,1831,41834,381
44959,160,2142,763,1782,39679,360
66576,2,29,171,18,1619,11
30598,52,1741,1028,1222,21252,519
5519,455,15167,1415,9427,44865,5740
17481,11,122,1279,95,6760,27
32246,2796,113766,1002,79799,350397,33967
10344,23,788,1372,505,14429,283
59412,394,4751,388,3576,24483,1175
58057,3142,41319,436,32949,119066,8370
57053,24,176,465,143,4345,33
50351,8,161,666,122,2387,39
36879,284,5876,901,4787,29669,1089
6951,450,13213,1398,9102,167473,4111
17893,1077,26425,1271,20269,147869,6156
17589,8,206,1277,137,9014,69
7795,5,230,1387,146,10207,84
66511,74,984,174,762,8132,222
24632,33,1286,1152,843,18919,443
13803,129,5425,1335,3554,28347,1871
40842,50,683,821,562,13801,121
380,32,1332,1466,931,35863,401
66927,6,70,160,55,3387,15
16870,1145,43051,1290,27972,397427,15079
27563,81807,2007981,1088,1349256,4753676,658725
64365,2,109,233,60,2351,49
9138,42,2089,1379,1100,13392,989
64097,417,8359,241,6643,52111,1716
39296,15,155,844,111,3893,44
25327,786,21197,1137,12695,95193,8502
36872,49,502,901,395,7821,107
15068,25,981,1318,694,40106,287
35062,2,75,944,47,2618,28
57782,66,980,445,690,15243,290
4861,70,1003,1424,660,25215,343
52806,80,1409,593,1056,17828,353
61896,54,1110,305,752,18842,358
50188,328,6316,670,5531,62279,785
2241,144,8736,1452,5448,50832,3288
59277,927,16585,396,13388,72024,3197
67002,76,800,157,623,6973,177
19075,45,1967,1250,1386,41807,581
20366,286,11574,1228,7673,82472,3901
15675,433,10259,1309,7298,85631,2961
39361,54,459,843,345,6281,114
1833,5,213,1455,157,14182,56
39263,34,384,844,302,14664,82
18102,14,492,1267,358,8348,134
21149,7,184,1214,147,10606,37
8413,15,794,1382,532,19311,262
12663,29,1210,1351,697,37815,513
13722,66988,2780692,1336,1590485,4473984,1190207
13969,692,23680,1333,15466,94017,8214
23920,443,6785,1168,4738,86810,2047
7407,2,51,1392,43,3241,8
9327,22,879,1378,569,9842,310
33600,205,4415,977,2951,42970,1464
58835,2,28,411,21,4678,7
63319,10,103,264,90,5340,13
65187,48,636,209,500,11421,136
339,206,8396,1467,5701,64083,2695
58088,50,1377,435,1078,22423,299
58209,84,1593,431,994,28549,599
27783,6632,215399,1084,120431,489219,94968
14408,86,2080,1326,1619,23949,461
23139,22,612,1182,415,13677,197
47579,13,150,732,116,5297,34
63688,16,258,254,175,5853,83
25904,17,477,1125,310,12312,167
6950,3626,112657,1398,69256,204443,43401
29134,151,3565,1057,2295,25562,1270
23867,542,9200,1169,5389,69644,3811
9688,310,8433,1376,5066,31068,3367
26999,24,1060,1100,874,18052,186
7458,95,9928,1391,6555,73479,3373
8232,459,49756,1383,29459,264659,20297
68067,66,1292,123,948,8724,344
2284,49,1705,1452,1221,11273,484
24531,179,5685,1155,3904,34334,1781
12540,7,464,1353,222,15256,242
25299,18,657,1138,430,13728,227
30192,198,4372,1036,3776,50847,596
3837,25,2120,1437,1537,33523,583
24781,28,440,1149,342,16385,98
28160,43,590,1076,414,7710,176
28458,1,134,1070,49,8943,85
12719,15,765,1350,435,6413,330
27462,226,7818,1091,4551,70256,3267
49469,28,299,688,242,10104,57
27553,10,301,1088,200,10676,101
34535,2929,57293,959,43082,158486,14211
25552,423,14090,1133,9394,141138,4696
24425,46,1888,1157,1243,22451,645
15339,3285,87199,1314,59365,402196,27834
49538,68,1516,686,1327,13048,189
37516,477,10921,882,7075,47706,3846
45362,225,3118,759,2437,27175,681
22195,6,335,1198,166,6497,169
1997,202,10843,1454,6452,133049,4391
6525,15,331,1403,259,22200,72
34797,13,196,952,138,3407,58
67209,12,163,150,131,3486,32
23849,26,1339,1170,915,18239,424
51966,18,270,622,223,7113,47
30758,75,2726,1025,1252,29791,1474
3779,18,1055,1437,699,13029,356
51026,46,681,648,591,36629,90
53059,797,13667,585,10231,33384,3436
66489,19,261,175,223,4137,38
60650,23,473,347,396,8931,77
28863,7,129,1063,94,6060,35
58720,54,638,414,490,13468,148
53887,138,1994,561,1642,12857,352
30660,106,1911,1027,1280,21981,631
1065,11,460,1461,324,7057,136
2945,22,1838,1446,1363,65233,475
45288,37,659,760,502,12235,157
66263,163,2916,181,2515,8180,401
746,12790,287583,1463,169359,521013,118224
1957,502,9451,1454,7084,40183,2367
13718,56,1522,1336,955,27254,567
58084,1748,28047,436,22208,123019,5839
4492,339,6262,1429,4323,58887,1939
13017,160,4415,1346,2520,43913,1895
63705,8,85,254,54,2328,31
35042,29,400,946,296,11704,104
6836,31,1159,1400,818,29678,341
12087,102,5647,1358,3990,38846,1657
6787,82,3011,1400,1983,58330,1028
66880,50,634,161,517,9995,117
5493,480,6574,1416,4719,32016,1855
29195,9,299,1056,183,6207,116
31664,22,554,1011,359,6434,195
43637,46,470,778,360,13314,110
68479,26,374,109,331,4150,43
66908,54,663,160,445,8961,218
61065,96,707,332,515,5480,192
15293,3,68,1315,42,2809,26
49266,338,4519,694,3999,62127,520
17807,10,500,1273,388,17513,112
2146,17829,1141720,1453,697207,2832041,444513
13674,57,2237,1337,1372,29065,865
3250,53,1731,1443,1218,31859,513
61818,3789,80791,307,64752,291672,16039
54162,55,400,552,318,11576,82
51790,12,564,627,381,6252,183
2167,7,321,1453,226,10312,95
30369,6,124,1033,100,3921,24
48313,106,1291,723,1107,31537,184
62794,174,3049,278,2536,39778,513
51678,232,3300,630,2666,33401,634
59846,17,296,377,264,7956,32
55920,1002,16621,497,12397,72219,4224
9860,3,203,1375,115,4111,88
59358,37,506,393,401,8434,105
46284,293,4844,749,3770,89216,1074
40497,456,5397,827,4262,63654,1135
12801,13431,379081,1349,206557,1332704,172524
37072,2,48,895,38,2898,10
54901,41,635,525,489,13530,146
27206,58,1456,1096,933,18593,523
67040,725,15764,156,13131,100737,2633
5398,1725,23990,1417,14907,115542,9083
49239,39,659,692,507,7788,152
23166,239,4843,1182,3618,71867,1225
28333,370,7311,1072,4967,63057,2344
54112,0,24,554,17,2508,7
6539,553,10804,1403,7351,65222,3453
30671,16,477,1027,305,5822,172
49026,20,456,701,373,7197,83
16100,6,302,1302,201,24393,101
48755,203,4370,710,2864,21917,1506
25139,505,10832,1141,6749,33052,4083
36489,26,330,908,280,8368,50
9248,10,401,1379,270,7010,131
4310,15,379,1431,239,4231,140
37023,5,38,896,29,3261,9
41670,5,130,808,87,12615,43
56461,7,129,481,90,4420,39
32394,2296,45852,1000,31694,146399,14158
1916,980,24046,1455,15588,98168,8458
2010,39,838,1454,605,21403,233
18740,220,8403,1256,5495,29747,2908
34813,68,1943,951,1474,25394,469
1976,2,136,1454,95,21484,41
4014,442,8863,1435,5606,69759,3257
17043,12,403,1287,319,10645,84
24188,26,1081,1162,727,14930,354
45273,318,3449,760,2633,49672,816
21863,3,378,1202,173,4364,205
34342,237,8755,962,6049,67993,2706
8541,13,789,1382,525,13009,264
18230,134,3716,1265,2580,41531,1136
61663,26,189,312,171,4092,18
60267,20,249,362,160,6203,89
39208,3215,67524,843,53904,257832,13620
37934,199,5423,871,3448,35778,1975
23681,6009,232720,1173,152733,599147,79987
18200,18,400,1266,308,6765,92
65056,169,2358,211,1868,10908,490
21364,135,3162,1210,1990,23863,1172
67324,50,472,147,376,8324,96
29316,971,21422,1054,14409,90386,7013
20848,36,541,1220,399,9540,142
56466,127,1113,481,933,10403,180
67979,25,325,126,247,3624,78
54220,24,340,550,299,4538,41
12718,166,4817,1350,2692,48555,2125
37779,218,3507,875,2912,43458,595
56114,8,193,491,124,14921,69
29132,14,515,1057,311,5163,204
28589,7,313,1068,193,4991,120
32950,40,615,990,392,8576,223
30109,438,14928,1038,10074,87217,4854
52751,10,170,595,129,7618,41
65160,4,55,210,39,3965,16
68685,10,176,102,155,4684,21
64518,154,2971,229,2356,26662,615
56757,6,104,473,79,4864,25
27355,8,252,1093,158,9297,94
54559,192,2086,538,1785,27369,301
44916,2362,36855,764,28680,108466,8175
12864,1271,68995,1348,38672,253319,30323
60877,12,120,339,102,3393,18
11717,22,1750,1362,976,29017,774
64058,18,328,243,240,5451,88
65956,8,179,190,130,8900,49
801,638,26346,1463,15856,112922,10490
28831,20,520,1063,303,7584,217
32352,16,667,1001,381,7251,286
57552,23,421,453,329,12655,92
3622,82,2539,1439,1756,62934,783
48747,122,2708,710,2006,23356,702
24214,519,17895,1162,12617,128973,5278
65444,23,440,203,375,13116,65
34441,10,211,960,132,4665,79
49473,7,297,688,204,16546,93
35053,167,2606,946,2105,24755,501
15982,139,3999,1304,2595,71247,1404
35897,12,344,924,273,6829,71
62005,19,139,301,73,2299,66
22125,178,5276,1199,3677,35911,1599
17573,28,733,1277,605,20587,128
66225,10,147,182,107,5037,40
21493,17,535,1207,402,11144,133
34847,39,342,951,258,9531,84
22268,47,884,1197,667,23093,217
12274,175,7985,1356,4643,60095,3342
17887,47,840,1271,661,15217,179
27402,41,1181,1092,819,17678,362
60800,111,1536,342,1201,14741,335
5108,21,425,1420,291,10269,134
17870,339,11922,1271,7616,55641,4306
3974,4,159,1435,111,13790,48
54529,86,828,539,687,25258,141
28764,1,76,1065,39,3335,37
13259,27,981,1343,459,13439,522
14934,400,29759,1320,12988,124757,16771
66562,18,256,172,200,3787,56
34539,5239,155330,959,101547,490285,53783
11643,555,16054,1362,10355,104711,5699
35475,35,952,935,733,16524,219
26589,143,2946,1110,2086,39846,860
31204,702,11228,1017,8750,82403,2478
21820,2,97,1203,57,13960,40
5472,62,1609,1416,996,27100,613
67561,493,9460,139,7443,64854,2017
24964,15,509,1145,344,6678,165
66048,22,446,188,388,5279,58
32823,72,2090,992,1393,19844,697
65821,85,1391,194,1150,12261,241
37022,3972,94540,896,69473,292339,25067
50412,39,345,664,303,8711,42
56347,118,1141,484,911,12718,230
16445,33,837,1297,542,11317,295
56593,15,182,477,137,10317,45
20964,11,310,1217,217,11128,93
8184,13,832,1383,600,27396,232
29476,12428,221043,1051,123436,848704,97607
59736,18,650,380,497,7259,153
13131,18,1053,1344,535,14848,518
29115,25,882,1058,568,7711,314
65900,103,1748,192,1497,34956,251
7246,9,246,1394,143,10615,103
9936,2293,188790,1375,107990,595310,80800
20496,1145,25159,1226,16272,118696,8887
25256,839,37034,1139,25518,77334,11516
31097,101,3056,1019,2057,25811,999
21515,14,1447,1207,948,17109,499
46320,798,24081,748,18719,129801,5362
61644,25,305,313,239,5205,66
6443,25,943,1405,582,20471,361
29655,68,1302,1048,867,15578,435
7301,17,566,1393,362,15969,204
25962,76,1636,1124,1239,30505,397
20598,14,463,1224,304,5633,159
35691,183,4672,931,3183,61331,1489
19399,89,2590,1245,1847,74192,743
20107,184,3566,1232,2387,58899,1179
63041,214,2108,272,1849,31793,259
17464,70,2199,1280,1142,15120,1057
12000,27,678,1359,377,8186,301
52949,195,3873,588,3159,22722,714
42238,151,2137,799,1810,21219,327
22413,19,761,1195,561,16229,200
67689,17,291,135,204,5223,87
976,46,2571,1462,1714,54341,857
49905,577,7993,667,6155,49496,1838
9584,86,2740,1377,1794,43132,946
66721,2,27,167,24,1939,3
28505,52,1673,1069,921,38100,752
6670,16,294,1401,201,6526,93
37917,142,3001,872,2289,30542,712
17693,19,680,1275,451,7761,229
61140,6753,117949,329,89083,527207,28866
15838,4,211,1307,141,9475,70
46815,62,976,742,767,7870,209
27954,91,863,1079,552,6159,311
9633,22,1271,1377,864,20262,407
505,10,253,1466,188,24369,65
62588,35,590,283,404,11790,186
27935,33,1062,1080,760,13967,302
39821,2467,96500,837,72201,436566,24299
37257,175,1867,889,1444,21464,423
38282,53,735,862,592,19566,143
36364,1,56,912,47,4604,9
3630,13,436,1439,314,19610,122
56426,2,38,483,34,1555,4
62749,7,79,279,58,1559,21
52441,3,72,606,50,5791,22
28377,2208,37287,1072,26370,124044,10917
21523,6,314,1207,222,16202,92
26012,5,642,1122,373,13707,269
27740,4,153,1084,80,4653,73
30577,6,78,1029,54,4855,24
22734,35,669,1189,497,15347,172
6842,145,5171,1399,3517,34026,1654
33970,29,1027,971,632,10574,395
56171,32,367,490,284,5899,83
23982,180,5621,1167,3639,26249,1982
4860,816,20309,1424,12431,113154,7878
55590,654,7559,503,6107,50056,1452
47811,53,751,729,576,7491,175
37561,55,974,881,774,22254,200
15801,622,19212,1307,11308,87470,7904
9215,493,9986,1379,6622,38480,3364
59541,2257,49439,387,37217,253738,12222
68296,2,33,116,25,1961,8
35502,34,588,935,445,10203,143
50340,128,2748,666,2114,32840,634
20606,65,1447,1224,1040,19060,407
15764,21,966,1308,697,30509,269
22173,121,4919,1198,3190,52313,1729
11371,3276,59500,1365,36801,291801,22699
29028,32,487,1059,414,22986,73
21721,203,3206,1204,1985,40122,1221
19662,36,893,1240,622,12511,271
13279,338,8018,1343,5301,53100,2717
689,7287,285847,1464,180966,797776,104881
66747,31,337,166,286,3851,51
67661,26,432,134,306,10448,126
4698,70,1969,1426,1485,33018,484
16043,233,4294,1303,3451,87632,843
57803,14,124,445,93,3256,31
38315,41,414,862,321,5380,93
28629,114,3531,1067,2357,16842,1174
55832,5,55,500,48,4611,7
4721,52,1370,1426,1041,23814,329
32836,50,1136,992,802,36432,334
63493,15,264,260,234,6493,30
56802,5,34,471,29,8932,5
60910,3337,46373,330,36810,234534,9563
37952,24,227,871,149,9358,78
39997,216,4480,816,3538,33139,942
35211,0,32,941,26,2571,6
61509,102,1254,317,959,6712,295
38522,2110,29250,855,23297,87371,5953
23251,27,539,1180,356,11185,183
39837,13,302,837,246,9768,56
18671,33,714,1258,523,11909,191
52971,111,2963,588,2370,28717,593
54913,31,214,525,201,6075,13
24364,4973,132741,1158,95734,399268,37007
52860,40,418,591,286,7668,132
25137,346,14474,1141,10590,60550,3884
52869,13,113,590,78,5393,35
32252,128,2816,1002,2036,28566,780
46485,5,98,746,78,6299,20
29511,19,733,1050,438,14279,295
29169,233,10444,1056,7221,48787,3223
9455,251,6159,1378,4184,20650,1975
28365,47,528,1072,473,6466,55
42576,9,303,794,205,10745,98
49421,1298,25086,560,18274,88739,6812
3868,197,4989,1436,3680,29563,1309
56044,29,281,494,231,4079,50
21659,1863,40208,1205,26893,130773,13315
25371,86,3132,1136,2063,19693,1069
17152,5,202,1285,145,6056,57
27093,144,2013,1098,1372,27478,641
5095,1,202,1421,181,14962,21
68429,16,235,112,182,8912,53
49113,235,4603,699,2426,103760,2177
23539,27,460,1176,346,18981,114
4475,26,653,1429,507,10708,146
53562,20,352,572,245,11353,107
31237,73,1629,1017,1186,15946,443
64021,1709,25795,244,20210,101265,5585
53758,43,732,566,555,6821,177
11442,107,7342,1364,3912,36072,3430
54846,82,597,527,461,10960,136
33521,1131,18907,979,13367,89536,5540
32211,182,3579,1002,2218,22421,1361
25638,10,472,1131,338,28490,134
57988,166,2337,439,1737,56543,600
12156,39,767,1357,486,10641,281
17730,0,1238,1274,982,21699,256
8753,102,4139,1381,2502,22675,1637
48827,262,3755,707,3012,40490,743
28876,82,1712,1062,1028,10362,684
317,102,4549,1467,3208,32214,1341
32292,51,1217,1001,732,7973,485
1329,5135,207093,1459,132495,1024239,74598
23145,61,1177,1182,993,19841,184
11974,30,1621,1359,931,15018,690
11369,205,4129,1365,2028,33094,2101
16109,11,458,1302,314,10358,144
40474,62,1323,827,1068,54735,255
64879,100,1082,218,684,11266,398
26409,46,816,1114,681,15662,135
66022,85,836,189,691,10642,145
9347,4,194,1378,117,7737,77
45470,20,868,756,662,9676,206
49997,75,830,674,581,10636,249
27735,2,56,1085,41,13146,15
27125,1245,25424,1098,17138,163628,8286
22834,2,96,1187,75,35198,21
33397,67,749,981,510,18472,239
26704,4108,64167,1107,41315,266657,22852
50107,104,1179,671,897,23061,282
17115,14,937,1286,637,19817,300
38330,132,2944,859,2345,16618,599
44501,11,197,769,150,7278,47
50056,17,167,673,143,2642,24
56390,244,4426,480,3772,35405,654
30726,936,18634,1026,14143,69304,4491
20581,474,12754,1224,8874,109650,3880
5679,83,2245,1414,1489,22261,756
1691,1,116,1456,66,14766,50
15605,14,859,1310,548,19241,311
23618,4,110,1174,87,3955,23
68453,337,6417,111,5294,55136,1123
24603,300,7849,1153,4822,44865,3027
9816,1,55,1376,48,8631,7
54830,8,85,528,63,5636,22
64285,39,592,235,458,8716,134
46843,13,113,742,84,5033,29
56154,28,342,490,283,5274,59
19892,670,47336,1236,30768,155423,16568
65777,807,17183,195,14164,100106,3019
50989,11,225,649,173,7998,52
28463,166,15835,1070,9320,53276,6515
37216,22747,464363,891,364553,2513780,99810
30707,33,816,1026,559,7707,257
26233,66,1290,1118,808,17590,482
18035,13,549,1268,429,11124,120
8265,18,481,1383,320,8930,161
68430,2,76,112,32,6351,44
27488,43,1823,1090,1238,22863,585
33211,87,2745,985,1965,52302,780
33530,199,2977,979,1869,21741,1108
53381,71,1235,576,1005,11515,230
15778,37,1130,1308,824,17735,306
3804,172,4145,1437,2784,61342,1361
61863,8,136,306,109,6793,27
18798,55,2136,1255,1379,10870,757
22928,56,1019,1186,829,25096,190
25817,173,4186,1127,2534,26185,1652
5447,10,1060,1416,718,15698,342
62672,184,2757,280,2208,19550,549
555,67,2904,1465,1946,22226,958
9263,283,8691,1379,5633,31944,3058
7897,9202,913300,1385,432282,2018492,481018
52083,220,3159,618,2557,26881,602
5718,25,413,1413,298,9851,115
19210,0,152,1248,107,5058,45
38926,1,80,848,54,4571,26
36486,117,1233,908,993,18832,240
68852,13,154,94,125,4164,29
48743,19,549,710,502,28589,47
30083,246,12753,1038,8352,94002,4401
42754,612,6409,790,4550,77173,1859
4262,35,1437,1432,987,26024,450
5734,55,1582,1413,1053,13720,529
34062,60,1666,968,970,13171,696
50044,72,827,673,646,7348,181
17953,18,773,1270,611,11123,162
12823,50,1891,1349,884,17493,1007
53235,16,450,580,348,21783,102
4351,726,21567,1431,14403,64675,7164
26864,159,3500,1103,2424,24530,1076
52352,3230,45294,609,35036,222291,10258
17340,14,292,1282,217,19359,75
3819,400,6347,1437,4539,29503,1808
28882,12,218,1062,166,7682,52
16463,1136,18743,1296,12017,65081,6726
33473,1522,26545,980,19836,150232,6709
35353,4,239,938,168,8845,71
48740,56,765,710,624,9525,141
32480,36,1465,998,973,22575,492
37160,9,128,892,112,8870,16
39385,52,438,842,365,9508,73
53225,154,2681,580,1807,34966,874
964,42,2997,1462,2109,64933,888
67152,4,29,152,24,1624,5
3424,1117,77932,1441,44388,199165,33544
3431,55,1447,1441,980,17752,467
34375,111,3094,962,2402,32100,692
38176,27,681,865,489,5538,192
35609,1384,21317,932,15565,65017,5752
49954,1,98,676,66,8137,32
60742,169,3299,344,2317,17863,982
28850,1794,39083,1063,27523,143283,11560
12696,17,1180,1351,613,14921,567
31625,8,187,1011,121,9991,66
33138,12,370,986,258,7290,112
46932,608,4135,740,3435,31666,700
12132,40,1369,1358,668,14937,701
23913,2505,53606,1169,33374,267426,20232
7873,37,1588,1385,1080,20615,508
23838,16,302,1170,210,9612,92
49403,8,101,690,67,4503,34
20100,232,4759,1232,3015,21893,1744
35152,13,378,943,241,20297,137
63034,26,401,271,270,4618,131
1840,35342,1019231,1455,739485,2621236,279746
24768,25,550,1149,366,9047,184
34640,35,510,956,370,5853,140
49986,10,99,675,70,3764,29
3173,17,724,1444,508,21834,216
44457,101,979,769,686,13342,293
20804,4,104,1220,72,10178,32
38376,410,10524,860,7733,83678,2791
21200,49,1576,1213,1196,23288,380
8207,1735,66652,1383,37082,162525,29570
36036,2747,46128,922,35856,295135,10272
19266,98,1662,1247,1321,13688,341
14139,153,4083,1330,2829,22985,1254
67338,29,567,146,422,5040,145
1993,37,960,1454,717,13660,243
20346,5,207,1228,151,12523,56
10811,603,21177,1369,13712,124968,7465
23130,190,5458,1182,4056,59726,1402
18793,8,109,1255,92,8469,17
12553,7221,293843,1352,138250,949242,155593
9507,5,199,1377,121,14534,78
34245,92,1223,965,817,8946,406
17834,55,1852,1272,1328,14041,524
36770,101,1088,903,877,15944,211
31278,290,6110,1016,4581,44149,1529
65569,99,916,200,659,4374,257
62066,20,318,299,295,13949,23
38492,40,483,856,363,3755,120
51025,80,1194,640,945,19239,249
34313,90,1196,964,815,16916,381
19256,53,1725,1247,1089,29360,636
27828,14,425,1082,215,9729,210
57055,7,107,465,92,10941,15
51878,13,231,624,198,5407,33
61781,47,1055,308,766,11454,289
836,28940,1250708,1463,718811,2535798,531897
61048,210,2047,333,1725,14293,322
40226,58,1133,831,922,18276,211
53042,116,1035,585,876,14257,159
17930,457,8250,1270,5563,57337,2687
26264,49,1280,1117,836,9847,444
56666,0,133,476,86,6168,47
9727,15,671,1376,421,9242,250
29186,53,1122,1056,684,10389,438
9275,63,3273,1379,2025,31814,1248
13414,82,3524,1341,2115,44604,1409
12049,32,1012,1358,555,5667,457
14713,1871,65995,1322,40638,187376,25357
7747,10,595,1387,379,30178,216
34123,7,194,967,138,2462,56
20952,11,549,1217,376,5350,173
28497,16,465,1069,279,4624,186
33647,401,7523,976,5290,60309,2233
64980,630,6853,214,5455,21057,1398
41618,37,592,809,484,15032,108
14884,27335,620522,1321,329610,1574081,290912
18871,16,504,1254,393,14851,111
61913,15,511,303,330,12498,181
7284,5,257,1393,155,31739,102
53177,30,661,581,540,10362,121
55218,13,358,516,215,12049,143
36172,34,711,918,625,31487,86
60872,9,50,339,48,3548,2
43207,138,1958,783,1462,18097,496
21062,720,15259,1215,10360,57397,4899
66181,1,18,183,13,1903,5
50441,2946,40168,663,31659,128293,8509
23837,4,120,1170,91,6331,29
23782,13,91,1171,75,5012,16
53505,76,1269,574,1096,19916,173
28349,4,189,1072,119,5817,70
49653,2,57,683,39,5697,18
33075,160,2660,987,1704,17517,956
3474,43,1030,1441,737,41274,293
12734,25,1369,1350,783,12104,586
63420,4,52,262,42,4145,10
10442,1904,56587,1372,34536,289103,22051
25984,30,787,1123,498,18510,289
12438,108,1775,1354,1012,17630,763
17382,24,1235,1281,845,12788,390
23269,94,2267,1180,1559,22786,708
14390,24,644,1326,472,10280,172
17890,15,465,1271,376,13566,89
11484,37,1741,1364,1117,19629,624
48729,28,361,711,283,11036,78
66321,11,117,180,82,3762,35
20176,1,94,1231,71,2343,23
15207,0,0,1316,0,28378,0
35639,36,689,932,503,7739,186
39843,164,3089,837,2623,48322,466
29238,145,3697,1055,2517,31023,1180
30092,154,2414,1038,1642,19616,772
3586,13,462,1440,331,19033,131
66178,210,5958,183,5253,28007,705
1309,44,1473,1459,1060,24851,413
40632,129,1909,825,1526,22752,383
50149,13,288,671,263,19082,25
53082,2,54,584,46,4551,8
56540,77,1466,479,1123,24031,343
19790,9,332,1238,229,7519,103
65646,47,414,198,336,9704,78
65533,48,402,201,319,6330,83
57523,139,1412,453,1116,29252,296
5683,11,602,1414,380,15900,222
42855,89,1443,742,1139,14956,304
68281,9,108,117,76,5074,32
44014,1853,38545,774,28750,166470,9795
33295,73,1553,983,1133,16475,420
1920,151,6556,1455,4462,141860,2094
8677,103,3474,1381,1831,22207,1643
26192,81,1660,1119,1479,22954,181
1816,56,3885,1455,2621,84576,1264
18207,59,1217,1266,953,22295,264
47221,26,311,588,242,8203,69
37304,137,3709,888,3280,34082,429
10828,158,6493,1369,3963,32081,2530
57621,182,2534,450,1921,29399,613
59490,118,1554,389,1364,21570,190
14815,225,4439,1321,3390,30833,1049
32759,105,2277,993,1309,13250,968
66930,154,4453,160,3462,28836,991
65981,142,3040,190,2372,8505,668
50966,234,2629,650,2159,26123,470
42792,125,1164,789,897,11135,267
15964,60,1347,1304,907,21426,440
34311,49,770,963,581,6517,189
15775,15772,358280,1308,219163,1504776,139117
3659,19,424,1439,302,11181,122
9375,2315,64136,1378,40675,243856,23461
29585,6,288,1049,200,9549,88
29614,27,837,1049,554,12853,283
7115,32,1229,1396,811,34058,418
20564,1079,30419,1225,20802,131880,9617
49423,106,1063,689,869,7611,194
4469,38,1277,1429,830,19541,447
16506,3906,141060,1296,85551,318749,55509
59703,55,1014,381,745,12179,269
27604,134,3512,1087,2308,26630,1204
60847,8,137,340,102,2614,35
5689,4,309,1414,208,25489,101
32601,12,723,996,474,34960,249
66701,7,81,168,63,4375,18
17330,22,1014,1282,697,20081,317
56206,76,935,489,737,10296,198
16967,5,247,1288,200,7320,47
68104,39,598,122,475,7543,123
35322,150,2488,939,1975,37637,513
2576,76,3765,1449,2494,117855,1271
60531,20,321,351,235,9301,86
762,399,27844,1463,18079,238675,9765
21885,1,112,1202,77,5071,35
9399,71,3342,1378,2060,38322,1282
58576,68,1191,419,986,16684,205
47553,8,212,732,186,9829,26
4124,759,16039,1434,11189,100145,4850
60402,58,551,357,454,9205,97
37512,181,5862,882,3864,36806,1998
60529,42,377,352,339,7155,38
58987,18,255,406,208,6417,47
30905,662,11254,1022,6845,48058,4409
50625,229,5197,659,3691,56315,1506
59880,13,159,375,120,3463,39
25272,0,81,1138,56,6606,25
16226,3,619,1300,418,14669,201
1915,10,366,1455,272,17067,94
29015,9,354,1059,203,5269,151
22602,1140,28624,1192,19617,198937,9007
22681,34,1009,1190,733,24140,276
18919,1513,26563,1253,18268,132719,8295
20184,40,1505,1231,912,22348,593
49464,21,234,689,181,5328,53
15390,318,7998,1314,5529,107550,2469
3887,3,204,1436,129,13842,75
33445,38,887,980,554,12622,333
67566,46,1042,139,851,10480,191
33114,23,307,987,197,5061,110
62804,4,22,277,18,2249,4
53561,63,839,572,600,7034,239
33121,2650,86074,987,62689,411473,23385
49523,398,3658,687,2686,33466,972
48465,149,2145,720,1543,14809,602
49855,15,264,678,230,12126,34
41905,20,297,804,186,4802,111
41633,79,1527,808,1268,32370,259
66713,2,57,167,40,3917,17
14281,168,9354,1328,6045,100249,3309
56445,47,707,482,586,16116,121
27326,56,887,1094,637,15600,250
46773,193,5372,742,4633,74696,739
8841,169,6753,1380,4422,52657,2331
58917,66,1012,408,722,17383,290
25457,58,704,1135,578,12759,126
4050,539,16482,1435,11802,130197,4680
28045,12,409,1078,319,6805,90
19957,8,159,1235,136,19017,23
37844,47,511,874,379,6665,132
12244,68,2214,1356,1126,62845,1088
15366,393,14550,1314,8556,69562,5994
14746,6,95,1322,58,4911,37
56858,31,417,470,322,6012,95
51159,55,470,644,342,4367,128
6655,11,249,1402,169,5050,80
8389,223,7305,1382,4898,76522,2407
65034,1716,5748,212,4713,357297,1035
55503,62,1033,509,848,11803,185
42123,24,564,800,391,14420,173
28048,6,299,1078,177,13476,122
27659,121,3122,1086,2000,52463,1122
30257,13,311,1035,210,16000,101
17424,6949,229803,1281,152020,769091,77783
20027,108,3858,1234,2797,29348,1061
46962,22,614,740,457,7398,157
47524,329,3412,732,2857,28005,555
24861,384,6490,1147,4654,24613,1836
53986,632,5654,558,4042,27403,1612
58051,520,8285,437,6614,121762,1671
20010,27,678,1234,474,9594,204
34944,183,2708,948,1987,43108,721
3079,146,3332,1445,2053,23398,1279
60730,2812,47696,344,37317,247686,10379
14172,66,3134,1330,2091,40644,1043
3255,86,1712,1443,1210,43267,502
43647,49,394,778,296,5075,98
32143,8,247,1004,148,5177,99
32368,13,304,1000,201,5428,103
3054,149,6403,1445,4507,48164,1896
44317,65,1112,770,823,14007,289
57636,26,368,450,249,4540,119
28494,226,4487,1070,3171,64705,1316
24264,801,17988,1161,12265,88825,5723
64864,13,192,218,107,5733,85
38407,129,1655,858,1469,25282,186
18523,61,2221,1260,1659,10535,562
32654,44,2053,995,1213,18150,840
20131,240,5359,1232,3777,54446,1582
31146,13,163,1018,107,6876,56
15158,10,449,1317,323,12174,126
58850,63,757,410,635,10671,122
66783,837,15449,164,11509,92355,3940
2134,7,329,1453,242,19259,87
11060,262,18558,1367,10882,134053,7676
60679,45,623,346,518,11760,105
63760,158,1788,253,1436,7812,352
22729,16,383,1189,250,10918,133
20459,12,1265,1226,863,8357,402
6160,54,4019,1408,2488,26556,1531
36542,718,14069,907,10021,112579,4048
43440,304,3881,780,2949,20590,932
13081,21,803,1345,453,22265,350
1716,4,197,1456,135,20462,62
49442,65,1315,689,1049,10925,266
12562,343,6250,1352,4047,21799,2203
46403,3,137,748,107,5379,30
27064,3699,65444,1099,43119,258811,22325
58985,27,446,406,344,6227,102
36328,1364,26823,912,21555,134910,5268
41545,36,566,810,451,8213,115
17656,1,66,1276,47,3910,19
12590,71,1845,1352,1213,11870,632
2710,135,7498,1448,4782,95046,2716
63650,10,69,256,58,2468,11
36148,158,2240,919,1897,55277,343
43063,261,4133,785,3224,27534,909
29430,4,307,1052,267,5905,40
56414,1,63,483,54,4055,9
25760,23,1446,1128,579,13625,867
20713,11,416,1222,279,7135,137
31296,52,1059,1016,701,14461,358
27987,21,636,1079,397,18932,239
62570,53,727,283,536,5994,191
64280,83,1686,235,1443,11499,243
20549,17,1574,1225,1145,19845,429
58121,206,3131,434,2442,18001,689
16723,34,731,1292,502,13546,229
66257,50,658,181,500,4664,158
11674,366,12507,1362,6804,53508,5703
62146,1,14,295,11,1971,3
5914,8,253,1411,182,19001,71
57356,34,823,457,508,21115,315
60412,2566,27542,357,20067,97443,7475
65233,27,466,208,426,6116,40
12109,97,2947,1358,1852,64383,1095
19488,19,352,1243,284,15088,68
50156,38,570,670,501,16887,69
267,5,226,1468,146,14720,80
29353,193,4980,1053,3005,31051,1975
36948,1,20,899,16,5726,4
15127,17,340,1317,233,6216,107
23259,61,2058,1180,1712,47665,346
64253,5,97,237,72,1886,25
66214,1,41,182,33,2445,8
49253,409,7109,694,5886,43815,1223
52382,21,370,608,283,6805,87
32296,5,319,996,225,8244,94
57393,35,585,456,451,15215,134
14136,331,2910,1330,2019,28027,891
10841,48,1101,1369,743,33638,358
19589,22,482,1241,412,17542,70
19593,11,528,1241,316,13599,212
25669,90,1688,1130,1089,8749,599
43265,121,3159,782,2280,17077,879
24164,17,795,1163,585,38791,210
30036,18,353,1039,274,12499,79
319,116,6013,1467,4071,79991,1942
48933,1610,24968,704,19658,108997,5310
53800,84,730,565,583,11884,147
10299,82,1560,1373,935,17703,625
1229,173,6915,1460,4208,41214,2707
21394,321,4823,1209,3295,37795,1528
40889,32,344,820,262,8070,82
32581,17,270,996,213,9873,57
62284,3,76,292,30,4605,46
48510,103,1136,717,914,12927,222
38803,41,1244,849,879,14798,365
11452,196,8294,1364,4920,31806,3374
40449,18,659,827,531,13174,128
12704,13,493,1351,255,12925,238
36877,22,493,901,400,9309,93
12895,145,3386,1348,2007,25765,1379
42688,10,222,791,161,3760,61
18341,143,3889,1264,2952,63121,937
7346,17,564,1393,372,15850,192
15403,104,3264,1313,2144,36225,1120
32525,60,1478,997,1128,26240,350
16587,51,3004,1295,2242,31687,762
2523,364,8235,1450,4851,23900,3384
39211,220,4167,845,2451,54625,1716
43773,32242,768481,777,550130,1771744,218351
34932,152,2053,949,1412,12622,641
17171,46,873,1285,650,12407,223
8486,329,19305,1382,11687,118591,7618
28291,8,272,1073,168,8092,104
64167,30,186,239,151,4952,35
8597,65,1940,1381,1218,20900,722
6703,7518,203468,1401,109594,514877,93874
55786,295,5297,501,4578,45580,719
57535,28,238,449,188,4935,50
34382,46,1035,962,733,12426,302
9086,83,2805,1379,1858,30406,947
30391,41,1161,1032,729,15214,432
494,99,2411,1466,1517,32522,894
53527,67,570,573,497,9682,73
63103,27,519,270,415,7256,104
63037,1,29,272,23,3153,6
42977,326,35054,787,26243,31068,8811
14335,123,2290,1327,1653,27040,637
34706,4,84,953,53,4963,31
11563,18,860,1363,573,16283,287
6321,226,7636,1406,4784,43981,2852
6816,5,99,1400,65,6693,34
18635,26,821,1258,574,28204,247
741,15,859,1463,635,18857,224
18768,7,454,1256,296,32006,158
60285,19,125,361,90,4332,35
9661,5,161,1377,104,7863,57
18757,62,926,1256,585,16876,341
24454,75,2269,1156,1489,25612,780
17166,3,119,1285,90,4904,29
23561,35,545,1175,381,12767,164
21582,41,1166,1206,845,15440,321
60492,172,1506,353,1266,17182,240
5004,12,816,1422,476,36388,340
21532,10,415,1207,300,11363,115
11598,7,864,1363,459,17553,405
6664,97,4551,1402,3252,32599,1299
29797,66,1812,1045,1560,26052,252
7008,3,662,1397,504,38985,158
12542,138,7899,1353,3879,26369,4020
33160,187,4227,986,3091,40689,1136
9324,71,1409,1378,849,31431,560
1682,9,289,1456,191,13814,98
16202,23,435,1300,292,8407,143
3067,1212,34058,1445,24721,84974,9337
20720,40,1123,1222,845,23117,278
2387,13,914,1451,665,7766,249
33609,249,4843,977,3475,57514,1368
36925,10372,444035,899,317283,1074880,126752
3648,19,1325,1439,912,13457,413
49743,15180,322283,681,254548,657020,67735
32137,83,1318,1004,855,7649,463
6685,1113,29758,1401,20028,233006,9730
9457,238,8750,1378,4785,39392,3965
48634,553,10267,713,7893,67623,2374
34511,6,263,959,157,11080,106
56782,14,247,472,207,5200,40
18849,15,375,1254,313,14956,62
13697,91,2967,1337,2043,28191,924
35707,96,2537,930,1786,25589,751
50202,11,393,669,294,10165,99
32407,100,1424,999,998,15586,426
11649,42,2816,1362,1405,24817,1411
25702,76,2209,1129,1342,17399,867
15182,278,9422,1316,5946,50087,3476
12765,23,2246,1350,1107,18411,1139
3527,6,116,1440,95,9768,21
35643,26,469,932,392,12563,77
9029,17,878,1380,561,11313,317
54007,2339,25825,558,20447,170204,5378
66638,579,11793,170,8693,89822,3100
42456,98,1681,795,1103,5605,578
9671,142,2457,1377,1653,9274,804
62914,3,49,275,39,1857,10
25917,15,166,1125,159,13272,7
40473,209,3649,827,2968,42046,681
30994,22,472,1020,311,11084,161
67613,5,83,138,64,4027,19
32258,263,8619,1000,6066,67685,2553
56393,15,283,483,245,11048,38
21520,34,796,1207,608,15528,188
30673,463,17413,1003,12382,111187,5031
55026,64,1207,522,939,14812,268
9704,8,409,1376,265,9834,144
33665,27,713,976,562,11046,151
4417,615,10831,1430,7154,45650,3677
12442,119,2845,1354,1510,31403,1335
10330,26,678,1372,455,19562,223
62385,32,314,289,247,4792,67
62581,163,1982,283,1564,25664,418
270,34,1354,1468,864,65780,490
24545,348,9930,1154,7119,104435,2811
45811,180,2912,752,2432,55490,480
26731,972,19884,1106,13402,144321,6482
10550,26,1193,1371,724,24858,469
9501,85,1677,1377,978,18209,699
19453,7,302,1244,227,7701,75
10168,172561,8244160,1373,4254059,15045145,3990101
40036,78,886,834,712,12029,174
47011,395,4095,740,3100,22916,995
51567,52,679,633,587,17235,92
15797,720,25553,1307,16688,112501,8865
2292,38,1295,1452,981,27738,314
50744,76,1022,656,748,12608,274
31594,156,6011,1012,4203,38894,1808
58106,123,1722,435,1300,25288,422
16116,41,2342,1302,1435,13876,907
7286,13,384,1393,278,11931,106
43653,58,723,778,523,9495,200
60970,9,142,335,91,8142,51
24641,673,15822,1152,11703,88702,4119
17325,32,598,1282,481,8048,117
12783,4,364,1349,204,6669,160
50694,71,1410,657,1193,28059,217
33374,6,262,982,157,8628,105
55753,92,1419,502,1103,16367,316
34151,165,4742,966,3569,77761,1173
574,12,533,1465,378,23627,155
65313,5,105,200,91,2362,14
65481,12,332,203,232,7158,100
20024,22,685,1234,480,16779,205
51461,0,0,637,0,5249,0
2730,14319,489924,1448,285697,1425930,204227
36466,169,3608,909,2623,30242,985
1147,19,657,1460,448,27816,209
3455,93,4056,1441,2662,43206,1394
19466,146,4807,1244,3655,42875,1152
63942,17,196,247,148,2652,48
15658,3439,140366,1309,83514,588025,56852
37541,6,213,881,173,17217,40
12032,34,1198,1358,651,21848,547
17687,43,988,1275,733,14607,255
49800,57,1263,679,1049,21876,214
3422,4,111,1441,67,8041,44
11885,19,592,1360,273,14757,319
60639,11,151,347,110,8637,41
20975,26,1068,1217,726,24208,342
20717,2,264,1222,191,4324,73
11239,40,1663,1366,1018,17887,645
29743,48,796,1046,502,9619,294
17114,2,224,1286,180,34729,44
43761,63,764,777,609,7659,155
33252,128,3940,984,2680,49446,1260
13209,134,4757,1344,3369,54263,1388
4419,3404,117514,1430,72767,269146,44747
18578,31,596,1259,443,16231,153
49334,22,341,692,276,8177,65
41257,48,1200,815,946,16994,254
42736,2901,60147,791,47875,376076,12272
29310,1,113,1054,71,6748,42
67591,2,79,138,53,3121,26
65122,3,73,210,54,2040,19
8739,2338,89697,1381,54067,269138,35630
11983,661,14723,1359,10470,111845,4253
2894,46,1706,1446,1190,29969,516
63470,29,375,260,292,5281,83
60615,34,824,349,641,7910,183
68115,54,979,121,867,11566,112
32286,39,1431,1001,775,6626,656
2262,59,2697,1452,1659,25800,1038
14437,14,778,1325,542,22190,236
49938,6,111,676,68,3524,43
11700,0,0,1362,0,16367,0
49292,3160,68162,693,53655,403952,14507
67114,4,59,154,47,5338,12
11781,1400,113488,1361,53205,294486,60283
3994,402,11969,1435,7581,129669,4388
20242,324,7099,1230,4216,31585,2883
4601,20,1137,1427,735,21427,402
2011,8,226,1454,149,12316,77
20241,462,9473,1230,6973,74905,2500
37549,9,201,881,172,2408,29
53495,108,1164,574,883,11908,281
10079,132,5787,1374,3438,57544,2349
59598,10,106,385,69,5035,37
18713,2,210,1257,137,18777,73
11955,29,641,1359,303,6086,338
36021,532,7432,922,6190,51706,1242
20000,8,217,1234,158,4311,59
13149,68,3554,1344,1997,33108,1557
21809,4235,69942,1203,43774,148173,26168
40020,45,1106,834,822,17969,284
20455,21,630,1226,482,7845,148
3120,979,66155,1444,43263,344287,22892
51918,39,677,624,426,6112,251
46912,35,871,741,654,15304,217
19188,52,1330,1248,909,28015,421
25419,388,11462,1136,7851,92981,3611
29281,147,5784,1054,3421,41498,2363
15644,1,160,1310,76,16153,84
21084,284,6672,1215,4511,41784,2161
52782,2,84,594,48,3022,36
51487,8,111,636,87,2547,24
63651,98,1126,256,866,20105,260
23342,39,965,1179,771,38726,194
42069,6,171,801,143,3490,28
57872,1155,30299,442,21267,120670,9032
56438,427,6590,482,5465,45950,1125
49702,1397,22150,682,18530,131549,3620
49662,8,120,683,91,6580,29
20239,2,94,1230,77,5375,17
25845,22,1323,1127,818,13170,505
58671,11,153,415,118,5003,35
39809,45,775,837,662,13170,113
53364,4,50,577,41,2986,9
51315,337,4998,640,3998,26896,1000
33457,3,138,980,86,6226,52
7710,65,2262,1388,1571,42976,691
61720,17,191,311,151,4897,40
32174,6,425,1003,213,7453,212
25479,18,596,1134,502,28587,94
17954,4,215,1270,179,4874,36
63624,5,181,252,98,7592,83
52486,24,393,604,260,13526,133
29930,14,575,1042,329,19047,246
61714,50,473,311,406,8954,67
368,590,17660,1467,9922,85905,7738
387,541,12366,1466,9064,44934,3302
9419,98,3064,1378,1913,24260,1151
28819,282,13002,1064,8918,43792,4084
1267,66,3093,1459,2275,79215,818
31363,0,34,1015,20,2283,14
19014,307,11264,1252,7286,96812,3978
68019,26,264,125,208,5361,56
9093,126,4388,1379,2048,22325,2340
33171,1,36,985,23,13086,13
2703,56,1892,1448,1293,18454,599
27186,90,3302,1097,1928,22887,1374
38871,29,576,849,422,4289,154
32550,2038,31952,997,23368,118039,8584
61492,5,34,318,26,2800,8
31452,106,2158,1009,1563,31157,595
22208,4,169,1198,89,4731,80
2517,169,4571,1450,2857,56298,1714
57437,98,1083,455,895,12700,188
23888,88,3166,1169,1983,20067,1183
7519,130,3140,1390,2175,33561,965
33773,19,1292,974,804,22683,488
18118,1,55,1267,41,2910,14
58711,61,476,414,415,9648,61
48281,92,1316,723,1036,26065,280
22035,3,52,1200,39,5595,13
16325,1,58,1299,38,9159,20
24031,87,3442,1166,2323,31272,1119
56828,84,1010,470,773,11096,237
5586,145,4187,1415,2827,37868,1360
52740,42,785,594,596,21577,189
21792,247,5047,1203,3428,32315,1619
46450,56,807,697,680,19940,127
55343,8,85,513,70,7462,15
37566,25,490,880,405,18236,85
51372,22,282,639,247,8917,35
20428,70,2745,1227,1861,19509,884
15413,12,853,1313,523,9329,330
9591,89,1995,1377,1238,15205,757
54400,4,59,544,40,3011,19
62757,19,196,278,162,11226,34
12868,66,5034,1348,2781,38684,2253
9113,129,3393,1379,2309,23289,1084
67099,46,616,154,513,7246,103
30449,18,682,1031,417,5955,265
15340,32,743,1314,538,12737,205
36718,47,496,904,408,9496,88
20375,37,1707,1228,1135,14571,572
57191,58,633,461,489,9640,144
15540,14,877,1311,680,23132,197
31772,80,1432,1009,1128,39908,304
3686,161,5911,1439,4260,24315,1651
57999,466,5948,438,5036,39769,912
56434,20,388,482,258,6387,130
32255,24,711,1002,489,5241,222
10357,2404,112194,1372,72661,506144,39533
30535,48,852,1029,572,12315,280
43513,8,257,779,218,12703,39
58192,61,1438,432,1188,13003,250
34032,874,21096,969,15551,123663,5545
60417,5,50,357,31,2920,19
23173,267,8384,1182,5797,68052,2587
51921,136,2667,620,2035,26654,632
19263,929,46555,1247,33071,214017,13484
60066,1986,27126,369,22076,149678,5050
22730,863,23024,1189,15267,122368,7757
23645,111,1807,1174,1212,40310,595
67163,1,27,152,20,2370,7
48549,48,651,716,527,6734,124
3353,5,385,1442,274,6887,111
59806,36,818,378,631,27052,187
61483,1383,16756,318,13718,107771,3038
11558,31,1006,1363,601,14371,405
23385,81,1232,1178,897,11764,335
63355,8,164,264,115,5375,49
67882,2,29,129,21,1409,8
62952,12,169,274,128,1214,41
57948,20,228,440,177,5346,51
1551,34,1687,1457,1087,11200,600
66818,71,1986,158,1504,24740,482
25966,21,548,1124,369,7946,179
3830,44,1405,1437,990,39312,415
41528,20,298,811,219,13562,79
39759,5820,122942,824,92431,341208,30511
68346,1,112,115,34,2461,78
12074,200,3802,1358,2360,20821,1442
54031,12,520,557,405,5279,115
42492,8632,233728,795,179198,557993,54530
64384,12,68,233,61,2163,7
1106,31,2296,1461,1674,53135,622
11486,644,35208,1364,19020,217589,16188
51838,60,650,626,478,20489,172
2708,24,892,1448,616,19533,276
12422,141,2929,1354,1851,34298,1078
56915,5,72,468,57,6859,15
25381,270,5523,1136,3728,39626,1795
25145,47,587,1141,427,13478,160
10125,4468,104163,1374,61929,227894,42234
65346,801,16343,205,13886,96721,2457
24167,508,26297,1163,20186,138238,6111
1348,87,4775,1459,3292,35301,1483
35077,78,2414,945,1796,27586,618
21650,764,35146,1205,22265,169721,12881
16962,27,878,1288,600,15210,278
5812,609,30737,1412,19534,91302,11203
22587,25,553,1192,372,10252,181
9732,29,882,1376,554,6717,328
54596,113,1075,536,851,9828,224
57483,33,407,454,279,8586,128
17825,28,805,1272,627,14640,178
68510,8,291,109,238,3006,53
57155,66,752,462,616,20882,136
56272,1,45,487,20,2613,25
20229,132,4436,1230,2964,23113,1472
8123,84,1587,1383,1127,22039,460
59253,263,3131,397,2449,27556,682
19592,9,341,1241,271,8750,70
35629,37,979,932,627,11769,352
26896,36,2058,1103,1144,16578,914
25921,87,2317,1125,1234,26615,1083
66383,6,60,178,53,5146,7
61954,10,108,303,78,6494,30
13937,56,2959,1333,1916,38151,1043
8269,72,875,1383,601,9236,274
67371,463,8396,145,7018,72142,1378
18484,45,1887,1261,1300,15937,587
14553,1,119,1324,73,6151,46
22711,107,1602,1190,1074,12377,528
41856,9,220,804,158,11248,62
37584,556,14206,880,11051,62386,3155
33048,67,855,988,551,7230,304
21377,10014,451595,1210,250163,1066082,201432
66698,16,218,168,181,8144,37
10517,1131,66240,1371,39137,222402,27103
28213,15,532,1075,399,13799,133
34181,142,2604,966,1760,20888,844
3884,20,478,1436,323,14744,155
32615,326,8243,996,6223,72789,2020
34411,36,1045,961,670,18356,375
52619,9,74,599,47,2807,27
21971,100,1730,1201,1188,9560,542
57843,90,1548,443,1192,36908,356
11082,167,4306,1367,2801,25948,1505
67039,33,475,156,392,7770,83
30157,62,1317,1037,848,8868,469
756,23,774,1463,539,16529,235
40174,296,7245,832,5794,39649,1451
28797,67,967,1064,631,14335,336
32766,26,575,993,369,3493,206
41518,11,178,811,148,7719,30
20266,24,1292,1229,989,17660,303
50576,22,371,659,340,5551,31
34073,3,39,968,32,1932,7
64579,14,223,227,175,3414,48
65366,23,514,205,357,11770,157
9453,42,1527,1378,905,15099,622
27989,51,767,1079,580,6488,187
19895,29,1089,1236,845,15401,244
636,9,477,1464,358,13251,119
7485,745,63557,1391,34524,395747,29033
47380,213,2900,734,2435,29615,465
7188,27,1084,1394,771,22427,313
7691,25,970,1388,669,17774,301
22396,9,651,1195,433,14244,218
15528,17,476,1311,369,20371,107
52666,26,243,597,170,6604,73
62612,1200,16486,238,13769,116986,2717
10603,14,551,1371,365,26401,186
22226,104,4238,1197,3477,24928,761
11514,7,749,1363,438,20736,311
31041,151,3001,1020,2153,54281,848
62829,74,1023,277,832,15155,191
26376,29,787,1115,493,11110,294
20633,15,570,1223,426,25141,144
947,164,4837,1462,2922,30852,1915
59557,53,394,387,322,5511,72
20385,4,226,1228,161,10069,65
8566,542,23763,1382,14506,159801,9257
29686,324,9417,1047,6431,62521,2986
8687,2,97,1381,68,6314,29
991,7,284,1461,210,23114,74
24201,30,760,1162,541,14865,219
26019,393,9884,1122,6652,39320,3232
1312,34,1189,1459,862,52786,327
48742,15,253,710,204,4452,49
15305,2472,52459,1315,36025,166450,16434
57883,3,49,442,36,4672,13
12405,36,2235,1354,1264,19571,971
29850,34,1574,1043,843,12938,731
60936,16,145,336,112,3396,33
4949,334,7176,1423,4936,37793,2240
18204,1157,25215,1266,15726,180441,9489
49972,1430,23710,675,17487,143313,6223
60411,142,2038,354,1526,25724,512
41919,592,11317,803,8362,100689,2955
12910,0,0,1348,0,7830,0
40209,384,4257,831,3371,36718,886
62213,30,330,294,209,2510,121
22970,12,604,1185,439,38191,165
17643,8,482,1276,361,16087,121
42732,2,80,790,65,10484,15
37249,23,450,889,265,13144,185
64786,7,69,221,50,2374,19
12248,49,1896,1356,1155,20690,741
57785,7,45,445,36,5939,9
5152,1115,79437,1420,49953,400897,29484
63308,60,380,265,340,5390,40
27742,9,356,1084,285,18055,71
38641,40,754,852,566,8547,188
41021,36,715,818,574,40854,141
22211,177,2397,1198,1405,12667,992
15034,300,3859,1318,2464,28031,1395
50583,7,50,659,40,3607,10
9310,439,13739,1378,8993,38753,4746
16293,250,7293,1299,5047,56914,2246
27157,4,289,1097,182,16177,107
29631,15748,381862,1048,226647,822586,155215
35503,215,3428,934,2543,30576,885
61748,8,48,310,40,1297,8
25030,31,1696,1143,1094,9930,602
51993,59,810,621,633,10571,177
59873,177,1525,375,1159,12609,366
27928,16,184,1080,112,5640,72
1878,960,31119,1455,23353,62487,7766
23431,1053,11552,1177,7246,64639,4306
19413,11,357,1244,300,20261,57
60889,47,575,338,475,16914,100
29677,239,7313,1048,4050,29501,3263
31546,42,1968,1013,1191,26556,777
9784,19,638,1376,326,5929,312
26722,533,10433,1107,6931,47307,3502
67407,1,54,144,36,5700,18
24680,434,17426,1151,12687,102356,4739
26904,1521,41080,1103,24877,316674,16203
31556,52,910,1012,555,10353,355
5536,45,1654,1415,1027,34126,627
3503,19,531,1440,364,20388,167
21726,48,1012,1204,684,11186,328
38075,96,3558,867,2855,58073,703
16231,663,8640,1300,5113,37663,3527
64677,17,141,224,118,4508,23
30076,20,412,1039,269,8968,143
2491,91,5016,1450,3455,52866,1561
23473,3,133,1177,96,4691,37
68305,97,2567,116,2129,32679,438
12071,136,8498,1358,4034,52837,4464
11765,16,711,1361,324,5212,387
24669,43,1150,1151,713,10834,437
45505,15,256,756,206,12547,50
61563,6,126,316,103,2849,23
54909,27,596,525,414,17356,182
48925,124,1723,696,1434,14564,289
35169,13,150,943,120,5652,30
20220,13,510,1230,346,8389,164
1392,5,190,1459,145,19307,45
12088,43,1491,1358,938,16656,553
60086,4,57,369,51,11318,6
56424,6,52,483,46,3501,6
15354,153,10138,1314,6513,51505,3625
53611,284,3157,571,2848,31416,309
25612,203,5874,1131,3770,31708,2104
25169,17,267,1141,218,5575,49
37621,269,4720,879,3754,29222,966
62578,63,818,283,548,8936,270
59020,10,113,405,81,6158,32
43529,1769,29207,779,22700,197362,6507
11775,57,1796,1361,721,8490,1075
66073,234,6484,187,5174,39024,1310
37091,282,6401,894,5355,39980,1046
60900,79,717,338,543,4599,174
6994,19,388,1397,283,13875,105
20198,16,370,1231,254,15530,116
27653,62,1322,1086,815,13669,507
61522,36,373,317,268,4021,105
22870,1098,30300,1187,21740,209143,8560
7329,1105,23095,1393,14856,150210,8239
29148,3971,166113,1057,121581,314830,44532
68467,32,584,110,447,6982,137
31548,149,4664,1013,2923,48705,1741
40051,190,2910,833,2390,19494,520
37623,303,5645,879,4850,51047,795
14785,1,69,1322,46,7018,23
15402,0,0,1313,0,2144,0
67612,20,194,138,171,3257,23
52514,10,165,603,154,10327,11
67328,8,299,147,184,5000,115
40140,2,57,832,33,4707,24
56498,37,645,480,509,13053,136
58827,4,65,411,55,3329,10
65576,2,28,200,18,2891,10
58878,7,133,409,115,3770,18
30805,31,809,1024,542,8808,267
2840,213,7843,1447,5705,60603,2138
17839,5,127,1272,101,6773,26
67599,4,66,138,47,3361,19
12476,465,28801,1353,15660,115967,13141
18267,1,71,1265,55,2990,16
58798,11,209,412,147,10890,62
29074,3,125,1058,81,6572,44
41603,3477,51633,809,41407,209186,10226
3305,26,1048,1442,812,9823,236
4018,97,3411,1435,2523,43418,888
7854,38,1087,1386,741,20064,346
58877,11,114,409,91,5985,23
17492,15,286,1279,220,8524,66
15010,14,199,1319,136,6672,63
49030,9,172,701,150,4918,22
20636,118,2260,1223,1609,20145,651
26213,3,88,1119,58,2841,30
1268,22,1135,1459,840,39603,295
43157,102,1171,784,854,15500,317
21240,135,1821,1212,1329,43591,492
36228,5,123,917,91,6613,32
27704,37,707,1085,404,9252,303
55217,16,166,517,128,6072,38
20316,44,843,1229,564,10466,279
12363,47,1310,1355,795,27363,515
64679,21,221,224,205,4873,16
60126,463,10713,366,8527,50359,2186
3563,26602,1580250,1440,896126,3531322,684124
24286,2923,135324,1161,84835,383924,50489
5783,948,40414,1413,20693,128440,19721
41958,3,119,803,102,6304,17
7355,32,4411,1392,3089,27716,1322
56247,14,191,488,148,5811,43
22604,2607,80035,1192,52226,466472,27809
30761,149,3665,1024,2301,26785,1364
28441,9,978,1071,524,5961,454
54184,53,754,551,678,12832,76
29056,24,1102,1059,671,14040,431
9243,24,787,1379,505,16563,282
56923,25,172,468,156,5436,16
65242,5981,92500,208,71596,541185,20904
31392,6894,144630,1015,85851,455030,58779
42098,9,106,801,95,2009,11
41325,4,104,813,82,3820,22
11307,346,8839,1365,5682,54878,3157
9270,1,172,1379,100,5650,72
62609,1386,28837,282,21671,209277,7166
25164,18,867,1141,615,15053,252
8760,274,9069,1381,5629,78111,3440
65985,219,4006,190,3259,25505,747
37862,777,13437,860,10450,118114,2987
63356,13,257,263,199,5072,58
5832,6,229,1412,139,5294,90
30902,24,1012,1023,621,9095,391
26637,93,3039,1108,1850,23269,1189
64909,13,183,217,164,8168,19
65678,119,1808,197,1422,27210,386
18436,12819,391935,1262,235565,1561161,156370
59629,49,568,384,453,14425,115
7069,203,2746,1396,2049,18400,697
56616,48,810,477,674,19464,136
50189,35,563,669,381,6640,182
7573,18,753,1390,441,14881,312
34530,12,433,959,275,11266,158
29633,1222,25771,1048,16971,236628,8800
7675,179,4318,1388,2907,42988,1411
26245,61,764,1118,536,9031,228
66793,14,435,165,369,3784,66
50541,3,73,660,53,4053,20
3410,18,546,1441,378,13027,168
66316,4,63,180,48,2007,15
3748,141,6025,1438,4078,99052,1947
24679,64,3493,1151,1940,32452,1553
31205,106,2368,1017,1466,12071,902
45107,6,172,762,136,5422,36
13093,1769,108103,1345,61494,362242,46609
57874,24,244,442,173,9692,71
51781,3,103,627,91,5684,12
65266,8,170,207,131,5585,39
27038,7893,144204,1099,92464,367949,51740
10186,376,9007,1373,5606,37196,3401
21549,7,303,1207,211,5738,92
13597,33,1591,1338,839,14368,752
20067,55,2216,1233,1415,18916,801
37635,178,3575,863,2732,39075,843
48830,32,533,658,355,4837,178
6162,734,22988,1408,14156,60428,8832
22584,2,122,1192,101,14836,21
12585,618,23177,1352,12802,89614,10375
66998,81,810,157,576,7399,234
64766,23,491,222,341,8520,150
1839,98,3633,1455,2248,24576,1385
23413,774,19466,1178,13779,148309,5687
52434,118,1187,606,948,31368,239
37538,981,13509,881,10725,83807,2784
19224,17,1277,1248,821,16149,456
37524,112,1329,882,1065,13858,264
5569,128,3671,1415,2621,19108,1050
68057,17,162,124,152,5947,10
30072,5883,123078,1039,74062,537332,49016
55430,1064,10243,511,9270,66792,973
61349,19,215,322,154,1802,61
49322,75,884,692,727,15093,157
49805,2,51,679,44,5142,7
60934,4798,80938,336,64906,225586,16032
56930,429,6071,468,5034,64160,1037
10456,3528,114875,1372,76181,627792,38694
12284,0,0,1356,0,6469,0
24611,8,218,1153,145,10026,73
20125,528,19334,1232,13532,141761,5802
21563,69,1131,1206,770,21100,361
17439,8,346,1280,266,14850,80
9809,134,2528,1376,1559,23813,969
36186,19,230,918,196,5500,34
28934,43,1465,1061,991,23955,474
56945,3,44,467,37,1659,7
58171,90,1985,432,1619,18459,366
56763,14,269,472,220,10858,49
61965,38,894,302,503,22431,391
21657,79,2313,1205,1466,25108,847
3611,464,19921,1440,12200,107072,7721
13258,88,2925,1343,1714,32826,1211
64402,3,54,232,54,5458,0
32019,272,5436,1004,3343,22543,2093
63990,53,622,245,417,5642,205
68700,17,401,102,371,10947,30
50391,19,208,665,169,5407,39
18867,94,4833,1254,3368,37296,1465
61312,6,78,323,62,4851,16
23279,69,3011,1180,2205,121259,806
39594,263,4614,840,3157,31688,1457
31791,299,8311,1009,6087,32020,2224
54415,521,4859,543,3589,32959,1270
17970,145,4124,1270,2971,63050,1153
54848,19,149,526,137,5003,12
23755,7881,250149,1171,158531,906238,91618
23149,128,1664,1182,1165,14624,499
48101,252,3660,726,3097,39783,563
49513,108,1145,687,996,14774,149
57920,320,5472,441,4276,25904,1196
24952,51,1363,1145,988,17302,375
21450,64,802,1208,552,10976,250
13002,2,221,1346,104,6570,117
34766,49,1224,951,848,31930,376
63921,6,148,247,90,5673,58
33043,13,358,988,147,6844,211
43004,34,510,787,405,11412,105
10636,124,5093,1370,3461,36461,1632
59567,63,840,386,660,8441,180
35274,16,445,940,312,12631,133
3627,129,6145,1439,4181,45969,1964
61254,1500,14734,324,11465,42338,3269
55992,137,2270,495,1710,19510,560
35390,484,8063,937,6078,36525,1985
5953,30,749,1411,543,14433,206
45248,9,118,760,106,12333,12
20314,23,451,1229,335,10423,116
15452,29,1434,1313,948,18458,486
55593,117,1523,506,1058,13172,465
33758,8,454,974,323,3516,131
53691,0,277,568,214,6649,63
33824,53,1143,973,771,9917,372
17209,83,2291,1284,1203,16704,1088
27390,79,3171,1092,2093,62108,1078
1430,375,15325,1458,10460,65073,4865
19441,38,1388,1244,886,9128,502
67206,10,74,150,57,2815,17
803,24,756,1463,517,36566,239
34263,13,273,963,195,3612,78
6829,159,6243,1400,3920,25576,2323
43103,22,307,785,242,11662,65
36915,124,2365,900,1982,44589,383
51051,23,369,648,289,5528,80
34172,17,1070,966,647,12445,423
27096,20,436,1098,270,12390,166
18113,4067,201804,1267,129804,837175,72000
15866,6,487,1306,333,9025,154
11440,15,263,1364,158,6250,105
28383,15,364,1072,226,4313,138
19824,0,60,1237,50,11981,10
57325,14,214,458,164,5248,50
34593,2330,62572,957,40976,226226,21596
59422,72,6602,389,3988,8927,2614
342,69,2925,1467,1769,39784,1156
59426,142,1240,391,973,24014,267
3999,1,161,1435,99,16898,62
9106,4,146,1379,98,6840,48
66909,2,55,160,34,3506,21
21093,10,492,1215,340,30348,152
66692,1,21,168,19,2076,2
54902,32,362,525,280,9839,82
30130,63,1337,1037,924,13375,413
30241,491,7141,1035,4550,66968,2591
10011,150,2703,1374,1758,27542,945
20542,4,250,1225,164,7500,86
15592,168,5198,1310,3640,68633,1558
23191,19,537,1181,460,36925,77
56588,4957,76451,478,51935,317916,24516
19371,47,599,1245,397,8090,202
12857,22,716,1349,388,8507,328
31081,75,1420,1019,914,16985,506
49816,70,940,679,728,16557,212
25047,13,614,1143,436,9905,178
41672,31,777,808,566,10809,211
68317,5,33,115,24,3541,9
63593,212,3249,257,2608,15794,641
2256,30,1173,1452,830,19301,343
37735,10,125,876,106,4877,19
8042,966,40416,1384,25080,263655,15336
67355,5,92,146,74,2261,18
4486,678,14610,1429,8822,120333,5788
23494,20,964,1176,681,11671,283
26730,22,952,1106,500,9993,452
17350,21,631,1282,442,14898,189
7344,50,1584,1393,1031,24718,553
66035,6,76,188,59,2271,17
67422,23,372,144,295,5247,77
4189,75,1963,1433,1366,17321,597
5023,5,198,1422,149,13470,49
40932,835,36471,820,23680,68005,12791
63183,230,4703,268,3579,23374,1124
9595,111,2201,1377,1416,20059,785
57941,70,749,435,619,11203,130
12389,10,206,1354,104,7210,102
13982,5,319,1332,181,8316,138
39101,6,139,846,119,7838,20
3132,231,11590,1444,7402,73007,4188
63746,64,1075,253,894,16473,181
61825,13,129,307,101,2008,28
27566,15,174,1088,112,3857,62
33660,11,186,976,153,8531,33
24194,12,463,1162,356,10936,107
37265,341,12513,889,9262,29242,3251
44129,68,1301,773,1025,25180,276
6852,8,277,1399,212,7042,65
3445,30,969,1441,763,12643,206
6417,28,1499,1405,1093,21631,406
6971,14975,576486,1398,338735,1324279,237751
55134,164,3430,519,2447,25805,983
51737,47,553,628,430,9071,123
43757,55,1080,777,923,24329,157
16707,41,581,1293,440,5559,141
16396,2,43,1297,26,4908,17
13648,167,3122,1337,1893,24767,1229
10342,2713,75661,1372,55102,364796,20559
32522,5,541,997,345,19164,196
35853,16,312,922,241,5382,71
4263,20,494,1432,357,22595,137
50797,7,70,655,66,10242,4
48160,1777,16598,725,12763,335048,3835
39621,21,380,840,310,6647,70
22827,26,929,1187,642,12912,287
60681,29,447,346,380,22060,67
8574,27,1572,1382,941,13868,631
35510,148,2152,934,1634,15462,518
3454,307,11684,1441,7620,66999,4064
11946,474,28167,1359,14270,172222,13897
18058,9,789,1268,576,11962,213
41322,97,1401,802,1093,19823,308
18415,40,816,1262,600,7565,216
53534,6,66,573,53,2922,13
21655,246,6494,1205,4166,40848,2328
16473,3,35,1296,22,3803,13
54564,101,862,538,756,15044,106
63451,144,1491,261,1155,8642,336
4942,146,7408,1423,5200,48162,2208
36422,8,160,911,137,6741,23
16966,316,9396,1288,7088,95997,2308
57287,35,561,459,413,12680,148
18774,49,2160,1256,1440,41909,720
66323,20,306,180,245,6681,61
67183,166,2667,151,2176,46224,491
33867,746,18797,973,12960,88472,5837
29158,45,1974,1056,1190,11320,784
52719,5,82,595,59,3879,23
6215,13,557,1407,338,10736,219
15524,59465,1226527,1311,719022,3391230,507505
43273,30,457,782,361,14339,96
55796,6,54,501,52,8560,2
27920,26,1479,1080,918,29698,561
38098,16,298,867,266,8891,32
22350,192,7052,1196,4858,54647,2194
51272,995,8766,641,6490,33497,2276
25249,1090,22847,1139,14960,164139,7887
10116,3,121,1374,70,2435,51
68549,4,130,107,76,3556,54
68610,46,499,105,376,3306,123
6795,208,7704,1400,4934,66009,2770
23770,904,17776,1171,11628,62567,6148
30160,63,1367,1037,854,27816,513
46799,39,410,742,341,6391,69
42714,577,9399,791,7358,64579,2041
26483,89,2551,1113,1577,14803,974
16186,144,5231,1301,3545,71353,1686
20265,227,4948,1229,3287,42408,1661
44921,152,2374,764,2016,30320,358
45477,386,3949,758,2891,29458,1058
41132,192,3049,816,2284,59955,765
17654,10,487,1276,373,11561,114
63179,13,282,268,229,6022,53
53045,3767,47172,585,39360,225630,7812
23123,4,179,1183,148,5684,31
6866,37,786,1399,526,30946,260
50357,1009,36408,665,28300,117717,8108
28408,75,1096,1071,722,12924,374
56835,201,1872,467,1423,16609,449
660,617,16154,1464,10500,63786,5654
26966,42,1063,1101,606,10635,457
35669,84,2230,931,1783,28334,447
52462,231,2550,604,2003,21935,547
1325,25,755,1459,524,26830,231
47875,22,567,729,469,8786,98
24010,41,803,1167,584,12519,219
36514,57,604,907,463,9697,141
63680,446,7295,255,5693,95189,1602
2485,20,694,1450,519,18115,175
3732,43,937,1438,577,19251,360
66629,118,1836,170,1427,10965,409
9070,411,9574,1379,5994,114042,3580
41832,218,5269,805,4274,27353,995
3196,92,2572,1443,1612,28683,960
22926,292,6818,1186,4915,53017,1903
75,13,626,1471,381,25543,245
55258,10,106,515,84,3994,22
23670,59,945,1173,698,32214,247
62600,1,53,283,26,2098,27
33235,80,1877,984,1478,32855,399
20252,19,441,1230,343,12677,98
17685,183,6883,1275,4554,54930,2329
20568,7,378,1225,264,14747,114
16472,151,5932,1296,3949,71739,1983
13480,27,908,1340,588,25628,320
57192,56,626,461,518,18078,108
65376,0,4678,205,3777,48414,901
52340,709,10079,609,7870,68407,2209
68082,13,435,123,276,8852,159
52894,32,387,590,307,11531,80
10043,6,268,1374,157,17416,111
15085,0,0,1318,0,6211,0
16098,119,1727,1302,1100,28586,627
28485,91,3229,1070,2120,14956,1109
9,28,1539,1473,849,57322,690
65469,37,327,203,267,4205,60
38083,68,778,867,689,14744,89
12862,1568,46572,1348,29236,268239,17336
8255,17,687,1383,444,28723,243
12227,0,0,1357,0,8937,0
3582,307,14273,1440,7304,53605,6969
11850,33,1513,1360,767,24651,746
6896,25,1492,1399,1004,20608,488
9669,197,11368,1377,7069,202156,4299
56020,1882,56907,493,44268,297793,12639
23479,30,689,1177,504,25314,185
3673,12,336,1439,274,30264,62
3663,5,118,1439,92,10568,26
67293,12,150,138,127,3699,23
49568,14,166,686,130,4715,36
33058,22,609,987,417,13240,192
66723,977,16246,167,13170,150724,3076
7563,95,3428,1390,2355,52308,1073
20354,64,1607,1228,1120,37739,487
4554,11692,507958,1428,282378,1611006,225580
65879,0,16,192,11,1644,5
15894,13,2648,1306,1144,53945,1504
2584,52,1317,1449,883,19567,434
14054,46,2867,1331,1690,23636,1177
20869,42,348,1219,288,15109,60
13764,573,11777,1336,8187,99644,3590
60442,27,175,355,138,5455,37
66205,50,810,182,672,13640,138
66129,73,654,149,463,6834,191
14976,8878,191430,1319,120552,504969,70878
57099,7,154,463,113,8681,41
33821,661,8652,973,7300,101742,1352
1719,40,2610,1456,1875,50671,735
31968,27817,486469,1003,330908,1020403,155561
2398,8,250,1451,172,7442,78
56592,6,77,477,65,4910,12
49908,35,316,677,245,9619,71
19120,45,2426,1249,1652,18054,774
53762,8,129,566,123,5063,6
66473,13,364,175,307,12104,57
24901,378,13190,1146,8391,125452,4799
2958,134,3285,1446,1980,24867,1305
67217,24,413,150,315,7006,98
23390,52501,1117573,1178,680420,2113589,437153
32152,5,171,1004,106,10981,65
24490,30,1161,1156,690,10886,471
2595,13,809,1449,539,25490,270
60040,34,250,370,200,7088,50
4093,197,4628,1434,3041,41968,1587
21008,158,4059,1216,3004,73761,1055
4648,12,758,1427,577,13509,181
50135,35,381,671,282,7679,99
16604,54,1266,1295,908,26382,358
11308,18,737,1365,434,14091,303
17377,3,102,1281,64,2063,38
50525,168,2583,661,1999,35495,584
34385,107,1982,962,1430,19878,552
65035,168,2054,212,1829,17361,225
13562,194,9648,1338,6023,97202,3625
723,73,1897,1464,1403,33408,494
69010,1,11,91,9,1847,2
7737,58,1765,1387,1234,69879,531
45469,41,662,758,571,15196,91
25424,390,6208,1135,3922,19420,2286
12829,1,190,1349,59,7121,131
1953,96,2502,1454,1797,17805,705
48896,23,229,705,191,8324,38
50893,158,2034,652,1611,21156,423
55685,33,553,504,442,10908,111
48694,6,126,712,80,3003,46
63502,16,135,259,115,3342,20
42370,11793,336861,790,229426,841595,107435
24466,281,6984,1156,4009,31843,2975
61737,53,553,310,430,4372,123
40683,503,11549,824,7532,46971,4017
36867,0,38,901,31,3808,7
977,794,42485,1462,29385,144756,13100
25085,17,403,1142,336,13362,67
12455,101,2382,1354,1438,31290,944
4165,13,300,1433,190,22891,110
9998,7,585,1374,368,10083,217
48924,15,220,704,180,5543,40
59778,52,730,379,587,13643,143
46171,132,1581,750,1244,10813,337
23847,323,11059,1170,8065,72951,2994
15126,15,763,1317,519,17677,244
13947,25,1243,1333,740,18994,503
9014,5,275,1380,183,12050,92
32167,177,2180,1003,1430,17845,750
608,103,3138,1464,2221,47751,917
29940,140,3531,1042,2080,14490,1451
25360,4101,94904,1136,57020,479382,37884
14275,119,2667,1328,2107,32728,560
61042,6,76,333,57,5248,19
2842,63,3441,1447,2286,16897,1155
67296,21,276,147,214,3247,62
17764,29,440,1274,301,12565,139
51262,57,331,642,254,4391,77
15052,6255,137713,1318,88612,499315,49101
24537,340,18357,1154,12095,158894,6262
29725,35,1465,1046,1177,20217,288
1282,52,1210,1459,880,31457,330
4557,344,16312,1428,8890,39805,7422
27578,734,17783,1087,11620,82448,6163
52164,71,711,615,527,17904,184
59500,12,198,388,171,13926,27
8331,2337,51008,1383,31528,200871,19480
49862,15,178,678,131,6826,47
3912,7,187,1436,141,8181,46
25778,130,4588,1128,2664,25543,1924
35930,40,579,925,399,17729,180
19667,10,444,1240,358,15960,86
61038,6,78,333,56,2152,22
25193,101,2422,1140,1611,40838,811
9337,76,1453,1378,945,18174,508
51106,63,1143,646,904,10107,239
15134,12,232,1317,167,17714,65
16807,37,1787,1291,1202,33793,585
17882,9,339,1271,222,5691,117
20994,9,227,1217,159,7722,68
6892,9,550,1399,402,24449,148
61804,108,1971,306,1367,20769,604
32183,46,1676,1003,1110,20894,566
61109,108,6119,330,4488,18152,1631
26996,274,8367,1100,5031,50212,3336
22257,64,951,1197,816,22895,135
12456,24,789,1354,486,8423,303
17091,21,337,1286,277,9024,60
19629,37,1228,1241,847,17339,381
8317,66,2117,1383,1292,32537,825
18163,4,173,1267,144,7011,29
54968,11,329,523,183,5504,146
30123,141,4434,1038,2816,34500,1618
1239,137,2951,1460,2183,68596,768
4410,7,168,1430,118,22411,50
2834,17,175,1447,115,5824,60
59296,40,310,395,241,6614,69
52525,65,1000,602,857,12067,143
56118,5525,97513,491,72080,340497,25433
57381,22,254,456,223,5460,31
65659,15,188,198,141,7994,47
9179,8,436,1379,285,8114,151
3893,12,465,1436,323,7752,142
58613,1010,23629,417,19026,80524,4603
23717,296,7569,1172,5106,33687,2463
63785,26,177,252,159,6874,18
54508,73,916,540,670,13765,246
66477,25,222,175,177,4183,45
53084,154,1282,584,1121,20535,161
24007,48,1604,1167,1071,61613,533
18169,10,411,1267,305,23869,106
36158,2318,40140,918,31524,198856,8616
60505,13,138,352,98,5316,40
64134,24,508,240,402,7589,106
15189,21,450,1316,322,18193,128
29257,8,184,1055,157,10665,27
31263,201,5409,1017,3623,43501,1786
22324,231,3991,1196,2736,26763,1255
60254,54,1110,362,743,19058,367
6821,6,222,1400,157,16446,65
23384,984,19515,1178,12231,59128,7284
1207,5,639,1460,408,10223,231
14971,35,1651,1319,1088,16433,563
22003,8,683,1200,456,22094,227
36404,165,3312,911,2541,23001,771
13353,166,5605,1341,3670,45443,1935
6998,110,2221,1397,1636,25654,585
51307,48,831,641,734,21772,97
27795,13,193,1083,163,15379,30
58725,31,443,414,321,11423,122
3349,81,1870,1442,1253,21981,617
63042,2,79,272,53,4347,26
59399,8164,215894,391,164425,649552,51469
57598,69,621,451,483,10550,138
16499,2,353,1296,223,11606,130
57962,197,2509,440,2071,24972,438
61611,11,64,314,54,2687,10
8689,83,3170,1381,2026,25272,1144
32232,785,31811,1002,22765,90283,9046
10669,0,410,1370,253,8800,157
27073,416,12054,1099,7676,116797,4378
11495,176,11311,1364,5298,72400,6013
62549,13,241,284,153,4657,88
67995,3,24,126,16,1780,8
23277,20,954,1180,691,26992,263
31842,9,752,1008,458,10261,294
17208,12,403,1284,307,10537,96
18916,33849,1250579,1253,731924,2059157,518655
57675,15,211,449,178,9133,33
4870,53,2114,1424,1378,18813,736
56735,103,1001,473,708,9316,293
57039,5,135,465,76,4149,59
37296,18,425,888,331,4456,94
68204,24,246,119,195,3512,51
68254,5,66,118,35,1663,31
23171,24,644,1182,449,11205,195
61821,60,1462,307,1087,15644,375
31901,7,193,1007,138,9778,55
65062,85,544,211,442,9852,102
21817,25,850,1203,558,10466,292
17738,23,974,1274,644,17903,330
31658,16,899,1011,565,8449,334
47184,113,2475,737,1821,29418,654
62889,33,405,275,318,8687,87
49133,573,21541,698,14353,164549,7188
17480,59,3228,1279,2357,32269,871
65617,12,129,199,99,5749,30
28060,5848,198131,1078,127104,287271,71027
18439,1852,65540,1262,44811,335625,20729
15969,515,14180,1304,9987,132463,4193
54562,2110,308012,538,220647,384985,87365
38267,15,249,863,161,4245,88
33129,45,1435,986,887,11629,548
30838,16,782,1023,408,9838,374
6745,1970,47938,1400,30291,335062,17647
34352,11,237,963,161,5326,76
29774,37,2272,1045,1337,11008,935
10197,127,3958,1373,2566,47815,1392
19612,8,145,1241,116,14504,29
26357,478,5735,1115,5033,66412,702
26647,10,290,1108,159,5653,131
3812,18828,808268,1437,501123,1438528,307145
23466,16,999,1177,823,24295,176
36554,68,1875,906,1487,47077,388
755,46,2421,1463,1611,30039,810
59543,793,18526,386,14878,81967,3648
32051,57,1123,1005,780,10655,343
63348,21,366,264,304,10591,62
48708,36,369,711,280,7178,89
896,171,2966,1462,1869,22297,1097
22205,19,732,1198,423,54244,309
50296,9,103,667,95,14946,8
62512,20,531,285,479,7676,52
27667,21,1013,1086,779,30204,234
14158,176,5546,1330,3265,22593,2281
49789,380,9246,680,6995,111568,2251
41617,43,537,809,445,13006,92
57479,13,331,454,191,8511,140
54384,258,3035,545,2559,24128,476
27967,7,351,1079,204,5244,147
53798,4134,65793,565,50356,242248,15437
31091,139,2756,1019,1771,19607,985
29780,10,375,1045,243,5915,132
33626,21,334,977,209,6824,125
57878,13,195,442,145,11719,50
4560,227,7766,1428,5199,133638,2567
50177,354,4942,670,4083,49915,859
54891,54,238,525,194,4604,44
17436,16,240,1280,208,16898,32
18548,29,735,1260,559,17125,176
35200,1321,30181,933,22967,175169,7214
16401,173,4885,1297,3559,52588,1326
52045,2,47,619,32,2745,15
7825,21,1766,1386,1005,20677,761
21354,616,26887,1210,16478,100103,10409
28969,118,3358,1060,2331,32590,1027
56924,6,100,468,66,7103,34
10086,33,1405,1374,845,14977,560
58783,9,131,412,87,8231,44
9605,2148,33866,1377,23897,86713,9969
62416,247,3676,288,3115,33441,561
13500,1881,44731,1339,29144,314262,15587
34904,236,5260,949,3670,104950,1590
25437,4,323,1135,213,9032,110
31723,44,936,1010,637,10800,299
32634,173,3872,995,2459,44366,1413
3116,333,19210,1444,13356,79199,5854
49566,722,12622,686,9717,83919,2905
51028,32,588,648,440,9738,148
48638,14,426,714,340,17616,86
6756,43,2090,1400,1383,21545,707
63455,8,23,261,19,2432,4
54430,13,260,543,160,7844,100
52312,11,158,610,95,11573,63
42119,10,334,800,270,22112,64
7439,8,765,1392,533,17596,232
17889,54,1398,1271,1055,22587,343
48561,54,470,716,355,6326,115
22697,15,321,1190,206,7520,115
66798,15,149,164,121,2512,28
3761,0,813,1438,479,11882,334
32365,41,1433,1000,962,39520,471
66364,106,1836,179,1525,11123,311
30018,28,675,1040,379,15412,296
15599,419,6701,1310,5033,52956,1668
822,9339,628526,1463,420677,2568055,207849
26526,555,14723,1112,9568,106630,5155
38679,0,18,852,15,1951,3
46043,64,1221,751,954,27404,267
42790,8,268,789,180,10551,88
25496,17,316,1134,229,13739,87
3977,16,962,1435,648,38759,314
9235,16,324,1379,217,13938,107
59874,41,494,376,385,8040,109
6253,287,14946,1407,10063,113730,4883
3996,410,7651,1435,5277,58924,2374
60220,7607,280185,363,206412,758650,73773
51090,98,1384,646,1111,15638,273
58424,140,2355,424,1679,11745,676
33223,143,2642,984,1926,32065,716
32966,31,653,989,407,6967,246
8621,6,281,1381,173,7738,108
48908,2,36,705,31,1721,5
49250,0,42,694,31,2499,11
51341,38,486,639,377,10593,109
15799,427,6956,1307,4700,55269,2256
5510,342,10581,1416,7149,79348,3432
23885,33,619,1169,407,13364,212
16500,46,942,1296,741,24120,201
60565,70,723,351,594,7031,129
21082,1689,36680,1215,22708,121336,13972
59194,25,234,399,183,7401,51
26716,447,13855,1107,9175,127076,4680
31150,34,725,1018,385,11056,340
4563,48,1850,1428,1200,36883,650
52986,2288,34395,587,27517,121572,6878
33657,21,310,976,257,6726,53
6086,3545,120209,1409,78617,296635,41592
40211,6,335,831,247,6618,88
917,250,10008,1462,6791,114732,3217
26360,37,638,1115,410,12318,228
28194,44,845,1075,689,7956,156
17358,49,1493,1281,1084,39137,409
20661,2,107,1223,88,10204,19
8373,58,1292,1382,893,10761,399
52176,44,492,615,387,9163,105
17527,26,1146,1278,867,13806,279
29986,18,564,1041,358,7843,206
22157,7,668,1198,437,8417,231
55621,11,168,505,124,5925,44
31555,111,4526,1013,2788,39258,1738
33278,123,3391,981,2063,28254,1328
39075,16,344,846,260,12463,84
11707,23,1259,1362,637,6203,622
31153,66,1722,1018,1405,38781,317
60160,294,3975,366,3097,28277,878
17765,58,2139,1274,1572,27268,567
10009,65,1404,1374,862,8357,542
33573,6,397,978,258,9472,139
19434,4,343,1244,295,4048,48
43151,9,255,784,209,4787,46
59802,96,1502,378,1340,13682,162
44267,58,461,771,363,10104,98
37067,11,190,895,138,4119,52
9621,1241,27033,1377,16916,97206,10117
26164,6,129,1120,89,16471,40
10291,2255,184758,1373,100512,463869,84246
24332,14,226,1159,178,4710,48
51041,66,1477,648,919,11005,558
24256,51,1577,1161,1121,26884,456
49311,53,582,692,410,17897,172
57716,12,270,448,215,7500,55
40123,30,397,832,328,6543,69
6883,77,4315,1399,2226,18336,2089
367,529,26477,1467,16425,88106,10052
27559,14,800,1088,543,10441,257
11763,12,713,1361,350,5222,363
3148,67,1710,1444,1338,39117,372
18917,3,315,1253,208,4679,107
11676,28,1064,1362,608,27361,456
5096,13,541,1421,364,18720,177
18098,7,428,1268,299,5231,129
68806,12,80,98,67,3530,13
33038,271,4214,988,3101,28102,1113
812,15,430,1463,333,28460,97
38410,38,840,859,708,15466,132
66881,63,2293,161,1785,18368,508
22383,121,4899,1195,3303,44499,1596
63766,2365,30272,252,24004,79454,6268
27252,9,110,1095,80,8856,30
25228,130,2998,1140,1879,58822,1119
58388,48,576,425,454,6614,122
95,11368,360573,1470,215748,902826,144825
51296,11,206,641,151,5359,55
20657,73,3122,1223,2310,54914,812
61685,68,479,311,361,5876,118
63689,34,357,254,296,5151,61
65002,1,22,213,15,3310,7
40894,32,495,820,406,7960,89
26348,26,747,1115,453,7361,294
16348,2,71,1298,49,6125,22
35480,77,2038,935,1472,18316,566
25340,5,272,1137,179,24204,93
54016,8,110,557,81,5701,29
59215,2,70,398,28,3406,42
48832,2,41,707,35,2018,6
30560,11,248,1029,158,2706,90
53186,377,4659,580,3701,31970,958
66675,26,226,168,202,4646,24
27387,430,12028,1092,8089,88169,3939
11842,7,510,1360,271,14632,239
28120,10,700,1077,416,9801,284
28771,4,89,1065,47,1643,42
21241,1,111,1212,91,6343,20
13499,25,2934,1339,1662,33439,1272
22951,125,3893,1185,2254,19358,1639
15230,144,3916,1316,2581,61987,1335
57010,77,1001,466,834,16132,167
67935,5,78,128,51,5890,27
10361,249,5949,1372,3949,77530,2000
23882,636,17176,1169,11487,101100,5689
49507,18,417,687,329,11028,88
29031,607,14776,1059,9637,143763,5139
29977,6030,121562,1041,70840,401624,50722
23859,3,119,1170,87,10943,32
36005,29,469,923,391,18179,78
31749,36,684,1009,440,15076,244
12996,24,1489,1346,913,36106,576
19417,118,5303,1244,3008,36071,2295
49757,39,403,680,328,10048,75
436,12735,336316,1466,198601,621534,137715
7655,428,10288,1388,6593,33999,3695
2123,51,3029,1453,2013,60000,1016
55079,6,50,520,43,1861,7
64788,39,593,221,453,9233,140
31274,4385,90712,1016,55327,191798,35385
40640,1267,41096,802,32723,206498,8373
60521,35,394,352,285,8309,109
21998,130,8415,1200,5186,58903,3229
61764,127,2036,309,1731,22115,305
33026,84,2226,988,1471,27137,755
13941,14,969,1333,561,37118,408
55532,179,1983,508,1571,27724,412
7170,16,298,1394,205,11181,93
64819,62,783,220,632,5064,151
66736,303,4430,166,3243,23726,1187
7664,537,33754,1388,18632,205315,15122
59014,371,7957,405,6516,37648,1441
5881,22,603,1412,457,15276,146
55508,12,261,508,176,6117,85
4224,6,483,1433,280,6762,203
63891,16,100,248,72,3483,28
54894,12,36,525,28,4131,8
4809,93,2477,1424,1784,34423,693
28839,452,5834,1063,4175,75917,1659
6168,386,6997,1408,4674,31761,2323
5909,65,2848,1411,1807,50142,1041
20978,50,2407,1217,1609,13337,798
38403,110,1534,859,1150,16907,384
11611,5,500,1362,259,21039,241
54821,177,1125,528,841,11370,284
44302,65,930,771,671,17584,259
53340,100,855,577,683,10320,172
14034,491,19387,1332,12178,149302,7209
7418,55,1158,1392,770,13136,388
15936,7,159,1305,89,6014,70
63567,15,98,258,71,5831,27
12838,36,2517,1349,1337,26395,1180
50242,2,39,667,30,3798,9
36848,87,2110,902,1782,34506,328
66759,11,170,166,110,2463,60
50979,14,168,650,142,6931,26
50136,33,360,671,291,4112,69
59339,5,59,394,40,4166,19
40502,58,1096,827,857,12557,239
37588,275,6883,880,5143,43707,1740
4361,28,509,1431,292,17883,217
14895,71,6300,1320,4384,20823,1916
34433,2542,80544,961,55600,338837,24944
44577,8,160,768,113,7720,47
67663,515,12666,132,10484,62320,2182
8545,28,982,1382,612,13133,370
68601,32,613,105,479,9159,134
25407,4,161,1136,97,8585,64
64369,38,623,233,547,11923,76
1206,22,456,1460,295,29741,161
46067,4233,138014,751,99257,234189,38757
2994,12,266,1445,203,9079,63
27443,4631,97401,1091,77629,249794,19772
66623,15,410,170,317,6652,93
16198,17,1001,1301,735,12699,266
33636,40,1674,977,1090,36487,584
61266,1,45,324,26,7872,19
4898,28,1094,1423,760,19032,334
62330,3,37,290,28,6417,9
30945,415,16338,1022,10005,93622,6333
7606,10,491,1389,291,10330,200
12964,77,2044,1347,1033,23160,1011
30696,24,715,1026,553,13390,162
68189,49,669,120,506,20790,163
36494,2,196,908,153,7754,43
66006,27,189,189,148,3673,41
32639,107,2107,995,1550,20953,557
17555,22,621,1278,539,12950,82
51544,1304,14361,634,10961,96447,3400
4945,28,1077,1423,768,19898,309
59950,9,74,373,49,2733,25
28765,14,403,1065,245,16385,158
28138,26,377,1076,260,9525,117
9559,18,367,1377,252,8617,115
62362,43,508,289,401,14305,107
32452,306,6843,998,4708,40772,2135
18175,83,799,1266,641,9015,158
5731,15,260,1413,163,5718,97
66128,95,1287,185,1066,12957,221
27001,177,7910,1100,5196,72567,2714
21505,48,1284,1207,875,14636,409
57865,6,89,442,74,3330,15
56490,79,632,480,546,5832,86
55322,217,4414,513,3521,41178,893
26444,9,136,1113,78,17616,58
16887,4029,75643,1290,41329,163072,34314
13533,17,875,1339,519,8986,356
9382,41,1201,1378,732,7835,469
39523,28,478,841,350,10538,128
68041,8,85,124,68,4257,17
66961,10,167,159,131,3276,36
14938,130,2627,1320,1665,25845,962
8027,4251,111702,1384,63382,216050,48320
6031,939,49395,1409,30054,188987,19341
62431,49,716,287,592,10394,124
35827,779,14438,927,10471,156613,3967
26873,611,14890,1103,10604,31873,4286
31748,51,988,1009,787,20069,201
21602,10990,446369,1206,250678,1468243,195691
51448,34,631,637,413,6740,218
35032,82,1126,943,867,35753,259
5872,6,551,1412,333,15786,218
55207,540,6406,517,5324,43359,1082
9477,36,901,1378,624,13525,277
43173,433,5853,783,4591,78735,1262
9558,2565,113883,1377,76987,265151,36896
5570,95,2311,1415,1422,17822,889
64124,28,552,239,402,5844,150
22472,18,561,1194,362,11076,199
15154,3,148,1317,110,9075,38
23993,291,12295,1167,8436,86085,3859
52208,193,2171,614,1824,26331,347
386,187,7371,1466,5055,73911,2316
4516,3,82,1429,65,3503,17
50011,78,1117,674,816,14827,301
29437,23,680,1051,434,32833,246
3727,127,5718,1438,3691,48228,2027
38150,9,170,865,148,11497,22
53060,632,9074,585,6953,75929,2121
67804,11,173,131,148,4285,25
21224,872,26467,1212,15800,142191,10667
13437,185,2591,1340,1529,19561,1062
65396,8,133,204,67,5012,66
35359,940,16382,937,12549,124832,3833
7416,13799,581595,1392,280793,1245118,300802
55495,17,253,509,182,4714,71
66941,82,861,159,686,13228,175
15521,98,1922,1311,1378,36781,544
53432,10,175,575,123,4794,52
30858,12,229,1023,150,23247,79
6043,122,5228,1409,3374,52269,1854
56110,20,245,492,175,13445,70
13416,224,12033,1341,7909,127809,4124
2464,1731,61055,1450,37779,214162,23276
2179,1003,27317,1452,18155,183466,9162
48931,27,450,704,356,10655,94
58591,96,650,418,474,6620,176
50710,92,1703,657,1443,27468,260
29016,11,351,1059,267,10646,84
59561,4,57,387,47,2753,10
20338,107,3573,1228,2331,67783,1242
68706,25,424,101,318,7659,106
8370,15,592,1382,394,18669,198
25606,9,432,1132,253,10036,179
32811,61,1122,992,849,13648,273
3180,178,3991,1443,2141,28669,1850
33093,129,2184,987,1615,23498,569
20823,11,196,1220,155,10037,41
65592,9,99,200,83,6328,16
1782,1063,32693,1456,22532,131979,10161
12800,193,5253,1349,3324,32810,1929
31862,74,2259,1008,1430,17774,829
64925,202,3946,216,3121,34537,825
53926,150,1776,561,1577,17987,199
56027,250,6604,494,5442,37209,1162
42552,349,6825,794,5897,53406,928
54424,62,541,543,402,5370,139
22111,84,3595,1199,2324,57226,1271
40043,1252,42080,834,30583,166340,11497
14574,4,298,1324,211,19948,87
508,33,1427,1465,975,34988,452
18472,1,84,1261,73,9085,11
15341,161,4314,1314,3023,49371,1291
42079,43,670,801,570,12116,100
52431,7735,133706,606,104719,576906,28987
6987,24,1121,1398,737,9071,384
17042,13,220,1287,170,16634,50
17084,1069,47092,1286,28757,304253,18335
60984,39,398,335,299,9507,99
23607,9,212,1175,135,6825,77
34840,7,124,951,94,5669,30
32959,65,3208,989,2178,23100,1030
31751,132,3313,1009,2400,35829,913
61599,44,522,315,463,14772,59
2795,107,3864,1447,2698,25757,1166
13338,13,483,1342,268,10940,215
49432,83,959,689,815,17008,144
34141,18,502,967,322,16703,180
47599,6,123,732,95,17807,28
27927,112,2442,1080,1381,7803,1061
56499,78,1687,480,1038,14687,649
49260,31,1098,694,815,22283,283
65812,35,505,194,411,21095,94
14356,21,872,1327,598,15050,274
23601,10,175,1175,134,6524,41
26850,18,463,1104,283,7530,180
54822,109,1459,528,1156,16609,303
56275,799,20742,487,15403,165467,5339
13929,617,26440,1333,16873,162736,9567
46035,49,796,751,612,15369,184
12121,211,10898,1358,6151,56797,4747
22899,2912,67195,1186,44081,494506,23114
21918,3207,83918,1201,58319,504305,25599
44421,136,2879,769,2250,44822,629
40414,122,2204,828,1854,70470,350
33391,6477,178969,981,119642,613766,59327
57643,96,1298,434,1030,17995,268
59474,56,656,389,539,21023,117
32447,16,803,999,498,14296,305
59942,42,353,373,255,5393,98
48957,4188,72658,701,59018,476938,13640
41834,36,689,805,560,19869,129
27789,4427,64664,1083,45544,253420,19120
41802,33,648,806,487,7682,161
41659,88,5217,808,3358,15798,1859
42612,76,1674,793,1095,13579,579
56522,3,51,479,43,5449,8
13457,16795,482129,1340,312713,1254198,169416
31665,6488,273343,1011,182089,720295,91254
28145,10,255,1076,159,7754,96
13189,161,3557,1344,2401,23399,1156
48526,1149,163616,716,111482,228584,52134
53643,163,1545,569,1250,25834,295
31191,5233,110757,1018,68526,420218,42231
709,32,1855,1464,1280,53370,575
12267,10,1094,1356,546,7929,548
61622,99,1715,314,1403,19911,312
26185,10,540,1119,340,7993,200
1347,54,4797,1459,3128,81344,1669
35702,136,1967,931,1552,37441,415
34801,16,275,952,235,6872,40
26477,67,1097,1113,689,5992,408
28162,1,35,1076,32,1733,3
67005,45,798,156,613,7024,185
21983,170,2815,1201,1782,29470,1033
11899,183,2538,1360,1453,24063,1085
23515,189,6551,1176,4778,53123,1773
15760,0,0,1308,0,16704,0
62042,139,1563,300,1319,12474,244
54018,14,91,557,79,5542,12
34403,37,800,961,545,11082,255
68624,4,72,104,51,4548,21
60142,315,4881,366,3553,31177,1328
10964,84,1749,1368,1085,27440,664
18820,3177,86741,1255,55569,362867,31172
64857,22,554,219,320,7425,234
60314,1110,11917,360,9614,60295,2303
25346,0,0,1137,0,12219,0
57905,80,1274,441,1065,17996,209
25501,11366,432113,1134,264294,952335,167819
54327,24,290,547,238,7941,52
12988,0,0,1347,0,68082,0
23659,23,758,1173,552,28983,206
17126,95,2768,1286,1827,36949,941
5148,76,4427,1420,2944,40890,1483
59134,40,514,401,404,6328,110
63261,91,1393,266,1193,7881,200
61846,12,190,307,143,7812,47
50701,41,248,657,199,4713,49
59621,57,1565,384,934,20955,631
12448,48,1265,1354,866,35179,399
26077,31,626,1121,428,21741,198
65033,395,5744,212,4955,25463,789
14923,143,1900,1320,1346,39176,554
53389,4,59,576,49,2504,10
38283,174,2474,862,1859,24592,615
18182,41,1224,1266,820,20358,404
22042,7,274,1200,163,8788,111
53263,83,1092,579,861,22107,231
57421,7,162,456,124,8521,38
51072,36,549,647,441,10093,108
14876,47,949,1321,599,7734,350
65517,16,140,202,117,2026,23
12240,15,477,1356,247,7839,230
47704,249,3289,730,2626,33197,663
39334,4,96,843,81,5411,15
38158,1839,30363,865,23780,112464,6583
12681,7,1185,1351,623,10812,562
48578,683,7724,715,5596,30671,2128
531,25,871,1465,611,21632,260
28776,84,2546,1064,1685,51438,861
53497,5,90,574,79,4669,11
64308,97,2353,235,1795,11643,558
63641,133,2575,255,2130,27925,445
47857,14,198,729,125,7681,73
49705,170,2159,682,1736,33796,423
571,20,1790,1465,1191,20536,599
55090,16,290,520,137,2657,153
32891,77,1004,991,686,10557,318
61604,32,387,315,312,5975,75
1580,431,7528,1457,4881,31575,2647
9511,559,9583,1377,6347,33370,3236
17428,26,434,1280,290,16267,144
18892,0,14,1254,12,2675,2
944,9999,328322,1462,196381,1172287,131941
41129,54,893,816,665,9050,228
42602,27,361,793,308,8189,53
67651,27,603,137,494,9422,109
44741,9,105,766,83,7946,22
25229,34,606,1140,374,6432,232
18314,34,298,1264,246,9682,52
53405,2,36,576,30,2304,6
11335,19,446,1365,296,13294,150
16503,6,754,1296,447,8202,307
2686,405,10593,1448,7159,68606,3434
13649,0,0,1337,0,18912,0
59766,88,690,379,507,10904,183
51351,160,2030,636,1495,31481,535
15953,773,10738,1305,6879,77213,3859
6114,57,1692,1409,1153,47135,539
10094,33,836,1374,546,14722,290
38853,183,3689,849,3205,43466,484
33422,165,3438,981,2219,25485,1219
67646,44,548,137,444,13522,104
9140,47,675,1379,471,25431,204
62177,38,384,294,299,7080,85
6834,12,254,1400,174,16109,80
29514,52,1169,1050,780,18775,389
5327,67,3549,1418,2142,17405,1407
26587,35,1066,1110,638,12325,428
13694,8,306,1337,174,13682,132
57376,7148,89994,457,67149,264107,22845
4364,28,1678,1431,1239,28023,439
23461,52,1150,1177,830,17544,320
51022,62,1232,648,1008,18459,224
48019,37,421,727,283,4851,138
6047,9711,291447,1409,157380,754978,134067
23,923,37239,1472,23234,216207,14005
59924,82,681,374,536,7559,145
54973,1395,20624,523,15653,129399,4971
13007,14,1117,1346,704,10430,413
14520,20,1422,1325,1080,15256,342
26220,11,162,1118,118,24048,44
62503,17,155,285,121,7122,34
66786,4,34,165,25,720,9
66545,33,388,171,314,5599,74
67266,3,30,149,27,4601,3
3112,73,1321,1444,969,10765,352
23035,276,6548,1184,4428,45003,2120
4659,14,413,1427,304,5835,109
40092,2,61,833,47,4073,14
24365,176,3376,1158,2615,30594,761
10474,273,11350,1371,6953,70246,4397
11520,1007,25092,1363,15588,114159,9504
65764,36,642,195,498,10212,144
21487,13,810,1208,569,17140,241
17914,906,18210,1270,13754,192459,4456
63996,51,882,245,710,11337,172
56707,23,282,474,249,7532,33
51532,22,172,635,133,10195,39
60263,17,287,362,219,10052,68
6109,0,75,1409,45,19584,30
30753,137,3678,1025,2597,39309,1081
4308,457,10026,1431,7340,113003,2686
63583,2230,13266,258,10612,258928,2654
6582,66,1882,1403,1286,32769,596
34583,4246,119418,958,86897,421586,32521
27442,50,924,1091,578,12634,346
28238,36,1496,1074,995,21714,501
47736,55,642,730,506,8228,136
39502,7,126,841,113,8856,13
12430,206,5384,1354,3305,40169,2079
19440,18,190,1244,144,7153,46
68103,18,220,122,167,2915,53
26020,26,839,1122,576,15800,263
53649,137,1918,569,1496,24724,422
32684,46,1370,994,937,16004,433
34563,372,5563,958,3866,39826,1697
60178,14,158,365,122,5850,36
65958,5,49,190,42,3869,7
62519,20,293,285,228,4799,65
62252,1312,27977,292,22910,140091,5067
19169,1626,79540,1249,52993,251872,26547
11796,13,1788,1361,704,9283,1084
30376,9,346,1033,208,11330,138
12200,3,276,1357,159,5968,117
52334,25,368,610,280,10857,88
37191,103,3066,891,2657,31014,409
10740,2322,75637,1370,44737,538728,30900
27163,16,631,1097,378,5940,253
68872,26,375,95,308,4740,67
21541,96,5839,1207,4788,96544,1051
62235,25,282,293,246,16562,36
34074,3739,98985,968,64874,452214,34111
10798,19,412,1369,270,12428,142
27046,86,2910,1099,1801,46528,1109
1015,9,215,1461,145,19311,70
4903,569,34187,1423,21698,145721,12489
48746,32,1018,710,589,12556,429
20959,98,1834,1217,1195,23744,639
18565,33,2446,1260,1825,24314,621
37490,16,280,883,251,4371,29
3408,11,225,1441,139,7504,86
47699,49,1072,730,816,23572,256
37246,374,13263,889,10696,76765,2567
64789,23,335,221,254,5553,81
25545,49,1112,1133,704,6608,408
26501,1228,28489,1112,18982,112801,9507
40006,18,331,834,229,6418,102
64353,11,150,234,111,4809,39
45353,81,845,759,700,20989,145
50707,3,15,657,10,1909,5
21349,111,1183,1210,835,19073,348
17205,9,776,1284,566,28392,210
58496,164,1283,421,981,14241,302
34019,9,446,969,309,5607,137
37936,21,583,871,475,21274,108
924,24,1008,1462,736,16037,272
19468,93,3373,1244,2346,20918,1027
59774,1785,51560,376,38042,157759,13518
54188,5,71,551,39,6326,32
67377,186,2993,145,2579,21480,414
23964,151,3013,1168,2080,27494,933
61350,72,1828,321,1436,36331,392
57046,5419,122528,465,85083,312370,37445
23576,20,733,1175,603,11774,130
26168,41,1393,1120,1147,10835,246
37341,131,2712,887,2429,39882,283
68543,16,180,107,148,3463,32
64196,211,3215,238,2619,11798,596
7412,4,176,1392,108,8044,68
25651,25,672,1130,409,9832,263
12533,47,1346,1353,740,34566,606
57928,9,211,441,159,4273,52
49092,61,975,699,878,15198,97
51276,4,112,641,94,14927,18
61943,7,47,303,38,3069,9
19498,14,526,1243,424,31296,102
19240,52,2821,1248,1971,31754,850
64414,5,68,232,59,2698,9
47605,27,435,732,394,6053,41
67007,720,11469,157,8853,93937,2616
10808,36,1039,1369,631,9413,408
57463,51,754,455,534,20813,220
15772,19,853,1308,581,22851,272
12640,42,2343,1351,1240,19885,1103
34249,62,1242,965,844,22956,398
52277,689,9721,612,7658,56251,2063
63417,27,861,262,683,11455,178
53281,56,867,579,700,7848,167
32865,897,21367,991,14735,139378,6632
41440,32,263,812,205,4876,58
42462,28,294,795,209,9159,85
41391,4414,70744,813,61252,305761,9492
9553,2157,45131,1377,28646,118938,16485
28432,129,4347,1071,2871,46383,1476
29249,18410,298096,1055,206815,1156088,91281
22643,120,1799,1191,1244,38555,555
15245,82,1499,1316,1077,34939,422
16590,11,176,1295,129,7026,47
15792,15,686,1307,456,16537,230
6643,25,968,1402,619,20916,349
27671,5,99,1085,67,2877,32
59839,13,114,377,81,4658,33
65402,11,167,204,110,4383,57
5820,13,747,1412,578,10520,169
33784,1292,26819,974,19099,200427,7720
61697,52,1039,310,845,11336,194
34261,87,2690,964,1873,37314,817
50325,432,5679,666,4360,51613,1319
13325,67,4190,1342,2680,49676,1510
16561,8,518,1295,362,16028,156
56724,146,2900,474,2465,26279,435
53085,23,275,584,197,8806,78
27863,9,588,1082,351,10669,237
61477,75,1197,318,950,8173,247
60389,1743,25284,357,20188,184284,5096
54276,109,1207,548,962,15850,245
11921,20,804,1359,481,42510,323
9547,10,663,1377,420,12536,243
23980,21,354,1167,293,31013,61
13584,16,1212,1338,756,48868,456
53993,19,257,558,189,8058,68
20479,198,3922,1226,2927,23780,995
61955,47,395,303,318,9357,77
26528,75,1509,1111,783,16459,726
23324,150,4452,1180,3115,85091,1337
19317,33,1080,1246,728,12046,352
4490,31,3169,1429,2137,24809,1032
34778,72,2282,952,1526,25971,756
60053,7,191,370,146,4304,45
15240,15,647,1316,497,18098,150
37833,70,1671,874,1297,18039,374
273,124,3018,1467,2116,12627,902
51928,7,91,623,68,2780,23
23904,850,21065,1169,13255,119394,7810
20640,46,1267,1223,930,20525,337
49175,167,1818,697,1488,16871,330
22496,3355,77753,1194,57765,416799,19988
10375,66,2000,1372,1216,45199,784
35305,4002,82436,939,56932,327351,25504
56088,53,1025,492,871,18011,154
26298,47,961,1116,637,13205,324
45606,162,6048,757,4239,39146,1809
22850,3,343,1187,239,10321,104
19044,13,415,1251,276,9338,139
2046,351,7891,1454,4519,85513,3372
15263,36,1137,1315,788,28425,349
17524,298,13388,1278,8141,83521,5247
16000,2007,30773,1304,17081,283274,13692
65973,210,4098,190,3152,11120,946
2642,60,2589,1449,1744,31343,845
17131,0,0,1286,0,6843,0
66996,0,28,157,16,2479,12
57723,24,196,447,165,8619,31
50428,8,123,664,103,16655,20
37832,74,1261,874,842,11313,419
53780,6313,117278,566,89648,466784,27630
52219,10,221,613,178,5947,43
8186,295,5165,1383,3313,16826,1852
4303,11,496,1432,374,13972,122
40560,11,156,826,125,8594,31
26586,7,446,1110,269,7943,177
19598,49,1395,1241,980,28038,415
15040,10,660,1318,364,8099,296
48497,256,4121,713,3371,37940,750
2849,57,1861,1447,1381,36103,480
66113,765,9792,186,7953,50897,1839
55759,53,1030,502,796,7917,234
66794,0,273,165,192,7114,81
38388,37,657,859,513,10183,144
62065,93,1078,281,902,8830,176
37014,13,312,896,253,6801,59
64268,82,565,236,491,6335,74
66667,0,14,169,10,2302,4
68561,897,10198,106,7996,33136,2202
6262,143,2330,1407,1469,88296,861
29145,5099,145410,1057,93419,328281,51991
60717,28,432,345,293,7761,139
27158,5,384,1097,234,11311,150
18620,0,0,1259,0,9903,0
23317,157,4766,1180,3285,30307,1481
58430,28,307,424,231,11670,76
67960,22,240,127,201,7582,39
59023,25,199,405,154,4670,45
31598,188,2547,1012,1636,10522,911
31747,34,805,1009,530,17919,275
17373,1,70,1281,55,6324,15
26566,101,3165,1110,2256,52593,909
57037,14,362,465,287,4651,75
65624,41,708,199,598,13220,110
37390,28,730,885,583,17230,147
40732,93,1043,823,838,18483,205
56150,18,339,490,245,11765,94
66735,24,328,166,246,5756,82
63560,56,550,259,488,10396,62
14846,94,1663,1321,1028,8394,635
29602,39,1111,1049,686,23413,425
17979,27,892,1269,621,17322,271
68086,10,184,123,131,4127,53
35611,8031,196850,932,136125,531536,60725
5747,80,2376,1413,1779,20251,597
24729,16,534,1150,460,17799,74
2254,232,3450,1452,2122,39852,1328
57612,4512,60236,451,45775,201318,14461
67351,9,62,146,47,2266,15
28023,303,9422,1078,6145,77631,3277
24495,2473,75836,1156,47004,459204,28832
29309,137,2202,1054,1531,24979,671
15516,22,599,1311,400,13261,199
19252,354,5274,1247,3283,39750,1991
9748,29,718,1376,511,13743,207
26078,15,411,1121,251,9381,160
52385,1,73,608,40,2389,33
22501,329,6869,1194,4820,61967,2049
60085,690,9670,369,7351,33169,2319
28796,499,6133,1064,5274,77648,859
27624,37,1076,1086,624,15269,452
64023,79,3008,244,2133,26169,875
51480,85,1595,636,1383,73880,212
3460,1132,33846,1441,21738,141428,12108
61747,24,267,310,232,4223,35
56905,127,2399,468,1805,18659,594
38572,703,10661,854,8293,71768,2368
20685,25,744,1223,529,12100,215
33409,10,525,981,302,5554,223
34282,8,448,964,278,8717,170
26612,0,0,1109,0,3109,0
28551,562,14427,1069,9994,73692,4433
21031,16,421,1216,296,11725,125
5175,98,4226,1420,2864,42360,1362
15175,92,3025,1316,2051,40093,974
16425,2,137,1297,104,5765,33
56122,57,782,491,569,11789,213
7055,6,233,1397,131,9419,102
3138,6,204,1444,145,22911,59
36898,607,11529,900,9171,96805,2358
36843,3145,53460,902,37830,253545,15630
50330,6,90,666,70,5811,20
11906,12,485,1360,250,6451,235
30565,43,2702,1029,1642,21873,1060
243,187,7487,1468,5138,54954,2349
31407,34,949,1015,653,24429,296
35083,10,271,945,141,4462,130
56186,8,78,489,59,3995,19
68092,0,33,123,20,2916,13
24288,747,46041,1160,29273,81030,16768
54439,18,134,542,108,6436,26
23863,28,591,1169,418,8582,173
24334,100,3730,1159,2486,19045,1244
22779,22,1113,1188,711,15802,402
60788,797,8605,342,6827,54168,1778
35737,0,653,930,508,3353,145
53346,44,512,577,393,13906,119
28784,29,914,1064,565,17563,349
4157,104,2730,1433,1919,57630,811
233,107,3550,1468,2166,28633,1384
49159,62,1331,697,927,19781,404
7530,20,664,1390,416,12740,248
37492,38,916,883,725,24944,191
26859,14,438,1103,342,18972,96
65882,166,2682,192,2032,16312,650
53565,604,7160,572,5988,51446,1172
847,144,6844,1463,5143,66045,1701
49888,695,9041,677,6590,38115,2451
53035,228,4525,586,3178,48438,1347
25930,27,592,1125,405,20253,187
15457,35,1773,1312,1259,16880,514
22880,8,240,1187,176,9810,64
4466,129,2944,1430,1949,54961,995
31793,405,7656,1009,6247,45833,1409
61501,29,456,318,349,7417,107
57097,7,62,463,40,5002,22
4290,62,1302,1432,861,15990,441
45804,14,116,754,101,6315,15
1503,20,709,1458,533,25454,176
37393,20,391,875,312,15456,79
37647,77,897,879,709,16314,188
19689,66,1178,1240,717,12404,461
22823,101,2150,1188,1259,13802,891
67087,97,1356,155,1122,18747,234
28851,8,139,1063,130,11505,9
59410,42,681,391,542,8275,139
37784,10,168,875,123,2479,45
26150,28,634,1120,375,10924,259
2208,65,2382,1452,1752,35798,630
43141,37,902,784,717,10288,185
34935,1360,45393,949,31760,211120,13633
67341,15,279,146,186,4719,93
28777,4,213,1064,139,10137,74
50930,2439,53832,651,42202,350803,11630
65183,7,69,209,62,5501,7
6199,133,3741,1408,2615,26975,1126
13861,33,2028,1334,1329,19408,699
12833,0,58,1349,23,6834,35
15020,598,13898,1319,9662,66966,4236
29262,4,209,1055,128,14449,81
36062,61,1085,921,807,6646,278
25131,1038,28411,1141,19213,86409,9198
17981,811,10918,1269,7980,87840,2938
8425,73,2265,1382,1396,18076,869
26347,84,3928,1115,2163,24860,1765
44654,218,2913,767,2555,22264,358
57485,15,109,454,85,3550,24
29451,13,382,1051,312,11243,70
34150,2639,45058,967,29268,178728,15790
52733,1672,21175,595,16960,82963,4215
26127,158,4026,1120,2090,15970,1936
34824,0,19,951,15,3920,4
58967,20,195,406,174,10542,21
26639,21,442,1108,275,12389,167
12693,3230,126397,1351,61743,745913,64654
46836,89,1336,742,921,9319,415
38418,13,131,858,107,5734,24
44199,113,1809,771,1595,19171,214
36876,149,1777,901,1451,18765,326
29667,62,1889,1048,1315,26502,574
4190,124,2881,1433,2063,23788,818
16890,77,2344,1290,1624,28064,720
1394,7,334,1459,248,20605,86
54058,513,5758,556,4555,45766,1203
50781,124,2984,655,2036,13638,948
58416,81,889,424,721,31365,168
52630,1841,22874,599,17433,162421,5441
15926,104,2202,1305,1609,16034,593
60745,16,149,344,129,6351,20
3471,900,32646,1441,19485,237666,13161
30286,14,278,1035,178,6100,100
43285,11,455,782,346,12368,109
13101,385,28730,1345,15547,152955,13183
27896,65,1916,1081,1298,19782,618
21146,21,432,1214,256,8360,176
51459,111,1149,637,962,14721,187
67158,27,536,134,373,20861,163
58927,93,2120,407,1620,26672,500
35874,28,392,926,270,6136,122
31685,3551,84353,1010,49495,247678,34858
10248,7,460,1373,290,7443,170
23613,207,3588,1174,2407,79090,1181
66277,35,449,181,355,5767,94
12948,60,1592,1347,908,21132,684
6246,42,5074,1407,2998,18385,2076
2737,123,3242,1448,1907,23611,1335
49917,8,161,676,137,4437,24
26199,20,568,1119,394,25405,174
54198,268,2315,551,1948,18461,367
56926,335,6143,468,4825,65263,1318
32057,947,18650,1005,14294,158902,4356
45621,12,190,757,150,5358,40
11659,55,3472,1362,1791,64376,1681
17347,88,2911,1282,2102,61160,809
52612,18710,464319,599,357680,1298579,106639
2411,591,20529,1451,15196,56926,5333
36424,317,3981,911,3290,37069,691
21468,15,401,1208,348,26747,53
17783,47,1898,1273,1426,51538,472
66714,3,77,167,66,4763,11
45616,1,34,757,31,3180,3
24576,55,644,1154,571,41719,73
62199,13,235,294,149,8039,86
36832,306,6762,902,4742,30816,2020
25464,50,899,1135,845,12768,54
22104,108,3493,1199,2180,33669,1313
59123,10,128,401,92,3282,36
37046,393,8221,896,6088,47588,2133
35100,90,1572,945,1075,13251,497
66862,8,144,162,99,3728,45
16601,109,2285,1295,1573,16914,712
34055,44,1002,968,716,30931,286
23391,10,547,1178,407,25981,140
2700,25589,846279,1448,573938,2785675,272341
27492,916,13264,1090,9402,104525,3862
49320,18,487,692,394,3092,93
16786,67,1501,1291,1012,39460,489
6538,905,32320,1403,18611,82942,13709
3131,136,5418,1444,3950,72191,1468
984,62,4541,1461,3112,74835,1429
40996,77,1078,818,851,17731,227
36895,21,301,900,245,6195,56
2372,6,274,1451,194,29316,80
14573,3,303,1324,209,13767,94
22913,14,431,1186,321,4844,110
10396,79,4595,1372,2920,76585,1675
13344,27,667,1342,382,8195,285
20808,10,190,1220,151,6931,39
47907,16,139,728,111,4285,28
36778,1,332,903,283,14216,49
65039,81,1451,212,1228,20395,223
64918,220,5126,217,4117,25624,1009
55243,66,582,516,503,11888,79
51045,270,3977,648,3192,70998,785
12615,13360,350882,1352,218636,993580,132246
23193,27,580,1181,483,40803,97
67249,348,18534,144,13747,52704,4787
12744,272,8363,1350,6191,55820,2172
56640,296,5457,476,4391,37309,1066
32212,244,3674,1003,2557,18943,1117
68686,1,34,102,22,831,12
32477,63,2360,998,1748,57795,612
35105,145,4221,944,3304,54723,917
13646,4788,130143,1337,77968,655502,52175
38439,34,1059,858,839,22517,220
43155,357,5632,784,4574,44770,1058
32870,67,2050,991,1364,30769,686
57492,12,194,454,127,6711,67
40976,6,72,819,59,8036,13
23045,40,643,1184,476,22073,167
501,22,935,1466,714,26929,221
2592,8,382,1449,263,9538,119
40766,3,84,823,67,4497,17
29889,198,3392,1043,2480,29841,912
61730,55,473,310,399,8040,74
11348,13,803,1365,456,16189,347
22738,30,727,1189,522,6183,205
29902,13,346,1042,220,26112,126
18109,10,316,1267,244,12193,72
2127,633,15861,1453,11396,86727,4465
30428,65,1992,1032,1204,22735,788
38020,2008,41439,869,29382,355892,12057
52203,69,703,614,550,15999,153
5399,7,273,1417,206,32178,67
17375,1,19,1281,17,4243,2
17937,21,440,1270,301,7916,139
20709,184,3021,1222,2038,27681,983
16405,192,7726,1297,4767,38879,2959
34254,15,576,963,396,4701,180
49218,33,427,695,254,8737,173
63139,6,54,269,43,5326,11
19708,21,973,1239,720,37336,253
35947,1,87,924,63,7448,24
3203,69,1614,1443,1157,100539,457
4650,447,18086,1427,11463,95361,6623
4944,12,249,1423,165,21218,84
53103,33,347,583,275,5647,72
34166,95,2699,966,1896,29450,803
51474,87,960,636,638,6831,322
64163,12,92,239,72,10009,20
32074,35,1082,1004,622,12614,460
21323,38,954,1211,649,12062,305
21508,98,1326,1207,876,7372,450
68736,32,297,101,266,5121,31
48963,30,549,697,448,11627,101
18408,106,2314,1262,1606,23458,708
67850,3,102,130,74,4222,28
64069,810,9762,242,7454,62417,2308
12926,5,602,1348,279,25096,323
3682,169,9772,1439,6578,64639,3194
21233,21,342,1212,226,7452,116
8505,1067,25344,1382,14951,79452,10393
65334,195,4479,206,3904,23168,575
50788,5,155,655,117,10331,38
21219,52,1337,1212,890,45020,447
62196,293,9665,294,7674,54140,1991
33953,23,586,971,383,13289,203
55007,2,21,522,18,2772,3
24738,45,1632,1150,1104,19660,528
38889,30,719,849,571,11981,148
62901,10,172,275,130,3829,42
46445,107,1528,747,1291,18099,237
3721,948,26933,1438,19325,101914,7608
33417,23,346,981,237,5850,109
58021,27,459,438,362,10837,97
60383,0,53,358,46,5854,7
56180,204,3132,489,2141,32144,991
13199,70,1642,1344,1098,24906,544
47673,17,195,731,145,2548,50
54455,102,1111,542,925,12067,186
25239,575,7301,1139,5050,50821,2251
17689,11,564,1275,471,11301,93
24413,31,794,1157,537,18377,257
51642,8,227,631,167,7696,60
16990,2,125,1288,103,11318,22
36907,13,689,900,518,25351,171
29942,288,4087,1042,2676,30025,1411
30579,13,380,1029,250,12672,130
26261,8596,260661,1117,168090,801787,92571
38450,11,168,857,134,6157,34
8231,49,1803,1383,1117,16769,686
34184,147,1619,966,1050,15870,569
61565,14,211,316,137,3008,74
9618,151,5751,1377,3755,53028,1996
31549,524,9097,1013,5942,45492,3155
10568,12,481,1371,312,11742,169
12288,6,217,1356,117,7794,100
20153,11,604,1231,400,7978,204
4836,33,730,1424,513,29954,217
66872,36,415,162,344,4313,71
11837,86,5364,1360,3152,31558,2212
51003,149,1779,649,1341,12618,438
1435,24,640,1458,412,26095,228
64084,6,127,242,98,2511,29
20305,2084,64231,1229,44334,445765,19897
14442,4,160,1325,117,14816,43
37215,91,3023,891,1984,30798,1039
24875,706,25231,1147,15263,173277,9968
58069,317,4378,436,3189,33947,1189
5213,13,355,1419,297,18407,58
38845,16,273,849,234,9701,39
1381,109,2491,1459,1766,27406,725
49873,17,357,678,259,4888,98
2061,1033,29316,1453,18850,266057,10466
21183,394,6160,1213,4512,31658,1648
53553,39,233,573,184,10584,49
7581,119,2225,1390,1440,34087,785
40422,15,151,828,140,3864,11
35708,2405,53922,930,40204,160809,13718
60567,107,1372,324,1085,13594,287
1786,22,638,1456,426,17496,212
67444,9,216,143,82,6895,134
67019,17,155,157,118,3186,37
63072,5,70,271,46,4578,24
31418,19,607,1015,410,16532,197
17194,133,3577,1284,2232,22085,1345
15004,29,1234,1319,824,12583,410
34570,892,28379,958,19754,102612,8625
834,823,22568,1463,14534,138681,8034
40348,435,7038,829,5394,66210,1644
4767,43,1218,1425,859,15277,359
25409,30,1463,1136,980,18320,483
37769,66,629,875,514,12006,115
64515,111,853,228,729,10756,124
25579,104,3281,1132,2039,20353,1242
731,4,251,1463,172,20089,79
47188,8,190,737,161,8832,29
4494,158,4224,1429,3077,20733,1147
31976,5,156,1006,108,5929,48
4726,11,497,1425,369,17699,128
35954,2,47,924,33,1371,14
14513,4644,77110,1325,53666,378791,23444
63835,9,210,250,138,6809,72
65119,97,1597,210,1216,24092,381
15740,192,3632,1308,2538,47371,1094
54406,142,1047,544,866,29126,181
25691,439,8151,1129,4940,82139,3211
36400,1,22,911,20,1769,2
60638,15,145,347,126,6586,19
57866,10,120,442,100,3519,20
64994,118,2368,214,1962,26259,406
23121,435,6478,1183,4656,40327,1822
30000,119,2362,1040,2113,36387,249
8853,94,3922,1380,2316,36876,1606
50790,274,6943,655,5027,33920,1916
19352,10,260,1246,195,22602,65
49147,121,2647,698,2141,35257,506
38525,24,692,855,611,16836,81
57927,9,177,441,146,8099,31
63870,11,177,249,126,4138,51
6595,43,997,1402,647,19381,350
56467,107,1040,481,837,9081,203
16663,38,767,1294,473,16661,294
37846,2918,73021,873,56725,421895,16296
329,1509,119582,1467,78798,412215,40784
26958,7,500,1101,298,7420,202
21176,3,116,1213,76,6140,40
66446,1,26,176,22,2472,4
7417,272,5175,1392,3546,30422,1629
32432,12,276,999,161,10156,115
48375,8723,101630,721,78186,459735,23444
17862,8,191,1272,123,6778,68
61063,4,106,331,83,4509,23
50286,5,48,667,39,3957,9
15689,38,610,1309,377,18702,233
48227,2199,47349,724,33390,220399,13959
10343,556,18745,1372,12633,161408,6112
60241,14,181,362,147,6665,34
36812,1497,33016,903,23098,97390,9918
55923,14,305,497,236,8321,69
35963,12,390,924,293,11119,97
62238,1446,24940,292,17012,86394,7928
59754,29,409,380,308,6409,101
50560,96,1269,660,1028,26895,241
8419,226,8433,1382,5399,37318,3034
33704,4262,90841,975,63554,323411,27287
37225,7,97,890,72,5286,25
5908,13,1051,1411,732,17104,319
33199,863,10296,985,7950,82175,2346
58233,61,801,430,694,18926,107
23352,4059,73804,1179,54133,191675,19671
609,135,6339,1464,3771,50977,2568
49050,248,5136,700,4067,46116,1069
54475,388,5262,541,4052,49840,1210
13168,0,151,1344,78,6200,73
29620,494,10021,1049,7024,47722,2997
53575,173,1565,572,1264,9273,301
44749,10,98,766,78,3418,20
54443,264,4577,542,3641,38479,936
1001,14,926,1461,635,42187,291
6305,5,115,1407,72,5100,43
32456,58,1512,987,982,16740,530
2362,57,2171,1451,1507,16970,664
59797,38,1036,378,731,5964,305
27773,737,24057,1084,14329,89213,9728
7729,242,3980,1387,2700,18512,1280
27678,93,3711,1085,2402,24639,1309
58357,2986,58717,416,40404,440488,18313
57162,854,59589,461,44106,159017,15483
31350,3,107,1015,71,4475,36
65388,123,2249,204,1780,18239,469
67868,13,277,129,176,5354,101
2095,123,5213,1453,3534,88844,1679
67725,6,134,134,111,8147,23
30481,108,1076,1030,853,15215,223
30256,65,1952,1035,1391,18554,561
8014,40,815,1384,544,32250,271
32900,259,3311,991,2291,16367,1020
39025,13,190,847,135,5459,55
9551,99,1887,1377,1151,15788,736
22194,63,1601,1198,1033,12609,568
19613,137,5748,1241,4188,67263,1560
21725,271,10064,1204,6455,100580,3609
25516,2737,54564,1134,36973,166871,17591
37208,26,391,891,255,9844,136
9434,28,1210,1378,762,12382,448
20791,117,1908,1221,1258,20553,650
36442,29,566,910,444,15011,122
37397,17,229,885,194,6149,35
65466,80,1133,203,911,8800,222
29434,31,454,1052,340,13496,114
16718,185,5698,1292,4010,30715,1688
54640,36,471,534,432,11746,39
12867,7,255,1348,151,4115,104
25126,7,198,1141,178,10732,20
65333,34,242,206,202,3513,40
55483,1,97,509,67,3691,30
4613,371,9161,1427,5736,64473,3425
68055,14,191,124,158,8053,33
57856,299,3564,442,2866,42454,698
37600,3,126,880,97,5159,29
56144,14,178,490,136,7005,42
29417,19,550,1052,318,7521,232
56092,10,124,492,105,8094,19
49668,4,89,683,67,5655,22
25973,4,273,1123,175,15709,98
58231,19,200,430,165,7898,35
61775,22,270,309,216,8777,54
63684,12,162,255,127,5053,35
9274,59,2983,1379,1878,19689,1105
36906,245,4198,900,3250,27286,948
21933,1788,27796,1201,16989,129197,10807
9487,31,797,1378,478,17411,319
18146,101,2030,1267,1350,25652,680
5366,133,10919,1417,7257,48004,3662
8399,403,11178,1382,8022,130361,3156
33968,1052,23953,971,18541,111506,5412
55570,32,275,507,260,8544,15
17735,31,963,1274,659,12722,304
39111,43,488,846,311,14205,177
14979,11,533,1319,348,15613,185
54881,27,261,526,194,7120,67
22439,48,1534,1195,1079,24004,455
7701,20,667,1388,449,27450,218
25212,3,172,1140,127,6733,45
23420,56,1795,1177,1337,40092,458
31445,16,215,1014,147,10495,68
40508,9,319,827,243,11146,76
17815,13,396,1273,321,11347,75
39872,713,10200,836,8368,128009,1832
63792,9,214,252,147,5130,67
50304,123,2181,667,1624,11572,557
67159,44,497,152,396,10821,101
5203,279,5398,1419,3677,28761,1721
58098,17,186,435,145,4489,41
59501,173,2328,386,1893,18507,435
24883,278,3585,1146,2378,41829,1207
8175,101,1297,1383,802,6802,495
66363,40,684,179,433,3788,251
29968,696,7305,1041,5185,23031,2120
15019,84,1790,1319,1337,28889,453
66965,9,205,158,183,4646,22
50220,83,1506,669,1133,19029,373
28270,71,2195,1074,1367,16735,828
25081,226,7666,1142,5380,55849,2286
56950,234,11463,467,8928,50714,2535
6097,40,694,1409,466,18052,228
1299,635,9878,1459,6889,50887,2989
55888,75,1366,498,1153,13462,213
50165,0,378,670,294,4124,84
12636,23,1765,1351,903,14602,862
24932,9,356,1145,257,10150,99
52502,115,2757,603,2232,52787,525
50885,84,1752,652,1374,20668,378
58649,99,897,416,726,12581,171
49282,16,246,693,186,8297,60
1460,167,5122,1458,3374,84328,1748
31998,91,4261,1006,2845,16599,1416
30131,222,7816,1037,5358,47471,2458
30618,5,91,1028,71,11758,20
46650,2103,30418,744,24222,249309,6196
36909,64,1797,900,1565,33128,232
15118,40,730,1317,527,9892,203
32077,124,5957,1005,3979,37685,1978
67236,0,19,150,17,1145,2
18490,56,1798,1261,1255,13652,543
20037,110,1972,1233,1337,34422,635
20642,29,652,1223,476,9651,176
10674,9,271,1370,173,13996,98
14630,2861,55694,1323,40310,283667,15384
17416,49167,1144461,1281,711948,2516389,432513
34617,259,6125,955,4103,49758,2022
54670,161,2832,533,2188,18195,644
35600,9,229,932,172,15446,57
62580,850,9899,283,6970,82681,2929
36294,64,1497,915,1297,19854,200
26675,47,943,1107,795,7711,148
10801,75,2336,1369,1463,10157,873
39789,450,6864,838,5283,32126,1581
8461,272,6914,1382,4251,75808,2663
57299,47,644,458,523,11077,121
47092,16,199,739,120,11233,79
10583,14,857,1371,571,9684,286
13698,75,3078,1337,1873,25252,1205
9636,18,1523,1377,931,13229,592
11098,72,2110,1367,1460,17151,650
30340,612,12232,1033,8672,64619,3560
29408,12094,389502,1052,222354,1346096,167148
21579,62,2748,1206,1614,35005,1134
17967,128,3776,1270,2772,108260,1004
63735,26,218,253,175,12438,43
6131,216,6553,1408,5075,82324,1478
52519,66,912,592,780,16637,132
52642,44,691,598,613,17915,78
57207,55,897,461,747,8538,150
18687,132,3339,1257,2279,37242,1060
34749,225,6527,953,4873,67934,1654
49084,3862,56323,692,45439,225201,10884
60322,14,223,360,178,1952,45
61752,1368,29147,310,23222,133315,5925
55320,133,1514,513,1354,17845,160
31232,44,2282,1017,1416,33122,866
62499,13,120,286,97,3456,23
7707,547,24129,1388,15723,85246,8406
23398,213,5073,1178,3589,55293,1484
24160,2133,38063,1163,25900,110641,12163
15396,221,4635,1313,3415,70133,1220
65618,18,231,199,185,5219,46
53067,2316,48070,585,38276,181997,9794
11011,352,8865,1367,5186,51821,3679
53755,67,668,566,552,17423,116
15677,2,188,1309,145,7706,43
14519,419,6120,1325,3708,38914,2412
15765,192,4679,1308,3314,35435,1365
49345,50,755,691,569,22321,186
49216,16,368,695,297,8949,71
49894,38,458,677,409,13046,49
12808,798,16511,1349,10571,77279,5940
14552,13,424,1324,313,10869,111
25634,117,4523,1131,2863,61045,1660
16622,45,1686,1294,1135,26536,551
34621,35,641,955,446,13355,195
61327,19,241,322,192,5407,49
49770,1678,14315,680,10421,72818,3894
38339,36,572,861,394,6359,178
36281,29,283,915,220,5688,63
58788,1,37,412,24,3715,13
38193,151,2091,864,1446,14192,645
35555,5,103,933,80,6907,23
67855,7,196,130,119,4005,77
59385,33,486,392,381,15784,105
57386,5,33,456,23,4979,10
27424,6,232,1091,118,14179,114
26488,179,4705,1113,2929,41774,1776
27072,9,329,1099,230,9881,99
48756,7,52,710,42,3985,10
48080,78,996,726,806,17340,190
58447,81,782,422,694,13328,88
60308,27,340,360,257,4927,83
33933,31,364,971,272,17054,92
313,215,12120,1467,8031,120698,4089
55835,7,39,500,24,3259,15
1295,354,9723,1459,6668,84254,3055
60819,46,1115,287,860,25776,255
17443,0,0,1280,0,3548,0
29244,31,813,1055,523,7993,290
10276,13,994,1373,581,15409,413
14541,153,3379,1324,2457,41492,922
62873,10,154,276,112,7234,42
12154,18,781,1357,446,15055,335
63632,11,167,256,129,3905,38
58573,11,124,419,100,4644,24
34016,57,1085,969,590,26830,495
6287,5,223,1407,167,7330,56
4357,491,14022,1431,9702,86591,4320
22990,72,1814,1185,1374,54390,440
3539,22,428,1440,331,10410,97
2868,101,4902,1446,3321,132231,1581
62681,132,1571,280,1256,21767,315
34326,436,5548,963,4376,63917,1172
23419,26,1212,1177,892,14570,320
21924,10,266,1201,187,39653,79
48489,23,269,719,193,8802,76
34990,28,392,947,351,15721,41
54727,18,183,532,111,3725,72
68236,19,671,118,379,13434,292
10410,200,7111,1372,4566,75932,2545
60573,15,85,350,76,3891,9
62345,6,87,290,69,7207,18
29355,238,4268,1053,2562,34599,1706
26480,15,381,1113,240,7716,141
28977,27,748,1060,482,3819,266
55779,46,433,501,309,15846,124
55638,125,3274,504,2089,17338,1185
59972,43,797,372,562,12530,235
24876,8,386,1147,315,6688,71
5855,32,1085,1412,790,15616,295
1601,10700,839573,1457,428476,3743958,411097
43153,238,2185,784,1713,14402,472
23244,423,7339,1181,5360,54213,1979
48315,1050,19353,722,14885,90806,4468
60786,2350,39488,342,30368,232889,9120
52293,1,39,611,28,4980,11
25755,13,322,1128,206,12273,116
9185,2868,96336,1379,64700,275559,31636
56293,9,196,486,132,4855,64
13326,25,736,1342,466,12964,270
67638,82,882,137,690,13921,192
1195,41,1685,1460,1140,15625,545
29004,19,257,1060,201,7279,56
58242,417,12037,430,8092,41680,3945
35447,1,87,936,68,4440,19
67570,55,1024,139,816,11013,208
19971,118,2996,1235,2254,22195,742
36223,32,576,917,472,4833,104
14320,3171,80361,1327,56765,277631,23596
1356,354,8129,1459,5382,50137,2747
14737,90,1919,1322,1459,22811,460
29934,456,11061,1042,8308,85935,2753
9199,35,1708,1379,1153,17976,555
54595,50,495,536,427,15921,68
30866,437,9239,1023,6871,51129,2368
23138,33,1369,1182,1112,20470,257
36157,18,196,188,146,8466,50
59392,75,926,392,705,15126,221
19008,487,15596,1252,9274,42659,6322
62366,55,710,289,574,11783,136
18358,40,1585,1263,1104,10369,481
68468,13,175,110,135,2673,40
1328,202,3029,1459,2107,29785,922
44429,22,319,769,231,5072,88
38510,564,16522,856,12449,82784,4073
23631,6,520,1174,351,9718,169
25559,5,322,1133,215,8190,107
15629,143,3952,1310,2522,38779,1430
36070,50,756,921,585,37555,171
58384,6,40,425,25,5639,15
11543,3454,140963,1363,80285,504169,60678
47227,51,877,736,723,29309,154
11096,48,1468,1367,930,7824,538
53408,20,254,575,200,7561,54
32770,14,371,993,242,11791,129
11347,31,1051,1365,619,14213,432
43445,25,338,780,295,9447,43
66336,43,811,179,578,8619,233
28397,13,800,1071,443,10204,357
64482,75,1274,230,969,17789,305
12786,28,988,1349,512,7345,476
44133,104,967,773,811,22935,156
14912,106,3604,1320,2507,53647,1097
28578,33,884,1068,561,11716,323
34855,55,1247,950,789,12958,458
52880,14,299,590,209,9155,90
24429,269,7108,1157,4608,32273,2500
19471,118,2782,1243,2223,61923,559
2668,33,1176,1449,809,32655,367
44623,1831,26012,768,20120,113333,5892
32166,10,314,1003,203,5561,111
15368,14,930,1314,668,26671,262
20563,17,756,1225,556,20881,200
19318,410,12610,1246,8699,149846,3911
10629,109,3136,1370,2134,37741,1002
5323,20,497,1418,314,21547,183
12061,5,272,1358,136,5448,136
17886,88,4865,1271,3195,51686,1670
68599,19,270,105,217,9264,53
11385,535,21191,1365,13752,154748,7439
27234,2,120,1096,82,144558,38
59755,66,677,380,571,9657,106
63629,6,82,256,58,3235,24
52861,44,407,591,339,5069,68
59850,22,383,377,324,14867,59
26861,9,411,1103,206,9697,205
3348,9,298,1442,224,29024,74
68955,52,457,93,393,6980,64
40721,85,1581,824,1234,18950,347
3594,119,3386,1440,2284,46176,1102
15952,34,934,1305,756,10162,178
58609,20,225,418,188,12165,37
3358,196,10826,1442,7117,105920,3709
25924,481,17730,1125,11499,83793,6231
183,753,22326,1469,13485,99178,8841
20345,880,18348,1228,12791,52529,5557
3279,56,1041,1443,746,35020,295
60078,12,138,369,117,8307,21
51263,1506,26299,642,21759,117794,4540
51087,1064,13828,646,8832,74360,4996
19933,434,11227,1235,8283,49327,2944
3512,78,1897,1440,1339,76868,558
49378,4,27,690,25,2564,2
58071,40,381,436,287,8051,94
1594,23,417,1457,281,11439,136
18716,16,417,1257,319,33398,98
18534,6,543,1260,384,10118,159
8432,47,878,1382,553,12441,325
58110,2271,27556,435,21903,119038,5653
55299,103,873,513,741,8651,132
24244,110,1686,1161,1154,29524,532
67468,21,446,141,364,6161,82
15659,935,32351,1309,23253,157966,9098
49471,183,3763,688,2589,43827,1174
53843,25,343,563,314,15674,29
10099,34,494,1374,309,5465,185
7336,7,340,1393,207,13528,133
24779,239,5350,1149,3357,52042,1993
54217,153,2806,550,2197,38798,609
39742,1201,21537,838,18515,132407,3022
58716,169,2304,414,1810,17123,494
65670,97,1583,197,1399,9971,184
58563,122,1461,419,1073,14407,388
30534,70,1415,1029,1196,28203,219
60336,25,243,359,195,7343,48
2664,41,1267,1449,855,29145,412
49000,15,258,702,185,4899,73
22362,147,9481,1196,5710,83760,3771
28911,2,147,1061,89,9591,58
63397,4,37,262,33,2594,4
53173,14,107,581,77,3690,30
69027,4,60,90,48,2780,12
23664,680,23348,1173,13684,65531,9664
12254,7020,122366,1356,75317,271610,47049
3009,14,385,1445,267,7488,118
59864,80,450,376,352,6292,98
66149,22,580,184,476,5917,104
48757,32,811,710,607,12494,204
65570,65,1157,200,979,9316,178
50410,150,3734,664,2858,29583,876
36858,92,2101,902,1577,18355,524
56317,134,1655,485,1341,13160,314
30173,337,5471,1037,4142,28422,1329
8247,61,1613,1383,1068,22815,545
52988,184,3621,587,3037,38657,584
24552,28,674,1154,553,27834,121
41364,25,285,813,215,13058,70
10337,72,2065,1372,1373,18040,692
23805,490,6894,1170,4754,58816,2140
46580,6269,127945,745,95966,789165,31979
7234,142,4148,1394,3008,30113,1140
40786,80,1408,822,1140,15843,268
30693,91,1346,1026,964,9160,382
4526,145,3967,1428,2678,32967,1289
970,5,309,1462,201,12248,108
5983,15,345,1410,267,12815,78
13522,187,5403,1339,3398,42401,2005
41335,2166,46992,812,30894,116173,16098
66811,0,12,164,9,2531,3
11074,1262,61214,1367,34417,256135,26797
64303,961,19142,235,15176,121450,3966
3613,248,14663,1440,8883,138990,5780
9268,4,187,1379,134,6999,53
17202,4254,84013,1284,46630,230744,37383
3986,48,914,1435,640,19080,274
59577,17,136,386,118,7596,18
2636,7348,233166,1449,129604,436042,103562
107,94,1787,1470,1010,18067,777
55164,26,173,518,160,7716,13
37463,13,317,883,282,9250,35
67900,20,365,129,290,8309,75
67373,35,586,140,483,9172,103
4701,72,1632,1426,1158,28153,474
30001,5,222,1040,145,28056,77
7347,483,19108,1393,8751,94960,10357
54449,58,516,542,480,16403,36
42233,93,3764,799,2116,26147,1648
4149,416,10276,1434,6328,50413,3948
26931,174,6941,1102,4197,38052,2744
20217,601,11904,1230,8316,90571,3588
61809,30,507,192,406,3932,101
659,4,806,1464,605,28386,201
61696,15,108,312,92,6232,16
1126,11,562,1460,419,17862,143
11449,24,1913,1364,1139,17715,774
38077,35,587,867,445,13573,142
63433,0,20,261,14,1530,6
57590,12,109,451,82,5426,27
23115,283,4999,1183,2958,38896,2041
7035,13,481,1397,374,29999,107
49696,115,1535,682,1375,21112,160
3236,37,1968,1443,1224,45640,744
14688,54,1145,1323,789,10075,356
19773,132,3548,1238,2637,55744,911
48692,1,156,712,125,6503,31
12475,299,6492,1353,3895,22893,2597
15309,645,24558,1315,17036,89581,7522
10655,69,2624,1370,1683,31781,941
45268,71,1669,760,1046,13909,623
19200,2,102,1248,71,5064,31
68226,9,157,119,124,5175,33
37694,1,20,877,19,2896,1
35981,12,314,924,234,3552,80
68948,99,1655,93,1295,13464,360
16319,11,775,1299,516,9307,259
31806,38,644,1008,485,8634,159
12383,780,22826,1355,14928,123747,7898
66284,172,2120,181,1655,19716,465
52184,27,304,615,232,5483,72
16127,580,22649,1302,15639,166494,7010
31293,262,2685,1016,1666,19908,1019
17874,13,529,1271,391,11410,138
13315,185,4015,1342,2330,24731,1685
24543,4060,116456,1154,81239,650806,35217
5967,27,966,1410,611,12087,355
51911,8,290,624,225,13606,65
55002,13,87,522,66,6269,21
28250,3,243,1074,147,16173,96
21960,101,3894,1201,2115,50125,1779
32918,137,1417,990,926,16697,491
31430,100,1782,1014,1212,27274,570
10170,2224,63509,1373,41047,214453,22462
26780,54,1583,1105,972,14053,611
4972,10,219,1422,160,10149,59
15685,2,66,1309,43,3984,23
8861,24,1993,1380,1260,48095,733
11160,4,158,1366,85,6151,73
22647,7200,106320,1191,73605,217943,32715
25066,386,7765,1142,5060,46597,2705
61779,4,90,308,75,8666,15
64840,1047,11453,219,9295,59186,2158
59249,85,999,397,824,14525,175
6806,490,12628,1400,8724,42301,3904
7734,62,2193,1387,1456,27471,737
40452,114,1434,827,1064,16975,370
29484,17,228,1051,206,6963,22
62011,5,108,301,88,3194,20
26418,37,743,1114,466,20205,277
23974,1444,29954,1167,20414,156161,9540
14949,30,587,1320,438,18962,149
772,251,8796,1463,6064,37987,2732
42308,5,229,798,176,13424,53
14399,1709,56513,1326,36181,580364,20332
37035,3,248,896,197,9270,51
18064,0,157,1268,124,16990,33
59662,11,88,383,67,9328,21
52194,663,17723,614,15177,69333,2546
19119,27,767,1249,598,29289,169
510,31,892,1465,680,21913,212
22923,68,1999,1186,1270,18804,729
23428,374,11685,1177,7077,74716,4608
17045,613,17708,1287,12206,193979,5502
27937,28,838,1080,538,14918,300
27327,3,115,1093,74,15937,41
48486,60,1075,709,852,25053,223
60962,21,301,335,209,6407,92
42249,14,269,799,192,8993,77
14598,255,4044,1324,2981,29554,1063
18933,20,645,1253,407,8990,238
45355,116,1318,759,948,11806,370
15002,30,1189,1319,878,19160,311
56565,113,2007,475,1767,35519,240
57033,5,141,465,112,11074,29
20937,253,15437,1218,7991,75197,7446
21758,124,3639,1204,2357,34662,1282
54740,398,4607,531,3855,74021,752
8836,53,1163,1380,744,15778,419
64821,232,3854,220,3175,44157,679
55547,30,355,507,316,8447,39
14930,29,977,1320,687,12966,290
16236,318,5959,1300,3250,20770,2709
46538,75,1758,745,1334,30464,424
23257,3,225,1180,178,14265,47
43085,192,2513,785,2044,38449,469
22593,53,775,1192,537,11201,238
42243,474,8261,799,6743,70274,1518
25051,83,1912,1143,1316,27690,596
42410,8,70,796,54,8606,16
67424,13,152,144,119,2769,33
61905,12,189,304,144,5511,45
60837,678,13488,340,10339,56205,3149
34148,626,8549,967,6217,50655,2332
21128,51,1388,1214,1045,19303,343
61631,15,211,313,176,5184,35
50736,54,791,656,608,20104,183
67986,6,43,126,35,2542,8
54279,52,450,548,336,8110,114
61274,8,76,324,60,1921,16
12379,63,2471,1355,1387,28808,1084
27017,43,2273,1100,1417,22596,856
58651,165,1349,416,867,11540,482
17452,49,1348,1280,981,40849,367
6721,120,7435,1401,4560,37762,2875
3564,59,4342,1440,3087,53450,1255
36392,81,1283,911,1120,18290,163
343,17,376,1467,242,14005,134
56282,450,6986,486,5745,40761,1241
3690,21,794,1438,485,19050,309
53940,79,1342,560,1050,10313,292
59332,10,226,393,183,5889,43
26828,101,2306,1104,1415,14256,891
53269,9,161,579,123,7500,38
12339,16,689,1355,413,23426,276
66902,35,775,161,596,6294,179
2521,19,712,1450,517,43882,195
65590,7,101,200,83,7694,18
3652,18,238,1439,184,23467,54
27807,180,5054,1083,3115,46285,1939
55727,11,244,503,162,12110,82
3229,25,1167,1443,856,13649,311
51069,4375,87400,647,67272,225753,20128
62491,240,2689,286,2227,17173,462
57151,95,2224,462,1899,29398,325
67134,57,665,153,520,11945,145
63876,14,275,249,244,9856,31
29582,92,1465,1049,972,13277,493
40328,25,456,830,348,9383,108
29526,535,13829,1050,10055,74917,3774
27907,9,411,1080,395,22824,16
22351,215,9021,1196,7170,83550,1851
6022,41,1333,1410,882,12648,451
60366,8,185,358,147,6573,38
25094,12,350,1142,267,11453,83
2837,36,1021,1447,738,19985,283
453,24,2388,1466,1679,19101,709
22333,1,44,1196,34,5182,10
35243,56,854,941,663,15318,191
33074,16,377,987,243,10573,134
11615,126,2687,1362,1682,33842,1005
18947,19,509,1253,367,10602,142
873,159,11997,1462,8035,105635,3962
22924,175,4528,1186,3212,42000,1316
2083,58,1849,1453,1214,43485,635
23814,220,4266,1170,3072,37453,1194
49622,11,533,684,247,10955,286
9603,21,460,1377,310,6647,150
3214,349,28968,1443,18812,92871,10156
53827,28,465,564,386,11046,79
39541,610,8272,841,6363,54858,1909
8093,329,15069,1383,8944,69619,6125
54778,147,880,530,655,7082,225
23819,4,194,1170,138,8863,56
18991,0,34,1252,29,20339,5
57879,5722,83753,441,61979,287924,21774
24945,7,294,1145,202,7163,92
36356,4220,67784,913,56503,366146,11281
26193,46,1224,1119,751,13081,473
35933,20,328,925,229,7134,99
12040,431,12811,1358,8354,66388,4457
30915,170,2439,1022,1624,31411,815
57788,11,153,445,96,7117,57
16165,7,186,1301,109,4629,77
56910,42,773,468,583,8672,190
39600,230,6118,839,4957,52163,1161
50614,199,2320,659,1952,46924,368
22564,2,140,1192,100,8795,40
61593,526,6669,315,5479,53294,1190
34349,8,145,963,121,4778,24
3072,457,10679,1445,7583,128569,3096
20083,4,164,1232,134,6638,30
56331,323,4192,485,3226,28677,966
35347,16,280,938,191,6222,89
23872,22,1207,1169,801,38762,406
66819,1061,13621,163,10996,70298,2625
35543,14,265,933,197,8230,68
50784,265,3273,655,2437,20852,836
37906,111,2054,872,1529,20339,525
50920,164,2900,651,2011,28235,889
22400,0,0,1195,0,4057,0
21840,75,2213,1203,1289,14451,924
10075,36,1409,1374,973,14279,436
17378,0,116,1281,80,3874,36
2535,1437,71327,1450,42925,359132,28402
57908,167,2131,441,1778,31178,353
58931,42,725,407,459,23720,266
61404,35,493,320,448,13161,45
19654,3,128,1240,109,12414,19
23087,3757,76906,1183,52724,321249,24182
20207,59,2186,1230,1526,26045,660
63414,45,558,262,477,11709,81
47153,37,487,738,421,32639,66
28736,1813,37930,1065,24154,312513,13776
12819,148,4057,1349,2455,43542,1602
54387,14009,200108,535,137882,552157,62226
18130,239,10997,1267,7749,162598,3248
54089,53,749,555,559,34593,190
35799,0,53,928,35,3991,18
58828,134,3196,410,1972,28180,1224
67989,49,857,126,692,8892,165
33817,13,1003,973,754,23816,249
63229,29,236,267,180,12397,56
27246,11,298,1096,238,21365,60
2155,11,561,1453,361,21789,200
11421,43,2928,1364,1687,22228,1241
16760,26,687,1292,476,14010,211
16816,158,3662,1291,2576,29315,1086
31929,10,261,1007,178,8878,83
38265,6,129,863,95,4488,34
62507,5,79,285,51,2164,28
56787,4146,81353,472,53232,460157,28121
193,45224,1481098,1469,722039,2699078,759059
13060,319,12133,1345,8577,80825,3556
10959,7,222,1368,149,14649,73
61842,13,138,307,112,4834,26
26023,52,1100,1122,665,16462,435
53083,550,17958,584,11631,70201,6327
32058,6,169,1005,94,7983,75
34435,42,1261,961,857,20481,404
53296,119,1771,579,1193,16113,578
66694,10,97,168,68,1130,29
8263,84,1093,1383,714,7695,379
41612,9013,130776,809,107277,662703,23499
53947,49,1024,560,695,6756,329
27554,1757,31668,1088,21887,100761,9781
28264,264,5145,1074,3527,26307,1618
43837,256,3532,776,2564,15054,968
36496,12,259,908,202,6879,57
67800,53,524,132,440,5440,84
12403,56,2091,1354,1248,12697,843
68752,29,356,100,290,6845,66
7255,3673,108733,1393,63032,237692,45701
20380,17,813,1228,639,19134,174
41580,872,11490,810,7907,55743,3583
53485,43,1149,574,852,21351,297
53508,36,391,574,331,18156,60
2052,260,4836,1454,3370,70389,1466
2420,260,10284,1450,6664,101011,3620
17288,11,381,1282,301,20226,80
3557,639,15597,1440,9834,111303,5763
41782,22,628,806,479,22930,149
30667,34,1164,1027,807,7415,357
22710,658,11324,1190,6860,65680,4464
12733,11,1061,1350,525,12307,536
12216,4,327,1357,177,9727,150
56224,30,371,481,285,7525,86
18758,18,1714,1256,980,11929,734
21296,5,147,1211,106,5652,41
4409,448,22012,1430,14407,114922,7605
21269,553,22489,1212,13750,123705,8739
56881,17,477,469,409,6698,68
66291,22,425,180,336,19305,89
26463,68,2402,1113,1508,23389,894
49571,25,352,686,284,9137,68
1659,86,4437,1457,3406,64753,1031
63010,30,205,273,162,7671,43
31020,29,1154,1020,675,14375,479
66027,29,469,188,358,10779,111
61411,105,2264,320,1566,16408,698
28406,300,5097,1071,3391,35308,1706
34903,203,3931,949,2816,78434,1115
37453,53,1149,884,821,43269,328
25494,191,3989,1134,2575,36157,1414
59055,46,500,404,397,3795,103
18582,13,324,1259,250,12480,74
15170,16,449,1317,286,19078,163
32925,1,114,990,71,4853,43
49453,69,805,689,586,9492,219
62784,131,4650,278,3669,32196,981
21259,113,4576,1212,3196,36676,1380
36448,1,29,910,26,1676,3
26978,116,3023,1101,1712,28352,1311
38911,36,871,848,628,11085,243
59732,21,156,380,127,2727,29
50709,14,85,657,70,3507,15
13607,505,13671,1338,9302,162691,4369
31573,22,322,1012,269,9136,53
32349,38,901,1000,542,18117,359
39206,7,467,845,351,14528,116
63039,37,1121,272,795,11060,326
9253,8,489,1379,302,15864,187
67074,13,417,155,315,7770,102
12409,24,725,1354,426,14293,299
2285,354,12497,1452,8456,101929,4041
49417,85,1285,689,1156,18838,129
65427,19,139,203,122,8247,17
36932,13,290,899,235,4360,55
30786,104,2005,1024,1301,20626,704
36136,33,775,918,684,10334,91
53155,43,588,582,461,5214,127
49877,622,7177,677,6050,65136,1127
15141,245,7469,1317,5138,36051,2331
13520,685,16826,1339,10528,165637,6298
60259,103,1014,362,829,14467,185
13627,40,1285,1337,781,54674,504
9540,533,8568,1377,5479,41477,3089
33205,73,2956,985,1887,55954,1069
14194,1039,44106,1329,30639,158749,13467
19898,19,808,1236,608,24836,200
64,16,1003,1471,649,18871,354
6026,40,1631,1410,1129,43859,502
36098,0,0,920,0,3103,0
63554,3,76,259,59,6297,17
25040,5,480,1143,306,18171,174
32997,40,1052,989,703,11160,349
39445,24,604,842,480,13844,124
55319,127,2063,509,1735,29031,328
65352,13,105,205,84,3455,21
57854,239,4725,442,3834,47175,891
42356,2491,52653,797,41844,161863,10809
49011,7809,194939,702,151022,452925,43917
68433,11,100,112,87,5807,13
34714,7,133,953,111,5740,22
1560,1733,34890,1457,21975,168433,12915
29807,43,785,1044,703,9652,82
49931,84,1726,676,1241,28279,485
28427,2620,90874,1071,61385,255224,29489
58888,54,556,409,461,9450,95
51219,8,163,643,132,7325,31
55397,33,369,511,280,6976,89
49228,29,1144,695,779,17254,365
50114,34,646,671,411,11145,235
41255,207,3177,815,2502,31558,675
14645,25,1052,1323,715,24521,337
10900,48,1663,1368,1040,11058,623
13355,745,28044,1341,16936,109053,11108
36439,190,3181,910,2373,32602,808
18612,1,152,1259,125,7881,27
2655,74,2531,1449,1836,25880,695
30940,20,505,1022,328,17858,177
27473,132,2349,1090,1412,12150,937
67423,936,25479,144,20504,153338,4975
20569,43,1268,1225,853,35570,415
31553,7,161,1012,95,7316,66
56545,452,3630,479,2867,26108,763
38633,239,3060,853,2452,34350,608
10296,6,386,1373,272,11145,114
17450,121,2329,1280,1890,38330,439
30270,39,1421,1035,1011,12890,410
37730,30,620,876,477,13871,143
20876,55,641,1219,439,11209,202
63323,32,257,264,211,3847,46
26079,15,257,1121,173,9459,84
8808,1499,57528,1380,41309,234734,16219
23414,58,1164,1178,830,17723,334
18132,13,380,1267,330,37774,50
28206,10,268,1075,169,9488,99
13302,114,5476,1342,3208,100930,2268
58904,37,692,408,492,12730,200
33605,265,4300,977,2926,33642,1374
25425,28,1287,1135,868,16997,419
8954,3895,103919,1380,59695,294780,44224
6868,3,96,1399,69,4830,27
12038,41,1666,1358,851,49348,815
57337,80,1367,458,970,16850,397
3318,76,6339,1442,3898,76030,2441
60654,52,764,347,611,8739,153
60977,69,1177,335,885,13696,292
33020,937,17397,988,11668,141474,5729
48395,81,1988,721,1691,39843,297
33421,142,3052,981,2148,16425,904
21167,24,599,1213,456,22566,143
64033,35,299,244,235,3230,64
37509,10,344,882,241,4265,103
32087,19,1166,1004,717,8962,449
31252,231,2404,1017,1564,34795,840
50737,1125,20306,656,16114,110872,4192
37186,292,7559,891,6189,62953,1370
32968,3,34,989,18,4524,16
1518,12,499,1458,296,36767,203
25332,0,0,1137,0,5551,0
19733,181400,5921429,1239,2683063,15242808,3238366
22694,0,0,1190,0,3291,0
49478,42,995,688,737,8697,258
3614,34,2039,1440,1495,60161,544
28609,3,109,1068,63,7905,46
21802,2,158,1203,121,10365,37
17164,6,154,1285,112,12659,42
38649,24077,626782,852,357539,2595202,269243
46339,48,762,749,611,17648,151
12084,71,2658,1358,1425,27186,1233
21015,77,1355,1216,1032,12381,323
29467,462,7899,1051,4959,47481,2940
16533,197,5073,1295,3496,55637,1577
3775,125,4238,1437,2742,84886,1496
24228,93,2268,1162,1633,46565,635
3239,73,1549,1443,1008,26971,541
31910,160,2906,1007,2300,57196,606
60123,109,1625,367,1288,9896,337
54060,18,187,556,138,9982,49
27202,56,2097,1096,1331,20496,766
54076,81,689,555,543,21847,146
15811,109,3007,1307,2152,40662,855
17107,49,1832,1286,1318,27659,514
31663,24,403,1011,266,4631,137
22582,157,7817,1192,5199,53533,2618
4505,28,1216,1429,864,48654,352
5725,136,7148,1413,3621,26472,3527
55873,5,40,499,30,3180,10
51964,9,127,622,100,8007,27
33436,11,196,980,122,4710,74
55667,6,108,504,82,3973,26
59269,415,9742,396,7076,87260,2666
65007,15,116,213,95,3052,21
24689,115,2047,1151,1361,29224,686
54829,149,1919,528,1444,20617,475
36242,81,1811,915,1577,53239,234
55932,7,85,497,76,5745,9
3879,175,10250,1436,6581,99843,3669
16137,271,6391,1302,3911,34241,2480
9484,33,790,1378,487,10779,303
22979,29,1105,1185,776,11598,329
28933,25,370,1061,308,25307,62
12353,16,951,1355,466,9198,485
31683,1812,52353,1010,38502,126519,13851
37176,178,1157,892,890,14648,267
60547,13,133,351,90,2712,43
13006,7,310,1346,164,10715,146
2453,74,2043,1450,1415,23619,628
59310,9,97,395,70,3588,27
13117,619,25224,1345,14722,151495,10502
62671,64,463,281,356,4289,107
29996,110,5040,1040,2855,39889,2185
3157,20,335,1444,249,10168,86
12508,32,863,1353,553,26814,310
61376,9,213,321,156,6185,57
63124,19,493,269,331,10527,162
32739,287,8841,994,6624,40004,2217
38295,27,269,862,230,6443,39
36556,26,701,906,591,13598,110
50785,57,774,655,564,11172,210
34036,13,620,969,356,10898,264
18544,1150,41619,1260,26119,136810,15500
38748,217,3904,851,3248,57899,656
26053,287,11239,1121,8066,67900,3173
65206,119,1588,209,1229,28477,359
66029,21,204,188,181,6243,23
36308,12,305,914,246,8828,59
6805,18,983,1400,645,14857,338
39556,46,1370,841,1075,26858,295
35876,26,672,926,535,25885,137
36352,11,168,913,145,14652,23
5468,260,12958,1416,5797,47713,7161
65176,76,1968,209,1341,24253,627
24126,29,768,1164,572,9080,196
8307,18,969,1383,627,20639,342
13675,194,10454,1337,6656,58641,3798
29315,77,1859,1054,1436,37163,423
33965,1,13,971,9,4359,4
40269,354,6228,830,4645,49353,1583
34823,157,1996,951,1441,31792,555
9613,5,217,1377,151,5460,66
30611,523,12791,1028,9063,90882,3728
52842,73,721,591,565,10978,156
837,38,2296,1463,1724,25817,572
55891,31,163,498,122,3493,41
13191,21,1104,1344,704,16026,400
35992,240,5328,923,4560,26009,768
63365,1911,38837,263,29785,210394,9052
10520,44,2122,1371,1318,22085,804
56036,20,533,494,445,19019,88
64382,50,846,233,691,13986,155
28351,168,2918,1072,1905,26110,1013
50440,9,116,663,106,5412,10
66130,2649,53621,185,44070,222981,9551
13581,865,41315,1338,24061,239813,17254
24710,1044,91884,1150,54983,179688,36901
67871,830,11228,128,8912,52498,2316
13183,64,2815,1344,1518,16472,1297
25712,57,798,1129,546,13293,252
61749,4,63,310,48,2933,15
7512,64,2024,1390,1431,29246,593
22956,5,77,1185,58,3007,19
388,94,3283,1466,2322,54664,961
25652,100,2922,1130,1702,26780,1220
11776,9,210,1361,108,14259,102
50755,46,1168,656,638,20091,530
24213,39,986,1162,721,15631,265
17154,27,994,1285,693,44696,301
56665,1376,18363,475,14800,94127,3563
9858,13,1366,1375,879,14973,487
48632,50,612,713,491,36370,121
52450,7,148,605,117,5086,31
68542,2,17,107,14,3179,3
5237,528,15488,1419,10669,156781,4819
21818,41,1376,1203,1011,19011,365
57804,10,92,443,70,3161,22
10836,4340,176855,1369,100801,420835,76054
68787,25,310,99,279,3083,31
14499,55,2196,1325,1633,24646,563
61295,12,61,323,38,3241,23
41387,20,445,813,370,8237,75
3810,31,1147,1437,829,14672,318
23319,3,140,1180,99,6716,41
23018,144,3421,1184,2629,26797,792
57646,1195,31736,450,25762,152717,5974
61910,579,14640,304,11179,102664,3461
55922,63,781,497,658,9781,123
4920,37,1110,1423,831,32286,279
40735,39,694,823,523,20540,171
10725,26,1070,1370,704,24443,366
18773,17,543,1256,401,11148,142
5076,351,7226,1421,5344,37645,1882
33115,31,771,987,540,14997,231
27381,531,13475,1092,9929,27190,3546
57120,2799,43656,463,30394,196600,13262
57743,102,1629,447,1323,21753,306
5098,44,1561,1421,1047,16795,514
61982,35,638,302,504,14523,134
57014,127,1231,466,1033,15463,198
51570,586,12208,633,9560,122632,2648
61403,16,745,321,589,7806,156
35177,104,1388,942,990,16588,398
24352,5257,153462,1159,100418,337037,53044
23799,197,3449,1171,2430,37083,1019
63237,3,62,267,38,2755,24
13991,19,526,1332,313,13333,213
27269,5,69,1095,60,6118,9
31992,57,1026,1006,749,14960,277
11989,122,4670,1359,2668,37256,2002
30366,33,474,1033,411,8294,63
26915,148,4037,1102,2808,41969,1229
62369,4,79,289,73,3652,6
15751,311,8727,1308,6287,135191,2440
33813,29,657,973,471,13450,186
9777,17,1178,1376,770,14994,408
18276,118,3622,1265,2330,16319,1292
34674,57,1443,955,1009,18268,434
58646,443,5579,416,4506,87756,1073
62599,15,270,283,182,7513,88
33208,10,358,985,238,8556,120
65419,324,6007,204,4852,50758,1155
28253,6,123,1074,81,8184,42
1083,36,2977,1461,2223,86423,754
29068,18,476,1058,291,10918,185
25837,105,1968,1127,1259,16601,709
38063,0,11,868,9,5017,2
40993,17,525,818,414,11722,111
61217,98,1885,326,1431,31643,454
10422,20,1017,1372,617,24881,400
29796,13,245,1045,149,6722,96
27182,803,15219,1097,8983,66059,6236
29769,49,3233,1045,1809,17492,1424
26330,35,815,1116,637,9482,178
68362,645,11726,114,9788,95334,1938
42726,254,3893,788,3149,50264,744
20087,12,363,1232,264,24161,99
66780,3,13,165,11,1398,2
19204,22,709,1248,526,7875,183
3836,319,16780,1437,10916,193930,5864
47158,93,988,737,800,11769,188
28766,40,595,1065,390,10940,205
50713,10,106,657,92,11498,14
54635,32,271,535,237,6638,34
63681,59,1176,255,955,11601,221
13466,2827,106165,1340,74096,213372,32069
3905,19,659,1436,436,37435,223
59515,20,350,388,272,11091,78
8301,103,1144,1383,752,9742,392
30396,260,5505,1032,4740,64789,765
37447,12,285,884,191,13180,94
1389,15,471,1459,338,18996,133
18459,473,8461,1261,5401,73702,3060
37177,843,15891,892,10919,100877,4972
37965,0,0,870,0,3369,0
11162,129,9152,1366,5185,52433,3967
23470,177,3560,1177,2554,21670,1006
54374,14,206,545,144,4426,62
63977,6,108,245,76,4876,32
23267,41,2791,1180,1969,48606,822
57979,1050,21391,439,17470,85027,3921
9865,48,3306,1375,2241,31421,1065
17542,2298,52536,1278,37495,255469,15041
67150,14,397,152,284,8155,113
45847,24,502,754,333,3525,169
9293,11,423,1379,275,11189,148
63617,116,2117,257,1625,21131,492
64190,25,361,239,261,12757,100
27397,17,922,1092,561,10850,361
66000,2,90,189,67,6739,23
5773,370,13147,1413,7934,72482,5213
29187,18,924,1056,495,16590,429
10492,32,1210,1371,856,16100,354
4131,788,15718,1434,9999,131652,5719
9813,77,5885,1376,3986,33562,1899
61333,52,548,322,434,6569,114
55332,130,1255,513,1141,24381,114
24456,596,18649,1156,13249,85833,5400
65128,20,245,210,172,4069,73
64695,53,587,224,478,5618,109
10607,72,2280,1371,1438,24810,842
6455,17,417,1404,307,20604,110
63652,0,17,256,13,1996,4
44666,1924,42425,767,33105,188187,9320
1472,8,377,1458,264,18477,113
22918,32,625,1186,467,15646,158
57477,27,221,455,174,10376,47
3628,113,4922,1439,2796,29297,2126
39030,149,3302,847,2519,23232,783
60906,2672,32974,337,28422,115671,4552
10193,22,682,1373,401,8724,281
29114,446,11871,1058,7755,91162,4116
50511,36,541,661,445,8967,96
68692,128,1608,102,1330,10736,278
13048,3,132,1346,71,3778,61
60637,481,4741,347,3900,30029,841
41495,507,9688,809,8168,107168,1520
2205,14,1286,1452,829,101513,457
34891,24,537,949,380,5598,157
57966,17,241,439,188,5873,53
21320,5,146,1211,98,6040,48
67401,28,654,144,499,14566,155
25578,166,6590,1132,3862,29034,2728
62449,51,531,287,390,6811,141
64364,35,385,233,310,7674,75
22614,434,5338,1191,3249,23567,2089
31052,196,5045,1020,3659,34356,1386
27253,17,672,1095,411,34559,261
52381,12,178,608,157,16768,21
57660,36,634,449,540,11127,94
68666,4,109,103,84,4657,25
64807,151,4619,220,3679,31008,940
47415,11,336,734,263,6429,73
12304,87,3229,1356,2046,49252,1183
25694,60,1226,1129,707,18351,519
58020,7,88,438,81,6300,7
51796,19,398,627,330,6499,68
1437,31,718,1458,536,12151,182
11927,9,704,1359,344,13863,360
9876,523,12107,1375,7302,83705,4805
22354,54,1114,1196,767,15501,347
33922,292,4338,972,3528,27898,810
20662,0,0,1223,0,8477,0
33857,0,100,973,84,8409,16
18880,15,296,1254,175,8651,121
52547,19,178,602,149,2790,29
33945,30,763,971,528,10663,235
28389,0,0,1071,0,11289,0
59323,54,719,394,535,19337,184
30720,48,1250,1026,754,19620,496
30975,26,416,1021,261,5099,155
59233,43,687,398,553,27830,134
25189,55,1835,1140,1244,43181,591
1092,29,1435,1461,928,32289,507
14843,19,422,1321,280,12783,142
41331,54,686,813,576,12051,110
31035,24,842,1020,490,9941,352
45325,1,56,760,48,4866,8
62278,21,225,292,181,2524,44
2926,76,4495,1446,2978,33292,1517
37479,77,1760,883,1251,24868,509
61165,28,715,328,532,7240,183
2163,5,577,1453,401,6711,176
52235,1507,21921,613,16516,93947,5405
5786,69,1990,1413,1318,27373,672
57886,30,198,442,150,11443,48
30049,10,244,1039,161,15170,83
3397,4239,133408,1442,70785,546621,62623
28663,17,373,1066,236,10922,137
24951,2,195,1145,130,7738,65
67746,35,730,134,614,7682,116
64720,33,1114,223,899,26600,215
6353,18,441,1406,324,5758,117
41606,9,85,809,67,5897,18
67831,92,829,131,622,5908,207
1880,58,1217,1455,834,11960,383
27931,412,9608,1080,6264,53020,3344
14740,7,237,1322,153,13927,84
63204,18,330,267,249,8407,81
31190,22,403,1018,254,4195,149
16553,16793,347997,1295,208274,768445,139723
41060,24,449,817,374,7592,75
36149,1,104,919,77,9129,27
57193,66,1425,461,934,8711,491
60912,9,103,337,92,2409,11
17809,124,2298,1273,1759,22987,539
12008,2,221,1359,151,11181,70
1874,1063,34442,1455,22058,155165,12384
30600,178,1350,1028,1006,13446,344
60189,101,1027,365,859,8515,168
66050,50,1315,188,1026,14807,289
68390,21,443,113,360,9180,83
17894,73,1958,1271,1231,15649,727
53120,175,2217,582,1759,23788,458
34345,101,2878,963,2138,38458,740
68918,654,13281,94,11777,103282,1504
58248,14,180,430,147,7457,33
14475,778,17787,1325,14062,139254,3725
22378,0,0,1195,0,2120,0
31003,56,1409,1021,944,11769,465
55956,32,436,496,331,15844,105
43713,23,556,777,462,14245,94
22092,87,2513,1199,1783,23501,730
28899,16231,362104,1062,221137,1088638,140967
5136,26,1352,1420,809,28903,543
9670,87,1666,1377,1006,10556,660
30900,188,2075,1023,1410,29175,665
37619,12,609,879,451,13172,158
20133,237,5927,1232,3384,48093,2543
32981,96,817,989,506,8073,311
30561,15,251,1029,174,6758,77
18158,219,3446,1267,2581,32613,865
59199,53,519,399,409,8152,110
49312,36,2518,692,2156,25453,362
56174,563,8599,490,7258,78903,1341
20279,53,2087,1229,1180,15817,907
1875,11261,398778,1455,277647,2024136,121131
8139,23,1052,1383,648,13748,404
35487,11,205,935,133,3230,72
31605,21,794,1012,518,12047,276
18192,19,934,1266,690,40279,244
1838,3089,92451,1455,57445,187286,35006
60845,51,615,340,501,10302,114
23471,263,7495,1177,4825,61137,2670
61023,33,768,333,569,14628,199
2181,3,95,1452,62,7790,33
32523,587,15542,997,9511,39291,6031
40742,83,1450,823,1207,9541,243
53095,206,3024,584,2626,27941,398
13430,154,2005,1340,1398,16606,607
22466,102,1839,1194,1370,16597,469
46902,1136,21939,741,17708,138176,4231
30745,492,6612,1025,5364,41082,1248
65013,8502,213988,142,168551,801556,45437
36380,4,66,637,44,4727,22
22289,134,1745,1197,1205,13586,540
26471,14,373,1113,246,9725,127
17356,7,319,1281,243,9148,76
62651,4,60,281,42,3252,18
66505,1,50,174,34,2665,16
50312,93,1445,666,1253,23035,192
21810,9,248,1203,193,14867,55
38881,2,79,849,44,4302,35
37168,1,53,892,37,6898,16
9832,34,1465,1376,829,16623,636
33175,26,283,985,214,6535,69
34646,11,490,956,316,5149,174
32474,14,411,998,284,11376,127
50686,64,1193,657,923,21634,270
2892,3,188,1446,123,8114,65
61088,30,296,331,262,6934,34
49868,46,626,678,499,6111,127
13542,390,27744,1339,15238,117466,12506
66755,61,468,166,406,10824,62
30149,63,1966,1037,1603,26457,363
68990,0,12,91,9,2300,3
36271,208,2174,915,1656,43777,518
53859,7,74,563,69,4669,5
34528,37,1167,959,779,15583,388
23557,3433,61399,1175,41149,197769,20250
23393,99,3773,1178,2338,51772,1435
58296,3175,34907,427,27297,140202,7610
18697,329,12931,1257,9108,115634,3823
25585,133,5499,1132,3686,39071,1813
49046,157,2038,701,1555,28262,483
57206,41,776,461,593,29283,183
12079,8,340,1358,185,7193,155
30583,7,407,1029,289,16718,118
61090,3,65,331,48,2826,17
15830,45,1280,1307,901,19371,379
12586,62,3013,1352,1674,36158,1339
56934,5,83,468,67,3178,16
27707,435,19364,1085,10486,114753,8878
32631,64,1513,995,1041,50266,472
8424,51,652,1382,422,10232,230
5202,21,691,1419,500,25993,191
28064,14,534,1078,343,7087,191
1132,60,2334,1460,1690,20144,644
54641,96,1784,534,1341,15102,443
8738,5,179,1381,118,6990,61
25955,26,825,1124,542,13832,283
28112,15,372,1077,229,14719,143
37597,344,5163,879,4190,27293,973
62970,2,19,273,16,3466,3
51773,7,167,627,116,11347,51
20309,71,1711,1229,1183,26954,528
51961,33,623,622,451,14374,172
61273,4,84,324,72,1935,12
17246,75,1911,1283,1408,20277,503
56323,16,268,485,189,8790,79
67965,7,252,126,223,2419,29
31429,80,1641,1014,1064,30391,577
56899,12,96,469,77,4874,19
38749,20,487,851,388,33501,99
28364,20,1157,1072,655,8349,502
8939,495,8165,1380,5538,75684,2627
16159,415,3198,1301,2719,77071,479
57428,65,1529,456,922,25509,607
39326,81,754,843,583,8819,171
32221,22,902,1002,532,12401,370
41027,201,4004,818,3296,40327,708
18783,8,197,1256,161,5350,36
28559,70,2769,1068,1739,24877,1030
53501,2253,25117,574,19888,165140,5229
12872,419,10972,1348,6639,62418,4333
2154,28,641,1453,428,20084,213
11846,38,2880,1360,1450,21719,1430
12543,35,2772,1353,1538,28642,1234
31174,70,1680,1018,1076,25733,604
18918,0,267,1253,197,7203,70
42684,24,415,791,316,8034,99
14996,17,617,1319,419,9044,198
22882,47,1300,1187,924,18347,376
43281,1518,62229,782,49552,217319,12677
38479,2759,41713,857,29685,120033,12028
12340,145,4229,1355,2658,35635,1571
11278,2089,61452,1365,34497,138618,26955
35432,93,1842,936,1383,19963,459
46027,78,1396,752,1103,33566,293
3446,8,329,1441,225,8174,104
63402,12,171,262,124,4242,47
51134,41,638,645,485,5742,153
11128,1684,76189,1366,46820,183778,29369
31414,100,2327,1015,1416,9439,911
63606,27,656,257,382,8857,274
4980,15,391,1422,252,18669,139
27212,2060,58989,1096,40059,252710,18930
21954,4,267,1201,176,5966,91
23763,45,1411,1171,971,29953,440
17395,10,540,1281,414,16869,126
12818,49,1350,1349,804,17690,546
63212,41,530,267,421,7325,109
52117,1595,18580,617,15259,108402,3321
34259,17,1103,964,705,30408,398
20534,154,21399,1225,12505,72365,8894
51438,4,58,637,34,2545,24
22291,97,1943,1197,1629,36116,314
9261,36,1189,1379,739,22078,450
49411,30,311,690,200,5614,111
58984,40,407,406,315,8296,92
36800,39,533,903,399,7159,134
15713,17,364,1309,244,5184,120
22170,0,0,1198,0,743,0
3954,20,1057,1436,761,15019,296
56407,21,375,483,316,8306,59
18564,5,112,1260,70,7165,42
33538,2,114,979,80,5473,34
5875,628,20081,1412,13302,160927,6779
49806,64,716,679,582,13642,134
15779,20,654,1308,459,20665,195
24368,15,427,1158,312,10560,115
15147,425,6509,1317,4687,44986,1822
56260,28,337,487,277,9885,60
3219,58,1290,1443,849,11614,441
27693,4,154,1085,107,2719,47
64201,1808,34011,238,26757,220810,7254
17003,67,1771,1288,1234,12454,537
14752,264,4983,1322,3331,30464,1652
35102,204,4615,944,3372,22918,1243
68756,78,1002,100,817,11521,185
32573,507,7737,996,5692,26407,2045
28989,9,523,1060,283,14902,240
37531,65,668,882,546,14137,122
36831,53,624,902,529,9856,95
66480,38,459,175,360,4052,99
18237,146,6630,1265,5164,45706,1466
37841,17,330,874,270,8977,60
35204,23,687,941,513,20217,174
3855,104,3849,1437,2630,42600,1219
3831,26,748,1437,544,19131,204
68650,147,1669,103,1407,10031,262
21784,82,3575,1203,2472,26548,1103
67385,36,736,145,624,10683,112
55996,19,151,495,108,4443,43
32614,293,5193,996,3755,88215,1438
45021,278,3587,763,2755,30242,832
22327,495,20680,1196,12855,126749,7825
65637,14,200,199,142,2841,58
19362,751,10165,1245,8133,130346,2032
67869,6,43,129,34,2077,9
36022,31,495,922,400,8823,95
58274,29,370,271,303,5431,67
8915,94,1729,1380,1142,16263,587
11816,12,849,1361,278,11600,571
48786,8,408,709,259,9706,149
41344,43,781,813,653,8579,128
59432,687,11061,391,8906,60341,2155
64245,14,232,237,184,5159,48
12058,411,18194,1358,11290,134417,6904
9938,8,546,1375,354,14480,192
23564,14,384,1175,284,19956,100
5729,618,26272,1413,17641,92629,8631
12282,29,1606,1356,763,31577,843
60625,2542,48733,348,39531,259458,9202
56315,3,37,485,34,2062,3
37767,15,350,875,275,8165,75
31100,120,3574,1019,2742,68536,832
32763,106,677,993,546,14254,131
28996,574,13591,1060,8829,61189,4762
18470,166,4381,1261,2872,47650,1509
38327,8,187,861,133,5817,54
68515,2,54,108,52,3235,2
27949,942,19357,1080,12765,168225,6592
41582,75,1731,810,1363,18816,368
35067,29,443,945,329,5061,114
28453,44,1307,1070,798,27620,509
12213,52,4299,1357,2218,31457,2081
63125,12,359,269,262,7538,97
35226,16,304,941,206,11624,98
23026,37,821,1184,561,14495,260
7414,16,647,1392,447,16655,200
22605,1651,47625,1192,28621,208062,19004
33461,849,26342,980,17760,104321,8582
15989,10,467,1304,343,10206,124
55273,33,324,515,270,14768,54
25867,104,2019,1126,1343,23193,676
22242,14,697,1197,469,5518,228
40007,3,48,834,39,2357,9
66746,105,2018,166,1779,22895,239
26610,25,683,1109,412,17559,271
10394,2947,85189,1372,53846,180143,31343
2688,374,39464,1448,26464,111187,13000
50216,34,884,669,714,10523,170
53767,2893,38888,566,32155,158312,6733
12289,384,15575,1356,9134,56460,6441
67077,370,4704,155,3681,32614,1023
22303,2446,62111,1197,42642,255917,19469
24843,193,5723,1148,3794,91779,1929
36771,3,37,903,20,5500,17
54409,16,177,544,111,5089,66
8521,459,8859,1382,5796,34691,3063
60456,20,303,355,218,8277,85
51133,33,670,645,469,3973,201
3813,162,2204,1437,1529,16463,675
24094,218,3606,1164,2488,32502,1118
34461,12,209,960,132,8518,77
62624,13,112,282,89,4340,23
62122,68,1251,296,1053,15232,198
67985,4,148,126,139,3229,9
1085,36,1623,1461,1144,39004,479
32807,67,1048,992,625,7151,423
67186,2,113,151,74,2389,39
48686,9,119,712,107,6201,12
13663,461,11875,1337,8050,98597,3825
60733,47,370,344,282,7672,88
56740,15,270,473,205,8241,65
38725,415,7733,851,5536,31707,2197
37530,12,168,882,122,5875,46
14076,140,3532,1331,2364,56831,1168
49509,41,830,686,648,8932,182
44166,324,5663,772,4607,61374,1056
57330,381,5101,447,3651,21437,1450
12313,158,2284,1355,1388,14358,896
30930,474,6759,1022,4601,34467,2158
14794,107,1466,1322,1033,10170,433
32054,27,920,1005,607,6463,313
8357,35,626,1383,403,5835,223
18232,7,325,1265,232,16639,93
23092,65,2009,1183,1373,35481,636
52962,21,628,588,466,18906,162
1783,53,2156,1456,1625,80661,531
21074,32,1045,1215,661,10111,384
14658,8,243,1323,189,19920,54
37436,5,85,884,65,6276,20
28141,52,691,1076,480,40179,211
31953,18,181,1006,125,16723,56
64102,3,20,241,19,4438,1
51655,566,7743,616,6157,36396,1586
32905,781,13760,990,9621,108511,4139
54319,24,161,545,127,9275,34
3261,3835,101750,1443,67039,518749,34711
57389,129,2305,456,1894,28522,411
62977,14,336,273,222,7211,114
13440,8,456,1340,239,12977,217
16969,32,860,1288,663,22478,197
5999,113,3563,1410,2509,21741,1054
61733,204,1983,310,1502,16106,481
64841,49,428,219,323,5873,105
2780,17,599,1448,412,22389,187
60653,25,336,347,265,16575,71
51929,127,1926,623,1748,17443,178
37855,1137,21991,873,17856,134254,4135
22914,40,911,1186,537,18287,374
1882,185,3798,1455,2674,30743,1124
43397,304,2902,779,2131,16793,771
60196,253,3150,364,2527,26237,623
28202,1755,33225,1075,21312,90122,11913
32119,90,2947,1004,1993,35983,954
13839,41,1294,1335,690,11292,604
8544,532,11336,1382,7865,60102,3471
34058,46,589,968,374,17906,215
34999,45,1012,947,774,23775,238
68530,829,18958,108,16179,133360,2779
38028,7,91,868,74,6826,17
1227,1274,69241,1460,46269,317353,22972
51509,12,124,635,106,3928,18
33434,31,1039,981,799,14987,240
36128,135,2377,919,1859,23267,518
54518,29,427,539,356,13596,71
64810,50,720,220,569,16583,151
23690,293,5019,1173,3776,33081,1243
23335,24,646,1179,463,16603,183
21283,53,447,1211,383,13960,64
50696,2601,27615,657,20953,117063,6662
54760,373,4813,530,3949,17496,864
66289,185,3176,180,2423,32806,753
48861,617,10363,707,8078,23938,2285
30830,98,3352,1024,2429,36148,923
22340,35,297,1196,250,8713,47
55865,78,1183,499,846,8092,337
16193,204,8703,1301,5887,91508,2816
24139,171,3175,1163,2339,29981,836
3749,163,5327,1438,3657,25164,1670
22299,188,5405,1197,3778,40801,1627
61269,3,76,324,62,1577,14
54773,43,487,530,380,7608,107
5654,66,2579,1414,1543,39094,1036
48490,70,1753,719,1346,16500,407
54782,51,618,529,511,15134,107
60130,47,854,367,631,8254,223
16092,1,112,1302,66,14331,46
18037,314,4945,1268,3372,28439,1573
21190,38,1620,1213,1203,22672,417
33858,5,283,973,196,7137,87
14093,22,811,1331,589,16299,222
13492,66,1940,1339,1180,27100,760
26280,282,7861,1117,5190,71043,2671
9828,61,906,1376,566,10467,340
51161,92,1651,644,1210,30675,441
32275,2846,59094,1002,44733,285345,14361
19104,17,1221,1250,717,40820,504
21557,8,340,1206,255,6620,85
14646,832,51145,1323,37242,294078,13903
19857,2,189,1237,132,9433,57
32742,30,714,994,449,14160,265
66949,9,138,159,99,2597,39
36338,17,378,913,312,12393,66
4322,314,12677,1431,7405,62365,5272
52022,626,6131,620,4878,58620,1253
56465,198,3461,481,2824,52454,637
61230,19,135,325,114,3493,21
24124,499,18972,1164,14781,122423,4191
6145,2,141,1408,96,4933,45
38213,7,224,864,175,10861,49
54532,226,2540,539,2084,28356,456
29613,6,169,1049,111,3997,58
10721,36,929,1370,600,8825,329
64539,34,377,229,302,6085,75
47357,8,86,735,75,4011,11
20086,9,261,1232,192,6850,69
17550,114,2477,1278,1796,24879,681
27305,31,1311,1094,752,11526,559
29263,25,726,1055,480,9214,246
34432,498,11685,961,8884,89278,2801
14481,46,1058,1325,876,52389,182
19661,78,2489,1240,1982,40181,507
18929,401,8840,1253,5613,43211,3227
39220,47,761,845,633,12619,128
36078,627,6953,921,5875,56181,1078
19344,300,4366,1246,2802,58000,1564
10906,83501,2871679,1368,1637748,6225691,1233931
25163,895,15194,1141,10383,70547,4811
25387,534,9780,1136,5051,34705,4729
2940,32,910,1446,710,30399,200
49476,40,1102,688,726,21210,376
15235,24,746,1316,472,11226,274
6165,9,484,1408,275,31085,209
35348,19,444,938,298,8695,146
52493,4,79,604,48,5070,31
68973,42,622,92,519,8542,103
10463,52,1969,1372,1305,19805,664
21601,3,99,1206,71,8149,28
60477,179,2224,354,1750,51984,474
89,640,29582,1470,17760,147798,11822
15651,12,312,1310,250,23737,62
50726,178,5050,657,3773,60684,1277
39547,61,1463,841,1153,19315,310
21235,53,995,1212,685,38290,310
65603,3,66,200,43,2916,23
59811,83,1078,378,910,14443,168
66583,105,1757,171,1470,13715,287
29612,93,3073,1049,1897,15702,1176
27318,40,609,1094,388,14814,221
34257,43,1023,965,819,17197,204
13759,283,8521,1336,5429,84221,3092
31380,8388,184915,1015,145073,778178,39842
18105,1051,28862,1267,20343,195841,8519
19774,18,315,1238,219,11358,96
819,51,2645,1463,1760,30106,885
37815,100,1560,874,1268,16942,292
18894,68,2262,1254,1471,23213,791
5410,21,1118,1417,768,14284,350
12092,120395,4254304,1358,2119708,7778743,2134596
5387,2,22,1417,19,2912,3
4009,568,23248,1435,15245,64202,8003
33320,153,2214,983,1544,16195,670
66154,11,219,184,176,4579,43
35806,100,1829,928,1327,36340,502
1696,18,1019,1456,740,14275,279
58162,223,3469,433,2773,50819,696
43137,509,7041,784,5704,44820,1337
17963,636,27306,1270,18996,99133,8310
1680,6,330,1456,241,29003,89
1184,29,1396,1460,927,15581,469
16096,11312,352516,1302,224710,1715558,127806
24298,104,2472,1160,1874,27224,598
28218,41,742,1075,525,26042,217
39922,4060,77088,833,59847,455629,17241
55455,161,2845,510,2256,25537,589
37059,41,789,895,565,7863,224
31931,51,2574,1007,1620,8560,954
8211,10,909,1383,602,21434,307
19591,109,2206,1241,1541,18550,665
68142,57,481,121,380,6693,101
30724,54,1406,1026,1176,26683,230
37096,19,343,894,266,7202,77
1231,5,307,1460,218,21366,89
36497,9428,206746,908,153127,1093771,53619
24014,21,562,1166,404,10657,158
7774,119,4782,1387,3374,51478,1408
31364,8,293,1015,203,18856,90
41547,26,411,810,300,10666,111
29749,88,2017,1046,1322,54509,695
38251,16,494,863,429,12887,65
37455,14,351,884,277,9743,74
60239,34,267,363,217,2779,50
20656,214,5634,1223,3690,98882,1944
10874,5,366,1368,200,10572,166
59415,206,6312,391,5143,46468,1169
15567,401,5259,1311,3233,51730,2026
56929,175,2630,468,2216,27227,414
35771,38,1517,929,1106,19928,411
4873,744,14903,1424,9304,83511,5599
22135,263,7127,1199,4677,23609,2450
8417,0,54,1382,39,4422,15
13175,150,11449,1344,6371,66219,5078
65179,16,478,209,397,10961,81
59165,22,207,400,169,8558,38
32749,18,671,993,443,7580,228
30101,39,822,1038,611,20179,211
37578,111,1773,880,1504,30236,269
8655,111574,4723747,1381,2762178,9260071,1961569
56159,4,43,490,34,4187,9
163,3,234,1469,153,10829,81
5651,28,1146,1414,778,12329,368
60046,23,805,370,430,8405,375
32821,1076,13876,992,9975,63330,3901
65751,53,823,196,692,8574,131
31175,67,1402,1018,856,13568,546
50065,5490,164260,668,104396,943492,59864
16994,20,246,1288,170,8656,76
67973,19,221,126,197,3404,24
17832,78,3045,1272,2096,26264,949
240,347,26523,1468,18227,129333,8296
55505,3443,55138,509,41959,372355,13179
12804,2405,49032,1349,27399,138546,21633
23826,3347,37039,1170,28796,429542,8243
16301,4,147,1299,89,4621,58
714,27,1633,1464,1287,52831,346
9079,185,6983,1379,4715,80443,2268
6900,16,292,1399,188,6137,104
34293,264,9188,964,6420,72870,2768
18120,21,898,1267,554,8319,344
20816,3,163,1220,124,9954,39
17058,251,7494,1287,4971,54583,2523
7633,21,510,1389,335,12072,175
4230,15,374,1433,303,12295,71
17137,1335,69880,1285,22558,675437,47322
9098,62,2165,1379,1368,24966,797
49823,43,433,679,381,6071,52
35460,50,519,935,385,7520,134
49989,158,3647,675,2701,36004,946
39731,12,114,838,108,4592,6
2745,30,638,1448,483,20078,155
29741,92,2711,1046,1664,22425,1047
53781,846,12073,566,10375,66860,1698
30383,74,1614,1032,1080,15178,534
35228,122,1989,941,1533,24818,456
32611,17,489,996,367,11427,122
2190,14,620,1452,370,11754,250
35716,14,244,930,188,8782,56
56056,2424,57161,493,46367,189111,10794
1564,7,75,1457,50,3958,25
30607,11,517,1028,292,11231,225
68589,15,235,105,193,6014,42
64362,23,305,233,240,5525,65
45145,45,809,762,539,9781,270
67667,14,170,136,105,4543,65
28219,21,424,1075,280,14511,144
34224,2568,36526,965,26617,83314,9909
14171,25,870,1330,612,21883,258
40953,1403,24404,819,18591,179646,5813
42428,31,819,796,617,16543,202
38394,9,125,859,102,8516,23
51670,4,80,630,68,5421,12
67400,6,96,145,65,2234,31
66691,44,524,168,406,3884,118
58683,120,2465,415,2085,24075,380
34479,22,573,960,349,15749,224
42935,6,96,787,70,4021,26
10615,46,1340,1371,853,14882,487
7748,2200,106979,1387,60555,458235,46424
68588,16,214,105,159,5660,55
36828,48,611,882,531,11732,80
50479,83,1287,662,966,16094,321
49405,1499,39767,690,26153,259353,13614
32842,282,5205,991,3532,35558,1673
51559,409,4985,634,4051,46629,934
20800,15,670,1220,469,9128,201
12031,44,1092,1358,613,10674,479
24460,8323,189394,1156,131914,542061,57480
13433,83,1940,1340,1093,13701,847
60404,761,19624,357,14689,103080,4935
37409,556,9689,885,7647,65179,2042
8584,1,214,1382,130,8057,84
33698,14,282,975,174,9396,108
53380,36,308,576,246,12155,62
9168,15,611,1379,385,8066,226
10484,53,1554,1371,1003,14090,551
13620,4,451,1338,253,5472,198
59508,4,61,388,41,4512,20
12195,238,11448,1357,7160,77987,4288
58318,13,93,427,75,4846,18
36210,88,2846,917,2384,22146,462
30437,273,6625,1031,4755,78772,1870
22523,362,8886,1193,6438,42856,2448
18465,31118,521133,1261,350293,1224264,170840
38694,28,283,852,218,2438,65
19136,12,297,1249,219,18527,78
65598,153,1728,200,1404,13623,324
2229,161,6442,1452,4033,33055,2409
1286,40,1733,1459,1274,44946,459
8898,149,9731,1380,5920,112437,3811
44452,12,95,769,79,10581,16
68159,28,504,120,398,7332,106
48624,18,388,714,255,8927,133
36221,1232,23876,917,19516,129284,4360
39262,156,2932,844,2184,79084,748
15861,1950,55664,1306,39373,288827,16291
13075,5,405,1345,195,16419,210
56873,89,1356,469,1083,31550,273
44221,11,202,771,144,7354,58
61921,41,544,304,428,6084,116
22053,30,808,1200,500,8199,308
55800,347,5602,501,4586,20035,1016
6962,115,1889,1398,1334,31454,555
15819,40,1282,1307,917,38246,365
64485,71,972,230,752,8685,220
23096,1,117,1183,76,7051,41
32084,96,784,1004,541,7728,243
2005,25,1583,1454,1172,59357,411
30466,7018,238845,1031,147188,899305,91657
24133,113,5749,1163,3983,37940,1766
29691,9,211,1047,115,6581,96
6113,49,2377,1409,1638,19041,739
31438,5,232,1014,167,5820,65
15466,5,128,1312,88,9531,40
64510,1191,20995,229,16694,97394,4301
19617,3,171,1241,131,9683,40
673,38,1278,1464,896,56018,382
7561,18,520,1390,344,26428,176
66092,0,12,186,5,3256,7
830,514,11085,1463,7782,72366,3303
28240,89,1039,1074,666,23031,373
58433,32,439,424,376,9653,63
6640,31,371,1402,229,27965,142
16084,5602,131070,1302,89588,339174,41482
32758,21,436,993,276,8749,160
53977,83,3649,559,2790,32985,859
37308,6,111,888,84,4566,27
33888,1939,23220,972,16114,110684,7106
1056,18,1398,1461,963,13983,435
46373,167,1673,748,1319,8602,354
24801,139,4827,1148,3189,59238,1638
15443,29,887,1313,573,7659,314
17789,11,529,1273,404,14084,125
11279,93,4439,1365,2708,29606,1731
19006,35,1508,1252,1062,19618,446
65596,127,1560,200,1221,6283,339
27400,11,215,1092,147,9726,68
65267,3,48,207,29,3050,19
62270,35,899,292,734,7736,165
28814,30,636,1064,475,12085,161
42556,64,1359,794,895,18721,464
41686,19,241,807,188,8640,53
65704,7,31,196,26,1623,5
63378,3,27,263,26,2759,1
37354,82,2891,886,2229,41888,662
32867,30,1225,991,752,11018,473
25397,29,668,1136,473,9040,195
50943,44,567,651,434,9223,133
66340,5,47,179,42,2624,5
4434,35,1129,1430,908,13056,221
7678,52,1444,1388,956,28954,488
34124,171,3103,967,2246,19646,857
54293,85,2198,548,1805,14282,393
43,422,17903,1471,10744,156556,7159
9251,237,6770,1379,4190,39886,2580
64112,6,83,241,68,6009,15
45219,19,263,761,201,4406,62
50842,0,202,653,165,12948,37
4459,48,1684,1430,1175,19791,509
25001,628,24546,1144,16252,185870,8294
18964,104,2406,1252,1572,27617,834
48771,21,398,709,331,9551,67
26263,18,481,1117,334,9281,147
61297,69,974,323,813,16378,161
55344,61,876,513,663,8286,213
50774,67,842,655,696,22777,146
55957,16,442,496,282,11398,160
45150,33,329,762,263,10849,66
66878,93,1330,161,1153,24146,177
66868,13,108,162,79,2219,29
66202,12,132,182,98,3732,34
29695,394,11311,1047,6508,42304,4803
29422,50,718,1052,541,11218,177
33534,55,1306,979,972,7320,334
62968,2,40,273,35,1876,5
35193,8,97,942,69,1961,28
16736,1176,22750,1292,14025,140817,8725
55844,8,83,500,67,3517,16
16848,56,1135,1290,798,28075,337
42796,2193,58929,780,47327,399827,11602
46867,5,74,741,66,8414,8
20997,881,18460,1217,13007,60551,5453
64506,34,498,229,413,15895,85
50844,659,10561,653,8111,38652,2450
22244,339,18559,1197,9938,104605,8621
11418,43,1212,1364,735,16365,477
23928,346,8504,1168,5111,59901,3393
30921,27,519,1022,317,4447,202
68350,202,2506,115,1898,18978,608
56093,199,3421,492,2434,50640,987
64153,16,249,240,207,7514,42
10165,3741,189980,1374,112125,572007,77855
64604,49,1529,226,1305,16970,224
57263,43,904,459,695,9986,209
11840,1,249,1360,125,5337,124
42174,3,168,800,124,6080,44
65016,22,176,213,131,9925,45
54834,19,128,527,99,7239,29
38318,20,225,861,168,5415,57
27495,43,955,1090,596,6521,359
51506,38,463,635,403,14369,60
62518,5,218,284,193,5396,25
31719,20,678,1010,435,8865,243
5262,85,1453,1418,1041,35061,412
34567,17,367,958,253,14411,114
56273,10,322,487,270,12240,52
5482,104,2560,1416,1754,27445,806
56087,92,746,492,579,5658,167
63536,577,11642,258,9358,61541,2284
52716,66,718,596,578,12085,140
14293,37,1626,1328,1258,23513,368
28828,17,316,1063,214,14582,102
46968,19,301,740,258,8033,43
31132,37,1572,1019,1235,16389,337
69016,2,6,91,5,658,1
30629,18,293,1028,206,4917,87
12990,295,11539,1347,6913,164019,4626
35221,22,394,941,337,5722,57
1405,4,228,1458,183,4901,45
54273,29,291,548,264,7040,27
60765,7,117,343,73,3362,44
20257,316,3496,1230,2911,33167,585
6452,86,2419,1404,1524,14430,895
17147,15,498,1285,373,10981,125
27676,1498,30403,1085,19595,205132,10808
57176,21,256,462,203,14407,53
605,37,2292,1464,1554,65406,738
21536,154,5573,1207,3636,21139,1937
30168,13,677,1037,400,9867,277
8200,1072,39531,1383,23603,133117,15928
59483,265,2910,389,2341,20124,569
49501,42,590,688,438,23409,152
3540,7,389,1440,284,15431,105
59350,206,2827,394,2280,21309,547
64676,50,703,224,546,11472,157
22072,11,293,1200,194,14455,99
28901,183,2512,1062,1629,13843,883
35472,135,3033,935,2280,40150,753
29021,3,155,1059,97,5631,58
46559,91,1057,745,839,12353,218
57737,15,125,447,106,5541,19
11047,0,7025,1367,4917,33962,2108
37025,10,399,896,307,6445,92
31668,5,149,1011,113,12454,36
64930,100,2125,216,1637,22490,488
32730,169,4426,994,2864,19428,1562
64001,218,4324,245,3539,19779,785
53969,74,1449,559,1206,17140,243
31345,131,4049,1015,2389,35107,1660
13036,1662,43525,1346,28822,134001,14703
36052,143,1832,921,1442,20298,390
57855,49,479,442,368,3074,111
9066,186,6810,1379,4382,40636,2428
17858,110,2169,1272,1518,69707,651
68663,3,90,102,71,3885,19
47205,108,1289,737,1074,10150,215
56992,293,3590,466,2812,37567,778
50020,37,357,674,324,6583,33
56627,20,207,476,173,6671,34
15243,237,4965,1316,3442,109105,1523
33805,2,124,974,74,36944,50
10666,7,728,1370,451,13758,277
58104,16,145,435,106,5217,39
6848,57,1923,1399,1356,17692,567
9738,97,6452,1376,4120,44044,2332
36856,27,607,902,466,7623,141
27124,20,402,1098,249,5620,153
27057,135,4834,1099,3695,50680,1139
27051,310,4962,1099,3189,22254,1773
7649,668,21407,1389,13983,181613,7424
54911,3,19,525,12,2376,7
62656,132,1357,281,1141,10386,216
10870,3694,103417,1368,63503,509612,39914
61897,60,1689,305,1311,21147,378
40986,90,8070,817,6610,38248,1460
18161,81,2767,1267,1948,67874,819
30224,267,4703,1036,3498,66310,1205
29392,170,4730,1052,3134,67712,1596
5549,3,236,1415,162,28450,74
38292,11,213,862,191,10562,22
46885,2967,40501,741,28700,186835,11801
55283,34,333,514,258,8162,75
12051,10,352,1358,201,7490,151
4826,6,283,1424,196,17021,87
4229,31,422,1433,328,4704,94
30662,29,889,1027,589,8268,300
64420,1754,30960,231,25759,144355,5201
14498,3,167,1325,122,7907,45
9725,1,182,1376,108,8060,74
60569,2916,38042,350,31782,120736,6260
3034,195,4425,1445,3364,29002,1061
2659,6,330,1449,205,21403,125
50274,244,4070,667,3307,21031,763
14721,65,1063,1322,732,12989,331
3081,71,1992,1445,1262,20916,730
24925,190,2070,1146,1428,22582,642
6436,311,21944,1405,14106,140664,7838
17191,10,1079,1284,754,15482,325
19291,1305,39561,1247,27372,247123,12189
39816,102,2031,837,1468,20375,563
5751,49,1594,1413,1149,24432,445
31681,40,1109,1010,836,18505,273
65605,36,259,200,224,3935,35
50257,1410,35140,665,29056,259625,6084
49255,66,1674,694,1230,19687,444
59092,49,1695,402,1414,34720,281
40299,44,815,830,613,11666,202
14404,38,1108,1326,824,15970,284
10755,255,7288,1369,4718,54691,2570
1982,36,1018,1454,707,33974,311
43149,17,279,784,241,9658,38
52620,5,96,599,57,7160,39
3970,10,1026,1435,769,10323,257
29874,76,1816,1043,1155,70786,661
36730,2,126,904,91,8928,35
31272,110,3371,1016,2140,37942,1231
15918,32,649,1305,442,14224,207
10975,5,259,1368,144,6058,115
38559,165,3338,854,2766,29059,572
44327,33,615,770,483,12794,132
60325,14,223,359,175,7539,48
40349,8,94,829,75,5794,19
25994,230,8001,1123,5223,42133,2778
68246,14,264,118,203,5858,61
62605,19,279,282,234,7443,45
65099,199,2934,211,2321,16371,613
11253,66,2811,1366,1651,27863,1160
50868,289,5277,653,3959,29378,1318
6383,3150,124939,1405,78883,498550,46056
59868,22,652,376,461,14679,191
21248,31,485,1212,322,6295,163
20840,403,10103,1220,6562,44178,3541
4463,798,53207,1430,34759,301894,18448
36479,34,812,909,640,22952,172
867,58,1468,1462,1093,30867,375
9790,53,1414,1376,996,10662,418
66138,50,945,185,688,10233,257
49699,51,556,682,488,15553,68
17707,1987,58451,1275,37693,221075,20758
4502,3442,90337,1429,49568,207653,40769
10238,327,10975,1373,7564,73059,3411
68550,6,67,107,48,4936,19
30209,26,350,1036,195,4018,155
50141,92,638,671,448,10823,190
38162,14,242,865,198,11340,44
21090,395,13429,1215,8683,42623,4746
8518,17,239,1382,184,12030,55
14523,197,6734,1324,4355,38387,2379
48498,329,4216,718,3314,44304,902
14841,8,319,1321,231,14314,88
30223,9,496,1036,301,5347,195
61389,2,33,321,29,3496,4
58187,445,5943,432,4209,18310,1734
38126,49,566,866,450,13169,116
62598,79,729,283,568,14137,161
3175,32,1548,1443,1098,14596,450
16920,18,657,1289,457,36449,200
29985,176,7258,1041,4821,21917,2437
10787,45,1566,1369,871,16337,695
18666,24,896,1258,682,15790,214
1340,22,950,1459,674,7907,276
20707,135,2483,1222,1948,33417,535
65648,85,1090,198,921,23416,169
13714,51,660,1336,378,6402,282
3548,189,21592,1440,12321,88782,9271
64745,2,62,222,45,4573,17
65422,6,103,204,72,5159,31
1411,8,316,1458,222,7772,94
59475,127,1439,389,1122,14224,317
19780,35,833,1238,672,39540,161
32481,433,14225,998,8455,55660,5770
33111,3,148,987,93,3390,55
58672,5373,108025,415,77444,573686,30581
28021,6,150,1078,126,23670,24
18075,738,29833,1268,18798,166521,11035
48244,1180,21025,724,16134,210108,4891
9047,78,3100,1379,2113,32694,987
17999,11,279,1269,201,4629,78
29194,66,1049,1056,708,8437,341
62736,72,493,279,417,12347,76
28958,81,1447,1060,955,13492,492
934,3671,183838,1462,122441,462036,61397
34848,14,264,951,185,8682,79
54368,412,10835,544,8702,42295,2133
28109,405,14076,1077,9067,126330,5009
31183,43,1298,1018,779,11038,519
37966,3,112,870,93,6169,19
18866,8623,243014,1254,168397,1034200,74617
10119,23,796,1374,512,12387,284
49308,4,34,692,28,5211,6
22114,35,1169,1199,864,18270,305
54522,43,434,539,346,5085,88
24963,17,160,1145,114,2787,46
35660,76,1496,932,894,10101,602
61180,19,366,327,265,4499,101
16727,36,2117,1292,1403,40883,714
28705,20,429,1065,269,18881,160
41525,11,508,811,324,14180,184
13471,0,0,1340,0,6959,0
6272,232,24108,1407,12938,84079,11170
33005,4,210,988,132,4632,78
596,3308,115485,1465,77588,383927,37897
30763,29,988,1025,552,10951,436
5181,5,281,1419,206,5033,75
1908,37,3040,1455,1988,66992,1052
65305,20,249,207,197,6180,52
29739,31,2290,1046,1406,13685,884
30739,21,448,1026,293,3165,155
5758,367,21451,1413,14049,95901,7402
61680,112,1157,312,902,9637,255
68781,7,136,99,112,4624,24
50384,322,4371,665,3496,60676,875
4096,76,2247,1434,1424,24341,823
908,150,5084,1462,3788,61426,1296
36127,2382,49788,919,41064,219292,8724
8635,1450,33642,1381,21346,188973,12296
64791,72,1576,221,1240,14810,336
10319,544,14788,1373,9624,105011,5164
2546,14,405,1449,283,23015,122
18782,9,843,1256,580,14406,263
11825,55,1832,1361,862,13370,970
1843,30,951,1455,669,19271,282
2230,16,453,1452,321,13358,132
4573,28,1741,1428,1179,22161,562
65357,46,856,205,614,6085,242
1363,23,691,1459,468,26502,223
30190,168,4077,1036,2550,28338,1527
19486,235,3558,1243,2264,30508,1294
28044,2723,68581,1078,45292,346287,23289
45966,21,247,752,199,13399,48
64354,37,283,234,231,3838,52
58860,57,475,410,403,14051,72
37771,1798,34621,875,29824,179879,4797
19361,25,436,1245,296,9787,140
60603,1674,26137,349,20480,111551,5657
22533,10,411,1193,275,6705,136
1390,26,847,1459,622,24041,225
54426,643,7183,543,5996,54463,1187
2476,19,840,1450,540,11950,300
40479,53,1127,827,914,13549,213
9958,241,7489,1375,4418,80809,3071
23408,48,1192,1178,829,19350,363
51899,35,425,624,346,5206,79
25076,8,289,1142,191,11422,98
875,6,578,1462,421,16180,157
28179,11,424,1076,272,7424,152
58801,8,46,412,38,2894,8
33607,137,2371,977,1645,20626,726
25263,159,2648,1139,1871,16208,777
12576,7,312,1352,134,9278,178
31686,4367,138831,1010,92024,363665,46807
47488,1044,14147,733,10280,41066,3867
42762,47,549,790,438,8163,111
16393,6,88,1297,62,18981,26
50939,150,1970,651,1603,19451,367
11888,23,1766,1360,1046,45113,720
62903,2776,48151,274,34616,303662,13535
67622,0,40,137,30,2067,10
46350,205,3872,748,3033,22901,839
2183,53,1342,1452,964,19154,378
10757,14,735,1369,462,12612,273
60611,7,92,349,62,4202,30
34286,12,434,964,284,10875,150
22467,18,927,1194,691,17091,236
61313,31,281,323,242,5765,39
40564,30402,903660,826,661839,1823287,241821
5824,15,414,1412,256,6321,158
42815,738,10560,789,7949,45615,2611
36414,97,1828,902,1552,38498,276
29969,5,233,1041,152,17244,81
6210,21,754,1407,505,19454,249
56345,9,224,485,154,7196,70
32993,67,859,989,606,6110,253
50034,19,165,673,130,18057,35
14128,152,3291,1330,2216,38878,1075
46888,90,1134,741,867,15489,267
52438,20,221,606,164,2589,57
12028,112,10349,1358,5074,24723,5275
58631,17,224,417,194,6467,30
15941,22,797,1305,557,8803,240
42418,18,213,796,171,11717,42
51070,24,185,630,152,5454,33
25037,172,8332,1143,5375,51310,2957
24178,6,290,1163,206,4450,84
28220,67,1781,1075,1037,22211,744
45784,26,480,755,394,13257,86
66620,18,193,170,156,2961,37
14968,65,1298,1319,992,43924,306
10720,25,438,1370,310,19610,128
1404,2,258,1458,168,12074,90
34135,21,299,967,204,4002,95
67093,53,994,155,637,18666,357
68139,26,188,121,157,3682,31
18592,14,339,1259,219,16492,120
41320,148,2230,814,1836,14154,394
8667,16,717,1381,439,13372,278
10073,1079,21109,1374,13532,99517,7577
48710,104,1350,711,886,11526,464
50991,20,200,649,160,8464,40
64247,6,165,237,127,5921,38
28763,32,944,1065,664,20125,280
8510,384,7414,1382,4826,27164,2588
16429,26,1650,1297,1122,47285,528
31565,21,932,1013,608,11903,324
49869,129,2136,678,1821,24893,315
13525,26,719,1339,471,15388,248
42352,28,355,798,236,6754,119
68836,2,26,97,23,2735,3
37412,40,645,882,467,23445,178
42388,45,304,797,249,9087,55
6746,219,5888,1400,4059,64304,1829
13063,29,622,1345,369,15286,253
16248,11590,268444,1300,195707,788839,72737
4854,85,3340,1424,2289,63005,1051
67741,626,7580,134,5630,34636,1950
13478,50,1152,1340,709,11895,443
15522,267,18391,1311,11945,110863,6446
56519,29,405,479,348,12081,57
11764,7043,262456,1361,157932,1309372,104524
60557,43,584,351,480,9232,104
20293,73,4711,1229,3164,55415,1547
13239,552,14628,1343,9357,65499,5271
10077,8,348,1374,216,9224,132
15917,919,60170,1305,37923,185852,22247
65454,45,314,203,249,2182,65
8316,163,5413,1383,3189,55395,2224
14559,6391,158933,1324,101198,409622,57735
27771,20,317,1084,217,7171,100
51550,512,5550,634,4477,43636,1073
11871,6152,361238,1360,185583,1254807,175655
55326,32,412,513,294,5876,118
57649,74,1168,450,954,21544,214
37942,1355,22337,871,17874,184003,4463
4184,16,1149,1433,740,10759,409
65079,44,852,211,695,6051,157
8361,8373,158305,1382,101803,525745,56502
66606,3,23,171,18,1698,5
23953,138,4063,1168,2172,92584,1891
18357,18,702,1263,552,23871,150
64481,0,36,230,28,993,8
9219,32,966,1379,546,12154,420
19594,121,1935,1241,1330,22512,605
1708,3,190,1456,121,20326,69
59531,14,131,387,91,5258,40
65871,18,265,192,223,2679,42
3352,835,25887,1442,16504,103059,9383
27632,15,461,1086,378,16407,83
22456,5,261,1194,203,11843,58
32514,4,171,997,135,8379,36
69006,136,2264,91,1838,18782,426
12703,66,1188,1351,722,19084,466
9053,14,685,1379,466,13749,219
25089,5,429,1142,278,17931,151
68822,51,594,97,472,4270,122
52351,67,710,609,542,9996,168
54038,46,633,557,481,21237,152
22323,141,1637,1196,1103,10377,534
26247,207,4889,1118,3332,69523,1557
60195,12375,351663,360,244282,1302357,107381
701,48,2919,1464,1992,49186,927
18664,95,2761,1258,2124,34211,637
47689,33,686,730,556,29330,130
3605,445,11783,1440,8272,43160,3511
60843,17,165,340,135,5127,30
15802,46,798,1307,562,12151,236
16031,10,327,1303,256,19197,71
24595,256,8837,1153,6146,90431,2691
19896,164,3886,1236,2758,35396,1128
56098,191,4348,492,3647,83567,701
28081,219,4027,1077,2854,202638,1173
23289,11,323,1180,216,3035,107
16636,36,1284,1294,911,20605,373
53519,25,217,574,163,10429,54
45589,65,790,757,634,28489,156
31908,86,3478,1007,2509,49627,969
38021,57,1128,869,932,16131,196
27132,523,9552,1098,6807,92089,2745
55144,683,12151,518,10045,73739,2106
17366,20,2055,1281,1397,24870,658
34047,734,10213,968,7450,54590,2763
707,19,1467,1464,899,39717,568
61991,75,723,301,566,8262,157
21967,251,8864,1201,6114,54242,2750
30605,106,1038,1028,726,12738,312
68225,5,94,119,77,2431,17
26283,3,97,1117,76,6569,21
168,371,9721,1469,6737,95321,2984
19019,6,146,1251,120,16134,26
57419,52,1024,456,794,15903,230
21091,17,412,1215,302,10043,110
29911,0,360,1042,223,6670,137
68909,4,77,95,65,2109,12
43613,888,19112,777,14876,75764,4236
40657,57,853,825,608,33796,245
23119,646,12698,1183,8206,162202,4492
59981,143,1739,372,1529,17675,210
20836,1344,37679,1220,26499,369255,11180
44712,25,218,766,176,6942,42
15753,24,934,1308,572,20301,362
52989,73,483,587,397,5869,86
49184,7,90,696,59,3745,31
12858,21,678,1349,374,15362,304
36807,19,449,903,379,11300,70
8793,1251,48723,1381,29650,156625,19073
2004,96,2384,1454,1755,39729,629
49594,14,615,685,407,31517,208
18710,5,518,1257,348,13968,170
62515,9,68,285,46,4723,22
13602,96,3185,1338,2100,27325,1085
18781,81,2154,1256,1495,22690,659
63245,38,395,266,302,4504,93
38297,27,463,862,354,11630,109
54229,496,5475,550,4660,42872,815
32036,53,1001,1004,637,10081,364
15932,3,116,1305,63,5678,53
835,17,1134,1463,643,16942,491
47000,12905,278064,740,190716,1562852,87348
34787,7,101,952,76,3715,25
32942,27,466,990,271,3893,195
2544,1289,45183,1449,27486,285637,17697
63929,7,57,247,49,3201,8
23766,10,195,1171,133,10501,62
31329,128,2224,1016,1610,23572,614
54124,244,3403,553,2663,31712,740
61813,77,1044,307,884,12997,160
30884,42,763,1023,481,6279,282
8536,16,1030,1382,622,14275,408
59932,155,1707,373,1317,26987,390
41076,38254,1156796,817,705159,2273530,451637
56457,189,4683,482,3592,21433,1091
63464,66,831,260,628,9083,203
51477,69,1105,636,910,16109,195
2921,121,3787,1446,2784,25781,1003
36499,244,1482,908,1077,18938,405
62923,20,214,274,180,4509,34
12180,2480,104888,1357,66337,453162,38551
59623,14,137,384,110,6331,27
7518,8,541,1390,331,4550,210
33929,266,6126,971,4329,59116,1797
8254,92,2586,1383,1386,18760,1200
45869,229,2664,754,2286,18810,378
35905,44,950,926,693,5503,257
58368,29,370,426,308,3770,62
11684,57,2691,1362,1287,10046,1404
53124,2041,21318,582,16716,164454,4602
52890,12,101,590,75,4209,26
60956,42,393,336,285,6598,108
20077,15873,728321,1233,445190,1791593,283131
2822,1359,81972,1447,51376,367246,30596
36912,4,191,900,152,14603,39
54905,22,1079,525,650,4310,429
19927,34,1693,1235,1168,22255,525
49437,61,1013,689,784,20224,229
38296,50,529,862,422,4507,107
29795,84,1560,1045,1052,27656,508
35727,67,1023,930,747,18976,276
16851,447,16762,1290,10666,341961,6096
34287,5,210,963,151,8063,59
63484,42,351,260,287,5240,64
28913,3,179,1061,94,5038,85
56464,24,341,481,243,7896,98
47521,832,11032,731,8450,65091,2582
8896,145,3410,1380,2190,19106,1220
50486,25,539,662,431,10392,108
1569,13,423,1457,300,31247,123
6759,11,191,1400,143,19442,48
20891,17,207,1219,155,9067,52
31482,317,4888,1014,3391,36768,1497
43175,18,304,783,219,5034,85
69032,4,61,90,54,3530,7
42258,181,2297,798,1854,25723,443
35576,467,5821,933,4457,54339,1364
7290,24,752,1393,584,8721,168
24655,59,760,1152,681,48400,79
15425,4906,146459,1313,84258,936927,62201
29729,326,5135,1046,3150,50391,1985
5162,5108,247872,1420,140786,928048,107086
48483,16,369,719,283,14604,86
38272,7,174,862,150,10430,24
26157,32,962,1120,615,13744,347
29487,25,1141,1051,800,14030,341
44207,459,14106,771,11387,90644,2719
49314,2,27,692,22,2751,5
8906,945,15775,1380,10291,40476,5484
61197,91,1143,327,995,12054,148
55882,6,131,498,91,6532,40
12748,63,1765,1350,993,12685,772
20794,285,8835,1221,6179,61529,2656
35836,15,524,927,390,16172,134
61132,50,979,329,755,15895,224
14401,14,314,1326,243,8196,71
18821,41,1220,1255,814,9820,406
35414,3,114,937,76,12566,38
63616,148,1420,256,1206,15682,214
27627,97,2890,1086,1928,34553,962
16330,7,174,1299,118,11664,56
54512,27,314,540,249,5108,65
16121,12,339,1302,223,9675,116
15161,32,1187,1317,857,23432,330
64905,4463,90027,217,70240,330917,19787
4739,13,558,1425,404,15639,154
67542,4,55,140,34,2466,21
55775,17,200,501,149,4160,51
66297,25,357,180,266,6034,91
49480,5,103,688,79,2844,24
52980,1115,10744,587,8491,94500,2253
58552,167,4220,419,3145,26401,1075
9673,287,8071,1377,5114,63949,2957
8774,2,63,1381,44,6091,19
38243,91,1457,863,1261,28950,196
5775,22,617,1413,391,15465,226
5688,164,5033,1414,3275,29271,1758
20213,168,3860,1230,2873,27781,987
40950,198,3127,819,2350,24498,777
20352,40,1485,1228,1109,16367,376
27224,13,555,1096,407,6564,148
15927,9308,377065,1305,248337,646610,128728
43899,1753,27968,776,23860,133437,4108
22607,2155,49863,1192,33598,307913,16265
52019,25006,312079,604,226302,965197,85777
4288,79,2170,1432,1530,40056,640
4319,33,846,1431,635,18645,211
28624,152,5730,1067,3657,67483,2073
9867,6,151,1375,94,5266,57
64610,12,115,226,77,2475,38
64219,18,183,238,145,4449,38
40743,18,540,823,427,12624,113
34804,162,2388,950,1786,46093,602
13687,7660,177297,1337,106217,662325,71080
50118,40,390,671,317,8570,73
21559,78,1978,1206,1395,33050,583
28721,11,654,1065,378,7576,276
1007,41,1524,1461,1178,26983,346
27870,79,1704,1081,1121,34030,583
25989,143,4070,1123,2545,20805,1525
12560,36,1697,1352,824,18069,873
18608,47,1155,1259,903,16884,252
34253,7,116,965,89,12473,27
9033,65,1311,1380,893,14487,418
21310,14,299,1211,218,14268,81
37776,2,24,875,18,4798,6
17510,31,1561,1279,1076,22208,485
36283,3,60,915,46,4074,14
54696,12,196,533,150,11263,46
15777,15,444,1308,298,22825,146
63939,14,82,247,71,3653,11
1820,21,359,1455,269,33866,90
32751,77,1018,990,719,25965,299
39606,146,2198,840,1739,14464,459
25933,488,15298,1124,9916,46300,5382
54483,210,2898,541,2350,25825,548
50426,26,457,664,319,20598,138
27857,1171,19847,1082,13199,69441,6648
5596,8,1166,1415,805,23074,361
17760,36,1184,1274,759,27111,425
12766,3924,119519,1350,74219,415282,45300
60026,12,175,371,140,5317,35
16943,87,2671,1289,1761,20923,910
20030,3,217,1233,171,11766,46
22343,215,5383,1196,3685,26937,1698
10955,178,6827,1368,3979,48005,2848
37687,5,69,877,50,2923,19
45791,10,194,755,158,4850,36
68101,13,318,122,267,5007,51
43039,12,116,786,93,4773,23
67479,334,2247,142,1984,16175,263
10806,466,37159,1369,20869,77057,16290
61990,1,25,301,25,1693,0
60712,47,839,345,625,6854,214
15264,278,6469,1315,4430,71963,2039
29670,29,927,1048,560,20353,367
64589,129,2526,227,1972,12873,554
16572,385,7870,1295,5233,50319,2637
61578,7,44,315,37,6543,7
62535,63,961,284,813,19744,148
66532,2,42,173,26,2882,16
5388,15707,588495,1417,360328,1216879,228167
13224,152,2978,1344,1811,34232,1167
36818,323,8317,902,6647,77066,1670
3031,82,5022,1445,3124,34345,1898
11045,290,25077,1367,13137,78810,11940
12634,9,704,1351,317,11475,387
20315,760,18064,1229,11377,54704,6687
50692,364,4135,657,2769,35236,1366
59845,1,42,377,21,5565,21
61797,66,501,308,396,6689,105
8179,276,10201,1383,5356,34416,4845
60664,43,290,347,231,2500,59
12308,10130,250468,1355,136469,705609,113999
36340,2,184,913,141,5690,43
36155,2,126,919,103,6851,23
24885,16,410,1146,312,9105,98
5505,100,7135,1416,5087,43464,2048
26816,99,2898,1104,1961,19158,937
52305,8,97,610,72,4733,25
7717,13,799,1388,573,39205,226
32293,24,245,1001,156,5257,89
17586,34,1157,1277,693,10043,464
40237,9,279,831,219,7602,60
30108,10,153,1038,108,4195,45
67543,31,568,140,503,13607,65
59957,0,0,373,0,2373,0
22736,5,255,1189,174,5040,81
24616,106,2395,1153,1629,16997,766
55599,16,150,506,110,4150,40
26422,44,2204,1114,1336,19506,868
31656,13,368,1011,220,5649,148
59025,3,56,404,36,2106,20
63955,17,370,246,318,5972,52
29825,165,4810,1044,3115,70735,1695
28944,1928,75896,1061,51501,368695,24395
5483,3,82,1416,63,8476,19
6085,7575,435318,1409,276299,1121292,159019
34760,96,1824,952,896,9732,928
41804,25,468,806,387,15280,81
14213,180,3440,1329,2473,42102,967
19443,542,9432,1244,6361,94756,3071
29096,6,601,1058,401,7176,200
10012,27892,573548,1374,349478,908618,224070
3643,14,413,1439,308,17396,105
5104,14,753,1421,500,15814,253
21066,92,1173,1215,784,22324,389
14311,15,466,1328,352,23164,114
34575,115,1475,958,976,15519,499
24691,0,0,1151,0,2352,0
55807,14,169,500,131,8511,38
6968,30,803,1398,560,10271,243
67664,48,710,136,563,12897,147
53476,100,1170,575,889,20077,281
65470,122,1404,203,1049,8721,355
3835,53,3107,1437,2120,21117,987
64742,42,391,223,334,8005,57
62633,33,375,281,314,8978,61
50314,51,937,666,744,14430,193
19965,7,266,1235,191,6190,75
10694,606,16480,1370,11513,104164,4967
5300,98,3510,1418,2465,68132,1045
49065,50,932,700,720,26114,212
23736,7,274,1172,216,14630,58
51574,140,3883,633,2736,50592,1147
57572,24,243,452,208,6722,35
64141,290,4672,240,3432,31030,1240
65221,42,522,208,401,7817,121
45867,3,71,754,48,2807,23
771,21,324,1463,246,12998,78
14389,14,491,1326,327,6051,164
13905,1328,37771,1334,24775,120625,12996
28200,214,7647,1075,4423,47623,3224
30236,6,587,1035,335,13985,252
57455,12,355,455,244,3917,111
52512,161,2022,603,1524,27845,498
49609,34,469,685,369,20144,100
29616,390,8701,1049,6049,104816,2652
13611,220,8259,1338,5247,53548,3012
59424,11,163,391,123,11153,40
21011,20,358,1216,239,3875,119
16930,71,3264,1289,2233,85470,1031
52925,36,524,589,423,14753,101
34428,49,743,961,490,11589,253
16597,19,403,1295,305,14779,98
50763,8,225,656,152,10468,73
44074,188,2929,774,2436,19522,493
5093,9,242,1421,168,22517,74
12826,12,890,1349,491,24357,399
30046,1018,40293,1039,29945,222351,10348
28163,8,207,1076,170,4545,37
28638,86,1332,1067,1103,34896,229
9271,35,1334,1379,814,11433,520
5032,48,2509,1421,1666,40374,843
18256,4,60,1265,46,13732,14
7425,8,284,1392,197,20800,87
9222,1438,45923,1379,31016,263413,14907
18144,8,352,1267,227,14267,125
29117,210,4260,1057,2820,26945,1440
9191,72,2434,1379,1501,13776,933
53077,173,1664,584,1319,32062,345
355,82,2508,1467,1867,24420,641
56877,5970,183554,469,132492,391541,51062
63861,14,188,249,146,6665,42
67216,6,215,150,120,15310,95
64624,64,839,226,690,6006,149
17818,31,964,1272,747,17896,217
25664,791,14709,1130,9759,88787,4950
50516,12,191,661,136,6185,55
13796,77,1354,1335,861,11547,493
1304,58,1630,1459,1159,26648,471
2915,129,3840,1446,2616,42165,1224
46921,149,3052,741,2234,39437,818
36531,213,1791,907,1412,17090,379
32117,78,1109,1004,711,10432,398
3794,6406,181151,1437,113198,399231,67953
30171,240,7728,1037,5359,106904,2369
11760,111,2663,1361,1506,28936,1157
23274,13,352,1180,289,23637,63
55504,33,294,509,220,6247,74
13823,1,58,1335,30,3421,28
4428,394,8304,1430,5015,46717,3289
25341,229,11610,1137,8217,73603,3393
9134,72,2021,1379,1010,19509,1011
55918,17,521,497,394,13534,127
40525,653,12968,826,10587,90961,2381
5554,196,2931,1415,1924,26426,1007
27037,4,307,1099,193,13203,114
1620,418,14855,1457,9744,122741,5111
30787,140,2440,1024,1768,26727,672
14183,17,710,1330,488,13675,222
12052,1,223,1358,123,3284,100
28439,21,267,1071,166,4717,101
21845,36,1866,1203,1215,32398,651
30596,3,43,1028,31,3165,12
32141,175,4050,1004,2068,26395,1982
16713,137,1811,1292,1333,24520,478
9960,1892,38573,1375,24331,108125,14242
53932,275,2970,561,2559,26460,411
20193,32470,932262,1231,582328,1574563,349934
34955,597,9267,948,6097,39954,3170
50592,0,8,659,6,1309,2
14703,64,3717,1323,2632,21823,1085
66438,16,117,176,92,2915,25
65439,7,69,203,55,2118,14
16446,40,385,1297,297,19517,88
14643,157,4997,1323,3225,18671,1772
1080,3,126,1461,77,9250,49
30970,7,154,1021,104,10220,50
9109,2626,115219,1379,68062,506931,47157
49066,6,60,700,48,4482,12
4082,204,5916,1434,4241,26514,1675
7541,106,3788,1390,2466,59873,1322
43857,27,331,776,273,8439,58
13820,57,771,1335,457,10433,314
16372,203,5506,1298,2975,21438,2531
27791,606,12162,1083,8429,50299,3733
28155,77,1606,1076,1113,13591,493
16645,87,3283,1294,2246,67902,1037
24077,22,523,1165,372,9766,151
67375,18,134,145,103,3424,31
22470,13,1650,1194,1193,36050,457
49213,12,320,695,220,8278,100
68313,4,32,116,20,1220,12
17626,44,1380,1276,1095,52360,285
15774,182,5565,1308,4076,24264,1489
324,27,1200,1467,934,24116,266
31796,26,674,1008,435,21121,239
20632,34,490,1223,374,15603,116
20714,2,224,1222,153,4031,71
29479,625,10456,1051,7203,104231,3253
13853,140,4382,1334,2828,58929,1554
35372,15,474,938,387,11769,87
55463,1,39,510,31,2915,8
33310,127,2767,983,1682,23302,1085
358,4,349,1467,190,10180,159
38136,38,793,866,677,16652,116
16928,24,562,1289,369,10703,193
66699,22,525,168,464,6290,61
33948,269,2734,971,2084,36003,650
17186,12,778,1284,531,8745,247
8128,7737,198941,1383,118840,393854,80101
65349,7,81,205,57,5016,24
23916,4305,78837,1169,49202,201724,29635
42034,59,1244,802,965,14087,279
31897,133,3867,1007,2805,37934,1062
30524,50,876,1029,591,9077,285
5143,72,4512,1420,3007,68502,1505
62007,22,425,301,338,3984,87
35393,33,1060,937,772,18765,288
28837,15,490,1063,323,10098,167
62722,686,13043,275,10029,82042,3014
4070,95,5393,1434,3409,44731,1984
21013,602,13403,1216,9992,151916,3411
38026,41,988,869,727,27009,261
3258,120,5986,1443,4049,51574,1937
22369,2394,47704,1196,34509,167359,13195
64979,26,592,214,452,8764,140
57494,12,236,454,158,6652,78
16489,24,1064,1296,718,9025,346
41372,19,448,813,347,19881,101
54365,11,128,545,95,3670,33
2789,46,1321,1447,972,18667,349
10407,38,1241,1372,673,9109,568
34394,28,579,962,449,8812,130
32273,41,1248,1002,702,9951,546
19061,10,275,1251,205,15021,70
26927,445,9729,1102,6262,38711,3467
36403,53,873,911,733,24963,140
14337,0,0,1327,0,9254,0
64823,10,124,220,89,5790,35
64728,40,561,223,479,12941,82
58656,3283,78438,416,52076,392380,26362
53670,138,1704,569,1341,22059,363
66632,32,208,170,178,6563,30
61621,925,25645,314,19746,143408,5899
46916,289,3738,741,3136,29768,602
64843,100,1407,219,1246,6272,161
26669,59,1753,1107,1101,25618,652
8983,14,1285,1380,864,14121,421
10112,20,637,1374,474,12185,163
63256,1,34,266,26,3711,8
49187,153,1833,696,1479,30876,354
42104,117,1398,801,1035,14065,363
58973,4176,79253,406,65999,335602,13254
61203,16,206,327,165,5191,41
52671,102,1046,597,818,11763,228
56649,66,948,476,585,9360,363
32009,27,664,1005,439,14444,225
36805,18,437,903,360,6426,77
13179,170,6560,1344,3484,82511,3076
56142,10,181,491,150,5603,31
6891,121,2688,1399,1904,28079,784
22281,33,731,1197,509,11097,222
53815,18,321,564,208,8464,113
53754,19142,260732,566,198151,1352748,62581
11532,0,121,1363,62,5990,59
32321,7,219,1001,132,9200,87
820,1273,50250,1463,30962,273680,19288
11116,39,845,1367,519,41047,326
56892,24,547,469,405,12342,142
5222,91,1445,1419,1138,22333,307
28114,294,6234,1077,4393,41225,1841
12377,283,8911,1355,5124,112009,3787
57302,263,3016,458,2399,13568,617
37483,281,4790,879,3947,45648,843
15977,27,974,1304,692,6388,282
16804,62,2856,1291,1936,29182,920
32487,282,4118,998,3237,46448,881
18029,35,1346,1269,757,9427,589
41911,212,3098,804,2478,28773,620
38317,41,940,860,800,24991,140
25586,37,776,1132,414,8445,362
13844,111,1560,1335,1012,22407,548
10062,21,1148,1374,750,32969,398
32470,4,113,998,79,17709,34
17564,437,8140,1277,5915,43242,2225
3109,3,93,1444,73,9386,20
25835,185,3262,1127,2171,27431,1091
21694,91,1362,1204,929,13767,433
48808,23,784,708,552,20971,232
22179,9,581,1198,416,27602,165
5232,47,1440,1419,974,12575,466
5339,146,9464,1418,6076,54788,3388
12937,660,17507,1347,8914,47030,8593
61914,1515,29119,304,22564,131298,6555
28965,1,103,1060,57,10216,46
29493,18,435,1051,259,10111,176
39552,13,194,841,163,6950,31
30210,24,553,1036,411,7217,142
4633,13,327,1427,219,13617,108
18300,14,369,1264,264,30346,105
53719,239,2371,567,2053,30519,318
30690,65,2794,1026,1723,15396,1071
30454,7,218,1031,130,4713,88
6734,6,275,1401,167,13969,108
51354,1033,18130,639,14670,133440,3460
28182,2,32,1076,18,2786,14
47923,1,112,728,76,7609,36
56891,13,259,469,185,4905,74
26202,20,447,1119,297,9429,150
64109,31,336,241,281,6245,55
20833,19,350,1220,256,13495,94
60747,38,488,343,389,6933,99
59899,27,310,375,228,8794,82
54485,1554,28092,541,20045,60361,8047
67326,76,1162,146,876,14821,286
25271,81,1823,1138,1279,37121,544
31024,61,1531,1020,1066,25661,465
44257,18,465,771,371,9526,94
59379,25,424,392,327,10026,97
49140,224,2922,698,2293,31702,629
12716,707,21819,1350,13715,69446,8104
8073,117,4179,1384,2594,41996,1585
4011,34,1113,1435,812,22234,301
54859,28,284,526,216,4610,68
17213,2,708,1284,287,29694,421
66689,35,516,168,416,9869,100
66330,3,35,179,25,1098,10
12325,349,11874,1355,7046,65654,4828
25511,190,6401,1134,5618,82415,783
33709,641,14326,975,10645,36722,3681
62031,24,384,300,310,9357,74
22278,34,712,1197,528,20196,184
66442,111,1376,176,1162,14385,214
7545,2,164,1390,126,8491,38
4872,5,144,1424,91,4351,53
6598,18,807,1402,499,23621,308
5921,30,1086,1411,777,76187,309
15495,70,881,1312,494,6915,387
20453,3846,136750,1226,92538,706993,44212
53145,7,118,582,77,9170,41
22566,36,1582,1192,1103,15173,479
5911,33,769,1411,616,18356,153
19868,40,939,1236,710,12043,229
48353,203,3108,722,2544,46267,564
29975,330,11830,1041,9003,93222,2827
10753,52257,1372220,1369,718034,2154676,654186
68564,25,278,106,210,5864,68
26407,42,550,1114,465,19062,85
9080,11200,346655,1379,184215,1082795,162440
23701,18,467,1172,372,30630,95
14779,89,2384,1322,1564,16979,820
9544,608,14104,1377,7908,46784,6196
31009,133,5152,1021,3472,23987,1680
61872,19,161,306,124,1854,37
56301,3,70,486,52,4233,18
23883,1677,40182,1169,26122,258633,14060
27417,127,1834,1091,1189,18423,645
55872,108,1046,499,817,15698,229
25375,13,298,1136,216,19678,82
32096,331,7078,1004,4721,36009,2357
24610,122,6655,1153,4466,63693,2189
40781,67,1826,822,1586,26159,240
24036,45,1599,1166,1108,31053,491
1177,1088,58156,1460,28170,170683,29986
32554,2364,54046,997,34432,310176,19614
6524,1961,73857,1403,45466,281571,28391
20571,167,8413,1225,5741,77825,2672
7169,2026,45779,1395,28680,309856,17099
8142,52,1958,1383,1189,23102,769
14803,17,415,1321,317,25323,98
14617,83,3392,1324,2398,44073,994
35203,61,1079,941,901,15334,178
21088,23,457,1215,309,21688,148
51632,860,64224,631,47444,127744,16780
16531,9160,171677,1295,118152,373169,53525
47795,2429,38286,707,30421,243675,7865
57387,8,235,456,168,3788,67
49330,784,17510,692,13313,132014,4197
25190,73,1926,1140,1345,43034,581
67581,36,408,139,353,5061,55
12145,86,2782,1357,1850,51426,932
32519,14,606,997,403,16527,203
24064,0,19,1165,11,4322,8
17199,4,98,1284,86,18981,12
16721,23,902,1292,641,21136,261
53629,76,1058,570,942,14959,116
34610,147,3831,957,2460,23927,1371
56957,189,2002,467,1655,15131,347
32565,3,119,997,69,4222,50
1039,304,16654,1461,10861,98110,5793
38089,1,14,867,12,8416,2
67908,6,18,129,18,1449,0
65524,0,26,202,21,2461,5
32003,268,9297,1005,6607,64706,2690
38006,309,7083,869,5846,72471,1237
2064,65,1956,1453,1278,12214,678
53004,250,3068,587,2160,43734,908
64138,0,19,240,12,1314,7
23410,4,210,1178,159,11299,51
32899,65,2878,991,2048,36493,830
56300,13,178,486,150,9860,28
16643,84,3426,1294,2108,15241,1318
19020,40,1155,1251,869,25707,286
4015,20,935,1435,661,9510,274
50054,186,3340,672,2711,31432,629
65109,152,1547,211,1190,6800,357
4859,273,5009,1424,3326,75842,1683
23509,21,709,1176,502,27728,207
4957,33,1729,1422,1138,28388,591
10610,282,10050,1371,6568,95876,3482
61114,177,2605,330,1922,34768,683
53788,115,681,565,516,5487,165
24934,28,577,1145,446,10857,131
56418,133,1968,483,1482,15380,486
55453,2,31,510,25,2411,6
50992,6696,107392,649,88267,419709,19125
68333,0,7,115,6,1211,1
28577,9,91,1068,86,5064,5
25192,210,5768,1140,3884,49279,1884
62092,128,1570,298,1339,23960,231
30844,68,2627,1023,1490,14989,1137
50370,522,9044,665,7415,53870,1629
31860,96,3892,1008,2624,39460,1268
29554,430,4286,1050,3137,24727,1149
63295,20,394,265,325,7106,69
38239,21,241,863,219,10921,22
6624,5,215,1402,146,20685,69
25505,152,3133,1134,2152,36318,981
52845,168,1860,591,1449,18230,411
24666,13584,283062,1151,184874,1279097,98188
20550,22,530,1225,371,12709,159
27687,50,1905,1085,1137,23461,768
22416,17,772,1195,566,13360,206
55560,105,2020,507,1596,22433,424
3322,33,1579,1442,1071,20015,508
5028,323,15887,1421,10816,74656,5071
67681,12,167,136,134,4856,33
67291,78,944,148,742,5883,202
56475,1688,37001,481,28767,245772,8234
11500,114,11058,1364,6573,67172,4485
199,27,847,1469,661,24776,186
44567,1180,20177,768,16947,168335,3230
687,616,11734,1464,7459,71188,4275
20701,221,7363,1222,5117,121471,2246
67759,28,677,133,602,13645,75
48854,22,450,707,362,9708,88
53941,6,50,560,39,3992,11
948,2,104,1462,67,11686,37
4674,238,4951,1426,3348,27215,1603
62165,20,214,295,164,5515,50
24855,10,215,1147,198,6808,17
17130,178,4646,1286,3377,31718,1269
50900,113,1717,652,1270,14813,447
33213,1165,19332,985,13045,180613,6287
35008,4632,86185,947,63645,379844,22540
48469,42,1034,719,750,10399,284
6472,19,2016,1404,1321,20558,695
68255,132,2328,118,1965,24661,363
31419,70,2097,1015,1418,17498,679
5342,28,1463,1418,959,20727,504
52213,2495,37620,614,28124,104861,9496
16286,23,651,1299,402,14361,249
7797,38,1636,1386,1187,35037,449
47137,5,83,738,61,3328,22
3947,227,4508,1436,2896,45166,1612
3677,215,5600,1439,3388,48965,2212
978,175,2994,1462,2159,26986,835
50964,247,2300,650,1855,32372,445
20711,8,172,1222,127,6876,45
45724,1107,21509,755,16687,83749,4822
26756,52,2230,1106,1336,23992,894
32971,32,755,989,518,6046,237
12162,2,413,1357,200,37570,213
34971,7,240,948,142,4683,98
52885,52,456,590,353,6595,103
34817,118,1836,951,1420,26199,416
7486,171,11150,1391,7060,38361,4090
5321,0,11680,1418,6852,53114,4828
13436,63,2793,1340,1553,15770,1240
10154,1165,46053,1374,24695,228492,21358
57049,29,257,465,229,6728,28
60147,82,808,366,619,6584,189
67310,25,474,147,367,7556,107
3638,5,155,1439,110,40495,45
17565,7,432,1277,331,10849,101
13272,20217,772371,1343,437134,2055492,335237
68411,18,454,110,376,13728,78
29521,477,19831,1050,12038,191207,7793
40195,47,654,831,483,13078,171
49492,65,963,688,735,16051,228
20425,16,279,1227,242,11100,37
18689,2559,44485,1257,29639,359647,14846
9241,192,7253,1379,4934,61678,2319
56612,58,516,477,408,12497,108
58568,231,2050,419,1698,18520,352
38677,918,13463,852,10414,66878,3049
54143,260,1981,553,1530,16727,451
63477,138,1751,260,1500,16866,251
25574,297,8751,1133,6088,434486,2663
35481,0,49,935,32,2953,17
13829,181,10099,1335,5947,47544,4152
50142,99,1283,671,976,14766,307
15622,132,3493,1310,2672,110067,821
66425,70,451,176,371,5342,80
14799,64,1919,1321,1409,20756,510
2041,560,22176,1454,11972,110537,10204
18899,25,1398,1254,1046,20525,352
8496,30,1037,1382,710,37454,327
62878,49,400,276,297,3224,103
48357,2,154,722,117,10046,37
16268,2,375,1300,128,14383,247
68140,28,374,121,294,6997,80
16610,1,47,1294,36,6948,11
8511,38,1232,1382,864,14259,368
55116,545,9670,519,7202,65157,2468
34324,38,1112,963,790,22876,322
16042,7,334,1303,230,11152,104
24131,28,781,1164,512,10478,269
8772,1775,39389,1381,24712,218120,14677
65322,31,364,206,328,8817,36
8418,20,258,1382,171,6855,87
67695,1,79,135,54,3421,25
828,9,727,1463,481,11712,246
65421,35,616,204,375,9229,241
56654,76,1122,476,908,11354,214
17800,18,492,1273,382,9381,110
54729,92,1077,531,748,17117,329
6560,17,446,1403,340,37211,106
22713,106,2615,1190,1845,23129,770
33663,73,1068,976,699,10045,369
31501,19,474,1013,359,11439,115
16564,13,392,1295,254,16303,138
33370,398,29780,982,20961,34037,8819
20069,495,14456,1233,9821,76171,4635
10056,3207,72932,1374,40576,152403,32356
4936,228,10169,1423,6394,74851,3775
29193,19,1393,1056,782,19124,611
68114,36,652,122,585,17217,67
50536,9,83,661,77,3142,6
64935,154,2160,216,1735,41010,425
65243,103,1621,208,1257,18534,364
14673,56,7657,1323,5055,63574,2602
24513,66,1797,1155,1238,26169,559
29003,12,376,1060,251,18221,125
14625,0,50,1323,32,4177,18
10681,470,7788,1370,5343,34988,2445
55644,576,7648,504,6285,45052,1363
1928,391,7237,1455,4934,36819,2303
36916,248,3868,900,2983,30940,885
16381,1718,36946,1298,25177,468599,11769
9427,50,1884,1378,1136,26532,748
32439,5,144,999,93,3243,51
52286,300,3549,611,2852,47916,697
54925,1804,42450,524,33356,197999,9094
32957,31,511,989,337,5033,174
63543,116,1155,259,675,5527,480
26153,1,88,1120,55,4414,33
11313,11,590,1365,311,8842,279
47989,5667,103834,727,74836,603619,28998
68056,79,1274,123,1046,13622,228
18819,129,3410,1255,2195,21711,1215
16594,0,0,1295,0,9570,0
62790,9,126,278,95,2157,31
3308,6,567,1442,391,41185,176
13228,71,2699,1343,1385,31144,1314
14162,690,36916,1330,24608,146256,12308
51103,87,922,646,754,17694,168
54816,172,2109,528,1737,23145,372
2581,3925,122968,1449,63084,453734,59884
19379,299,11560,1245,8856,67214,2704
22084,531,15316,1199,9034,86721,6282
59346,9,132,394,113,3916,19
37780,78,1491,875,1062,34138,429
6844,76,3508,1399,2037,49569,1471
7283,39,1387,1393,1048,8569,339
39919,26,344,836,279,10565,65
24369,193,4490,1158,3114,35688,1376
36327,104,1887,913,1634,22893,253
586,634,15709,1465,10865,131434,4844
28061,222,5099,1078,3224,33136,1875
51619,118,1785,632,1370,17016,415
50931,115,2010,651,1502,30560,508
65917,11,123,191,90,3890,33
22070,43,1883,1200,1357,25091,526
20649,43,1640,1223,1133,40906,507
52008,9,213,621,165,5136,48
27897,1,90,1081,62,13776,28
56636,70,1226,476,948,29044,278
33736,10,622,975,355,5375,267
20271,52,1309,1229,966,22105,343
25474,45,1577,1134,1017,34363,560
8034,33,1039,1384,570,7169,469
56942,14,334,467,244,5517,90
14667,4,218,1323,163,10540,55
14236,5,361,1329,292,10608,69
61341,8,83,322,74,4643,9
16171,92,3199,1301,2026,58121,1173
22040,23,682,1200,435,13699,247
45322,169,3230,760,2543,49163,687
60199,10,245,364,203,12538,42
24072,149,2715,1165,1961,21162,754
41977,7,368,803,278,9062,90
6029,49,1808,1409,1124,39564,684
26504,22,571,1112,412,22802,159
29033,0,0,1059,0,3661,0
25642,3866,128893,1131,76777,577445,52116
10591,508,10878,1371,6887,44770,3991
19360,36,892,1245,665,16404,227
40435,47,1045,828,839,18386,206
54139,34,306,553,246,6623,60
44406,97,1699,770,1225,28129,474
13869,0,0,1334,0,10989,0
14505,227,6408,1325,3954,34780,2454
40073,42,730,833,581,7896,149
768,56,2132,1463,1447,30710,685
1427,17,1206,1458,711,6846,495
22818,1772,21405,1188,13776,103711,7629
2545,26,568,1449,365,27629,203
65488,61,1755,202,1349,7560,406
7235,14,260,1394,178,10113,82
21923,103,1960,1201,1109,16727,851
24051,14,418,1165,335,23133,83
43433,43,439,780,342,4557,97
61278,144,2070,324,1508,7647,562
55086,13,146,520,102,7785,44
61875,3632,165737,305,121142,371753,44595
209,312,16123,1469,10814,193233,5309
66766,5,42,165,38,2009,4
19737,1,68,1239,48,4305,20
6431,355,6504,1405,4760,56303,1744
51988,125,1491,622,1013,13806,478
37787,0,111,875,86,5903,25
59052,105,1606,404,1146,6383,460
15796,167,4329,1307,2878,30273,1451
35511,112,2881,934,2247,86856,634
200,50,4852,1469,3279,35993,1573
57141,5756,146155,394,101720,591594,44435
67348,7,89,146,72,2319,17
24857,152,2827,1147,1891,24772,936
25605,19,1792,1132,1050,20703,742
13383,8,244,1341,137,11566,107
66499,4,79,174,67,2545,12
34438,1891,41730,961,27833,227591,13897
33002,2590,120877,988,93747,344103,27130
66732,7,114,166,94,4580,20
31948,38,1188,1007,757,13135,431
48812,58,1802,708,1478,19588,324
16256,1183,22347,1300,16380,106050,5967
53620,974,18451,570,14575,120924,3876
52440,928,15182,606,12628,83412,2554
9761,15,476,1376,293,6730,183
22394,42,871,1195,615,8873,256
3364,38,1806,1442,1197,27254,609
55658,544,4390,504,3521,29829,869
28743,333,6689,1065,4434,63447,2255
44274,25,295,771,235,8083,60
19745,50,2412,1239,1437,10420,975
20956,3,267,1217,210,9240,57
56447,25,366,482,300,9954,66
56511,9,188,480,126,8334,62
60024,6,56,371,43,2534,13
17055,10,150,1287,120,8778,30
19464,149,3103,1244,2157,52330,946
54588,1,23,537,16,3352,7
12345,33,2291,1355,1437,19818,854
56688,58,1741,475,1396,10323,345
26698,98,1675,1107,1040,7929,635
53772,58,589,566,499,14411,90
14206,3,396,1329,300,16688,96
57690,60,1209,448,829,19287,380
57415,10,157,456,121,3707,36
16497,13,298,1296,188,11770,110
58332,22,941,427,729,14597,212
68261,7,86,117,60,2473,26
195,1175,31119,1469,19583,123423,11536
27615,598,11988,1086,7618,77031,4370
63548,9,98,259,66,1531,32
28632,177,5708,1067,3739,71019,1969
36510,35779,780776,907,562831,2201672,217945
50265,631,8261,668,6682,59515,1579
59556,667,16045,386,12846,97518,3199
35753,9,329,929,246,8140,83
61122,10,259,329,217,8318,42
56164,254,4789,490,3621,24840,1168
35123,413,8375,944,5935,47026,2440
21481,55,2195,1208,1547,23282,648
32425,20,518,999,361,9864,157
28041,6,108,1078,96,8464,12
65434,67,1051,203,757,13419,294
30389,52,1462,1032,911,15716,551
34238,12,548,965,324,11709,224
63158,200,2373,268,1836,27581,537
15648,498,13671,1310,9092,62870,4579
17674,25,664,1275,487,18903,177
5317,1,97,1418,57,5462,40
52276,13,195,612,159,5311,36
1408,212,4479,1458,2990,44706,1489
19599,48,1360,1241,951,11958,409
176,229,9014,1469,6047,32486,2967
68683,2557,51735,102,43432,255947,8303
38233,13,207,790,174,7523,33
4373,26,700,1430,467,11158,233
40406,32,359,828,290,4965,69
745,860,80696,1463,51183,319120,29513
44927,12,149,764,123,6505,26
21534,7,502,1207,329,9249,173
23199,77,1224,1181,986,24972,238
54937,71,739,524,570,9300,169
65181,35,381,207,329,5329,52
39471,164,2910,842,2365,28141,545
35714,329,7747,930,5940,47165,1807
12471,23,1400,1353,799,14267,601
31714,28,459,1010,310,5974,149
54413,33,350,543,262,11137,88
16632,36,1041,1294,757,13124,284
35569,89,2226,933,1633,18724,593
59836,33,390,377,344,9085,46
54246,1079,11609,549,9597,68518,2012
41275,88,1938,814,1574,22500,364
66541,12,138,173,122,1358,16
2749,29,1265,1448,883,21019,382
26315,46,2091,1116,1183,23595,908
19099,664,12723,1250,8540,135229,4183
7732,24,597,1387,391,15761,206
12108,144,2866,1358,1808,19108,1058
16178,315,8246,1301,4585,45120,3661
5829,0,73,1412,56,7126,17
15742,908,91876,1308,53651,154690,38225
20917,34,1475,1218,930,16677,545
8892,636,19727,1380,12344,124751,7383
67416,13,109,144,87,5892,22
64806,3,19,220,12,2535,7
6535,355,9514,1403,6663,145339,2851
40886,418,8534,821,5573,73803,2961
18069,12,758,1268,528,18416,230
64923,120,1005,216,812,15207,193
4863,767,31973,1424,21297,171022,10676
49122,2,134,699,95,5844,39
18825,12,152,1255,123,4467,29
32356,3,89,1000,61,4871,28
51383,291,9120,638,6461,25602,2659
50471,10002,132479,662,83042,448436,49437
36248,26,267,916,209,8977,58
8441,57,1280,1382,898,14119,382
18877,17,597,1254,446,7652,151
1955,88,3129,1454,2249,41006,880
6463,381,5241,1404,3404,48824,1837
59717,148,1628,377,1407,21297,221
8305,8,310,1383,215,13184,95
228,210,6707,1468,4393,76147,2314
55550,6,64,507,51,6832,13
53079,22,327,584,259,11254,68
1495,295,17352,1458,11445,89996,5907
40456,11,287,827,219,9445,68
9450,465,13787,1378,9148,59549,4639
56261,38,519,487,438,17643,81
34502,118,3796,959,2793,42666,1003
38252,83,763,863,579,7043,184
6738,237,13594,1401,8646,113038,4948
29979,8132,152520,1041,92135,467090,60385
20212,102,1996,1230,1449,21378,547
2760,20,935,1448,657,20918,278
54886,251,2083,526,1606,22446,477
12142,40,1858,1357,1096,29040,762
32337,51,1835,1001,783,14202,1052
21133,21,937,1214,691,21412,246
62548,44,1026,284,708,14662,318
21707,14,385,1204,248,6966,137
20957,1,71,1217,63,6373,8
61718,23,319,311,250,6901,69
32145,1094,28828,1004,20099,84146,8729
67430,236,10083,144,8084,41582,1999
23895,9,341,1169,275,35230,66
64450,59,1177,231,936,11279,241
36081,228,3143,921,2456,26554,687
64615,42,744,226,664,17176,80
27190,197,3863,1097,2591,46298,1272
2073,182,3319,1453,2521,20867,798
751,125,8518,1463,6216,102566,2302
63925,4,94,247,85,6563,9
58670,8154,220053,415,151489,808703,68564
52378,81,723,608,606,14564,117
54134,189,2013,553,1591,14939,422
430,31,1176,1466,747,35410,429
51861,5,194,625,131,5749,63
62559,87,1177,284,885,7991,292
18213,220,7518,1266,5146,202545,2372
30394,95,2110,1032,1325,37618,785
7507,91,2085,1391,1471,15083,614
29997,10,454,1040,264,9125,190
9920,138,3121,1375,1995,22148,1126
15880,235,9273,1306,6299,130429,2974
31075,222,9506,1019,6360,95899,3146
33426,15,532,981,364,32568,168
14764,0,0,1322,0,6252,0
44118,6,105,773,90,4898,15
22158,52,1377,1198,1015,19672,362
36777,437,9123,902,7265,98372,1858
63450,23,198,261,138,4671,60
64030,59,366,244,310,5071,56
56155,32,529,490,422,8473,107
60045,11,147,370,93,7795,54
58352,23,374,427,269,6718,105
4761,30,1678,1425,972,42406,706
26018,16,180,1122,145,16848,35
33684,67,1323,976,966,21113,357
16247,1,226,1300,125,7435,101
31479,21,355,1014,255,6364,100
16426,12,259,1297,192,5428,67
40393,20,734,828,521,15331,213
64486,48,724,230,595,15718,129
28708,16,1283,1065,694,11366,589
8297,33,946,1383,646,9983,300
32930,1342,25510,990,16200,163589,9310
11529,2,352,1363,190,4517,162
13818,71,1779,1335,1015,7897,764
32431,276,5632,999,3973,26091,1659
26300,113,1880,1116,1187,29946,693
15106,60,854,1318,646,12041,208
33831,18,328,973,210,9309,118
63895,248,5752,248,4647,29503,1105
23256,74,1603,1180,1300,38485,303
13623,333,10029,1338,6197,88692,3832
50041,99,2032,673,1597,49054,435
7595,198,6246,1389,3843,20449,2403
823,1435,78782,1463,48215,304475,30567
10865,7,402,1369,234,7677,168
22578,49,1519,1192,1156,10129,363
25590,145,7109,1132,4453,66760,2656
57124,602,8479,463,7130,68804,1349
38044,56,1135,868,821,34391,314
8945,10,502,1380,339,6661,163
15510,47,1651,1312,1135,10098,516
38528,22,432,855,320,5557,112
63867,96,909,249,752,20073,157
16300,3,326,1299,191,8233,135
20554,0,0,1225,0,6822,0
7116,3,172,1395,110,18480,62
46359,15,245,748,169,8361,76
25333,0,0,1137,0,8876,0
12006,894,22121,1359,13446,109955,8675
12632,23,823,1351,501,9464,322
11005,4825,166263,1367,103066,523348,63197
39684,43,932,839,737,28067,195
29283,20,417,1054,262,10096,155
10917,1,47,1368,39,12603,8
7444,8,905,1391,637,47631,268
15449,242,7261,1313,4626,55235,2635
58668,53,668,416,480,9279,188
51513,51,1104,635,853,18905,251
54772,31,231,530,177,6395,54
6501,7,225,1404,160,6758,65
55240,5311,80828,516,56434,222882,24394
11582,554,21090,1363,13297,98544,7793
7369,10,626,1392,452,6657,174
1683,7,112,1456,65,12610,47
10667,117,4512,1370,2724,22150,1788
16232,7,325,1300,210,4866,115
17725,47,1264,1274,983,43100,281
6637,834,28293,1402,17902,71401,10391
30680,1,177,1027,104,5461,73
19449,11,359,1244,272,8753,87
51107,22,235,646,213,12704,22
34673,13,168,955,120,5320,48
27481,24,315,1090,219,4545,96
31022,4,65,1020,48,8188,17
26446,2964,100191,1113,58935,392496,41256
66549,32,651,172,545,11210,106
34513,130,3040,959,2161,20187,879
17816,45,1231,1273,858,15828,373
15249,180,4744,1316,3197,46945,1547
3334,21,577,1442,419,45755,158
60944,56,672,336,487,9094,185
21445,13,216,1208,162,14532,54
65123,17,155,210,131,3076,24
63738,111,1304,253,939,11990,365
23554,18,363,1175,243,6403,120
55534,10,147,508,119,7379,28
4393,14,168,1430,94,5261,74
10142,339,10711,1374,7467,28060,3244
21651,64,849,1205,681,5611,168
21407,14,723,1209,493,26429,230
2794,102,2212,1447,1362,54378,850
48289,840,18144,723,14718,87527,3426
47833,13,224,729,162,2817,62
4738,57,2656,1425,1846,29117,810
59190,86,1722,399,1201,15498,521
32085,26,646,1004,395,11862,251
20446,10,175,1226,146,7418,29
59843,3,36,377,30,2635,6
28750,8,222,1065,120,16568,102
32686,16,513,995,328,19490,185
61367,94,1500,321,1262,16901,238
6464,10,198,1404,131,35564,67
4204,10,335,1433,222,15968,113
49576,102,1570,686,1345,20842,225
68704,6,73,101,59,2147,14
56528,4,43,479,39,4995,4
32645,106,2400,995,1758,29558,642
63075,12,112,271,91,6026,21
25429,1088,17231,1135,12393,86508,4838
62263,4,69,292,54,6500,15
28528,24,1446,1069,954,35756,492
22749,66,1561,1189,1240,26156,321
54749,84,791,530,583,17499,208
42530,5,64,795,53,4523,11
56785,871,11979,472,10023,82377,1956
20831,62,1688,1220,1235,36061,453
28454,403,10582,1070,6712,67729,3870
159,178,5951,1469,4720,64906,1231
26112,1930,58171,1120,35420,376837,22751
27528,27,540,1089,317,5063,223
27118,41,583,1098,501,20772,82
54189,5,51,552,36,2715,15
8672,24,855,1381,540,18771,315
21683,62,749,1205,445,12867,304
23362,401,10244,1179,7269,90274,2975
30306,31,1166,1034,741,32691,425
58480,5,56,421,50,4667,6
27137,10,252,1098,170,11659,82
51957,542,7667,623,6358,48093,1309
22490,3,78,1194,61,5798,17
19336,80,1328,1246,847,10568,481
27983,200,14899,1079,9682,42565,5217
7494,69,2276,1391,1537,32891,739
66357,6,154,179,116,2370,38
35941,154,2770,924,1742,45032,1028
67168,6,252,152,164,14145,88
46207,293,4203,749,3051,19467,1152
10435,0,0,1372,0,13811,0
3731,18,1026,1438,666,48554,360
7038,36,1036,1397,686,26280,350
13369,183,4817,1341,2686,47239,2131
8213,529,6796,1383,4623,25183,2173
20263,0,14,1230,13,2641,1
23963,176,5199,1168,3696,43356,1503
43101,117,2573,785,1985,36482,588
55312,104,934,513,753,11704,181
62698,1613,51403,262,33506,115310,17897
54839,111,800,527,622,7157,178
31258,209,7715,1017,4950,39994,2765
18199,21,1021,1266,730,15109,291
64948,1838,19118,215,14817,106748,4301
66164,7,101,183,72,2129,29
29073,3,104,1058,61,4110,43
60384,124,1552,358,1282,20602,270
14044,7,439,1331,277,6673,162
700,0,67,1464,48,5335,19
64792,0,43,221,27,3895,16
58884,33,408,409,254,8905,154
53802,699,7676,565,6048,91687,1628
32203,11,237,1003,143,6999,94
53209,10,83,580,73,3644,10
59064,24,240,402,192,4169,48
55371,57,723,512,529,21422,194
56638,49,368,476,312,7981,56
23492,40,896,1176,606,17095,290
46416,377,9670,748,7464,91787,2206
5866,870,33112,1412,20608,182775,12504
62257,8,244,293,208,1672,36
55285,149,2226,514,1787,15246,439
24132,15,809,1164,528,10130,281
6620,202,5774,1402,4168,62349,1606
370,146,3080,1467,2230,27313,850
25431,273,5489,1135,3861,49311,1628
30457,77,1918,1031,1195,16133,723
3590,201,3936,1440,2974,58118,962
14880,184,2800,1321,1964,105017,836
60038,12,208,370,166,6211,42
43992,7,131,775,104,9676,27
42662,5479,107991,791,76487,386110,31504
50871,4,68,653,46,2488,22
67557,159,2879,140,2324,17046,555
56443,9,136,482,109,3695,27
2054,1024,29514,1454,17973,98743,11541
2361,71,1208,1451,882,33863,326
28647,28,567,1067,326,11059,241
28290,29,747,1073,432,10408,315
11785,0,0,1361,0,10335,0
15316,145,2342,1315,1590,18831,752
23284,41,1312,1180,1034,29672,278
30828,7,304,1024,179,3958,125
54079,9,80,555,70,3440,10
49786,20,363,680,287,8296,76
5816,3131,86003,1412,49835,281022,36168
17976,130,3335,1269,2182,21808,1153
1470,25,1076,1458,788,31211,288
58207,28,192,432,157,7299,35
55436,76,1024,510,821,19189,203
51479,17,212,636,164,6705,48
13318,11,316,1342,185,9925,131
42700,140,3019,791,2280,29357,739
64546,26,833,228,606,10235,227
51196,5,111,643,86,5739,25
17127,42,2911,1286,2185,39654,726
51089,132,2364,646,1780,21729,584
22619,3688,132133,1191,86162,423182,45971
17128,27,776,1286,643,25626,133
63279,1235,17641,266,14687,90264,2954
13855,5,235,1334,128,8539,107
59494,4,50,389,37,3240,13
68570,31,337,106,254,3512,83
59468,33,700,390,617,9968,83
10997,38,2970,1368,1751,28724,1219
1127,32,1164,1460,769,26211,395
22473,151,4543,1194,3165,73081,1378
62024,29,343,300,267,4149,76
13216,0,0,1344,0,14284,0
22898,5,249,1186,181,10605,68
8794,18,488,1381,320,12383,168
616,99,2774,1464,2067,32290,707
30392,28,736,1032,647,12368,89
6342,31,679,1406,447,7743,232
31525,18,478,1013,376,8551,102
37870,453,8416,873,6774,94783,1642
26372,19,673,1115,427,26459,246
18180,2366,47919,1266,31724,149843,16195
13961,4531,139558,1333,91100,935516,48458
39825,284,9159,837,7519,50534,1640
24009,31,505,1167,379,7679,126
24527,19,820,1155,563,20834,257
20403,2,190,1227,140,6307,50
6933,21,752,1398,508,21676,244
4080,36,1300,1434,842,19741,458
65613,1511,19633,199,15382,136070,4251
50679,2,69,658,48,1992,21
39065,43,839,846,730,13607,109
1396,16,526,1459,341,12912,185
68735,72,882,101,776,14492,106
53417,10,99,575,84,9816,15
10483,712,15395,1371,11074,39639,4321
36123,41,480,920,358,19364,122
41754,1274,19269,806,14926,121344,4343
4253,182,4341,1432,3277,70517,1064
7898,3,216,1385,139,15991,77
59078,444,9722,403,7160,32381,2562
21104,25,1287,1214,984,18564,303
38967,6,108,848,82,4371,26
45358,88,967,759,757,21710,210
24785,9,105,1149,84,6524,21
34607,805,23407,957,16186,73988,7221
32064,7056,156924,1005,94051,438663,62873
4640,684,10518,1427,7039,56789,3479
38453,29,597,857,494,8283,103
31950,51,877,1007,597,13368,280
28344,24,394,1072,271,5527,123
8728,2035,87762,1381,50613,413741,37149
34630,3,153,956,103,6155,50
22983,214,2772,1185,1733,25771,1039
61564,15,196,316,164,5075,32
31533,1588,37716,1013,23935,212637,13781
34248,9,208,965,156,2144,52
13051,6,324,1345,173,10213,151
2170,49,1906,1453,1363,23628,543
61482,100,1252,318,1010,12892,242
32796,35,878,993,516,8497,362
48926,58,954,704,715,25558,239
32647,210,4508,995,3264,42350,1244
19343,4,83,1246,66,4085,17
35730,90,2540,838,1965,49214,575
64694,25,213,224,189,8611,24
19355,47,949,1245,673,19428,276
66914,16,215,160,133,4745,82
58055,5591,79171,436,62147,224595,17024
3629,102,1946,1439,1313,28507,633
43593,764,14921,778,11734,69116,3187
3415,55,2436,1441,1530,30948,906
21300,14,314,1211,226,12819,88
37475,270,8546,883,3386,45454,5160
21050,11,447,1216,323,8393,124
35064,1,23,944,17,2522,6
26398,246,7839,1114,5168,82024,2671
14098,32,1307,1331,804,13448,503
66865,41,433,162,380,6932,53
4729,2100,25660,1425,15732,64022,9928
6644,35,771,1402,538,22764,233
56113,132,1325,491,1018,14374,307
272,790,31500,1468,24358,209441,7142
48721,21,257,711,210,6463,47
8963,1,139,1380,87,2793,52
2905,964,30243,1446,18274,122224,11969
17140,1739,35709,1285,24164,148611,11545
58363,2009,38721,423,27914,162621,10807
64681,2,36,224,29,2841,7
9193,46,2428,1379,1408,15449,1020
23777,14,693,1171,471,22224,222
44430,265,3761,769,3157,51518,604
50843,5,43,653,30,3301,13
15208,315,11341,1316,7886,46644,3455
2924,38,1209,1446,804,25407,405
55688,9,128,504,110,9084,18
49032,3667,56895,683,47792,352480,9103
51355,26,261,639,241,9554,20
32358,4,159,1000,102,15361,57
55657,34,679,504,520,8666,159
27288,579,11685,1094,7627,85836,4058
40083,68,1320,833,982,62673,338
35877,78,1942,926,1596,24819,346
68164,15,170,120,142,2777,28
12891,147,8238,1348,4102,84896,4136
16624,12,517,1294,378,12528,139
31145,96,1188,1018,786,21864,402
51007,192,2829,649,2166,58239,663
6327,8,669,1406,241,10620,428
57631,13,71,450,57,5443,14
22219,261,5174,1198,3366,43584,1808
67795,35,406,132,319,4327,87
17728,54,1864,1274,1357,17683,507
21432,2200,77900,1209,54902,371109,22998
10031,12,483,1374,298,6589,185
36398,11,245,911,183,10092,62
39341,398,4027,843,2726,35642,1301
53888,1030,16390,561,13726,174755,2664
788,21,1160,1463,761,16855,399
21092,711,68402,1215,41418,239199,26984
29219,33,1081,1055,668,31189,413
29365,142,10460,1053,6568,39476,3892
9729,22,339,1376,228,7296,111
8133,90,2176,1383,1296,12429,880
15463,26,699,1312,468,42292,231
55416,24,251,511,206,5789,45
23392,100,2778,1178,2040,18688,738
36941,33,856,899,603,22629,253
36729,9,106,904,77,2152,29
68420,20,419,112,350,7887,69
32994,14,320,989,201,3019,119
16575,1114,37707,1295,21802,150132,15905
52792,13,180,593,157,16695,23
39850,2,106,837,67,3311,39
61535,3,23,317,18,2972,5
13529,4021,82934,1339,61360,348942,21574
2835,135,4543,1447,3174,38359,1369
64004,6,76,245,58,1609,18
62012,131,1851,300,1465,14791,386
16217,17,307,1300,229,11501,78
67349,6,78,146,62,3257,16
16612,81,1524,1294,1004,31743,520
4614,6,194,1427,144,18310,50
6856,11,204,1399,125,12947,79
32175,11,309,1003,239,36018,70
29544,10,288,1050,168,6952,120
18946,36,510,1253,365,8634,145
34113,267,6233,967,4513,68385,1720
52963,4,51,588,35,3671,16
36967,50,1057,898,836,15488,221
21760,28,781,1204,512,13527,269
3822,159,3880,1437,2490,20412,1390
3768,3,61,1438,47,6261,14
66677,94,2381,168,1891,26821,490
5574,119,3094,1415,2126,24811,968
16135,33,551,1302,382,6905,169
26037,16,446,1122,276,5129,170
2257,16,435,1452,311,11695,124
10954,9,213,1368,134,5090,79
61346,44,1057,322,668,14610,389
51501,89,1309,635,1047,19802,262
57255,1009,15414,460,12836,81949,2578
32329,4866,201688,1001,137331,915122,64357
55587,313,6054,506,4774,56857,1280
20394,13080,304902,1227,185914,788980,118988
1290,8,378,1459,276,17561,102
28580,2216,49959,1068,34367,312386,15592
65837,4,43,193,43,4909,0
39450,15304,335651,842,256666,988834,78985
37207,0,728,891,576,16454,152
67726,8,172,134,109,7539,63
31558,61,1828,1013,1040,31177,788
59670,22,190,383,140,10408,50
41942,39,483,803,384,7010,99
35956,90,2202,924,1692,33200,510
12820,8,589,1349,340,21021,249
13059,810,12481,1345,8166,90190,4315
33828,9,486,973,309,15311,177
21755,238,5876,1204,3367,32645,2509
55404,6,84,511,60,5226,24
45445,41,715,758,548,18278,167
12757,46,2416,1350,1333,18488,1083
24788,2,280,1149,195,6912,85
6082,28,909,1409,613,42187,296
51235,7,114,643,88,3749,26
34950,37454,1420308,948,957807,3626697,462501
26736,1612,33163,1106,23074,115844,10089
37241,16,386,890,315,11820,71
30552,19,618,1029,370,9566,248
13107,15,1509,1345,854,12487,655
13150,141,5872,1344,3743,85273,2129
60791,11,141,342,87,4362,54
10217,3,196,1373,141,7813,55
32206,33,1446,1002,858,16466,588
4556,86,9682,1428,6313,32912,3369
5311,278,5038,1418,3483,54519,1555
6496,3026,78533,1404,45947,221556,32586
4474,88,2023,1429,1429,28064,594
8657,46,1101,1381,732,11590,369
53447,6,75,575,52,3372,23
25512,12,156,1134,111,3147,45
7615,193,16596,1389,11289,95979,5307
7603,15,338,1389,247,7888,91
20861,1208,18106,1219,10732,76811,7374
31425,36,803,1014,544,13433,259
22382,1429,40785,1195,25421,298616,15364
23869,39,971,1169,739,20046,232
57408,7302,188171,456,146125,656300,42046
54473,3250,44352,541,35036,255065,9316
8927,39,1562,1380,997,10072,565
15503,16,763,1312,517,28267,246
22444,29,383,1194,319,6559,64
5753,17,754,1413,512,28941,242
19446,13001,415116,1244,245658,1020533,169458
16145,0,67,1301,40,7666,27
68620,119,2717,104,2308,20402,409
58325,52,311,427,241,5585,70
29549,158,4557,1050,2984,68642,1573
11789,792,21546,1361,12279,91904,9267
18028,12243,498548,1269,294154,1735544,204394
58249,31,212,430,167,3334,45
63854,718,12259,250,9909,106560,2350
14549,91,2570,1324,1812,17501,758
300,419,17055,1467,11971,99772,5084
789,89,2466,1463,1412,31489,1054
51202,263,3644,643,3184,22450,460
68233,13,199,119,166,4029,33
53332,29,409,578,315,5244,94
52865,8,115,590,96,7105,19
6433,7,246,1405,155,7343,91
6855,26,482,1399,352,28904,130
12324,36,3684,1355,1950,27290,1734
45013,70,1433,763,1104,8858,329
3772,38,917,1438,685,13848,232
56922,2648,29715,468,22287,123300,7428
3625,74,1194,1439,734,14701,460
13455,16,642,1340,317,13557,325
10156,25,972,1374,596,5525,376
17501,74,2846,1279,1945,26965,901
56607,29,500,477,411,4301,89
21722,46,1481,1204,994,23474,487
6018,11,230,1410,172,9145,58
36252,3247,90653,916,64233,350705,26420
33917,10,116,971,102,3446,14
34442,57,1654,960,1058,22064,596
34004,80,1469,963,973,16102,496
66851,200,3500,162,2881,37843,619
25831,15,224,1127,184,9461,40
26068,89,1875,1121,1315,22133,560
30189,1321,45910,1036,32702,340783,13208
14392,1623,66861,1326,41387,380953,25474
18079,8,132,1268,95,10867,37
15174,6,469,1316,322,10635,147
58829,148,2449,411,1997,25193,452
60831,33,309,340,238,10592,71
5821,95,1734,1412,1189,25704,545
36207,292,5779,904,4491,56038,1288
50458,39,554,663,385,4113,169
43949,32,460,775,330,10547,130
12754,196,9956,1350,6074,58992,3882
48233,17,249,724,193,13188,56
67953,1,49,127,38,2109,11
12939,39,904,1347,445,13125,459
50123,346,6421,671,5344,70945,1077
8532,48,1926,1382,1271,20260,655
2204,56,1570,1452,1086,20577,484
24724,38,1428,1150,956,20297,472
4816,15,567,1424,395,27116,172
15496,12,116,1312,93,3840,23
110,144,4606,1470,3293,55671,1313
148,1365,75636,1469,46025,336366,29611
11602,8,450,1363,227,11019,223
18951,2,99,1253,78,7661,21
24391,173,5106,1158,3653,78014,1453
28158,31,1407,1076,855,21183,552
12851,683,24318,1349,15987,101824,8331
35872,4,112,926,61,3905,51
36515,19,380,907,323,14615,57
64906,5,28,217,19,4874,9
15313,26,777,1315,563,14527,214
51693,58,1517,630,1134,11721,383
28757,26,782,1065,653,15469,129
19758,53,1477,1238,1031,19455,446
19232,0,0,1248,0,9178,0
135,278,15418,1470,9673,189078,5745
43903,18,380,776,288,12849,92
40308,70,1396,830,1079,22702,317
38442,19,313,858,237,10957,76
57259,7,94,460,66,5200,28
28404,48,891,1071,645,32949,246
34696,332,8791,954,5957,38592,2834
58290,102,2323,426,1730,21263,593
27844,63,1884,1082,1130,16091,754
791,45,1940,1463,1347,31094,593
62239,51,567,293,490,9158,77
67711,21,425,135,381,6673,44
67867,83,1247,129,1053,12974,194
64476,2,10,230,10,2063,0
35828,501,7728,927,5832,81792,1896
61616,272,5792,314,4843,69659,949
26665,221,8925,1107,5730,48076,3195
35839,250,3527,927,2807,95069,720
35165,9,243,943,166,4387,77
26706,3566,89608,1107,60218,315493,29390
1002,54058,2899030,1461,1346066,6302003,1552964
31285,37,837,1016,566,8317,271
64401,678,7585,232,6546,44911,1039
19673,91,2188,1240,1484,17774,704
33335,3108,75611,982,52030,150191,23581
5063,210,5935,1421,4115,58873,1820
20088,6,507,1232,380,11074,127
54521,27237,414980,539,282417,1798012,132563
21325,57,667,1211,480,17374,187
7844,1,136,1386,105,12141,31
61772,1,19,309,14,3369,5
53206,271,2623,580,2144,19266,479
23841,183,4441,1170,3346,58285,1095
50273,0,15,667,12,3507,3
57851,1,26,443,21,5633,5
29258,5818,146992,1055,100201,461246,46791
11143,2730,64615,1366,38383,379027,26232
63048,14,172,272,133,5677,39
32390,27,805,1000,546,5587,259
33715,16,548,975,359,17314,189
10654,46,1930,1370,1265,18449,665
59997,210,3406,371,2323,20621,1083
62576,40,459,283,340,7061,119
14151,97,2284,1330,1553,23506,731
22937,4805,160169,1185,109550,669522,50619
17531,40,2716,1278,1889,25877,827
9465,10087,255879,1378,140748,416353,115131
16262,41,1221,1300,828,10744,393
23932,4,188,1168,139,8530,49
60520,147,1001,352,962,11097,39
49346,17,201,691,174,4858,27
60217,14,245,363,205,7405,40
1463,8,334,1458,230,18858,104
52730,10,138,595,110,3978,28
357,41,1767,1467,1145,94103,622
1535,46,851,1458,679,40127,172
35527,14,211,934,136,6432,75
46088,672,21554,751,15742,103671,5812
52084,362,4515,618,3636,43036,879
9805,289,12639,1376,8108,45162,4531
36762,219,2808,904,2024,73502,784
41836,144,4044,805,3100,57324,944
57823,128,4146,444,3254,34842,892
13903,257,9179,1334,4724,45970,4455
64371,8,71,233,58,3869,13
57600,83,1416,451,1082,12349,334
53192,419,3207,581,2682,43042,525
56375,6,59,484,40,2556,19
63730,20,202,253,159,5338,43
6911,102,2685,1399,1699,13363,986
4895,169,15393,1423,9219,63063,6174
19805,61,1891,1237,1294,10941,597
29828,6,139,1044,99,5909,40
50112,96,933,671,761,10293,172
58852,115,1615,410,1202,16522,413
3783,58,1358,1437,857,18994,501
1434,1,187,1458,117,28030,70
62119,4,24,296,22,2427,2
21571,19,668,1206,440,20094,228
68210,14,149,119,121,3537,28
57779,12,72,445,64,5498,8
13910,310,10543,1334,6561,115807,3982
41591,12,199,809,163,5876,36
16004,25,683,1304,464,26097,219
22336,51,1215,1196,959,36240,256
12524,24,995,1353,591,30784,404
8250,5,307,1383,185,16152,122
38829,14090,316666,849,216229,1001865,100437
36786,131,1569,903,1367,31834,202
29103,66,893,1058,515,8324,378
877,21,961,1462,706,19871,255
29751,47,1384,1046,757,13005,627
37010,249,4268,897,3718,45755,550
9361,24,1003,1378,690,17612,313
14504,2001,78928,1325,41593,244658,37335
63374,22,213,263,171,9867,42
55141,2,52,518,49,7760,3
25824,106,1789,1127,1180,19584,609
42280,8393,158694,799,119143,621916,39551
13776,54,2395,1336,1555,17201,840
68154,2,31,121,19,4347,12
10867,63,2855,1369,1533,19988,1322
22821,3604,104647,1188,69668,290237,34979
67573,10,176,138,138,5230,38
53716,884,13580,567,10060,85279,3520
60896,662,9065,338,7541,72102,1524
23788,74,3095,1171,2304,56705,791
67258,842,15882,149,11630,96049,4252
13271,199,3975,1343,2573,36730,1402
8076,6,325,1384,221,19728,104
26388,39,3031,1114,2000,37892,1031
15869,5,164,1306,96,3205,68
7481,6,315,1391,224,36040,91
28258,2546,91959,1074,54768,425152,37191
36460,22,619,909,496,12278,123
18627,193,8508,1258,5838,32613,2670
15762,17,758,1308,517,19390,241
53455,642,10135,575,8004,108821,2131
15160,776,18716,1317,12578,198003,6138
31231,134,4675,1017,3762,32230,913
7659,63,2093,1388,1138,10871,955
18141,6,254,1267,216,40315,38
15104,26,411,1318,274,6170,137
10293,80,1707,1373,1123,16376,584
52446,63,1033,606,787,21975,246
7767,29,1981,1387,1280,20469,701
27142,128,1908,1097,1136,14123,772
21026,88,3701,1216,2827,25685,874
15871,31,736,1306,555,17331,181
6957,30,1070,1398,770,29542,300
58099,185,3255,435,2499,35177,756
1830,42,1160,1455,805,31425,355
15180,60,3276,1316,1984,73930,1292
18370,5,121,1263,91,10345,30
40695,931,12036,824,9656,125685,2380
68249,39,386,118,340,7622,46
34914,817,12194,949,8789,74883,3405
38977,51,627,848,558,11896,69
64595,8,110,227,78,3698,32
22417,62,2960,1195,2391,32477,569
35263,76,1813,940,1359,13157,454
42564,1043,12963,794,10013,98725,2950
6281,21,716,1407,459,16119,257
66040,43,297,188,219,2970,78
34750,9,263,953,150,5823,113
20008,14,569,1234,423,7428,146
14578,0,76,1324,42,13276,34
2139,15,674,1453,440,12275,234
51151,20,252,645,188,5829,64
4381,3,94,1430,70,10724,24
50324,1373,19191,666,15343,73030,3848
785,165,4333,1463,2881,44489,1452
8825,1318,30171,1380,20385,138786,9786
3696,1,131,1438,94,6244,37
24618,213,4645,1153,3418,26750,1227
17761,260,5645,1274,3932,32585,1713
57805,363,7701,445,5400,29270,2301
58034,13,188,437,166,5833,22
28612,39,1055,1067,638,17221,417
41135,83,1544,816,1266,30344,278
56569,69,1089,478,893,10989,196
31957,76,2038,1006,1281,13255,757
29662,1005,23897,1048,14649,165294,9248
60735,23,701,344,364,8046,337
67025,50,1883,157,1137,16547,746
15488,30,1432,1312,1008,15391,424
58557,62,731,419,596,8263,135
1464,22,934,1458,648,18072,286
27282,21,300,1095,256,10944,44
36503,29,434,908,356,9926,78
20286,120,5063,1229,3859,56703,1204
52868,15,185,590,145,9578,40
51319,1656,35824,640,21984,280328,13840
20310,89,4434,1229,3251,34538,1183
65311,0,5,206,5,1749,0
18631,0,70,1258,48,4469,22
55364,2080,51518,512,38510,204649,13008
8377,20,969,1382,518,10830,451
52004,953,13930,621,11315,74351,2615
3245,130,1609,1443,1155,17094,454
43553,18,764,779,569,17190,195
53890,143,1361,561,985,6217,376
23157,35,2315,1182,1382,16254,933
60225,23,462,362,336,14336,126
24373,0,0,1158,0,10365,0
14618,30,816,1323,562,18396,254
68677,1,56,102,35,3792,21
66826,47,667,163,570,18312,97
824,399,20486,1463,13014,123459,7472
28228,34,845,1075,670,16733,175
149,57,3180,1469,2244,25635,936
17235,363,8209,1284,6222,78570,1987
5690,32,675,1414,404,12177,271
49607,22,321,685,227,15431,94
69009,1,41,91,28,1020,13
49593,626,7583,685,6220,62082,1363
50990,36,776,649,613,8264,163
19527,8,268,1242,175,5306,93
55734,25,375,502,292,7560,83
46672,1968,27289,744,21840,230965,5449
40190,4950,106189,831,86204,298791,19985
3679,57,1067,1439,769,20156,298
11738,11,425,1361,162,10473,263
12915,0,21,1348,12,3753,9
14261,38,1088,1328,683,12893,405
67234,8,219,150,154,6117,65
57557,32,273,452,226,6271,47
58281,48,1003,429,793,17608,210
58945,221,3716,407,2482,47228,1234
27485,48,1033,1090,648,13352,385
8431,783,17298,1382,10950,71915,6348
16357,1,101,1298,61,9101,40
17097,42,1567,1286,1259,44192,308
53545,256,3533,573,3037,29935,496
13944,23,1241,1333,819,21031,422
66791,8,152,165,114,4220,38
54638,28,317,534,231,4799,86
17383,0,162,1281,140,6497,22
24015,1180,30144,1166,20013,153826,10131
14336,6,132,1327,89,3210,43
64567,3,39,228,25,2328,14
31279,76,1222,1016,820,18477,402
11515,70,1775,1363,1146,28427,629
18872,54,1415,1254,1031,12598,384
11835,7,641,1360,250,14895,391
5928,7,504,1411,356,19118,148
37820,8,272,874,200,8510,72
2084,1029,48801,1453,29433,132900,19368
44418,945,14044,769,11270,71264,2774
5836,2,171,1412,126,13013,45
63067,56,978,271,783,10217,195
9914,18,562,1375,340,8637,222
27287,52,1198,1094,889,26872,309
30801,16,654,1024,446,21332,208
21716,6,251,1204,178,13588,73
9237,24,456,1379,268,4486,188
55401,97,2260,511,1637,17231,623
28235,40837,735473,1074,534914,1307399,200559
50444,45,746,663,540,9104,206
26572,120,4641,1110,3040,21432,1601
53463,58,578,575,486,6219,92
2275,12057,471903,1452,283603,1153639,188300
17828,50,2059,1272,1551,32054,508
35133,33,613,944,452,15721,161
58118,262,5120,434,3944,14873,1176
32254,47,1086,1002,858,29215,228
64771,115,963,222,727,5072,236
9112,9,130,1379,95,4233,35
39819,8,153,837,114,5734,39
29862,2,80,1043,52,4964,28
25446,34,797,1135,507,4856,290
64045,59,623,243,498,14796,125
41680,42,670,808,521,8175,149
48691,178,1781,712,1377,19990,404
15225,940,19488,1316,14693,94113,4795
37274,23,447,889,338,6273,109
15919,380,15937,1305,11917,49543,4020
65666,17,160,198,136,5068,24
67679,26,459,136,357,6990,102
54344,1384,15278,546,12519,120283,2759
12758,34,1008,1350,560,10881,448
36972,3,64,898,39,5700,25
7570,6,85,1390,58,3845,27
5948,144,10027,1411,6469,48811,3558
8508,37,1185,1382,716,12474,469
26373,1,193,1115,131,7530,62
53918,329,2788,561,2171,17744,617
28030,424,6473,1078,4353,22524,2120
10981,2,236,1368,128,6604,108
8149,385,6947,1383,4527,47400,2420
49085,79,800,699,688,10837,112
12503,56,2400,1353,1521,66423,879
37251,25,710,889,583,10749,127
51855,10,194,625,164,3513,30
51713,171,1412,629,1121,19802,291
65383,163,2420,204,1876,22524,544
30055,93,1485,1039,951,23871,534
4241,19,515,1432,348,13504,167
36463,20,442,909,338,7626,104
15781,118,3918,1308,2652,54593,1266
15997,91,1260,1304,958,18208,302
67588,15,271,138,245,8090,26
27895,17,434,1081,270,6002,164
35564,2837,50632,933,40542,323421,10090
7600,389,10924,1389,7016,59175,3908
14583,4,168,1324,120,10625,48
38506,243,5469,802,4504,74643,965
27939,11,475,1080,371,27070,104
34734,4,55,953,41,5166,14
52107,33,407,617,343,5460,64
67187,3,61,151,39,3752,22
6982,8,479,1398,357,26778,122
48471,40,300,720,266,7944,34
1852,250,4108,1455,2484,29355,1624
62268,9,82,292,62,3111,20
66467,7,83,175,56,3949,27
65249,43,317,208,275,4066,42
64152,203,5009,240,3376,55958,1633
32541,72,3441,996,2269,39896,1172
37361,20,537,886,477,15101,60
67360,74,788,146,638,11603,150
37810,73,2895,874,1629,20654,1266
35837,1776,30611,926,23378,161302,7233
21177,15,418,1213,329,6535,89
23294,15,356,1180,220,5413,136
33959,6791,100559,971,74819,384636,25740
14156,559,17227,1330,11662,88373,5565
55650,18,205,504,148,4553,57
8916,470,16080,1380,10266,105538,5814
37979,487,13687,870,10433,173292,3254
29452,993,19751,1051,12723,142930,7028
34010,1348,17233,970,11250,59570,5983
20788,28,726,1221,612,22162,114
9893,115,2622,1375,1621,15127,1001
37738,709,9542,876,6791,35593,2751
51951,41,733,623,642,9739,91
62921,69,1139,274,911,10093,228
8191,23,713,1383,479,7468,234
20741,1046,41321,1222,31426,296652,9895
12281,1580,44100,1356,27164,208413,16936
17495,7,443,1279,368,17762,75
21906,5,276,1202,157,8741,119
64705,23,340,224,259,3975,81
14890,49,1041,1321,668,44069,373
39073,826,38602,846,31609,294615,6993
57662,24,259,449,211,4860,48
20350,40,1941,1228,1357,17215,584
28957,4319,88067,1061,63185,324653,24882
37637,266,3634,879,2859,43095,775
56692,37,401,475,347,9418,54
35296,14,756,938,455,10796,301
51488,5,77,636,67,6105,10
60560,113,798,351,720,8666,78
49565,67,1575,686,1377,59866,198
29458,31,801,1051,527,12264,274
55952,1035,12084,497,10917,72175,1167
6877,150,2457,1399,1542,18226,915
30479,32,993,1030,615,16297,378
9658,17,621,1377,431,10219,190
24751,124,5036,1149,3332,27681,1704
8626,45,1358,1381,818,15869,540
68460,4,52,110,40,2691,12
27317,89,2104,1094,1407,15398,697
3193,201,7227,1443,5331,45719,1896
22279,32,773,1197,505,14172,268
30229,5,156,1036,108,3812,48
25065,23,811,1142,565,33918,246
1925,72,1634,1455,1184,49761,450
37179,29,408,892,307,17179,101
52903,7,100,589,83,11648,17
17117,3,164,1286,114,17076,50
48593,1794,25586,714,20212,268656,5374
34689,31,723,954,554,11653,169
6027,42,2511,1410,1567,35418,944
7524,188,6497,1390,4653,80411,1844
25894,32,348,1125,198,7659,150
59125,4,50,401,41,3605,9
29938,14,509,1042,299,11236,210
15083,104,2709,1318,1814,35354,895
6110,12,472,1409,321,17669,151
4530,25,587,1428,443,18192,144
2327,35,1276,1451,953,46930,323
2827,25,1341,1447,812,14507,529
63349,645,8227,263,5951,66555,2276
57143,493,6818,463,5648,40623,1170
22575,316,5694,1192,3990,37598,1704
56685,376,4072,475,3202,35951,870
47517,251,2669,733,2139,35863,530
62006,54,551,301,429,9548,122
61570,16,184,315,134,5621,50
20860,6,594,1219,422,13802,172
37105,9,243,894,219,13428,24
44441,87,1077,769,934,17118,143
33905,257,7830,972,5845,43484,1985
25990,11,351,1123,303,10935,48
50033,20,618,674,364,11407,254
62639,813,10005,281,8241,66450,1764
35355,25,582,938,481,15513,101
33902,564,10140,972,7475,68957,2665
48707,2730,48024,711,38773,242690,9251
398,434,14324,1466,8512,50795,5812
48612,9,156,714,125,6364,31
5535,7,217,1415,164,5970,53
9056,54,1277,1379,804,14139,473
21380,176,5613,1210,4091,66552,1522
50418,1681,23926,663,18011,87951,5915
54321,12,328,547,225,3475,103
59615,5,52,384,39,3016,13
34258,247,4954,963,3637,26060,1317
6580,107,3129,1403,2093,21221,1036
64013,105,712,244,569,7517,143
60943,17,324,336,247,5884,77
20344,48,1251,1228,956,28535,295
20124,18,308,1232,183,4587,125
66069,6,71,187,51,1981,20
57128,12,117,463,94,4831,23
4605,223,5330,1427,3636,43258,1694
61889,1295,29114,305,23247,122355,5867
54527,40159,572338,539,427191,2381401,145147
14443,4334,443458,1325,257764,848750,185694
61716,179,2521,311,2100,20015,421
49994,965,14044,675,10878,81435,3166
55264,838,14036,515,11865,66303,2171
52353,36,725,609,593,18054,132
3085,6,284,1445,198,12327,86
1370,3239,97961,1459,63744,415293,34217
7145,2,150,1395,101,23237,49
15898,22,889,1305,634,13749,255
63661,28,470,255,350,7498,120
14543,17,577,1324,439,12769,138
63430,65,864,261,654,14473,210
12150,76,3485,1357,2065,17448,1420
32128,79,1190,1004,852,10676,338
1507,8,934,1458,539,23058,395
50747,12,233,618,202,10625,31
11027,14,621,1367,362,32717,259
15107,132,2647,1318,1728,25192,919
40009,207,3135,834,2610,31909,525
25827,28,353,1127,242,42788,111
46703,526,8859,743,5807,52021,3052
61484,65,604,318,508,7581,96
26332,421,8695,1116,5717,58484,2978
9682,32,1150,1377,780,20142,370
61992,106,1980,301,1710,25924,270
29168,241,3571,1056,2380,36955,1191
10589,11,444,1371,277,16969,167
42832,51,893,789,640,14071,253
34192,368,7949,966,5309,94677,2640
24060,28,568,1165,405,15921,163
58157,63,1127,433,871,17102,256
54212,668,13774,550,11060,63651,2714
48831,16,255,707,181,7187,74
3246,0,290,1443,223,24394,67
2864,1,92,1447,61,7281,31
35846,48,1101,927,863,19204,238
63326,49,798,264,598,14057,200
21096,11,604,1215,444,10743,160
26617,1356,25052,1109,16339,153385,8713
30985,32,419,1021,381,68747,38
61533,20,328,317,238,7592,90
14832,4,236,1321,148,4889,88
21782,26,724,1203,509,8967,215
16169,21,281,1301,230,14977,51
18296,1346,35474,1264,24914,347791,10560
33256,885,13786,984,9558,54141,4228
67137,4,49,153,38,3432,11
155,808,38807,1469,22932,158899,15875
16061,11,411,1302,292,9169,119
39266,0,32,844,26,3231,6
19917,70,2029,1236,1335,31872,694
16763,36,729,1291,490,11578,239
62868,57,705,276,624,8656,81
63165,15,253,262,231,2340,22
49001,11,130,702,86,4697,44
27757,7,258,1084,160,9344,98
30082,25,966,1038,673,18051,293
13136,232,9660,1344,5917,71433,3743
2790,41,3456,1447,2296,23275,1160
8507,651,10664,1382,7146,44125,3518
22689,291,4875,1190,3286,30978,1589
61878,112,1041,305,898,12724,143
8057,21,244,1384,171,9421,73
7001,256,7946,1397,5419,43508,2527
6782,14,519,1400,320,7929,199
7803,2,168,1386,81,7621,87
56663,34,598,476,414,13312,184
36028,26,418,922,335,13995,83
67203,57,1019,151,823,20372,196
64704,24,314,224,275,9327,39
50501,3389,141096,655,111613,637746,29483
49812,97,2172,679,1851,18048,321
13388,4,301,1341,166,12407,135
25648,165,4246,1130,2179,56763,2067
14665,36,1486,1323,1092,20400,394
57714,59,521,448,409,8248,112
30928,173,2141,1022,1394,13448,747
33088,242,3098,987,2104,18118,994
53537,6,342,573,284,7575,58
34626,45,508,954,414,7023,94
66187,8,178,183,130,4928,48
24446,452,8601,1157,5288,29510,3313
4923,66,1865,1423,1199,50566,666
30120,359,11061,1038,7728,40907,3333
64429,30,374,231,297,6909,77
47901,36,520,729,418,12687,102
54868,1396,19078,526,14729,73780,4349
11148,180,6693,1366,3691,46262,3002
19261,500,11499,1247,7362,37818,4137
2806,1,195,1447,125,17150,70
1078,427,23724,1461,16325,137617,7399
16757,784,28402,1292,19408,245409,8994
18632,108,3955,1258,2819,47266,1136
36940,48,918,899,730,16032,188
19659,5,285,1240,191,19859,94
27079,95,2336,1099,1506,16572,830
31354,302,5849,1015,3484,71189,2365
29118,165,4365,1057,3060,54391,1305
58283,4942,66357,428,52636,174082,13721
18249,54,2148,1265,1650,18692,498
4055,27,820,1435,567,7469,253
3343,12,355,1442,239,35967,116
33450,46,910,980,706,9267,204
30874,21,901,1023,611,5795,290
66871,4,39,162,32,1186,7
30939,157,10069,1022,6397,46524,3672
35994,39,601,923,457,9929,144
49194,449,4455,696,3351,22663,1104
5805,10,169,1412,133,7539,36
5864,30,1175,1412,775,46818,400
41041,9,196,818,166,7078,30
61973,143,1761,302,1345,12107,416
31047,282,7824,1020,5278,59820,2546
59519,1001,14314,388,11382,64803,2932
63302,13,116,265,94,1877,22
15429,50,1421,1313,1115,30932,306
15269,51,1552,1315,1012,26530,540
61096,42,1131,330,840,7362,291
30956,17,756,1022,460,6584,296
125,4,189,1470,121,5309,68
52521,54,1020,602,805,31385,215
25070,1585,44177,1142,27166,236968,17011
2756,27,1440,1448,954,24368,486
17939,5,243,1270,163,8139,80
9730,51,1653,1376,1110,41151,543
32976,4,88,989,56,7888,32
2105,1,150,1453,101,19799,49
28981,346,11024,1060,7011,57494,4013
13707,59,2509,1337,1351,22097,1158
14821,86,2251,1321,1492,53270,759
63186,10,82,268,67,11337,15
67896,30,662,129,530,13542,132
29576,188,3249,1049,1687,13465,1562
29374,269,3597,1053,2500,32140,1097
21268,6,468,1212,328,7706,140
51854,190,2548,625,1948,15421,600
67034,356,6251,156,5055,50025,1196
27818,5,184,1083,98,12793,86
54117,38,401,554,334,10104,67
1862,7,455,1455,315,17420,140
2458,111,2700,1450,1504,22959,1196
28932,23,2991,1061,2467,14341,524
24949,7,223,1145,141,12650,82
28489,362,18355,1070,12083,88891,6272
9907,5,255,1375,178,13851,77
29652,15,569,1048,353,5985,216
56936,10,127,468,107,3190,20
28359,200,5416,1072,4236,85858,1180
3008,58,3391,1445,2398,46741,993
377,15,679,1467,391,20453,288
60136,98,1247,367,860,16535,387
22110,338,5667,1199,4010,45563,1657
5566,8,231,1415,156,11557,75
63490,8,110,260,90,5041,20
10859,21,848,1369,475,7294,373
26875,24,806,1103,594,13181,212
32475,71,1702,997,1152,13310,550
24376,92,2656,1158,1938,34248,718
48545,10,148,716,119,8438,29
54322,2327,40430,547,27614,107607,12816
7202,279,11413,1394,7310,52798,4103
40124,41,441,832,353,18949,88
59637,41,501,384,356,14255,145
25090,217,3729,1142,2310,20727,1419
37340,407,9588,887,7448,86081,2140
11990,46,2418,1359,1217,33737,1201
62905,29,382,275,351,4016,31
38225,9,229,864,204,7498,25
43405,29,430,781,324,8903,106
15638,11,157,1310,112,11584,45
31362,172,2861,1015,1845,25929,1016
55471,0,30,509,19,1840,11
21872,11,655,1202,443,19384,212
22372,102,3961,1196,2619,32447,1342
33612,29,1284,977,840,23595,444
25706,294,10131,1129,6752,57113,3379
24028,18,438,1166,292,8123,146
56927,22,442,468,349,13798,93
32012,34,1600,1005,1062,31208,538
22765,14887,323623,1189,198646,754173,124977
34371,157,5304,962,3613,25362,1691
23085,2124,48312,1183,37001,221363,11311
11588,75,3235,1363,2066,24237,1169
56679,146,1845,475,1516,12974,329
51808,436,7777,626,6673,58328,1104
6603,0,0,1402,0,16944,0
24079,852,28676,1165,19484,169770,9192
53958,187,2245,560,1878,13719,367
9855,119,3099,1375,2238,29496,861
18061,4,225,1268,142,7790,83
3292,41,609,1442,472,10375,137
62890,2,35,275,35,2869,0
49557,187,1924,686,1540,8059,384
8998,33,777,1380,549,9555,228
9194,140,2103,1379,1194,13051,909
61147,20,316,328,222,7034,94
20588,93,1948,1224,1261,33689,687
3281,35,1386,1442,949,51203,437
1175,56703,1730952,1460,920372,3552792,810580
51595,32,349,632,249,3506,100
67508,10,84,141,72,2448,12
51504,32,177,635,160,5324,17
27033,80,2735,1100,2321,29474,414
10896,62,1374,1368,857,13122,517
6557,339,17574,1403,10876,245909,6698
59701,336,7054,381,5446,20315,1608
42995,91,1183,787,959,17104,224
13227,52,1722,1343,1138,21930,584
37040,26,543,896,456,9114,87
54314,656,7496,547,5475,27093,2021
8650,38,1144,1381,724,10668,420
54285,146,1260,547,989,14922,271
57968,213,4723,439,3850,28836,873
6313,19,724,1406,494,11176,230
66671,346,7861,169,6607,101224,1254
39154,39,570,845,438,7154,132
16089,438,9023,1302,6297,45183,2726
6575,1473,58392,1403,37837,255449,20555
53851,44,545,563,478,8172,67
65614,1,11,199,6,1212,5
30632,16,433,1028,293,7422,140
35218,4,93,941,82,2398,11
10236,22,816,1373,537,13683,279
29518,852,16432,1050,9929,66755,6503
61057,7,92,332,77,6807,15
4147,7,374,1434,281,28823,93
18747,30,635,1256,451,7552,184
14124,12,335,1330,247,8543,88
7564,88,1812,1390,1175,23375,637
14944,55,1485,1320,1004,12544,481
17473,2100,66374,1279,43627,497858,22747
3326,1,166,1442,115,16591,51
67052,6,131,156,95,2881,36
40295,36,471,830,362,8113,109
987,88,2336,1461,1726,20807,610
21333,137,2270,1211,1625,26457,645
34861,5,319,950,273,15849,46
9743,1,79,1376,30,6723,49
47156,5,66,738,54,2347,12
20341,148,5112,1228,3415,25390,1697
9616,15,439,1377,286,6379,153
63258,114,1702,266,1400,16866,302
3154,38,944,1444,699,19986,245
52941,85,1163,589,938,13738,225
49249,2,16,694,13,2248,3
24273,30387,827689,1161,450915,2353501,376774
13037,8,527,1346,286,8238,241
18864,10,418,1254,258,6515,160
63597,22,265,257,212,4741,53
11155,18,804,1366,531,8942,273
48520,9,138,718,96,4051,42
354,103,2859,1467,1685,53508,1174
3078,138,3828,1445,2351,16734,1477
62253,13,317,293,263,8295,54
16696,21,1083,1293,811,16364,272
50211,340,3616,669,2784,31637,832
2927,47,1504,1446,928,72948,576
32854,125,2282,991,1659,16595,623
48735,15,155,711,124,3993,31
952,1089,19998,1462,12789,80165,7209
23665,50,832,1173,570,20954,262
48069,40,349,726,230,3747,119
62191,34,407,294,340,8527,67
60258,92,1663,362,1170,19177,493
22757,20,408,1189,305,12884,103
11063,41,1326,1367,855,11365,471
27311,153,3962,1094,2502,21306,1460
47235,45,1051,736,756,16688,295
60846,1094,23822,324,16934,205476,6888
12167,28,623,1357,361,32272,262
28385,13,501,1072,344,9484,157
60951,7,84,336,52,2720,32
20747,67,3956,1221,2926,39808,1030
57282,12,247,458,223,7725,24
23322,140,4486,1180,3134,37064,1352
63598,270,3826,257,3033,21945,793
28402,16,609,1071,386,36313,223
49029,139,2173,701,1640,32806,533
61960,76,857,303,687,11146,170
41210,2980,58618,815,42439,262185,16179
12277,34,6308,1356,2788,16063,3520
37248,32,732,889,548,12410,184
12015,1628,60905,1359,34293,319056,26612
12761,190,9155,1350,6052,68199,3103
25804,138,2747,1127,1811,25777,936
64654,87,1114,225,900,9520,214
13145,226,13500,1344,7636,67979,5864
18905,52,557,1253,431,11440,126
31843,225,3134,1008,2036,16738,1098
14325,166,7525,1327,5386,94803,2139
48781,47,516,709,415,7429,101
52463,44,912,604,732,16173,180
60380,12,272,358,203,9558,69
7686,54,2101,1388,1426,31629,675
64027,11,149,244,96,3940,53
25023,25,827,1143,535,10893,292
62346,1839,17968,290,15100,95398,2868
54342,51,489,546,385,11749,104
57890,1,46,442,25,1460,21
6405,491,13023,1405,9457,71028,3566
67260,7,126,149,79,6649,47
61066,18,281,332,212,13792,69
18962,93,1294,1253,861,9806,433
51531,162,2656,635,2092,16286,564
43472,55,770,780,653,12726,117
12449,179,3602,1354,2167,43641,1435
55995,24,229,495,163,5043,66
36069,128,2702,920,2252,38173,450
40329,33,765,830,624,22632,141
52999,15,353,587,258,17325,95
13044,225,7573,1346,4145,63222,3428
62469,181,3520,286,2748,66512,772
64235,9,56,237,55,1616,1
51922,1,24,624,15,3563,9
35525,321,5822,934,4315,36006,1507
41610,3,76,808,60,3003,16
60499,47,454,353,361,5527,93
35891,39,1362,926,1002,10170,360
30882,61,2353,1023,1861,18722,492
9571,3064,151306,1377,73911,282133,77395
34472,62,1991,960,1345,27848,646
35329,747,13281,938,9707,78481,3574
12358,416,8295,1355,4863,35508,3432
10829,6,420,1369,279,13831,141
66232,19,1028,182,748,5514,280
23603,285,6580,1175,4327,90484,2253
18405,3,135,1262,92,3162,43
67170,5,100,152,66,2195,34
17827,181,6546,1272,4459,48833,2087
10272,226,4063,1373,2917,53845,1146
66036,53,505,187,443,10084,62
3104,12568,491151,1444,319923,1555134,171228
41599,499,7922,809,5889,38659,2033
42570,9,311,794,252,8915,59
54779,20,147,530,115,3029,32
65547,182,3110,201,2647,32500,463
35491,29,293,935,216,4686,77
27913,40,1116,1080,626,9615,490
17780,147,4654,1273,3275,160847,1379
10540,520,10397,1371,7070,69874,3327
64278,71,1246,235,1075,9383,171
69057,3,36,90,27,3766,9
33449,17,268,980,180,3891,88
26225,165,3349,1118,2888,28979,461
64170,19,303,239,244,10256,59
37880,34,595,873,516,12080,79
15951,49,1063,1305,676,33541,387
18129,68,2336,1267,1214,11170,1122
24810,3896,93172,1148,62766,230858,30406
23729,72,1828,1172,1283,19517,545
19811,105,2879,1237,1981,40574,898
29894,173,2874,1042,2148,51677,726
33780,125,2080,974,1459,25742,621
23409,172,6165,1178,3937,63392,2228
21065,189,2328,1215,1885,21566,443
61682,192,3389,293,2699,46265,690
17551,36,1588,1278,888,10559,700
18319,98,5370,1264,3591,43396,1779
67916,95,1634,125,1373,17198,261
17136,156,2146,1285,1556,20848,590
59493,22,301,389,234,5196,67
14894,109,1134,1320,821,16925,313
52540,12,157,602,136,12571,21
4013,58,1202,1435,828,28802,374
14933,136,2772,1320,1891,26567,881
51094,1344,12416,646,9699,82549,2717
58582,11,155,418,104,9494,51
38148,1039,19841,865,13767,62402,6074
35636,17,301,932,223,8371,78
31117,47,1164,1019,715,12375,449
59917,7,47,374,24,10173,23
60564,9,99,351,81,3654,18
26229,78,2190,1118,1785,57702,405
33118,31,543,987,330,8641,213
28908,149,1791,1062,1176,19450,615
3809,11802,704434,1437,382426,2352845,322008
34122,165,3301,967,2388,29261,913
48670,53,995,712,701,17976,294
63219,36,657,267,560,19983,97
63532,225,4617,259,3862,36465,755
23653,357,8500,1174,5870,34900,2630
53789,52,497,565,390,8686,107
61084,17,202,331,177,4859,25
25801,21,404,1127,267,13497,137
33051,102,2562,988,1569,18775,993
61848,7,110,307,82,1548,28
52797,27,264,593,221,6034,43
61579,48,1309,315,1017,6840,292
10130,33,900,1374,633,12651,267
51703,2136,36224,629,29661,165383,6563
32834,163,2220,992,1500,15104,720
40065,77,1204,833,938,16314,266
61427,26,284,320,226,6106,58
30777,204,6037,1025,3593,18609,2444
61742,13,187,310,146,3032,41
51166,953,11759,644,8714,37916,3045
33372,193,7366,982,5253,50048,2113
6793,15,918,1400,435,8417,483
57508,29,214,454,155,3714,59
48569,11,176,715,126,4104,50
4503,455,10661,1429,7563,40151,3098
15072,12,617,1318,473,34310,144
60897,236,3365,337,2989,28854,376
1210,20,923,1460,680,28777,243
49227,17,409,695,251,9963,158
63403,870,11466,262,9114,77340,2352
38526,7,230,855,180,6213,50
34603,2,157,957,111,11609,46
28690,63,1096,1066,691,9567,405
56811,26,241,471,196,5292,45
22277,94,1304,1197,1057,23133,247
39898,12,365,836,250,6670,115
32118,10,176,1004,119,8480,57
20630,43,1610,1223,1112,17187,498
56009,11,153,495,117,5665,36
23707,8,198,1172,153,9202,45
64106,0,12806,241,10615,61577,2191
25143,172,2392,1141,1533,14002,859
64570,8,166,227,136,8460,30
1689,180,7748,1456,5226,142422,2522
37141,407,6026,893,4143,42793,1883
68212,62,1211,119,995,11379,216
20753,20,842,1221,579,14776,263
48290,1097,17884,710,13169,74340,4715
2960,94,1988,1446,1454,16798,534
7632,19,897,1389,664,13643,233
30979,329,4712,1021,3512,24843,1200
66855,12,73,162,58,2867,15
34961,249,4352,948,3128,22192,1224
66468,276,4859,164,3690,34031,1169
68616,1,120,104,87,8189,33
35079,1697,27194,945,18896,191271,8298
13011,7,345,1346,197,21680,148
25466,46,1843,1135,1043,22848,800
37610,0,23,879,18,2438,5
18400,3,198,1262,123,3606,75
68773,38,514,99,406,4917,108
3483,967,31535,1441,21217,71318,10318
58940,6,68,407,44,3671,24
51269,38,616,641,546,29615,70
20732,27,350,1222,264,12467,86
50425,28,503,664,397,10040,106
54343,98,1231,546,1079,17477,152
66313,44,764,180,620,3545,144
13833,16,448,1335,277,19239,171
30291,1088,19351,1034,12595,232276,6756
52375,83,983,608,789,23812,194
24085,100,2894,1164,2007,30564,887
5989,54,1716,1410,1218,72662,498
56631,2,42,477,25,4704,17
5755,3349,75136,1413,50599,232217,24537
35521,194,3905,934,3054,87194,851
53763,50,481,566,348,7525,133
9542,20,408,1377,249,9822,159
69015,3,23,91,15,3002,8
10018,37,2366,1374,1581,31615,785
7679,63,3480,1388,2189,41607,1291
9814,31,1082,1376,735,18340,347
40369,123,2060,829,1426,40019,634
53589,540,7134,572,5030,26289,2104
54603,38,323,536,240,6168,83
63193,309,5159,268,4224,36907,935
24943,142,4046,1145,2762,42742,1284
13690,94,3276,1337,1963,58802,1313
48778,40,389,709,270,4655,119
40259,123,1459,826,1156,14773,303
23507,28,939,1176,803,20618,136
16747,12,458,1292,341,19232,117
58135,11,198,434,125,3522,73
21791,83,1827,1203,1274,15475,553
54899,618,8678,512,7384,68404,1294
13633,283,11620,1337,7023,102317,4597
49493,26,394,688,268,4279,126
40980,57,821,819,683,15741,138
59446,95,1207,390,946,16171,261
37285,43,723,888,580,18076,143
28914,25,540,1061,307,4840,233
61545,153,5758,316,4786,45145,972
68379,7,129,114,101,4106,28
36247,42,516,916,393,12625,123
54092,28,202,554,169,5830,33
4256,24,2724,1432,2026,39600,698
42474,12,206,795,173,16635,33
46944,174,2571,740,2067,26498,504
29983,6,222,1041,147,13694,75
65184,1,62,209,38,3805,24
16771,19,820,1291,587,13256,233
41760,126,1321,806,953,18995,368
7280,21,479,1393,315,12988,164
51152,14,173,645,119,7755,54
62972,4,30,273,25,1809,5
18681,26,871,1258,674,10881,197
24326,212,2849,1159,1966,10869,883
62041,94,842,300,707,14160,135
33904,11,436,972,258,5888,178
38042,199,5985,866,4955,52359,1030
62315,33,1026,291,797,11907,229
18177,16,499,1266,379,12207,120
177,13,349,1469,265,16073,84
35987,4,76,923,54,5330,22
50225,345,6203,669,4907,42089,1296
25503,620,16818,1134,11880,54330,4938
8178,116,3034,1383,2137,29209,897
21472,33,754,1208,488,9304,266
14636,27,403,1323,294,13317,109
58556,36,595,419,509,16021,86
51580,464,8960,633,6990,40419,1970
52271,23,207,612,158,7210,49
2316,26,739,1451,509,24475,230
11900,37,2648,1360,1227,63461,1421
68393,39,529,113,417,5977,112
40607,15779,290218,825,190947,1421906,99271
48939,285,7473,704,6131,44873,1342
58378,587,15059,425,12486,62450,2573
3829,50474,2396202,1437,1231292,5248084,1164910
4003,480,17882,1435,11206,102518,6676
62773,56,1200,278,899,13814,301
29372,0,0,1053,0,5902,0
53050,31,385,585,289,5465,96
30610,40,1288,1028,887,22537,401
53386,183,1732,576,1394,10396,338
40862,25,405,821,272,3515,133
36459,3368,53483,909,43356,323355,10127
39996,2,132,834,105,9096,27
30981,9,487,1021,283,10711,204
12528,69,2571,1353,1648,16094,923
60067,10,163,369,135,10613,28
60133,34,262,367,245,6577,17
35948,94,1409,924,1083,18951,326
31927,863,14174,1007,9030,74249,5144
48886,10,190,706,142,8157,48
32797,6,184,993,147,11297,37
13394,31,721,1341,458,21034,263
26843,757,13770,1104,9037,56329,4733
29607,8,581,1049,330,15353,251
64778,148,1271,221,1013,17053,258
57853,10,188,442,126,5491,62
57142,107,1967,463,1491,11314,476
59464,249,2918,390,2288,28241,630
47888,534,11476,729,8816,109553,2660
8416,3,145,1382,96,3970,49
26273,26,1123,1117,736,16751,387
62959,0,41,274,20,1707,21
9413,201,10967,1378,5826,71076,5141
54194,105,1164,551,785,9119,379
54411,23,189,543,150,10119,39
51571,193,3004,633,2378,22756,626
61566,4,46,315,31,2762,15
40353,10,152,829,128,6911,24
19567,22,598,1242,483,19694,115
22556,11,317,1193,248,12845,69
6729,804,29552,1401,21067,165831,8485
51869,1792,20552,624,15377,71327,5175
23480,16,485,1177,335,7404,150
57828,7,170,444,128,5242,42
57777,34,409,445,308,8157,101
60480,9,114,354,90,2501,24
51042,24,606,648,402,7162,204
13524,81,3938,1339,2472,32529,1466
23265,16,794,1180,574,34801,220
13203,7,333,1344,194,5672,139
34031,1053,18227,969,12303,71389,5924
63002,36,537,273,422,6119,115
20826,1,46,1220,40,2794,6
53172,605,6604,581,5409,34028,1195
38501,14,336,856,235,5895,101
19584,18,536,1241,363,18516,173
12410,186,3659,1354,2063,25555,1596
9990,361,11506,1374,7347,76526,4159
1797,866,22719,1456,15823,91168,6896
32070,167,3443,1004,2412,40109,1031
35041,128,2960,946,2004,17772,956
32060,6923,141769,983,91446,294581,50323
18580,6,376,1259,296,20870,80
60687,35,593,346,506,18370,87
41016,32,356,818,251,3150,105
6169,10,384,1408,239,6747,145
17814,400,18263,1273,12282,100590,5981
33071,416,13476,987,10213,131991,3263
25465,83,1783,1135,1340,27898,443
9872,69,1840,1375,1274,31732,566
67716,10,171,135,133,7355,38
21270,11,215,1212,148,5708,67
15274,2,132,1315,64,7623,68
62509,42,667,284,557,13878,110
27220,233,3004,1096,1986,16525,1018
41643,32,813,808,576,11703,237
32919,128,4481,989,3243,45738,1238
43361,1,43,781,29,3610,14
48415,172,2211,721,1559,30838,652
68922,26,474,94,396,7805,78
25517,17,332,1134,225,12873,107
5563,126,2575,1415,1837,115280,738
49595,6,306,685,228,18078,78
50027,9,125,674,101,4100,24
36803,161,1333,903,942,7973,391
62163,4,46,295,37,2588,9
63601,9,165,257,116,5912,49
54587,18,135,537,102,6300,33
34116,107,1703,967,1132,25696,571
65665,12,225,198,176,4551,49
61092,33,575,330,411,14479,164
34557,61,1594,958,1099,17894,495
15527,539,14075,1311,10061,153286,4014
57300,14,162,458,123,7189,39
36767,3,69,896,57,4827,12
57417,283,3202,456,2639,30974,563
14166,20,456,1330,330,11696,126
22083,93,2179,1199,1619,32780,560
43997,4,176,774,133,24356,43
22671,11,531,1190,360,6163,171
24141,52,1151,1163,765,14393,386
50894,81,1330,652,1169,27670,161
44352,27,592,770,480,14400,112
64465,57,1060,230,822,8107,238
15748,7,525,1308,366,32944,159
4051,2,123,1435,87,11462,36
2859,519,10373,1447,6803,106514,3570
35206,16,361,941,268,5726,93
15261,152,7410,1316,5135,115313,2275
48891,16,177,706,117,3971,60
29080,8,600,1058,394,44777,206
41268,34,710,815,517,8605,193
16419,45,1639,1297,1112,20374,527
24919,0,18,1146,14,936,4
1288,46,996,1459,722,22827,274
21276,37,1424,1211,952,10112,472
643,50,1909,1464,1327,41130,582
6691,12,313,1401,237,15173,76
25418,69,1895,1136,1266,22513,629
66812,0,14,164,11,2143,3
7318,206,3079,1393,2089,29804,990
44547,901,24898,768,19483,121438,5415
20085,10,740,1232,586,12314,154
23436,0,0,1177,0,4972,0
21572,8226,231629,1206,141697,1188687,89932
57718,21,244,448,207,3892,37
13577,4,207,1338,116,7483,91
39908,25,236,836,177,3373,59
64514,55,689,229,559,7464,130
58139,238,3848,434,2967,24302,881
45147,3,114,762,83,4588,31
3374,1550,33398,1442,21332,172804,12066
34475,2372,33412,960,25825,155710,7587
62082,100,1097,298,891,6776,206
46899,18,290,741,209,3971,81
26759,7,281,1106,170,5582,111
16803,31,847,1291,646,34445,201
8870,48,2081,1380,1294,18402,787
15252,13,536,1316,398,6760,138
31764,70,2103,1009,1566,19105,537
6245,414,11594,1407,7615,50777,3979
9085,786,13339,1379,8034,73814,5305
26838,1362,34427,1104,23463,163657,10964
18760,42,1210,1256,906,37722,304
36066,19,420,921,324,9814,96
1593,259,11664,1457,7283,58600,4381
48741,2,49,710,35,5247,14
28926,4353,152664,1061,103664,721284,49000
5134,213,9816,1420,6585,96883,3231
64746,55,767,222,632,8794,135
61659,10,213,313,136,2456,77
28879,2762,77543,1062,46286,275643,31257
39415,24,442,842,339,11510,103
21978,12,310,1201,180,4198,130
56011,10,116,495,81,8432,35
48862,53,558,706,464,12299,94
38326,15745,412335,861,314831,1612057,97504
25699,51,721,1129,482,9507,239
23482,192,5257,1177,3098,40336,2159
12041,37,1203,1358,575,9991,628
16388,14,692,1297,415,10223,277
9556,79,2076,1377,1290,24149,786
33090,44,661,987,563,10056,98
28941,2115,60233,1061,39139,324652,21094
19017,23,460,1251,317,11320,143
8420,30,1130,1382,665,8020,465
45707,76,1144,756,834,12477,310
24505,79,3691,1155,1972,22477,1719
32723,1976,58918,994,37020,188038,21898
24619,1384,44227,1152,26765,278349,17462
28585,31,1493,1068,933,19758,560
66008,1002,13019,189,10642,39141,2377
61927,146,1483,304,1159,7817,324
8252,19,663,1383,479,13758,184
47427,160,1425,734,1081,10824,344
18938,420,5205,1253,3172,23423,2033
50355,754,12185,665,8868,118472,3317
30262,22,527,1035,370,6072,157
25296,15,277,1138,197,6206,80
49717,90,3432,682,1731,12612,1701
36766,389,7718,903,6336,65230,1382
10943,55,2528,1368,1387,53779,1141
30367,21,400,1033,356,7408,44
6593,102,2761,1402,1926,30204,835
29527,116,4521,1050,3134,26930,1387
68256,288,5949,118,4507,38223,1442
30233,17,938,1036,710,33826,228
66724,8,116,167,94,5258,22
9981,6,369,1375,247,9003,122
45769,12,149,755,114,3066,35
4842,205,4756,1424,3210,23007,1546
11877,97,4482,1360,2173,38688,2309
61799,36,642,308,545,12545,97
15750,20,774,1308,570,15979,204
19963,2,24,1235,21,3323,3
24122,20,588,1164,459,6626,129
9760,47,1306,1376,865,18420,441
33151,75,1568,986,1135,13377,433
57673,312,3018,449,2344,30787,674
24488,31,1370,1156,846,18029,524
67830,135,2681,131,1875,36489,806
31046,24,1176,1020,750,13642,426
18196,141,8645,1266,5873,89454,2772
31255,68574,1284656,1017,865013,2719614,419643
9781,7,348,1376,248,9891,100
17417,246,6922,1281,4795,55884,2127
64751,51,517,222,452,5602,65
3240,24,537,1443,376,40571,161
60686,22,217,346,133,18780,84
65237,37,640,208,491,5103,149
44831,12,236,765,177,5662,59
62036,350,7945,300,6072,33316,1873
49988,42,1067,675,613,9021,454
27605,19,296,1087,197,4417,99
61664,15,227,313,187,8061,40
31542,23,520,1013,434,13017,86
23477,329,4981,1177,3421,22428,1560
25939,13,129,1124,113,4794,16
50646,406,5436,658,4793,65576,643
61778,60,884,309,685,13765,199
67047,24,537,156,403,12051,134
23689,34,900,1173,627,9126,273
55111,15,162,519,144,7377,18
4104,173,2799,1434,2181,26828,618
48141,7,172,725,141,7283,31
62464,6,73,287,53,4467,20
34260,18,518,963,336,6254,182
23911,190,4923,1169,3426,109154,1497
66162,6,85,184,67,5686,18
61773,40,427,308,356,48282,71
16753,270,8441,1292,6118,58731,2323
5384,403,10052,1417,6916,46384,3136
57134,62,563,463,443,6019,120
32440,9,336,999,195,4120,141
6927,19,1006,1398,800,16397,206
62129,26,185,296,164,7490,21
60669,45,587,346,453,7757,134
6739,212,4224,1401,2468,19514,1756
21220,42,721,1212,470,13624,251
10290,0,0,1373,0,5065,0
66314,4,44,180,32,2102,12
48567,3,41,715,32,4074,9
54785,1713,18121,529,14856,129639,3265
13573,384,22533,1338,12721,100297,9812
6337,41,1222,1406,858,28316,364
19650,99,2379,1240,1517,27592,862
13535,180,2138,1339,1435,11497,703
16530,11,426,1295,296,13491,130
34131,335,6933,967,5036,50485,1897
35357,19,295,938,196,5824,99
4871,37,1785,1424,1176,36389,609
21143,293,6508,1214,4411,27558,2097
14585,38,1294,1324,960,36260,334
35852,74,1151,927,930,32585,221
49606,43,1247,685,966,15306,281
63893,10,141,248,123,3963,18
35642,6,169,932,131,7408,38
1368,729,27498,1459,17225,120818,10273
33866,1,85,973,68,14454,17
30128,368,11775,1037,8177,108250,3598
47259,808,8212,736,6273,44871,1939
51205,49,1038,643,718,10524,320
42436,64,969,796,627,16267,342
60605,22,175,349,132,4453,43
8236,5805,279127,1383,147792,861931,131335
65021,140,2416,213,2140,21412,276
31996,11,285,1006,180,7172,105
63408,1,19,262,14,2648,5
8866,740,15466,1380,9617,44918,5849
10057,115,2563,1374,1453,11237,1110
17724,55,5376,1274,3369,33558,2007
13708,4,377,1336,231,14065,146
3191,16,1217,1443,761,24870,456
48766,11,154,709,120,7483,34
2356,33287,1241204,1451,663439,4178312,577765
13219,238,5784,1344,3814,33416,1970
57284,42,627,459,548,11730,79
27493,13,533,1090,319,19070,214
39807,447,7506,837,5664,37956,1842
19311,119,4648,1246,3117,57809,1531
54797,6,93,529,54,7135,39
51722,84,1907,629,1303,19661,604
49730,60,588,681,476,14818,112
9489,22,244,1377,171,7630,73
7836,15,496,1386,366,30566,130
1595,3,161,1457,110,12412,51
6402,97,1495,1405,1036,24456,459
64813,25,197,220,143,13708,54
26827,35,795,1104,527,16494,268
21545,31,554,1207,408,5628,146
3626,12,268,1439,197,10976,71
24271,188,1577,1161,1161,19237,416
21953,8,152,1201,94,8210,58
3125,12,205,1444,144,10201,61
25254,4,135,1139,107,7627,28
32412,158,2248,999,1672,15819,576
18294,13,454,1264,334,26606,120
55291,46,635,514,501,15644,134
30747,547,9569,1025,6242,48614,3327
34285,15,435,963,315,10212,120
32732,20,491,994,418,5168,73
29394,67,3253,1052,1831,17575,1422
9037,3031,71847,1380,39997,118653,31850
14984,308,8009,1319,5594,69009,2415
66524,6,69,173,46,4271,23
55318,1,9,513,9,2281,0
68187,86,1722,120,1565,20630,157
28278,35,1126,1074,819,10583,307
1798,73,2236,1456,1562,17109,674
20348,65,1638,1228,1077,35371,561
66653,18,303,169,244,9540,59
58130,22,278,434,240,10660,38
38086,369,5824,867,4205,41831,1619
59618,9,109,384,78,2352,31
38002,11,156,869,107,12733,49
40365,80,633,829,500,3645,133
52038,0,49,620,37,2586,12
9377,5,247,1378,150,9295,97
66679,0,10,168,8,3833,2
55661,419,8527,504,6627,40124,1900
16611,832,12047,1294,8392,43967,3655
32702,5,214,994,140,10518,74
50148,140,1371,671,1136,10157,235
45514,18,225,757,175,15536,50
31825,15,440,1008,325,5653,115
18750,40,1980,1256,1156,22001,824
4550,194,4791,1428,3130,72673,1661
11942,648,19530,1359,12218,188227,7312
3055,16,633,1445,450,20201,183
41947,339,9667,803,7745,77060,1922
13041,0,0,1346,0,8487,0
59971,3,70,372,39,7875,31
31012,116,4247,1021,2659,64696,1588
52661,33,765,598,573,15587,192
56621,1,44,477,38,2947,6
29841,21,701,1044,408,10307,293
63599,20,344,257,263,10043,81
9021,211,6127,1380,3854,88283,2273
52085,50,497,618,427,11836,70
4085,1621,29262,1434,18221,128016,11041
1931,2431,68872,1455,41291,242230,27581
25003,40,950,1144,657,11244,293
9521,541,17655,1377,10839,71718,6816
55596,30,309,506,236,12196,73
67314,12,136,147,108,2636,28
23137,147,3021,1182,2099,30183,922
10307,22,934,1373,528,17228,406
258,6,394,1468,232,13180,162
15767,48,1108,1308,746,24679,362
37471,20,791,883,662,8631,129
16203,28,686,1300,438,16519,248
37172,17,249,892,194,8637,55
7827,36,970,1386,654,31450,316
31984,208,5584,1006,3887,31359,1697
1668,27,628,1457,433,22399,195
27613,0,0,1086,0,17932,0
54536,31,270,539,218,9261,52
41846,34,560,805,434,7835,126
7677,10,663,1388,485,12008,178
26379,9,968,1115,625,29011,343
7776,11,747,1387,468,17004,279
57877,33,444,442,310,18168,134
57035,106,2640,465,1922,31716,718
42532,64,657,794,509,15566,148
67884,4,122,129,94,2243,28
7562,81,3795,1390,2680,58254,1115
61034,118,2649,333,1916,23842,733
41112,15,303,817,241,6534,62
52621,38,602,599,458,13880,144
19793,204,5030,1238,3655,17611,1375
27961,57,929,1079,603,12579,326
37273,7,140,889,102,8421,38
33052,162,5480,988,3628,28386,1852
27187,3,93,1097,57,3669,36
67044,1,70,156,51,3063,19
8241,35,1977,1383,1230,24113,747
46002,6,210,752,154,6850,56
9174,32,968,1379,662,15027,306
64812,20,342,220,259,6625,83
57198,2100,30231,461,24280,132434,5951
27942,10,536,1080,307,22370,229
56916,1172,26439,468,20822,260814,5617
55394,172,3934,511,2988,25184,946
13470,16,587,1340,326,17363,261
2184,8,96,1452,76,9476,20
36302,183,2184,914,1861,23255,323
34669,55,962,955,649,6471,313
22386,66,1672,1195,1201,50599,471
38024,41,1245,869,1045,18571,200
10856,1083,46777,1369,29602,243385,17175
17610,16,1021,1277,761,30009,260
21344,792,15866,1210,10850,72085,5016
57953,219,2715,440,2260,34567,455
37333,45,1579,887,1314,17882,265
37989,415,3746,869,3139,26067,607
67537,40,378,140,277,4549,101
36079,857,13819,921,10901,194812,2918
2490,174,6129,1450,4386,24961,1743
35563,29,579,933,447,12654,132
28701,11,550,1065,308,8867,242
31218,18,607,1017,294,21195,313
12907,26,1493,1348,721,18434,772
65876,7,48,192,43,1880,5
49716,1311,26103,682,19473,107682,6630
6688,42,1514,1401,951,50217,563
54218,308,2505,547,2039,37080,466
59433,88,1565,391,1343,22986,222
13429,9396,174329,1340,105799,414747,68530
12300,35,1632,1356,1039,112228,593
22793,1322,37721,1188,23791,324998,13930
48363,47,907,722,717,26404,190
55270,18,342,515,295,11931,47
62898,5,128,275,112,2174,16
22530,55,1320,1193,807,11294,513
24040,15,654,1166,453,13570,201
68920,383,5723,94,4611,46013,1112
22178,21,595,1198,479,24259,116
62333,10,167,290,120,5709,47
6947,226,4542,1398,2719,53673,1823
55380,80,737,512,626,11855,111
17750,47,1184,1274,952,28910,232
64875,543,7519,181,5523,108903,1996
15579,331,6424,1311,4582,82137,1842
64592,20,249,227,179,4913,70
32977,318,9082,989,5218,55521,3864
21178,4,260,1213,211,21582,49
67815,0,27,131,15,2635,12
13174,95,7170,1344,3532,33594,3638
8928,3,196,1380,104,4814,92
40343,152,2259,829,1958,26649,301
56814,3,93,471,69,3579,24
18978,329,7971,1252,5869,56024,2102
30484,31,1463,1030,982,21812,481
21506,42,1157,1207,788,16256,369
15227,48,2303,1316,1753,60664,550
33545,120,2320,978,1645,45992,675
57354,290,3552,457,2718,22885,834
16631,8,190,1294,108,3675,82
36175,1431,46675,918,36741,245724,9934
12933,20048,689172,1347,407461,2139156,281711
11284,12,555,1365,299,9623,256
37656,50,729,878,652,14100,77
30372,14,1159,1033,708,27480,451
48342,55,868,722,696,10343,172
247,6710,157378,1468,94899,433963,62479
9627,78,1589,1377,1057,15098,532
11480,27,891,1364,592,19326,299
38549,1012,19400,854,14936,160652,4464
31570,11,316,1012,202,5610,114
42438,42,918,796,721,13940,197
4539,281,7962,1428,5920,149486,2042
53886,1,34,561,30,5515,4
41471,2,69,811,50,8734,19
50124,65,1130,671,860,11923,270
11596,4,416,1363,207,6248,209
7554,3322,249065,1390,123264,657549,125801
25737,45,2143,1129,1314,27292,829
18575,4110,109917,1259,69400,698111,40517
50751,35,517,656,429,10052,88
33674,2305,56075,976,38794,273386,17281
18116,180,8022,1267,5325,49858,2697
19319,2969,80026,1246,53205,466059,26821
56229,11,356,488,229,8173,127
8100,25,505,1383,338,10545,167
60068,10,160,369,126,4794,34
66031,11,358,188,263,6235,95
50399,126,1670,662,1322,21015,348
55077,66,793,520,488,10016,305
17062,0,111,1287,81,6409,30
42414,23,386,796,323,21323,63
8069,28,725,1384,424,9797,301
54694,7,171,533,121,2770,50
21846,59,1096,1203,752,12813,344
27160,21,608,1097,367,9344,241
22545,1933,80466,1193,56151,375876,24315
10557,159,4841,1371,3025,81190,1816
27247,343,5707,1096,2939,61881,2768
36728,960,16438,904,11500,77513,4938
27002,31,852,1100,483,12315,369
21007,14,358,1216,241,11634,117
59949,38,423,373,314,7990,109
36315,33,339,914,292,10474,47
62441,23,658,287,485,14218,173
2248,119,7348,1452,4479,70819,2869
4264,49,1519,1432,1024,13675,495
8167,11,403,1383,258,27053,145
34835,112,2468,935,1850,24505,618
64020,36,608,244,449,4390,159
21587,17941,451622,1206,252595,1534508,199027
50173,163,1969,670,1573,19610,396
53956,281,5789,493,4600,49553,1189
51534,46,569,634,447,6457,122
27729,11,277,1085,161,9197,116
68854,5,122,96,89,3368,33
60583,19,146,350,116,2024,30
68425,3763,112048,112,96228,492410,15820
60332,32,863,359,747,9063,116
63006,18,271,273,202,13942,69
6788,6,141,1400,114,8523,27
56410,307,5327,483,4402,62439,925
19725,12,822,1239,589,26407,233
60245,69,1016,362,754,15693,262
68094,7,86,122,65,2721,21
20735,80,4196,1222,2881,49317,1315
6956,522,7833,1398,4776,57154,3057
63376,39,741,263,599,16654,142
52096,32,1031,617,589,11357,442
29628,14,499,1048,329,10658,170
24396,43,1135,1158,757,16401,378
48665,0,92,712,53,4027,39
30865,102,933,1023,539,13218,394
32495,152,2360,998,1402,12789,958
56340,2,47,485,36,2797,11
10078,123,5435,1374,3423,45339,2012
47043,18,147,739,115,5453,32
6336,18,446,1406,311,17531,135
27626,39,1217,1086,705,7698,512
43241,9602,192502,782,152224,1297240,40278
41569,89,1134,810,817,14322,317
5419,11,434,1417,306,20564,128
35459,91,1574,935,1060,20411,514
57975,91,1122,439,1005,16875,117
29405,2,40,1052,27,3550,13
50046,57,794,673,646,10891,148
35281,264,4412,937,3462,37550,950
57517,1,25,454,19,2976,6
4792,47,1004,1425,627,9489,377
19623,6001,300477,1241,198844,919668,101633
20837,0,0,1220,0,9027,0
48081,126,2592,726,2110,25068,482
34379,54,1163,962,723,35592,440
4075,15,661,1434,459,12550,202
17122,68,1982,1286,1492,18464,490
63915,76,869,248,676,22675,193
16110,83,614,1302,454,12635,160
60884,70,467,338,419,19698,48
68292,15,173,116,132,3251,41
53158,9,193,582,152,3070,41
49640,35,360,684,286,3092,74
33444,237,4118,980,3076,52364,1042
33804,88,2544,974,1756,41078,788
65668,26,362,195,311,6218,51
1897,2,233,1455,144,7933,89
50691,13,84,657,61,2887,23
49485,40,619,688,567,13969,52
14925,8,253,1320,164,3985,89
1568,4,150,1457,100,8602,50
23512,528,29174,1176,16562,78607,12612
60075,177,2769,369,2330,19898,439
29708,428,5855,1047,3937,43954,1918
26805,6,315,1105,189,7489,126
43293,1492,25017,782,20878,182350,4139
2804,426,15763,1447,10174,104409,5589
21114,735,22988,1214,15511,126943,7477
45155,372,3691,761,2857,44743,834
4989,302,6644,1422,4386,63852,2258
460,36,1747,1466,1037,19035,710
46226,58,986,749,824,19595,162
34307,6298,133133,964,86906,326330,46227
55966,89,1043,496,740,12209,303
68494,107,1388,109,1274,18492,114
21857,1093,25008,1202,15756,148845,9252
47891,10,161,729,131,4699,30
35750,70,783,929,551,20566,232
11527,120,3869,1363,2420,23293,1449
57342,43,745,457,464,14660,281
13314,107,1301,1342,827,16487,474
52201,29,384,614,311,10862,73
9041,60,1050,1380,723,19362,327
38412,77,1241,858,1032,15678,209
9498,37,733,1377,486,15578,247
36931,148,1358,899,1014,13504,344
53696,261,3365,568,2912,56704,453
50151,42,527,671,414,6303,113
718,431,19157,1464,13373,147194,5784
7792,99,3872,1387,2558,44719,1314
12159,7,303,1357,166,6675,137
60856,113,1049,339,872,9039,177
20838,17,377,1220,280,14513,97
44617,2,128,768,93,8432,35
13042,22,1057,1346,593,46957,464
50206,68,3373,662,2599,28233,774
65852,135,2950,193,2425,21845,525
30701,18,590,1026,364,10154,226
8991,14,404,1380,263,26710,141
49864,35,176,678,150,6223,26
48617,16,208,714,151,5246,57
64287,10,253,234,195,6517,58
60869,64,903,339,729,16506,174
1236,92,7180,1460,4796,88866,2384
24827,225,1806,1148,1287,21712,519
57945,16,213,440,159,5669,54
51831,84,2679,626,2054,20651,625
61008,17,165,334,126,4054,39
19977,84,1260,1234,907,11710,353
57613,1303,15850,451,12162,154138,3688
30512,0,38,1030,22,4905,16
4541,429,10676,1428,6854,38542,3822
62214,17,293,294,234,10582,59
37201,52,720,891,593,7109,127
1667,14,501,1457,367,16695,134
50832,6,67,654,53,2640,14
31547,54,1152,1013,837,10859,315
67582,9,168,139,125,3502,43
4092,559,8465,1434,6245,47479,2220
41786,303,4259,806,3523,63233,736
28715,286,7492,1065,6191,32018,1301
34090,9,400,968,232,6037,168
49670,49,1214,683,760,20673,454
25097,9621,226967,1142,143868,717216,83099
56147,5053,132208,490,96581,504273,35627
65232,10,121,208,108,2238,13
6616,103,2662,1402,1881,35472,781
11113,24,825,1367,485,15020,340
56031,188,2726,494,2197,36142,529
12163,1327,64481,1357,34763,269624,29718
27338,23,862,1093,499,11533,363
18165,152,5496,1267,3823,24311,1673
56524,226,4230,479,3389,29123,841
3057,15,628,1445,488,9870,140
44212,1215,23056,771,17727,167655,5329
61029,13,231,333,155,6076,76
34496,1748,30867,959,24694,131759,6173
67839,26,239,130,189,6995,50
28192,95,1599,1075,1184,38558,415
55930,34,593,497,450,11029,143
10181,24,2581,1373,1712,29177,869
44034,172,4623,774,3317,84026,1306
37709,5,122,877,105,2872,17
57993,75,695,439,587,11182,108
8195,1125,23211,1383,15552,75789,7659
54361,154,1507,546,1208,25236,299
6340,12,299,1406,212,20112,87
33438,49,890,980,583,27545,307
57240,18,275,460,222,7325,53
55830,25,482,500,333,4733,149
50031,72,561,674,413,7805,148
52417,14,242,607,187,7065,55
51109,3,54,646,40,2411,14
20618,1947,79167,1224,49746,463309,29421
54070,6050,64752,555,50184,228959,14568
50740,2651,62405,656,42943,285995,19462
10275,9,701,1373,444,17736,257
9479,25,769,1378,522,14492,247
59887,38,366,375,278,6019,88
61416,1138,56582,320,41755,120415,14827
24155,24,842,1163,634,18729,208
4028,151,5160,1435,3233,64053,1927
34982,137,3333,947,2473,42743,860
28936,1897,40064,1061,27212,233963,12852
11742,24,549,1361,293,14887,256
59718,2,25,381,23,2702,2
12492,176,10955,1353,5512,51934,5443
37057,778,10958,895,8149,55017,2809
22140,45,1112,1199,740,15097,372
19684,130,3824,1240,2591,47124,1233
164,1377,44005,1469,23981,159202,20024
13283,1,110,1343,62,21408,48
19746,1,35,1239,29,2291,6
44367,34,760,770,606,20496,154
49347,5644,81763,691,60085,365335,21678
17292,21,852,1282,639,15027,213
55021,2,30,522,24,1554,6
10441,47,1111,1372,708,9610,403
7036,16,567,1397,382,18786,185
7726,7,689,1387,467,27267,222
33643,18,260,977,179,8400,81
42566,47,989,794,727,23302,262
12660,36,1038,1351,623,21139,415
49016,41,313,701,222,6583,91
64647,1089,18518,225,14568,94666,3950
6905,17,427,1399,294,17258,133
10194,1140,25191,1373,14126,83952,11065
24219,7,236,1162,181,14823,55
16784,35,2349,1291,1718,20382,631
60955,249,2689,336,2243,10324,446
66995,43,580,157,421,9139,159
55252,42,759,515,618,16506,141
8060,1594,34241,1384,22094,89563,12147
21395,0,0,1209,0,7293,0
50256,78,1009,668,839,15223,170
59198,1,23,399,17,1727,6
35850,16,280,926,213,6799,67
58168,157,2186,433,1702,24437,484
60700,5,177,345,123,10205,54
16455,1953,40505,1296,26409,208503,14096
3299,5,253,1442,174,6352,79
20461,92,2947,1226,2179,20861,768
56065,87,1238,493,1079,23160,159
11288,116,3235,1365,1479,17234,1756
14638,42,969,1323,669,51781,300
14012,13,776,1332,552,39163,224
30946,119,3747,1022,2281,31454,1466
9979,12,301,1375,195,5561,106
33387,1,79,981,71,4671,8
21060,6,328,1215,210,23615,118
20092,1336,29354,1232,23068,216067,6286
41402,39,331,813,273,8186,58
21221,67,1991,1212,1585,54761,406
2459,406,10861,1450,8095,103330,2766
49303,84,1395,692,1052,16231,343
60854,10,138,339,113,3177,25
14831,0,31,1321,28,2600,3
14576,2,225,1324,140,7087,85
12821,37,1068,1349,641,15103,427
28401,35,830,1071,545,10752,285
24278,7,280,1161,242,14072,38
10514,20,1026,1371,706,15883,320
49125,5,113,698,83,7574,30
20480,75,1637,1226,1180,26328,457
16897,642,13023,1289,9685,56801,3338
4425,27,608,1430,441,23608,167
54303,3,55,547,41,4466,14
57907,11,737,441,540,5170,197
5491,462,31052,1416,20168,73920,10884
725,66,3788,1464,2643,28339,1145
66220,12,65,182,52,3158,13
5744,22,821,1413,559,20757,262
26576,374,6090,1110,4091,47492,1999
63303,112,3563,265,2599,21468,964
62870,11,81,276,61,3669,20
21079,73,3590,1215,2282,49191,1308
6395,489,25029,1405,14566,186004,10463
50878,107,1470,652,1083,21692,387
20908,10,331,1218,226,8328,105
35300,8,182,939,142,5127,40
31499,784,11675,1013,10447,79748,1228
59102,8,59,402,46,2607,13
22366,37,841,1196,545,13652,296
24869,10,465,1147,239,5588,226
39059,27,326,846,240,5564,86
26738,61,2410,1106,1354,11199,1056
53474,3,44,575,40,3092,4
35282,22,683,940,481,10104,202
37765,51,1374,872,1140,22561,234
10922,3,81,1368,62,12936,19
53651,22,235,569,151,6878,84
5394,19,593,1417,407,10960,186
34466,341,8980,960,6915,157050,2065
56597,69,1387,477,1240,12394,147
20773,358,5882,1221,3836,40015,2046
17496,31,808,1279,510,6909,298
53803,63,1265,565,1003,8545,262
19432,14,1006,1244,718,9934,288
35938,6,115,925,82,3800,33
18732,542,5532,1257,4262,34714,1270
37195,91,2281,891,1968,53669,313
14610,8,301,1324,234,7968,67
65451,4,42,203,29,2447,13
39462,24,393,842,324,27139,69
62926,28,630,274,567,16169,63
637,52,1898,1464,1279,25101,619
64913,104,1576,217,1231,17446,345
26454,5,370,1113,232,15419,138
62255,9,96,293,71,4488,25
18537,16,837,1260,649,10724,188
10128,6,495,1374,341,15239,154
27483,11,402,1090,230,4513,172
47117,10,285,738,257,10041,28
23168,118,1228,1182,868,14553,360
37831,618,14401,874,11812,45896,2589
6853,14,685,1399,473,32456,212
32936,28,610,990,389,6291,221
26752,84,2603,1106,1716,54766,887
12322,1177,48679,1355,30727,220671,17952
66308,9,107,180,86,4562,21
3063,15,608,1445,436,15001,172
68600,3,28,105,27,3767,1
24196,5,239,1162,176,8258,63
42990,56,982,787,767,15086,215
31706,26,540,1010,386,10475,154
15351,17,541,1314,433,25939,108
21072,43,1706,1215,1177,30092,529
35608,1787,34155,932,24839,102883,9316
1202,21,642,1460,498,15398,144
31710,7,204,1010,177,7187,27
49163,7,109,697,79,3811,30
60693,21,242,345,193,6013,49
16961,41,1411,1288,998,51652,413
36418,5,132,911,109,4990,23
31608,43,1437,1012,956,9528,481
2652,4,164,1449,115,33999,49
12258,1368,51701,1356,28963,316363,22738
56909,27,439,468,284,8904,155
64142,214,2563,240,1893,10379,670
22693,6,381,1190,256,16558,125
59257,5773,224935,376,161819,997783,63116
49525,208,3231,687,2375,55185,856
40882,19,447,821,358,8365,89
42784,10,134,790,104,5530,30
58134,6,103,434,77,4647,26
49526,123,3021,687,2294,45010,727
24759,778,22178,1149,14565,92074,7613
12641,204,6518,1351,3611,48267,2907
63905,95,1083,248,833,10657,250
60373,41,729,324,590,6373,139
45674,12,585,756,390,11353,195
51132,30,277,645,236,2710,41
3987,94,1293,1435,875,18518,418
54555,62,367,538,295,5589,72
64588,201,2800,227,2085,11572,715
16801,126,3225,1291,2265,33241,960
5310,44,1002,1418,741,13640,261
50575,31,301,660,239,5381,62
31373,146,3203,1015,2826,39213,377
32597,21188,562490,996,386075,1834843,176415
54109,310,2388,554,1921,13417,467
47691,192,2273,730,1782,21918,491
15720,8,823,1309,418,14931,405
15090,577,25793,1318,16895,111647,8898
44704,7,104,767,81,3962,23
31725,889,18967,1010,13248,89695,5719
60646,17,306,347,220,4203,86
17329,1127,16461,1282,10428,64364,6033
53439,5,74,575,49,5437,25
341,155,13570,1467,8729,130395,4841
9569,122,3471,1377,2296,22762,1175
6270,19,475,1407,345,13838,130
30138,106,4632,1037,3301,64073,1331
60647,120,3764,347,3113,25165,651
16106,1360,30096,1302,21661,158698,8435
56425,8,112,483,86,3234,26
16287,6,481,1299,331,16618,150
2056,175,9599,1454,6711,49142,2888
67610,6,45,138,36,2977,9
60367,34,400,358,324,7468,76
30553,44,1602,1029,1093,26757,509
38923,382,8178,848,5848,120831,2330
65565,33,567,201,484,7082,83
60234,41,558,363,454,7429,104
37563,106,1344,880,1008,14938,336
15005,71,967,1319,678,10431,289
2916,355,14805,1446,8777,70710,6028
28659,61,1889,1066,1170,27522,719
9370,244,4819,1378,3023,74653,1796
49818,0,5607,679,2695,24593,2912
60759,22,392,343,261,8814,131
38959,64,2401,848,2043,27773,358
8562,3589,101604,1382,60694,245661,40910
65385,6,57,205,48,3675,9
42690,288,1798,791,1348,16695,450
9994,306,9000,1374,5719,69926,3281
23585,248,4216,1175,3179,33392,1037
14901,57,2713,1320,1873,36845,840
64511,4,77,229,61,2913,16
26281,984,27689,1117,20407,174833,7282
29313,426,8369,1054,5316,48732,3053
53358,48,354,577,274,8091,80
9838,92,3976,1376,2048,21710,1928
10366,62,1067,1372,675,7351,392
49953,2481,36879,676,29823,342048,7056
3743,181,4816,1438,3214,38229,1602
54222,146,1054,550,810,22959,244
31924,25,1053,1005,667,10574,386
51234,968,21857,642,18246,138338,3611
52086,41,588,618,379,20410,209
23261,14,603,1180,446,15284,157
11124,15,585,1366,337,8435,248
60767,366,3879,343,3010,21102,869
22231,14,542,1197,390,12115,152
28827,7,170,1063,120,14188,50
25008,1383,38298,1144,22697,237302,15601
24960,191,3603,1145,2498,53750,1105
17777,113,1865,1273,1386,35336,479
58629,15,211,417,169,4386,42
26363,16,488,1115,307,5331,181
26679,1787,55051,1107,34654,325210,20397
56637,14,217,476,168,11308,49
33651,5,171,974,106,4599,65
3461,2,55,1441,42,6443,13
4175,2,130,1433,94,30802,36
22944,50,1220,1185,744,16999,476
36748,5,113,904,83,1731,30
6726,52,2618,1401,1693,41345,925
2161,17,585,1453,450,27651,135
15955,2524,60968,1305,40561,256692,20407
33601,12,349,977,223,5754,126
60663,1640,23724,346,18443,82862,5281
24265,20,1217,1161,762,43769,455
23286,23,695,1180,530,21193,165
30341,81,1980,1033,1336,46015,644
50013,6356,96416,674,63622,262554,32794
67015,3,72,157,49,5287,23
25806,125,3488,1127,2121,15003,1367
50904,27,200,652,169,7039,31
2217,13,665,1452,483,22692,182
45905,40,1166,753,847,8728,319
65185,124,1703,209,1367,12208,336
21705,3713,103796,1204,63843,588964,39953
66982,42,1005,158,513,8550,492
17528,1267,57672,1278,40555,243219,17117
53697,8159,122986,561,101100,593693,21886
24528,2,133,1155,104,20498,29
24414,29,579,1157,412,12867,167
13670,91,1510,1337,852,9681,658
1857,16,376,1455,260,9151,116
67504,259,8530,141,6946,23443,1584
3952,120,3023,1436,2297,44563,726
58534,1453,40766,420,28676,236288,12090
63609,23,441,257,303,8802,138
24075,17,433,1165,311,10496,122
7366,51,1433,1392,924,14575,509
18997,3903,263144,1252,152757,864834,110387
62922,1,9,274,6,1918,3
16150,58,1159,1301,791,15308,368
67033,35,549,156,370,7677,179
10353,359,9484,1372,6232,39843,3252
61903,36,287,304,221,4331,66
48470,4901,70613,720,50028,408103,20585
5102,20,807,1421,533,25380,274
17708,3,99,1275,69,2963,30
20149,5,212,1231,164,6643,48
62575,94,1038,283,790,9271,248
33566,400,7469,978,5475,29495,1994
54700,126,1117,532,956,13505,161
63268,227,2850,266,2239,29787,611
18937,17,1331,1253,919,31430,412
17331,4,342,1282,244,20720,98
61596,141,1285,315,1064,12302,221
13012,25,1125,1346,541,7676,584
14795,4,46,1322,35,4708,11
23723,24,644,1172,453,16855,191
18990,37,1583,1252,1098,15261,485
19218,41,1631,1248,1156,25220,475
20879,26,1213,1219,783,16154,430
50069,159,2511,672,2044,45930,467
26021,4,195,1122,164,5847,31
38046,4,101,868,77,9931,24
85,39556,2317546,1470,1333630,4961148,983916
18889,8,171,1254,128,13797,43
47181,101,1609,737,1346,33963,263
58184,33,343,432,251,5938,92
38170,68,2413,865,1812,16426,601
44141,6,202,773,146,11215,56
57277,65,689,459,596,9784,93
3351,10,583,1442,392,22235,191
26681,13,242,1107,147,12847,95
14822,8,336,1321,167,18985,169
66280,10,100,181,81,2677,19
56162,22,606,490,509,16903,97
39686,1192,19061,839,14368,88713,4693
19744,8,545,1239,434,24344,111
8747,12,398,1381,264,5449,134
48734,14,179,711,129,15397,50
50235,16,238,668,201,4673,37
51682,2719,52600,630,42769,357405,9831
5500,29,685,1416,441,19663,244
32405,6627,124550,1000,80281,566775,44269
34001,13,315,970,182,3606,133
33727,42,954,975,695,23416,259
25140,848,14958,1141,10434,92122,4524
53354,47,406,577,363,16542,43
62425,2569,66715,288,47836,119142,18879
472,697,20732,1466,13775,128565,6957
37118,12,413,894,273,8135,140
50573,469,6160,660,5142,65887,1018
64939,165,2596,216,2183,17156,413
43895,202,6315,776,5094,61712,1221
57863,7,119,442,97,6171,22
27261,13,273,1095,183,3779,90
55110,3,140,519,102,5432,38
16478,127,2562,1296,1707,31678,855
58706,58,1188,414,802,26870,386
52615,16,142,600,113,3367,29
58841,6,47,410,28,6673,19
19741,286,8156,1239,6115,84338,2041
19390,103,2614,1245,1720,27686,894
66382,133,1227,178,1041,16169,186
8580,5,81,1382,46,4536,35
47637,41,465,731,344,14412,121
39777,50,664,838,506,16615,158
50285,99,1782,667,1444,33033,338
39914,48,1313,836,1044,21201,269
24744,21,658,1149,415,10908,243
60299,32,772,360,501,12147,271
15681,9,302,1309,208,8932,94
17695,322,3025,1275,1984,25578,1041
22538,2425,62143,1193,41976,145243,20167
49728,5,35,681,31,4256,4
58921,251,2626,407,1976,12662,650
41474,57,934,811,801,24985,133
4986,41,965,1422,645,22663,320
14001,46,1335,1332,868,44809,467
8074,710,16159,1384,11790,103977,4369
35104,10,173,944,145,5243,28
47152,220,1600,738,1272,25427,328
15785,57,1428,1308,912,10137,516
18816,7,605,1255,436,10434,169
5739,2519,48390,1413,31891,235122,16499
33539,12,284,979,220,7547,64
49886,46,1119,677,865,21911,254
56889,8,98,469,85,4145,13
3806,392,24673,1437,15306,168811,9367
57589,455,7148,451,5481,48499,1667
28923,355,10482,1061,7326,39219,3156
38566,417,5957,725,4808,32026,1149
37681,272,4402,877,3684,53436,718
14319,419,7904,1327,5287,47339,2617
60821,65,1332,341,986,15673,346
28338,224,6290,1072,4254,48924,2036
34661,82,908,955,644,20073,264
15643,7,193,1310,140,15503,53
61310,26,306,317,239,3911,67
16751,3241,66361,1292,44221,369305,22140
68536,0,56,108,45,7359,11
56706,21,326,474,258,7153,68
22057,1130,20941,1200,15644,69511,5297
5901,32,794,1411,543,8819,251
56161,552,4528,490,4054,48178,474
8002,16,925,1385,724,17451,201
34104,33,1473,967,922,11458,551
10926,1,28,1368,23,12159,5
50846,86,1354,653,967,14190,387
4362,10,224,1431,156,9091,68
482,431,10015,1466,4936,71362,5079
23769,68,2423,1171,1635,38445,788
24,462,21654,1472,12578,161286,9076
32110,42,1026,1004,703,14331,323
41311,42,1077,814,894,31536,183
51124,90,1316,645,1138,12598,178
36003,4,162,922,137,7154,25
11793,95,2327,1361,1385,10908,942
51300,461,16733,641,12444,81138,4289
13390,42,2187,1341,1291,23594,896
32895,1658,33141,990,22688,79441,10453
62283,59,916,291,703,17188,213
60242,68,747,362,557,11681,190
9132,5,330,1379,232,38567,98
54457,190,1068,542,918,11628,150
66920,8,137,160,107,3824,30
18628,7,417,1258,337,12921,80
5889,5,242,1412,177,18738,65
63206,5,82,267,61,4234,21
68203,18,591,120,441,12377,150
25158,1004,20404,1141,14193,72912,6211
51779,35,485,627,349,4458,136
68557,112,2084,107,1707,11941,377
8997,147,4074,1380,2883,58486,1191
64179,3,96,239,75,3069,21
33668,7,237,976,195,15008,42
60814,2436,40527,341,32244,267346,8283
38848,429,8451,849,6962,83247,1489
43245,8,100,782,78,2786,22
7339,26,527,1393,377,22243,150
15081,5,136,1318,85,5842,51
8296,2,132,1383,102,9141,30
12011,237,5220,1359,3243,31178,1977
13121,157,2973,1345,1945,24398,1028
57397,2,33,456,24,308,9
56767,14,145,472,101,7886,44
49600,386,5124,685,3922,26548,1202
12018,3,237,1359,118,14823,119
45059,10,282,762,205,8220,77
62872,10,173,276,106,3662,67
34753,0,5213,953,3715,38762,1498
13418,15,396,1341,248,17272,148
5283,581,51586,1418,32857,238916,18729
19467,71,3540,1244,2889,31214,651
14135,441,3518,1330,2425,31258,1093
59201,41,497,399,414,11450,83
12222,18,647,1357,350,5836,297
65050,6,197,212,133,5921,64
11941,15717,428450,1359,283318,1365299,145132
66145,2,32,184,21,1876,11
16341,290,4681,1299,3420,54121,1261
10784,227,4068,1369,2815,43711,1253
14650,4,247,1323,160,4234,87
10114,18,879,1374,561,8097,318
61272,4,99,324,82,2366,17
25200,188,3081,1140,2194,21059,887
20063,23,642,1233,437,14311,205
31235,6,365,1016,303,11097,62
16541,4899,147036,1295,97523,457531,49513
34447,18,994,959,652,8866,342
31830,398,12457,1008,8920,104909,3537
20320,0,36,1229,35,10390,1
35647,1027,21517,932,16555,145096,4962
32115,42,617,1004,412,13189,205
59021,7,75,405,56,4315,19
3143,3202,204147,1444,118545,628573,85602
45910,35,344,753,294,12602,50
174,129,8303,1469,6171,47465,2132
2442,31,1779,1450,1208,33298,571
55516,2,17,508,15,5713,2
21711,17,895,1204,631,19928,264
20877,10,304,1219,216,10881,88
58781,67,954,412,781,11405,173
5904,141,5563,1411,3631,108422,1932
13071,116,6172,1345,3445,61110,2727
8458,114,4699,1382,3030,18137,1669
49798,235,4791,679,3710,39978,1081
10234,104,9971,1373,6006,37979,3965
28646,8,134,1067,87,6805,47
36182,104,998,918,759,8825,239
20273,19,737,1229,592,18336,145
61413,39,324,320,271,7019,53
58585,10,132,418,120,8470,12
29101,6,181,1058,154,6673,27
1645,92,2704,1457,1853,42036,851
62364,71,1171,289,954,9050,217
29792,4,134,1045,124,16726,10
17275,1045,42158,1283,32838,170082,9320
44154,110,2921,772,2493,34452,428
57565,13,150,452,127,3030,23
37223,284,4430,890,3627,85304,803
33347,315,6861,982,5012,73131,1849
34916,51,782,949,484,11213,298
7027,60,1603,1397,1146,37994,457
58237,85,1364,430,1193,28444,171
48559,17,202,716,133,5715,69
20896,6,105,1218,77,5478,28
13061,1186,22389,1345,13655,174845,8734
40201,0,0,831,0,2079,0
34526,183,2198,959,1538,18502,660
57260,377,11556,459,8635,39885,2921
13182,51,1795,1344,1089,11890,706
56304,62,1056,486,843,13105,213
54190,10,147,552,99,3321,48
57562,100,1919,452,1489,12421,430
61830,1660,31776,307,25778,171552,5998
1968,127,3480,1454,2349,46384,1131
3939,70,1464,1436,1060,38945,404
50523,19,290,661,225,10391,65
58117,71,457,434,388,9406,69
12687,7583,296145,1351,160334,1038933,135811
38000,261,3785,869,3031,33533,754
5124,228,4208,1420,2848,40623,1360
50623,86,1420,659,1160,19422,260
16023,7,230,1303,167,9310,63
29903,7,237,1042,188,8123,49
66916,29,629,160,453,9019,176
9589,13,306,1377,206,7276,100
19430,10,731,1244,537,16910,194
26959,341,4136,1101,3339,21880,797
62907,1,30,275,21,4477,9
10995,341,10835,1368,6545,133880,4290
11015,21,616,1367,386,44936,230
7769,264,8868,1387,5855,65559,3013
32685,692,22211,995,16352,162759,5859
17295,28,560,1282,414,20519,146
4380,312,15600,1430,11231,46056,4369
17877,150,3822,1271,2859,30705,963
29965,278,7458,1041,4738,44881,2720
21374,656,8851,1210,5642,32158,3209
32560,4,39,997,36,3673,3
30263,160,4868,1035,3202,54019,1666
48796,284,3118,708,2452,16402,666
13262,16,346,1343,192,7402,154
47979,48,774,726,491,10921,283
9750,4,319,1376,209,8231,110
33664,73,1916,976,1426,34921,490
60094,6,47,368,30,5397,17
30872,23,713,1023,483,4382,230
15301,50,1770,1315,1179,19349,591
5238,5,341,1419,236,8715,105
2672,9,362,1449,207,17544,155
58101,249,4707,435,3757,26724,950
257,9,348,1468,222,15371,126
49094,49,451,699,353,4413,98
48590,12,169,714,134,6320,35
68889,11,120,95,97,2329,23
51841,123,1517,626,1207,15577,310
54862,118,891,526,722,11068,169
26739,13,302,1106,235,8384,67
19946,39,1157,1235,869,57714,288
20965,29,312,1217,265,19111,47
28503,245,3762,1069,2011,29390,1751
67082,5,58,155,56,4782,2
1935,5325,290892,1455,177888,1147443,113004
7090,2,207,1396,162,10000,45
2332,2833,118786,1451,70481,436873,48305
3509,9,874,1440,598,17911,276
32237,2529,54576,1002,39155,261192,15421
64080,2,38,242,29,1414,9
57620,476,12923,450,10468,42077,2455
50921,166,2430,651,1959,24767,471
14400,224,3909,1326,2553,37043,1356
61757,99,1019,310,819,9320,200
45314,3516,74217,760,56477,214807,17740
12128,127,4572,1358,2414,38599,2158
31332,984,24153,1013,17527,116651,6626
4363,109,9064,1431,6157,56304,2907
10439,20,998,1372,634,14264,364
22559,4,172,1193,132,16024,40
64848,4,63,219,53,2499,10
65552,10,73,201,59,1435,14
59764,127,1372,379,1125,8916,247
61391,8,83,321,57,2037,26
28222,64,1505,1075,903,14844,602
53813,190,1405,564,1097,20018,308
23124,7,350,1183,262,8062,88
54230,4,44,550,36,3515,8
51237,8,164,642,143,10073,21
35140,32,1067,943,874,35553,193
37482,21,396,883,357,15081,39
31138,9,242,1019,141,3949,101
55150,2,78,518,62,4800,16
36779,7,86,903,67,2595,19
58843,124,1327,410,1013,8597,314
16832,50,1130,1291,756,27824,374
3276,7,544,1443,405,33700,139
11794,9,283,1361,141,9363,142
51887,3,50,624,47,4759,3
4837,9,329,1424,226,10172,103
19873,33,935,1236,602,10224,333
17339,1997,38910,1282,23533,186118,15377
56641,6,82,476,76,2656,6
61258,3,62,324,46,3189,16
66611,29,431,170,345,3914,86
59758,55,710,346,584,17706,126
16014,899,29530,1303,20103,208171,9427
4683,1520,42405,1426,31850,180033,10555
65290,7,114,207,93,2686,21
27978,14,297,1079,250,11521,47
8230,216,8863,1383,5356,69326,3507
434,11,246,1466,163,29811,83
34811,4,155,951,119,9179,36
24833,22,542,1148,363,14231,179
63304,124,1835,265,1400,16235,435
34405,30,824,961,601,8532,223
64221,24,407,238,284,3836,123
41141,83,2282,816,1856,50079,426
31243,124,2756,1017,1815,21291,941
48867,338,3579,706,2782,32540,797
29472,89,2202,1051,1313,20415,889
22388,77,2322,1195,1663,26362,659
51843,220,2546,625,2041,24324,505
4978,470,26237,1422,16268,182695,9969
41235,30,541,815,482,25106,59
44698,70,1366,767,1113,9166,253
7627,1045,31035,1389,20671,215449,10364
6732,10,265,1401,199,9695,66
31813,6388,211055,1008,128197,881773,82858
62406,177,6258,286,5183,29474,1075
13841,211,3077,1335,2088,19956,989
1244,117,2781,1460,1944,31576,837
39765,474,9099,838,6553,44985,2546
16241,4,186,1300,130,4820,56
58572,31,344,419,260,5778,84
23243,173,3650,1181,2497,63463,1153
14511,5,348,1325,243,11405,105
51762,10,342,628,270,13289,72
26258,246,4964,1118,3344,74263,1620
22909,163,2964,1186,2034,23611,930
27394,15,438,1092,271,9844,167
2197,36,3329,1452,2294,49603,1035
32332,142,2285,1001,1699,23971,586
4136,5,163,1434,119,8361,44
62443,9,103,287,77,4846,26
41822,1346,55704,805,34728,163505,20976
21414,330,5288,1209,3513,71477,1775
54062,309,3338,556,2379,17427,959
17069,38,1267,1287,933,11337,334
31512,158,3167,1013,2179,42240,988
7658,257,5441,1388,3896,35512,1545
64149,48,606,240,441,13722,165
50029,4,83,674,72,2945,11
58470,259,4222,422,3212,27964,1010
59168,5,228,400,180,5223,48
10185,1131,34294,1373,23419,199372,10875
61975,298,4468,302,3304,21298,1164
32669,1126,30764,995,21935,279265,8829
24763,4,156,1149,112,11859,44
53684,38,429,568,346,11645,83
62912,3,93,275,59,4043,34
52165,23,364,615,231,6823,133
44167,463,6564,772,5596,60518,968
35386,57,1520,937,1037,10672,483
8306,21,1033,1383,595,11475,438
318,4432,141158,1467,72285,402346,68873
36436,149,3816,910,3325,33986,491
6647,6,277,1402,187,12069,90
5925,331,29584,1411,19514,179660,10070
20904,135,2791,1218,1674,20508,1117
24955,193,3603,1145,2496,35504,1107
67709,40,479,135,385,5737,94
21169,11,513,1213,380,15630,133
62356,10,109,289,89,8468,20
20518,48,1196,1225,837,20531,359
52942,33,380,588,301,7201,79
57413,4209,115817,456,78854,386075,36963
6142,17,605,1408,370,7019,235
35149,18,537,943,352,4839,185
51533,85,1000,634,790,14595,210
20180,32,608,1231,364,6543,244
10873,222,8090,1368,4342,37308,3748
54114,64,709,554,568,5543,141
24938,251,4388,1145,2061,29834,2327
10491,12,596,1371,391,7945,205
32288,450,10783,1001,7536,68458,3247
30927,102,3895,1022,2766,46815,1129
57896,5,50,441,42,2211,8
66197,11,328,182,258,9699,70
1103,70,2385,1461,1682,25576,703
32990,18,301,989,200,26114,101
55336,8,35,513,32,4709,3
58119,55,647,434,539,10357,108
10715,19,621,1370,441,6748,180
13076,3346,165139,1345,101845,389247,63294
35590,171,2797,932,2105,20544,692
32818,33,681,991,541,12920,140
1527,6,294,1458,189,8919,105
10549,18,470,1371,345,23724,125
18288,221,7657,1264,5875,61122,1782
56777,5,74,472,64,51395,10
18811,1785,39372,1255,28649,201222,10723
62955,319,3211,274,2655,26451,556
50264,31,507,668,413,8841,94
47091,31,423,739,351,14940,72
27378,613,12057,1093,7994,96122,4063
38336,145,2666,861,1956,18487,710
57247,61,614,460,525,11970,89
610,129,2912,1464,1747,40692,1165
36105,54,942,920,808,17642,134
14833,7,710,1321,506,18803,204
29634,54,1147,1048,644,10265,503
20880,197,3881,1219,2732,33096,1149
60624,14,167,348,118,9522,49
23287,5,216,1180,143,3000,73
6298,4,120,1407,83,7305,37
10574,237,5406,1371,3681,28905,1725
1057,141,3336,1461,2310,44705,1026
3671,15,618,1439,524,15158,94
65683,92,1250,197,975,6819,275
29675,44,1056,1048,712,5022,344
55639,0,65,505,57,2790,8
448,0,69,1466,43,8359,26
5458,330,13126,1416,8308,66183,4818
48804,40,511,708,402,10549,109
2724,77,3679,1448,2440,83273,1239
30765,127,2097,1025,1285,17846,812
21356,112,2174,1210,1575,36166,599
35745,6,121,930,85,3041,36
55068,4,34,520,30,3425,4
19132,11,560,1249,377,21666,183
61083,553,9691,319,7713,89362,1978
50115,1065,16730,671,13279,132247,3451
50626,9,131,659,109,7751,22
15826,784,42513,1307,24347,192426,18166
18630,231,6633,1258,4541,54466,2092
30628,7,115,1028,93,3499,22
6753,0,88,1400,59,12822,29
20999,6,173,1217,115,12400,58
53709,3,36,567,24,3719,12
33895,22,388,972,275,6995,113
49968,9,131,675,105,4392,26
18378,576,16541,1263,12028,153692,4513
25241,8,333,1139,208,8047,125
60937,52,404,336,331,8254,73
4642,108,3492,1427,2450,42260,1042
64433,22,292,231,217,4993,75
40748,6,209,823,195,10603,14
37019,19,468,896,385,8807,83
67715,18,441,135,333,8846,108
3260,13,842,1443,574,19451,268
27670,36,474,1085,334,13883,140
7860,9,299,1385,175,3601,124
5282,125,6260,1418,4389,40296,1871
736,4497,118815,1463,64114,317007,54701
47320,59,765,735,581,9991,184
8519,3,148,1382,86,12796,62
61637,21,280,313,213,7034,67
109,9,508,1470,353,6689,155
27303,322,6229,1094,5076,67462,1153
54765,7,103,530,75,8876,28
32609,50,1259,996,861,27557,398
9055,91,3238,1379,2047,27216,1191
63896,5,53,248,38,2602,15
61881,37,365,305,283,5936,82
12252,138,4112,1356,2767,80044,1345
14379,146,2800,1326,1930,44842,870
49785,80,811,680,686,7808,125
29772,34,419,1045,285,9042,134
68135,36,357,121,330,8320,27
619,12,569,1464,416,19481,153
12429,123,4698,1354,3091,50960,1607
16413,56,2437,1297,1486,35544,951
29637,2,171,1048,89,6061,82
15635,0,0,1310,0,8334,0
25455,35,815,1135,564,9138,251
14104,147,4610,1330,3208,76244,1402
6961,28,802,1398,507,8259,295
2319,8,353,1451,219,11452,134
1581,433,12384,1457,8532,126856,3852
49350,2162,56198,691,44522,371610,11676
63584,9,87,258,66,2444,21
10659,13,760,1370,443,10982,317
63395,26,327,262,272,3295,55
15454,172,4069,1313,2695,48800,1374
15064,6,419,1318,297,24524,122
34355,10,200,963,143,6701,57
19305,411,8916,1246,5747,99856,3169
54210,16,204,551,174,9646,30
68956,0,18,93,16,533,2
65763,3,49,195,37,2761,12
12885,166,7066,1348,4312,93592,2754
62497,53,660,286,516,13345,144
53530,273,4142,573,3206,30826,936
18445,36,1129,1261,697,8051,432
2769,29,1200,1448,858,38336,342
8880,22,1013,1380,661,34793,352
51076,33,426,647,371,14061,55
8834,24,1675,1380,979,20188,696
28456,136,2900,1070,2195,31732,705
52669,556,7406,597,5523,55552,1883
1666,13,408,1457,281,8595,127
50759,61,814,656,605,10733,209
62168,0,38,295,23,2521,15
2210,51,4169,1452,3060,36220,1109
12917,2,167,1348,83,8404,84
30459,207,6917,1031,4178,25514,2739
28821,99,2222,1064,1463,11097,759
20022,2743,72278,1234,49607,311640,22671
9844,197,6344,1376,4130,37318,2214
32031,110,3456,1005,2767,29503,689
15636,443,11652,1310,7715,74599,3937
40666,99,918,825,720,8429,198
5956,133,8365,1411,5599,75685,2766
23502,3,372,1176,267,11162,105
63003,13,381,273,267,8887,114
32735,100,1518,993,1084,20078,434
52380,6,65,608,64,3164,1
56476,16,221,481,175,5708,46
29876,5,161,1043,96,7072,65
31446,2,111,1012,73,2509,38
18176,62,1979,1266,1265,15906,714
15549,109,2931,1311,1962,28503,969
64710,6,105,224,83,3745,22
21966,12,597,1201,355,6641,242
63439,537,9540,261,8012,52759,1528
9742,61,2440,1376,1668,21949,772
51573,65,1083,633,888,13700,195
65014,12,126,213,90,2570,36
50354,0,31,665,22,5340,9
68567,460,10250,106,8932,74392,1318
51332,1162,18416,640,15022,82874,3394
24699,202,5380,1150,3792,115678,1588
16006,128,2401,1304,1366,22006,1035
8467,278,11470,1382,7123,145092,4347
5105,37,2065,1421,1417,29162,648
24182,52,1468,1163,927,38674,541
62854,1,18,276,16,1579,2
51344,84,1120,639,909,12994,211
16502,1,97,1296,68,24597,29
60691,18,230,345,186,5827,44
3676,4,133,1439,95,14937,38
28132,8,562,1076,372,20933,190
21289,379,5058,1211,3003,47107,2055
21768,49,1343,1204,900,14709,443
30569,102,2939,1029,2031,24328,908
27642,44,834,1086,539,9554,295
56683,81,995,475,816,13808,179
31084,144,2338,1019,1585,24960,753
32030,114,2341,1005,1393,13863,948
66095,507,6950,186,5775,64280,1175
895,46,1177,1462,808,39704,369
30483,289,9384,1030,5662,36362,3722
16194,32,1488,1301,956,39524,532
56101,72,872,492,638,28676,234
18036,58,2018,1268,1415,20414,603
10701,0,184,1370,110,5756,74
3865,1025,38412,1436,23626,251892,14786
29967,53,933,1041,665,14392,268
21362,24,1482,1210,937,13884,545
18640,21,1027,1258,673,12888,354
64969,4,47,215,34,6718,13
56218,9,132,489,109,4881,23
10446,3,90,1372,61,6973,29
16139,6028,112721,1301,77742,408042,34979
26845,20,476,1104,401,32083,75
30170,58,732,1037,582,18092,150
67744,1,31,134,19,5650,12
28997,70,1166,1060,758,22716,408
8182,1371,42741,1383,26132,139157,16609
37372,1248,16074,886,12803,150477,3271
39656,192,4480,839,3643,51154,837
46552,31,490,745,380,12175,110
55947,14,143,497,122,5015,21
30078,23,1081,1039,657,29280,424
3271,340,11855,1443,6802,44972,5053
59555,12,207,387,179,4061,28
3482,47,1246,1441,921,8981,325
12060,2456,96226,1358,62316,480609,33910
28476,1233,48820,1070,30394,355988,18426
3405,39,2633,1441,1721,46614,912
14945,18,909,1320,656,14728,253
25014,282,4151,1143,2610,30753,1541
67940,56,763,127,608,6141,155
8797,41,1188,1381,661,16219,527
54121,152,1475,554,1169,22946,306
5312,16845,348541,1418,237208,677194,111333
7161,19,364,1395,246,9280,118
32307,88,2276,1001,1334,29068,942
34810,16,262,951,178,10016,84
68571,5,61,106,46,1522,15
3430,13,506,1441,319,12950,187
10510,428,14667,1371,10045,107808,4622
35899,1499,35382,926,27100,195556,8282
18967,3,299,1252,230,22859,69
23312,50,1310,1180,810,19345,500
8658,127,3522,1381,2263,18349,1259
34615,2928,54187,956,33593,321855,20594
32460,32,773,998,499,14369,274
60321,20,244,360,214,10004,30
41955,29,327,803,238,3687,89
68175,14,392,120,313,4545,79
29896,8,144,1042,132,13036,12
32572,44,496,996,345,7639,151
30054,106,3829,1039,2380,21444,1449
49234,30,419,695,319,8581,100
12431,56,2168,1354,1249,23941,919
34562,47,2259,958,1725,18808,534
3580,24,1863,1440,1154,27400,709
52555,10,227,602,167,4050,60
14175,170,2909,1330,1714,37938,1195
3442,26,726,1441,584,11016,142
58976,36,490,406,364,10778,126
1497,226,3345,1458,1977,15045,1368
10892,192,5066,1368,3127,35478,1939
28761,1263,31551,1065,18625,271492,12926
22474,7,381,1194,274,20595,107
22497,10,261,1194,175,12313,86
20809,479,12338,1220,8743,120538,3595
44541,5618,246159,768,181813,372785,64346
52341,39,452,609,385,10986,67
3883,26,2260,1436,1649,23686,611
57615,53,909,451,712,11205,197
8720,4211,139877,1381,87645,780107,52232
34299,141,10887,964,6950,27627,3937
39740,110,1394,838,1114,6441,280
59459,20,289,390,215,6330,74
60969,14,173,335,133,6314,40
11987,55,3258,1359,1888,29656,1370
38381,631,9409,860,7604,105088,1805
40410,216,3288,828,2137,14942,1151
17184,76,1901,1284,1373,37727,528
19501,621,19794,1243,14301,205832,5493
65298,67,805,207,710,7359,95
35219,361,6413,941,4593,36737,1820
58640,17,307,416,234,8094,73
17214,24900,621668,1284,415367,1105920,206301
9906,26,317,1375,213,13778,104
3199,3,87,1443,60,11539,27
54611,33,320,536,270,18166,50
50436,152,2104,663,1672,16591,432
56344,8,73,485,54,6459,19
34147,10365,214998,967,143230,776693,71768
23896,24,1372,1169,875,14187,497
13769,39,1542,1336,920,13326,622
23504,9,332,1176,236,8409,96
51188,10239,138390,643,97076,458236,41314
22440,178,5395,1195,3997,31022,1398
17444,28,592,1280,476,20185,116
27508,31,657,1089,347,6479,310
42007,24,217,802,170,4408,47
15551,1891,78539,1311,56123,410248,22416
59247,142,2393,397,1856,14039,537
43163,157,3086,783,2499,27499,587
28576,120,9405,1068,5239,53745,4166
3023,842,12097,1445,7863,39804,4234
25711,5,238,1129,131,14517,107
28295,9,272,1073,175,12464,97
20169,19,334,1231,269,18259,65
63722,5,306,254,142,3596,164
30186,47,852,1036,657,26540,195
21249,17,1360,1212,933,29577,427
61095,1,33,330,27,3104,6
22635,11,300,1191,197,3227,103
18103,120,3722,1267,2485,105863,1237
36417,281,4656,910,3523,41792,1133
11792,753,19468,1361,11055,96736,8413
8087,114,1519,1384,1200,36703,319
21434,8,157,1209,122,16748,35
25870,37,1187,1126,939,44718,248
6437,4,116,1405,84,6523,32
16556,5,234,1295,185,13007,49
54652,178,4006,534,3211,47235,795
21420,11,542,1209,347,10663,195
52509,322,4118,603,3205,34873,913
6587,37,769,1402,563,9711,206
63653,16,135,256,110,5591,25
10097,113,4088,1374,2468,36105,1620
22331,487,18106,1196,12453,120427,5653
48012,193,3442,727,2651,47416,791
60273,2,49,362,41,4968,8
33630,23,328,977,237,3614,91
36533,4,231,907,169,6765,62
63810,13,272,251,205,7273,67
30429,21,935,1032,620,7985,315
4830,41,1038,1424,744,22536,294
34088,46,1007,968,646,6716,361
27322,6,131,1094,88,3404,43
61989,4,42,301,35,6886,7
61127,77,1039,329,867,16996,172
52141,2,112,616,77,2485,35
67980,11,152,126,123,2950,29
20841,105,1655,1220,1166,17306,489
61291,20,251,323,188,3470,63
33218,186,2478,983,1781,27118,697
16448,98,2953,1297,1985,48147,968
68406,3021,101432,112,63479,545487,37953
28536,11,261,1069,180,5208,81
63969,87,1092,246,885,21160,207
6005,14,1205,1410,727,12111,478
2251,213,5042,1452,3784,40734,1258
26905,49,1489,1103,1022,13900,467
45911,11,383,753,306,8777,77
15440,14,544,1313,364,8702,180
14776,102,1279,1322,899,17926,380
40648,159,2425,825,1822,27588,603
59465,97,2176,334,1801,28508,375
34683,13,393,954,274,13629,119
50905,0,18,645,14,1325,4
24404,30,1396,1157,931,50426,465
60448,12,73,355,58,4531,15
46378,216,2984,748,2246,34166,738
41095,219,3476,817,2732,19244,744
18502,5359,125651,1260,78186,451984,47465
31480,107,3702,1014,2346,88178,1356
30644,5,183,1028,150,6974,33
29322,27,423,1054,322,6184,101
679,1772,101456,1464,64213,305325,37243
57026,129,1545,465,1202,19205,343
27343,8,712,1093,488,22504,224
17427,1820,33709,1280,22980,108459,10729
17534,213,3555,1278,2518,53168,1037
2798,22,1179,1447,814,30058,365
50881,87,1501,652,1195,43318,306
58422,21,321,424,236,6477,85
7442,3,128,1391,86,22843,42
59305,3172,90539,395,68987,365842,21552
59024,14,171,405,118,6315,53
38494,36,791,856,609,16817,182
12520,43,1959,1353,1206,40907,753
1883,11,535,1455,330,20648,205
17025,310,7306,1287,5053,48166,2253
63813,144,1719,251,1328,12232,391
51908,3,48,624,38,3223,10
60966,60,958,335,783,9091,175
12905,0,0,1348,0,22868,0
28471,8,459,1070,351,12645,108
30311,5,373,1034,257,9085,116
52128,19,321,616,255,12970,66
64174,4,72,239,54,2583,18
38857,48,904,849,659,9360,245
27177,42,1859,1097,1199,27010,660
33692,261,4726,976,3525,21345,1201
18128,44,1286,1267,858,22702,428
6459,128,3717,1404,2274,64361,1443
33447,6,130,980,113,7486,17
10847,115,4245,1369,2665,19500,1580
68446,37,702,111,569,11472,133
49681,14,180,683,121,7153,59
467,211,10646,1466,7115,67642,3531
24275,4,109,1161,89,11646,20
22868,70,1052,1187,714,11908,338
60194,22,220,365,177,4571,43
37136,39,1344,886,1017,16751,327
40440,761,8465,828,6045,52529,2420
49587,2,13,685,8,5932,5
13045,17,1393,1346,670,15586,723
30594,447,15385,1028,9578,90869,5807
46972,136,4156,736,3299,52455,857
17701,55,2084,1275,1545,23846,539
62917,3,131,275,78,12547,53
6412,2080,95939,1405,59137,655674,36802
69036,16,304,90,263,4303,41
60512,12,71,352,49,2987,22
30544,274,9300,1029,6391,54085,2909
64648,1043,14151,225,11668,56816,2483
64621,7,318,226,249,7265,69
14761,75,2379,1322,1597,22877,782
2515,221,8307,1450,5526,40978,2781
62046,591,13930,300,11544,59699,2386
21278,1,58,1211,39,2157,19
37761,28,336,875,291,11388,45
63166,80,1549,268,1194,22354,355
55982,425,6607,495,5492,70488,1115
33351,41,737,982,486,8540,251
54924,387,4031,524,3371,75324,660
29466,15,622,1051,392,22210,230
8192,6,228,1383,165,17594,63
37706,18,728,877,555,12551,173
38662,0,34,852,27,4238,7
34858,2709,41381,950,30926,147883,10455
51997,32,464,621,361,7277,103
25319,113,3675,1137,2614,74827,1061
37071,7,120,895,96,4987,24
44822,17,407,765,307,8301,100
45168,2,38,761,25,3866,13
36750,81,1387,904,1103,12065,284
48493,13,255,719,173,9798,82
23183,22,1225,1181,814,17741,411
32902,146,2605,990,1608,19043,997
442,886,45082,1466,30583,207254,14499
4063,25,1415,1434,978,14852,437
28642,35959,1187986,1067,734949,1985546,453037
14601,272,7723,1324,5325,47831,2398
68455,10,105,110,82,5698,23
41908,250,3140,803,2676,31477,464
63171,75,1582,268,1312,21156,270
21346,16,929,1210,613,38778,316
2939,38,1417,1446,1095,19003,322
37002,16,329,897,258,13034,71
63667,8,81,255,64,3822,17
65996,8,77,189,56,6017,21
4039,13,195,1435,140,10468,55
29808,46,1748,1044,1182,24431,566
11965,843,19495,1359,11741,68244,7754
52248,4471,269591,612,197589,997326,72002
10627,2599,47570,1370,33770,162572,13800
31500,68,852,1013,569,12342,283
39934,3,105,836,88,5245,17
13512,259,3294,1339,2138,63776,1156
20311,38,1895,1229,1291,10849,604
27494,51,2515,1090,1569,18029,946
25134,41,1934,1141,1240,24515,694
35693,931,11904,931,8359,44140,3545
50653,10,53,658,49,2238,4
21409,0,0,1209,0,5705,0
58934,917,8297,407,6614,54101,1683
55576,654,10157,506,8083,143181,2074
3965,35,1513,1435,1018,31185,495
29256,17,759,1055,387,21326,372
59994,6,97,371,86,7593,11
49035,9,127,701,102,5378,25
60501,18,411,353,368,12645,43
56826,410,3958,471,3240,44894,718
21423,27,826,1209,511,10308,315
36861,4,121,901,104,8808,17
24358,8,125,1158,94,7248,31
34716,7,440,953,269,8255,171
65222,124,5378,208,1581,13953,3797
33980,23,435,970,258,9021,177
58391,1254,32250,425,24599,136055,7651
63547,10,118,259,94,4820,24
63224,1,23,267,11,2224,12
49404,25,383,690,343,12419,40
52640,2,20,598,17,5324,3
56316,3,36,485,31,2719,5
26822,2083,63054,1104,40443,167506,22611
57798,5,77,445,59,1628,18
64132,81,1273,240,1063,26964,210
67511,7,70,141,50,3556,20
37042,279,4908,896,4139,73564,769
8279,65,2844,1383,2045,30383,799
58444,97,1495,423,1223,15984,272
67756,19,249,133,209,7918,40
37752,28,563,876,504,14739,59
57906,67,899,441,712,7486,187
47413,31,506,734,376,14936,130
29440,5494,111512,1051,65863,461396,45649
1755,79,2484,1456,1785,33977,699
35134,8,204,944,143,6931,61
4540,21,977,1428,716,56280,261
62155,593,5189,295,4272,42807,917
49169,142,1834,697,1391,22984,443
68100,2,50,122,38,3486,12
35295,74,1289,939,990,14571,299
3545,310,19523,1440,11549,97937,7974
390,2,222,1466,167,9673,55
68181,1,56,120,9,1537,47
11585,10,541,1363,297,7953,244
36464,9,123,909,96,5651,27
41609,849,11467,809,8871,69921,2596
5138,473,27724,1420,17303,152494,10421
30968,1860,33284,1021,22003,132559,11281
15878,4599,77863,1306,50054,322857,27809
15957,55,2254,1305,1500,25699,754
13868,69,1218,1334,666,19023,552
50669,59,695,658,541,5594,154
60159,6,150,366,107,5856,43
15817,7,141,1307,105,17295,36
32988,1337,34485,953,22503,259398,11982
17146,36,906,1285,696,21816,210
24301,5,230,1160,159,9010,71
24922,28,1483,1146,989,59710,494
23278,42,1767,1180,1239,48245,528
19010,34,3327,1252,1949,18062,1378
63778,152,3260,252,2747,23596,513
29041,37,899,1059,604,23123,295
1502,8,361,1458,262,10051,99
65964,7,103,190,73,3399,30
17405,96,4334,1281,3116,29170,1218
2269,21,531,1452,342,26198,189
8849,522,8916,1380,6075,36001,2841
24816,69,1170,1148,734,21728,436
55184,15,224,518,148,2340,76
49162,334,3501,697,2825,26742,676
54269,10,201,549,148,7274,53
9649,229,10409,1377,6477,45420,3932
23720,288,5797,1172,3724,61354,2073
27532,15,305,1089,270,10317,35
56055,21,394,493,306,10336,88
11482,28,1370,1364,904,48404,466
9027,12,417,1380,281,7222,136
10098,93,5087,1374,3174,36113,1913
34077,13,223,968,161,12191,62
35565,14,344,933,250,9032,94
17526,62,1754,1278,1285,33256,469
52628,170,2356,597,2007,25996,349
55107,46,991,519,769,16543,222
32885,12,576,991,394,11849,182
27691,33,1172,1085,820,51848,352
20686,0,0,1223,0,12890,0
10163,343,7310,1374,4235,56160,3075
23272,0,0,1180,0,12105,0
20062,32,1210,1233,801,9847,409