Mod,likes,downloads,time,unique_dl,views,dl_dif
2856,519,22941,1738,14477,142962,8464
2364,877,25145,1802,17957,86740,7188
3150,51,981,1612,608,23832,373
2340,214,7318,1803,4828,53652,2490
2754,30,874,1765,535,19087,339
2440,1893,101653,1797,73236,169108,28417
2854,35,1487,1739,879,29386,608
2381,125,2120,1801,1563,28882,557
2798,802,18250,1752,10709,98060,7541
2733,12,768,1768,478,16719,290
2190,1158,48253,1809,33271,303983,14982
2892,71,1287,1725,846,20875,441
3011,226,5602,1672,3456,31326,2146
3139,397,5067,1619,3071,28727,1996
2360,194,9197,1802,6156,73535,3041
2945,162,2548,1702,1772,35358,776
2967,24,895,1697,581,22441,314
2646,1789,70416,1781,44262,290531,26154
2378,25,566,1801,407,24307,159
2810,70,1306,1748,830,13121,476
2944,41,1689,1702,975,33316,714
2847,29,1066,1741,618,18022,448
2746,260,4078,1767,2660,14917,1418
2284,151,6395,1805,4351,26040,2044
2930,289,3910,1708,2844,42401,1066
3080,228,8930,1644,6066,39479,2864
3579,163,4014,1280,3087,76874,927
2213,234,10013,1808,6689,48223,3324
2927,113,3857,1711,2355,48193,1502
3274,87,2968,1570,1707,42871,1261
2648,1876,34743,1781,22524,114628,12219
2620,814,14179,1783,9462,87819,4717
2426,172,4442,1798,3180,47855,1262
3297,677,14027,1555,9448,92726,4579
2336,20,435,1803,347,28127,88
3932,5,114,532,94,6937,20
3927,20,337,553,264,11049,73
2895,361,11098,1725,6967,101521,4131
2187,93,4061,1809,3113,52656,948
2690,2,187,1775,64,10220,123
2908,130,4209,1719,2856,41904,1353
3070,490,13703,1650,8710,67784,4993
2886,74,2629,1728,1504,65669,1125
3877,206,3538,769,2802,31321,736
2439,26,734,1797,532,17426,202
3912,64,523,643,431,15499,92
2237,29,1342,1807,974,38406,368
2799,806,28219,1751,18750,166576,9469
3358,46,833,1479,589,18481,244
3119,62,2452,1628,1314,39543,1138
2451,196,6488,1797,4538,68965,1950
2716,32,1358,1771,846,22637,512
2424,267,8739,1799,6596,48474,2143
2880,371,14444,1729,8942,63597,5502
2999,99,4209,1679,2659,35793,1550
3161,129,3809,1607,2060,36563,1749
2208,431,13830,1808,9881,86758,3949
2425,154,3447,1798,2626,24608,821
2390,227,11722,1801,7786,91382,3936
3485,64,1772,1365,1381,23642,391
3969,6,101,220,89,6274,12
3039,236,10046,1662,6263,54652,3783
2310,232,10222,1804,7108,103224,3114
2820,328,12358,1747,8015,49018,4343
2348,98,3824,1803,2100,18472,1724
3825,16,208,931,178,16728,30
3333,93,2239,1507,1693,34357,546
3800,1603,22197,977,16865,68769,5332
2374,64,3972,1802,2568,73459,1404
2588,395,11928,1786,8083,90178,3845
3954,24,398,397,277,5666,121
2222,55,2785,1808,1911,68965,874
3018,85,1682,1669,1192,25178,490
2995,9,1174,1684,592,39137,582
3618,25,363,1207,268,15691,95
3268,677,11966,1572,7649,54264,4317
2982,742,12265,1690,8719,40157,3546
2484,408,12518,1794,8468,92510,4050
2167,51,1534,1810,1093,29653,441
2247,33,1784,1807,1123,35328,661
3730,571,26777,1054,22248,91258,4529
2162,132,4568,1811,3492,33916,1076
2910,388,6897,1719,4707,49295,2190
2524,69,1474,1791,1036,27282,438
3838,49,574,908,487,24939,87
3344,32,968,1502,788,30408,180
2305,42,1048,1804,779,26162,269
2297,581,14317,1805,9708,71016,4609
3951,12,123,452,81,3774,42
3845,43,618,869,458,20105,160
2618,148,3538,1783,2440,33736,1098
3292,20,441,1561,326,19706,115
2966,67,1728,1697,1160,28725,568
3026,103,1547,1667,1086,14489,461
3899,126,1582,703,1132,6787,450
2283,462,7890,1805,5896,93949,1994
2397,70,1668,1800,1150,51625,518
2765,198,9319,1760,5481,52155,3838
3383,140,1666,1448,1305,23967,361
2783,181,4475,1754,3185,65088,1290
3111,249,5518,1630,3500,24753,2018
3945,85,1106,486,929,19728,177
3004,85,3661,1676,1910,43003,1751
2635,29,1984,1782,1092,13954,892
2526,12,799,1791,506,18815,293
2271,81,3297,1806,2226,38549,1071
2149,32,889,1812,619,26146,270
2828,108,2845,1746,1848,33119,997
3148,171,3265,1613,1997,51125,1268
2725,27,1605,1770,1023,55378,582
3008,65,2423,1673,1439,26684,984
2553,15,597,1790,414,18038,183
2802,108,4892,1750,3329,48756,1563
3961,36,361,328,298,9442,63
2841,304,8078,1742,5396,40122,2682
2371,42,1557,1802,1199,36624,358
2695,64,1203,1774,712,21858,491
2730,383,23112,1769,14575,87870,8537
2358,506,21084,1802,15632,137417,5452
2458,44,1040,1796,786,17499,254
2436,13,586,1798,419,26248,167
2475,21,1017,1795,772,26472,245
2454,54,1170,1797,706,26032,464
2259,26,1028,1807,847,21365,181
3197,134,4586,1595,2757,27722,1829
2561,99,2767,1789,1884,25898,883
3385,144,2268,1447,1618,28518,650
3355,80,1536,1485,1213,27350,323
2361,76,1596,1802,1255,17848,341
3907,31,259,670,227,11441,32
3081,317,11219,1644,6141,77712,5078
3113,115,3850,1630,2000,53186,1850
2303,430,13780,1804,10142,105529,3638
2621,95,1988,1783,1337,36104,651
2991,93,3471,1685,2156,30614,1315
2362,180,4144,1802,3275,56340,869
3879,19,468,765,280,19583,188
2221,104,5213,1808,3819,39500,1394
2652,37,574,1781,438,22467,136
2309,450,10172,1804,7129,37826,3043
2241,37,1084,1807,812,51460,272
2667,131,2006,1779,1436,25019,570
2321,71,2274,1804,1597,17871,677
3958,30,484,359,291,5113,193
3842,73,1317,893,916,9214,401
2736,161,3765,1768,2435,48402,1330
2435,7,414,1798,259,14850,155
2320,94,2682,1804,1919,49203,763
2349,60,2113,1803,1388,49119,725
2177,12,428,1810,239,8162,189
3834,26,608,913,517,7838,91
2449,16,643,1797,459,49084,184
2703,353,11189,1773,7506,151848,3683
2387,618,42052,1801,24774,201623,17278
2872,228,9375,1732,5500,52757,3875
2405,52,1124,1800,821,9888,303
2281,101,4776,1806,3085,43423,1691
2289,72,5081,1805,3591,67583,1490
2219,2205,84141,1808,56887,417696,27254
2850,45,1291,1740,901,31145,390
2565,118,3665,1788,2572,23252,1093
3876,14,382,801,301,6925,81
2150,1119,24562,1812,16885,109221,7677
2166,125,2362,1810,1500,32114,862
2712,185,6837,1772,4397,62002,2440
2767,103,1831,1760,1284,36418,547
2192,519,8912,1809,6425,69046,2487
2176,1223,34830,1810,20287,177255,14543
3460,42,655,1398,510,23359,145
3576,229,5531,1282,4647,68189,884
2795,156,1800,1752,1331,23243,469
3043,36,691,1660,463,19900,228
2584,171,6781,1786,4153,79825,2628
2626,72,1475,1782,989,33347,486
3810,598,14154,967,10783,110872,3371
2594,210,4362,1785,3078,22432,1284
2859,382,10279,1736,6681,42511,3598
2195,18,810,1809,492,9347,318
2511,56,1678,1792,1163,31577,515
2416,1636,75234,1799,50347,407650,24887
2344,28,985,1803,648,33045,337
2829,28,648,1745,473,12166,175
2453,3746,77815,1797,54573,218274,23242
2599,345,8363,1785,6060,104668,2303
2279,53,1662,1806,1145,52715,517
2501,103,2120,1793,1451,55312,669
2498,150,2604,1793,1864,17411,740
2175,87,2519,1810,1838,27471,681
2291,159,3312,1805,2273,54581,1039
2272,129,1666,1806,1316,16749,350
3900,35,646,703,493,9562,153
2427,490,22293,1798,15801,162130,6492
3963,54,500,304,433,11454,67
2877,26,628,1732,479,15721,149
2924,233,4457,1714,3035,59378,1422
2357,66,3011,1802,2115,67979,896
3488,408,11659,1360,9864,93872,1795
2466,67,1815,1796,1213,42102,602
2523,25,809,1791,550,15980,259
2677,3,158,1778,98,17387,60
2893,64,1153,1725,844,22625,309
2687,131,4559,1775,3294,20584,1265
3844,53,689,887,541,14040,148
3173,135,3372,1604,1958,51761,1414
2813,15,704,1748,395,17941,309
2470,5414,121350,1796,71418,394727,49932
3946,58,740,478,624,11603,116
2280,3854,68739,1806,50794,250231,17945
3382,108,1658,1451,1219,68628,439
3206,129,3697,1594,2264,40585,1433
2551,54,1415,1790,1080,19639,335
2819,2027,41628,1747,29030,276470,12598
2589,25,1579,1786,946,37448,633
3147,119,3586,1614,2021,34349,1565
3024,25,487,1667,345,22221,142
2822,501,12301,1747,8283,114608,4018
2979,58,1492,1692,933,18545,559
3955,21,405,364,274,2683,131
2894,55,1341,1725,847,30758,494
2370,44,1513,1802,1114,42706,399
2614,28,432,1783,322,19381,110
3930,673,11430,542,8651,61114,2779
2957,121,2593,1700,1761,17284,832
2923,66,902,1714,672,29189,230
2287,68,3558,1805,2515,35782,1043
2516,388,10016,1792,6573,73810,3443
2793,92,4993,1753,3324,42615,1669
2918,409,11274,1715,7521,58458,3753
3973,30,446,174,364,11822,82
2696,18,365,1774,223,12489,142
2642,124,2337,1782,1399,24818,938
3186,26,763,1599,491,29184,272
2290,2264,56497,1805,33331,197954,23166
2142,10,325,1813,235,15900,90
3453,14,244,1403,199,16135,45
3922,248,2496,604,1754,13245,742
2698,34,1269,1774,957,19950,312
2479,141,2783,1795,2045,70153,738
3881,58,1447,760,945,17349,502
2367,253,6292,1802,4361,97089,1931
2407,765,24423,1800,15019,107555,9404
2278,9,415,1806,241,12290,174
2307,596,46192,1804,29666,141438,16526
3128,27,1161,1625,565,18498,596
3118,73,1509,1628,921,9372,588
2965,282,4467,1698,3082,47029,1385
3880,376,6827,763,5095,27980,1732
2210,193,5180,1808,4024,85863,1156
3591,46,524,1255,436,32197,88
2194,187,4719,1809,3327,42399,1392
3823,376,7623,934,4911,67180,2712
3957,39,387,360,314,10739,73
2833,244,8044,1744,5101,57414,2943
2562,72,2140,1789,1376,25968,764
2779,100,4979,1755,2986,37834,1993
2347,451,12535,1803,8542,126170,3993
3074,102,3617,1648,1976,32841,1641
2727,29,1470,1770,937,45715,533
3300,103,1431,1551,981,27485,450
2306,55,1763,1804,1310,22568,453
2417,640,13197,1799,8751,55985,4446
2311,4099,122975,1804,78074,515630,44901
3950,106,1053,452,958,12882,95
2238,75,2788,1807,1934,36868,854
2197,6,169,1809,114,16427,55
3299,166,3234,1554,2330,51820,904
3071,110,3303,1649,2002,32727,1301
2502,67,2302,1793,1745,40559,557
2256,77,3117,1807,2394,47371,723
2611,1199,19652,1783,13927,107782,5725
2934,263,5786,1706,3828,35943,1958
3533,392,15823,1318,13311,104426,2512
2834,134,2786,1744,1965,45637,821
2797,264,9609,1752,6105,39272,3504
3092,18,1219,1639,686,23772,533
3868,61,1090,818,731,13871,359
2275,39,2335,1806,1409,32142,926
2823,79,1375,1746,972,37523,403
3815,99,1234,954,893,7542,341
2536,8,734,1791,437,18056,297
2152,7,410,1812,276,10910,134
2569,110,2484,1788,1727,38375,757
2232,27,758,1808,500,13080,258
2483,3589,70995,1795,47211,198940,23784
3505,88,1642,1342,1155,23793,487
2663,95,3018,1779,2041,47351,977
2935,30,2135,1706,1320,48571,815
2550,132,2655,1790,2034,30864,621
2246,25,1368,1807,903,14616,465
3422,431,7428,1419,5816,95170,1612
2702,94,2435,1773,1617,53083,818
2406,32,628,1800,434,8794,194
2607,183,20333,1784,15930,80197,4403
2499,200,5709,1793,3739,57428,1970
2950,158,3270,1701,1868,61225,1402
2899,48,598,1724,422,14347,176
3926,27,275,569,233,10333,42
2932,697,8977,1707,6486,42100,2491
2338,376,7396,1803,4825,52014,2571
2745,58,2088,1767,1414,21888,674
3236,291,7686,1584,4876,77221,2810
2630,125,2582,1782,1642,20399,940
2446,492,11731,1797,7050,96373,4681
2444,211,6278,1797,4192,36328,2086
3414,414,5049,1421,4097,58368,952
2752,57,1050,1765,703,35213,347
2572,791,12754,1788,8707,85052,4047
3937,46,407,509,307,7868,100
3914,64,737,634,541,12916,196
2693,21,1568,1774,958,29425,610
2421,139,5746,1799,3840,80225,1906
3291,11,254,1561,179,18205,75
3915,69,841,629,662,11912,179
3115,41,865,1629,534,5499,331
2389,331,12772,1801,8019,66379,4753
2261,52,2335,1806,1622,39592,713
2207,28,444,1808,365,16874,79
3247,3117,68075,1577,36577,343971,31498
2538,13,541,1790,349,18378,192
2826,166,9004,1746,5551,58394,3453
2169,37,706,1810,609,30526,97
3061,102,1142,1652,706,18301,436
2552,58,1068,1790,778,31537,290
2633,81,1451,1782,1028,33932,423
2943,118,2695,1703,1538,31464,1157
2528,79,1297,1791,927,40619,370
3461,274,3900,1397,3120,47018,780
3546,97,1540,1310,1118,22593,422
2215,227,6598,1808,4392,30935,2206
3896,65,966,727,728,7004,238
2916,80,1273,1716,859,19732,414
3561,255,4042,1290,3144,65129,898
2327,1714,36723,1804,25666,121712,11057
2705,44,884,1772,603,19802,281
3975,11,240,134,169,3755,71
3826,36,760,931,437,6454,323
3851,119,1537,859,1172,14396,365
2165,134,8290,1811,5787,108825,2503
2984,57,1161,1689,797,35803,364
2396,41,1051,1800,795,44800,256
2383,735,18337,1801,11962,79763,6375
3191,170,3138,1597,1923,16851,1215
2282,26,609,1805,352,19245,257
2700,108,1769,1773,1293,25117,476
3088,116,2245,1640,1368,40566,877
3336,289,6702,1505,5165,114691,1537
3911,57,1460,660,1242,16607,218
3190,185,3184,1598,2299,44848,885
3917,14,210,624,137,17388,73
2737,7,224,1768,155,16054,69
2868,57,1463,1733,973,17249,490
2248,30,1035,1807,784,38694,251
2917,43,2508,1716,1763,24984,745
2525,259,16250,1791,11832,144024,4418
2776,17,723,1756,419,33103,304
3890,38,618,729,512,17036,106
2939,199,9554,1705,6131,83001,3423
2625,67,1692,1782,1198,30156,494
2858,73,1913,1737,1319,26431,594
2196,8,297,1809,209,18824,88
3238,254,4353,1584,2687,59205,1666
2578,128,3024,1787,2052,30510,972
3095,1055,52004,1638,26488,177980,25516
2657,419,8086,1780,4916,71504,3170
2242,310,16124,1807,11528,78074,4596
2766,591,16270,1760,11500,90949,4770
3964,26,500,291,416,11450,84
3259,100,2577,1574,1630,18894,947
2460,83,2986,1796,2187,32759,799
2437,348,17886,1797,12627,114385,5259
3918,201,2334,622,1611,18012,723
2993,222,6946,1684,4255,65622,2691
2488,986,35853,1794,21289,223093,14564
2992,132,2989,1684,2101,38730,888
2781,344,10071,1755,6333,65324,3738
3366,76,1420,1470,1039,15614,381
2514,622,14810,1792,10159,65702,4651
2862,42,1081,1735,665,27166,416
2368,106,5982,1802,3786,58332,2196
3818,427,4715,947,3290,52147,1425
2159,146,11528,1811,7959,88851,3569
3312,27,321,1538,243,17299,78
2214,24,774,1808,589,7770,185
2876,74,3522,1732,2220,19232,1302
2987,112,2222,1688,1463,19653,759
3033,384,4760,1664,3170,32658,1590
3558,291,5120,1295,3339,47037,1781
2379,44,1075,1801,804,28826,271
2825,444,6751,1746,4726,79418,2025
2445,4,235,1797,154,24021,81
2954,237,6471,1700,4517,58385,1954
2907,1087,21423,1719,14929,91546,6494
2318,29,1155,1804,797,20596,358
3110,188,13869,1630,5982,68845,7887
2227,180,10672,1808,7251,79889,3421
2331,23,470,1804,317,37324,153
3298,272,8070,1555,5125,51609,2945
3484,146,2417,1367,1791,72571,626
3934,287,2495,511,1713,21478,782
3885,188,3718,752,2421,34459,1297
2728,94,1723,1769,1163,27489,560
2356,96,4044,1802,3075,46449,969
2148,52,2427,1813,1975,26220,452
2853,152,3574,1739,2345,26953,1229
2845,2520,76351,1741,44054,342689,32297
2949,108,2375,1701,1559,34016,816
2200,24,1413,1809,989,19256,424
3543,25,421,1312,354,27676,67
2462,34,1829,1796,1368,28043,461
2431,142,2449,1798,1870,37924,579
3028,41,1361,1666,912,27445,449
3040,162,5878,1662,3531,30567,2347
3017,1236,40707,1670,25776,237677,14931
3947,80,760,466,633,17119,127
2735,111,2811,1768,1845,18331,966
2450,223,7458,1797,5291,57444,2167
2948,73,2426,1701,1601,35678,825
3218,86,1972,1591,1251,52580,721
3069,35,1051,1650,652,20925,399
3407,384,6276,1428,4754,44916,1522
3065,30,569,1650,363,16254,206
2143,1519,45832,1813,29420,296391,16412
2866,13,534,1734,291,18157,243
2671,43,796,1779,571,18441,225
2236,1055,108010,1807,73897,405955,34113
2244,9,913,1807,574,7618,339
2294,576,20530,1805,14111,147280,6419
2249,47,1929,1807,1095,32360,834
2654,14,398,1781,229,12398,169
2486,13,278,1794,198,8015,80
3129,61,1200,1624,671,26831,529
3225,105,2373,1588,1288,45433,1085
2610,98,2281,1783,1468,46435,813
3809,473,7141,968,5701,62597,1440
2452,37,1260,1797,900,27415,360
3002,376,9684,1677,5951,51087,3733
2598,43,1048,1785,745,21188,303
2220,56,3170,1808,2297,69640,873
2161,790,19292,1811,12833,67878,6459
2685,1616,61275,1776,41195,148053,20080
2355,55,1785,1803,1282,34549,503
3884,20,327,752,297,7839,30
3397,337,8470,1433,6258,30315,2212
2217,767,20306,1808,13051,96482,7255
2433,64,1496,1798,1175,18636,321
3502,98,1730,1346,1335,35947,395
2262,102,4765,1806,3615,44398,1150
2699,30,609,1774,397,19679,212
2953,32,1455,1700,906,26895,549
2665,68,1115,1779,829,23770,286
2837,82,4276,1743,2800,35897,1476
2339,196,3880,1803,2822,29912,1058
3038,1350,47959,1662,29124,218874,18835
3970,149,1085,213,954,9678,131
3544,393,19786,1311,16686,88929,3100
2615,13,637,1783,431,16888,206
3929,76,807,544,714,18644,93
2747,156,6149,1766,4129,63130,2020
2879,50,1194,1730,748,30665,446
3240,3450,77777,1584,46170,299993,31607
3051,25,694,1656,417,22082,277
2782,46,1545,1754,1035,28024,510
2585,83,2217,1786,1458,28695,759
2158,877,26970,1811,17584,195785,9386
2313,55,1522,1804,1192,20809,330
2816,589,12928,1748,8861,65467,4067
2410,160,3479,1800,2556,28321,923
2812,34,1025,1748,646,19081,379
2323,154,5505,1804,4170,43741,1335
3878,158,4616,767,3499,14461,1117
3185,14,813,1599,363,17452,450
2185,15,464,1809,382,21876,82
2878,250,4728,1731,3030,43790,1698
2780,240,7402,1755,4889,43205,2513
2493,156,4182,1794,3198,33644,984
2627,102,3102,1782,2235,20663,867
2941,49,1526,1704,970,27415,556
2481,81,3704,1795,2284,82115,1420
3503,241,6887,1343,5224,64713,1663
3924,4,40,593,31,8722,9
3798,126,1741,979,1322,30276,419
2595,144,7899,1785,4809,86352,3090
2401,220,6423,1800,4765,62058,1658
3898,59,1330,720,1035,29581,295
2815,584,19977,1748,12952,111007,7025
3143,51,1085,1616,581,14231,504
2239,587,16634,1807,11506,125984,5128
2477,159,4003,1795,2612,37646,1391
3501,342,4772,1348,3932,46946,840
3409,122,2780,1427,2108,44119,672
2170,819,42413,1810,25959,288193,16454
3913,94,814,637,623,10445,191
2807,40,541,1749,354,14541,187
3931,125,1941,533,1406,19112,535
2774,37,1034,1756,706,24711,328
3882,681,8316,753,6193,40313,2123
2188,25,562,1809,390,21699,172
3016,480,13127,1670,8021,60020,5106
2666,103,2888,1779,1867,31367,1021
2472,100,2524,1796,1864,53965,660
2775,50,2568,1756,1567,29851,1001
2680,422,7671,1777,5406,71502,2265
3205,808,22203,1594,13728,113019,8475
2836,27,896,1744,574,21534,322
2933,115,1967,1706,1351,27912,616
3239,84,2674,1584,1707,27660,967
2758,90,5359,1763,3378,38435,1981
3106,65,1099,1634,670,16847,429
2146,297,7716,1813,5578,32312,2138
2408,5,331,1800,229,10513,102
3531,192,2814,1321,2166,31687,648
3811,541,4678,966,3920,52477,758
2757,1893,56384,1763,36477,381996,19907
2777,85,2002,1755,1325,13301,677
2384,146,6586,1801,4545,58890,2041
2189,89,4485,1809,3167,68641,1318
2770,68,2568,1758,1499,45567,1069
2961,184,7797,1699,5231,35078,2566
2319,236,8254,1804,5678,67969,2576
3180,183,4497,1602,2540,41764,1957
2558,325,9630,1789,7006,82290,2624
2482,380,9308,1795,6055,53670,3253
3832,288,5104,925,3379,47227,1725
3685,458,36519,1108,30792,107425,5727
2398,922,16065,1800,10500,83835,5565
2989,364,13815,1686,7947,71026,5868
3492,76,817,1357,626,29950,191
2377,68,1881,1801,1443,40356,438
2592,186,5945,1785,3738,48350,2207
2567,912,18843,1788,11579,96612,7264
2638,130,3852,1782,2769,51739,1083
2761,117,2220,1763,1468,26259,752
3260,121,2868,1574,1811,28577,1057
2286,28,680,1805,472,12522,208
2631,42,909,1782,639,24748,270
3060,56,1752,1653,995,26041,757
2764,306,7633,1761,5689,54173,1944
2315,1257,23472,1804,17936,245175,5536
2233,11,282,1807,207,22013,75
2791,883,26498,1753,17216,87578,9282
2969,29,609,1696,384,15236,225
3784,79,1583,1003,1121,10463,462
2198,20,1188,1809,876,14526,312
3105,5,163,1634,79,12931,84
3116,170,2746,1629,1584,32946,1162
2605,99,6018,1784,3796,85199,2222
2679,46,937,1778,692,20234,245
3577,209,7431,1282,5701,44863,1730
3497,104,1585,1352,1266,26237,319
2653,278,6528,1781,4763,50358,1765
2906,2510,33827,1720,25333,116382,8494
2602,209,4917,1784,3563,28856,1354
2772,766,17428,1756,12024,137399,5404
3711,84,1512,1076,1046,15842,466
2328,24,1032,1804,678,36569,354
3935,91,918,511,712,12942,206
2909,121,2741,1719,1849,35405,892
3124,602,21440,1626,11741,127071,9699
2542,284,5556,1790,4015,37364,1541
3575,1668,42249,1283,31401,208180,10848
3717,17,800,1063,556,22100,244
2330,276,4944,1804,3277,22557,1667
2640,5487,122133,1782,77910,475075,44223
2506,66,1950,1792,1496,48437,454
2647,197,3423,1781,2444,27184,979
3214,12,290,1593,174,6521,116
3437,171,4693,1410,3298,22358,1395
2366,11,641,1802,503,21084,138
2990,420,8487,1685,4982,42238,3505
2936,46,1039,1705,646,21387,393
3415,517,6779,1421,5547,63731,1232
3019,59,2306,1669,1332,40729,974
3068,55,1480,1650,913,15756,567
2354,41,1662,1803,1253,29886,409
2260,274,29640,1806,21143,110792,8497
2459,45,2189,1796,1382,32955,807
3136,744,22938,1620,11832,75937,11106
2734,6,140,1768,92,10978,48
3903,19,538,692,336,14904,202
3887,147,2259,747,1568,19812,691
2513,637,14678,1792,10250,72239,4428
3816,17,335,954,212,7952,123
3943,57,817,492,633,20932,184
2496,177,7114,1793,4791,67800,2323
3308,20,291,1538,210,17746,81
2293,105,1372,1805,1013,25413,359
2749,654,27843,1766,20762,103270,7081
3923,14,109,597,77,11137,32
2581,457,17092,1787,10871,108012,6221
2201,21,1178,1809,915,14370,263
2448,70,1321,1797,1031,38468,290
3373,542,8150,1457,6685,53713,1465
2938,62,1746,1705,1207,25072,539
2708,59,898,1772,570,17514,328
2503,82,6175,1793,3741,56972,2434
3175,190,8440,1604,4548,56529,3892
2522,2768,67797,1791,50389,259156,17408
3075,97,2658,1648,1644,29512,1014
2243,84,2654,1807,2001,71759,653
2228,259,5335,1808,3925,93546,1410
3131,132,5706,1623,3212,44924,2494
2434,1296,46173,1798,32428,180548,13745
3821,88,1271,939,982,37088,289
2500,178,5938,1793,3869,54484,2069
2487,139,4331,1794,3084,70498,1247
3547,208,13328,1310,11489,73385,1839
2883,10,390,1729,258,19981,132
2204,64,1404,1808,1034,43902,370
2974,102,1456,1694,949,10343,507
2376,108,2766,1801,1891,87588,875
2606,78,2049,1784,1509,38111,540
2326,1212,81016,1804,50356,234973,30660
3952,32,412,445,284,8545,128
2234,10,418,1807,303,26675,115
3140,58,5218,1618,1878,32081,3340
2298,29,1435,1805,1002,39187,433
2393,1257,58154,1800,39210,408589,18944
2817,121,2732,1748,1913,50215,819
3145,98,2847,1615,1261,29834,1586
3059,86,1865,1654,1243,32217,622
3592,232,3928,1255,3542,25432,386
2978,169,2925,1693,1967,57573,958
2587,406,13608,1786,8500,75144,5108
3015,37,1042,1670,683,16305,359
2343,178,7367,1803,4827,49361,2540
2715,33,1126,1771,725,43697,401
2593,27,780,1785,560,31201,220
3271,235,2655,1571,1967,38747,688
3944,105,827,489,657,9885,170
3282,49,891,1565,512,14237,379
2890,352,16811,1726,11001,119847,5810
3593,1423,36291,1255,27201,189135,9090
2180,43,1045,1810,678,16164,367
3208,96,2238,1593,1539,17975,699
2515,186,5566,1792,3746,43081,1820
2929,101,4030,1708,2769,15125,1261
3338,77,1698,1504,1298,52624,400
3905,43,374,674,335,15802,39
3284,67,2886,1565,1752,37897,1134
3976,22,406,115,378,7022,28
2986,74,1817,1689,1156,20170,661
2801,901,13327,1751,9609,83997,3718
2937,57,899,1705,616,23993,283
2140,438,12155,1814,7433,138446,4722
2211,129,6104,1808,4503,58433,1601
2796,320,8008,1752,5664,53672,2344
3047,78,1897,1657,1115,27973,782
3883,26,389,752,272,15682,117
3219,209,5979,1591,3655,43312,2324
3908,12,90,670,74,4903,16
2212,111,4126,1808,2964,17078,1162
2418,7,352,1799,259,18228,93
2900,112,2288,1722,1647,22468,641
3275,158,7009,1568,4949,41432,2060
2400,24,1151,1800,791,21345,360
3289,122,3409,1562,2504,48945,905
2324,48,1058,1804,828,28104,230
3035,163,12208,1663,6868,86418,5340
2884,155,6340,1729,3666,45436,2674
2430,252,4790,1798,3570,27364,1220
2518,46,955,1792,641,23488,314
2257,42,1921,1807,1206,32477,715
2308,488,13718,1804,9528,128506,4190
2888,426,9150,1727,6038,49033,3112
3125,104,3627,1626,1942,35508,1685
2955,31,1118,1700,786,28040,332
2216,14,638,1808,474,27834,164
3285,130,4009,1565,2770,53444,1239
2751,10,427,1766,288,15103,139
2600,59,1405,1785,928,27117,477
3808,14,453,970,303,15038,150
2808,186,3487,1749,2389,49692,1098
2411,109,4128,1800,2975,66877,1153
2643,63,1825,1782,1186,72376,639
3639,101,6366,1171,4804,39784,1562
2873,310,11234,1732,6833,82771,4401
3209,423,12241,1593,6465,114577,5776
3109,32,832,1632,334,7420,498
2709,4,320,1772,173,12189,147
2353,492,16501,1803,10366,91878,6135
2489,207,3741,1794,2664,22648,1077
2476,180,11775,1795,7601,100106,4174
2517,73,2668,1792,1776,28488,892
2369,107,2766,1802,1775,63359,991
3264,243,6503,1573,4654,59245,1849
2717,45,1526,1771,1068,20830,458
3829,97,1948,926,1542,36411,406
3222,37,718,1590,374,25793,344
2596,11,612,1785,366,14397,246
2337,22,816,1803,643,33126,173
2395,232,10879,1800,7375,97415,3504
2579,45,1187,1787,800,19474,387
3920,121,1606,612,1397,17475,209
2423,1414,40938,1799,30185,196923,10753
2226,87,2353,1808,1795,50944,558
2186,186,5738,1809,4421,31370,1317
3020,85,1342,1669,933,27040,409
2480,18,714,1795,552,35105,162
2253,49,1801,1807,1212,38009,589
2474,50,2227,1795,1681,65054,546
2830,32,520,1745,388,22680,132
2701,71,3112,1773,1866,19950,1246
2380,112,4801,1801,3650,56169,1151
2191,61,2304,1809,1634,55101,670
2168,75,2196,1810,1473,27915,723
2316,363,13186,1804,8268,42976,4918
3559,20,219,1295,175,12759,44
2264,37,3214,1806,2014,31935,1200
3334,445,6631,1507,4681,99300,1950
2231,40,999,1808,721,21038,278
3966,32,260,271,166,6745,94
3938,42,393,506,318,6129,75
3244,549,15134,1580,9536,76974,5598
2628,61,1162,1782,801,23457,361
2786,288,13036,1754,7938,54081,5098
2202,19,280,1808,240,19190,40
2678,114,2842,1778,1888,33054,954
2840,4,100,1743,72,13659,28
2889,229,3932,1727,2762,34135,1170
2962,584,10470,1698,6981,52178,3489
3117,75,2573,1628,1497,20455,1076
2891,97,1965,1725,1209,20765,756
2512,311,9914,1792,6946,105623,2968
3906,68,573,674,521,9402,52
2296,302,7981,1805,5410,41601,2571
2507,20,1666,1792,1057,21375,609
2519,26,984,1792,667,16422,317
2896,30,567,1724,421,31310,146
2619,229,5702,1783,3467,38498,2235
2811,800,30787,1748,21450,171131,9337
3273,18,696,1571,440,22717,256
3350,100,2265,1489,1730,42601,535
3865,44,287,820,231,6406,56
3806,282,2692,973,2048,14891,644
2980,370,8293,1691,5281,47294,3012
2365,246,5764,1802,4107,54040,1657
2722,50,3034,1770,2129,54623,905
3933,66,1169,521,965,15325,204
2409,443,11698,1800,7705,72895,3993
3702,24,496,1084,318,6069,178
2245,114,4408,1807,3152,41613,1256
2946,274,4577,1702,3245,60691,1332
2478,34,1286,1795,867,27562,419
3925,40,338,580,265,14589,73
2351,132,17203,1803,11139,42730,6064
2832,35,568,1744,418,15199,150
2285,391,7284,1805,4972,44300,2312
2491,363,9969,1794,5977,102920,3992
3156,1678,52015,1609,28045,278867,23970
2457,64,2360,1796,1578,47313,782
3093,62,3528,1639,1822,49450,1706
3494,384,10615,1354,7848,60255,2767
3499,603,24165,1350,20253,140312,3912
2254,74,1414,1807,1068,43748,346
2154,75,2707,1812,1868,53578,839
2849,525,19610,1740,12480,67069,7130
2174,129,6553,1810,4526,61555,2027
2548,405,9717,1790,6221,78407,3496
3888,58,862,744,750,20284,112
3977,2,48,114,38,3696,10
2428,144,2937,1798,2209,26969,728
2329,1060,27800,1804,18313,100708,9487
2670,81,4017,1779,2660,65513,1357
2763,38,1033,1762,695,20130,338
2235,37,1167,1807,826,34198,341
3571,169,4844,1285,4040,77415,804
2363,454,9707,1802,6999,46062,2708
3889,167,1723,734,1258,13508,465
3261,70,2219,1573,1351,18367,868
3192,160,3214,1597,2174,65288,1040
2183,838,14872,1809,9803,77579,5069
2199,27,1318,1809,1008,15857,310
2461,16,322,1796,246,16621,76
2557,122,2979,1789,1929,16947,1050
3459,603,10172,1398,8276,76227,1896
3283,615,12795,1565,8200,86973,4595
2520,15,385,1792,291,22841,94
2659,1166,58813,1780,41278,276370,17535
2533,207,4625,1791,3205,28124,1420
2334,22,962,1803,681,28073,281
2295,35,1249,1805,893,21143,356
2414,287,5695,1799,4222,29543,1473
2394,442,10617,1800,6993,50406,3624
3606,330,16726,1231,14389,94764,2337
2732,143,5894,1769,3806,66400,2088
3610,113,1176,1227,940,30113,236
2288,161,3924,1805,2530,27607,1394
2726,693,20528,1770,13044,81707,7484
2582,2672,58397,1787,35681,223576,22716
2441,21,582,1797,422,29172,160
2456,59,2055,1796,1262,49450,793
2634,17,426,1782,309,22111,117
3237,51,885,1584,491,19488,394
2182,243,7728,1809,5338,72733,2390
2560,787,21332,1789,15624,121961,5708
2413,118,3096,1799,2328,13895,768
2769,1161,38724,1758,26182,341691,12542
2203,231,6994,1808,5384,60459,1610
3812,177,2666,962,1904,17341,762
2509,257,17544,1792,11237,116624,6307
2649,83,1736,1781,1146,35324,590
2867,198,3875,1734,2590,30527,1285
3854,349,5678,855,3737,34219,1941
3193,190,5027,1597,2843,34022,2184
2655,1205,28524,1780,19438,109011,9086
3949,19,181,459,130,3758,51
2576,935,41106,1787,29219,185184,11887
3134,12,321,1621,190,6873,131
2724,9,279,1770,186,24092,93
3608,241,3539,1230,2863,86181,676
3566,4,135,1288,123,7449,12
3163,791,22210,1606,11678,138348,10532
2346,141,5767,1803,3671,92379,2096
3455,12,177,1403,143,21221,34
2831,29,731,1745,482,15016,249
3860,1334,20503,846,17024,148940,3479
2686,17,260,1775,173,15935,87
2399,67,921,1800,656,24909,265
2921,266,6577,1714,4616,41663,1961
2250,19,762,1807,513,21241,249
2471,114,3536,1796,2396,27672,1140
2842,256,8740,1742,5726,44739,3014
3242,32,1452,1581,946,23409,506
2762,164,6511,1762,4106,42833,2405
2312,22,911,1804,708,26966,203
2179,13,463,1810,326,11464,137
2251,2959,90278,1807,53273,336177,37005
3149,313,9303,1612,4838,56424,4465
2332,562,11182,1803,7801,84804,3381
2555,998,32718,1789,22110,155514,10608
3211,208,18352,1593,10833,94178,7519
3491,205,3680,1358,2683,43479,997
3053,2144,75164,1656,45301,270763,29863
2566,102,2683,1788,1877,31791,806
3921,349,3779,607,2675,25922,1104
2975,31,1926,1694,1266,23102,660
3967,18,163,207,152,4537,11
2505,12,394,1792,287,10463,107
3901,21,353,696,227,10351,126
3302,34,1471,1548,1115,39270,356
3861,57,596,831,422,15644,174
2903,189,4981,1722,2969,65775,2012
3585,259,7509,1269,5813,42190,1696
3262,234,5212,1573,3371,49702,1841
3545,17,240,1310,183,12778,57
2468,51,1125,1796,833,23137,292
2835,388,7278,1744,4683,39280,2595
3919,34,319,620,243,9533,76
2597,51,1515,1785,981,33610,534
3916,28,244,629,203,6266,41
2575,29,688,1787,492,21544,196
2266,1285,30608,1806,20214,132630,10394
2160,470,11004,1811,8264,39455,2740
3960,24,518,332,302,14194,216
2645,2390,80968,1781,53716,293935,27252
2510,945,25794,1792,16962,119867,8832
3974,10,158,137,116,5450,42
3421,417,5693,1419,4195,70814,1498
2359,721,18980,1802,13228,50915,5752
2564,975,24219,1789,16847,150392,7372
2844,526,18604,1741,11891,63506,6713
3948,64,905,460,690,9481,215
2345,464,7715,1803,5597,86305,2118
3962,16,231,310,179,8031,52
3220,171,4484,1591,2773,38633,1711
2904,211,3017,1721,2092,41975,925
3301,1327,26407,1550,18520,161417,7887
3162,114,4120,1606,2300,29303,1820
3646,24,429,1161,364,29458,65
3031,83,2610,1665,1420,44141,1190
2960,113,3565,1699,2350,24243,1215
3215,150,5381,1592,2942,37264,2439
2463,407,11894,1796,8339,97585,3555
2415,171,5762,1799,4427,48983,1335
2760,30,1089,1763,695,31660,394
3902,29,358,693,295,7965,63
2983,204,5728,1689,3476,33047,2252
3875,26,341,816,211,5564,130
3857,129,1952,851,1480,22497,472
2546,43,2678,1790,1700,29707,978
2688,46,845,1775,587,17393,258
3715,216,3532,1071,2343,31321,1189
2268,124,9944,1806,6587,60515,3357
3581,337,13199,1275,10923,116195,2276
2155,5,150,1812,108,18568,42
2662,33,2599,1780,1797,35224,802
3940,68,618,501,541,7640,77
2255,211,4447,1807,3261,41755,1186
2644,164,2403,1781,1721,15341,682
3942,2,80,493,53,10794,27
3412,157,2248,1424,1695,15412,553
2492,17,1067,1794,619,36155,448
2147,0,0,1813,0,44680,0
2773,425,17497,1756,11575,84100,5922
2442,81,2046,1797,1321,24306,725
2541,292,6195,1790,3752,48174,2443
2490,37,1228,1794,823,15531,405
3614,33,491,1210,321,21242,170
2756,451,19995,1764,13175,85212,6820
2719,26,1386,1771,842,47268,544
2473,97,2757,1795,1794,27103,963
3457,33,622,1402,504,19208,118
2314,124,2578,1804,1989,32309,589
2218,331,16468,1808,10981,129916,5487
3959,20,363,358,231,3307,132
2447,216,8546,1797,5267,57388,3279
3813,897,16390,959,13514,120352,2876
2601,91,1866,1785,1454,17439,412
2301,3,84,1805,69,17311,15
2145,6414,199441,1813,113409,1019719,86032
2181,427,8741,1809,6797,127828,1944
2681,49,2053,1777,1441,27056,612
3941,254,2754,493,2153,21633,601
2720,214,7549,1770,5103,100306,2446
3442,505,6791,1407,5457,60104,1334
3972,2,19,213,16,3654,3
3446,21,168,1406,139,12303,29
2806,378,7617,1749,4946,48536,2671
2718,51,1502,1771,1031,17158,471
2612,560,15797,1783,11792,83896,4005
2803,208,9499,1750,6201,83146,3298
3349,143,3052,1489,2257,32625,795
2422,90,1698,1799,1230,34646,468
3871,12,217,818,150,8888,67
3100,1395,68144,1637,25954,341665,42190
2689,85,4007,1775,2080,39476,1927
2252,338,9296,1807,6876,62179,2420
2402,118,5028,1800,3131,50749,1897
3528,266,3512,1324,2679,39874,833
2818,17,372,1747,220,14369,152
2240,142,6862,1807,5123,62215,1739
2622,114,3667,1783,2259,50215,1408
2673,134,2779,1778,1913,32287,866
2304,124,11324,1804,6896,86134,4428
3621,32,511,1205,335,14748,176
3064,1585,54870,1651,33709,270052,21161
3006,229,5110,1675,3276,41913,1834
2697,224,9543,1774,5647,62508,3896
2543,3060,71482,1790,41834,230729,29648
3714,90,1071,1071,787,14433,284
3596,27,339,1251,298,9716,41
2742,56,1018,1767,689,27965,329
2420,50,1034,1799,750,21011,284
2864,121,5923,1735,3616,50564,2307
2731,31,873,1769,535,29574,338
3939,36,214,501,157,6396,57
3022,79,2056,1668,1137,28059,919