Mod,likes,downloads,time,unique_dl,views,dl_dif
361,3,49,375,42,10341,7
125,3,216,420,120,5804,96
881,101,1095,157,1031,14023,64
985,87,941,132,827,10471,114
211,3,90,407,42,7204,48
759,11,73,183,62,1960,11
543,306,4622,295,2979,40117,1643
964,19,258,139,238,7116,20
710,34,241,196,213,9618,28
697,134,1407,198,1259,8401,148
999,100,3313,125,2301,16765,1012
712,8,185,195,177,4401,8
805,48,366,172,287,3995,79
94,82,2550,425,2161,56271,389
319,59,802,383,708,20757,94
1010,175,2322,121,2027,27316,295
830,52,527,165,424,7965,103
1021,13,49,117,45,2597,4
695,34,221,202,156,4794,65
119,1,54,421,28,4377,26
353,3,46,377,27,4106,19
439,2,20,359,11,4133,9
523,408,9912,313,6676,62812,3236
401,6,139,368,73,5962,66
926,104,1216,145,1108,9527,108
270,82,705,395,610,15868,95
924,7,165,147,87,3551,78
650,383,3522,222,3093,39310,429
726,24,168,190,151,7592,17
311,13,649,385,305,10771,344
585,96,1328,266,993,15510,335
486,129,2284,340,1691,24082,593
537,14,469,299,273,8094,196
921,31,479,148,404,6128,75
842,502,19841,163,15319,47271,4522
899,136,1906,154,1620,18232,286
724,3,31,191,29,2517,2
785,5,34,177,29,1898,5
63,845,15286,430,11367,183598,3919
183,375,4939,411,4175,45984,764
284,31,293,390,261,10001,32
744,131,1346,185,1130,17461,216
829,185,2705,166,2490,21485,215
35,33,1454,435,714,20630,740
161,21,514,415,363,8598,151
410,438,9574,366,7369,50986,2205
242,1093,16410,400,14038,165466,2372
927,26,380,146,310,10874,70
916,133,2427,150,1829,19134,598
558,913,24201,287,15698,104635,8503
370,109,876,373,703,16753,173
536,4,231,301,225,10316,6
864,34,388,159,316,4429,72
760,124,8531,182,6199,23352,2332
991,5,252,129,81,4412,171
344,36,722,379,632,13643,90
467,162,3368,345,2935,31560,433
628,83,679,231,584,10865,95
1029,14,223,113,215,5997,8
409,4,68,366,49,6181,19
405,69,1084,366,888,10684,196
552,11,339,292,168,6831,171
422,73,954,362,771,11721,183
817,13,170,168,142,8561,28
47,14,195,433,117,6811,78
903,49,651,153,581,8793,70
955,24,253,141,205,9098,48
388,54,929,370,800,20632,129
904,385,9383,153,6962,32067,2421
682,628,15339,203,11359,84861,3980
290,6,242,388,93,3714,149
503,678,11578,329,9802,74332,1776
460,409,9524,347,6481,39878,3043
164,295,2533,414,2023,62522,510
121,9,150,421,93,3457,57
606,336,6771,248,5279,61574,1492
470,36,831,343,724,19706,107
23,9,230,436,140,6968,90
770,13,161,180,126,3269,35
949,212,3682,142,3207,21360,475
792,128,1359,175,1235,8839,124
263,33,635,397,530,14762,105
907,51,398,153,359,10120,39
402,175,3761,367,2902,68709,859
217,3,77,406,23,1881,54
219,13,471,405,297,9024,174
493,335,6136,335,4858,109915,1278
819,6,81,168,75,3901,6
922,4,213,148,96,4502,117
75,15,187,428,122,7464,65
1002,35,495,124,367,7457,128
704,1946,42163,198,38313,235005,3850
511,4,143,324,136,6366,7
701,13,129,199,118,12989,11
735,34,454,188,373,9963,81
1038,166,2628,107,2483,21073,145
544,139,1231,292,997,16285,234
477,31,1167,341,580,18463,587
848,4,112,162,107,3334,5
826,6,140,162,124,3768,16
600,1086,23660,254,19687,92872,3973
372,96,940,373,700,18301,240
741,0,71,186,26,1826,45
641,1049,37689,227,31869,202556,5820
831,264,2939,165,2558,26464,381
343,129,1738,379,1222,10916,516
581,15,221,268,188,3290,33
557,1321,37871,288,26890,112632,10981
751,57,714,184,611,6399,103
717,3,32,193,30,3158,2
865,1,12,158,11,1679,1
840,73,684,164,613,7668,71
216,589,17447,406,12763,108779,4684
224,1,40,404,23,3279,17
19,14,221,437,133,5906,88
851,34,676,161,605,9060,71
57,7,130,432,65,9765,65
875,200,3550,157,2720,33427,830
612,1967,56952,242,44497,196607,12455
1046,22,255,102,208,7039,47
649,257,3029,223,2815,17305,214
617,108,1677,239,1233,17595,444
661,20,111,218,91,3278,20
640,105,1120,228,889,19126,231
979,2,35,133,23,2401,12
786,15,132,177,109,3393,23
226,2,48,404,24,4920,24
959,497,11010,141,9343,58795,1667
406,56,1185,366,697,21866,488
471,2,58,343,50,3586,8
797,63,463,173,435,8931,28
936,336,11839,144,9273,44322,2566
295,0,52,387,27,2453,25
854,12,88,160,81,3699,7
180,10,326,411,198,10799,128
495,287,4277,333,3405,65882,872
138,6,68,419,44,5153,24
331,561,10952,382,8976,105489,1976
675,109,968,212,843,15108,125
923,3,21,147,20,1915,1
157,121,3220,415,2575,39690,645
430,278,5305,360,4337,39328,968
943,54,1631,143,1424,17002,207
262,1256,18890,397,16026,151264,2864
114,1,44,422,23,4136,21
256,59,1627,399,1143,28907,484
371,1941,63284,373,41077,243259,22207
940,4,300,144,113,5839,187
288,117,1053,390,898,16822,155
298,11,442,387,275,6799,167
878,0,11,157,10,955,1
1052,234,2980,96,2715,24341,265
222,4,164,404,71,16990,93
391,11,206,370,182,18953,24
1031,46,630,110,488,7417,142
231,4,43,404,27,4050,16
318,135,1612,383,1338,26379,274
434,1,60,359,42,2807,18
15,65,2308,437,1895,42644,413
269,84,749,395,653,18944,96
1053,24,408,90,326,7885,82
212,39,427,406,334,14416,93
619,0,97,238,55,4187,42
29,32,1196,436,638,15114,558
692,19,228,202,181,4933,47
1045,131,5662,103,4609,34446,1053
1034,77,1197,109,1109,9132,88
550,8,205,294,93,6683,112
992,41,1129,129,1063,19502,66
282,534,6609,391,5487,45180,1122
528,183,4569,307,2923,40144,1646
781,179,5381,177,3154,42557,2227
394,1208,25086,369,16820,101345,8266
438,175,4492,359,3645,40047,847
684,13,463,204,403,5438,60
42,13,468,434,184,7781,284
100,40,328,423,297,21846,31
952,39,333,142,272,5557,61
611,16,312,244,280,8920,32
348,5,88,378,62,4094,26
574,715,12172,272,10043,94281,2129
621,291,4824,236,4088,45286,736
782,15,240,177,206,5712,34
478,23,817,340,632,14062,185
739,183,3686,187,3259,25739,427
791,118,2205,175,1644,29715,561
508,2,63,327,24,4783,39
32,15,262,435,134,17087,128
421,518,10291,362,6857,40089,3434
416,113,1753,363,1034,27866,719
911,52,968,152,784,11406,184
323,32,574,382,515,14597,59
860,7,169,159,157,3687,12
468,16,369,344,319,13631,50
960,38,420,141,261,12259,159
437,3,47,359,24,4160,23
750,37,314,184,289,9713,25
942,32,362,144,300,9492,62
45,12,418,433,212,8558,206
364,106,3474,374,3015,37963,459
289,14,243,388,215,8946,28
515,72,749,321,670,18250,79
728,1,11,190,10,1397,1
754,59,1684,184,1568,12264,116
982,163,2723,132,1924,15541,799
381,333,4219,371,2654,53284,1565
555,88,1346,290,884,10789,462
752,562,6974,184,6310,43307,664
954,111,3601,103,3279,21683,322
182,17,299,411,220,17097,79
268,103,1464,396,1081,21521,383
150,2,49,417,24,3757,25
260,730,9691,398,8314,90719,1377
837,310,5025,164,4026,47145,999
973,0,6,137,5,1708,1
428,373,6577,361,5437,39757,1140
41,13,210,434,105,7190,105
1011,63,375,121,340,6204,35
719,63,585,193,497,11514,88
803,255,3396,172,2646,31475,750
631,26,333,230,293,9989,40
790,1,25,176,23,2024,2
110,8,420,422,199,5111,221
583,251,4548,266,3719,39958,829
64,11,182,430,114,6347,68
65,8,158,430,89,11512,69
265,206,1978,397,1626,27440,352
58,21,276,432,184,8511,92
448,5,209,351,79,7160,130
425,72,1615,362,1286,24835,329
443,42,997,356,554,14860,443
20,4,46,437,26,3915,20
563,49,452,281,334,13045,118
822,49,254,167,204,4701,50
667,175,4370,215,3777,47788,593
316,18,192,384,144,9133,48
502,7,519,329,320,9306,199
349,106,1618,377,1422,33714,196
841,64,785,164,603,17409,182
39,1,68,434,35,7576,33
716,54,432,193,369,12263,63
332,427,7534,382,5742,50573,1792
310,86,956,385,880,23558,76
763,56,656,182,539,20569,117
335,5,154,381,88,12435,66
554,447,4887,290,3988,48126,899
390,2,78,370,58,3370,20
194,6,122,410,68,4077,54
498,13,361,331,198,6800,163
103,10,416,423,179,6878,237
360,122,1144,375,986,15379,158
983,41,305,132,266,9038,39
184,1,31,411,28,7556,3
592,9,101,263,98,5844,3
707,3,14,197,13,2765,1
633,32,164,230,139,5286,25
560,286,3582,283,2814,31451,768
981,185,3325,132,2321,28049,1004
213,7,144,407,108,9456,36
177,152,5036,412,2499,66331,2537
542,70,804,297,742,24290,62
474,414,5181,343,4203,50190,978
532,267,6037,305,4978,74700,1059
1033,253,5529,109,4308,27537,1221
901,15,154,154,145,5670,9
709,11,58,196,46,4373,12
733,3,19,188,16,2394,3
632,196,4139,230,3473,51918,666
732,15,296,188,263,4860,33
228,238,5089,404,4309,66984,780
38,11,194,434,87,6843,107
181,2260,51023,411,39346,231027,11677
941,3,20,144,17,2313,3
241,9,206,402,110,7428,96
866,156,4968,158,2821,20839,2147
604,23,471,250,405,10727,66
620,371,4814,237,4191,58831,623
179,7,152,412,72,4832,80
976,169,1657,135,1463,12848,194
1024,11,112,114,105,5136,7
142,3,45,418,21,3961,24
469,2,84,344,29,4960,55
261,6,110,398,50,4812,60
369,571,7372,373,6337,49511,1035
561,17,155,283,128,6599,27
948,66,826,143,717,12260,109
816,4,81,168,39,1875,42
255,172,2268,399,2038,19900,230
102,45,1632,423,733,15200,899
681,35,709,207,640,15862,69
496,786,32796,333,23637,152893,9159
1017,18,350,116,321,7483,29
488,4,103,339,41,4397,62
31,4,210,435,105,6021,105
132,14,568,420,255,9476,313
986,335,5648,132,4513,31723,1135
734,34,263,188,237,6161,26
252,17,262,400,204,15411,58
143,120,4505,418,2115,64354,2390
580,37,213,268,188,12252,25
969,103,1868,137,1311,12902,557
229,353,9893,404,6892,52216,3001
505,88,774,329,664,20061,110
84,417,23352,426,15455,198295,7897
877,54,1118,157,851,15609,267
582,574,8264,267,5849,65789,2415
970,40,1682,137,1442,21046,240
276,141,2093,394,1687,22964,406
905,400,12311,153,9192,49692,3119
938,42,453,144,435,7001,18
423,3,63,362,35,3405,28
427,337,3222,361,2495,31867,727
718,43,361,193,336,8311,25
529,270,3749,306,2701,34686,1048
1039,193,5145,107,3510,22438,1635
524,23,714,313,627,11986,87
673,250,4242,213,3143,35984,1099
984,203,4736,132,3604,26832,1132
299,5,80,387,55,3860,25
315,2,311,384,96,6838,215
749,0,34,184,13,1509,21
564,125,1207,282,1027,30695,180
918,117,1188,149,1107,13124,81
203,72,1392,408,1129,25376,263
330,1310,36370,382,24006,168162,12364
420,87,1994,363,1380,18242,614
359,361,3937,375,3022,44132,915
429,47,766,361,660,24149,106
737,1,21,187,19,1669,2
235,15,476,403,238,9114,238
957,28,219,141,172,3987,47
173,30,1205,412,698,14665,507
917,105,3270,144,3224,15247,46
657,119,1309,213,1161,17256,148
659,20,605,219,539,12375,66
571,36,359,276,307,6480,52
271,254,2739,395,2363,33165,376
436,111,6588,359,5505,30156,1083
351,36,518,377,406,16326,112
426,409,8431,361,5508,35201,2923
572,124,1002,275,863,17186,139
264,108,1146,397,1044,22405,102
1015,24,429,120,352,3485,77
676,70,825,211,681,8939,144
148,4,210,417,101,5000,109
431,1355,32966,360,25697,132385,7269
668,505,14990,215,13205,64440,1785
239,30,299,402,267,27437,32
487,10,256,339,135,6233,121
693,2386,84676,202,51101,253947,33575
727,493,9760,190,7631,30599,2129
8,14,382,438,208,18596,174
320,685,9322,383,5975,88853,3347
199,445,11649,409,7481,103970,4168
747,8,91,184,88,2768,3
648,109,1396,224,1237,34056,159
742,21,327,186,295,8504,32
971,54,429,137,407,4893,22
772,27,346,180,274,6921,72
671,96,813,214,589,14689,224
811,23,264,170,234,12847,30
538,3,123,299,48,4077,75
366,250,3764,374,3107,36598,657
382,11,620,371,342,8352,278
780,27,269,177,234,5229,35
579,6,340,269,118,6688,222
880,164,2352,157,2102,26064,250
61,1,28,431,15,3491,13
413,657,8835,365,7450,82404,1385
237,1,62,401,30,3519,32
662,3,45,218,39,4090,6
610,809,15359,244,11340,99049,4019
414,704,16143,364,11830,74021,4313
1050,40,1016,99,888,14628,128
568,18,127,279,113,3835,14
644,23,134,226,126,6144,8
140,28,694,419,377,17226,317
457,2,33,348,19,2305,14
932,12,242,145,226,5189,16
74,15,274,428,181,9741,93
404,10,624,367,371,7919,253
447,192,3541,354,2729,17670,812
329,696,11700,382,8184,37431,3516
432,64,612,360,548,11685,64
411,1011,10624,365,7854,60401,2770
248,5,57,400,39,3145,18
98,3,293,424,165,8444,128
133,174,2701,419,2064,41449,637
146,248,2833,418,2401,40194,432
272,1232,25261,395,15523,229161,9738
849,80,1157,161,979,7269,178
475,167,2151,342,1866,31077,285
195,6,67,409,54,7193,13
845,190,3616,162,3377,33413,239
479,2310,90428,340,63298,229046,27130
757,31,352,183,275,11286,77
518,183,2206,320,1735,23065,471
551,136,1748,294,1475,15894,273
614,16,188,241,167,7508,21
977,7,293,135,138,9062,155
178,11,299,412,144,5445,155
766,25,183,181,171,13922,12
526,103,992,308,885,26353,107
1000,9,142,125,101,5322,41
1044,89,1254,104,1218,14627,36
862,15,84,159,72,4137,12
566,62,457,279,392,5835,65
309,255,2959,385,2306,63968,653
34,20,484,435,420,12776,64
843,37,309,163,291,5198,18
56,39,1247,432,586,15402,661
884,154,1646,156,1538,19262,108
980,40,778,133,603,4802,175
48,36,825,433,469,20151,356
812,1,14,170,12,915,2
787,205,3205,176,2697,20312,508
86,184,4957,426,3433,62575,1524
647,503,7375,224,5608,67200,1767
55,20,950,432,456,9190,494
931,93,1225,145,1057,8004,168
852,14,541,161,489,7888,52
577,10,254,270,163,6549,91
891,11,90,155,79,2552,11
838,2,21,164,19,1206,2
69,14,346,429,178,6945,168
946,89,1379,143,1163,12931,216
130,31,1038,420,473,12758,565
587,60,808,265,669,8927,139
18,33,854,437,453,17874,401
136,4,65,419,63,11185,2
328,462,5241,375,4202,77869,1039
573,123,1643,276,1408,33632,235
1041,111,1926,106,1860,19822,66
1,6,479,443,189,29562,290
599,30,435,256,333,11716,102
722,1,18,192,18,1685,0
374,83,946,372,838,15395,108
953,444,11027,142,8647,44897,2380
603,2,100,250,40,4631,60
598,181,2985,256,2497,26339,488
867,61,1036,158,791,15851,245
1036,432,11919,108,9294,40353,2625
307,858,19780,385,13402,99172,6378
141,2,42,418,28,2735,14
293,16,258,388,138,5354,120
139,1,35,419,21,2570,14
944,18,128,143,109,3211,19
545,2,38,294,37,3790,1
313,1052,16428,385,12431,89918,3997
996,3,22,126,18,3221,4
795,61,613,174,506,9056,107
777,26,546,178,315,4204,231
517,6,234,321,71,6709,163
569,0,49,279,12,1980,37
83,996,18596,406,13274,148173,5322
616,177,2401,241,1562,44295,839
112,23,1536,422,521,16484,1015
958,67,540,141,451,5446,89
882,6,83,157,70,2034,13
910,25,242,152,227,3519,15
49,10,165,433,90,8173,75
321,372,6176,383,4913,56189,1263
857,10,135,160,120,3577,15
277,25,583,393,311,17628,272
909,100,1861,152,1497,14733,364
258,5,94,398,53,6169,41
149,2,72,417,43,8764,29
337,14,139,381,104,6041,35
368,5,229,373,130,4902,99
729,146,1878,189,1633,14416,245
215,3,145,407,62,5908,83
507,188,5517,327,4690,27084,827
91,6,176,425,68,5676,108
301,452,5421,387,4289,43017,1132
713,3,36,195,36,2743,0
776,76,675,179,612,5607,63
870,65,920,158,790,12791,130
145,0,16,418,10,2973,6
801,250,3469,172,3091,30846,378
1049,42,555,100,434,9397,121
80,219,6250,427,3586,91113,2664
44,14,704,434,624,14745,80
1001,6,150,124,141,3788,9
1051,99,1279,98,1201,19205,78
890,121,3220,156,2768,21737,452
738,153,2514,187,2299,19914,215
578,403,3653,269,2760,28837,893
1019,257,5618,118,4753,38750,865
783,22,654,177,482,5233,172
813,2,25,169,24,1366,1
821,3,18,167,16,1527,2
514,0,0,321,0,4675,0
898,20,170,154,146,2911,24
745,4,35,184,32,1923,3
588,0,40,264,21,2196,19
375,20,2892,372,1927,17580,965
11,0,131,438,49,6877,82
655,285,7021,221,6042,36803,979
774,52,687,179,622,11269,65
626,193,3016,233,2473,40153,543
778,41,1356,178,711,11006,645
176,6,91,412,56,2960,35
883,54,845,156,650,10972,195
1040,4,85,106,65,5564,20
930,6,190,145,95,4937,95
968,29,638,137,474,11032,164
357,10,221,376,101,7225,120
352,9,189,377,93,4549,96
689,3,209,203,99,5147,110
827,192,2770,166,2513,24372,257
387,105,1228,370,1053,13930,175
1037,42,350,107,302,8297,48
1035,12,86,108,84,3161,2
929,214,5544,145,4916,29736,628
769,34,276,181,217,6046,59
466,27,197,345,181,8903,16
541,34,293,297,239,21839,54
622,99,885,235,797,11599,88
771,1,43,180,39,2838,4
602,19,357,252,308,8467,49
171,163,1814,413,1616,29454,198
925,2,22,147,22,1900,0
1013,83,1058,121,935,9582,123
156,0,31,415,11,5110,20
152,2,70,416,51,5845,19
1016,157,2698,120,2399,22938,299
1005,0,35,123,29,3620,6
407,4,77,366,43,4219,34
521,161,4079,317,2580,36729,1499
350,233,13624,377,7881,71319,5743
37,311,4146,433,3408,229327,738
159,632,8537,415,7401,81850,1136
50,289,9624,432,5956,102726,3668
730,1,8,189,8,1349,0
214,6,171,407,84,6106,87
192,12,214,410,116,8402,98
834,922,51242,165,38503,165508,12739
327,130,1266,382,1111,24481,155
888,60,939,156,781,13026,158
206,3,57,408,30,3191,27
189,27,1140,410,732,13568,408
765,1,21,181,20,1297,1
274,20,249,395,189,24142,60
442,3,110,357,53,5453,57
204,19,598,408,398,10575,200
562,515,7789,282,6193,101739,1596
629,20,266,231,239,8477,27
76,200,7688,428,5898,68914,1790
104,10,187,423,105,4961,82
584,604,8899,266,7329,39364,1570
459,1,43,348,23,2249,20
796,44,636,174,528,7794,108
1020,11,104,118,97,4418,7
601,373,6210,254,4966,37439,1244
1047,213,3544,102,3100,40677,444
646,15,271,224,245,7372,26
534,1,96,304,51,4553,45
314,134,1329,384,1103,16148,226
151,1,42,417,30,3313,12
876,39,418,157,365,9022,53
859,23,223,159,194,6243,29
686,175,3141,204,2503,21812,638
784,56,569,177,521,5815,48
324,243,7066,382,6093,44355,973
51,6,629,432,232,8832,397
998,14,173,125,161,2969,12
764,2,18,182,16,1384,2
417,709,11541,363,10058,73706,1483
1032,64,527,110,471,6637,56
531,0,68,305,28,3141,40
424,404,8008,362,5528,34341,2480
863,30,336,159,294,5458,42
253,22,969,398,419,11028,550
613,243,3049,241,2462,17526,587
691,30,384,203,345,8338,39
106,13,652,423,270,7667,382
99,36,1301,423,693,14585,608
296,889,18880,387,15876,124394,3004
990,45,692,130,527,6795,165
10,177,11864,438,6498,128608,5366
127,3,198,420,105,6053,93
912,0,105,151,21,2430,84
988,52,665,131,625,7366,40
593,7,85,262,79,4104,6
446,27,316,354,275,8513,41
396,22,337,368,277,29389,60
788,676,17336,176,13029,49860,4307
113,3,15,422,9,10133,6
1025,14,384,114,340,8210,44
297,4,95,387,67,15339,28
720,84,1024,192,946,15865,78
935,58,1769,145,1179,16143,590
386,86,1187,371,1007,20113,180
513,154,1485,322,1179,19002,306
547,58,731,294,558,31143,173
444,418,9778,356,6962,39192,2816
198,16,330,409,226,11639,104
201,34,2002,409,746,23084,1256
223,3,111,404,58,4014,53
1018,93,1509,118,1212,12945,297
871,21,257,158,240,5861,17
575,3,39,271,23,4480,16
823,52,1117,166,632,9264,485
36,22,679,435,315,11586,364
608,8,53,248,52,7408,1
435,8,153,359,100,4813,53
363,219,4056,374,3645,46796,411
869,85,1101,158,906,11581,195
53,1057,25034,432,19593,214949,5441
232,2,55,403,37,3820,18
705,4,22,198,22,3105,0
565,286,2731,281,2288,30865,443
193,14,391,410,199,5478,192
25,85,3063,436,1464,33459,1599
1012,2,47,121,39,5609,8
220,1,73,405,45,4875,28
773,18,220,180,201,4160,19
14,33,1091,437,650,17767,441
533,0,216,305,81,8027,135
753,431,10813,184,9583,72560,1230
440,62,1017,358,642,22285,375
978,308,12346,135,9158,56759,3188
123,13,895,420,369,8025,526
188,9,148,410,132,14139,16
397,28,279,368,258,6123,21
937,106,1516,144,1377,14087,139
500,1,70,331,29,3230,41
174,24,1077,413,440,12079,637
994,49,421,127,413,7198,8
345,2,32,379,16,4552,16
109,23,946,422,617,18971,329
627,4,126,233,44,3249,82
207,572,20219,408,9595,193309,10624
93,96,1269,425,1026,36612,243
250,0,77,400,33,1749,44
906,307,9288,152,8729,48536,559
928,351,5794,146,4621,33769,1173
756,2,15,184,15,1625,0
623,88,605,235,500,8774,105
836,160,2611,164,2452,24646,159
591,6,121,263,103,5283,18
962,531,15974,140,12177,58143,3797
638,297,2733,228,2263,25505,470
654,44,480,221,376,6192,104
347,5,98,378,57,4143,41
723,76,843,191,763,16058,80
900,45,452,154,397,5088,55
590,19,151,264,141,15400,10
885,8,258,156,143,3367,115
711,4,26,196,23,2120,3
24,6,136,436,72,5084,64
687,430,6818,203,6202,50246,616
118,5,199,421,126,7168,73
1014,116,1008,121,899,14184,109
597,1,53,261,13,3063,40
820,11,177,167,105,2670,72
273,57,978,395,753,14780,225
914,397,9498,151,6873,39042,2625
509,7,116,327,69,6237,47
965,119,2106,139,1871,11931,235
635,78,581,229,492,12187,89
677,132,1338,211,1079,14340,259
746,55,501,185,428,8452,73
43,4,73,434,44,4283,29
245,43,314,400,270,24696,44
553,13,228,291,182,7290,46
652,1257,47270,221,41690,233003,5580
70,7,106,429,65,5833,41
967,93,2361,138,2047,28391,314
895,214,4165,154,3096,27340,1069
377,203,1788,372,1445,26435,343
961,19,187,140,166,3933,21
306,82,2227,386,1412,34767,815
919,5,219,148,79,4039,140
818,298,6391,168,4908,29755,1483
615,140,1391,241,1090,18092,301
683,327,3954,206,3178,30364,776
120,8,325,421,249,6994,76
506,64,1614,328,923,28186,691
358,14,180,375,157,11221,23
1043,29,224,105,214,6669,10
861,28,596,159,523,10043,73
302,38,778,387,609,20095,169
775,47,699,179,611,9442,88
304,89,1486,386,1105,38620,381
158,4,116,415,88,7154,28
494,49,483,334,430,21534,53
205,4,60,408,31,3003,29
379,1,116,372,47,3182,69
950,47,966,142,784,8666,182
454,302,4786,349,3830,61924,956
850,197,4435,161,3173,33415,1262
400,128,3674,368,2931,53499,743
651,205,4988,221,4193,28098,795
725,164,2007,191,1807,21045,200
896,15,265,154,224,4077,41
341,11,218,380,112,6879,106
79,8,174,427,88,6234,86
858,50,1182,159,897,21526,285
383,32,1229,371,673,13000,556
567,46,374,279,318,6130,56
251,8,165,400,104,5711,61
117,4,232,421,115,6900,117
451,108,1518,350,1339,26587,179
234,118,1426,403,1262,34365,164
1008,186,4587,122,4291,28503,296
286,166,3078,390,2445,29476,633
230,42,1857,404,1112,19094,745
33,7,202,435,110,7314,92
634,201,2263,230,1940,20207,323
525,584,7539,312,6295,85478,1244
280,10,207,392,122,7433,85
1026,111,2179,113,1919,20700,260
472,10,192,343,141,8170,51
645,349,5755,225,4101,65778,1654
966,21,198,139,144,6753,54
596,26,244,261,202,4296,42
539,4,300,299,118,8350,182
267,54,471,396,394,16717,77
702,26,294,199,257,8934,37
855,258,6422,160,5403,34786,1019
291,50,763,388,577,35581,186
281,1,35,391,17,2964,18
169,1432,38600,413,26624,217965,11976
1027,33,292,113,226,4553,66
62,3,87,430,30,5314,57
367,6,121,374,60,4081,61
833,16,175,160,154,7886,21
708,185,4349,196,3847,43745,502
246,53,712,400,589,26294,123
134,37,1865,419,1035,26419,830
412,449,8766,365,6291,54123,2475
589,199,2567,264,2296,28270,271
116,5375,190654,421,102799,1016250,87855
334,16,787,382,283,7813,504
452,3,74,350,35,3353,39
879,10,149,157,144,9173,5
463,5,58,347,50,4148,8
997,59,644,126,631,14010,13
853,286,5335,161,4186,33384,1149
688,233,2987,203,2248,31878,739
643,274,3313,227,2969,46602,344
664,83,1188,216,970,10592,218
814,703,36135,169,24895,107965,11240
639,33,449,228,408,11618,41
1003,92,1200,124,929,7052,271
706,252,3024,198,2657,26030,367
21,17,440,436,255,14144,185
501,4,100,331,55,3403,45
389,90,1409,370,1041,23520,368
325,32,836,382,739,15715,97
154,0,21,416,14,2890,7
872,106,1233,156,1080,19278,153
993,49,384,128,323,7515,61
66,4,129,430,81,11034,48
886,133,2020,156,1763,18501,257
660,35,451,219,354,13284,97
945,68,661,143,605,9065,56
455,312,4323,348,2766,39706,1557
915,4,44,151,21,2071,23
540,37,985,297,707,14331,278
13,35,857,438,467,12146,390
807,2,76,172,40,2880,36
694,54,504,202,476,11560,28
71,60,5049,429,2765,26786,2284
46,10,287,433,135,7844,152
913,80,757,151,673,10332,84
254,18,471,399,245,6038,226
236,1,63,403,28,3316,35
933,11,183,145,168,5129,15
625,20,204,234,170,12548,34
874,142,1677,158,1626,12584,51
85,35,572,426,333,13748,239
995,155,2809,127,2006,14842,803
586,241,3344,266,2929,36698,415
721,149,1756,190,1683,18737,73
779,4,26,178,24,1701,2
445,386,7194,355,5410,55034,1784
630,111,1279,231,860,27692,419
939,498,13534,144,11280,80420,2254
963,125,2636,139,2095,20856,541
384,38,1199,371,781,14937,418
755,41,491,184,425,12840,66
656,157,1678,219,1387,23997,291
52,12,317,432,152,7498,165
789,38,501,176,412,7758,89
556,247,2249,289,1892,34566,357
92,15,338,425,213,7816,125
809,2,41,171,41,2863,0
292,880,13117,388,10924,92662,2193
365,5,114,374,74,3979,40
312,7,441,376,121,5486,320
605,1396,63192,249,50871,272842,12321
1007,13,181,122,130,11913,51
609,27,216,245,190,6896,26
419,2,55,363,38,2488,17
97,7,230,424,136,5411,94
798,30,574,173,418,9076,156
210,4,46,407,36,5272,10
108,11,399,422,171,7776,228
22,0,231,436,123,5517,108
680,34,276,207,251,10036,25
30,258,11197,436,6593,95689,4604
73,1,71,428,42,8198,29
804,170,3150,172,2439,15568,711
187,2,44,410,38,7491,6
740,2,27,185,23,1695,4
810,25,566,170,316,5508,250
767,34,552,181,512,9653,40
715,4,51,194,47,3117,4
1023,22,188,115,156,3678,32
618,65,1278,239,1107,19421,171
714,246,3724,194,3076,31208,648
956,234,6531,141,5215,59185,1316
512,12,485,322,178,10485,307
326,841,12521,382,11274,106984,1247
287,218,2213,390,1853,23011,360
835,7,87,164,84,3375,3
700,3,26,199,24,2253,2
679,291,3421,209,3012,40700,409
499,6,473,332,251,7242,222
300,85,5309,387,3587,42837,1722
570,22,183,278,147,7969,36
768,165,1821,181,1396,20144,425
800,32,380,173,301,8066,79
449,1026,22332,351,17656,116678,4676
846,20,408,162,362,9782,46
1048,43,396,101,372,10306,24
595,243,4622,261,3624,26168,998
920,557,13198,148,10645,71317,2553
473,3,85,343,41,4905,44
354,255,3509,376,2536,30014,973
456,1,40,348,25,1910,15
815,20,343,168,283,5762,60
839,244,3392,164,2605,26757,787
696,5,55,201,47,4006,8
1030,63,678,110,651,6977,27
559,51,427,285,341,9258,86
26,25,636,436,351,9617,285
126,163,1629,420,1223,30264,406