Mod,likes,downloads,time,unique_dl,views,dl_dif
3620,2337,56629,1207,41388,273013,15241
125,691,7183,2286,5183,95096,2000
958,380,11843,2158,7691,67907,4152
1985,711,19368,1881,11173,103889,8195
3380,825,12422,1451,6998,53802,5424
211,45,386,2278,282,63508,104
3638,261,4172,1173,2844,22575,1328
543,130,5267,2237,4452,60921,815
765,133,14996,2201,11590,72660,3406
964,104,2135,2158,1593,28767,542
710,69,1659,2211,1155,19040,504
697,704,16613,2214,10502,61506,6111
3969,872,17735,839,11837,76067,5898
1525,166,3233,2035,2266,21499,967
1341,1024,36487,2087,22909,97879,13578
2809,99,1512,1748,971,24452,541
1215,859,30681,2114,21510,137334,9171
3486,443,6149,1364,4750,37051,1399
3981,1870,19888,831,13809,121924,6079
805,43,1771,2189,1176,24241,595
4344,16,354,231,241,7462,113
1560,57,1295,2028,929,21110,366
1496,24,680,2044,459,11741,221
830,7,206,2183,176,15039,30
4089,13,181,708,109,6400,72
1021,157,4883,2151,3113,50839,1770
442,62,3506,2253,2798,34290,708
4369,1,25,153,21,1352,4
1984,53,2690,1882,1853,40576,837
1842,16,868,1951,619,16684,249
1419,4,244,2059,172,11707,72
1647,34,2172,1999,1418,23971,754
3013,583,12345,1671,8200,70237,4145
2118,86,1700,1824,1331,29333,369
4170,142,2133,581,1573,24069,560
2058,1230,23897,1852,14088,121810,9809
963,205,19688,2158,13663,138218,6025
902,7,456,2167,334,15160,122
116,24,423,2286,299,68227,124
1970,103,3972,1893,2741,43919,1231
1689,87,2313,1987,1450,21595,863
270,1,11,2271,7,111084,4
1022,36,699,2150,485,21887,214
4131,81,946,636,699,10971,247
3696,73,1358,1092,939,13629,419
4020,28,243,783,172,7004,71
3713,85,1766,1073,1158,32321,608
3316,799,30661,1533,21172,229467,9489
759,166,3736,2203,2440,27695,1296
632,24,857,2224,652,51835,205
428,1758,73419,2255,47983,309854,25436
4248,116,2511,450,1876,29587,635
750,3426,133009,2204,77196,550979,55813
3912,175,5240,889,4593,69383,647
3572,216,18685,1284,13900,79213,4785
3583,1973,41443,1272,27675,169655,13768
4097,17,428,692,260,11230,168
391,39,518,2258,260,27696,258
4133,373,3889,634,3064,26831,825
2608,39,617,1784,469,15232,148
486,1595,34715,2246,22711,111257,12004
2115,883,22916,1826,14340,86213,8576
1317,1,64,2092,44,15735,20
3536,9,125,1317,107,8504,18
921,16,1200,2163,931,37678,269
2061,12,320,1851,236,15651,84
179,1050,15269,2281,9670,126623,5599
3704,59,1017,1084,698,25124,319
263,10,260,2272,163,139191,97
1569,84,2458,2025,1684,71189,774
1975,27,449,1888,328,14598,121
3683,188,2572,1118,1863,22904,709
4313,10,145,352,83,6251,62
183,221,2868,2281,2462,142610,406
4063,199,2582,730,1555,13865,1027
4025,82,477,756,418,13531,59
1188,71,1504,2120,1205,15313,299
284,24,668,2270,432,105420,236
989,90,1924,2156,1186,24213,738
1566,420,14727,2025,9466,52427,5261
410,582,7387,2257,4649,200765,2738
4217,9,427,500,275,14702,152
1242,185,6641,2108,4868,47837,1773
322,22,400,2266,243,39920,157
3280,23,731,1565,464,10481,267
370,284,2985,2261,2283,60603,702
4026,15,176,754,121,8312,55
1655,21,1494,1996,1115,19493,379
1818,43,1301,1960,959,23817,342
4157,88,1975,599,1448,21622,527
2070,17,380,1848,259,10929,121
1104,84,2156,2137,1655,22103,501
1744,26,647,1976,450,14816,197
1779,14,405,1970,284,11479,121
2636,1986,42015,1782,24154,246603,17861
4159,108,1556,595,1216,23381,340
737,93,1502,2206,1052,44812,450
3655,632,10257,1151,7560,98610,2697
1604,7,517,2016,308,55483,209
1633,66,2015,2003,1550,42035,465
3573,42,619,1283,458,20051,161
215,683,7298,2278,4875,367114,2423
2914,26,992,1716,703,27174,289
4115,92,1025,655,724,13335,301
903,296,9386,2167,6522,73917,2864
955,296,7501,2159,5116,77339,2385
485,205,6343,2246,5296,28949,1047
4331,150,6776,264,5215,29471,1561
781,1251,26264,2195,14167,115172,12097
904,1360,41727,2167,26464,106529,15263
503,27,865,2244,681,28126,184
1642,27,2020,2000,1399,21619,621
1830,478,18380,1957,11686,141305,6694
1015,80,4790,2152,3256,48649,1534
164,183,1982,2283,1575,74829,407
1214,298,6871,2114,4802,71339,2069
534,65,2059,2239,1500,30660,559
889,154,4441,2168,3068,76424,1373
507,171,5714,2243,3995,45737,1719
2571,473,7069,1788,4367,35837,2702
3862,35,295,915,217,6437,78
4278,5,51,387,36,3667,15
1422,74,5836,2059,3895,56004,1941
1833,131,3695,1956,2435,19886,1260
2106,213,10830,1831,6264,93962,4566
1225,11,293,2112,231,31112,62
949,86,1719,2160,1214,16823,505
1973,875,35779,1891,23819,217447,11960
1997,191,6224,1878,4062,49070,2162
4153,73,664,600,579,12168,85
314,2299,47101,2266,34118,426624,12983
907,107,5027,2166,3610,46743,1417
402,104,2316,2258,1546,39609,770
4210,48,509,507,358,15364,151
493,29,1931,2245,1568,37736,363
591,197,4799,2230,3640,35602,1159
3906,763,13681,891,10164,118411,3517
1753,61,1614,1974,1099,41843,515
278,38,560,2271,302,23281,258
1075,138,2638,2142,1721,72650,917
1906,175,4825,1926,3397,34707,1428
1925,4,327,1917,212,9354,115
677,54,2705,2218,1933,42512,772
704,22,640,2212,472,22824,168
3329,123,2710,1511,2040,53297,670
283,3,61,2270,24,13419,37
2027,7,223,1869,170,15755,53
4318,10,124,306,109,5163,15
1372,14,602,2076,420,17979,182
143,4,29,2285,21,17835,8
544,15,778,2237,580,30280,198
848,78,8397,2178,5577,76316,2820
2038,16,729,1867,476,20116,253
641,22,590,2223,420,12847,170
3803,1538,23347,975,17052,172600,6295
1332,38,998,2089,707,18249,291
3797,132,1686,981,1339,34744,347
666,636,29843,2220,22416,196101,7427
343,61,761,2263,496,25355,265
3295,3570,159095,1556,114047,798831,45048
3359,235,5717,1478,4367,61503,1350
3410,82,926,1426,692,13842,234
751,11,599,2204,448,21823,151
1639,8,172,2001,113,10934,59
799,15,821,2190,655,40315,166
686,19069,716523,2217,457496,3875501,259027
1893,22,867,1934,642,24457,225
224,7,69,2277,51,6158,18
1032,44,1857,2149,1387,34348,470
355,439,7828,2262,4777,79080,3051
1947,17,318,1906,196,18869,122
2041,197,7423,1866,4805,42395,2618
1573,21,1030,2024,723,18742,307
57,21,310,2289,211,59654,99
3287,172,3726,1562,2405,50904,1321
1172,126,3010,2125,1966,22108,1044
2053,160,3012,1855,1782,35601,1230
661,462,10538,2221,7894,113248,2644
1792,125,3045,1965,1965,37194,1080
1361,2582,48558,2081,31798,146322,16760
786,114,3734,2193,2528,56106,1206
1828,128,4161,1957,2959,73738,1202
2078,554,10491,1843,6531,88815,3960
2016,5,293,1873,201,15424,92
4206,138,2208,520,1680,24793,528
3628,32,522,1191,356,11152,166
1086,132,4720,2140,3478,46064,1242
119,308,5404,2286,3435,142071,1969
3741,176,1568,1026,1226,23720,342
3477,135,1851,1375,1472,18630,379
663,20,1085,2221,864,18817,221
1570,52,2840,2025,1748,58276,1092
4351,21,412,208,339,7959,73
331,176,2160,2265,1245,71968,915
3425,282,3170,1417,2128,39797,1042
3584,26,491,1272,397,17473,94
1227,105,3833,2111,2618,72126,1215
943,22,901,2160,549,23717,352
3810,45,854,959,683,10504,171
114,302,6163,2286,3404,92785,2759
1038,60,1999,2148,1409,18440,590
3883,46,1188,899,786,44495,402
122,2136,37753,2286,28704,445598,9049
2824,4,204,1746,151,11676,53
288,19,314,2270,220,21742,94
3427,124,1963,1416,1423,29768,540
298,418,4483,2268,3728,182945,755
4182,373,5975,566,4568,25138,1407
439,116,4194,2254,3223,50209,971
761,17,532,2202,417,14199,115
828,122,8101,2183,6368,76943,1733
3761,23,308,1019,236,9196,72
1253,258,22768,2105,16306,88098,6462
1031,64,1791,2149,1240,24913,551
3858,165,1922,917,1205,20129,717
434,37,3218,2254,2580,69043,638
1815,59,2893,1961,1938,61675,955
282,43,599,2271,362,33284,237
2036,40,1013,1867,780,13638,233
1058,1542,61903,2145,42148,441853,19755
613,168,6512,2227,4703,89630,1809
1435,4991,173476,2056,107059,346856,66417
356,32,322,2262,242,52203,80
1856,44,1052,1944,749,16953,303
3482,25,560,1369,405,29108,155
1424,11,1191,2059,889,20342,302
1146,64,3104,2128,2163,30009,941
4028,65,1289,753,938,23431,351
692,94,3125,2216,2407,67730,718
1045,162,7506,2147,5212,44998,2294
1034,48,1971,2148,1321,44704,650
3844,12,139,929,106,8008,33
4143,243,2690,618,2185,49480,505
39,13,119,2291,79,37491,40
3653,1594,41819,1153,29929,241566,11890
394,289,3801,2258,2977,150202,824
3743,7,124,1025,82,5342,42
438,28,1277,2254,927,34535,350
3529,80,1703,1323,1342,19833,361
2091,398,19293,1837,11487,120006,7806
4346,38,399,227,336,7112,63
496,113,4101,2244,3338,99773,763
3804,929,13073,974,9801,67442,3272
3348,329,7350,1490,5385,138870,1965
1365,200,8131,2078,5769,131337,2362
1216,42,2053,2114,1414,19548,639
100,29,258,2287,175,55650,83
128,30,714,2286,447,32261,267
952,422,7829,2159,5491,89831,2338
348,314,4377,2262,2947,64553,1430
361,134,3902,2261,2528,70825,1374
782,5,394,2195,303,22955,91
1613,289,8473,2013,5764,36175,2709
1182,4,211,2122,172,12484,39
939,2081,45134,2161,34760,140605,10374
431,5,349,2255,272,13965,77
488,7,721,2246,618,25086,103
34,92,532,2291,348,132923,184
690,128,8388,2216,6301,81223,2087
4062,22,208,730,158,9832,50
3384,522,7001,1448,4967,72226,2034
1102,166,5725,2137,3910,51314,1815
791,104,4405,2192,3159,49834,1246
3822,16,515,949,330,14452,185
421,43,2286,2255,1634,36726,652
1358,27,354,2082,251,12789,103
222,253,2233,2277,1805,173099,428
3658,39,576,1145,492,15489,84
208,47,340,2278,229,27690,111
160,1,65,2284,38,27581,27
88,27,549,2288,356,70346,193
960,111,4684,2158,3440,30640,1244
3659,21,420,1142,315,18754,105
4312,17,123,353,84,10402,39
4247,142,1807,451,1244,13275,563
2110,385,6601,1830,5183,60695,1418
3881,59,992,903,754,22600,238
45,28,565,2291,293,84060,272
4264,12,255,415,165,7362,90
1544,376,6336,2033,4444,25917,1892
351,250,3794,2262,3083,179142,711
2138,213,5331,1814,3326,39047,2005
4111,41,260,659,182,5257,78
4165,61,690,582,542,13869,148
728,517,10823,2210,6817,83842,4006
3670,26,420,1131,314,7756,106
191,16,182,2280,134,34343,48
1898,16,779,1928,492,24950,287
920,1316,39399,2163,24627,231381,14772
1371,24,825,2076,598,36351,227
555,2824,157794,2235,98725,650170,59069
3759,6,144,1020,80,5829,64
4236,169,1561,477,1105,12938,456
954,211,4240,2159,2945,32335,1295
182,44,732,2281,513,104594,219
510,544,22028,2243,15253,79416,6775
3402,58,1055,1431,776,32942,279
268,157,2111,2272,1404,51684,707
2372,9,401,1802,267,21919,134
260,7,42,2272,28,11325,14
1675,107,3621,1991,2500,45529,1121
1037,17,550,2148,362,14992,188
4322,120,1987,290,1545,23394,442
4360,4,41,180,23,2134,18
3790,861,19005,984,13177,145267,5828
2570,21,409,1788,289,14857,120
1221,60,2116,2113,1475,27790,641
1085,125,9469,2140,6992,64815,2477
1447,236,5516,2054,3760,30010,1756
3807,82,1236,970,924,16685,312
803,109,8211,2189,5758,34797,2453
1018,4254,148175,2151,97008,708812,51167
1134,966,35507,2131,22390,295088,13117
1254,770,44847,2105,30280,137917,14567
1533,2113,79608,2034,51407,432117,28201
1913,276,8659,1923,4955,85848,3704
3372,18,708,1459,492,13946,216
1597,16,931,2017,639,36621,292
1769,116,7013,1972,4643,69094,2370
58,45,471,2289,354,52252,117
371,27,160,2260,106,18722,54
3403,18,270,1428,217,12513,53
4181,174,2619,568,1730,15937,889
1091,11,394,2139,310,11866,84
1848,15,617,1949,455,17315,162
822,406,11423,2185,7510,71888,3913
3393,49,1122,1440,835,11257,287
3598,41,1052,1250,748,12707,304
316,2155,41349,2266,24852,246350,16497
502,10,283,2244,216,17471,67
3044,135,4446,1658,3101,30806,1345
4335,335,4436,239,3058,21904,1378
3773,244,3045,1015,2395,66963,650
3625,67,1787,1192,1161,21651,626
4180,26,354,570,285,14437,69
3818,277,4092,950,2585,49244,1507
3405,623,11083,1428,8079,61576,3004
1246,217,9792,2107,6477,66929,3315
1745,210,5301,1976,3574,42687,1727
332,579,12812,2265,9560,219671,3252
310,31,681,2267,409,48734,272
763,239,9581,2201,6756,60933,2825
3866,33,461,914,381,8339,80
1069,38,1168,2144,908,21718,260
390,108,1834,2258,1274,63725,560
2099,143,2521,1832,1655,33721,866
1470,58,1271,2051,863,12318,408
1169,407,18581,2125,12226,158532,6355
649,409,26315,2223,19352,169165,6963
2101,105,4996,1832,3538,26529,1458
1907,354,11541,1925,8159,109706,3382
783,161,16447,2194,12695,107172,3752
1323,39,726,2091,492,27903,234
3251,67,1694,1574,1125,22265,569
981,39,1755,2157,1368,32709,387
3835,58,795,936,674,14625,121
4341,30,445,236,329,6669,116
480,28,1854,2247,1341,22660,513
1838,1691,36869,1953,20504,130459,16365
1766,147,6036,1973,3809,78766,2227
542,70,4547,2237,3339,88366,1208
1653,32,844,1997,610,16267,234
4088,12,163,710,93,12864,70
1168,176,4129,2126,2854,39256,1275
1735,11,598,1978,455,11974,143
3937,16,261,864,164,8314,97
1859,12,362,1944,247,8261,115
935,822,38445,2162,26867,222197,11578
3613,23,220,1215,186,4939,34
3423,155,1980,1418,1515,24556,465
4205,50,440,521,334,12767,106
3560,802,10753,1295,7634,92081,3119
2521,255,6360,1791,4488,60946,1872
893,172,14749,2168,10978,93212,3771
1118,160,7314,2134,4694,44641,2620
4074,96,823,726,550,6502,273
4297,23,393,384,292,3614,101
1407,184,5948,2062,4011,24935,1937
1465,13,953,2052,648,28036,305
1852,14,468,1947,325,16385,143
181,4804,78313,2281,50250,634981,28063
941,46,1109,2161,817,28682,292
2870,280,7612,1733,4656,73073,2956
3511,665,14827,1335,9820,57595,5007
241,46,584,2274,230,31894,354
276,16,267,2271,186,25589,81
4285,22,385,386,281,5786,104
1173,11,269,2125,221,13009,48
4176,37,276,575,236,7618,40
1206,14,323,2116,244,13350,79
3692,39,654,1097,477,17874,177
899,37,891,2167,740,22053,151
4329,57,790,270,518,7066,272
1478,484,25379,2049,17024,304236,8355
142,3,8,2285,7,14875,1
2672,1315,25859,1779,13047,98905,12812
2030,103,3298,1869,2005,30690,1293
1509,31,1321,2040,966,13002,355
261,17,209,2272,149,16882,60
1056,46,1090,2145,759,11841,331
118,260,2144,2286,1837,169862,307
4242,39,625,470,501,10973,124
1922,58,1798,1919,1232,29701,566
1343,633,19534,2086,13408,118852,6126
561,110,3890,2234,2882,53179,1008
3776,39,554,1012,448,16160,106
3850,13,212,921,122,8147,90
4150,54,723,604,477,12477,246
4117,692,11251,654,7931,84232,3320
3431,207,5394,1415,4069,57643,1325
4279,23,504,386,338,5459,166
4027,402,5741,753,4061,52813,1680
427,34,1357,2255,1045,34490,312
2785,86,2100,1754,1097,18559,1003
956,267,6563,2159,4916,49332,1647
1808,659,16166,1962,10091,88274,6075
31,116,1566,2291,1012,54998,554
132,35,404,2286,284,42139,120
4317,15,208,309,191,6045,17
197,28,354,2279,266,26995,88
1981,380,13901,1885,9828,93120,4073
3647,5,293,1158,190,12328,103
1713,304,7545,1982,4528,39865,3017
580,77,1905,2232,1388,32511,517
483,466,15429,2247,10531,76972,4898
531,71,4331,2239,3238,32111,1093
4108,209,3791,666,2518,41091,1273
877,172,3355,2172,2312,41063,1043
3465,817,12206,1394,8065,114138,4141
1429,313,5870,2058,4346,58113,1524
1247,33,757,2106,572,26382,185
4168,112,1428,581,1063,21593,365
1334,32,1007,2089,745,56125,262
2902,38,895,1722,536,13261,359
1540,149,5363,2033,3771,106427,1592
1251,127,3257,2105,2417,29869,840
1661,50,2154,1995,1482,24261,672
4214,88,860,503,587,11655,273
3799,102,2128,979,1324,24390,804
948,3,133,2160,107,24794,26
2997,880,12822,1683,7785,53696,5037
1939,72,2475,1910,1667,32209,808
3666,19,225,1133,201,5351,24
1392,149,6503,2067,3805,43037,2698
1895,49,3587,1933,2443,49508,1144
673,20,1061,2219,805,14032,256
1278,453,12618,2100,8690,150049,3928
3735,15,211,1040,135,6193,76
4245,482,6861,459,4897,33717,1964
3469,63,1097,1388,778,15202,319
3551,52,768,1304,609,13185,159
1523,124,2452,2037,1805,36680,647
1458,52,2626,2053,1901,39816,725
315,192,4123,2266,2595,135965,1528
1189,65,2187,2119,1485,72415,702
504,46,1372,2244,1053,33065,319
363,19,161,2261,125,25933,36
3420,463,9066,1420,6261,96336,2805
330,11,131,2265,92,25367,39
674,9,598,2219,472,14210,126
4137,85,1217,629,808,15311,409
429,5228,152605,2255,102166,608204,50439
4358,84,761,185,545,10632,216
4158,83,1380,598,944,17973,436
2080,43,1197,1842,729,19479,468
36,119,1113,2291,1006,194483,107
2113,71,5232,1829,3927,26364,1305
1444,3374,156083,2054,93400,571497,62683
4160,49,811,593,512,17230,299
173,0,11,2282,10,17293,1
3345,104,1376,1498,1015,20498,361
657,245,7255,2221,4600,33113,2655
3987,149,1895,829,1255,23744,640
2067,112,1062,1848,723,14466,339
271,103,1618,2271,936,43709,682
760,72,3640,2202,2437,34556,1203
572,21,492,2233,378,13460,114
545,661,45046,2237,32904,292423,12142
2077,316,5031,1844,3880,24161,1151
1080,16,637,2141,503,16157,134
1440,33,684,2055,452,13619,232
1810,85,2747,1962,1827,32237,920
668,54,1238,2220,925,25639,313
3753,40,379,1021,318,8311,61
239,49,578,2274,375,116223,203
2007,4,164,1875,111,12027,53
693,64,3019,2215,2112,73209,907
4301,3,43,384,36,8364,7
1193,62,1264,2118,957,18386,307
2971,5,376,1695,256,18052,120
3983,131,2309,830,1808,42400,501
1635,21,1378,2002,940,16548,438
227,21,228,2275,132,28886,96
1790,246,8865,1966,5698,66109,3167
1367,1625,41124,2077,26967,124684,14157
37,10,146,2291,82,46566,64
742,18,1702,2206,1190,42571,512
971,10618,275040,2158,155470,729005,119570
175,17,109,2282,79,36443,30
66,80,627,2289,435,72845,192
1826,293,15808,1958,10590,119106,5218
3553,506,9013,1303,7282,97433,1731
1418,65,2937,2059,2270,34267,667
366,13,231,2261,158,53078,73
1697,47,1740,1986,1125,28626,615
2139,31,1185,1814,779,27863,406
1510,6,309,2040,212,11303,97
482,10,582,2247,417,20964,165
1940,349,11443,1910,7506,62068,3937
1929,184,5324,1915,3458,48331,1866
2540,0,0,1790,0,24786,0
579,20,381,2232,265,29209,116
232,444,5852,2275,3951,125258,1901
413,134,1926,2256,1282,49175,644
1379,39,1573,2072,1049,32197,524
4161,49,505,592,358,19423,147
662,238,7171,2221,5756,114717,1415
610,17,746,2227,570,26034,176
1179,21,666,2123,449,27388,217
91,1053,22319,2287,15331,356723,6988
1393,35,1843,2067,1280,32467,563
4216,435,8229,491,5548,48513,2681
1060,380,6549,2145,4590,37664,1959
3746,57,713,1024,511,9995,202
372,58,1272,2260,752,25544,520
1347,267,16134,2085,10904,75028,5230
3612,43,987,1215,814,21425,173
4064,42,446,730,301,4654,145
1471,20,834,2051,617,27060,217
3626,440,12062,1192,7013,90730,5049
3327,57,1241,1514,1054,28872,187
1900,437,12178,1928,8643,67580,3535
4377,5,92,128,61,1566,31
1702,24,556,1984,351,17157,205
1563,25,1644,2027,1080,40588,564
1704,63,1454,1984,849,22938,605
727,326,20365,2210,12968,165949,7397
1483,370,16454,2047,12278,100115,4176
4246,34,736,448,487,10953,249
7,62,644,2292,399,78683,245
4119,192,2342,654,1678,33314,664
1273,42,571,2101,436,13875,135
195,7,81,2279,66,32784,15
259,2391,42745,2272,28575,380948,14170
2001,77,3525,1875,2330,40567,1195
168,4,36,2283,29,17578,7
2714,36,740,1772,472,18757,268
3991,144,4466,711,3063,37428,1403
1261,38,1158,2103,730,21978,428
3278,81,1479,1567,1029,36768,450
1599,11,690,2017,446,16101,244
1376,145,5508,2074,4079,54654,1429
1087,31,1047,2140,828,78024,219
766,114,5478,2200,3576,69905,1902
1926,23,1736,1917,1136,20904,600
303,536,6170,2268,3853,165040,2317
604,31,1678,2228,1216,47147,462
4260,91,1246,436,828,16299,418
169,1,12,2283,9,13872,3
3710,528,13127,1076,7923,67306,5204
202,10114,256388,2279,164359,936194,92029
464,7,640,2250,448,26366,192
1863,3,122,1944,68,5795,54
1760,400,20175,1973,14551,60738,5624
3314,733,12852,1533,7735,72710,5117
1255,33,815,2105,593,9702,222
4284,25,391,386,285,4537,106
980,467,18901,2157,13375,62553,5526
812,253,19383,2186,14270,119731,5113
4324,22,251,287,173,7081,78
959,330,6849,2158,4893,58237,1956
1648,135,2807,1999,1769,16644,1038
233,223,3013,2275,2005,95894,1008
647,5899,305188,2223,196547,1227521,108641
1752,193,5037,1974,3279,25195,1758
344,11,77,2263,58,61208,19
931,7,312,2163,213,20111,99
3146,163,2819,1615,1551,24752,1268
577,11271,409406,2232,280178,1514965,129228
4146,160,2193,609,1541,30688,652
880,53,1065,2170,756,29116,309
3411,141,1547,1424,1175,19273,372
2000,41,543,1876,328,10441,215
3656,130,2193,1150,1740,44082,453
186,64,461,2281,354,129528,107
4244,117,2904,465,2155,30803,749
4298,18,392,384,297,4094,95
736,0,756,2207,452,12346,304
1772,31,409,1971,287,13719,122
4129,19,340,638,246,16474,94
2104,77,2202,1831,1472,35578,730
479,293,10913,2248,7958,61165,2955
587,67,3126,2231,2357,108011,769
2107,107,1486,1831,939,20572,547
3636,162,4405,1175,3032,48559,1373
18,151,2607,2292,1672,90957,935
2003,1179,27736,1875,16280,110322,11456
3331,26,454,1508,352,27574,102
2128,48,1258,1818,866,16968,392
328,45,927,2265,546,34080,381
573,1030,20664,2233,13115,96001,7549
130,623,4602,2286,3294,47993,1308
115,37,510,2286,374,80794,136
4370,35,419,145,351,8738,68
722,505,10709,2210,7400,42966,3309
598,1272,37165,2230,23234,184359,13931
764,2045,36875,2201,22610,199743,14265
802,57,4799,2189,3749,45057,1050
532,152,4563,2239,3327,25540,1236
1491,146,5309,2046,3755,82419,1554
3781,674,27680,825,21084,78497,6596
3723,2528,26820,1056,17037,148517,9783
3605,16,316,1234,241,15255,75
944,4,307,2160,215,21687,92
1784,3154,138893,1969,94336,423966,44557
670,83,1478,2220,1029,17831,449
4275,76,1525,400,1295,26614,230
4035,17,215,736,152,11242,63
1714,262,6176,1982,4297,43471,1879
4355,96,1108,203,748,9289,360
669,33,2215,2220,1492,64720,723
2130,18,405,1817,236,16887,169
2125,81,4454,1819,2969,47769,1485
648,813,18818,2223,12320,71863,6498
497,244,7250,2244,5351,63861,1899
3326,50,1097,1515,725,17827,372
644,104,7570,2223,5219,71257,2351
857,93,2320,2176,1779,51294,541
3651,122,1271,1156,1020,18380,251
3352,131,3309,1487,2653,75258,656
1441,41,1700,2055,1172,17302,528
1700,76,1214,1985,874,20047,340
3615,36,1979,1209,1415,27814,564
1428,385,13893,2058,8508,124082,5385
1541,107,2022,2033,1435,17831,587
3719,168,3054,1061,2510,41362,544
368,7,51,2261,34,29924,17
1098,314,8297,2137,4929,51828,3368
1701,184,6774,1984,4350,65973,2424
4187,807,9857,558,7227,49074,2630
2887,72,1253,1727,747,16447,506
3748,325,6879,1024,4858,40691,2021
3783,46,1123,1004,716,24492,407
301,10160,177598,2268,105510,888930,72088
894,213,8232,2168,5611,88519,2621
776,86,6100,2196,4712,61112,1388
3775,59,1049,1013,821,23336,228
909,11,390,2165,322,26040,68
3766,251,3461,1017,2646,23460,815
4252,285,18587,445,13529,43969,5058
2037,242,7091,1867,4565,46147,2526
4080,60,524,720,433,12791,91
535,277,5519,2238,3686,28674,1833
1607,224,9544,2014,6645,40687,2899
1382,230,10933,2070,7449,112144,3484
4258,113,1911,438,1164,10957,747
3742,24,272,1025,177,6616,95
1400,42,4522,2065,3845,17790,677
1870,8,366,1942,265,14529,101
2123,223,7510,1820,5492,45451,2018
1110,10291,276362,2136,134369,780892,141993
1074,118,3783,2142,2707,39323,1076
1473,29,1921,2051,1336,48298,585
235,304,4443,2275,2692,83605,1751
1651,119,2486,1999,1800,31660,686
2018,7,464,1873,315,22712,149
906,245,13433,2167,9050,114723,4383
4266,35,405,413,286,15913,119
1839,3743,124867,1953,72068,426093,52799
1187,241,6756,2120,4575,40784,2181
6,49,777,2292,279,41914,498
1581,302,21742,2022,14343,48028,7399
745,566,13905,2205,9082,60016,4823
928,3742,111585,2163,78625,316807,32960
200,759,7477,2279,5386,236650,2091
375,15,230,2260,157,16500,73
3436,213,6070,1411,3912,64069,2158
1869,28,1125,1942,804,26977,321
3525,35,719,1326,499,35239,220
774,234,8413,2196,5882,74915,2531
585,39,1518,2231,1208,20817,310
4032,14,107,744,90,7054,17
3258,5679,247703,1574,140152,735820,107551
1027,83,2303,2149,1807,50937,496
1244,62,5161,2107,3690,48827,1471
4224,25,344,493,259,11611,85
930,1404,31589,2163,20334,117296,11255
2102,75,2216,1832,1350,29143,866
4295,29,575,385,402,6113,173
1812,41,1210,1961,802,21199,408
1835,167,4364,1955,2699,44652,1665
4152,599,11054,599,7910,64743,3144
3833,46,958,939,690,26970,268
2129,42,1453,1818,1082,20644,371
4304,21,434,384,272,6269,162
1873,48,2116,1941,1303,35092,813
1366,29,787,2077,574,18337,213
1637,11,474,2002,310,16667,164
682,247,12036,2217,8333,59161,3703
929,137,2172,2163,1543,14488,629
769,26,652,2200,521,38386,131
1660,8249,246973,1995,151733,1178358,95240
1692,577,43094,1986,27536,120104,15558
4145,139,1890,610,1352,22141,538
1960,934,32818,1898,21552,267094,11266
602,116,5206,2229,3939,96885,1267
385,8747,123705,2259,82072,567786,41633
891,89,3171,2168,2489,19440,682
28,3095,67510,2291,44380,408457,23130
4290,10,130,386,87,3655,43
1912,146,4198,1924,2857,50809,1341
672,90,2858,2219,1886,34884,972
3764,5,98,1018,54,3456,44
1005,119,6407,2154,4771,57801,1636
441,274,12072,2254,8310,102570,3762
305,72,1114,2267,795,119299,319
3009,789,10732,1672,7083,50603,3649
2031,71,1957,1868,1294,34327,663
1572,34,1555,2025,1114,22647,441
1695,66,1401,1986,1043,12864,358
740,626,30135,2206,20498,203995,9637
2076,21,305,1845,221,12733,84
4241,53,721,470,484,11545,237
192,527,5381,2280,4114,125095,1267
2137,195,9233,1815,6198,56671,3035
1482,33,1055,2047,708,18621,347
1903,10,554,1927,330,12866,224
888,130,3092,2168,2039,50709,1053
2009,515,13827,1874,9749,101042,4078
1413,191,3465,2060,2629,35195,836
274,118,1840,2271,1249,54010,591
1387,325,8608,2068,4685,78206,3923
557,281,6983,2235,5369,35885,1614
204,394,4940,2279,3346,98890,1594
3688,152,2377,1100,1971,80121,406
4211,280,4135,507,2931,34659,1204
1101,10,240,2137,181,8273,59
1438,94,5665,2056,4162,32501,1503
76,41,554,2289,384,19736,170
104,71,680,2287,486,121556,194
3252,754,14329,1574,8987,97233,5342
3144,38,728,1616,479,10741,249
459,173,7835,2252,6301,74965,1534
1777,40,2003,1971,1376,44129,627
2085,462,9371,1840,5995,64255,3376
4200,400,10264,534,7486,41222,2778
601,75,4820,2229,3175,42660,1645
2042,264,7280,1865,4839,62154,2441
3947,141,1088,856,776,7433,312
2759,17,730,1763,486,20347,244
1730,429,9406,1978,5873,51117,3533
1734,4864,107406,1978,66756,531863,40650
1243,38,1622,2107,1234,31784,388
1472,813,18420,2051,13545,85651,4875
1615,937,20831,2012,13693,71018,7138
2928,152,7200,1710,3990,61937,3210
876,104,2026,2172,1377,26325,649
3695,199,1920,1093,1580,49292,340
784,23,738,2193,564,26577,174
1002,52,1828,2154,1315,27855,513
51,5,83,2290,68,19454,15
4311,306,11825,359,8353,45734,3472
1911,154,2471,1924,1647,15069,824
1066,0,12770,2144,9038,95181,3732
184,627,7632,2281,5994,467389,1638
2869,107,4162,1733,2695,44386,1467
1739,21,1234,1977,820,22795,414
3805,23,562,971,380,9563,182
1708,574,19318,1983,12815,125323,6503
3306,503,7507,1540,4825,39169,2682
4327,26,289,274,231,5955,58
1595,168,7479,2017,5357,59064,2122
1712,180,8413,1982,5910,43688,2503
4084,19,181,714,129,6763,52
1249,36,989,2106,692,27815,297
10,19,173,2292,134,12836,39
3401,545,6299,1431,4179,46235,2120
437,6,377,2254,299,28238,78
593,191,4215,2230,3095,35875,1120
1620,64,1873,2009,1343,33712,530
1871,14,513,1942,367,19244,146
3539,73,1229,1316,874,29541,355
3928,137,1427,871,1091,9533,336
1934,274,6582,1914,4570,48998,2012
1841,41,1764,1951,1279,25174,485
1549,2593,44955,2031,24995,204223,19960
3073,21,319,1648,208,13511,111
297,304,3001,2269,2015,49111,986
1033,210,8383,2148,5469,100622,2914
3440,367,7302,1409,5111,39567,2191
1340,4,229,2087,150,11714,79
748,9,281,2205,223,17394,58
24,25,473,2292,249,40108,224
3114,169,2787,1629,1804,21558,983
625,17,604,2225,432,15182,172
1805,34,773,1962,553,10783,220
3667,8,339,1132,244,15897,95
4375,16,259,142,172,8825,87
198,34,711,2279,439,71831,272
582,213,9276,2231,6456,49516,2820
201,481,9772,2279,6469,164302,3303
223,44,674,2277,476,19463,198
2544,7,315,1790,206,9286,109
1124,133,3046,2133,2313,40317,733
628,152,15584,2225,11225,86796,4359
575,21,582,2232,465,22150,117
823,1464,26376,2185,19013,130939,7363
3000,139,2460,1679,1475,23814,985
4166,93,1928,581,1399,20826,529
3780,27,719,1010,479,15022,240
3829,10,213,941,131,8159,82
333,178,2157,2264,1326,73639,831
1160,16,477,2126,360,15009,117
1586,95,7090,2020,5062,69462,2028
3671,520,8872,1130,6491,46757,2381
1564,280,7821,2026,5440,74719,2381
1725,14,805,1981,574,19540,231
193,29,374,2280,272,33704,102
25,81,1286,2292,830,94687,456
4347,29,427,227,320,8270,107
220,3459,62691,2277,43462,390739,19229
3509,200,6847,1338,4899,67396,1948
14,7252,163463,2292,85012,1157622,78451
3399,215,3191,1432,2321,21287,870
753,33,1927,2204,1513,34423,414
1258,12,664,2104,445,15438,219
4207,14,223,516,187,6462,36
188,217,1429,2280,1118,102485,311
937,116,2208,2162,1462,30073,746
3456,420,7157,1402,4958,67268,2199
311,8,274,2267,140,7625,134
1016,0,1029,2151,818,23450,211
345,38,307,2263,226,75121,81
4072,24,344,727,244,18130,100
3678,345,7014,1124,5169,73300,1845
1978,730,20439,1886,13392,191971,7047
4231,16,415,482,232,7920,183
1927,649,20584,1917,13602,109941,6982
3698,257,5017,1090,3392,33754,1625
1723,84,1471,1981,952,22769,519
2105,670,20710,1831,12506,103040,8204
1737,529,18775,1977,12603,70537,6172
1788,12,648,1968,442,14399,206
4359,3,64,184,53,2915,11
4127,359,7229,644,5432,59289,1797
3694,14,197,1096,140,8345,57
912,457,14917,2165,8798,95286,6119
1622,66,2692,2008,1900,24105,792
2012,2,277,1873,190,13057,87
3530,29,361,1323,268,12177,93
3754,541,9115,1022,6869,52787,2246
1057,276,7439,2145,5141,56423,2298
1919,266,5943,1920,4226,41816,1717
1619,768,11388,2009,7194,59027,4194
4154,71,640,600,457,11273,183
1406,633,27393,2063,18504,143365,8889
1982,148,3036,1884,1943,31073,1093
1020,691,40108,2151,27038,108408,13070
2744,131,4845,1767,3101,34745,1744
723,104,9462,2210,6950,56053,2512
3602,17,427,1239,362,14782,65
1956,5,78,1902,51,19152,27
2004,178,6169,1875,4297,52973,1872
1825,1522,46784,1958,27543,194600,19241
3328,888,12900,1514,9230,101902,3670
4272,24,395,407,251,12406,144
885,101,2440,2169,1473,20683,967
1889,121,11876,1935,9007,68479,2869
3806,58,1466,970,1159,22070,307
4208,93,996,514,736,25551,260
41,580,7264,2291,4554,70921,2710
509,90,5427,2243,4339,61977,1088
836,317,17901,2182,13644,136442,4257
4053,560,6951,733,5267,45132,1684
2019,1022,32714,1872,21020,139277,11694
820,65,3113,2185,2270,59175,843
3010,228,4027,1672,2692,21114,1335
1718,203,7375,1982,4549,88992,2826
3381,334,11966,1451,9123,72745,2843
965,90,2584,2158,1832,24777,752
185,99,1024,2281,881,150668,143
746,284,9000,2205,6069,66071,2931
813,42,1084,2186,864,20015,220
43,73,1168,2291,578,53339,590
3232,167,4500,1585,3356,52820,1144
70,50,323,2289,238,50121,85
3495,99,2235,1353,1524,29809,711
1517,223,5846,2039,3744,21518,2102
2048,9,535,1862,379,21284,156
2897,19,475,1724,291,15430,184
895,124,4247,2168,3028,59954,1219
105,11,179,2287,101,43068,78
4031,95,1145,746,806,17222,339
3837,47,987,933,707,13633,280
1886,119,2841,1936,1993,23460,848
3630,49,1356,1187,937,33710,419
412,194,2760,2256,1995,53318,765
2075,48,1591,1846,990,25075,601
4289,18,363,386,205,6855,158
120,352,4408,2286,3340,60393,1068
154,108,1330,2284,1008,35708,322
1061,26,741,2145,575,20044,166
4361,12,175,179,134,8010,41
1043,136,13173,2148,9131,111665,4042
861,1124,215716,2174,157003,410444,58713
302,7,75,2268,51,32812,24
586,158,3870,2231,2640,28781,1230
236,11,86,2274,50,17959,36
1882,826,21256,1938,13247,185622,8009
538,6,338,2238,247,16670,91
1593,22,514,2018,346,7741,168
1748,67,1340,1975,922,17086,418
1610,271,12302,2014,8829,74364,3473
454,250,9770,2252,6856,79711,2914
1724,13,406,1981,285,31160,121
1814,9,224,1961,166,8797,58
1891,118,6269,1934,4223,62688,2046
4374,35,929,143,636,14968,293
1979,14,761,1886,557,27106,204
400,98,1380,2258,903,36643,477
3843,35,518,931,304,16771,214
778,170,5480,2195,3877,29622,1603
2755,92,3208,1764,2038,75129,1170
3801,676,11992,976,8750,63583,3242
1795,1436,47514,1964,32991,199631,14523
1062,46,879,2145,664,16959,215
2851,20,794,1740,507,23545,287
1368,26,948,2077,669,17807,279
1063,222,10407,2144,7101,180916,3306
3012,166,2401,1671,1587,23863,814
4293,29,452,385,325,3472,127
1301,13,273,2095,208,9494,65
1385,214,7729,2069,5341,97825,2388
967,30,1069,2158,810,11050,259
3877,101,2321,903,1461,42735,860
724,75,3346,2210,2420,49184,926
567,314,10285,2233,7577,71352,2708
251,19,161,2273,85,62945,76
1910,338,8521,1924,5535,71157,2986
3506,914,18710,1341,13753,147529,4957
1008,460,13566,2153,8465,98604,5101
3879,23,298,903,248,13504,50
1690,229,8790,1987,5847,71247,2943
230,13,59,2275,52,57111,7
3778,12,243,967,205,15950,38
3931,225,5524,871,3740,41115,1784
525,1047,25721,2240,17190,210544,8531
2554,15,826,1790,560,27704,266
3072,25,745,1649,502,18001,243
1707,49,1382,1983,866,34577,516
1684,230,15390,1988,10287,63153,5103
3587,55,1294,1260,1030,29150,264
1538,189,6145,2034,3857,42336,2288
3765,7,175,1017,85,6594,90
1840,359,7632,1952,5545,31476,2087
3812,37,915,959,645,14793,270
352,45,414,2262,291,24161,123
19,345,5925,2292,4468,187879,1457
1092,27,1317,2139,895,33240,422
253,29,195,2273,142,20287,53
267,60,549,2272,394,20728,155
1095,362,39609,2138,27067,200444,12542
4300,3,31,384,27,4805,4
1369,268,10946,2076,6677,51123,4269
291,63,691,2270,509,67437,182
3709,269,4021,1077,2875,41129,1146
1711,43,1780,1982,1205,18292,575
3701,178,2447,1085,1784,39137,663
1860,7,354,1944,243,7533,111
2919,286,7284,1715,4961,64809,2323
3046,387,7304,1657,4244,33841,3060
1726,73,3333,1980,2165,30132,1168
3526,117,2483,1326,1624,41523,859
3462,166,2269,1396,1735,14313,534
1608,17,999,2014,764,23789,235
134,1,6,2285,6,11162,0
1640,504,24494,2001,19465,125652,5029
1355,113,6320,2083,4439,55141,1881
194,68,547,2280,408,22633,139
196,1,6,2279,5,17442,1
1991,81,1545,1880,1130,28813,415
3210,1135,16530,1593,10987,131915,5543
3233,38,660,1585,436,26076,224
879,21,416,2171,324,36752,92
463,577,42355,2250,33106,189794,9249
2787,56,1371,1754,878,15656,493
3227,34,990,1588,700,44698,290
1589,364,6289,2019,4141,77394,2148
853,1262,56966,2178,37895,128126,19071
4286,0,14,386,9,1989,5
4093,23,291,703,222,15648,69
688,42,928,2216,665,19657,263
1156,143,18452,2127,13301,70274,5151
643,807,24880,2223,15685,100654,9195
248,1045,13002,2273,9356,175839,3646
1289,3,140,2097,98,7167,42
2092,185,8304,1837,4978,99623,3326
1003,43,1295,2154,934,23451,361
706,1718,43571,2212,28868,196236,14703
1218,541,19116,2114,12391,126432,6725
501,12,471,2244,336,17536,135
1445,166,7325,2054,5077,72707,2248
2052,335,16215,1855,11700,82346,4515
4008,17,228,814,163,18643,65
2081,133,3951,1842,2539,33498,1412
4003,97,1276,818,894,10358,382
2706,280,13328,1772,6793,134443,6535
660,515,12721,2221,8459,69383,4262
2013,2,337,1873,228,13639,109
873,973,53222,2172,37665,129054,15557
455,25,1207,2252,897,32560,310
3255,663,17763,1574,10875,96855,6888
4277,48,764,387,645,12411,119
4376,48,760,127,626,14204,134
3313,0,0,1535,0,7466,0
694,57,1365,2215,1025,22684,340
3452,23,567,1404,473,25083,94
46,48,597,2291,390,114631,207
1113,964,52238,2135,36572,327964,15666
2577,1210,41838,1787,27645,118383,14193
3707,103,1907,1082,1568,39842,339
2093,138,5460,1835,3430,67786,2030
874,1582,61552,2172,43109,275554,18443
85,5,43,2288,31,22759,12
721,269,10606,2211,8172,85760,2434
4016,105,1485,787,1016,22218,469
3763,201,2785,1019,2248,22124,537
384,25,354,2259,236,16517,118
827,485,15315,2183,11849,103172,3466
789,28,1278,2192,953,40293,325
2172,104,5327,1810,3445,50742,1882
4228,92,1755,486,1099,19428,656
3749,13,283,1023,173,6939,110
3725,340,4751,1055,3633,71347,1118
2060,326,7899,1851,5232,48179,2667
4162,7,129,590,111,3909,18
1857,33,612,1944,396,10626,216
419,378,8887,2256,6123,66870,2764
97,175,3798,2287,2197,188322,1601
1853,34,1038,1946,639,21042,399
205,223,3630,2278,1774,92217,1856
3304,358,10294,1543,7062,110141,3232
2861,353,9212,1735,5479,74337,3733
30,61,814,2291,531,47860,283
3689,71,768,1099,566,16002,202
837,36,846,2181,644,14473,202
3627,19,240,1191,176,7327,64
1775,83,2032,1971,1430,22085,602
2059,74,2007,1852,1344,12759,663
2741,114,4288,1767,2650,40278,1638
2121,1441,50753,1822,33542,249761,17211
1698,171,4286,1985,2456,59215,1830
1284,138,3449,2098,2576,18361,873
1989,83,3446,1880,2175,35585,1271
767,1493,36342,2200,22973,131491,13369
3556,56,751,1301,635,33043,116
1267,21,1067,2102,801,18713,266
245,28,477,2273,313,13004,164
326,31,407,2265,270,17106,137
1584,185,6244,2020,4368,42610,1876
1408,23,1052,2062,737,27433,315
1199,77,2114,2117,1449,48623,665
499,11,1207,2244,935,24641,272
896,240,10777,2168,6962,92118,3815
4151,171,3117,603,2126,52446,991
3788,92,1212,997,871,23897,341
3094,6,233,1639,106,11441,127
1751,20,774,1975,540,31025,234
449,93,6488,2252,5119,158767,1369
1571,117,3748,2025,2641,53865,1107
1359,204,5456,2082,3826,58855,1630
1004,102,3816,2154,2675,44607,1141
1942,36,1527,1908,926,25040,601
4140,19,166,621,119,12306,47
1948,51,2385,1906,1734,29874,651
2050,372,9378,1859,6603,62245,2775
1780,1969,51641,1970,33146,148138,18495
3641,15,412,1167,289,17254,123
1954,64,2286,1904,1634,52521,652
1559,13,1031,2028,699,15211,332
1294,102,3220,2096,2155,57403,1065
1821,5,390,1959,240,14085,150
815,817,27718,2186,19329,146412,8389
3897,1232,17892,895,13286,97427,4606
3942,612,11744,860,8925,99117,2819
1643,30,2039,2000,1403,20044,636
4291,18,415,385,301,3384,114
2066,38,1662,1849,1030,20223,632
3734,90,1996,1042,1446,24904,550
4019,12,263,783,162,6052,101
2852,56,1488,1739,1012,36580,476
379,312,5198,2259,3959,125690,1239
651,974,27070,2222,17200,105590,9870
1122,571,15408,2134,10271,172542,5137
126,470,26705,2286,20059,276228,6646
3541,442,4406,1316,3101,38576,1305
3432,513,6473,1415,4737,25833,1736
968,40,1592,2158,1202,15318,390
1894,132,5141,1933,3831,58112,1310
2998,278,7167,1681,4731,43034,2436
4192,17,276,551,179,12683,97
1761,127,3794,1973,2713,34427,1081
4306,31,418,377,356,10717,62
4305,3,70,307,54,3866,16
4017,63,625,785,487,9411,138
1304,137,5095,2095,3124,49504,1971
712,2351,158096,2211,107712,574096,50384
4366,3,59,160,50,2443,9
60,6,26,2289,17,26464,9
1618,17,292,2010,169,13206,123
3474,14,233,1382,176,11542,57
3846,152,3720,927,2178,46903,1542
319,9,195,2266,134,49157,61
1010,13,639,2153,477,16849,162
2871,70,2990,1733,1612,39203,1378
2641,27,735,1782,456,13456,279
826,1936,35087,2184,24244,122948,10843
1498,14,617,2043,450,23664,167
3276,11,248,1568,143,8278,105
4239,51,705,473,579,13027,126
2563,65,1726,1789,1109,19771,617
1322,58,2741,2091,1995,65259,746
3731,81,1583,1050,1300,23268,283
1386,235,10194,2069,6651,95953,3543
4273,4,151,403,105,3561,46
1219,66,2011,2114,1433,74030,578
933,236,6004,2162,4081,50252,1923
246,9,89,2273,50,17797,39
1976,97,2401,1888,1627,17014,774
3023,7,447,1668,280,23928,167
4144,51,2575,613,1587,21066,988
3691,60,924,1098,644,16491,280
1670,50,2835,1993,1999,30063,836
4149,43,308,604,207,16699,101
924,218,5793,2163,3763,52367,2030
650,644,46254,2223,27536,266284,18718
726,56,1406,2210,1090,19139,316
2153,44,629,1812,393,15754,236
762,604,19707,2202,12485,94164,7222
3112,244,10876,1630,7208,90150,3668
1494,245,11930,2045,7733,128663,4197
2855,84,3917,1738,2277,36206,1640
4212,15,250,506,175,15710,75
4226,383,4817,487,4014,25668,803
1905,90,2945,1926,2157,33709,788
3739,6,98,1026,58,4080,40
3873,0,281,905,239,11291,42
842,213,15543,2180,10884,106493,4659
2094,76,5485,1835,3344,34692,2141
1877,39,1645,1940,1074,23149,571
102,29,611,2287,429,78009,182
1107,88,1762,2137,1284,26165,478
1380,152,14198,2072,9780,92010,4418
2120,298,6937,1823,4807,57448,2130
1410,399,20526,2061,14352,111068,6174
785,30,1059,2193,788,53184,271
4141,162,1599,621,1335,30330,264
4220,269,4493,498,3689,49865,804
63,109,1154,2289,812,85509,342
3386,160,3967,1445,2846,57451,1121
1858,9,377,1944,264,10667,113
68,95,664,2289,488,100560,176
3504,397,6207,1343,4701,40084,1506
4122,49,429,649,287,16744,142
4302,23,480,384,312,5383,168
1112,1414,34788,2136,20836,236031,13952
829,797,37452,2183,26249,221803,11203
3510,11,283,1337,188,12146,95
242,9,126,2274,93,20957,33
1293,17,243,2096,178,9948,65
309,51,610,2267,375,15620,235
1141,16,694,2130,451,26157,243
3745,10,160,1025,96,5025,64
536,24,817,2238,702,20243,115
1192,79,6661,2119,4493,71976,2168
1320,363,8926,2092,6180,49068,2746
1654,439,18505,1996,12035,133651,6470
2973,6,164,1695,110,14390,54
787,133,4878,2192,3472,55125,1406
3321,64,2396,1530,1642,46885,754
4066,63,763,730,499,5837,264
3644,6,143,1164,115,10858,28
2206,156,2848,1808,1890,20526,958
1693,82,4603,1986,3217,55267,1386
1959,47,1399,1902,996,21547,403
4384,29,419,94,316,4786,103
817,77,2084,2186,1571,41314,513
2981,1348,28657,1691,20943,99466,7714
3256,855,21944,1574,12912,113198,9032
47,44,428,2290,316,68174,112
1420,2657,45970,2059,27610,249897,18360
3542,120,2663,1313,1914,42241,749
286,7796,148997,2270,72247,1043100,76750
1709,64,2103,1983,1589,30896,514
1937,20,519,1912,334,23776,185
2096,34,770,1834,526,13466,244
290,311,3930,2270,3013,68410,917
3794,166,4086,982,2806,41023,1280
1414,431,14353,2060,9028,73806,5325
1009,112,9138,2153,6421,98181,2717
3356,85,1406,1482,1200,33464,206
4121,163,1922,650,1473,31131,449
3649,151,3319,1156,2387,49503,932
1370,352,15768,2076,10416,129290,5352
524,13,1044,2240,762,24698,282
380,19,158,2259,115,67554,43
121,25,322,2286,216,26284,106
606,322,15669,2227,10876,75180,4793
576,17,1227,2232,900,22638,327
1178,115,1445,2123,1031,18371,414
470,487,9126,2249,6269,55815,2857
23,3614,58189,2292,38288,346711,19901
3257,408,8455,1574,5760,56718,2695
1266,109,7214,2102,5062,76399,2152
1232,4,208,2110,152,11523,56
2193,13,259,1809,185,18776,74
4261,25,748,426,482,12570,266
2341,50,4054,1803,3006,45036,1048
2132,24,458,1817,291,15725,167
75,248,2972,2289,2072,84032,900
1558,199,7268,2028,5351,121720,1917
3673,120,2158,1127,1630,38530,528
1396,67,1818,2066,1270,46338,548
701,239,3920,2212,2596,40414,1324
735,949,24387,2207,16098,134616,8289
252,5,94,2273,41,9328,53
1330,260,17582,2089,11872,69630,5710
1084,15,292,2140,195,10409,97
1390,3990,119712,2067,75956,426565,43756
3623,44,522,1192,377,11790,145
3481,178,2752,1370,1866,19241,886
600,316,14052,2229,9589,100081,4463
4178,231,2674,571,2110,17141,564
4015,52,951,769,657,17659,294
2098,106,7875,1832,4599,51513,3276
940,167,5259,2161,3590,39546,1669
831,510,26733,2183,19469,156030,7264
530,16,1056,2239,822,31019,234
150,2,28,2285,19,25633,9
581,508,18041,2231,12402,74094,5639
3681,121,1885,1119,1258,13302,627
1280,307,6009,2099,4505,50050,1504
4009,126,2074,812,1431,32604,643
1064,94,9302,2144,6731,74249,2571
1143,46,1423,2129,1024,32638,399
2963,5,111,1698,77,17237,34
865,1377,28275,2174,17424,87203,10851
840,1897,32872,2181,19029,119102,13843
1241,312,10734,2108,7410,67355,3324
1348,37,711,2085,515,20144,196
1629,62,2477,2005,1678,75722,799
922,101,2678,2163,2008,52085,670
2065,58,1452,1849,999,22141,453
851,4568,177104,2178,97965,755566,79139
2116,8,238,1826,150,14869,88
4196,78,1009,545,804,40511,205
2108,12,322,1831,215,17022,107
617,20,1082,2226,861,29130,221
2141,67,2089,1813,1303,19203,786
1353,149,2323,2084,1660,26681,663
4085,0,417,714,338,8463,79
1580,273,8142,2022,5826,66971,2316
3007,86,1286,1674,737,25518,549
226,90,1024,2276,570,36925,454
3792,238,3430,983,2603,58890,827
279,4,57,2271,38,26064,19
471,4,559,2249,401,27678,158
797,531,27663,2190,18373,161838,9290
295,195,2620,2269,1910,45522,710
1300,9,253,2095,171,8431,82
596,125,7940,2230,5704,100733,2236
2920,23,842,1715,623,22323,219
1504,1617,34748,2041,23066,299746,11682
180,12,152,2281,101,11726,51
2922,29,1660,1714,1074,19515,586
1200,73,1385,2117,1043,17998,342
2033,704,29055,1868,21248,66669,7807
4081,18,211,719,126,5488,85
111,1,41,2286,9,46684,32
157,1829,22165,2284,15434,205966,6731
1226,109,4944,2111,3557,71539,1387
2014,5,288,1873,188,13026,100
1170,137,11661,2125,7831,63902,3830
262,74,1159,2272,763,35587,396
1256,69,7177,2104,5297,44022,1880
256,609,7498,2273,4538,81149,2960
4307,43,540,376,366,7294,174
3808,13,289,967,188,15793,101
3924,788,11686,872,8348,54027,3338
4343,24,776,231,508,14640,268
3135,1795,48108,1620,29673,319492,18435
4090,10,102,707,83,3712,19
1313,345,13195,2093,8260,98390,4935
2020,86,3354,1872,2170,38099,1184
1676,83,1448,1991,981,27535,467
1126,333,15195,2133,10678,143822,4517
231,839,12165,2275,7996,262313,4169
1899,21,813,1928,517,11147,296
1324,795,30707,2091,20532,133171,10175
318,12,65,2266,51,34870,14
832,247,8487,2183,6204,120519,2283
908,44,2075,2166,1452,31018,623
269,114,1139,2272,853,48623,286
1053,335,10635,2146,7602,53218,3033
3303,25,609,1546,441,21809,168
2071,78,2032,1847,1213,28492,819
1373,83,5726,2076,3762,47316,1964
1685,39,1475,1987,968,20702,507
1999,35,1291,1876,915,30180,376
69,4324,57266,2289,38730,500958,18536
433,265,6808,2254,4638,35862,2170
4024,49,328,761,238,7279,90
281,104,1273,2271,949,54485,324
3755,13,315,1022,185,9956,130
3263,805,31050,1573,21034,166682,10016
550,133,3876,2236,2828,45599,1048
3622,9,280,1196,215,8302,65
3772,7,114,1015,68,5733,46
1720,7,119,1982,89,9192,30
3779,16,154,1011,138,7349,16
707,175,3617,2211,2694,36320,923
2022,349,10068,1872,6394,76677,3674
1849,49,1292,1949,924,23083,368
1923,135,3409,1917,2019,20205,1390
1298,1358,53559,2095,37217,223297,16342
1879,32,765,1940,531,25786,234
1611,1473,24725,2014,15686,214289,9039
4215,295,3213,502,2164,41368,1049
42,29,239,2291,171,31866,68
1904,4,132,1926,90,13990,42
3137,19,381,1620,253,11127,128
1281,460,13904,2099,9423,69097,4481
1876,2055,89975,1940,51730,438264,38245
2790,119,1724,1753,1139,20024,585
611,742,27138,2227,17725,124397,9413
1464,492,12674,2052,8748,135290,3926
1888,53,1741,1935,1211,33878,530
3996,163,5841,822,4852,60905,989
574,384,23863,2233,17669,141735,6194
619,10,284,2226,216,15275,68
3682,290,4384,1119,3396,48805,988
1067,431,12945,2144,9086,51464,3859
3337,128,2524,1505,1793,21921,731
462,225,17777,2251,12941,117207,4836
478,9,224,2248,180,13396,44
4372,81,1737,144,1569,22915,168
3435,243,6319,1413,4967,47427,1352
3973,452,8372,835,6892,53488,1480
1552,15,444,2030,323,19258,121
3120,41,1501,1627,879,27015,622
806,61,1464,2189,999,34384,465
4362,23,484,173,356,6078,128
323,20,263,2266,193,33040,70
1269,14,866,2102,587,24934,279
518,788,22480,2242,14249,78744,8231
3697,82,1365,1092,956,22382,409
4199,89,726,539,614,19616,112
942,547,36480,2160,25719,198976,10761
951,123,2544,2159,1841,41642,703
1487,43,1340,2046,880,31248,460
289,150,1694,2270,1189,40824,505
189,20,446,2280,207,26379,239
1121,6,341,2134,246,11151,95
3624,47,1028,1192,692,22041,336
4116,5,124,654,95,6441,29
159,340,2792,2284,2132,83171,660
4156,81,848,600,649,18549,199
1115,351,14229,2135,10291,93360,3938
1186,9,556,2120,439,11502,117
678,166,3565,2218,2579,36662,986
458,202,5428,2252,3996,28416,1432
465,83,4238,2250,3020,43116,1218
1774,41,1679,1971,1156,23549,523
435,3967,179904,2254,120695,778644,59209
794,43,1661,2191,1274,30169,387
3957,201,2276,846,1576,30510,700
4112,40,493,657,354,15558,139
1432,610,17897,2057,10849,97197,7048
4250,324,4286,447,3249,38485,1037
152,36,502,2285,358,26203,144
1951,61,1656,1905,1155,31309,501
2156,4,182,1811,118,12932,64
2135,32,1317,1815,990,14037,327
3760,119,1462,1020,1202,17685,260
1579,388,12739,2022,8797,86949,3942
4197,216,3843,544,1931,45438,1912
3652,109,2012,1154,1636,60391,376
1349,96,4039,2085,3120,48967,919
1974,12,645,1889,431,17696,214
3537,222,3636,1316,2574,26903,1062
1756,144,2939,1974,2035,32806,904
4011,387,3581,796,2590,38586,991
1271,358,36858,2101,24783,181961,12075
1308,192,15726,2094,10032,112111,5694
425,109,3774,2255,2943,66632,831
3540,68,1558,1316,1128,40860,430
1041,220,7175,2148,5018,71399,2157
20,26,312,2292,204,38900,108
1230,171,12570,2111,8327,72494,4243
4268,3,38,410,28,1887,10
4172,65,2678,579,1931,28570,747
3868,279,8386,913,6335,79206,2051
3057,544,13559,1655,8503,117476,5056
225,61,737,2276,527,35385,210
349,29,314,2262,215,15566,99
3762,8,95,1019,60,4413,35
841,250,7705,2180,5377,50032,2328
4309,34,468,372,407,8059,61
1265,45,1722,2103,1255,55070,467
4294,20,425,385,313,3308,112
9,840,12122,2292,7114,167851,5008
3479,85,1865,1372,1397,24049,468
1699,69,1610,1985,1161,38204,449
335,479,5001,2264,3244,60245,1757
3448,29,296,1405,221,17452,75
498,203,5404,2244,3744,60204,1660
1079,342,16798,2141,12116,112398,4682
103,9,109,2287,80,25258,29
983,11,413,2157,330,17786,83
664,16411,402094,2220,215722,1077220,186372
4185,16,226,561,196,6296,30
1601,1823,43499,2016,24335,328559,19164
560,81,3021,2235,2363,38103,658
1575,22,606,2023,484,17815,122
1522,505,19447,2037,12065,125115,7382
867,336,6020,2173,4522,41817,1498
213,38,657,2278,464,42481,193
177,441,6992,2282,4920,103717,2072
3813,72,818,959,593,15472,225
3995,11,149,824,130,6415,19
3705,228,4180,1082,3173,51933,1007
166,918,8499,2283,5628,288701,2871
3914,2675,64574,886,43511,338119,21063
4138,14,217,627,133,16132,84
3770,6,150,1016,101,7247,49
4263,16,165,416,113,8032,52
3279,101,3873,1566,2859,53742,1014
523,6,352,2241,270,11061,82
1119,83,3240,2134,2402,57688,838
3483,178,3309,1369,2442,21254,867
925,81,1902,2163,1345,21701,557
1866,5,131,1943,95,17891,36
4167,155,3536,581,2202,27205,1334
1663,243,5759,1994,4023,42398,1736
558,35,2738,2235,2057,60105,681
972,28,1132,2158,879,19385,253
240,164,1470,2274,1022,38432,448
1139,30,1631,2130,1194,23017,437
1932,224,4898,1914,3207,60216,1691
620,61,2538,2225,1841,24727,697
490,427,20861,2246,13757,142856,7104
3050,273,3708,1656,2604,20964,1104
4255,29,1378,443,454,14195,924
2063,399,11137,1850,7470,41331,3667
3364,32,807,1473,584,27200,223
4186,141,2120,558,1735,23635,385
3826,18,232,947,194,13624,38
1131,2267,57421,2132,32592,373553,24829
1508,424,7925,2040,5174,55541,2751
257,53,644,2272,537,42564,107
65,33,295,2289,224,43903,71
816,12528,327489,2186,185166,962107,142323
1621,202,6142,2008,4212,55878,1930
127,625,9986,2286,6158,201496,3828
2112,72,1380,1830,1009,18584,371
255,26,248,2273,174,24538,74
3266,154,4171,1572,3031,92068,1140
3594,34,975,1251,740,25928,235
3127,900,26919,1625,14569,155786,12350
546,18,869,2237,644,27563,225
336,3930,58568,2264,45621,567780,12947
1585,207,8933,2020,6420,93339,2513
1520,184,6750,2037,4657,72815,2093
1943,35,802,1907,547,17372,255
986,54,2235,2156,1677,35952,558
1957,34,1220,1902,842,25236,378
3732,55,1310,1047,899,30893,411
2857,61,2129,1737,1469,36491,660
2784,1104,24908,1754,16243,91505,8665
4223,15,391,494,229,16617,162
1123,10,463,2133,314,24330,149
84,162,1744,2288,1308,29633,436
1902,2452,54200,1927,32349,393560,21851
1389,38,1401,2068,890,25932,511
395,1374,14332,2258,10017,185235,4315
73,3073,48761,2289,36820,449122,11941
1936,300,6541,1912,4886,38617,1655
685,128,6212,2217,4575,67710,1637
3552,8840,188408,1304,122647,665819,65761
4101,1346,49580,686,37412,185270,12168
423,135,11856,2255,8258,121660,3598
4163,14,174,588,90,3441,84
1988,13,320,1881,213,25004,107
2792,106,2705,1753,1846,31127,859
1688,106,2077,1987,1485,20891,592
1089,0,0,2139,0,9784,0
491,37,4238,2245,3171,46967,1067
72,46,469,2289,359,39293,110
124,131,1046,2286,709,21218,337
1223,865,29691,2113,19976,155776,9715
934,161,5536,2162,4138,61090,1398
1931,82,2321,1914,1581,39316,740
299,98,812,2268,616,148334,196
1770,67,1749,1971,1145,28416,604
621,97,5856,2225,4341,61752,1515
624,17,737,2225,599,21882,138
1071,138,2558,2144,1745,45359,813
1602,105,3232,2016,2375,34804,857
2464,128,4427,1796,2634,51676,1793
1617,1725,100183,2011,58277,472993,41906
3645,139,2248,1162,1802,24921,446
359,65,1289,2261,808,54715,481
457,845,18713,2252,13302,94207,5411
4023,173,1559,764,1082,24795,477
1055,1472,143746,2146,101098,493607,42648
1511,229,10571,2040,7330,51182,3241
4274,41,855,401,581,8727,274
957,23,1558,2159,1108,19312,450
4201,39,588,529,424,8481,164
4191,25,308,553,194,13044,114
659,51,858,2221,656,10981,202
3700,181,3544,1087,2825,35675,719
3532,186,4153,1319,3025,46429,1128
436,88,4334,2254,3265,66152,1069
1851,27,1118,1948,638,18829,480
1234,7,337,2110,246,14718,91
1728,232,4751,1980,3484,39456,1267
2074,30,840,1846,591,10009,249
264,22,293,2272,220,12384,73
1901,3,215,1928,145,9412,70
676,493,11238,2218,7908,90657,3330
110,1269,15943,2286,12205,367883,3738
3934,31,759,869,462,17290,297
1650,56,2248,1999,1412,23839,836
4292,18,317,385,244,2827,73
1554,559,16817,2029,10677,93812,6140
4332,4,59,265,36,2734,23
890,55,1089,2168,738,19328,351
1532,1612,47166,2034,32547,173232,14619
3500,296,8592,1350,6400,41641,2192
1703,82,4798,1984,2874,60739,1924
1823,127,2591,1959,1536,38831,1055
8,955,12598,2292,8933,88368,3665
320,23,242,2266,144,14168,98
325,8,111,2265,77,11173,34
1329,165,13953,2090,9521,124469,4432
4353,53,620,206,406,5469,214
4169,65,770,581,588,11418,182
1996,209,10415,1879,8051,57444,2364
3654,52,1046,1153,751,25716,295
882,1803,31935,2170,22464,109547,9471
1394,116,2850,2067,1981,43185,869
772,104,6860,2199,4931,50426,1929
1484,190,3688,2047,2502,42267,1186
671,1056,34556,2219,24198,162603,10358
811,138,3502,2187,2287,23128,1215
1148,52,1581,2128,987,23309,594
3562,60,1031,1289,658,26777,373
4198,333,3150,542,2426,36840,724
808,22,654,2188,459,17619,195
2134,32,1088,1815,788,14133,300
4296,22,426,385,294,3653,132
703,1176,33590,2212,22921,129001,10669
2017,8,506,1873,327,18240,179
1017,9,371,2151,306,16022,65
61,1544,21512,2289,14367,153559,7145
793,2366,83320,2191,57498,532716,25822
2535,282,3889,1791,2740,27322,1149
514,10,355,2242,292,25205,63
155,44,387,2284,268,14133,119
3305,504,13678,1543,8445,83849,5233
1606,1740,30667,2014,20470,106758,10197
1782,27,673,1969,402,18184,271
1945,54,2893,1906,2032,34639,861
1224,230,9693,2113,6232,101243,3461
4235,9,249,478,119,4308,130
448,45,3150,2252,2383,32469,767
340,22,199,2264,154,20929,45
140,118,1213,2285,926,263273,287
3496,393,6770,1353,5609,83514,1161
1204,24,560,2116,411,14971,149
3413,85,1646,1422,953,12396,693
1157,30,2727,2127,2013,43082,714
1507,581,26077,2040,16824,134816,9253
932,41,2480,2162,1907,26964,573
4259,67,1163,437,846,12126,317
404,65,676,2257,510,72356,166
4243,128,962,468,808,30894,154
4364,359,5960,168,4765,33922,1195
3690,110,1257,1098,926,20244,331
4282,27,521,386,366,3615,155
1624,36,987,2007,673,14489,314
3597,405,6378,1250,4782,45702,1596
4096,464,8404,694,6182,43974,2222
695,16,987,2215,686,21466,301
4155,108,1030,600,747,16247,283
1237,64,1302,2109,920,13308,382
3339,1413,49757,1504,34928,211729,14829
5,166,1679,2292,1229,77295,450
1682,460,13471,1989,9103,64908,4368
411,5,191,2257,137,30244,54
4013,0,0,803,0,31108,0
1397,613,17916,2066,11471,103838,6445
3974,66,521,833,346,8628,175
98,2051,26198,2287,16814,358203,9384
133,14,49,2286,41,38449,8
3096,71,1221,1638,734,11962,487
146,149,1773,2285,1123,68890,650
3616,13,281,1209,233,8148,48
1423,122,4154,2059,3093,31338,1061
4135,23,360,633,188,8492,172
272,11,129,2271,106,63681,23
849,36,2218,2178,1531,46259,687
475,321,20113,2248,15326,109761,4787
1044,35,985,2147,705,27754,280
1475,11,1013,2050,744,29513,269
3335,59,4374,1506,3480,41112,894
1762,2568,43519,1973,26115,167543,17404
2952,5,194,1700,138,14132,56
1791,266,11807,1965,8451,128064,3356
881,787,22843,2170,13400,79850,9443
3663,557,11620,1136,8263,77206,3357
94,151,1644,2287,1185,116025,459
178,139,818,2282,723,79534,95
1272,29,695,2101,497,21366,198
79,563,6357,2288,4588,205775,1769
2005,18,538,1875,339,44022,199
862,329,9284,2174,6586,55544,2698
243,3,15,2274,15,19749,0
2624,356,16087,1782,7383,94559,8704
4328,145,1204,271,1010,13459,194
1822,111,6307,1959,4041,61862,2266
1307,950,31832,2094,22079,217930,9753
1862,120,4951,1944,3257,45408,1694
4316,20,251,309,210,8722,41
2804,0,0,1749,0,10284,0
884,157,3320,2169,2427,25898,893
1740,133,2190,1977,1353,17826,837
3130,37,1607,1624,777,19444,830
1716,304,6903,1982,4813,86590,2090
852,135,6644,2178,4603,47555,2041
3962,789,8767,845,6625,90904,2142
3293,197,2780,1558,2010,26723,770
1750,64,2180,1975,1446,45892,734
1908,206,5041,1925,3330,103730,1711
506,132,3810,2243,2694,64870,1116
1677,466,7569,1991,5312,37703,2257
1362,67,1701,2080,1205,20454,496
59,54,802,2289,558,51199,244
2015,2,321,1873,219,12342,102
1754,42,938,1974,623,22297,315
3629,135,1746,1191,1294,22366,452
1733,31,1511,1978,975,26689,536
1519,494,10769,2037,7423,138512,3346
317,578,8657,2266,5590,142627,3067
910,264,8701,2165,6150,50943,2551
1872,313,12380,1941,8079,70081,4301
1729,203,7909,1979,5088,39327,2821
136,401,5559,2285,4277,93804,1282
1125,129,3108,2133,2434,14983,674
1832,1131,42624,1956,29989,156653,12635
583,183,3508,2231,2329,20294,1179
599,156,16577,2229,12667,104052,3910
1201,1208,43506,2117,27857,155841,15649
374,168,3269,2260,2215,153099,1054
4021,82,1020,781,770,20551,250
603,55,1914,2229,1448,62681,466
1430,1991,85422,2058,54736,399625,30686
1850,7,312,1949,211,7945,101
1036,169,8326,2148,5637,34002,2689
1944,25,1318,1907,736,16684,582
1594,1140,21420,2018,12759,121624,8661
141,1,85,2285,42,11126,43
293,96,1314,2269,864,40008,450
4321,12,190,291,124,3499,66
139,76,1724,2285,1236,97265,488
1763,305,4957,1973,3454,52632,1503
2008,150,2013,1874,1312,57285,701
1827,0,259,1958,172,12610,87
1949,2805,48594,1906,27222,289344,21372
734,761,32763,2208,24580,154724,8183
3722,5706,93411,1060,66389,333155,27022
3789,353,4606,984,3481,62157,1125
80,223,2197,2288,1469,173947,728
777,1579,54530,2195,35394,357576,19136
3674,797,20520,1126,15308,112591,5212
4276,47,854,398,546,13127,308
3836,77,822,933,639,14685,183
4287,1,24,386,12,4392,12
3368,677,10668,1466,7586,92615,3082
112,643,9204,2286,6194,196534,3010
1673,32,2162,1992,1501,25960,661
1130,21,615,2132,440,18399,175
754,218,5930,2204,4258,43778,1672
653,35,1792,2222,1368,21362,424
1404,75,2441,2063,1820,28816,621
346,307,3817,2263,2586,100525,1231
4010,156,2334,805,1878,49219,456
3045,72,3790,1657,2247,33766,1543
321,9,129,2266,123,63973,6
982,105,5187,2157,3914,66468,1273
339,53,900,2264,580,46343,320
4147,51,518,609,353,8218,165
149,0,4,2285,1,13065,3
1767,102,1735,1973,1237,24652,498
3332,67,882,1508,645,19715,237
1409,222,24570,2061,14809,135832,9761
729,19,761,2210,596,17470,165
3869,3022,46288,909,37321,231350,8967
56,83,719,2289,514,66749,205
824,209,9499,2185,5978,154401,3521
4113,13,285,656,246,6005,39
1921,101,3576,1920,2445,36266,1131
870,597,19413,2172,12267,102756,7146
145,14,102,2285,85,27009,17
2617,177,6844,1783,4198,65511,2646
4281,14,336,386,247,2836,89
44,8179,113090,2291,82625,624627,30465
752,12,850,2204,610,23634,240
1068,625,23401,2144,16046,127555,7355
1493,10,661,2045,477,27813,184
1019,12,266,2151,189,15235,77
1591,275,4905,2019,3182,36461,1723
1480,328,11135,2048,6849,46289,4286
3030,106,1927,1666,1552,15735,375
54,30,275,2290,209,51783,66
3910,127,3800,890,2766,42979,1034
1013,205,3399,2152,2430,30521,969
135,34,604,2285,406,33995,198
540,945,17583,2238,10817,80402,6766
399,119,5397,2258,3956,167309,1441
249,106,951,2273,611,21854,340
898,18,337,2167,276,16320,61
3036,171,5155,1663,3197,31602,1958
1399,3273,120410,2065,78804,747426,41606
11,376,9669,2292,5003,151019,4666
1120,9303,292336,2134,203149,862660,89187
2126,26,1015,1818,729,12502,286
3480,4807,103337,1370,72014,438431,31323
2069,31,937,1848,658,18837,279
1854,122,3621,1945,2483,40879,1138
1992,5,81,1880,63,14131,18
4230,77,2310,483,1655,23209,655
1836,899,20809,1955,13908,316970,6901
4288,1,9,386,7,3267,2
699,161,9702,2213,6485,53806,3217
123,11,204,2286,148,35523,56
4065,51,544,730,333,5817,211
4345,66,847,228,713,8945,134
4,717,9831,2292,6106,140147,3725
2905,59,1174,1721,817,23820,357
1971,10,113,1892,84,6176,29
3887,0,0,590,0,3778,0
1683,159,14154,1989,9113,74544,5041
1490,760,23769,2046,17257,169852,6512
4308,35,863,373,699,15121,164
3795,85,1000,982,711,21420,289
387,366,5503,2258,4188,107990,1315
1403,565,11589,2064,8047,71145,3542
1282,44,1189,2099,869,18965,320
3241,39,800,1583,455,18041,345
3756,7,40,1021,35,4026,5
2915,24,1903,1716,1356,51344,547
1596,1027,27457,2017,18770,127682,8687
40,13,211,2291,156,42634,55
1011,38,2300,2152,1609,38720,691
90,62,717,2288,519,47175,198
3253,657,14165,1574,9109,115429,5056
1477,758,16102,2049,12129,96119,3973
1235,365,10983,2110,7561,68413,3422
138,160,1750,2285,1333,42884,417
973,79,1399,2158,1016,22422,383
2972,5,237,1695,149,14964,88
993,415,13876,2155,9178,169392,4698
190,170,3667,2280,2556,126882,1111
2095,202,8070,1835,5582,44658,2488
403,199,3281,2257,2263,48129,1018
350,209,2406,2262,1634,42675,772
809,431,5615,2187,4022,98542,1593
4174,15,351,576,184,10564,167
87,165,1591,2288,1267,110631,324
3771,604,11777,1016,8711,48745,3066
3706,111,1840,1082,1367,28589,473
730,77,1578,2210,1147,19746,431
731,32,1380,2209,1044,53139,336
214,570,9724,2278,6175,96684,3549
821,154,6949,2185,4561,62610,2388
592,2,125,2230,96,14526,29
3679,955,20008,1123,14843,110842,5165
1977,55,4997,1888,3178,59582,1819
4018,223,4275,783,3018,82299,1257
559,70,2277,2235,1634,28045,643
3952,163,2985,849,2283,47751,702
1834,65,1565,1955,1052,26962,513
719,57,1152,2211,876,23949,276
4218,67,1175,499,829,78543,346
698,31,1800,2214,1334,35792,466
1680,91,2139,1990,1373,31478,766
1093,289,7147,2138,5058,47383,2089
1402,702,27392,2064,18950,134613,8442
3782,1278,44522,1004,32563,101539,11959
3668,10,113,1132,90,8014,23
1262,615,11621,2103,6943,60710,4678
1047,48,1809,2147,1313,37743,496
2011,12,891,1873,608,15458,283
3640,1038,27388,1167,20496,164125,6892
520,579,13597,2241,10319,119489,3278
2144,101,3829,1813,2763,25366,1066
151,1,22,2285,19,20509,3
1616,315,8402,2011,5461,71511,2941
3311,116,2212,1538,1694,32688,518
3578,395,4435,1281,3414,33105,1021
1986,17,507,1881,356,16707,151
2455,465,11265,1797,7043,62316,4222
1644,3,235,2000,169,20828,66
3294,157,5640,1558,4544,60949,1096
324,12,143,2265,116,21229,27
1159,304,10293,2127,7203,56618,3090
4323,27,321,290,285,9844,36
4237,40,509,477,445,11434,64
424,140,2014,2255,1363,25439,651
1556,206,10083,2029,6772,74607,3311
892,5,150,2168,112,10718,38
1356,86,3916,2083,2876,22719,1040
1506,49,2262,2040,1602,37323,660
642,23,416,2223,318,15954,98
691,1011,50922,2216,31990,119296,18932
684,206,5113,2217,3873,67418,1240
626,135,2536,2225,1776,36240,760
129,20,243,2286,177,26227,66
296,81,1373,2269,978,86815,395
990,394,6443,2156,4526,39629,1917
1210,184,5602,2115,3981,51882,1621
1417,0,133,2060,88,6869,45
1321,3428,73743,2091,45575,216650,28168
167,503,5149,2283,3514,94940,1635
4299,21,421,384,286,4181,135
64,43,433,2289,323,38733,110
1804,30,947,1962,708,32243,239
4342,7,244,234,176,4596,68
265,3,118,2272,55,9158,63
396,10,93,2258,78,26273,15
2062,497,9418,1851,6047,34858,3371
4232,7,109,480,86,3334,23
113,44,590,2286,452,39330,138
1195,4,79,2118,65,6080,14
3643,550,7977,1165,6264,43920,1713
81,41,334,2288,263,56937,71
4102,51,993,678,714,13438,279
1600,94,1932,2017,1235,26726,697
4352,15,304,206,200,4086,104
1565,72,2106,2025,1201,30753,905
4240,251,8750,471,5022,75270,3728
1995,201,6567,1879,4668,77474,1899
1070,40,2207,2144,1632,29065,575
547,101,2178,2236,1438,32147,740
3918,399,11543,881,8623,103508,2920
163,71,673,2283,369,74860,304
871,309,9187,2172,5443,58219,3744
131,17,104,2286,73,22973,31
1609,11,413,2014,257,26791,156
1277,19,1076,2100,758,31844,318
1211,75,4101,2114,2757,38847,1344
3609,5,182,1230,144,10871,38
3920,70,1113,874,743,23904,370
3708,2004,70060,1079,32102,203634,37958
883,1227,47559,2169,35624,259597,11935
4029,38,577,749,374,20554,203
869,5,386,2172,273,30046,113
565,527,18252,2233,13041,83513,5211
1276,131,3252,2100,2056,41518,1196
4126,87,975,645,765,28668,210
3467,62,1256,1391,1055,10991,201
533,44,1239,2239,930,22173,309
440,13,1229,2254,978,28447,251
397,25,269,2258,223,20793,46
2002,402,13591,1875,9100,62421,4491
500,82,3307,2244,2483,18824,824
3767,115,2896,1017,2150,28778,746
174,333,10986,2282,6797,150393,4189
994,933,31650,2155,21960,144871,9690
1076,365,12649,2141,8818,83377,3831
1800,282,11248,1963,7413,100504,3835
2100,90,2315,1832,1439,23757,876
1721,228,5459,1981,3782,51126,1677
207,754,8261,2278,5560,101035,2701
1028,0,7614,2149,5454,66454,2160
2044,307,6971,1864,5121,38714,1850
4283,13,372,386,248,3016,124
250,30,439,2273,302,15031,137
4120,21,268,652,203,7409,65
1395,521,35908,2066,25237,142488,10671
2127,51,1760,1818,1328,13808,432
4320,45,586,292,411,5433,175
1208,58,2462,2115,1775,43367,687
2713,81,1986,1772,1176,37597,810
563,127,4809,2234,3694,52913,1115
1742,454,10583,1976,7157,106083,3426
1207,11,475,2116,358,20066,117
1512,1358,23381,2039,15447,85695,7934
2039,29,743,1866,509,18113,234
638,168,11882,2224,8273,84835,3609
1918,22,453,1920,307,12874,146
1920,51,1347,1920,905,24713,442
654,174,6546,2222,4800,80355,1746
646,470,27022,2223,19102,94846,7920
3595,564,7978,1251,6110,108890,1868
4303,19,364,384,239,4710,125
17,263,3566,2292,2503,151549,1063
1819,14,874,1959,587,15264,287
3827,30,739,947,502,17991,237
687,1002,29265,2217,18238,89710,11027
4340,37,481,237,375,7859,106
1257,49,1558,2104,1096,21987,462
1938,138,3449,1912,2401,34142,1048
645,1322,104414,2223,73658,365714,30756
2977,29,574,1693,356,11792,218
3816,93,2263,951,1553,28587,710
273,57,1050,2271,717,128887,333
1209,189,7741,2115,5883,68747,1858
914,119,6555,2164,4705,43597,1850
3055,5,317,1656,187,13525,130
635,1394,24449,2224,16468,77153,7981
3943,29,352,856,272,11128,80
304,15,448,2268,233,48205,215
3362,185,3728,1474,2627,45856,1101
1144,0,1563,2129,1132,33015,431
4219,29,149,498,110,10533,39
4030,87,1501,746,883,16324,618
1152,615,17668,2127,13260,124649,4408
2097,181,4291,1833,2979,34847,1312
1746,31,1077,1976,759,16544,318
377,27,861,2260,579,45890,282
3842,145,1907,933,1478,28711,429
461,100,2860,2251,2073,38132,787
367,118,1063,2261,741,55681,322
1625,9,577,2007,463,10802,114
306,43,573,2267,414,124096,159
919,82,2721,2163,1906,16406,815
2056,497,15393,1854,10652,45085,4741
615,3028,82876,2226,57754,345006,25122
683,92,3862,2217,2988,159845,874
1250,32,1408,2106,1118,24566,290
1630,68,1944,2004,1318,29147,626
835,712,13680,2182,9002,93862,4678
358,2,34,2261,31,23375,3
2090,19,589,1838,406,25099,183
2049,39,1631,1860,1151,33581,480
338,433,8355,2264,4444,163618,3911
392,16569,307574,2258,199147,2745989,108427
775,358,14954,2196,9463,80051,5491
566,90,5064,2233,3527,53553,1537
3524,296,3613,1326,2597,20299,1016
665,164,3556,2220,2717,73818,839
494,59,2510,2245,2076,78797,434
1757,155,4303,1973,3115,62931,1188
1299,125,2394,2095,1709,22203,685
519,274,9612,2242,7335,65091,2277
1108,7,609,2136,415,68158,194
3744,7,55,1025,48,2981,7
4034,820,14099,737,10070,58489,4029
1732,1288,61729,1978,42360,138796,19369
594,65,1982,2230,1337,21731,645
725,60,4014,2210,3068,53069,946
1238,393,28289,2109,19509,104486,8780
4069,100,1202,728,909,7241,293
341,19,175,2264,110,51284,65
203,140,1580,2279,1103,66465,477
1741,1400,33848,1976,23427,152645,10421
1082,520,29698,2140,20885,129320,8813
2064,264,4656,1850,3163,36145,1493
1994,325,8979,1879,5583,40971,3396
636,52,4195,2224,3184,56593,1011
234,17,147,2275,109,27816,38
4179,77,938,570,679,18572,259
1140,265,6340,2130,5079,45701,1261
466,293,5391,2250,3646,31316,1745
165,21,130,2283,116,26501,14
634,139,3608,2224,2628,34760,980
280,163,2136,2271,1622,150033,514
1077,1067,24590,2141,15248,118694,9342
472,5,187,2249,123,11537,64
1194,132,2931,2118,2365,27482,566
3989,146,1569,825,1110,16740,459
3557,88,2273,1300,1569,29901,704
4348,49,714,224,555,6590,159
3854,969,20044,918,15287,139116,4757
966,18,304,2158,229,7144,75
2055,465,9195,1854,6641,38570,2554
702,85,3127,2212,2273,34643,854
1065,102,18086,2144,14042,74443,4044
3323,62,1393,1518,1034,23991,359
29,16,506,2291,186,34329,320
3404,22,1062,1428,763,26210,299
1286,7,520,2097,400,23598,120
4234,36,638,479,565,18741,73
1398,82,2931,2065,2134,25995,797
3855,39,605,917,372,6910,233
3774,52,754,1014,553,12320,201
3270,637,16143,1572,9113,140881,7030
1486,1006,44490,2046,31479,215804,13011
2549,63,1753,1790,1069,12963,684
1961,13,383,1898,293,17221,90
89,45,657,2288,468,46269,189
1773,28,780,1971,532,12603,248
589,1057,33161,2230,23203,204814,9958
640,76,3251,2224,2378,56052,873
2209,124,2839,1808,1578,29450,1261
347,2609,43337,2263,26118,427348,17219
334,5,45,2264,29,20665,16
156,98,1583,2284,1128,53097,455
2010,185,2368,1873,1582,57752,786
1603,36,956,2016,667,20806,289
997,16,518,2154,381,37389,137
4379,19,423,116,343,5500,80
1710,18,694,1983,486,28465,208
3466,19,622,1394,496,23120,126
3196,123,8513,1595,2872,43520,5641
814,692,38299,2186,27982,248935,10317
505,32,1524,2244,1240,28590,284
2913,104,2214,1716,1227,17441,987
3864,72,1165,915,728,32605,437
3738,18,221,1029,178,36949,43
1990,272,4789,1880,3100,47952,1689
633,93,3976,2224,3091,40075,885
144,535,5851,2285,3645,70173,2206
1824,211,13980,1958,8771,81299,5209
667,74,2237,2220,1627,38370,610
3098,4540,112599,1638,64563,708756,48036
872,150,13167,2172,9308,87352,3859
1231,256,12805,2111,9017,69029,3788
886,106,1983,2169,1321,26160,662
1861,65,472,1944,350,18522,122
1467,989,18649,2052,12795,87537,5854
4118,235,2326,654,1726,34164,600
95,1245,13861,2287,10045,177642,3816
209,115,1401,2278,918,35685,483
915,154,5102,2164,3712,53494,1390
13,1957,43425,2292,24407,548606,19018
1174,112,2352,2125,1727,22162,625
153,13567,224408,2284,141169,1269370,83239
67,947,14077,2289,9067,176619,5010
1664,126,3278,1993,2031,31993,1247
1335,27,998,2089,728,59534,270
3363,95,1721,1474,1314,48561,407
254,6,222,2273,152,15582,70
3001,272,4154,1678,2593,25060,1561
616,99,5793,2226,4064,69324,1729
277,15075,279729,2271,155872,1773370,123857
4257,5,89,438,54,5061,35
1240,52,5702,2108,3933,51015,1769
1185,3430,88104,2121,52322,444673,35782
489,5,296,2246,229,21271,67
630,593,13807,2225,8982,69379,4825
3902,30,250,770,176,9570,74
3875,96,1581,904,1294,33263,287
1233,219,6000,2110,4847,33863,1153
4280,12,347,386,256,2817,91
755,406,15126,2204,11255,103955,3871
656,6,381,2221,196,10127,185
52,25,245,2290,163,38397,82
137,60,818,2285,575,117296,243
556,64,3155,2235,2285,68533,870
2970,119,1959,1695,1295,15763,664
3680,10,104,1122,73,9516,31
327,29,377,2265,269,64298,108
312,76,886,2267,693,51989,193
605,345,16200,2228,10701,60200,5499
1007,62,3474,2154,2619,48565,855
609,169,3500,2227,2358,40265,1142
3400,324,3800,1431,2609,27763,1191
1127,89,1764,2133,1318,30071,446
393,661,8442,2258,6359,81291,2083
147,32,309,2285,198,41042,111
1972,1,57,1892,39,13477,18
798,125,7446,2190,5013,68821,2433
210,65,621,2278,437,59921,184
108,27,211,2287,175,37180,36
4363,47,918,173,615,14543,303
22,32,601,2292,369,26155,232
1151,218,12878,2128,8949,111220,3929
1731,600,27153,1978,18381,187097,8772
3254,367,6841,1574,5018,74409,1823
2068,31,1202,1848,760,46027,442
187,3,45,2281,41,22498,4
2951,7,413,1701,230,13038,183
1153,283,8482,2127,5944,51090,2538
50,27,408,2290,262,53907,146
4068,91,858,728,588,7447,270
1727,47,3446,1980,2318,42341,1128
1950,6,203,1905,149,11128,54
618,393,17310,2226,11380,108349,5930
15,9582,306390,2292,216611,2399250,89779
287,37,559,2270,351,38800,208
4271,59,1303,408,801,6994,502
3361,455,7070,1474,5024,44562,2046
35,180,6061,2291,3686,157127,2375
4270,98,1787,408,1243,9161,544
1952,99,6272,1905,4129,41127,2143
300,273,3907,2268,2551,71947,1356
570,115,2817,2233,2147,22731,670
800,88,1943,2190,1572,15502,371
418,376,10046,2256,6980,51352,3066
4082,83,832,719,557,8320,275
3860,66,1232,915,921,20459,311
1416,638,18340,2060,12042,59492,6298
4378,44,447,119,354,6283,93
1180,782,38569,2123,26989,165413,11580
1529,5,216,2035,161,11156,55
1518,22,1060,2038,706,50688,354
1171,26,1071,2125,782,15607,289
1928,40,1809,1915,1211,27470,598
1715,1864,47894,1982,28968,168364,18926
1292,123,5036,2097,3372,42268,1664
3574,60,1324,1283,1040,13783,284
473,7317,231366,2249,136321,773556,95045
354,2900,83562,2262,57236,683368,26326
1935,133,4360,1914,3004,54171,1356
843,214,8321,2180,4809,50142,3512
3617,197,3209,1209,2268,59822,941
839,250,8865,2181,6644,84210,2221
739,246,9473,2206,6917,84818,2556
247,23,230,2273,166,37995,64
1771,98,3470,1971,2262,32634,1208
2124,193,5859,1820,3933,42175,1926
1796,37,783,1964,538,16343,245
3662,866,11850,1137,8770,45278,3080
3965,204,2187,843,1657,28142,530
3939,26,239,861,206,9699,33