Mod,likes,downloads,time,unique_dl,views,dl_dif
43530,61,1407,345,1045,5658,362
15485,2,208,2926,171,5964,37
43501,19,437,359,299,5523,138
29969,15,211,2201,176,3996,35
1419,127,3317,3739,2925,21427,392
5408,6,43,3519,33,4082,10
43449,32,281,396,237,3884,44
42980,8,137,794,84,2207,53
42599,6,63,941,48,2108,15
43507,16,221,355,175,2759,46
42501,12,209,1026,177,2737,32
42300,403,5972,1201,4463,48048,1509
43376,12,143,437,105,1846,38
42085,3,29,1399,22,1477,7
10741,9,336,3219,277,5379,59
27696,23,905,2323,774,8933,131
37590,4,137,1808,120,2292,17
43831,1,16,165,14,291,2
23383,5,363,2527,299,9649,64
43700,0,21,248,13,417,8
32639,10,193,2067,163,7773,30
37538,28,484,1811,400,4646,84
43783,1,9,203,6,662,3
42458,9,183,1065,129,2118,54
28889,24,1203,2255,918,10662,285
1031,10,292,3918,205,10484,87
43243,2,70,557,58,1069,12
43011,3,39,769,28,1510,11
33153,8,310,2046,258,7261,52
7096,14,295,3441,268,18195,27
34851,37,836,1976,682,9228,154
43544,62,906,338,714,6550,192
29388,165,3018,2229,2566,36262,452
42289,2,62,1213,45,2613,17
39343,3,230,1690,200,2946,30
39890,41,1012,1658,864,16097,148
7916,1,146,3388,134,3662,12
42721,80,4703,892,3102,22162,1601
25264,15,485,2442,387,4211,98
1222,4,116,3860,105,3922,11
27266,56,1613,2349,1187,8737,426
27800,14,489,2316,417,9911,72
32912,13,190,2056,164,2719,26
43160,3,83,606,48,3064,35
42574,4,48,966,41,4339,7
42477,8,183,1046,131,7701,52
6166,3,114,3484,85,2032,29
38894,14,221,1719,183,3256,38
43352,68,605,458,494,5771,111
30632,3,114,2165,104,4351,10
12831,18,550,3109,476,5534,74
28849,17,337,2257,292,8660,45
13218,32,736,3077,647,5966,89
23035,52,1017,2545,829,14169,188
42200,22,208,1300,159,32216,49
43401,9,117,419,96,2156,21
43123,23,191,615,158,3241,33
7958,14,2870,3383,1241,6871,1629
6685,10,164,3462,139,2762,25
1566,2,50,3685,44,1861,6
27307,28,441,2347,360,5128,81
947,4,98,3948,85,2992,13
43302,5,82,506,46,1701,36
43663,0,57,262,26,1077,31
3867,247,22106,3586,13401,58348,8705
27262,92,2318,2349,1776,20256,542
43523,18,152,348,122,1546,30
33146,1,57,2046,47,3290,10
1655,4,10312,3666,3412,2278,6900
1818,20,659,3625,581,8711,78
43336,49,867,469,717,6850,150
43817,4,56,175,51,1301,5
43586,10,125,307,88,1868,37
23825,33,529,2507,429,6823,100
1779,13,276,3632,239,4091,37
43474,11,307,381,170,4589,137
7974,9,123,3382,110,2499,13
43811,0,66,178,25,1150,41
42948,6,119,760,77,2725,42
39437,9,188,1685,150,3254,38
27024,6,80,2363,66,2716,14
42867,3,140,831,82,2010,58
955,11,14093,3946,4516,8342,9577
38080,10,244,1775,213,4445,31
43573,13,139,319,104,1156,35
42444,23,302,1080,261,4922,41
41778,41,686,1453,572,12266,114
39139,23,427,1704,334,5115,93
41408,71,1695,1510,1383,16943,312
43555,66,661,331,492,5055,169
21042,2,149,2650,134,3044,15
43032,19,298,751,248,4130,50
42506,20,220,1024,196,5665,24
34530,2,126,1995,113,2643,13
31920,6,126,2102,109,2715,17
23886,8,216,2504,187,8252,29
7517,4,133,3417,123,2823,10
42108,10,296,1394,253,4989,43
949,41,616,3948,529,5964,87
35423,31,622,1946,517,7130,105
43320,46,2428,488,1541,20371,887
26558,7,110,2382,100,3114,10
43641,9,124,273,80,1676,44
42120,118,2301,1390,1787,17304,514
20872,186,3695,2661,2704,17113,991
43390,6,108,424,74,2812,34
22868,4,160,2552,136,6538,24
33917,10,196,2018,165,2653,31
3906,167,2979,3584,2492,33212,487
26530,47,1492,2384,1278,19810,214
38423,351,9080,1750,7550,25963,1530
43269,31,335,534,284,4830,51
43194,3,31,588,23,1521,8
42293,6,153,1211,120,2310,33
7339,24,910,3427,820,13203,90
43235,1,35,561,25,1384,10
42675,39,512,915,371,3412,141
42532,155,2777,1005,2458,16142,319
29223,9,306,2239,233,5351,73
15445,1,102,2927,88,1864,14
14467,3,239,2984,141,4568,98
43455,3,54,395,40,1427,14
5864,5,148,3496,122,6035,26
12795,2,325,3111,189,2790,136
43478,12,153,377,116,2000,37
26870,130,1985,2368,1650,16643,335
9656,7,1695,3273,795,2841,900
1639,4,92,3671,78,1878,14
18343,27,936,2786,848,7805,88
42991,127,1311,786,1004,16834,307
42409,3,39,1122,36,2363,3
42100,152,3097,1398,2488,26870,609
7486,1,866,3420,396,1934,470
43655,10,119,229,102,1543,17
39318,4,114,1691,96,3901,18
43105,35,515,679,385,4396,130
21669,26,665,2614,574,7786,91
39539,7,236,1680,191,6490,45
43219,154,2507,567,2026,8505,481
42981,26,459,793,329,4738,130
42265,19,325,1231,240,3832,85
42245,197,3709,1260,3247,21230,462
11586,20,446,3175,390,5501,56
16043,28,560,2900,429,8025,131
42090,11,256,1399,211,9008,45
23060,2,29,2543,27,2126,2
24273,34,830,2486,696,15401,134
2995,8,1427,3603,661,9771,766
7272,15,1052,3432,418,3479,634
33973,339,4490,2016,3427,18876,1063
42399,2729,45388,1127,37074,212273,8314
42921,145,2018,821,1605,12693,413
24388,1,35,2480,31,2321,4
21164,24,515,2642,434,5476,81
42115,15,228,1393,198,4210,30
43055,50,550,725,387,3697,163
43721,1,21,239,17,444,4
42413,24,193,1118,159,5084,34
37242,1,59,1830,45,2160,14
9748,0,27,3270,24,1487,3
6704,2,54,3462,46,1978,8
24537,29,768,2473,617,7475,151
42338,2,129,1167,105,2836,24
43798,5,81,186,63,974,18
21639,14,542,2616,464,9761,78
43814,5,82,177,52,1042,30
7254,9,285,3433,252,3938,33
1437,0,61,3738,54,2708,7
43540,4,57,339,37,2614,20
40437,9,153,1617,124,4558,29
37400,427,12192,1820,10558,33465,1634
42530,8,161,1008,114,3248,47
1424,208,4709,3739,4214,30840,495
43626,4,30,277,23,443,7
43277,28,294,527,236,3359,58
27551,5,55,2331,49,1422,6
37708,50,732,1801,598,4728,134
43246,56,737,553,615,7667,122
42126,345,7530,1389,5579,24793,1951
42521,217,2688,1013,2232,16149,456
42773,652,10011,873,8113,47620,1898
7919,8,587,3387,378,3395,209
7205,4,159,3435,138,2730,21
43658,13,257,240,200,3578,57
24389,1,76,2480,67,1957,9
43033,19,285,750,123,1490,162
42669,31,498,916,372,3918,126
43148,32,1508,612,997,3912,511
26734,12,277,2375,237,2884,40
42243,6,157,1261,112,2851,45
42320,11,244,1187,184,3695,60
42354,26,429,1144,324,5194,105
29341,269,6121,2231,5233,26849,888
43868,0,5,145,3,249,2
43685,7,81,254,75,1582,6
43871,1,28,141,17,758,11
43605,21,193,296,152,1915,41
7785,3,47,3400,41,1815,6
42628,3,72,934,57,1220,15
12345,29,897,3136,832,14876,65
8449,114,1900,3348,1495,9718,405
1287,5,146,3838,132,9354,14
10307,75,1800,3243,1536,23063,264
43572,3,139,321,104,1643,35
6168,31,682,3484,598,6697,84
36520,10,195,1874,155,3312,40
6860,5,153,3454,134,3916,19
43022,53,762,758,592,5952,170
1957,18,1283,3621,1017,11531,266
2257,37,878,3615,722,13167,156
28213,668,10723,2293,8033,37456,2690
42534,1,72,1004,39,2081,33
13315,17,433,3070,376,7204,57
1788,4,189,3629,159,2865,30
26730,2,67,2375,62,3672,5
43469,8,68,385,49,4071,19
43532,2,26,342,18,974,8
43035,75,833,748,504,5760,329
43855,0,11,153,8,344,3
6928,51,1227,3451,907,10223,320
6010,11,283,3489,237,3025,46
42161,226,3215,1339,2768,32676,447
8993,1,33,3314,26,1942,7
42314,13,456,1191,391,5199,65
40053,365,5953,1647,4429,19511,1524
43374,27,368,438,236,3370,132
42440,0,9,1084,9,1385,0
14872,6,205,2956,185,7608,20
43743,2,49,229,42,752,7
24238,20,460,2488,396,4260,64
43293,34,363,516,306,4325,57
38449,10,262,1748,221,4514,41
41771,19,449,1453,368,8734,81
1091,19,386,3901,300,5010,86
42313,776,12755,1193,10556,70994,2199
41371,50,1153,1516,973,10034,180
33916,38,941,2018,792,9909,149
30818,9,488,2156,425,9073,63
40501,2,96,1611,85,2656,11
7040,4,103,3443,89,2332,14
1220,3,124,3861,107,5364,17
6206,14,629,3483,528,6706,101
40193,38,595,1639,492,10400,103
43346,18,107,461,79,1433,28
1069,8,142,3907,125,4575,17
43019,5,98,755,64,2807,34
43677,4,35,257,28,572,7
43423,166,2804,411,2222,12024,582
9046,9,367,3312,184,2374,183
1457,302,4496,3719,3598,39391,898
10169,9,153,3250,141,4759,12
24097,2,62,2493,51,1322,11
1549,27,535,3689,489,16575,46
35796,0,43,1918,35,1986,8
43865,0,11,147,11,391,0
42252,27,522,1256,417,5994,105
39965,28,642,1653,517,9879,125
43002,19,161,779,115,2423,46
33919,12,383,2018,329,5906,54
42839,7,96,844,56,2139,40
1766,40,694,3635,591,8694,103
1459,9,114,3718,96,2920,18
42422,3,35,1110,22,1276,13
1735,4,126,3647,108,3514,18
42333,163,2122,1170,1762,43512,360
43283,25,577,524,262,4577,315
43116,31,257,661,197,3222,60
3915,99,2172,3584,1693,19414,479
42111,56,927,1394,816,10842,111
21725,134,2429,2611,2085,8853,344
24341,10,84,2483,68,2450,16
1022,3,104,3922,92,3223,12
32101,13,198,2091,174,4256,24
42987,66,810,793,632,5612,178
43827,0,37,169,27,541,10
42328,5,148,1176,123,3495,25
23986,187,3638,2498,3003,12492,635
43118,65,554,657,440,9428,114
43732,2,25,234,20,1022,5
43231,24,359,564,264,4324,95
22899,27,724,2550,637,9208,87
42241,32,619,1264,530,9727,89
43334,3,98,471,69,3293,29
43142,0,29,618,21,1254,8
12419,39,1250,3131,1155,10683,95
43582,3,76,310,48,1480,28
6040,16,638,3488,559,5684,79
35845,18,241,1915,193,3922,48
43717,0,17,240,13,680,4
10770,105,2679,3218,2200,15355,479
30236,33,563,2188,441,5376,122
5226,25,536,3528,465,5493,71
43541,57,816,339,663,3565,153
1045,7,197,3911,175,5469,22
43802,1,16,184,14,383,2
42569,15,138,979,103,3202,35
17614,0,46,2818,41,1598,5
35923,8,151,1909,130,7292,21
37576,34,926,1808,760,15650,166
42101,83,1404,1397,1196,10703,208
43057,418,5961,724,4740,30243,1221
6063,3,109,3487,96,2767,13
1713,15,298,3653,243,5086,55
580,33,595,4460,518,16699,77
969,27,767,3942,690,9142,77
43495,0,41,366,26,1027,15
1613,62,2063,3678,1804,11012,259
41191,0,15,1544,13,1031,2
22610,0,71,2565,59,2478,12
36373,38,722,1881,619,6722,103
39450,6,192,1685,167,3836,25
21297,145,3017,2635,2473,11077,544
42396,335,7381,1129,6154,33958,1227
43889,0,3,131,1,100,2
10444,171,3608,3237,3247,37431,361
27588,2043,47296,2329,31723,175374,15573
42330,48,670,1173,515,9781,155
24842,32,449,2460,393,7421,56
42163,6,110,1338,97,3544,13
7390,3,66,3425,52,1910,14
42170,54,1316,1332,1038,12887,278
42326,9,97,1179,75,2754,22
1696,3,140,3659,119,4136,21
43240,42,507,558,407,7042,100
36406,1830,32318,1880,26470,121103,5848
42287,5,116,1216,86,3852,30
10448,133,5765,3237,5098,38432,667
43728,5,30,236,23,488,7
42185,1,45,1319,34,2180,11
41222,26,287,1539,250,7388,37
1118,1,95,3892,90,5868,5
7854,5,109,3394,100,3154,9
31894,1,43,2103,38,2571,5
31629,39,735,2116,602,5467,133
6099,4,327,3486,289,6849,38
43715,3,32,241,18,705,14
35561,13,318,1937,259,9630,59
42272,9,259,1227,198,4903,61
43030,464,7102,751,6047,33178,1055
37570,28,356,1809,277,5667,79
34076,1,55,2013,48,2448,7
43385,143,2563,429,2113,17020,450
14814,3,300,2959,270,4491,30
43223,9,110,566,90,1559,20
7973,9,231,3382,199,7139,32
11990,5,74,3155,53,2293,21
31813,448,10082,2106,8255,75998,1827
16829,8,273,2860,234,3188,39
43669,3,46,260,33,935,13
43736,1,13,232,10,432,3
8074,3,263,3371,234,3543,29
43695,10,136,251,84,1416,52
7555,57,1680,3415,1246,16179,434
43132,4,88,630,69,1703,19
15987,33,498,2903,415,4206,83
1562,3,88,3685,80,2818,8
25376,2,82,2437,73,2811,9
36220,2,42,1889,36,2961,6
43617,6,114,287,71,2197,43
43834,0,7,165,7,220,0
1555,56,12904,3687,5384,8073,7520
1071,8,247,3906,217,5203,30
43778,1,22,207,19,678,3
1697,1,97,3659,84,3634,13
39308,15,339,1692,278,7967,61
19638,15,165,2729,134,2396,31
33722,8,152,2025,123,3334,29
43107,16,924,678,638,5004,286
42402,67,1646,1125,1304,10617,342
42097,108,1687,1399,1450,9482,237
13969,40,890,3018,735,7374,155
42802,17,211,856,149,4773,62
43793,13,99,195,88,2162,11
29570,21,389,2221,333,3243,56
1638,7,88,3671,82,2823,6
11048,11,224,3204,189,7373,35
1050,13,602,3910,550,8278,52
36891,12,340,1852,253,4238,87
40523,0,229,1610,190,4745,39
42294,7,102,1210,77,2959,25
39855,8,171,1662,163,4894,8
43815,1,60,177,55,1289,5
14947,58,1945,2952,1666,29770,279
3612,55,883,3591,733,11227,150
1471,3,38,3713,34,1966,4
23648,0,0,2514,0,3663,0
1900,2,203,3622,106,7229,97
42652,49,475,923,367,5165,108
43491,0,15,369,14,1034,1
43197,38,441,584,321,3276,120
13981,4,160,3017,135,3175,25
1242,0,53,3853,44,2846,9
42167,6,100,1335,90,5079,10
3970,0,773,3582,332,2504,441
1704,9,238,3658,208,3275,30
1452,4,115,3726,95,5023,20
24294,25,677,2484,555,6232,122
33268,217,2466,2042,1889,16355,577
42364,12,437,1139,311,6859,126
43263,15,238,541,169,6161,69
28892,12,453,2255,349,4398,104
42871,47,493,830,374,4781,119
43566,2,205,326,159,4912,46
42324,136,2528,1182,2183,31794,345
40075,0,317,1646,289,6538,28
43607,4,75,295,46,2124,29
1599,2,68,3679,58,3060,10
42481,5,90,1043,56,3544,34
42219,12,117,1278,85,2936,32
33443,2,131,2035,119,3052,12
42834,114,1176,844,918,12486,258
42366,67,1480,1138,1257,15216,223
12550,41,696,3126,608,13046,88
43588,11,244,306,233,2515,11
3899,20,343,3585,285,8356,58
37468,16,320,1816,247,5760,73
43056,32,287,725,251,3150,36
14955,219,4164,2951,3313,23198,851
42494,15,291,1030,198,3141,93
1648,8,293,3668,195,4072,98
37051,2,56,1842,44,2796,12
38353,19,345,1754,298,3932,47
43271,6,74,531,57,2426,17
43170,18,360,598,232,3489,128
8716,27,612,3330,448,5006,164
43147,15,541,612,365,5667,176
1632,4,89,3673,73,2578,16
30810,8,138,2156,111,3578,27
30186,476,12862,2190,10883,56735,1979
26513,57,1078,2384,870,12816,208
43445,10,149,396,100,4741,49
42583,28,322,947,208,7672,114
5592,152,3123,3511,2674,59558,449
42005,28,426,1413,347,6431,79
1744,5,189,3644,156,6944,33
1671,279,5781,3662,4764,51938,1017
946,96,1871,3948,1624,10454,247
3882,1177,22945,3585,18578,186110,4367
43212,55,578,575,347,4109,231
31105,9,184,2144,156,1960,28
43303,9,102,505,73,2214,29
33218,4,281,2044,215,4719,66
38722,43,966,1729,725,12036,241
43489,9,92,370,79,2657,13
12333,6,206,3137,177,7543,29
16830,14,256,2860,220,3889,36
42486,8,108,1042,89,2028,19
42519,3,73,1013,61,3033,12
14646,4,156,2971,130,4276,26
39741,27,685,1669,572,7715,113
6122,19,564,3486,509,15842,55
6047,35,921,3488,785,10762,136
11428,3,196,3184,104,3400,92
39431,447,10149,1686,8235,51731,1914
6154,8,291,3485,254,3807,37
43799,14,235,186,206,2313,29
43500,1,29,360,17,1165,12
944,26,758,3949,674,15907,84
43146,47,486,612,343,4295,143
1784,5,139,3630,116,2890,23
43707,3,56,246,49,1024,7
27895,41,1512,2312,1321,17908,191
43154,167,2175,608,1718,10395,457
42299,30,349,1204,272,5479,77
25387,28,850,2436,739,8779,111
43616,6,68,288,34,1445,34
1714,1,60,3653,53,2083,7
42441,4,94,1084,65,3304,29
27859,15,335,2314,294,3470,41
27212,6,196,2353,161,3125,35
22932,45,1170,2548,1028,16692,142
13793,7,217,3034,179,5248,38
39462,13,289,1684,239,6690,50
42234,72,1061,1266,866,13162,195
37871,20,420,1787,368,5474,52
24395,2,174,2480,151,4411,23
1264,10,296,3843,246,5895,50
1650,2,90,3667,71,3158,19
42476,2,60,1046,47,3207,13
27265,12,390,2349,326,4155,64
1098,3,143,3897,131,5801,12
9125,9,131,3307,90,1723,41
23442,7,434,2524,402,13631,32
43422,102,1464,411,1184,4853,280
37660,13,237,1804,187,3699,50
42183,10,108,1319,92,2623,16
21405,25,544,2629,429,4100,115
27355,83,1281,2344,1080,13099,201
13384,140,2687,3065,2082,15128,605
29985,46,829,2201,714,6662,115
29374,3,125,2230,108,3085,17
42312,1,79,1196,65,1941,14
1117,0,50,3892,45,4327,5
28833,1,57,2258,52,2352,5
42411,7,114,1121,82,3562,32
5583,2,894,3511,595,5939,299
14215,13,249,3003,225,6322,24
41570,50,1449,1489,1302,18654,147
1651,6,0,3667,0,6662,0
43702,3,35,248,28,866,7
28891,26,384,2255,314,3749,70
6121,5,89,3486,77,2216,12
1228,106,2005,3859,1751,14793,254
43230,2,68,564,55,1326,13
42277,38,535,1221,360,5451,175
35237,52,755,1956,630,7822,125
43405,12,169,419,113,2106,56
11066,23,675,3202,593,8017,82
14561,6,150,2977,127,2504,23
43318,135,1457,490,1133,9984,324
43247,1,24,552,17,1286,7
42146,109,2216,1356,1974,15804,242
41337,466,8863,1520,6562,50765,2301
24229,0,56,2488,49,2727,7
29579,22,323,2220,241,5380,82
42648,13,113,926,83,3409,30
3935,11,428,3584,376,8441,52
1257,72,1186,3846,1042,31189,144
28916,598,17089,2255,13670,50345,3419
43350,102,1131,458,928,8385,203
1515,5,99,3705,82,2988,17
34186,10,146,2010,124,3132,22
42104,4,105,1397,86,3905,19
43801,4,23,185,19,719,4
43527,51,565,347,428,4915,137
43141,44,373,618,285,3574,88
43878,0,14,133,14,802,0
29281,27,369,2236,318,7102,51
43387,24,182,426,139,1841,43
1501,2,144,3710,117,5456,27
43037,89,764,746,644,9801,120
1005,49,1273,3930,1098,17037,175
6098,17,548,3486,413,4561,135
31012,197,3226,2149,2832,17826,394
43229,11,164,564,114,2805,50
42526,778,19393,1010,15540,103480,3853
43749,73,1181,227,880,13436,301
43295,14,208,515,156,2818,52
13463,13,572,3058,495,5431,77
42780,22,308,870,202,5833,106
28599,5,235,2270,211,5569,24
6097,7,186,3486,137,2774,49
42915,4,48,823,35,2657,13
42555,379,5778,994,4798,24507,980
19510,10179,268100,2735,199165,1041801,68935
38391,81,819,1752,677,6677,142
11170,3,353,3196,201,6618,152
42928,79,987,812,704,9136,283
42510,3,42,1020,31,2293,11
42686,26,311,913,217,2054,94
28259,15,447,2291,359,7355,88
12088,0,141,3151,96,5517,45
22938,34,872,2548,708,8564,164
4930,18,337,3545,291,3876,46
43613,1,28,290,25,1048,3
43406,86,907,418,754,6972,153
43601,1,16,300,7,1778,9
27183,72,4581,2354,4034,19355,547
11905,38,978,3160,873,15118,105
43314,2,44,493,34,1517,10
28439,11,317,2281,279,12432,38
43462,16,186,390,118,3205,68
9688,4,205,3272,187,7302,18
43812,0,19,178,15,333,4
27764,7,185,2319,172,3292,13
43437,14,129,400,99,1316,30
19604,1038,27636,2731,21032,208892,6604
6123,15,546,3486,492,15050,54
35368,206,4090,1950,3613,17761,477
15459,10,195,2927,159,7535,36
1612,19,429,3678,378,7460,51
38827,2,65,1723,45,2073,20
26883,0,51,2368,45,2920,6
22160,7,184,2587,152,3237,32
42187,4,118,1315,101,4600,17
29540,5,103,2222,89,2408,14
3675,2,126,3590,111,2202,15
19942,71,1649,2712,1448,7836,201
15453,4,186,2927,164,2386,22
40054,2,63,1647,49,1498,14
8629,13,345,3336,315,7613,30
43415,1,19,414,15,766,4
43120,319,4088,645,3262,23852,826
40894,2,137,1575,125,3900,12
42654,34,405,922,325,11769,80
6845,25,337,3455,264,4785,73
23335,368,6305,2530,5040,26368,1265
7518,30,653,3417,598,7012,55
34844,168,3823,1977,3231,17132,592
34288,8,207,2006,173,2881,34
1509,3,95,3707,77,5258,18
43800,20,260,186,231,2808,29
14435,1572,154159,2986,121625,301635,32534
21886,10,267,2602,223,7280,44
582,12,284,4403,247,17855,37
42997,34,382,782,297,2780,85
42099,140,3284,1398,2617,12722,667
43602,58,732,298,560,7661,172
42136,382,6988,1374,6052,65982,936
25411,15,455,2435,397,4715,58
10457,15,906,3236,558,5383,348
43852,2,136,153,81,991,55
23089,4,108,2542,97,3066,11
6462,8,665,3472,274,3449,391
41220,9,177,1540,146,4311,31
26088,5,317,2404,298,9000,19
43199,15,163,583,124,5555,39
1083,3,83,3902,69,2720,14
43510,5,65,353,60,1286,5
19335,13,381,2744,320,6937,61
18790,4,96,2767,85,3902,11
5710,3,91,3504,77,9632,14
34244,18,146,2008,122,4427,24
42549,50,500,1000,395,9229,105
43600,2,84,300,57,1192,27
28893,61,2634,2255,1794,35433,840
1542,68,1320,3690,1169,18272,151
43383,18,598,431,274,3952,324
43236,18,176,525,121,1643,55
21265,0,78,2636,70,2466,8
43180,20,247,594,165,3264,82
42210,3,92,1290,75,4789,17
1207,47,779,3861,714,6313,65
43724,1,32,207,31,1069,1
17686,7,145,2816,129,3823,16
41307,75,1046,1525,861,8520,185
1622,170,4183,3676,3400,39053,783
43025,21,278,754,201,4008,77
42203,2,36,1299,26,5828,10
39122,110,2048,1704,1641,13879,407
10472,14,1402,3235,1218,7611,184
43290,11,121,521,99,3159,22
22587,97,2447,2566,2019,10598,428
1073,17,257,3906,210,5984,47
4788,4,215,3552,120,2141,95
42022,13,227,1411,185,4819,42
29884,7,144,2205,115,2808,29
14162,2,128,3007,105,2462,23
15877,1,143,2908,106,3221,37
21407,45,1168,2629,977,9047,191
41074,18,270,1558,220,3544,50
43333,7,74,471,53,2142,21
42344,107,1409,1158,1091,16874,318
32356,1,46,2079,40,2529,6
43084,21,147,701,105,2464,42
43760,3,21,219,17,683,4
29019,2,217,2249,181,5968,36
42249,220,5154,1258,4161,36912,993
1718,1,49,3652,43,3881,6
19153,20,418,2753,332,4796,86
30765,79,1259,2159,985,9158,274
6749,147,3855,3460,3368,13681,487
6106,22,615,3486,467,6293,148
10608,9,301,3227,274,5063,27
1444,2,68,3737,58,2382,10
43198,2,65,583,39,2787,26
11275,10,286,3191,246,8268,40
43450,1,37,396,22,1377,15
41728,10,229,1463,206,5302,23
42156,1,17,1345,15,2373,2
42575,1621,42008,966,34971,145836,7037
7278,13,422,3432,286,6803,136
40784,18,343,1586,302,6631,41
1678,1,58,3661,53,1728,5
43121,42,619,644,519,15428,100
302,6,231,4265,192,8743,39
41730,67,1371,1462,935,14004,436
29091,15,195,2245,167,3074,28
42178,2,72,1328,58,2608,14
1610,311,5761,3678,4824,50877,937
43679,1,17,256,8,465,9
1557,9,89,3687,72,2166,17
43250,1,22,550,16,1097,6
42830,62,873,847,630,7993,243
1200,614,25867,3862,21313,134020,4554
1062,6,140,3909,109,4082,31
43747,8,143,228,119,2478,24
1575,3,54,3684,52,3029,2
26581,14,229,2382,190,3972,39
41833,3,87,1440,79,2747,8
7015,8,221,3445,196,4213,25
21377,147,3297,2631,2756,10858,541
22675,9,331,2562,304,8798,27
40277,6,53,1633,41,2066,12
29965,31,509,2201,460,4152,49
26039,30,480,2406,405,3916,75
42798,63,503,861,439,6054,64
43775,0,13,208,9,745,4
43446,2,119,396,94,1458,25
11058,0,335,3203,175,2307,160
6995,16,469,3447,408,7408,61
19467,60,1495,2737,1295,7949,200
42638,2,37,929,17,1785,20
43036,47,666,746,470,8222,196
43224,29,386,566,273,3782,113
19914,4,152,2714,140,2522,12
27420,13,249,2340,197,4328,52
1684,0,43,3660,37,1768,6
43150,16,163,611,141,3484,22
10282,4,64,3244,46,2582,18
43151,61,642,610,450,7250,192
43059,4,50,719,40,2432,10
37805,8,190,1793,159,3934,31
25542,1,71,2429,60,4102,11
42238,248,3801,1265,3017,24662,784
42323,0,0,1183,0,1445,0
42792,10,145,866,119,3575,26
42279,12,128,1220,94,3141,34
43109,35,486,673,335,4589,151
29272,5,113,2236,101,3384,12
38171,28,382,1768,263,5356,119
42709,69,3657,892,2568,9388,1089
28175,17,320,2296,291,4165,29
42089,14,185,1399,152,2421,33
1313,4,223,3822,203,4963,20
27246,78,1640,2350,1294,13117,346
43347,16,144,460,111,3137,33
9647,8,273,3274,191,2730,82
43539,14,147,340,109,1697,38
42118,108,1527,1392,1294,17721,233
43708,0,12,246,9,490,3
32809,12,530,2060,438,12328,92
22642,2,106,2564,100,5105,6
26487,9,162,2386,140,3646,22
43192,50,590,590,446,5679,144
26325,27,1161,2394,1020,10279,141
23746,3262,90388,2510,66835,284477,23553
6537,7,164,3468,130,2690,34
6190,10,176,3483,158,4303,18
6103,6,297,3486,226,4488,71
30210,7,321,2189,272,5677,49
43097,40,446,686,333,3249,113
1252,2,46,3850,40,2459,6
3648,1,50,3591,43,3807,7
42317,51,703,1188,634,9031,69
18440,12,491,2782,437,8707,54
43052,17,221,732,152,2179,69
42601,13,194,941,149,3956,45
16979,2,131,2853,111,4510,20
43254,56,832,546,543,9022,289
39406,25,431,1687,361,5379,70
1657,18,448,3665,357,6681,91
41544,54,1100,1491,896,14063,204
31867,3,164,2104,129,3064,35
19882,55,1084,2715,951,6295,133
26309,16,589,2394,521,10063,68
24047,1,57,2496,51,2149,6
43763,7,74,216,45,1180,29
35751,3,72,1922,64,3568,8
14894,86,2066,2955,1460,23107,606
43873,0,16,140,14,265,2
20491,68,2415,2684,2136,15948,279
43143,87,775,616,599,10146,176
30563,413,9604,2169,7776,62395,1828
22541,155,4289,2568,3800,39386,489
3919,4,360,3584,315,10226,45
43441,83,1299,398,1051,6629,248
43520,80,1155,350,869,7742,286
41720,14,411,1464,370,5036,41
43754,4,42,225,35,886,7
1113,64,1678,3894,1503,30171,175
6333,5,116,3477,102,2394,14
1283,7,193,3839,171,4710,22
42081,0,92,1399,66,11734,26
42009,184,2642,1412,2076,21507,566
14394,71,2165,2988,1903,25233,262
19710,7,192,2725,171,3988,21
40199,228,4289,1639,3564,19918,725
7968,32,551,3382,482,3739,69
36810,37,590,1857,469,6088,121
9967,358,17247,3259,13876,42406,3371
21939,11,226,2600,194,5311,32
33920,1,95,2018,82,2431,13
13608,11,432,3048,362,11207,70
38889,22,529,1719,450,8083,79
42102,16,216,1397,182,2655,34
42715,88,4668,892,3513,16780,1155
21589,14,297,2619,252,4046,45
1475,59,1234,3712,796,7630,438
28258,2,67,2291,59,2038,8
43864,20,251,147,209,1408,42
30736,9,118,2160,104,2349,14
33873,4,61,2019,49,1950,12
42251,105,1906,1257,1618,20120,288
14006,16,318,3015,262,9905,56
42485,3,35,1042,29,1116,6
13464,9,278,3058,243,4848,35
43482,7,86,375,62,1398,24
25299,45,1065,2440,927,11856,138
1645,4,142,3669,120,3128,22
43072,378,6047,709,4834,26162,1213
1747,5,86,3643,74,2254,12
42207,39,867,1294,664,12517,203
43558,7,70,330,53,1044,17
21113,54,1461,2647,1241,11074,220
21116,1,54,2647,52,1749,2
43202,53,515,581,440,6207,75
43738,1,28,231,23,1206,5
43629,2,58,277,53,998,5
22382,4,186,2577,171,3015,15
29542,32,584,2222,510,5079,74
42117,291,4454,1392,4009,19086,445
1559,5,158,3687,143,4621,15
42083,4,103,1399,94,5538,9
37861,4,222,1789,194,3531,28
3677,0,341,3590,104,2377,237
29479,12,197,2225,158,8142,39
22921,120,2659,2549,2099,18312,560
14458,157,3437,2984,2856,28267,581
43673,3,39,258,22,844,17
43330,36,1360,473,1110,5566,250
43788,3,35,200,24,1005,11
1122,13,219,3891,195,7772,24
10015,5,129,3257,109,4208,20
27479,296,4868,2336,3770,17215,1098
42573,194,3913,968,3178,20710,735
6015,4,99,3489,75,2279,24
42205,1,71,1296,55,2297,16
20507,22,1222,2682,1031,16419,191
2998,13,379,3603,346,11395,33
36869,14,230,1853,200,4360,30
25770,199,5390,2418,4260,26627,1130
42853,480,6356,836,4936,31951,1420
42865,1,31,831,29,1797,2
43875,0,10,137,9,282,1
43581,2,86,312,56,1924,30
43796,10,160,190,123,1068,37
27117,1,127,2359,115,3548,12
35386,16,267,1949,240,4549,27
43304,6,97,505,69,2604,28
42221,8,121,1272,88,1634,33
1618,6,151,3677,134,5215,17
17814,2,127,2811,103,5213,24
42929,7,86,813,77,2052,9
43452,1,50,395,39,886,11
42431,226,4057,1098,3227,19459,830
43846,3,14,157,10,326,4
1498,14,240,3710,208,5515,32
42158,172,3763,1344,3064,35108,699
30436,7,112,2176,95,1766,17
42568,18,242,980,170,2594,72
15840,1,69,2909,58,1544,11
43063,3,77,719,56,3132,21
21320,0,44,2634,36,2406,8
41941,11,177,1424,144,4872,33
1219,24,510,3861,422,11619,88
22966,2,139,2547,130,4917,9
43823,2,25,171,16,682,9
1787,15,311,3630,281,8683,30
9506,6,160,3282,133,2080,27
35563,11,280,1937,220,7387,60
43435,3,46,401,33,1759,13
42748,4,123,894,82,1767,41
23654,4,88,2514,74,2837,14
42327,106,2005,1179,1690,10335,315
42480,139,1933,1043,1707,19816,226
39030,65,913,1711,691,12260,222
43465,2,35,388,28,1554,7
43820,2,23,172,17,867,6
1785,22,359,3630,322,5849,37
42165,52,895,1336,742,9278,153
43012,67,1843,769,1415,8584,428
42723,17,681,892,428,8189,253
43210,8,110,575,84,1927,26
43649,11,205,225,174,2754,31
43419,8,70,412,51,2394,19
40885,31,388,1576,325,7602,63
42420,114,3136,1114,1813,23643,1323
13554,79,1580,3051,1402,21199,178
42656,139,1882,921,1493,10313,389
36812,27,560,1857,496,7252,64
42727,7,89,892,67,1845,22
8668,32,1442,3333,1246,21159,196
33651,9,171,2028,134,3962,37
5535,5709,203002,3514,157699,1212512,45303
42762,66,873,881,712,9160,161
42206,8,126,1294,92,3015,34
22051,24,508,2593,429,8696,79
43045,99,1461,738,1060,9622,401
1446,0,65,3733,51,2939,14
11325,34,1281,3189,681,9097,600
8740,9,317,3329,294,9468,23
8018,16,473,3379,439,5280,34
42725,23,1322,892,898,5549,424
43714,7,72,241,40,1379,32
42483,143,1884,1042,1533,16661,351
27069,76,1242,2361,1064,14746,178
33982,94,2082,2016,1409,12261,673
1443,4,155,3737,124,2438,31
42454,83,888,1070,750,8763,138
33316,6,231,2041,179,6752,52
43664,4,43,262,27,1814,16
42262,2507,43510,1233,36616,170961,6894
43209,59,1193,575,664,10116,529
42495,55,618,1030,518,3767,100
27358,5,111,2344,102,3503,9
37856,500,10031,1789,8523,42007,1508
1008,12,199,3930,179,7008,20
7650,1,53,3409,43,3074,10
41298,160,2648,1525,2237,25786,411
29480,13,330,2225,296,9397,34
42911,10,147,823,92,2396,55
1709,4,67,3655,52,2758,15
35761,7,141,1921,113,4778,28
42123,17,394,1389,331,5648,63
43221,19,195,566,172,3873,23
42270,411,5949,1228,5138,34788,811
1691,31,786,3659,555,6252,231
39774,12,321,1667,259,6338,62
43300,15,226,506,183,2569,43
27747,4,166,2320,153,1890,13
576,10,203,4404,178,8152,25
43696,5,69,250,45,958,24
26260,1482,34062,2396,23848,149370,10214
1196,7,189,3864,167,5869,22
42278,41,528,1221,430,4261,98
42685,80,1283,913,968,10144,315
11908,55,1325,3160,1168,14135,157
43826,3,84,169,69,1008,15
37821,8,189,1791,163,3281,26
26077,1,95,2405,89,2379,6
40529,22,339,1609,273,4491,66
6164,23,626,3484,543,8558,83
42188,34,535,1315,420,13829,115
41116,2,115,1552,100,4275,15
42297,32,374,1206,305,2407,69
43632,5,74,276,49,755,25
12639,5,137,3120,125,3819,12
43786,45,715,201,580,5974,135
4636,5,249,3558,209,3689,40
33402,2,37,2037,30,1936,7
43850,3,22,155,18,648,4
42259,16,139,1242,107,3209,32
8146,5,407,3368,185,2133,222
42190,1114,19213,1313,14340,59619,4873
43139,33,462,618,343,3342,119
43816,8,68,176,56,929,12
43100,334,3409,682,2761,13695,648
6016,4,105,3489,89,6230,16
40702,36,585,1594,476,6768,109
42636,45,619,929,481,6613,138
41332,41,597,1521,515,5211,82
42246,8,172,1259,149,4638,23
1046,10,206,3911,188,10688,18
42482,109,1175,1042,841,7895,334
28519,330,6054,2275,5199,20532,855
43551,7,103,335,68,889,35
8041,24,430,3372,390,6540,40
42380,33,536,1134,441,6276,95
42552,5,44,996,37,1947,7
3876,33,534,3585,472,5883,62
1488,29,475,3711,415,6037,60
42642,10,134,928,84,2534,50
1670,40,855,3662,722,15664,133
42488,4,90,1041,59,3912,31
43389,9,241,424,154,5001,87
43503,5,54,358,36,1897,18
39083,8,117,1707,95,2164,22
43257,16,93,545,63,1613,30
39367,12,219,1689,177,3863,42
42107,7,117,1395,94,2519,23
1654,10,172,3666,159,5096,13
42717,66,2641,892,1948,12894,693
43662,5,40,262,30,923,10
39938,0,30,1655,27,2069,3
1527,3,86,3697,75,2020,11
1256,54,10231,3846,6024,29518,4207
1412,0,64,3742,54,3593,10
43706,13,136,247,108,2649,28
8666,13,1497,3333,648,3327,849
8570,5,972,3339,383,8626,589
43069,96,1174,717,1028,10613,146
42103,312,4602,1397,3857,18626,745
1567,4,65,3685,60,2340,5
33285,13,462,2041,357,9950,105
27322,40,752,2346,664,9073,88
4906,22,1139,3546,626,6502,513
1687,0,37,3660,32,1684,5
37488,20,288,1814,232,3540,56
12440,5,218,3130,191,2834,27
5013,4,67,3541,57,2325,10
22263,9,425,2582,375,6846,50
43432,4,68,405,42,1793,26
24347,34,684,2482,587,8033,97
43631,88,1351,276,1072,13034,279
37539,21,545,1811,456,4364,89
4024,8,203,3580,175,5255,28
27375,3,57,2342,51,1396,6
37866,11,230,1788,182,4344,48
26654,18,407,2379,347,3029,60
9330,3,487,3293,211,2435,276
42150,4,126,1354,100,3367,26
43090,42,661,696,451,5843,210
42500,11,216,1026,178,2449,38
35400,357,6022,1948,4963,23304,1059
30669,163,3391,2163,2936,14476,455
1679,79,1642,3661,1380,21725,262
6204,4,126,3483,115,2352,11
28547,17,436,2273,358,6461,78
18984,2,73,2760,64,3048,9
17432,44,1468,2827,1297,22605,171
43425,11,208,411,161,2678,47
574,4,234,4408,194,7291,40
43650,13,183,246,156,2575,27
23107,69,1619,2541,1413,16076,206
26379,9,163,2390,131,2309,32
3930,34,815,3584,715,8686,100
16176,18,393,2894,315,5169,78
43026,183,1976,753,1634,19268,342
33050,4,115,2050,90,2565,25
10031,10,272,3256,247,5041,25
9425,6,436,3287,392,9704,44
20055,13,312,2706,269,4608,43
43529,2,68,346,51,704,17
43756,5,31,225,29,1222,2
30205,128,2484,2189,2040,25593,444
43807,2,31,179,21,867,10
43567,4,26,326,23,1061,3
42754,83,801,892,638,9403,163
42421,4,83,1109,66,3309,17
6149,1,89,3485,77,3435,12
43767,4,60,213,42,1063,18
10192,7,323,3248,204,4182,119
12735,12,203,3114,136,2806,67
43297,29,250,509,202,3503,48
3880,7024,167967,3585,125453,1003138,42514
43242,6,91,557,69,1913,22
43806,35,571,180,512,8708,59
6131,4,117,3486,96,2876,21
28768,2,106,2261,85,3110,21
42416,32,500,1115,398,4795,102
30696,463,8682,2161,7328,30507,1354
38170,848,18721,1768,15754,64980,2967
23197,56,978,2537,807,6003,171
42122,4,202,1390,178,4643,24
25085,111,1868,2449,1587,13843,281
1054,4,144,3910,131,5809,13
43159,5,126,606,95,1787,31
20882,27,413,2660,311,5029,102
43232,83,780,563,583,4124,197
1059,24,9364,3909,3464,17924,5900
1756,20,2234,3639,1029,4439,1205
583,1,68,4456,61,4050,7
43549,0,42,336,26,767,16
1271,2,126,3843,110,3590,16
1535,1,42,3693,36,2095,6
43112,85,1013,666,890,9851,123
42125,295,5246,1389,4157,44755,1089
41589,1280,27662,1484,21895,164033,5767
43327,185,2788,477,1945,14916,843
39939,28,649,1655,545,5437,104
42226,4694,84479,1271,63494,302347,20985
1209,53,965,3861,888,16507,77
42589,2,86,943,61,5521,25
42985,84,1106,793,842,5755,264
43597,3,29,301,27,1104,2
15341,3,96,2931,76,2177,20
32461,4,95,2075,81,4458,14
42602,4,92,941,73,3176,19
3653,9,233,3591,202,5319,31
19028,22,883,2758,760,8330,123
1699,6,134,3659,107,3479,27
43792,4,28,195,20,1794,8
25670,5,123,2422,109,9802,14
43130,158,2432,632,1726,17440,706
28861,325,5369,2256,4301,40629,1068
18689,3,117,2771,99,2455,18
41654,76,1391,1474,1027,17667,364
6046,13,183,3488,165,2734,18
41726,5,159,1463,110,3963,49
42141,6,151,1364,124,5489,27
3874,122,1995,3585,1570,13431,425
41046,5,168,1562,128,3249,40
15054,9,157,2945,136,2673,21
42133,7,96,1382,78,3637,18
20499,20,744,2683,701,6836,43
42209,155,3528,1293,2390,22946,1138
7101,4,132,3441,120,4160,12
1598,3,99,3680,87,2577,12
43477,16,292,377,207,2607,85
13122,13,256,3090,209,3587,47
42247,40,503,1259,429,6789,74
43473,5,133,381,96,2778,37
42372,35,394,1137,357,7814,37
43634,8,89,276,84,1946,5
42462,37,685,1058,497,9719,188
37427,39,508,1818,414,4571,94
10994,82,1698,3206,1319,12939,379
39125,193,3005,1704,2564,18199,441
38056,20,553,1777,439,10450,114
15451,10,364,2927,326,5228,38
27304,177,3701,2347,3167,20882,534
21875,181,3545,2603,2907,26649,638
23065,37,717,2543,513,8910,204
42311,11,196,1197,156,4164,40
5304,5,992,3525,433,2170,559
1268,5,117,3843,100,3533,17
43412,7,105,415,50,1599,55
42943,2,58,800,38,2339,20
18108,25,553,2797,461,5288,92
21948,48,606,2599,520,6418,86
27222,67,1141,2352,876,7952,265
43325,33,374,483,274,3796,100
43439,29,368,399,313,3878,55
26573,0,123,2382,107,2596,16
27454,26,431,2338,369,4901,62
42130,51,677,1386,506,6385,171
43249,26,312,552,262,5109,50
1526,6,142,3699,123,3483,19
8348,0,44,3353,39,2162,5
21677,5,140,2613,135,2858,5
31389,10,323,2129,273,5150,50
42379,29,558,1134,459,3649,99
25337,7,95,2438,88,1401,7
42703,53,676,908,486,5110,190
43081,357,4066,705,3323,22833,743
22788,50,733,2557,617,7674,116
43614,2,55,291,20,727,35
43675,8,113,257,103,1840,10
3917,24,709,3584,647,13395,62
27860,18,371,2314,306,4987,65
23676,186,3805,2513,2755,27220,1050
8013,11,245,3379,216,2321,29
38472,55,953,1747,809,5804,144
13407,13,236,3064,195,2915,41
26733,6,86,2375,69,1715,17
8380,224,4481,3351,3842,71438,639
6129,5,378,3486,300,9638,78
14679,1,84,2969,74,3055,10
1274,19,614,3842,486,11061,128
40636,5,179,1600,155,4411,24
43178,33,296,595,202,3458,94
42233,67,731,1266,571,6361,160
42173,27,702,1330,623,5471,79
6101,34,697,3486,489,7539,208
32173,24,453,2088,410,13306,43
31051,1042,32201,2147,26547,111717,5654
42376,126,2250,1135,1902,25860,348
43521,2,67,348,45,963,22
38235,12,218,1764,203,5869,15
43625,0,28,278,18,924,10
1336,6,188,3813,161,4463,27
984,2,101,3936,91,3097,10
43672,5,50,258,18,919,32
33049,2,86,2050,76,4659,10
12651,5,109,3119,92,2258,17
11904,47,1467,3160,1292,27062,175
42428,10,176,1100,131,3875,45
43847,2,9,157,5,313,4
30047,27,462,2198,414,3954,48
43466,9,99,388,57,1354,42
43479,83,1015,376,666,29605,349
43296,22,524,514,378,7959,146
8019,1,71,3379,66,5133,5
42493,47,498,1031,413,5546,85
43411,27,410,415,313,6321,97
22933,193,3996,2548,3205,25762,791
43206,44,228,577,197,2377,31
1218,1,77,3861,64,3717,13
14924,6,102,2953,82,2901,20
43779,18,217,206,200,4670,17
42733,41,641,901,417,7625,224
42693,236,3834,912,3255,28382,579
8008,4,150,3379,121,3352,29
32210,174,3401,2086,2943,15273,458
40760,15,200,1588,177,4910,23
16090,27,971,2897,875,15389,96
43175,83,1047,597,789,12222,258
43360,11,125,451,109,2393,16
42213,6,49,1288,37,2655,12
42744,109,1317,895,949,11193,368
26348,299,16728,2392,12546,82571,4182
42931,15,454,811,332,5529,122
37058,6,67,1841,58,3569,9
42471,8,113,1051,95,2481,18
43061,3,40,719,30,1450,10
22029,63,978,2593,796,7880,182
1666,6,203,3663,157,3793,46
18104,9,348,2797,317,4485,31
6757,41,1851,3459,1136,6472,715
1479,17,449,3712,339,3305,110
42558,111,1914,990,1643,9297,271
42433,22,456,1096,355,6441,101
42498,11,204,1026,161,2528,43
6932,1190,28394,3451,21545,186537,6849
43083,289,3468,701,2807,16257,661
34046,49,831,2014,667,6841,164
14949,24,628,2952,515,6179,113
1545,148,3192,3690,2823,31412,369
6209,9,208,3483,181,6140,27
43762,135,1921,216,1642,11227,279
18927,8,272,2762,235,5512,37
23770,6,117,2509,105,3627,12
43485,2,37,373,28,1144,9
1006,51,1138,3930,997,15952,141
22441,15,172,2574,133,2329,39
43070,37,436,716,368,5140,68
42079,1,12,1400,10,1018,2
1227,3,115,3859,94,3339,21
30958,38,476,2151,371,6355,105
3652,27,877,3591,743,14976,134
43488,94,935,370,736,5869,199
42263,1,63,1233,42,2247,21
24391,10,313,2480,224,4033,89
42237,5,150,1266,127,3242,23
43016,56,1204,766,992,11029,212
39024,1,51,1711,46,1680,5
25270,6,163,2441,141,1674,22
42629,115,2355,933,2080,18218,275
43505,5,86,357,69,1645,17
1423,191,4191,3739,3679,25990,512
42936,10,99,807,68,1312,31
26913,12,323,2366,298,3572,25
6169,16,480,3484,432,7254,48
16202,286,15138,2893,12523,105555,2615
31066,9,181,2146,158,4716,23
43193,59,801,588,585,13799,216
31997,6,143,2097,124,2515,19
43585,0,10,308,6,935,4
25930,4,170,2411,146,3533,24
25409,163,2835,2435,2428,28098,407
42291,90,2325,1211,2000,21782,325
42149,159,2476,1354,1762,23661,714
40521,9,133,1610,109,3659,24
34387,22,397,2002,321,10730,76
1420,59,1073,3739,957,6753,116
42677,83,1672,915,993,8045,679
27848,1,80,2315,65,2158,15
43656,2,101,225,82,1554,19
6211,13,547,3483,465,9478,82
33380,5,305,2038,278,5903,27
27198,9,159,2353,131,5763,28
42223,7,138,1272,119,4230,19
43404,2,47,419,30,817,17
33432,205,2908,2036,2443,32569,465
42359,135,2033,1143,1457,16788,576
25386,31,583,2436,539,4572,44
37963,38,806,1782,702,6957,104
33408,1,62,2037,47,1510,15
1126,8,333,3891,300,5969,33
6044,66,1382,3488,1184,6346,198
30049,29,654,2198,547,9049,107
9414,18,420,3288,338,6528,82
6858,6,124,3454,103,2790,21
28552,295,6183,2273,5116,29374,1067
42256,37,468,1247,363,9567,105
29464,585,17558,2225,14022,45875,3536
14414,117,3291,2987,2727,21551,564
1125,2,45,3891,40,2957,5
43514,1,13,351,9,874,4
43129,95,1321,632,931,15102,390
30763,8,192,2159,159,2070,33
34422,5,166,2000,144,7229,22
42581,4,138,951,117,2958,21
30199,15,233,2190,202,4654,31
11194,96,1624,3195,1283,9543,341
1036,15,238,3916,203,6765,35
35089,3,68,1964,60,2822,8
43825,2,39,169,27,628,12
1765,0,0,3635,0,4815,0
37803,10,218,1793,178,3786,40
30917,45,1156,2153,970,8010,186
16114,10,140,2896,118,2288,22
1049,4,230,3910,209,5711,21
7118,4,301,3440,251,5185,50
19727,15,262,2724,229,3784,33
1197,41,971,3864,886,14896,85
1673,25,554,3661,482,13301,72
18982,61,1390,2760,1106,9448,284
42063,13,217,1403,205,5500,12
37737,9,206,1798,186,4673,20
43851,1,46,153,33,738,13
28800,1,107,2260,90,3373,17
42091,2,35,1399,31,1677,4
28858,84,2884,2256,2406,20390,478
7430,0,49,3422,42,1978,7
43777,4,64,207,41,950,23
9754,393,24620,3270,21057,111181,3563
35938,1,53,1908,40,2104,13
1051,5,116,3910,102,3319,14
43174,14,89,597,72,1491,17
43822,4,50,172,29,763,21
3105,4,282,3601,181,3048,101
43258,6,41,544,27,2408,14
13504,130,2386,3056,1972,31089,414
22138,6,199,2588,176,9304,23
22956,16,310,2547,258,6371,52
42424,5,131,1108,109,5870,22
25147,150,3009,2446,2559,21418,450
8318,24,611,3356,539,13107,72
43162,22,300,606,251,3128,49
33639,43,704,2028,602,9146,102
6030,6,91,3489,78,2168,13
1068,17,404,3907,358,7632,46
34074,10,168,2013,136,4357,32
1297,27,639,3833,557,8360,82
18971,1,126,2760,115,2413,11
9337,1,62,3293,54,3394,8
1013,0,7,3927,6,1890,1
28772,20,316,2261,268,4580,48
43596,8,84,301,50,1473,34
43447,36,607,395,552,5123,55
43635,34,441,276,396,5353,45
42116,28,230,1393,184,3635,46
43620,101,1049,283,747,10050,302
1356,15,8314,3799,4028,5169,4286
33370,41,698,2038,584,5442,114
43204,36,425,580,303,5081,122
42230,12,191,1269,154,2650,37
8517,15,338,3343,314,3819,24
42172,79,1034,1330,881,13876,153
23233,61,978,2535,801,6344,177
37330,47,798,1825,702,8419,96
24857,19,414,2459,361,3615,53
42945,98,1289,798,1035,15311,254
24561,82,1151,2472,990,10032,161
42329,6,166,1174,143,2828,23
29817,32,690,2209,582,9125,108
18825,4,200,2765,182,4984,18
41238,16,297,1536,220,4241,77
43691,8,50,253,40,1315,10
39748,10,181,1668,159,3933,22
34418,117,1381,2000,1211,12162,170
43569,0,139,1719,108,3485,31
43281,12,159,525,130,2187,29
43165,12,148,454,106,4359,42
42896,1,52,830,27,1451,25
6208,11,393,3483,353,4774,40
1477,2,90,3712,66,2462,24
23408,2,108,2526,94,7010,14
43167,25,272,599,195,3452,77
36873,3906,90721,1852,66120,290479,24601
34846,97,1753,1977,1443,14646,310
993,13,368,3933,316,11105,52
42275,2,58,1223,48,2128,10
39348,261,8021,1690,6696,27491,1325
42822,10,201,852,131,5509,70
22601,68,976,2565,817,7363,159
28848,4,217,2257,200,5249,17
43321,0,33,486,23,1187,10
42613,106,1347,938,1045,9311,302
31248,20,284,2137,233,7359,51
29469,20,794,2225,611,13745,183
42933,395,6028,809,5090,35778,938
38464,19,384,1747,301,6266,83
43364,21,415,448,264,4010,151
21252,3,182,2637,149,3304,33
43341,137,2007,466,1623,15929,384
9407,59,2785,3288,2092,20459,693
43429,52,733,409,616,6855,117
1500,25,501,3710,448,5010,53
39446,5,84,1685,67,3454,17
43618,5,51,284,49,1079,2
22189,71,1604,2586,1424,16034,180
15454,4,153,2927,134,1972,19
43546,5,57,337,40,1705,17
23334,4,102,2530,86,5413,16
42522,231,2803,1013,2319,18142,484
1081,7,223,3902,205,8622,18
41102,4603,133638,1555,102623,539041,31015
998,355,8651,3932,7105,68999,1546
13198,29,1102,3078,892,9953,210
34852,22,244,1976,218,6688,26
43043,11,162,740,110,2859,52
34970,14,225,1970,187,4343,38
14843,2,128,2958,111,8403,17
21710,143,2602,2611,2073,16782,529
43803,5,36,183,23,417,13
22616,16,388,2565,335,5034,53
42952,127,2045,796,1522,7412,523
14689,6,280,2969,238,6398,42
43367,23,455,445,318,5007,137
1210,55,1107,3861,995,15983,112
42893,3,57,830,37,2024,20
43276,7,108,528,72,1971,36
8920,10,313,3319,276,11256,37
6095,7,123,3486,115,1668,8
1597,2,70,3680,54,3453,16
6045,2,140,3488,103,3010,37
42578,26,293,956,245,7939,48
42804,1,52,856,24,1462,28
6018,9,214,3489,146,3018,68
38444,17,417,1749,349,8223,68
30360,1,115,2180,100,5182,15
6126,7,229,3486,202,5082,27
43375,196,4278,438,3154,36886,1124
7391,20,306,3425,279,3584,27
1600,2,51,3679,43,1975,8
11950,3,296,3158,265,6905,31
42309,103,1963,1199,1675,15377,288
34480,8,146,1998,127,3600,19
42196,884,13278,1306,10297,89839,2981
19350,6,257,2743,193,6041,64
8479,55,2657,3345,1536,10694,1121
15529,0,120,2923,97,3696,23
43459,2,64,395,42,1377,22
1018,2,49,3925,39,3295,10
1213,5,251,3861,232,4619,19
40494,31,680,1612,511,8611,169
43244,27,214,556,183,3069,31
23890,59,1517,2504,1356,7354,161
1211,7,212,3861,189,7540,23
15595,14,355,2919,284,4170,71
37001,92,1958,1845,1684,26920,274
30152,26,454,2193,409,3885,45
43177,164,1732,595,1396,14866,336
42308,7,114,1199,98,3653,16
28884,1,30,2256,25,1348,5
16991,10,344,2852,312,7480,32
1289,3,113,3836,99,4456,14
1426,169,3823,3739,3360,29278,463
42415,16,367,1116,277,9631,90
43076,50,732,710,497,9006,235
43168,5,70,599,41,1904,29
41635,10,219,1478,166,9641,53
42925,12,108,820,68,2269,40
7407,8,173,3424,155,3039,18
994,151,4799,3933,4217,47418,582
1730,9,209,3649,189,6166,20
6528,11,638,3469,510,7738,128
35580,72,1421,1935,1155,11067,266
36876,24,445,1852,399,5032,46
1565,3,55,3685,50,1907,5
43345,1,41,463,34,2333,7
23012,3,102,2545,93,2135,9
25650,79,2251,2423,1920,9957,331
40500,4,138,1611,119,2694,19
42661,104,937,920,717,6774,220
35750,2,154,1922,125,4446,29
43098,110,1462,684,1123,8190,339
40994,106,1644,1568,1342,8538,302
43556,5,66,330,56,2242,10
16327,14,558,2886,491,7031,67
37243,1,62,1830,53,2167,9
1534,17,407,3693,357,11902,50
43153,156,2099,609,1562,9427,537
43237,55,512,559,345,4980,167
27123,5,138,2358,107,2899,31
42507,34,345,1024,291,6947,54
43217,6,56,567,44,1576,12
43513,5,58,351,41,1216,17
974,20,754,3941,669,11122,85
40421,10,319,1619,265,5896,54
42239,61,950,1264,769,7168,181
11898,86,3297,3160,2468,34195,829
28406,27,650,2282,536,14213,114
43559,11,166,330,132,1755,34
1217,17,216,3861,185,3768,31
43267,47,560,536,425,3670,135
20928,24,442,2657,358,6551,84
43136,22,213,628,160,4231,53
1633,15,263,3673,215,20703,48
42460,15,217,1063,160,8914,57
43580,4,51,312,39,811,12
42518,29,457,1014,352,8429,105
42378,60,764,1134,607,4248,157
2548,6,446,3610,293,4615,153
14627,2,111,2973,89,3213,22
42861,22,157,832,133,3632,24
1445,0,39,3737,30,1921,9
1099,10,254,3897,230,6155,24
11665,11,220,3171,183,3249,37
43173,0,32,598,25,1381,7
35483,16,498,1942,437,12569,61
27905,51,1155,2311,985,9532,170
43534,2,24,341,22,1010,2
22928,3,82,2548,70,3439,12
22207,11,306,2585,271,4806,35
43332,38,566,471,447,3936,119
3936,10,422,3584,374,7552,48
42884,4,49,830,29,1131,20
42438,17,244,1091,169,5304,75
23815,26,389,2507,349,5545,40
42560,80,1191,986,1006,13119,185
43508,22,309,354,265,3657,44
32506,100,2284,2073,1576,17074,708
3470,3,760,3594,273,2643,487
5846,74,1546,3497,1288,16743,258
7206,6,159,3435,132,2640,27
40204,119,2665,1638,2352,22747,313
37328,120,1666,1825,1328,13229,338
12961,25,818,3101,736,10151,82
43381,21,295,433,199,4261,96
42417,324,4448,1115,3567,25733,881
1077,24,1390,3904,1234,31117,156
43403,6,60,419,48,1419,12
1194,107,2188,3864,1887,26490,301
42729,44,1548,892,1135,7502,413
1427,223,4189,3739,3369,44256,820
43499,6,67,360,43,908,24
42456,31,437,1069,344,7905,93
18447,1,82,2782,73,3868,9
42511,55,725,1019,577,5929,148
6497,9,112,3470,101,2841,11
32579,5,245,2070,178,7138,67
21375,40,779,2631,688,4732,91
43399,76,938,419,727,8515,211
6363,8,182,3476,160,3671,22
42301,80,1004,1201,815,7428,189
1486,26,661,3711,468,5585,193
21827,1,42,2606,36,2694,6
42016,6,102,1411,81,2952,21
43877,0,8,134,5,345,3
43434,4,129,401,85,2122,44
42093,15,264,1399,220,3222,44
37913,20,401,1785,327,7339,74
37535,7,195,1811,168,7844,27
43480,16,227,376,162,2648,65
12273,3,133,3140,111,2655,22
1470,5,119,3713,109,2878,10
38352,67,1534,1754,1250,11515,284
14892,8,116,2955,100,3007,16
39573,3,126,1677,113,4395,13
42888,5,67,830,57,2633,10
1587,17,577,3681,429,5686,148
1688,1,38,3660,35,1752,3
1203,19,727,3862,667,15166,60
43054,17,260,729,123,4268,137
42938,12,137,804,88,2097,49
43034,33,547,749,409,5641,138
42875,3,113,830,55,1711,58
18290,4,135,2789,118,2508,17
19743,12,202,2723,169,3110,33
35948,44,1295,1907,1113,23907,182
12737,293,4670,3114,3819,31811,851
43502,31,235,359,213,2674,22
11151,2,85,3197,74,4503,11
43483,2,89,375,63,1659,26
14352,3,105,2992,96,6796,9
43515,3,66,351,46,977,20
30791,176,4694,2157,3748,31883,946
22076,31,339,2591,260,3268,79
42086,42,701,1399,593,6749,108
43562,3,71,328,35,1106,36
6170,20,456,3484,394,9682,62
29206,108,1823,2239,1550,10307,273
6143,30,977,3485,870,14490,107
42492,47,538,1032,408,10821,130
1335,9,170,3814,152,3759,18
541,11,258,4399,221,6154,37
4618,5,167,3559,131,2135,36
5543,31,799,3513,727,19850,72
6102,28,812,3486,600,8837,212
14257,8,228,3000,190,4118,38
41280,18,492,1529,413,9196,79
43324,4,25,483,20,1149,5
28236,5,97,2292,73,2095,24
1472,6,75,3712,63,2481,12
42153,63,1024,1348,814,13006,210
43612,7,101,291,87,1500,14
1233,10,146,3858,129,4067,17
43686,0,11,254,10,468,1
40967,103,1397,1570,1187,11587,210
28269,1,89,2290,73,2947,16
43186,14,166,593,120,2005,46
39828,3,84,1663,75,4351,9
33426,124,2649,2037,2241,15345,408
43074,11,198,711,135,4407,63
1556,1,90,3687,78,4485,12
43182,25,290,594,237,4325,53
31940,15,326,2101,290,4949,36
10290,7,144,3244,134,2313,10
42381,3,141,1133,120,6358,21
37578,27,509,1808,425,12031,84
27987,20,363,2306,311,3231,52
42350,12,317,1151,226,4818,91
43095,31,463,693,304,4557,159
27239,32,483,2351,403,8661,80
42192,5,128,1307,104,2659,24
8715,23,647,3330,544,6761,103
42528,50,765,1009,605,6838,160
43270,17,204,532,178,4210,26
43550,6,200,335,120,4449,80
43171,30,270,598,202,2154,68
27306,361,7144,2347,5693,42964,1451
43372,13,232,443,150,3021,82
14971,12,293,2951,265,4353,28
42907,20,307,824,181,4857,126
20500,18,599,2683,520,6991,79
40958,11,265,1571,241,7379,24
21981,105,3056,2596,2618,13666,438
43753,14,209,225,142,1392,67
1048,42,889,3911,764,11790,125
37228,6,140,1831,123,10031,17
9235,56,1387,3300,1188,22148,199
20557,53,3569,2680,2600,21753,969
12105,2,45,3150,37,1798,8
42988,71,966,793,731,5080,235
30679,5,140,2162,125,2758,15
6146,4,155,3485,114,2743,41
43592,3,63,304,52,1278,11
26544,21,325,2383,272,4012,53
42266,30,390,1230,324,3722,66
43674,2,39,257,22,906,17
43038,8,112,744,70,2315,42
43576,30,336,315,238,3929,98
43595,10,120,302,101,1917,19
22862,7,334,2553,295,6859,39
10272,21,1312,3245,717,4374,595
6035,8,436,3488,394,6557,42
38773,94,1372,1726,1117,11623,255
4588,6,824,3560,298,2275,526
9495,15,482,3282,444,12570,38
38823,2,104,1723,85,2548,19
985,92,3281,3936,2928,30381,353
6024,0,76,3489,64,2562,12
10059,65,2794,3254,2238,46008,556
8708,1,68,3330,57,2125,11
1669,5,132,3662,114,6904,18
4684,3,438,3557,315,3698,123
43125,16,109,639,96,2646,13
42162,30,325,1339,258,2723,67
42071,5,237,1402,202,2994,35
7204,3,129,3435,109,3035,20
999,2,72,3932,66,3967,6
42271,266,3909,1227,3441,21982,468
42331,3,97,1172,75,2714,22
43046,18,219,735,153,3073,66
4388,4,367,3568,202,6359,165
42325,18,448,1180,396,7054,52
7170,13,4771,3437,1720,15913,3051
27305,228,4403,2347,3710,27075,693
13877,20,1100,3027,962,8076,138
23363,298,5218,2528,4112,18038,1106
43690,3,63,253,36,920,27
43362,2,59,451,50,3795,9
43741,2,28,230,19,571,9
42132,12,314,1382,273,4581,41
40073,0,426,1646,389,6134,37
43238,211,2986,558,2309,16834,677
43453,9,195,395,151,2482,44
12378,5,291,3134,152,3331,139
43511,54,763,352,551,4458,212
25351,6,94,2438,83,2321,11
7662,66,2108,3409,1511,10563,597
36009,12,248,1902,199,5052,49
43636,6,46,276,32,1074,14
27565,2,131,2330,110,2744,21
585,6,112,4457,92,8342,20
43357,13,109,454,75,2372,34
33095,1,150,2048,119,3462,31
6064,5,113,3487,99,3000,14
34364,4,130,2003,108,4481,22
6052,6,86,3488,70,2018,16
42576,92,1024,958,839,6796,185
1569,10,124,3685,112,5427,12
1489,67,1119,3711,989,13167,130
17872,3,176,2809,157,4614,19
43089,8,78,696,61,2071,17
42332,120,3008,1171,1992,25264,1016
43734,11,87,233,66,1087,21
28744,288,8780,2262,7579,31376,1201
27057,6,89,2362,77,2436,12
37509,12,279,1813,230,3996,49
43354,2,49,454,36,1418,13
36459,13,166,1877,127,3340,39
43780,0,10,205,7,666,3
43420,129,2097,411,1676,9845,421
43353,37,423,457,297,3655,126
1379,1,74,3772,59,6258,15
43454,3,40,396,23,1330,17
43021,39,421,760,355,4601,66
43331,41,526,473,423,4522,103
43680,29,466,256,400,4213,66
35478,4,220,1943,184,2997,36
30835,11,151,2155,124,3060,27
31814,3,93,2106,81,3141,12
43278,17,198,526,156,2206,42
42365,17,291,1138,237,4820,54
43848,1,35,157,28,975,7
42194,14,305,1307,235,4571,70
28860,0,37,2256,30,2029,7
42340,63,1642,1166,1253,13716,389
43644,15,93,270,81,2969,12
43099,2,40,684,32,1990,8
20602,1,33,2678,30,2582,3
43340,43,644,467,555,5748,89
23108,17,508,2541,424,7052,84
26905,10,164,2366,141,2913,23
5762,10,274,3502,239,6602,35
1731,6,193,3648,156,4980,37
1672,68,1020,3661,914,16517,106
8718,39,1017,3330,707,11142,310
43307,1,24,499,19,1071,5
1421,106,2738,3739,2440,19487,298
1214,4,161,3861,138,4897,23
1774,3,118,3633,100,2370,18
27062,2,340,2362,282,3749,58
1422,256,5851,3739,4940,49400,911
43087,525,6535,699,5168,31459,1367
1686,4,103,3660,85,2814,18
20701,4,68,2672,62,1785,6
42154,14,269,1348,232,5558,37
43075,106,7141,711,5599,12093,1542
43284,18,142,524,110,2023,32
10354,12,346,3241,279,5414,67
10411,11,1606,3239,919,11047,687
43414,28,275,414,230,2408,45
43841,2,27,159,22,578,5
37362,3,174,1823,140,5283,34
20028,6,170,2707,151,2980,19
1002,49,1972,3931,1682,16667,290
28867,4,117,2256,92,2164,25
6683,14,824,3462,712,19611,112
23663,72,1076,2513,869,8368,207
28421,3,109,2282,89,5808,20
3879,2087,44152,3585,34907,143282,9245
8670,2,123,3333,114,3796,9
42385,19,514,1131,387,5320,127
43294,15,127,515,94,2475,33
17379,67,1111,2829,982,7134,129
41717,64,1063,1464,916,19217,147
43843,2,16,147,11,414,5
20596,5,65,2678,58,2444,7
42193,17,263,1307,229,4299,34
43241,118,1319,557,1052,10268,267
6043,8,312,3488,279,3660,33
2084,6,411,3618,259,3694,152
28862,15,479,2256,388,5861,91
7147,4,94,3438,83,3401,11
43545,2,77,338,55,1855,22
1789,103,2131,3628,1908,26163,223
8620,9,389,3336,342,5660,47
43610,5,46,292,32,1059,14
25731,4,212,2420,186,4160,26
8249,12,252,3361,175,2633,77
42268,27,476,1229,345,8743,131
42998,24,375,782,290,5860,85
41239,10,151,1536,142,7682,9
42113,159,3413,1394,2898,12527,515
1570,126,4603,3685,3923,31576,680
28275,3,96,2290,81,2410,15
42157,19,245,1344,210,4502,35
43227,12,152,565,113,3287,39
43839,5,91,161,73,1237,18
26620,1,46,2380,36,1829,10
43493,10,133,368,90,1938,43
15718,1,71,2914,64,3214,7
43484,73,947,374,737,7059,210
23066,25,847,2543,719,9200,128
43813,3,50,177,37,574,13
1701,0,32,3659,29,2073,3
43086,53,601,699,508,4715,93
43166,7,228,600,167,3595,61
8443,2,63,3348,51,1910,12
940,8,644,3950,600,7689,44
43504,2,33,358,27,1261,6
43313,12,231,476,163,4629,68
27280,114,1705,2349,1406,14632,299
43133,117,1468,630,1109,11563,359
43103,74,1018,680,666,8422,352
43836,5,60,163,46,672,14
42310,42,708,1199,581,9154,127
43651,10,152,229,131,2151,21
25111,10,306,2447,267,3939,39
42393,3,218,1130,177,4462,41
36945,8755,191878,1849,126802,1014123,65076
43310,18,520,496,388,3226,132
42478,8,160,1046,118,2372,42
7826,28,837,3397,741,12935,96
43830,2,35,166,20,659,15
42319,8,115,1187,95,2866,20
43646,17,168,268,151,3347,17
1034,6,114,3917,104,4033,10
43828,10,171,168,156,1869,15
27458,111,2189,2337,1744,18742,445
1560,12,231,3687,206,3544,25
26561,5,116,2382,104,2013,12
42577,8,89,957,63,1719,26
42812,44,345,854,287,8369,58
42989,81,1278,793,885,7413,393
42283,27,308,1218,208,6467,100
31068,3,184,2146,135,3363,49
39430,7,88,1686,71,7271,17
43639,3,58,274,43,1573,15
41127,6,111,1551,97,2919,14
42131,21,322,1383,255,4259,67
42499,18,251,1026,202,2890,49
43859,2,21,149,15,605,6
1216,9,159,3861,135,2836,24
41265,12,175,1531,136,3724,39
20927,32,582,2657,448,7167,134
38938,1,35,1716,28,2458,7
6051,20,421,3488,351,4372,70
42464,17,161,1057,145,5987,16
13971,38,522,3018,440,6617,82
8537,106,2951,3341,2181,14474,770
9768,16,189,3269,170,3061,19
33091,88,7896,2048,6348,23890,1548
42561,65,852,986,622,9368,230
43309,18,290,498,211,4676,79
42430,64,837,1098,595,7993,242
15546,34,1147,2922,917,21851,230
15606,2,74,2918,58,3821,16
36991,8,200,1846,171,5895,29
36360,36,706,1882,563,8821,143
15193,110,1856,2938,1501,11224,355
43020,1,45,762,29,2172,16
27082,10,393,2361,303,8447,90
43630,5,120,277,63,1568,57
24048,3,124,2496,112,2148,12
28830,45,960,2258,843,21750,117
3833,201,4249,3586,3415,30521,834
42758,584,8139,888,6323,41795,1816
43315,6,75,493,44,2046,31
34184,11,155,2010,132,3511,23
1417,116,3067,3739,2717,26732,350
42986,63,770,793,637,5926,133
3881,194,3413,3585,2891,32985,522
1544,18,441,3690,394,9827,47
8738,50,1118,3329,990,15334,128
42891,6,52,830,43,1957,9
41810,27,371,1444,340,7918,31
42505,16,237,1024,203,3264,34
982,6,171,3938,161,6945,10
41678,250,3790,1470,3251,24563,539
42940,16,167,802,120,3226,47
4531,1,14,3563,7,963,7
22684,68,2358,2562,2031,9339,327
22139,28,630,2588,548,8943,82
1480,0,21,3712,17,1619,4
42197,4,42,1304,37,3074,5
43183,35,262,594,201,3121,61
1136,4,207,3889,181,7800,26
42296,10,309,1208,173,5171,136
5724,10,187,3503,156,8808,31
42514,4,91,1016,65,5354,26
1466,1,49,3714,41,3248,8
43436,7,100,401,77,2853,23
38826,21,347,1723,290,6609,57
43386,18,384,427,259,3877,125
43818,9,100,175,81,2091,19
37000,17,278,1845,248,5345,30
42554,580,10665,994,9076,36318,1589
43248,63,937,552,671,11661,266
41714,27,894,1465,764,6744,130
42027,17,188,1410,162,7374,26
41727,0,27,1463,22,1407,5
3092,2,40,3601,34,2467,6
37854,131,1668,1789,1468,15573,200
14399,25,585,2988,490,8380,95
40026,19,273,1649,210,4207,63
1246,97,2263,3851,1868,10615,395
1745,133,3650,3644,3192,48103,458
10860,9,724,3213,433,7220,291
1415,52,848,3740,689,10556,159
40438,7,182,1617,153,3618,29
22373,35,792,2577,664,7359,128
17888,136,2375,2808,1911,17117,464
42307,1,32,1201,27,1953,5
43205,27,345,577,234,3196,111
36455,2,98,1878,80,9659,18
42979,251,5797,794,4480,31061,1317
43609,1,35,291,32,1267,3
28890,4,117,2255,95,2777,22
42201,7,141,1300,104,7821,37
43135,10,138,629,96,2916,42
22551,296,11594,2567,9585,28033,2009
35932,24,476,1908,431,4860,45
42535,76,1054,1004,819,11279,235
35482,11,209,1943,179,4223,30
14670,2,111,2970,97,3464,14
27264,26,405,2349,308,7912,97
43593,12,109,303,86,1756,23
23147,6,137,2539,111,3087,26
43809,1,64,178,59,694,5
42274,23,262,1225,225,3379,37
43835,18,241,165,226,3609,15
43774,3,50,208,40,750,10
34588,270,46943,1992,40251,54146,6692
42269,101,1757,1228,1384,14932,373
43306,15,471,499,317,6038,154
43124,135,1458,642,1184,8833,274
30562,121,2352,2169,1859,19952,493
42513,11,207,1016,170,2993,37
42632,7,62,932,47,1770,15
42160,55,585,1340,518,6442,67
43431,37,480,406,340,4488,140
27545,556,13528,2332,9780,67629,3748
4337,19,856,3569,642,6268,214
43239,10,189,558,149,3539,40
43498,4,124,362,73,2770,51
43647,9,171,246,142,1517,29
1442,12,587,3737,500,8100,87
42504,135,1846,1025,1389,19239,457
1088,13,458,3901,395,12684,63
43458,3,81,396,63,1197,18
41789,41,582,1449,509,7312,73
43661,7,101,264,90,1390,11
1478,3,77,3712,70,3185,7
42388,14,193,1131,152,5651,41
42389,15,168,1131,133,5675,35
24298,10,429,2484,347,7727,82
43719,6,25,240,16,726,9
43305,17,292,500,196,5233,96
6039,63,1109,3488,954,11289,155
26243,2,82,2397,67,2294,15
43266,161,2455,537,1874,14083,581
42484,2,57,1042,40,1355,17
33854,60,1249,2020,1061,11321,188
23923,10,176,2502,148,3893,28
42673,154,1501,916,1237,14277,264
43067,11,134,718,96,2929,38
26290,4,56,2395,45,1738,11
6031,50,1209,3488,1004,19867,205
22443,10,281,2574,228,7424,53
1107,4,103,3895,93,6301,10
32643,23,339,2067,284,3916,55
29713,83,1384,2214,1171,11705,213
43382,12,142,433,128,3107,14
25630,209,2886,2424,2363,13098,523
7716,15,446,3406,376,5083,70
1540,44,637,3690,516,10244,121
1661,15,322,3665,266,9394,56
43606,34,435,295,354,2949,81
25746,5,130,2419,112,2828,18
1454,24,678,3721,474,6296,204
43789,5,98,199,62,957,36
43808,1,13,179,10,386,3
6205,20,407,3483,361,5965,46
12458,25,1385,3129,978,6021,407
43470,224,3567,384,2918,17374,649
38967,5,168,1714,141,3589,27
42139,325,7951,1368,6775,62348,1176
43260,24,242,542,152,3508,90
20505,2,111,2683,100,2376,11
19600,49,1630,2731,1380,6193,250
42622,6,146,935,103,2375,43
26557,4,113,2382,102,3044,11
43761,2,30,216,14,709,16
42392,126,2241,1130,1918,22917,323
25725,328,5852,2420,4941,26497,911
43342,2,39,466,27,1215,12
1665,5,207,3663,185,5413,22
572,0,34,4412,24,3086,10
43268,59,601,536,504,5576,97
43705,8,59,247,48,719,11
1667,56,909,3662,738,8438,171
4614,1,86,3559,72,1799,14
24867,10,232,2459,197,6781,35
6980,13,300,3447,269,5036,31
7438,3,151,3422,123,3531,28
41896,44,1134,1430,946,10900,188
43127,2,84,634,60,2310,24
43845,3,45,158,33,635,12
1635,6,385,3673,301,6217,84
31077,8,273,2145,244,6749,29
1790,4,135,3628,118,3527,17
22281,6,176,2581,146,4548,30
41030,0,0,1565,0,2220,0
27948,11,211,2308,173,4756,38
42847,29,353,839,255,5630,98
1112,41,1267,3894,1146,20249,121
1658,61,1063,3665,916,7444,147
43207,71,3579,576,1941,20328,1638
30023,17,264,2199,213,4241,51
43128,364,5237,633,4387,19920,850
1462,8,219,3717,181,3844,38
9806,0,83,3266,70,4402,13
43015,130,1960,767,1570,9622,390
43218,36,331,567,276,3959,55
6214,32,669,3483,558,13456,111
8303,7,264,3357,215,3404,49
42182,12,315,1321,233,11601,82
43152,169,2282,609,1730,12580,552
13582,7,132,3050,110,2658,22
42261,14,271,1235,218,4041,53
30831,105,1569,2156,1193,9450,376
43727,2,55,236,40,703,15
37921,4,68,1784,56,2477,12
43861,0,26,148,16,479,10
43398,3,57,420,43,1262,14
43062,16,161,719,122,3259,39
1702,1,40,3659,37,1751,3
38824,10,141,1723,118,2220,23
1563,3,73,3685,65,2061,8
30633,2,71,2165,59,2874,12
42110,2,51,1394,44,1565,7
34290,7,203,2006,175,3242,28
43676,5,70,257,46,896,24
42423,8,91,499,75,2254,16
43214,101,2066,571,1639,11230,427
43226,23,219,565,157,3994,62
5671,13,954,3506,524,3855,430
14703,1,65,2967,60,4247,5
29862,5,62,2206,46,2194,16
43492,0,14,369,11,710,3
42459,20,466,1064,384,9606,82
39329,328,6566,1691,5378,39396,1188
6006,3436,131063,3489,101629,447307,29434
43126,6,118,637,72,1795,46
33478,22,518,2034,446,8347,72
15313,42,1490,2932,1323,9155,167
5839,1,73,3497,67,2407,6
43416,200,3719,413,2953,16513,766
42092,39,838,1399,706,14932,132
1574,24,624,3684,539,8692,85
42455,11,89,1069,71,2366,18
43543,23,261,338,174,3566,87
42445,5,118,1080,98,5089,20
42996,61,643,782,476,3957,167
43784,1,30,202,11,699,19
14432,6,122,2986,104,3148,18
43213,92,1316,573,983,9333,333
21995,10,275,2595,233,7411,42
6589,14,809,3466,501,10970,308
5307,13,645,3525,587,8883,58
43024,13,174,755,119,3975,55
37010,130,2337,1845,1921,19194,416
30197,12,305,2190,253,3676,52
12590,41,907,3123,803,6066,104
6127,30,572,3486,488,6109,84
20712,0,92,2671,81,2296,11
42078,5,180,1400,170,5887,10
1629,12,302,3675,270,8373,32
43627,20,253,277,178,2960,75
12189,411,7406,3145,4768,37486,2638
42450,113,1916,1072,1685,13252,231
42082,1,43,1399,41,3730,2
5384,29,1237,3520,751,6507,486
43311,470,7713,494,6061,42191,1652
6019,11,194,3489,172,4122,22
8796,5,182,3325,149,2144,33
13974,16,525,3017,425,4206,100
30660,0,71,2163,61,2748,10
43640,10,294,3934,256,25773,38
23875,8,315,2504,267,7281,48
43211,52,578,575,439,3078,139
37602,2,143,1807,122,4036,21
43739,1,36,231,21,665,15
43538,3,54,340,33,873,21
29399,586,15646,2229,13136,63021,2510
29866,6,138,2206,121,3169,17
1725,7,207,3651,190,7002,17
40402,11,317,1621,261,6140,56
9791,4,356,3267,205,5649,151
1076,21,789,3905,723,14875,66
43622,8,99,279,65,1167,34
29695,3,160,2214,138,3589,22
1116,13,375,3892,331,6933,44
42418,42,833,1115,691,6886,142
42597,5,86,941,72,2715,14
21345,76,1310,2633,1103,8175,207
10351,4,149,3241,123,2650,26
42563,13,186,984,146,3835,40
10293,32,637,3244,568,8604,69
43291,138,1916,519,1462,10547,454
38822,24,287,1723,244,3514,43
19867,13,196,2716,171,3601,25
42257,132,2161,1244,1855,19652,306
958,42,754,3945,642,19585,112
1137,14,533,3889,453,13801,80
3476,1,62,3594,47,1618,15
28729,192,3792,2263,3200,13886,592
40060,56,922,1647,701,5586,221
43272,42,666,531,514,4857,152
21422,46,1326,2629,1143,22593,183
30268,0,80,2186,67,2373,13
19139,8,196,2754,176,2484,20
37804,9,311,1793,263,4494,48
1441,10,396,3737,332,7406,64
1700,72,1324,3659,1198,19654,126
19723,12,241,2724,213,3947,28
39956,18,458,1653,385,4124,73
43102,2,92,680,52,3433,40
22532,18,359,2568,303,5518,56
1634,243,5046,3673,4298,23662,748
32887,525,15589,2057,13179,56779,2410
41650,443,8457,1474,7121,43916,1336
42216,4,80,1280,72,2244,8
42322,12,327,1183,263,3137,64
43619,7,73,284,39,1412,34
42559,11,154,989,117,5909,37
43794,1,35,192,33,703,2
43348,108,1389,459,1123,10304,266
42467,60,906,1055,716,10100,190
42567,57,881,981,707,23087,174
1607,5,186,3679,148,3880,38
11174,11,268,3196,247,6430,21
5856,6,746,3497,400,8129,346
42719,64,4864,892,3446,18029,1418
43486,52,799,371,606,3544,193
41045,4,82,1562,69,2762,13
1110,17,331,3894,284,6174,47
1605,6,96,3679,80,3373,16
9057,1,442,3311,148,3145,294
43023,100,983,757,820,8717,163
3620,51,1188,3591,1037,15440,151
43410,35,493,416,432,3859,61
42937,4,153,805,115,5041,38
28113,3,111,2300,96,2155,15
1208,4,148,3861,133,5918,15
30387,17,550,2179,436,6296,114
11082,1,55,3202,43,2180,12
43001,721,13091,779,10544,39475,2547
43476,0,30,378,26,1105,4
17949,5,73,2804,62,3210,11
10152,3,123,3250,109,3193,14
43694,3,45,251,42,1362,3
43328,4,54,476,43,2036,11
3347,25,818,3597,602,12698,216
22617,10,248,2565,206,2825,42
43468,15,222,385,139,2194,83
567,9,343,4400,309,14185,34
43251,1,25,549,18,1527,7
34278,314,6731,2007,5369,45803,1362
15452,4,170,2927,149,2163,21
7960,6,144,3383,126,3703,18
27221,5,292,2352,251,5378,41
42565,5,77,983,61,1992,16
30424,37,472,2176,381,7273,91
15456,20,791,2927,710,12197,81
28750,4,130,2262,112,2400,18
43591,20,349,304,308,4725,41
43343,5,77,465,55,1787,22
43329,14,213,476,130,2065,83
42383,2,104,1133,91,3212,13
43533,4,58,342,45,729,13
43773,4,82,208,62,1417,20
6207,1,110,3483,104,3054,6
42667,5,62,918,50,1765,12
43005,6,184,776,145,3503,39
1103,14,322,3896,295,7164,27
19657,25,485,2728,426,4946,59
20998,1,137,2652,120,2559,17
42137,26,534,1374,429,9370,105
14680,5,296,2969,255,5490,41
42784,144,1325,868,1032,8258,293
22575,3,63,2566,50,2491,13
9069,16,920,3310,806,14809,114
43144,66,849,615,677,4839,172
30954,23,416,2151,370,3968,46
14861,3,511,2957,436,13160,75
22024,33,721,2594,542,7601,179
43882,4,39,131,32,336,7
42228,19,281,1270,258,4882,23
43185,58,908,593,626,7395,282
11040,9,219,3204,190,5202,29
28254,85,2231,2291,1894,49559,337
28866,14,231,2256,191,4294,40
43710,14,90,242,78,2558,12
10415,45,1116,3238,936,16894,180
43047,2,10,734,8,1382,2
40934,21,293,1572,241,4047,52
43603,80,928,296,776,6813,152
42941,98,1291,801,1114,9098,177
41161,23,358,1548,288,4592,70
43442,21,400,398,332,2756,68
42202,168,2746,1299,2353,17482,393
12259,0,357,3141,161,4422,196
4386,2,261,3568,202,3611,59
23651,5,120,2514,104,2315,16
1291,2,80,3836,67,3019,13
1469,2,67,3713,55,1861,12
32981,8,186,2053,159,5220,27
6167,7,395,3484,356,9957,39
40299,120,1914,1632,1546,14437,368
1456,9,9097,3720,4443,3338,4654
43720,12,195,240,161,1974,34
42159,458,8246,1341,5444,32951,2802
42432,6,71,1097,60,3946,11
43733,14,123,233,96,1241,27
42873,4,86,830,68,2491,18
42474,8,125,1048,106,2047,19
31167,44,1202,2141,1024,16399,178
43645,4,39,270,24,1010,15
43044,8,167,739,112,3595,55
6377,3,390,3475,175,2951,215
43225,50,538,565,370,5840,168
8890,3,100,3320,91,7108,9
34621,15,257,1990,201,4300,56
8012,8,170,3379,159,3217,11
21255,8,279,2637,230,3893,49
43497,6,50,364,36,1285,14
43377,15,196,436,145,2315,51
39405,35,1022,1687,843,12094,179
1430,152,2557,3739,2054,30000,503
42387,6,94,1131,72,2912,22
43509,4,49,354,37,1257,12
21528,161,3111,2622,2504,23820,607
5155,57,2302,3533,1450,11878,852
42851,121,1673,837,1347,8904,326
43427,2,56,410,29,1252,27
27969,11,276,2307,240,4451,36
8848,9,251,3322,235,4999,16
1025,4,70,3920,61,3193,9
42288,10,160,1215,144,3308,16
41803,32,517,1447,468,10074,49
42425,20,300,1107,217,5902,83
1033,41,780,3918,646,9622,134
6309,3,621,3478,263,1724,358
43317,16,180,491,114,2539,66
39337,9,217,1691,197,8131,20
24454,6,97,2478,92,2340,5
42171,38,926,1332,792,7514,134
1266,14,256,3843,226,7454,30
43286,50,902,517,652,7307,250
26791,12,209,2372,180,2086,29
30554,1,64,2169,56,9996,8
42919,77,1088,822,770,7834,318
43208,24,171,576,124,2120,47
16238,38,1316,2891,1207,7830,109
1121,5,101,3892,90,4246,11
5204,14,250,3530,218,3405,32
10569,42,2139,3230,1791,23778,348
43163,11,99,604,70,1786,29
1517,11,346,3701,329,7570,17
42496,5,55,1028,47,2352,8
37885,31,941,1787,824,6718,117
24666,63,1455,2467,1240,20660,215
43598,4,59,301,55,1596,4
43234,453,6243,562,4769,36486,1474
43528,56,2220,347,1747,7795,473
42700,10,180,909,129,7101,51
23195,4,201,2537,173,4789,28
43274,3,63,529,35,2035,28
36700,29,518,1864,421,4507,97
43525,4,41,348,39,1241,2
43575,16,195,316,177,3002,18
937,18,2938,3950,1341,11179,1597
34180,39,427,2010,344,3397,83
1315,9,485,3822,436,19286,49
34185,8,112,2010,92,2200,20
43564,5,53,326,28,1081,25
42731,17,1251,892,902,6005,349
8894,24,495,3320,424,4983,71
23981,585,12967,2499,11094,50419,1873
8597,3,67,3338,57,3023,10
4976,3,99,3543,83,5031,16
42189,123,2015,1315,1557,23224,458
6050,25,559,3488,442,5269,117
42336,24,187,1168,153,3134,34
1191,32,458,3865,404,9211,54
6125,6,258,3486,213,6008,45
35080,251,5388,1965,4606,25587,782
22969,284,6904,2547,5706,30719,1198
42254,4,62,1254,49,3749,13
43115,12,141,662,102,3870,39
1627,24,459,3675,328,3860,131
1642,6,212,3670,192,3620,20
43408,9,141,417,99,3398,42
9990,54,1794,3258,1643,15005,151
12547,287,6504,3126,5351,59308,1153
23876,2,69,2504,63,1985,6
27263,20,371,2349,306,4292,65
21156,277,10589,2643,9125,42233,1464
1656,21,283,3666,248,6670,35
42990,171,2420,789,2004,23668,416
3611,143,1934,3591,1652,15451,282
43203,4,92,580,62,1471,30
43066,20,269,718,213,3936,56
1724,4,76,3651,57,2856,19
31635,727,17644,2115,13273,121298,4371
1512,6,199,3706,183,5601,16
43326,40,604,480,440,4736,164
42382,6,106,1133,84,5077,22
25680,1,71,2422,61,1428,10
40439,73,1150,1617,952,7965,198
961,16,443,3945,370,8181,73
29602,26,458,2220,400,3655,58
43681,5,94,255,66,1649,28
43561,13,139,329,103,2268,36
42406,349,7421,1124,6083,33670,1338
40223,12,222,1637,199,5068,23
42509,2054,39974,1021,33197,209604,6777
43577,4,53,314,39,913,14
43222,35,389,566,327,2907,62
11984,6,272,3156,174,5552,98
1043,4,162,3914,151,9273,11
22259,7,115,2582,100,3586,15
42571,31,520,973,450,7993,70
25676,140,4129,2422,3458,22401,671
43892,0,17,128,17,457,0
41649,49,859,1474,601,8293,258
19717,64,1996,2725,1711,16669,285
8306,9,275,3357,225,12236,50
6847,24,476,3455,409,4965,67
42174,20,364,1330,295,3426,69
42186,52,660,1318,562,7307,98
43757,4,64,225,54,1877,10
42168,7,78,1334,70,7471,8
32675,32,1103,2066,891,9681,212
43077,238,2448,709,2175,21137,273
34522,37,673,1995,525,6126,148
42321,16,311,1185,260,6799,51
42177,88,1996,1328,1455,19781,541
39957,50,649,1653,523,9565,126
43689,7,103,253,75,1169,28
3877,8,152,3585,121,4981,31
43418,211,3749,412,2953,14450,796
23822,5,226,2507,182,7999,44
43842,2,48,159,36,869,12
37695,6,88,1802,77,1874,11
42999,12,117,781,86,2996,31
15457,8,191,2927,181,5484,10
1690,9,266,3659,212,11434,54
21985,59,1997,2596,1767,10222,230
33271,9,142,2042,121,4366,21
33185,6,130,2045,103,2636,27
43008,180,2584,772,1757,19507,827
42280,3,248,1220,204,4028,44
42564,42,642,984,507,5415,135
6029,8,151,3489,132,3401,19
35815,2,155,1916,137,6411,18
1538,4,165,3690,139,4811,26
38558,81,2498,1740,2187,9898,311
42255,52,923,1253,748,12297,175
42595,42,1365,943,943,7777,422
23274,4,236,2533,213,6788,23
1092,11,218,3901,136,3834,82
42134,201,3154,1380,2557,18898,597
1095,2,53,3900,48,4280,5
1369,6,215,3785,178,5594,37
43542,3,63,338,36,1409,27
42135,1,188,1377,154,3146,34
43785,2,53,202,39,1513,14
19006,52,1042,2759,869,8534,173
6013,12,305,3489,257,3077,48
43745,5,112,229,78,1358,34
42397,11,263,1129,220,3920,43
1647,5,58,3669,50,2602,8
19465,109,2205,2737,1904,8623,301
13279,56,1843,3074,1580,17137,263
1708,2,35,3657,32,3305,3
42553,11,137,996,121,2284,16
23346,290,5297,2529,4152,15780,1145
1135,54,1394,3890,1152,15815,242
1726,3,115,3650,102,3942,13
7967,9,140,3382,131,2673,9
1608,31,832,3679,736,22218,96
37899,22,881,1786,754,9937,127
43368,17,290,445,189,3098,101
42503,22,388,1026,323,4162,65
23870,2,103,2504,93,8177,10
43748,51,736,228,624,7490,112
42220,4,94,1274,79,2008,15
41658,498,7203,1474,6066,33002,1137
43006,72,600,773,483,9109,117
42523,211,2477,1013,2036,14294,441
42908,11,164,824,114,2221,50
1778,6,112,3632,100,3161,12
27708,32,431,2322,362,3480,69
42935,96,1282,808,965,16331,317
38976,24,614,1713,516,10338,98
42343,440,5994,1161,5056,32957,938
39442,13,236,1685,213,6337,23
29671,127,2189,2216,1842,11898,347
43471,28,255,383,215,1950,40
1003,72,1547,3931,1293,24376,254
43524,79,722,348,588,8267,134
42151,9,337,1351,279,5794,58
43082,14,88,702,78,2700,10
27448,23,608,2338,499,4964,109
43862,7,77,148,62,770,15
42524,70,1042,1012,839,10904,203
42112,56,1053,1394,914,10512,139
28864,9,226,2256,195,5604,31
6673,12,2095,3463,963,2572,1132
38272,35,731,1761,645,5221,86
1619,4,166,3677,145,3999,21
40031,29,363,1648,322,7003,41
6012,6,281,3489,235,2655,46
14156,6,445,3007,349,7687,96
6349,10,226,3476,190,3648,36
43394,14,178,423,131,6392,47
42827,5,217,847,115,2891,102
36599,6,237,1869,191,3159,46
41951,18,295,1421,255,6497,40
5554,18,309,3513,272,3568,37
15504,38,1064,2924,968,17539,96
34620,0,62,1990,59,5301,3
43110,460,5519,672,4573,29606,946
3870,114,1814,3585,1467,14409,347
1616,9,182,3678,136,5624,46
1109,13,210,3894,184,5010,26
26014,5,156,2407,128,7258,28
1590,20,305,3681,274,8998,31
42668,22,403,918,322,6636,81
23745,17,254,2510,219,4888,35
42353,7,121,1146,109,1896,12
23200,3,71,2537,67,3204,4
42339,33,390,1167,323,7405,67
43106,62,519,678,422,5141,97
18389,32,861,2784,782,5644,79
1698,5,138,3659,119,3394,19
42412,449,10323,1119,8384,36646,1939
43853,2,20,153,14,532,6
43683,4,61,255,33,1119,28
29407,4,328,2229,279,4469,49
1267,11,270,3843,240,7338,30
42536,4,101,1003,79,3511,22
6213,3,213,3483,194,5767,19
1199,6,192,3863,157,5391,35
37947,233,6637,1783,5803,28437,834
33216,5,105,2044,83,2383,22
42473,170,2878,1050,2003,22146,875
42836,38,385,844,336,5965,49
42934,55,1092,808,700,10877,392
1286,88,2524,3839,1750,16609,774
43867,0,6,146,6,204,0
43451,8,82,396,59,1118,23
43467,1,31,386,14,1164,17
28693,4,243,2265,215,10543,28
41360,27,348,1517,268,4324,80
6011,8,286,3489,238,2726,48
25740,2,80,2419,67,3051,13
20886,2,116,2660,102,2641,14
1643,17,233,3670,195,6441,38
31904,9,200,2102,173,3071,27
40979,18,347,1569,288,9831,59
42515,5,136,1016,107,3834,29
18016,163,2691,2800,2193,17193,498
28562,347,6693,2272,5529,24134,1164
19602,237,4467,2731,3676,29449,791
43079,25,232,707,190,4308,42
43744,0,27,229,19,727,8
32379,5,54,2078,46,2023,8
1659,19,684,3665,595,12865,89
21855,12,338,2605,298,5792,40
42405,335,7209,1124,6151,28857,1058
32509,43,833,2073,696,6404,137
42627,3,40,927,26,2221,14
42900,8,130,830,81,2979,49
42248,26,459,1258,408,4369,51
43027,3,111,752,78,2545,33
42927,18,224,805,157,3178,67
43670,1,38,258,27,833,11
27139,10,151,2357,119,1901,32
13779,4,218,3035,194,4161,24
42993,5,240,783,204,1999,36
42529,5,121,1009,86,5195,35
43772,0,24,208,14,620,10
14890,9,208,2955,168,3800,40
43628,30,296,277,262,2629,34
43287,5,74,523,62,1238,12
12830,9,246,3109,221,3494,25
25275,11,456,2441,369,4039,87
42390,8,105,1131,86,2979,19
40077,0,390,1646,360,6224,30
15626,12,438,2918,387,4562,51
33468,24,418,2034,373,4566,45
43339,154,1928,467,1458,9712,470
1717,21,368,3653,303,5780,65
43359,27,238,451,174,2675,64
12175,1,290,3146,155,2232,135
42143,9,133,1362,113,3492,20
43292,4,151,516,92,2309,59
42690,6,81,912,56,5509,25
43253,4,54,547,32,1265,22
42240,46,714,1264,561,8676,153
43407,47,694,418,592,5625,102
5550,6,185,3513,157,4066,28
27890,16,176,2312,152,3195,24
1371,2,145,3782,90,7568,55
42098,18,240,1399,201,3486,39
30209,12,238,2189,191,5167,47
43654,5,116,250,100,1319,16
27750,7,182,2320,164,2276,18
6686,10,333,3462,269,5384,64
42650,1,47,924,30,1754,17
42527,15,386,1009,285,3944,101
41542,255,5629,1492,4237,31636,1392
43863,1,34,148,23,1714,11
41588,55,721,1485,568,14221,153
42490,74,1076,1040,844,5562,232
12957,42,1183,3101,1064,11656,119
16333,0,42,2886,36,2176,6
43028,24,275,751,189,3727,86
23653,4,114,2514,99,3897,15
37435,39,472,1818,371,7799,101
43137,5,37,620,23,4131,14
31045,26,547,2147,480,7166,67
15671,12,493,2916,448,4355,45
40947,457,9211,1571,6417,68940,2794
37976,12,329,1781,276,7075,53
32872,1,54,2057,47,3144,7
8302,17,1846,3357,793,7106,1053
12956,91,2788,3101,2293,21174,495
28774,596,18907,2261,14607,54370,4300
41911,2,49,1428,40,1700,9
42084,12,297,1399,266,5176,31
42147,5,169,1355,137,3870,32
38528,14,302,1743,243,4749,59
15026,28,500,2947,458,7511,42
21885,25,589,2602,517,5176,72
43042,0,0,740,0,1203,0
30150,26,454,2193,415,5035,39
31656,47,914,2114,780,6461,134
28268,11,236,2290,190,4518,46
991,25,405,3934,357,9152,48
27457,95,1616,2337,1304,7834,312
40078,18,434,1646,384,5594,50
42088,4,98,1399,85,2946,13
43169,7,95,598,57,2007,38
43623,8,47,279,46,1224,1
5755,10,2084,3502,1150,6699,934
43031,86,1269,751,827,8816,442
21070,2,254,2649,219,5298,35
43228,0,0,564,0,1246,0
43039,1329,33402,742,23768,174923,9634
4711,3,128,3555,98,2368,30
43621,1,23,281,17,655,6
20116,13,327,2703,277,4221,50
43189,20,239,592,165,3650,74
43264,5,104,539,80,2353,24
6036,23,574,3488,496,7028,78
1451,3,137,3729,117,4554,20
42395,338,5044,1130,4279,41818,765
42166,14,267,1335,194,3773,73
41317,50,615,1523,538,14494,77
42437,89,1931,1092,1526,16599,405
7193,2,147,3436,142,5782,5
1009,101,2445,3929,2188,36515,257
1695,8,205,3659,170,4449,35
1413,5,192,3741,176,8713,16
1694,31,703,3659,547,7149,156
43870,0,27,144,18,347,9
6009,9,312,3489,261,4071,51
42982,78,1063,793,824,5622,239
23219,113,4005,2535,3257,15838,748
43301,5,51,506,35,1777,16
43657,77,1710,266,1418,7501,292
5946,11,259,3492,208,5291,51
41706,19,365,1465,301,4377,64
43791,4,57,197,50,1234,7
43196,51,698,584,461,7905,237
22442,8,195,2574,147,3088,48
18967,4,62,2760,58,1836,4
7035,4,86,3444,74,2830,12
23365,12,121,2528,96,2154,25
42095,4,132,1399,119,3027,13
16826,4,320,2860,275,4328,45
14461,55,2796,2984,2392,22473,404
1543,119,3624,3690,3227,37595,397
19934,2,96,2713,87,2353,9
8359,104,3388,3353,2260,15781,1128
20494,33,1216,2684,1044,13971,172
43457,3,58,395,42,1428,16
43653,7,148,234,122,1965,26
43682,6,44,255,32,919,12
4009,35,849,3581,678,6815,171
21149,346,7119,2643,5886,51627,1233
31355,17,265,2131,244,4939,21
43611,6,48,291,38,1314,10
30766,7,109,2158,92,1852,17
33251,17,256,2043,207,6484,49
24392,1,55,2480,47,2158,8
42391,8,95,1131,77,3075,18
43430,1,20,406,13,1238,7
25477,4,172,2433,158,1915,14
42295,29,535,1210,441,13069,94
1259,5,98,3845,84,2924,14
1294,5,103,3834,87,3810,16
9493,18,489,3282,448,12060,41
43866,2,13,146,11,243,2
43652,4,69,234,57,1270,12
31746,4,64,2110,53,1689,11
38369,288,9352,1754,7460,31652,1892
42373,10,420,1137,360,7523,60
43388,6,84,425,75,2321,9
40734,29,381,1591,281,6562,100
41851,5,90,1438,76,2666,14
21884,50,1497,2602,1353,6695,144
39659,6,77,1673,59,2421,18
43565,27,149,326,138,1096,11
42465,2,85,1057,54,5943,31
35114,7,236,1963,203,8728,33
34296,3,132,2006,106,3386,26
42267,564,8927,1230,7092,65577,1835
31268,12,237,2135,213,4096,24
35180,11,174,1959,156,4602,18
27390,18,289,2341,239,2988,50
42826,1,41,851,21,1398,20
1063,50,1054,3909,931,13096,123
1676,2,50,3661,38,1643,12
23720,25,557,2511,479,6498,78
43699,1,51,249,31,1678,20
42579,31,486,956,398,5996,88
22047,4,184,2593,154,3610,30
14889,46,673,2955,551,7503,122
42232,5,198,1267,138,3453,60
43365,78,1804,446,1305,15901,499
43361,13,203,451,111,2785,92
36872,94,1101,1852,970,11092,131
2082,4,165,3618,141,5170,24
7143,4,68,3438,43,1616,25
6060,11,5957,3488,2447,6563,3510
13028,34,491,3097,405,5402,86
42410,44,485,1121,362,3906,123
26553,2,99,2383,86,2444,13
36711,109,1624,1863,1461,15248,163
1611,96,2033,3678,1814,18427,219
6038,48,1176,3488,1052,13813,124
42855,202,1925,835,1579,17927,346
1281,5,129,3840,111,3621,18
9496,45,1199,3282,1092,20395,107
17828,8,422,2811,380,4531,42
25556,18,423,2429,373,4339,50
43335,19,154,471,122,3691,32
42080,833,15769,1400,12647,77735,3122
18926,5,134,2762,115,2928,19
18663,7,144,2772,116,2584,28
43648,7,150,250,110,1579,40
12736,6,72,3114,57,2227,15
12587,1,265,3123,164,2524,101
42386,17,262,1131,225,4181,37
6065,10,172,3487,148,3342,24
42371,37,680,1138,521,8001,159
6148,6,141,3485,121,3377,20
43460,6,71,396,51,956,20
32693,27,605,2065,473,8679,132
951,10,180,3947,152,4826,28
43891,0,3,129,2,306,1
43718,0,68,240,57,739,11
43729,11,221,234,179,2075,42
24293,6,158,2485,131,2727,27
5840,18,237,3497,191,3713,46
7626,3,122,3411,111,3897,11
43216,50,799,568,614,6075,185
7934,10,301,3386,253,4109,48
29101,63,1525,2245,1227,13518,298
28363,7,317,2285,272,5864,45
16326,2,169,2886,135,2491,34
43018,27,307,765,181,3209,126
42377,43,1143,1135,879,5796,264
27549,3,167,2331,146,3168,21
43723,0,25,239,13,848,12
42276,0,0,1221,0,4937,0
12335,20,409,3137,357,5732,52
28122,12,491,2299,379,10220,112
1579,15,490,3683,387,8195,103
9483,19,323,3283,255,4704,68
43104,29,304,679,233,4382,71
40161,16,242,1641,201,7247,41
26559,0,19,2382,17,1040,2
43233,44,328,562,241,2364,87
42860,199,2311,834,1879,15772,432
42489,17,215,1041,182,3239,33
11662,30,468,3171,381,6160,87
6104,8,249,3486,200,2648,49
27157,1,47,2356,45,3975,2
25775,7,310,2418,273,6985,37
42042,72,966,1407,845,10793,121
42355,15,206,1144,180,3338,26
12960,38,1024,3101,923,10641,101
37007,55,1380,1845,1125,13536,255
4468,178,4990,3565,3134,20322,1856
36837,3,65,1854,59,2663,6
32196,13,348,2086,299,4967,49
5754,8,535,3502,470,9189,65
36017,10,180,1902,139,2408,41
15234,128,3158,2936,2492,27605,666
42658,133,2203,921,1522,15466,681
3505,33,1230,3593,1084,12913,146
43421,98,1491,411,1203,4523,288
43844,3,96,158,93,1272,3
42566,66,689,982,497,9384,192
25851,191,5100,2415,4430,41824,670
42334,12,200,1170,138,5152,62
32493,20,363,2074,291,8701,72
42253,4,66,1256,50,2492,16
43255,22,291,546,225,3592,66
43684,1,31,255,22,759,9
7200,7,190,3435,173,5190,17
42741,16,178,900,125,5001,53
42517,17,175,1015,150,4084,25
1723,21,331,3651,286,6100,45
14164,4,142,3007,118,2874,24
43245,3,18,555,9,1279,9
42292,39,647,1211,482,5020,165
43461,38,539,395,396,5359,143
32649,1,83,2067,74,3052,9
42659,0,37,920,26,2009,11
43065,117,1386,718,932,13224,454
43085,48,566,700,474,5071,92
1728,7,268,3649,222,5352,46
8525,1,93,3342,87,1883,6
23714,77,1294,2511,1058,8547,236
43358,25,292,453,205,3018,87
5001,8,482,3542,271,3345,211
43697,4,50,250,34,867,16
43369,11,143,444,125,3205,18
43583,2,59,310,40,1207,19
34863,125,2992,1976,2541,13739,451
7027,5,180,3445,166,5503,14
21970,132,2582,2597,2191,10986,391
1663,1,78,3664,70,3082,8
43428,13,202,409,156,3772,46
1577,6,191,3684,146,7748,45
42342,230,3184,1165,2527,21974,657
28917,8,434,2254,314,6424,120
41173,29,448,1547,358,4718,90
32427,484,15019,2077,11952,42312,3067
8648,1,67,3335,58,2213,9
43131,141,1326,631,1145,12067,181
14887,138,2550,2955,1920,16073,630
40085,39,627,1645,542,10264,85
27167,0,134282,2355,107933,256525,26349
7519,6,169,3417,140,2306,29
1621,25,514,3677,465,10871,49
42121,8,315,1390,286,3541,29
8832,2,44,3323,38,1664,6
38825,11,135,1723,117,3065,18
7817,2,69,3398,62,4155,7
29684,19,509,2215,417,8424,92
42848,4,66,838,43,2062,23
1114,32,726,3894,650,11109,76
29470,14,443,2225,338,9009,105
6857,39,5309,3454,2551,9456,2758
43464,32,642,388,554,10671,88
42502,12,260,1026,218,2840,42
23113,0,74,2540,62,2240,12
42235,26,380,1266,317,5169,63
43279,5,82,526,53,3786,29
6312,34,802,3478,691,10931,111
42782,67,634,870,520,6631,114
42525,6,105,1012,74,2851,31
6026,4,142,3489,125,7514,17
43713,11,59,241,56,1224,3
43667,5,119,261,60,1789,59
42799,551,7865,858,6346,43864,1519
43413,9,191,414,145,1778,46
42138,82,857,1370,690,9179,167
7113,17,939,3440,777,17193,162
42879,2,59,830,39,1414,20
26836,279,7102,2370,6085,25049,1017
42129,19,476,1388,400,7250,76
37072,178,3199,1841,2794,18560,405
42236,12,190,1266,157,3285,33
42664,100,1033,919,734,8214,299
22161,59,938,2587,836,10672,102
39350,961,18404,1690,12324,59166,6080
43487,0,22,370,17,1717,5
14891,363,8419,2955,5880,29009,2539
1677,0,51,3661,42,2024,9
42352,67,1169,1147,956,8701,213
6017,2,77,3489,53,2254,24
37130,11,138,1837,124,3526,14
1602,3,72,3679,68,2657,4
37038,318,5142,1843,4290,22574,852
42400,25,569,1127,492,6700,77
24376,131,4109,2481,3561,25129,548
43824,2,23,170,21,556,2
14678,2,87,2969,75,2964,12
43594,7,47,302,38,889,9
1234,30,941,3857,831,15153,110
27314,170,2605,2347,2127,23108,478
43424,88,1151,411,938,4736,213
28807,41,1105,2259,946,6293,159
15325,21,364,2931,312,7356,52
1592,8,208,3681,184,5172,24
43642,36,351,273,283,6664,68
8918,11,167,3319,149,2773,18
5512,49,30002,3515,10439,4879,19563
42282,12,179,1218,137,3870,42
37860,30,441,1789,360,4383,81
28479,41,746,2279,647,15052,99
14661,6,987,2970,865,7069,122
42096,63,897,1399,634,9816,263
1777,28,603,3633,492,8876,111
36621,20,365,1868,294,6256,71
43316,130,1363,492,1103,12573,260
23418,0,93,2525,73,3330,20
1425,178,4373,3739,3833,27265,540
43475,6,446,378,194,4673,252
6153,8,123,3485,105,3076,18
34412,10,188,2000,170,3636,18
32381,12,457,2078,355,4424,102
6028,5,106,3489,91,2267,15
43003,104,1356,778,1087,7299,269
43014,591,9402,767,7407,54838,1995
43496,29,281,365,217,4433,64
37489,534,11532,1814,9622,43174,1910
42580,46,654,953,517,6421,137
9874,32,596,3264,438,3852,158
40303,0,80,1632,65,3701,15
32886,503,13974,2057,11312,47230,2662
43113,595,8493,665,6573,28452,1920
39940,30,582,1655,506,4477,76
43119,112,1042,646,779,6558,263
945,19,469,3948,418,6857,51
18656,1,242,2772,222,3645,20
43319,63,537,489,466,4802,71
25278,37,1003,2441,883,7495,120
28348,5,164,2286,137,4272,27
42512,40,485,1019,389,4925,96
1624,4,213,3676,168,5292,45
1552,3,235,3688,210,4796,25
21670,27,579,2614,514,4908,65
1682,1,58,3660,52,1789,6
5446,6,233,3517,207,4066,26
43187,59,616,593,443,5711,173
43064,31,233,719,193,4652,40
42586,182,1953,945,1600,12134,353
1553,18,746,3688,462,8399,284
43531,4,81,344,51,1365,30
43108,564,7198,677,5553,21741,1645
3497,0,78,3594,69,2254,9
42466,13,197,1056,165,2754,32
43766,73,938,215,806,9148,132
43371,8,284,444,166,2825,118
2158,16,1046,3617,665,7205,381
34167,3,158,2010,148,3501,10
6100,45,1881,3486,1494,21995,387
43810,50,528,178,511,3873,17
32974,4,94,2054,79,3339,15
41622,1258,34864,1479,28542,160711,6322
27132,2,125,2357,118,1925,7
17976,5,94,2803,84,4059,10
42434,6,213,1096,166,20438,47
6163,2,3439,3484,1320,4540,2119
35562,9,215,1937,180,5947,35
6210,14,608,3483,546,15424,62
43433,19,187,402,144,1899,43
43795,13,400,192,310,3304,90
23572,38,746,2518,644,13180,102
6748,7,147,3460,130,3132,17
23183,56,1293,2538,1042,17666,251
43463,87,1252,388,919,7869,333
43660,3,21,265,11,675,10
41052,21,293,1562,242,4516,51
42119,17,348,1392,319,11515,29
43804,5,89,182,70,757,19
21418,17,503,2629,420,4233,83
30803,2,61,2157,55,1519,6
26259,42,644,2396,538,4182,106
35793,0,52,1918,42,1843,10
9975,25,329,3259,282,6712,47
35794,0,43,1918,36,2144,7
1750,6,92,3642,76,2314,16
1280,1,79,3840,64,3155,15
14288,23,559,2997,465,12735,94
32606,14,110,2069,95,1767,15
27765,205,6753,2319,5692,20128,1061
41799,37,662,1447,544,14864,118
43563,10,113,327,85,2465,28
1674,7,101,3661,80,2132,21
26338,18,534,2393,470,5379,64
5056,34,2187,3539,1058,11682,1129
18259,2,87,2790,74,3087,13
42468,26,384,1053,320,2780,64
1293,18,395,3834,359,8916,36
2680,5,131,3609,119,5175,12
41626,222,4942,1479,4092,40363,850
43472,8,112,381,94,2112,18
37249,408,7197,1830,5944,27241,1253
42930,3,134,811,101,2664,33
42064,2,134,1403,113,3255,21
33334,7,123,2040,95,3169,28
35622,118,2295,1932,1757,16080,538
23357,61,1020,2529,817,11327,203
31942,141,6267,2100,5295,45324,972
27550,4,56,2331,51,1488,5
1476,3,101,3712,75,4044,26
6958,46,1904,3449,1169,11916,735
42195,4,75,1307,58,1799,17
42924,35,376,821,322,6469,54
1662,7,182,3664,164,4048,18
42164,54,659,1336,518,7948,141
43101,439,4555,681,3558,20173,997
43191,185,2943,590,2180,15709,763
28284,2,124,2290,111,2965,13
17639,11,307,2817,257,2563,50
27744,4,169,2321,155,1960,14
39279,6,171,1694,147,3848,24
43730,15,184,235,138,2561,46
41737,447,7405,1460,6202,49308,1203
1743,45,851,3644,758,11728,93
37977,70,1791,1780,1509,24568,282
43589,6,77,305,62,1341,15
43481,40,377,376,290,2976,87
35094,130,2900,1964,2458,30719,442
27965,46,1497,2307,1277,11443,220
9029,3,65,3313,55,1630,10
1272,1,55,3842,40,3292,15
12506,7,100,3126,85,2811,15
6212,81,2133,3483,1711,18939,422
43838,5,146,161,119,1033,27
42453,6,381,571,246,1805,135
42880,0,24,830,13,1169,11
7783,4,788,3400,442,4993,346
42469,52,717,1051,548,5356,169
34013,23,253,2015,201,4073,52
42858,126,1515,834,1268,14203,247
31571,23,207,2119,188,4986,19
42347,737,20875,1157,16484,104431,4391
30600,117,1589,2167,1213,12180,376
8528,5,54,3341,51,2286,3
43080,11,137,706,85,2376,52
42179,54,779,1325,507,7068,272
43349,3,50,459,43,1120,7
43608,12,143,293,106,3210,37
25468,100,4568,2433,3928,21105,640
43078,12,98,707,82,1942,16
42145,3817,78056,1359,61214,505935,16842
1212,6,87,3861,68,3715,19
14194,2,167,3004,146,6014,21
6744,3,49,3460,36,1819,13
1014,75,1228,3927,997,10479,231
28311,457,15727,2288,12679,41686,3048
43768,62,1324,213,1138,5839,186
34029,7,184,2014,153,2768,31
43275,98,1365,529,1047,11412,318
42752,8,122,892,88,4090,34
40448,313,8685,1616,7352,70913,1333
1683,0,65,3660,55,1816,10
42939,32,386,803,286,4370,100
35564,27,451,1937,343,16920,108
43722,1,41,239,19,959,22
35481,46,725,1943,616,17835,109
42463,12,218,1057,173,2660,45
15175,157,2944,2939,2448,14298,496
14312,5,102,2995,79,3970,23
38626,102,1591,1735,1402,21622,189
1282,5,163,3840,143,4544,20
23743,6,103,2510,94,2642,9
19543,24,464,2734,386,15050,78
21822,37,627,2606,522,11083,105
27503,4,139,2334,117,2152,22
42760,12,225,882,171,3166,54
1011,18,261,3929,241,5695,20
23388,1164,19815,2527,16077,103246,3738
7282,2,129,3431,119,4071,10
12231,8,235,3143,196,3214,39
43049,8,36,732,30,1235,6
42014,11,188,1412,160,5544,28
42250,39,552,1258,466,7483,86
42384,88,1314,1132,1132,8326,182
11991,2,123,3155,99,2779,24
43373,4,56,440,36,1559,20
28886,3,143,2256,111,2011,32
15455,1,57,2927,49,1738,8
42905,22,768,824,559,8475,209
6203,16,426,3483,369,9007,57
28252,15,387,2291,325,6513,62
31429,16,221,2127,175,3662,46
41615,406,6972,1481,6029,41795,943
25515,18,659,2431,579,5589,80
26466,28,467,2387,389,6122,78
32372,4,102,2078,81,2993,21
9494,64,1172,3282,1043,19169,129
34725,162,5175,1985,4383,39109,792
42608,11,257,941,173,5493,84
1680,1,58,3660,51,1788,7
40620,10,282,1601,235,5818,47
5185,2,67,3531,58,7101,9
1007,24,391,3930,328,5855,63
9589,1,98,3277,92,3314,6
42706,12,237,907,145,5170,92
11932,18,511,3158,427,8896,84
43849,1,28,156,20,738,8
43140,387,11506,618,8535,23795,2971
42983,73,933,793,722,4856,211
29906,214,4124,2204,3488,16907,636
43155,153,1952,608,1527,7748,425
43701,4,39,248,31,845,8
1499,3,121,3710,106,3706,15
43156,151,1861,608,1476,8259,385
26455,1,83,2387,68,1926,15
1568,10,202,3685,176,6522,26
34489,3,122,1997,112,4951,10
8588,14,509,3338,458,9754,51
42155,237,6856,1346,5259,87858,1597
1032,7,153,3918,135,3676,18
7389,36,1198,3425,738,7376,460
42191,0,0,1311,0,10323,0
37672,25,473,1803,407,6384,66
39605,232,4234,1675,3084,25112,1150
43535,42,334,341,259,4160,75
43438,10,52,399,41,828,11
43181,98,1466,594,1224,9233,242
27816,12,566,2316,471,5327,95
28771,5,173,2261,149,4503,24
43456,0,13,395,11,749,2
42584,8,113,946,93,2420,20
43659,5,75,265,59,934,16
1727,4,176,3650,144,6575,32
41733,31,433,1461,383,7130,50
43751,3,87,226,51,2868,36
1215,9,254,3861,217,8246,37
43709,1,21,245,13,556,8
43017,100,1295,765,941,9020,354
43091,221,2211,693,1810,14255,401
43579,0,67,313,17,1494,50
43060,25,243,719,202,4063,41
11743,1,189,3167,115,4621,74
43351,0,0,458,0,1940,0
18155,0,19,2795,17,2383,2
43890,0,3,131,3,444,0
43282,39,440,525,325,3835,115
25560,1,54,2429,50,2272,4
43184,39,381,594,294,4347,87
8352,5,77,3353,68,2855,9
43819,7,45,173,45,1529,0
3909,62,990,3584,840,12546,150
22002,577,10971,2595,9575,58280,1396
43215,7,57,571,39,1938,18
1609,5,129,3678,113,2951,16
42140,7,131,1366,102,2428,29
1189,30,10199,3865,4811,17041,5388
12958,36,967,3101,891,14319,76
43188,14,144,593,99,1915,45
42479,13,233,1044,188,4195,45
28061,396,14562,2302,11516,42010,3046
43013,9,162,769,142,2035,20
43338,12,148,467,94,1883,54
23292,15,368,2532,315,4614,53
42582,253,3993,947,3151,23185,842
35997,12,258,1903,209,5560,49
42427,4,27,1101,24,2032,3
26564,6,490,2382,401,7587,89
28293,85,2961,2289,2490,20635,471
43782,3,65,203,49,1112,16
43881,0,8,132,7,149,1
41784,229,3855,1450,3262,28794,593
43195,55,856,588,601,5986,255
1561,6,99,3686,88,2934,11
42457,5,136,1068,95,2812,41
2678,249,10037,3609,6520,40510,3517
40700,21,318,1594,271,6733,47
42106,26,813,1397,587,8050,226
37588,32,554,1808,463,4106,91
38480,3,71,1747,60,3283,11
1742,22,497,3645,415,7915,82
42713,35,675,892,470,6429,205
38912,13,324,1718,296,8773,28
43832,1,8,165,7,516,1
1541,18,243,3690,203,4426,40
43029,2,7,751,7,5935,0
42114,2,64,1393,56,1556,8
42360,0,0,1142,0,7693,0
22049,1,65,2593,52,1993,13
6128,6,206,3486,177,5180,29
37795,846,18651,1794,14844,161593,3807
26555,15,361,2382,286,3034,75
18159,25,397,2795,353,5110,44
42592,18,242,943,175,5412,67
39369,530,8893,1689,7091,29761,1802
40111,11,238,1644,181,4092,57
42394,4,53,1130,47,1971,6
37133,35,891,1837,748,9882,143
42756,1,50,889,36,3983,14
1080,33,884,3902,771,14722,113
40289,12,259,1632,226,8432,33
42169,22,505,1333,422,10203,83
42448,304,5211,1075,4118,35529,1093
43633,33,335,276,267,4428,68
39170,125,1758,1702,1396,10114,362
2363,41,1154,3614,953,15734,201
43380,237,4248,434,3530,21951,718
43840,1,28,161,19,586,9
42609,49,691,939,512,8562,179
1550,12,178,3689,152,6251,26
42520,201,2388,1013,1972,13587,416
42105,2,95,1397,75,2922,20
37792,25,638,1794,476,6347,162
6151,7,261,3485,230,3453,31
43764,2,78,215,55,614,23
30788,185,5533,2158,4759,20897,774
42619,29,446,936,312,4827,134
42375,18,227,1136,182,5160,45
987,6,154,3936,127,3876,27
1630,4,63,3674,58,1949,5
40196,132,5085,1639,4255,46633,830
1258,28,651,3846,587,10402,64
43400,16,180,419,159,3112,21
6746,41,825,3460,748,7813,77
42109,11,128,1394,104,3660,24
1129,12,188,3891,176,5430,12
42570,713,11059,976,9092,30389,1967
6684,26,450,3462,410,10550,40
43759,11,101,222,95,1803,6
9227,47,1616,3300,1168,12094,448
43637,0,62,276,45,856,17
1279,2,138,3840,97,8789,41
29555,71,1868,2221,1565,15516,303
5847,64,1221,3497,1052,9050,169
43526,3,49,347,33,1311,16
11902,42,1238,3160,1108,16764,130
42562,51,610,985,473,5883,137
42407,150,2474,1124,1987,15956,487
26306,16,477,2394,409,7767,68
43590,8,41,305,36,2446,5
32628,41,990,2068,793,15939,197
22286,50,1087,2581,897,6041,190
37512,26,654,1813,566,6049,88
43402,1,39,419,33,795,6
20996,2,150,2653,130,2742,20
43391,15,239,424,146,2730,93
42242,7,174,1263,150,1952,24
43880,0,33,132,27,399,6
32285,1,79,2083,68,3017,11
41996,10,207,1415,173,3963,34
7145,7,312,3438,280,5239,32
43179,19,223,595,169,1540,54
43506,2,50,357,34,1201,16
6130,5,153,3486,102,2995,51
43698,3,49,250,36,1000,13
42932,35,341,811,288,8203,53
43164,44,433,603,330,5884,103
39698,23,301,1670,224,4441,77
15444,8,198,2927,174,4471,24
31868,1,49,2104,38,2249,11
42660,2,20,920,15,1492,5
43704,1,83,247,49,1639,34
34453,4,149,1999,117,6713,32
43220,11,106,566,79,1688,27
27303,149,2675,2347,2353,20750,322
42306,91,5097,1201,3819,14773,1278
43273,19,141,530,109,1539,32
42903,95,4982,828,2077,43149,2905
28063,54,719,2302,637,6892,82
42508,18,276,1022,234,4554,42
43409,19,234,417,205,3464,29
31840,8,152,2105,128,3591,24
1453,145,2925,3722,2547,36580,378
38788,1,58,1725,47,2600,11
23391,7,179,2527,162,4886,17
28868,7,138,2256,118,5004,20
43378,5,127,434,86,2425,41
16555,14,209,2875,184,3357,25
42995,21,288,782,208,3827,80
11140,2,209,3198,194,8823,15
4022,0,73,3580,57,2814,16
27312,67,1207,2347,968,12217,239
41947,415,8856,1422,7225,55571,1631
43040,8,127,741,89,4543,38
43288,121,1486,522,1185,12599,301
1603,3,129,3679,117,3983,12
1530,17,453,3696,293,5317,160
43874,3,52,139,49,1497,3
8844,15,781,3322,471,12490,310
18789,1,95,2767,81,3260,14
12816,74,2007,3110,1706,13646,301
6602,36,815,3466,587,9437,228
43668,2,34,261,21,1215,13
37206,25,545,1832,455,6395,90
41387,2,111,1514,86,3463,25
28887,19,878,2256,673,9403,205
22666,10,296,2562,268,5849,28
7127,15,229,3439,183,2558,46
27090,5,97,2360,85,2711,12
41584,21,492,1485,428,12993,64
33217,4,48,2044,41,2252,7
1601,3,72,3679,66,2470,6
23606,756,37353,2517,31747,151637,5606
1664,3,44,3663,39,1792,5
7064,26,1667,3442,811,9346,856
36744,8,558,1862,368,9593,190
17937,2,216,2806,198,2811,18
31655,18,389,2114,316,2361,73
42244,49,947,1260,664,15325,283
43073,116,1499,711,1313,11640,186
18082,9,279,2797,233,5493,46
28885,8,100,2256,80,1526,20
3875,955,27134,3585,16744,110782,10390
43829,2,110,166,77,889,33
9871,11,309,3264,283,6348,26
43522,7,259,348,187,4100,72
42832,166,2282,844,1742,17875,540
35353,39,1959,1950,1672,21081,287
36948,131,2767,1848,2243,16443,524
30830,37,526,2156,442,4517,84
24777,11,153,2463,139,2113,14
42901,3,82,830,45,3170,37
33070,18,469,2049,385,12364,84
42796,1486,29289,862,20238,84528,9051
6124,153,4283,3486,3740,30724,543
15259,17,262,2935,225,5122,37
43134,33,377,629,265,3973,112
1628,5,121,3675,106,4085,15
23440,28,1011,2524,901,9417,110
39836,13,236,1663,198,5303,38
21935,9,195,2600,167,6507,28
42124,40,571,1389,465,6951,106
43599,2,39,300,33,930,6
43769,4,47,211,28,881,19
43574,6,106,318,86,1020,20
39067,10,143,1708,122,3581,21
990,14,392,3934,361,27058,31
33096,10,296,2048,265,6855,31
23155,18,877,2539,734,13495,143
38296,14,298,1759,227,4616,71
27566,13,484,2330,406,2607,78
3941,4,347,3584,310,8442,37
43190,34,510,592,359,3147,151
3596,10,1515,3592,649,3276,866
1065,57,1469,3908,1266,17748,203
2612,2,530,3609,207,2342,323
17935,59,943,2806,743,7819,200
20134,16,264,2702,235,2353,29
42184,13,97,1319,86,2558,11
43448,4,59,395,50,1411,9
2252,23,804,3616,730,20792,74
42451,51,648,1072,536,10933,112
39884,20,231,1659,185,4685,46
37208,27,464,1832,381,6062,83
42341,45,814,1166,584,26678,230
43666,13,276,261,191,2152,85
6107,13,348,3486,238,5328,110
22618,19,669,2565,567,5609,102
8003,2,89,3379,80,2616,9
43568,70,589,326,422,4141,167
21372,48,1059,2631,882,9384,177
21837,33,705,2606,605,4063,100
28345,1,80,2286,73,3195,7
42439,4,104,1085,85,4123,19
29461,126,5462,2225,4689,19158,773
8729,11,407,3329,363,7874,44
43158,2,49,607,41,1561,8