Mod,likes,downloads,time,unique_dl,views,dl_dif
15253,8,356,2935,284,5580,72
43530,5,70,1038,53,2718,17
20900,24,859,2658,598,4076,261
16895,54,1787,2857,1263,17506,524
39057,2,34,1709,27,4346,7
24230,2,152,2488,116,4771,36
40329,283,9063,1629,6192,71328,2871
46045,38,532,316,427,6843,105
45856,4,92,402,54,3552,38
2809,32,882,3606,745,18434,137
7215,13,488,3435,278,3934,210
18546,95,4640,2778,3025,24711,1615
6415,149,5456,3474,3978,38451,1478
31632,1,64,2116,56,5615,8
42085,128,2612,1398,1759,39713,853
45144,4,43,639,27,1532,16
37590,2,51,1808,46,1619,5
3786,55,2247,3588,1838,17873,409
5352,5,215,3522,179,4127,36
12847,6,163,3108,130,2387,33
8613,206,8170,3337,5452,74118,2718
30061,11,240,2197,193,5713,47
22102,4,89,2589,70,3800,19
37332,38,1962,1825,1512,22030,450
18737,149,8526,2769,6181,70062,2345
43934,9,106,927,91,3158,15
26250,34,6035,2397,4956,11111,1079
44011,185,1994,915,1629,20205,365
19338,7,407,2743,316,8504,91
34851,5,310,1976,221,4846,89
29527,204,9816,2223,7513,76768,2303
17559,4,235,2821,207,5868,28
22774,48,1404,2557,1063,10871,341
15801,26,1374,2910,996,14853,378
28746,1,61,2262,51,2686,10
8884,42,665,3321,509,7569,156
44699,28,267,796,224,6334,43
19821,6,367,2718,290,12471,77
19827,10,404,2718,340,5079,64
13428,30,1514,3062,1078,22057,436
3583,23,2210,3592,1796,14462,414
4787,28,883,3552,676,7856,207
31252,8,258,2137,198,3110,60
32997,15,689,2053,540,13302,149
15451,1,235,2927,204,3818,31
32912,3,62,2056,56,1852,6
16606,5,175,2873,136,4191,39
34789,5,190,1980,152,4988,38
16767,47,2650,2863,2127,12149,523
32894,11,362,2057,304,14761,58
12913,56,2374,3104,1635,21437,739
4983,65,1632,3543,1257,11045,375
7052,86,2307,3443,1748,12818,559
41489,91,1981,1498,1514,24366,467
34332,3,60,2004,46,2119,14
38187,75,2013,1767,1569,34356,444
23035,7,268,2545,226,7734,42
19482,27,1223,2736,947,16006,276
14958,52,4686,2951,3515,52824,1171
26454,15,479,2387,394,8840,85
15717,2,273,2914,200,10503,73
1566,1,31,3685,28,1701,3
22272,84,4754,2581,3643,38568,1111
12585,77,4236,3123,3364,86882,872
7576,122,4117,3414,3108,45547,1009
28692,32,2682,2265,2046,24674,636
8292,23,693,3358,532,9301,161
46390,4,117,184,100,1643,17
29792,6,370,2210,287,6099,83
1818,7,476,3625,402,6723,74
9927,12,871,3261,674,13700,197
9193,4,224,3302,158,4285,66
45324,3,101,585,53,3292,48
23430,5,130,2525,98,2974,32
14996,82,10456,2949,7757,66142,2699
39393,32,2086,1688,1183,22062,903
15231,3,106,2936,85,2053,21
42948,358,5272,1211,4013,45377,1259
16404,4,542,2881,461,5230,81
7534,20,476,3416,362,8893,114
2283,12,841,3615,624,18122,217
42831,3,263,1240,204,8085,59
21214,4,148,2639,107,2751,41
14834,745,55232,2958,37629,222832,17603
11859,18,392,3162,291,10972,101
45181,3,24,629,10,2004,14
24710,49,1962,2464,1482,22947,480
26804,3,118,2371,99,1561,19
20766,16,1665,2669,1149,10277,516
31103,5,100,2144,86,2786,14
38500,13,538,1745,420,9410,118
46230,5,64,249,42,1170,22
3056,20,340,3602,267,10891,73
19789,17,512,2720,401,6703,111
30010,1,43,2199,39,1883,4
21579,706,39209,2619,28343,236649,10866
40972,140,4739,1570,3579,56157,1160
8883,8,515,3321,405,10739,110
4061,76,1824,3579,1396,12067,428
6631,447,27214,3465,19025,145575,8189
1997,11,1229,3620,505,7912,724
13081,52,2065,3093,1626,35740,439
18017,4,374,2800,299,5950,75
28509,8,295,2276,237,4587,58
8405,246,9670,3350,7389,81684,2281
10796,6,129,3216,103,5861,26
15790,11,410,2910,331,7667,79
44218,72,1150,878,771,26397,379
20471,63,3763,2685,2735,23933,1028
24110,0,96,2493,84,3817,12
43775,31,385,953,297,5104,88
26607,9,779,2381,466,4963,313
36743,41,749,1862,564,29442,185
4415,11,301,3567,250,3202,51
8489,346,9522,3344,7049,37578,2473
45255,4,32,608,23,2133,9
43249,0,11,1123,7,1721,4
32398,5,166,2078,135,4670,31
20587,11,924,2678,690,23330,234
14467,1,74,2984,61,3589,13
38146,16,666,1770,532,10007,134
40412,1306,40502,1620,28302,181970,12200
2667,4,93,3609,72,10022,21
8978,2,41,3315,30,4072,11
26193,11,2671,2399,1961,21424,710
5015,12,296,3541,249,10232,47
3958,234,19984,3583,13699,87580,6285
38066,35,698,1775,549,10965,149
39924,5,207,1656,159,4297,48
36198,22,921,1890,703,10631,218
4016,13,332,3581,252,4247,80
7968,6,294,3382,253,2188,41
18272,34,1326,2789,1100,11710,226
31282,36,601,2135,461,6780,140
35279,41,1198,1953,930,6176,268
19410,3,253,2739,210,13318,43
5529,5,591,3514,329,11182,262
14260,19,706,2999,499,17592,207
46347,9,105,206,98,2158,7
30990,59,5247,2150,3767,45728,1480
32191,117,5143,2087,3559,47775,1584
3951,33,1322,3583,1047,23076,275
37043,10,234,1842,200,6231,34
26704,388,113046,2376,78233,218031,34813
14937,12,541,2952,386,5831,155
44929,161,2184,725,1703,17139,481
21944,119,4046,2599,3103,16391,943
36269,48,1471,1886,1113,12577,358
5763,9,342,3502,275,3851,67
33701,0,0,2026,0,9208,0
15966,22,743,2904,591,11818,152
8036,35,2361,3372,1863,25008,498
12372,2,111,3134,92,4056,19
40034,3,144,1648,114,6880,30
32820,0,30,2060,27,1832,3
16361,5,236,2884,161,4288,75
16358,10,574,2884,476,6715,98
36702,1,82,1864,63,4046,19
25290,19,587,2440,465,5179,122
38058,35,430,1776,334,5018,96
36199,422,23405,1890,16327,108418,7078
6076,113,7134,3487,5320,140702,1814
37975,0,24,1781,17,2911,7
23950,20,407,2500,336,6917,71
6481,29,2007,3471,1517,16751,490
43277,38,361,1115,249,6285,112
29718,16,584,2213,472,6887,112
15247,27,2622,2935,1962,44710,660
25389,189,7612,2436,5888,80206,1724
16108,17,2650,2896,1786,37773,864
6722,27,723,3461,632,9389,91
30767,4,104,2158,75,3603,29
41691,0,0,1469,0,2250,0
36813,56,2394,1857,1790,31884,604
18829,17,1967,2765,1433,9385,534
23272,32,1059,2533,862,10459,197
12877,25,1387,3106,1026,30991,361
33881,31,999,2019,722,8596,277
21832,0,481,2606,319,3289,162
40399,18,412,1621,321,4756,91
41130,44,2016,1551,1486,21983,530
21048,8,239,2650,179,8744,60
24737,8,473,2463,364,4744,109
2445,12,427,3612,338,5909,89
3570,274,11746,3592,8654,56681,3092
4201,29,1428,3574,1133,16634,295
13526,123,5650,3054,4317,73780,1333
11537,10,171,3177,142,5003,29
3384,1116,68173,3596,46788,468396,21385
29834,41,1000,2208,736,8595,264
26904,61,4135,2366,2810,39867,1325
19963,3,166,2711,114,7874,52
28253,5,520,2291,398,9128,122
45247,42,391,611,284,5907,107
34838,50,1161,1977,916,15841,245
45846,19,542,405,447,5989,95
29513,3,124,2223,99,3601,25
5166,35,488,3532,373,4358,115
16337,4,333,2886,271,11807,62
34953,33,1615,1971,1187,16911,428
17690,32,1113,2816,790,8730,323
29978,30,981,2201,751,12731,230
29347,155,5657,2231,4331,43950,1326
17220,10,1771,2838,1286,15976,485
46138,17,245,282,193,3889,52
39385,70,1703,1688,1341,13692,362
8488,21,367,3344,305,13361,62
40825,77,1548,1581,1237,12524,311
35671,285,7164,1927,5345,54981,1819
24303,6,212,2484,147,7729,65
9763,46,1140,3269,917,11509,223
9878,35,2285,3264,1709,45541,576
30900,29,3269,2153,2327,15513,942
37497,12,583,1814,464,15434,119
6590,36,939,3466,700,10664,239
8038,28,278,3372,237,5025,41
28854,37,2276,2257,1749,12422,527
28842,5,1093,2257,830,21151,263
35527,10,406,1939,304,8458,102
7905,7,195,3389,163,5963,32
3372,55,1205,3596,912,9908,293
7224,0,63,3435,46,4815,17
18443,1,178,2782,132,7488,46
32485,6,218,2074,177,5004,41
4828,86,2739,3551,2036,24058,703
20778,207,10906,2668,8089,38750,2817
31726,3,67,2111,56,3346,11
16724,15,1499,2866,1061,20121,438
23550,23,1494,2520,1114,13532,380
2275,18,557,3615,379,12584,178
11055,3,142,3203,126,4452,16
16865,23,1330,2858,953,8885,377
41078,2,246,1558,196,12688,50
27821,5,329,2315,266,3147,63
2152,55,1278,3617,1045,19924,233
1220,4,75,3861,70,4874,5
30950,1,184,2151,156,5151,28
28741,37,1167,2263,927,9712,240
11955,4,232,3157,189,7061,43
38136,29,778,1770,605,13061,173
12995,12,503,3098,438,9568,65
11200,0,63,3194,47,2578,16
7051,7,303,3443,228,8667,75
2550,15,404,3610,315,7402,89
25485,132,5965,2432,4108,46541,1857
35983,11,595,1905,488,12116,107
40836,1,49,1580,36,3896,13
7952,52,1560,3384,1149,18034,411
45303,12,165,593,126,5261,39
40187,26,1281,1640,891,18735,390
32629,2,84,2068,64,2100,20
4689,8,546,3556,401,13115,145
16287,4,365,2888,256,7891,109
7334,1,64,3428,44,2541,20
17418,11,387,2827,311,3818,76
31499,42,886,2122,687,6205,199
29892,5,180,2204,147,5264,33
38337,8,170,1756,137,5083,33
39398,6,239,1687,168,5488,71
4088,5,137,3578,109,7047,28
46057,38,345,310,293,6518,52
34317,10,150,2005,128,4754,22
19949,87,5820,2712,3898,41504,1922
5088,31,553,3537,400,10754,153
3915,8,374,3584,300,5058,74
16818,583,58418,2860,40849,90481,17569
46150,0,31,276,30,2244,1
3132,2,45,3600,38,2240,7
11471,32,2334,3181,1866,19964,468
7808,1457,99605,3399,65631,311416,33974
34188,1,103,2010,81,3522,22
3461,58,995,3594,773,9908,222
31059,9,321,2146,259,4392,62
19228,940,34019,2749,22681,188909,11338
39259,2,59,1695,40,2473,19
18528,12,641,2779,511,10033,130
34545,8,386,1994,293,8204,93
29627,6,182,2218,147,4148,35
40530,257,9286,1609,6554,57252,2732
5797,27,733,3500,568,9651,165
22589,27,1535,2566,1193,12245,342
18221,55,1290,2792,936,8002,354
2301,6,194,3615,140,6610,54
43317,13,413,1104,310,6347,103
33106,6,174,2048,135,4422,39
30346,15,642,2181,517,6027,125
27182,37,1293,2354,965,16010,328
6666,2,104,3463,73,4349,31
29845,10,862,2208,689,9633,173
23393,43,3258,2527,2594,29851,664
2429,167,5872,3612,4415,31035,1457
42813,97,2037,1244,1618,37314,419
4698,5,197,3556,144,2838,53
41541,58,1905,1492,1372,25551,533
9583,37,711,3277,568,9208,143
22524,4,385,2569,277,6145,108
15287,20,2172,2933,1607,17304,565
38574,1,50,1739,38,3584,12
45916,6,107,380,87,1315,20
32404,2,118,2077,98,6684,20
7111,16,811,3440,656,12262,155
15825,2,183,2909,157,3322,26
14159,173,9991,3007,6884,72589,3107
19893,15,550,2714,444,14955,106
45396,49,387,566,323,6948,64
10494,24,1067,3234,893,18805,174
38426,54,932,1750,723,14945,209
40736,13,337,1591,273,8754,64
37569,12,367,1809,273,4014,94
30981,0,93,2150,81,3274,12
45886,24,125,391,97,2496,28
13307,4,149,3071,110,4391,39
2527,5,105,3611,91,6661,14
31495,25,921,2123,744,8436,177
1696,4,111,3659,91,3880,20
12999,39,1494,3098,1138,28257,356
45025,6,192,696,128,5341,64
38245,0,28,1762,19,2747,9
45998,41,755,342,602,9166,153
27202,4,209,2353,179,10573,30
10140,415,13993,3251,10558,51687,3435
20682,35,3094,2673,2456,30040,638
25617,22,664,2425,548,10657,116
38290,6,293,1760,257,7644,36
17421,6,549,2827,434,6207,115
31629,8,398,2116,301,3671,97
22647,10,847,2563,651,6671,196
36587,0,94,1870,83,3524,11
44965,15,402,714,264,6432,138
27715,6,191,2322,158,2003,33
43030,14,113,1189,105,3549,8
2054,1207,77017,3619,52138,374879,24879
38238,17,449,1763,371,7982,78
15640,19,841,2917,674,7306,167
2368,7,229,3614,187,3972,42
3885,23,934,3585,758,21853,176
11343,24,675,3188,535,7520,140
46353,0,103,205,57,2369,46
11174,3,170,3196,156,5584,14
39923,81,2242,1656,1571,20499,671
5297,246,20108,3525,13794,70061,6314
27558,89,1681,2331,1284,11054,397
33793,25,2455,2022,1882,20695,573
15506,1,77,2924,64,1751,13
9490,11,330,3282,265,5443,65
37812,10,702,1793,586,13087,116
36220,1,15,1889,13,1924,2
7085,37,2279,3441,1415,21575,864
4885,188,3690,3547,2763,56739,927
35514,118,2722,1940,2165,32157,557
5750,40,1632,3502,1265,14284,367
18749,42,1916,2769,1486,25862,430
31700,14,712,2112,515,16537,197
22521,1,64,2569,55,2472,9
43897,27,196,934,151,3473,45
19366,19,1816,2742,1354,16942,462
33028,4,166,2051,140,5040,26
17847,3,119,2810,103,3144,16
32074,1,110,2093,68,2709,42
4073,31,821,3579,615,7669,206
10522,21,783,3233,644,14588,139
17060,28,1630,2847,1236,24830,394
33054,430,35763,2050,27181,144324,8582
28262,29,1150,2291,885,16413,265
35178,3,312,1959,233,6572,79
10977,2,56,3207,42,3796,14
34146,20,520,2011,398,4027,122
35758,4,201,1921,175,3626,26
33770,2,136,2023,98,4761,38
43197,243,4860,1140,3687,43049,1173
30167,9,340,2192,275,14240,65
18819,9,357,2766,294,7736,63
22341,1,93,2578,68,1521,25
32261,92,1342,2084,1133,11662,209
22158,17,650,2587,535,6613,115
29614,0,40,2219,29,2497,11
20643,168,2626,2676,1998,15386,628
33077,3,76,2049,66,2954,10
24049,11,485,2496,425,6056,60
43758,132,1526,961,1252,13869,274
24309,0,4624,2484,3482,24897,1142
43106,121,2076,1165,1539,23324,537
44003,2,41,918,32,2235,9
12016,332,50705,3154,35871,164306,14834
21967,17,1179,2597,920,13146,259
2313,37,1041,3615,858,36497,183
19576,18,1444,2732,1061,9375,383
31356,68,2005,2131,1652,17570,353
45883,2,17,392,6,1082,11
36388,200,8897,1880,6552,61614,2345
20758,9,361,2669,287,5805,74
36493,19,1036,1875,769,13357,267
16195,2,128,2893,105,2910,23
4668,8,148,3557,121,4598,27
34001,2,162,2015,137,3025,25
28264,43,1968,2291,1610,10270,358
8782,56,1242,3326,989,13826,253
13669,41,841,3044,643,8246,198
43588,21,320,1018,244,3258,76
17341,78,3027,2831,2150,15429,877
14365,8,114,2991,82,6632,32
20350,5,249,2691,204,6333,45
5305,16,376,3525,309,7436,67
45696,5,30,463,16,1373,14
11024,161,5086,3204,3952,72810,1134
35181,20,596,1959,478,9015,118
25489,10,234,2432,189,5631,45
9716,5,134,3272,110,10721,24
12556,459,20162,3125,14284,78874,5878
28844,16,259,2257,211,3722,48
4146,124,6229,3577,4443,33462,1786
42596,12,400,1296,308,7674,92
33213,0,136,2044,111,4359,25
13564,21,1189,3050,910,18719,279
1671,68,3338,3662,2340,28223,998
32897,7,252,2056,176,18461,76
1888,548,41486,3623,27193,269700,14293
7226,37,1981,3435,1531,9410,450
23997,84,2549,2498,1836,11860,713
21603,60,2142,2618,1622,14439,520
15133,19,1214,2942,1015,32587,199
45040,51,526,689,440,11923,86
9080,284,9417,3309,7023,37504,2394
42969,43,555,1207,393,7557,162
6755,2,107,3459,94,5722,13
7551,0,103,3416,88,3204,15
13255,62,2395,3075,1773,27003,622
46151,0,5,276,4,721,1
15576,5,221,2920,155,6548,66
22658,11,749,2563,521,7777,228
16842,6,149,2859,120,2917,29
11428,0,81,3184,53,3030,28
14330,25,1227,2993,994,11887,233
45782,21,321,426,247,4666,74
38814,25,678,1724,535,14055,143
29903,2,57,2204,38,1566,19
28561,45,1011,2272,776,13552,235
34505,22,921,1997,736,11324,185
10710,6,176,3221,139,14310,37
46419,37,585,169,517,11484,68
36732,0,32,1863,27,2655,5
41217,12,197,1541,162,5363,35
2728,3,38,3608,28,4200,10
32822,0,81,2060,68,2632,13
7087,13,270,3441,226,11116,44
24967,0,68,2454,49,4972,19
4879,0,74,3548,38,2193,36
29885,3,99,2205,78,2054,21
28044,78,1102,2303,830,8406,272
3060,27,1052,3602,859,18466,193
27141,72,4510,2357,3276,22141,1234
22518,63,2931,2569,2202,17872,729
39313,32,548,1692,383,7456,165
40169,2,83,1641,67,3653,16
33298,141,7021,2041,5286,42746,1735
14669,249,11283,2970,8157,47952,3126
29622,15,546,2218,439,7915,107
24578,8,314,2471,238,2871,76
24213,12,219,2489,194,3466,25
37973,14,137,1781,112,5001,25
16351,1,93,2884,80,2072,13
14347,139,5171,2992,3404,22994,1767
1816,3,121,3625,99,17578,22
14735,10,390,2965,281,7116,109
10350,7,318,3241,275,17852,43
43061,5,165,1178,103,4459,62
8168,19,498,3366,420,8881,78
36352,3,85,1882,71,3134,14
33531,2907,77042,2031,53951,265997,23091
20290,11,676,2692,538,13519,138
14248,67,3158,3001,2504,33904,654
27993,5,121,2306,105,3104,16
46181,38,526,261,431,9653,95
27683,48,1431,2324,1139,14332,292
27616,16,1933,2328,1559,45110,374
28872,11,385,2256,282,5314,103
43405,2,30,1074,17,1673,13
41331,38,1200,1521,907,19622,293
35419,20,377,1947,327,6960,50
11971,3,129,3156,108,3827,21
2269,7,94,3615,77,3954,17
42146,63,1946,1387,1504,35588,442
6665,1208,59980,3463,40181,195411,19799
21352,12,766,2632,551,13069,215
25534,13,727,2430,632,11396,95
20364,4,236,2690,195,7506,41
7191,20,333,3436,286,2856,47
4860,7,163,3549,137,4008,26
26936,5,129,2365,107,2753,22
41689,36,395,1469,306,6569,89
6735,45,2031,3460,1343,15366,688
10306,14,258,3244,218,4312,40
24398,2,62,2480,46,1814,16
1257,22,25977,3846,6032,22130,19945
14015,18,1408,3014,1150,21226,258
2496,6,292,3611,195,29073,97
6113,7,321,3486,258,10377,63
6432,17,428,3473,316,5904,112
10155,94,3847,3250,2958,52051,889
18197,148,6013,2793,4480,30449,1533
34745,6,1312,1983,976,25796,336
15250,58,1022,2935,845,13294,177
34628,13,738,1990,555,12353,183
18330,90,6871,2787,4904,51677,1967
42484,72,897,1317,708,41533,189
39418,93,1247,1686,954,11458,293
43387,33,1162,1080,742,19400,420
2503,20,754,3611,532,8747,222
37070,13,345,1841,294,9187,51
22802,17,775,2556,496,5574,279
25110,2,103,2447,80,4335,23
15788,1,96,2910,67,6863,29
43749,9,229,963,190,8603,39
11145,36,1354,3198,976,12264,378
11949,62,3047,3158,2205,51238,842
8712,114,1847,3330,1375,15919,472
44162,323,10360,888,8456,45467,1904
16901,29,1731,2857,1297,9568,434
27119,1,147,2358,127,5107,20
36012,11,482,1902,374,8708,108
38224,1,88,1764,66,3458,22
34732,1,138,1984,108,3721,30
31258,23,920,2136,754,15450,166
2788,7,92,3607,81,4178,11
3140,22,743,3600,625,8052,118
42555,4,77,1303,58,4404,19
40249,0,38,1635,27,1811,11
7290,1,109,3431,94,7986,15
41824,20,825,1441,644,17907,181
44337,3062,61790,861,46034,224035,15756
35693,3,102,1926,85,3465,17
40318,5,269,1630,203,10511,66
7695,26,737,3406,596,14512,141
16230,25,1720,2891,1380,24130,340
7647,84,6424,3409,4676,51665,1748
9111,62,915,3307,703,10359,212
42686,4,269,1275,191,8352,78
31340,872,39435,2132,29265,280520,10170
6917,3,77,3451,62,2263,15
7693,92,1789,3406,1306,13823,483
13616,13,197,3048,157,2323,40
34065,3,166,2013,127,3426,39
45331,0,1395,584,1145,9095,250
26808,13,492,2371,405,5497,87
26796,32,675,2371,528,5543,147
35112,13,120,1963,102,2717,18
11878,6,446,3161,347,10391,99
30728,8,93,2160,83,5484,10
41537,34,771,1493,589,9365,182
30381,58,1929,2179,1538,7642,391
36020,21,396,1902,328,6323,68
39118,4,105,1705,89,2952,16
20755,11,707,2670,556,5020,151
43437,31,335,1067,273,4146,62
39443,40,867,1685,668,12453,199
5336,25,919,3523,638,13350,281
2948,15,494,3604,399,11650,95
14018,1,41,3014,30,2716,11
6123,10,498,3486,399,12810,99
7151,7,544,3437,406,8641,138
3328,5,125,3597,105,4197,20
35978,230,24816,1905,18921,100790,5895
3401,18,1053,3595,757,21717,296
23150,896,29376,2539,19921,143285,9455
41524,24,999,1495,758,17126,241
26477,35,1061,2386,856,19118,205
26896,38,604,2367,479,7122,125
41621,44,2002,1479,1187,14868,815
22568,1,88,2566,74,2025,14
4198,36,1320,3575,1016,32177,304
16821,26,1821,2860,1218,9423,603
30012,60,2266,2199,1883,15869,383
17855,9,558,2810,432,8071,126
20375,4,713,2689,602,12781,111
34562,4,70,1993,63,6812,7
12272,23,951,3140,751,24056,200
32945,191,7509,2055,5738,59040,1771
38618,25,769,1736,584,18894,185
16811,17,1059,2860,867,8627,192
1509,2,46,3707,41,4525,5
42672,0,174,1279,129,8017,45
2668,18,593,3609,460,5203,133
37282,67,677,1827,517,7877,160
2709,9,428,3608,325,10447,103
2544,14,201,3611,171,5750,30
9707,7,358,3272,308,6253,50
13843,6,340,3030,247,6634,93
7308,42,1428,3430,1093,8999,335
9059,14,502,3311,347,9167,155
16863,11,667,2858,569,5454,98
14261,11,328,2999,269,4096,59
5641,25,1857,3507,1375,31463,482
32462,2,144,2075,121,13545,23
11976,15,864,3156,636,7057,228
15897,16,541,2907,408,9612,133
44146,2397,68957,892,49369,381273,19588
29496,1,57,2224,49,2264,8
36176,4,118,1891,100,3121,18
34581,2,483,1993,395,8121,88
14685,0,0,2969,0,6180,0
15244,1,432,2936,361,7257,71
7229,56,2173,3434,1735,11283,438
45930,21,241,369,173,3970,68
12781,17,512,3112,380,7344,132
33483,4,153,2034,103,3471,50
33891,19,330,2019,287,5115,43
3352,148,4712,3596,3863,35164,849
38881,0,36,1719,28,4859,8
37719,54,4160,1800,3185,27045,975
34525,527,44650,1995,30363,169874,14287
19384,95,3023,2741,2152,16682,871
39204,2,56,1699,43,4272,13
29565,38,750,2221,615,6687,135
37350,16,478,1824,360,4938,118
4484,104,3992,3564,2718,21220,1274
43790,40,321,948,262,6539,59
16063,9,899,2898,680,32924,219
10242,21,900,3246,732,16643,168
28174,75,739,2296,574,5928,165
3099,5,217,3601,178,8947,39
10226,8,326,3247,244,4413,82
12256,85,2540,3141,1980,36106,560
19184,2,131,2751,109,15457,22
39867,4,209,1660,142,4629,67
20319,10,428,2692,358,9322,70
25845,33,1025,2415,837,9505,188
27698,3,116,2323,97,4048,19
11836,13,586,3163,435,7160,151
12820,2,302,3110,249,4606,53
20446,157,8036,2685,5084,48483,2952
28718,229,13946,2264,9998,102680,3948
8499,230,15577,3344,11380,159295,4197
10419,15,0,3238,0,51185,0
38068,54,1286,1775,1082,14864,204
32233,11,531,2084,397,5971,134
5402,7,86,3519,72,2630,14
3907,2,164,3584,131,5199,33
41299,9,132,1525,106,2487,26
18501,72,2618,2780,2002,18202,616
3444,2,23,3595,20,2409,3
16443,231,14284,2880,10159,63851,4125
17089,62,1751,2845,1408,21522,343
2686,52,3801,3608,2793,44514,1008
16556,17,565,2875,404,2888,161
20523,4,30,2681,21,1800,9
45795,4,40,424,37,1462,3
20988,2,105,2653,91,3350,14
10811,829,40638,3215,27715,103149,12923
40497,11,233,1611,185,5132,48
42056,8,308,1405,222,6280,86
8839,0,14,3323,11,1320,3
10991,165,6313,3206,4825,29759,1488
33948,13,676,2017,531,21739,145
4777,6,302,3553,243,3352,59
18190,4,77,2793,62,3886,15
2623,99,3173,3609,2488,40521,685
43679,3,50,984,43,2419,7
25285,3,176,2441,136,6911,40
6896,1,91,3453,67,9591,24
43894,3,35,934,30,1633,5
13053,56,943,3095,693,21236,250
27836,0,0,2315,0,7435,0
7015,5,165,3445,146,3307,19
26024,15,796,2407,609,7100,187
32626,10,486,2068,385,11996,101
6170,1,216,3484,174,6109,42
36777,38,707,1859,581,13258,126
45838,6,71,409,65,2974,6
42798,6,114,1247,86,5452,28
14878,4,357,2956,296,12402,61
14668,42,920,2970,760,10028,160
45096,505,13072,662,10814,40306,2258
12515,18,783,3126,606,11509,177
12028,33,1326,3154,1090,10300,236
28446,33,1391,2280,1021,10330,370
42224,39,1211,1369,916,13126,295
43036,11,203,1186,166,2219,37
11446,53,1911,3182,1518,18579,393
30528,15,908,2170,699,5909,209
41505,32,380,1496,294,3288,86
6714,8,478,3461,280,5537,198
10174,15,664,3249,491,12905,173
30137,4,244,2194,190,5606,54
40765,12,243,1588,190,5442,53
6294,34,1295,3479,920,12086,375
4489,170,7351,3564,5270,54317,2081
5593,8,134,3510,112,5130,22
43109,7,385,1164,248,14372,137
12665,28,615,3118,485,5136,130
18567,36,870,2777,691,16422,179
21801,2,82,2607,75,4052,7
40005,115,4496,1650,3249,34220,1247
36899,3,90,1852,65,2741,25
5111,12,645,3535,485,8460,160
1860,11,381,3623,299,11869,82
10135,35,1025,3251,798,23604,227
30873,21,416,2154,300,4539,116
4112,29,767,3577,611,13584,156
9647,2,130,3274,110,2757,20
37520,32,930,1812,686,9655,244
34555,6,230,1994,180,4019,50
12457,48,45416,3129,16002,15838,29414
45749,1626,44927,439,36361,329925,8566
9941,3,327,3261,265,8473,62
15111,109,5503,2943,4151,57827,1352
26487,4,117,2386,101,2652,16
13513,49,3247,3055,2677,18488,570
35524,2,93,1939,81,5242,12
34010,194,4828,2015,3537,22450,1291
4517,19,732,3563,588,25362,144
17759,6,266,2813,205,3634,61
8371,10,243,3352,194,8067,49
5696,5,480,3504,242,3313,238
21835,4,217,2606,168,13672,49
5449,10,149,3517,127,6679,22
11578,19,1230,3175,879,16209,351
2903,9,157,3605,131,4288,26
37061,66,1861,1841,1413,28416,448
41108,103,1168,1554,851,9470,317
41992,3,261,1415,192,11292,69
6101,11,369,3486,274,5707,95
11207,28,1271,3194,918,16807,353
9513,20,1043,3281,817,22803,226
42317,26,725,1351,539,5424,186
17007,5,653,2851,461,4579,192
39952,15,668,1654,438,14755,230
40481,218,6149,1613,4639,26991,1510
39326,1,60,1691,42,2132,18
5167,1,92,3532,82,5293,10
3960,51,1730,3583,1478,17190,252
36540,2,26,1873,23,2109,3
10076,18,472,3253,353,5961,119
38655,123,1444,1733,1127,10299,317
5293,7,314,3525,259,4741,55
35817,103,2880,1916,2077,32981,803
45270,8,395,601,298,7305,97
44990,13,147,705,131,3146,16
24821,8,375,2461,327,3193,48
37366,293,5868,1823,4321,36308,1547
17887,7,380,2808,312,6291,68
31592,3,143,2118,112,9219,31
26579,6,432,2382,346,17676,86
3301,2,67,3597,45,4821,22
18324,51,3277,2787,2257,14024,1020
12487,49,1645,3128,1327,17188,318
18527,5,182,2779,161,2410,21
45320,232,2426,587,2027,24749,399
42793,81,1109,1248,843,15453,266
7875,5,284,3392,207,10523,77
15122,8,668,2942,464,13046,204
46287,13,235,232,211,3998,24
14770,3,139,2962,117,5302,22
35077,5,107,1965,91,2273,16
19591,227,14919,2731,9083,75511,5836
19227,1,39,2750,31,3909,8
6571,5,60,3467,48,2305,12
35027,58,3731,1968,2874,27265,857
31689,18,600,2112,503,9617,97
17410,50,4172,2827,3323,27279,849
35518,3,328,1940,261,4892,67
28378,829,107688,2284,73908,176896,33780
26913,5,228,2366,200,2474,28
4299,69,1664,3571,1339,15468,325
11236,9,145,3193,115,3291,30
40631,12,274,1600,211,3262,63
4932,13,792,3545,626,6698,166
16037,61,4393,2900,3207,31555,1186
9002,6,125,3314,103,3880,22
36662,0,28,1866,24,3603,4
15270,78,3502,2934,2686,69339,816
7475,18,690,3420,553,17138,137
35969,1984,50664,1906,34500,250625,16164
25953,58,4188,2410,2796,17153,1392
32823,1,224,2060,170,5218,54
15462,5,297,2927,230,5358,67
40541,5,162,1608,124,2464,38
34588,14,5527,1992,4627,12004,900
34656,7,342,1988,287,6782,55
2681,138,14552,3609,8859,98464,5693
46040,5,103,318,70,2325,33
15971,8,216,2904,163,13580,53
10148,12,917,3250,684,12233,233
29020,7,294,2249,239,3995,55
30682,24,823,2162,673,9037,150
38333,3,73,1757,60,3798,13
16932,414,39266,2855,27016,271770,12250
32774,25,444,2062,352,4802,92
14569,155,5214,2976,4121,26707,1093
4912,12,514,3546,419,6731,95
16192,48,2941,2893,2318,28839,623
6226,258,8043,3482,6279,57218,1764
36669,2,111,1865,92,2923,19
11684,537,27107,3169,19420,269847,7687
29731,1,208,2213,177,9124,31
40876,221,4370,1577,3139,33819,1231
32306,2,219,2082,184,2490,35
28184,4,661,2295,554,9240,107
41088,28,621,1557,451,6193,170
43077,30,1067,1173,761,15579,306
29601,29,1633,2220,1206,18685,427
4466,136,2454,3565,1809,49709,645
42205,11,423,1373,305,8878,118
31927,39,2175,2101,1652,21249,523
3696,11,268,3590,221,13523,47
20286,5,409,2692,334,13329,75
25770,32,2347,2418,1675,13940,672
18633,3,72,2774,61,2800,11
15365,8,201,2930,153,4976,48
43848,2,52,940,37,7221,15
26317,1,26,2394,24,2340,2
10447,73,2408,3237,1749,30356,659
16578,4,338,2874,262,10723,76
36009,2,85,1902,70,2885,15
11673,9,225,3170,170,5409,55
38897,14,441,1718,359,12651,82
1618,3,109,3677,81,4305,28
19628,4093,264094,2730,189417,756928,74677
45325,15,231,585,197,7755,34
7815,36,1046,3398,757,6884,289
9972,17,507,3259,405,4977,102
1887,4,181,3623,152,10639,29
20664,2,98,2674,86,4210,12
20623,105,2782,2677,2145,38026,637
16310,26,683,2887,540,5920,143
19049,6,380,2757,299,3384,81
3731,499,38104,3589,27787,172672,10317
45644,7,78,487,57,4248,21
22284,332,7760,2581,5935,35409,1825
24855,0,1919,2459,1522,14501,397
18344,3,326,2786,250,7418,76
40052,0,3588,1647,2771,16609,817
25332,337,14875,2438,10893,81798,3982
25307,127,4725,2440,3462,34411,1263
40098,32,561,1645,460,7446,101
3598,16,330,3592,252,4507,78
25536,40,998,2430,751,12544,247
42302,146,3015,1355,2078,43218,937
42718,81,1417,1270,1074,11660,343
39030,3,190,1711,152,4856,38
26234,112,3705,2397,2630,16363,1075
24654,2,0,2467,0,3135,0
40708,2,37,1594,27,3261,10
39608,2,145,1675,66,4487,79
22315,4,182,2580,130,6298,52
23880,7,178,2504,145,3672,33
3430,20,762,3595,594,11630,168
10348,13,221,3241,177,4114,44
26164,0,265,2401,203,7263,62
37306,6,226,1826,204,6581,22
10805,3,160,3216,130,10642,30
35189,1,64,1959,58,3933,6
7419,30,1114,3423,819,12720,295
27046,30,819,2362,621,6837,198
43920,442,8823,929,6745,51640,2078
14938,9,281,2952,233,5040,48
26940,15,607,2365,416,6932,191
1107,1,80,3895,68,5617,12
8668,11,1246,3333,910,18834,336
40128,8,361,1643,252,7248,109
36222,5,474,1889,379,8762,95
15547,18,398,2922,320,6330,78
5230,103,4540,3528,3721,30603,819
45970,26,290,353,266,4947,24
40937,11,912,1572,666,19170,246
4680,19,370,3557,311,3436,59
5156,994,38776,3532,26592,239646,12184
7055,168,7980,3443,5974,49288,2006
28404,5,269,2282,218,4274,51
41101,9,433,1555,345,5778,88
29874,0,49,2205,37,2574,12
45977,2,97,349,72,1701,25
26515,28,1540,2384,968,11258,572
29534,4,377,2222,277,16469,100
44299,14,116,868,87,3424,29
15996,0,36,2902,29,2938,7
27759,12,428,2320,349,6550,79
2812,41,1199,3606,985,16633,214
36488,33,850,1876,670,11405,180
7280,7,339,3431,243,3911,96
27069,12,530,2361,443,8799,87
23080,538,15502,2542,10518,65861,4984
45917,13,175,379,148,1960,27
27912,4,116,2310,82,2906,34
5393,6,151,3520,125,3880,26
27020,158,10529,2364,7637,72141,2892
46027,30,414,328,355,6749,59
12155,58,2967,3146,2243,33216,724
18489,12,634,2780,530,15577,104
28292,24,533,2289,427,5000,106
16795,99,25720,2861,18274,93637,7446
28083,74,2589,2301,2202,35878,387
39327,82,1331,1691,1028,14952,303
42273,51,1643,1359,1019,14990,624
9121,14,727,3307,504,12063,223
44225,62,598,877,464,9300,134
40278,128,3336,1633,2354,45064,982
45134,7,60,642,44,1933,16
16369,0,0,2884,0,2904,0
10043,1,138,3255,117,4825,21
25692,16,362,2422,297,5805,65
21237,88,6654,2637,5020,45717,1634
41315,150,3325,1523,2372,46127,953
5991,10,152,3490,128,5238,24
29692,69,1718,2215,1301,15472,417
19016,27,2732,2758,2026,9871,706
10102,58,2488,3252,1936,33166,552
12411,93,5309,3132,3778,46004,1531
16744,81,3348,2865,2397,47411,951
4529,15,1258,3563,895,9547,363
28475,2,59,2279,49,3038,10
8835,12,141,3323,119,3448,22
16144,12,1279,2895,1025,14335,254
45102,282,2593,657,2150,24298,443
1266,8,198,3843,163,6987,35
16495,158,25661,2878,17197,53910,8464
6079,2,67,3487,54,2249,13
42685,0,0,1275,0,4074,0
33928,5,552,2018,459,7242,93
37261,39,834,1829,671,28945,163
4840,7,114,3550,90,4068,24
34360,10,169,2003,141,3265,28
45362,3,129,577,59,3913,70
20433,16,660,2686,440,7507,220
18607,25,1070,2775,837,12486,233
17985,3,154,2802,123,5500,31
8500,2105,104516,3344,69621,288739,34895
22145,1,90,2588,73,7951,17
43833,85,1049,926,843,15640,206
6029,3,97,3489,84,2696,13
4556,11,572,3561,392,9266,180
25749,7,134,2419,116,1854,18
46340,2,35,210,30,1937,5
34120,18,462,2011,378,6446,84
4874,38,667,3548,563,11958,104
41413,64,1678,1509,1211,17263,467
36616,9,761,1868,565,5185,196
3032,9,380,3602,283,3407,97
40940,191,4845,1572,3391,31701,1454
35140,8,317,1961,265,9993,52
26291,810,71654,2395,41677,242934,29977
46116,9,208,292,168,4959,40
14276,87,2287,2999,1700,15291,587
19078,12,689,2756,597,4245,92
25417,3,230,2435,190,5921,40
40057,24,394,1647,301,7371,93
14710,1,49,2967,38,6454,11
19880,17,868,2716,680,9023,188
2736,19,1358,3608,1112,14740,246
12034,11,780,3154,548,4119,232
19427,38,3261,2739,1890,25599,1371
22321,6,131,2580,91,5696,40
42732,22,594,1266,452,12384,142
32740,14,230,2064,190,2806,40
4784,4,208,3553,180,6808,28
2116,20,513,3618,376,14887,137
30099,21,1439,2195,1121,11771,318
16749,28,1908,2865,1567,17984,341
27511,2,204,2334,158,4637,46
42522,2,47,1309,34,1771,13
44924,8,385,726,277,4158,108
36489,9,629,1876,540,6352,89
41015,3,246,1566,190,3866,56
6416,111,3634,3474,2670,25666,964
10520,27,483,3233,381,3907,102
5444,7,97,3518,76,2921,21
15271,8,517,2934,419,8858,98
33232,3,148,2044,122,3118,26
20437,9,495,2686,379,5009,116
29256,1,491,2237,377,6450,114
28339,15,1532,2286,1079,17212,453
40771,37,681,1587,479,7798,202
25558,318,10598,2429,6836,84498,3762
10196,11,226,3248,188,7823,38
3576,7,851,3592,644,17398,207
35111,85,4404,1963,3426,24910,978
36994,111,3131,1846,2435,18423,696
14734,6,170,2965,138,5042,32
40302,32,576,1632,443,13315,133
39097,7,134,1706,105,6803,29
38776,26,557,1726,464,12432,93
45229,155,1568,616,1215,6792,353
30025,1,242,2199,203,9929,39
11166,6,142,3196,122,8872,20
10848,12,188,3214,161,3468,27
16411,44,1456,2881,1097,11957,359
2272,173,3647,3615,2697,25956,950
22263,4,235,2582,213,4035,22
26160,4,158,2401,133,5616,25
19402,16,952,2740,800,14402,152
39879,6,89,1659,72,2621,17
15306,8,508,2932,413,13021,95
37447,122,1510,1817,1108,8815,402
28435,5,116,2281,103,8194,13
32721,7,244,2064,203,9766,41
19943,5,118,2712,104,3511,14
26269,18,641,2396,523,3702,118
45326,22,228,585,178,4191,50
29209,1,90,2239,71,4591,19
10252,19,677,3246,534,15479,143
1923,50,3728,3622,2931,36790,797
9192,7,219,3302,191,5621,28
43745,368,12449,963,10177,92980,2272
36113,15,677,1895,559,8483,118
3441,7,80,3595,51,3278,29
46145,4,113,272,64,1735,49
36763,43,593,1860,449,7525,144
33795,2,76,2022,64,2382,12
41639,123,1271,1476,929,14178,342
34717,7,277,1985,210,5882,67
26664,2,70,2378,63,3683,7
35551,3309,144628,1937,91402,503872,53226
24361,11,315,2482,243,3217,72
40420,4,230,1620,175,2463,55
40369,3,126,1623,106,3438,20
11740,29,383,3167,281,5074,102
8452,48,1930,3348,1600,22766,330
5819,5,191,3499,151,4294,40
43567,391,5233,1026,3828,54176,1405
45089,7,109,666,69,2981,40
34123,2,42,2011,33,2221,9
3453,66,2582,3595,1864,21620,718
6241,21,701,3482,545,8267,156
26329,367,13281,2394,9113,61127,4168
40003,13,411,1650,312,8211,99
5233,40,1472,3528,1174,23820,298
19844,1,131,2717,111,9905,20
38441,24,597,1749,372,4443,225
38126,19,381,1771,308,9691,73
3374,114,3615,3596,2820,44596,795
1446,2,45,3733,34,2671,11
28771,1,89,2261,75,3145,14
4223,12,369,3574,297,6229,72
26389,2830,92897,2390,66542,337659,26355
36026,71,893,1901,713,6892,180
39851,25,812,1662,598,5688,214
14465,1,102,2984,81,3555,21
31273,136,5788,2135,4721,28216,1067
12353,17,555,3136,399,20707,156
28768,0,36,2261,33,1718,3
14080,13,398,3010,340,7788,58
35144,25,648,1961,516,6173,132
5316,5,221,3524,193,4497,28
38686,5,188,1731,131,3548,57
2347,124,4029,3614,2817,16179,1212
45638,22,370,433,328,3122,42
39251,28,1036,1695,717,11304,319
40406,49,547,1621,402,6245,145
40877,96,2115,1577,1549,27733,566
3269,44,1637,3598,1336,28374,301
21593,28,649,2618,530,5940,119
45926,45,1480,2522,1241,7780,239
8709,11,371,3330,302,5418,69
3141,10,362,3600,297,4418,65
38595,2,101,1738,68,7312,33
34324,1128,33764,2005,21088,217297,12676
23566,102,3539,2518,2741,25184,798
11384,12,382,3186,304,7441,78
1535,3,26,3693,22,1677,4
7837,196,5208,3396,3867,58202,1341
15266,3,285,2935,221,6207,64
40806,120,3176,1583,2279,37393,897
40211,146,6023,1638,4790,39555,1233
42226,8,246,1368,196,4994,50
23058,12,685,2543,572,9755,113
4758,1,100,3554,84,13468,16
3590,7,164,3592,136,14830,28
42696,22,198,1273,149,3686,49
33331,7,188,2040,131,6090,57
14761,81,5398,2963,3901,26402,1497
6458,19,809,3472,645,18573,164
41356,97,2389,1518,1875,24782,514
23301,13,396,2531,328,6359,68
41359,34,477,1517,358,5901,119
41713,10,188,1465,147,3896,41
13641,4,116,3046,89,4425,27
45245,9,70,611,49,2518,21
37863,132,3402,1789,2711,25912,691
6923,84,4527,3451,3459,39942,1068
26787,87,3504,2372,2686,14643,818
32932,23,429,2055,350,4857,79
1008,5,124,3930,103,5541,21
38676,7,171,1732,130,4038,41
41018,10,230,1566,177,6436,53
11933,25,637,3158,435,17043,202
37553,43,1196,1810,980,14095,216
41953,14,213,1421,171,4361,42
20098,38,5730,2704,4027,45046,1703
20062,0,728,2706,570,8536,158
17218,90,3465,2838,2526,39474,939
22729,8,1345,2560,965,13789,380
20499,12,640,2683,549,5690,91
27421,214,7379,2340,5316,35446,2063
42247,13,424,1364,302,5881,122
4005,52,1359,3581,1072,14621,287
26870,11,560,2368,438,6670,122
22311,7,500,2580,418,11086,82
25297,30,916,2440,759,11024,157
11221,72,1792,3193,1467,37481,325
13795,26,1718,3034,1333,12765,385
46074,9,145,304,105,1997,40
1268,3,78,3843,62,3101,16
6321,85,6661,3478,4642,56053,2019
36712,6,221,1863,174,2772,47
35626,2,47,1932,36,2323,11
19355,42,6314,2743,4685,73134,1629
2215,177,9301,3616,7023,49431,2278
36643,20,641,1866,512,7576,129
36957,1,119,1848,89,5422,30
45542,2,21,527,18,1275,3
45880,90,1078,392,894,18981,184
11730,11,606,3167,453,11382,153
32647,13,430,2067,364,11521,66
26089,16,508,2404,401,5411,107
31029,164,5560,2147,4492,40912,1068
37609,2,133,1806,112,4192,21
18593,17,281,2776,211,3351,70
12422,76,2833,3131,2223,25508,610
22963,4,165,2547,135,4736,30
21124,12,706,2646,566,21854,140
1943,69,2349,3621,1712,18139,637
21248,555,35614,2637,26118,202105,9496
35084,16,299,1965,252,4929,47
25353,45,1418,2438,1115,20595,303
8410,14,589,3350,435,13672,154
20354,84,4297,2690,3011,38096,1286
20836,5,245,2664,212,6506,33
41402,16,584,1511,432,10489,152
1797,319,11098,3626,8170,51242,2928
29325,6,80,2232,66,2361,14
3964,16,253,3583,191,5046,62
45319,22,348,587,221,4387,127
36713,10,178,1863,134,6804,44
29640,85,5754,2217,4368,30265,1386
45747,9,229,440,128,4718,101
46231,2,23,249,13,1502,10
40796,33,1178,1585,944,14505,234
32484,11,246,2074,209,4619,37
23314,68,1706,2531,1216,14008,490
37649,10,357,1804,306,5926,51
13761,9,310,3035,266,4040,44
38471,1835,129225,1747,82848,458832,46377
23851,11,240,2505,180,4833,60
26493,22,442,2386,355,3217,87
40209,78,1259,1638,938,17414,321
12339,100,17411,3137,12646,43427,4765
12651,2,58,3119,53,1551,5
13339,63,2985,3069,2362,33027,623
12706,14,343,3116,286,3551,57
15770,30,1150,2911,883,18414,267
42493,361,6582,1315,4905,40223,1677
27975,6,160,2307,138,2818,22
16802,11,541,2861,421,8930,120
19171,10,743,2752,594,8122,149
31743,1,63,2110,50,2441,13
39375,36,1414,1689,998,11504,416
43988,6,165,920,141,3963,24
27554,43,872,2331,646,6558,226
9766,2,52,3269,41,2912,11
43146,7,157,1153,98,4649,59
28474,2,82,2279,47,3182,35
42744,46,434,1261,339,6557,95
29222,24,1066,2239,866,17824,200
38135,208,7035,1770,5070,59060,1965
6605,5,61,3466,46,2341,15
30783,28,521,2158,410,5920,111
24362,2,207,2482,173,9040,34
32630,1,79,2068,66,2736,13
22052,16,435,2593,346,7324,89
45129,274,2839,644,2348,15012,491
36078,13,1082,1897,679,11201,403
23742,56,1188,2510,951,15268,237
27934,2,128,2309,111,5913,17
26857,11,441,2369,362,10567,79
7928,3,98,3386,82,3835,16
24325,14,756,2483,555,7435,201
1922,66,3575,3622,2468,21271,1107
4238,185,6818,3573,5447,119121,1371
45480,32,423,547,348,4789,75
34698,3,91,1986,72,3581,19
4439,18,324,3566,258,10874,66
41288,3,284,1528,227,7096,57
44087,125,9084,892,6605,26668,2479
40153,19,443,1642,349,7242,94
5822,26,605,3498,437,9324,168
3780,6,57,3588,48,6595,9
26331,1,97,2393,79,8325,18
23643,24,1037,2514,804,9424,233
26603,5,652,2381,522,16911,130
20709,0,82,2672,74,2532,8
45570,85,2343,515,1994,14794,349
2610,6,108,3609,88,4284,20
4114,22,999,3577,823,17185,176
22338,53,2479,2579,1880,17024,599
4235,11,363,3573,286,11127,77
7169,14,291,3437,222,5293,69
11457,74,77128,3182,31799,56321,45329
22197,171,7628,2585,5563,36105,2065
33299,213,17822,2041,12479,100109,5343
18583,26,921,2777,703,16557,218
27613,2,72,2328,61,2018,11
40470,57,1567,1614,1142,18628,425
38669,22,337,1733,271,14620,66
20818,57,2887,2665,2301,19491,586
36842,50,2753,1854,2245,24124,508
23655,3,47,2514,38,18989,9
34388,5,167,2002,133,4357,34
4013,5,151,3581,112,3810,39
33174,7,327,2045,287,3999,40
35826,2,76,1916,63,4326,13
30753,0,138,2159,110,6121,28
2675,1,23,3609,21,2415,2
13987,1676,66221,3017,46109,148709,20112
27228,5,347,2352,267,5202,80
32578,6,302,2070,244,4859,58
15620,38,4052,2918,3126,32635,926
45236,13,273,614,192,4263,81
32724,24,305,2064,248,2863,57
7306,16,271,3430,227,6189,44
38032,9,239,1778,178,4021,61
30811,4,213,2156,181,6530,32
20340,23,466,2691,395,3727,71
37707,29,471,1801,369,8459,102
30423,2,104,2176,81,3140,23
18140,0,45,2795,33,5187,12
29108,7,334,2244,281,3980,53
36676,4,131,1865,106,5764,25
26887,0,227,2367,175,9655,52
19966,4,338,2711,240,7581,98
22720,88,3654,2560,2909,26103,745
23148,4,180,2539,146,2419,34
36158,87,952,1892,733,6947,219
43656,36,389,988,343,6664,46
31085,307,13213,2145,9272,58884,3941
8174,27,993,3366,791,58733,202
17140,0,67,2842,51,2505,16
38994,22,735,1713,593,8586,142
12368,3,186,3135,162,6469,24
20254,1,152,2694,104,2008,48
12805,14,1909,3110,1195,33639,714
37678,14,690,1803,563,16579,127
9696,5,100,3272,81,2102,19
17127,44,4672,2843,3250,12978,1422
10355,128,3177,3241,2521,55332,656
16535,25,2255,2876,1647,38010,608
15021,2,105,2948,89,2841,16
8593,10,675,3338,565,5406,110
35255,53,2157,1954,1810,20433,347
29173,7,138,2241,114,4922,24
1908,195,5066,3622,3359,19882,1707
46014,9,349,331,181,2210,168
1126,4,244,3891,209,5798,35
8351,6,251,3353,180,4064,71
4857,8,257320,3549,87136,4480,170184
44945,187,8268,720,4267,61971,4001
1680,0,34,3660,31,1647,3
16920,0,4391,2855,3386,39643,1005
18245,8,318,2790,242,4928,76
16745,285,20264,2865,14646,124985,5618
32767,1,46,2062,35,1879,11
19865,31,1402,2716,1081,12995,321
2691,1242,56751,3608,38097,203104,18654
25524,1416,69406,2430,43089,239829,26317
4294,43,1962,3571,1481,23820,481
45217,2,31,618,18,1710,13
6494,4,50,3470,42,1874,8
35131,23,470,1962,390,7079,80
7370,52,2702,3426,1958,10617,744
27753,14,440,2320,352,6153,88
1036,8,153,3916,124,5698,29
32671,3,120,2066,99,2787,21
46243,144,2482,245,2027,19668,455
18109,6,245,2797,200,3581,45
27628,14,463,2327,366,9405,97
29833,10,297,2208,257,8095,40
3429,368,24440,3595,18776,90690,5664
4658,8,481,3557,363,6153,118
30972,42,947,2150,775,24353,172
6199,21,710,3483,429,4018,281
19235,22,728,2749,553,6186,175
13731,3,73,3038,59,6505,14
41984,2,147,1416,108,5258,39
24968,43,2222,2454,1735,25896,487
6491,28,540,3470,439,9513,101
9621,5,277,3275,215,4243,62
23682,0,93,2512,59,3019,34
42335,4,109,1348,76,3167,33
32055,21,996,2094,695,17719,301
29124,47,1264,2243,995,7393,269
26437,4,170,2388,123,7410,47
7578,37,1721,3413,1271,19901,450
35259,54,1259,1954,1020,19107,239
40555,327,6338,1606,4512,21658,1826
14295,292,34750,2996,22696,133657,12054
28710,4,223,2265,181,10165,42
14703,0,48,2967,39,3517,9
9743,14,444,3270,359,12874,85
20106,201,12094,2703,8308,65849,3786
26831,2,35,2370,28,1440,7
17980,155,5759,2803,4507,46534,1252
11454,2,42,3182,34,1138,8
37519,2,232,1812,201,12281,31
43547,17,332,1032,230,7047,102
18971,0,94,2760,83,1893,11
9337,0,48,3293,42,3029,6
1013,1,7,3927,5,1808,2
23050,111,4111,2544,3155,44697,956
37943,16,466,1783,376,5480,90
24314,0,162,2484,128,3069,34
32198,20,1077,2086,828,14086,249
998,37,3048,3932,2286,28373,762
27417,146,14005,2340,9478,48225,4527
29947,44,674,2202,551,9703,123
20373,77,3939,2689,3003,18815,936
10050,2,105,3255,92,3588,13
17646,4,59,2817,50,5565,9
43918,12,259,929,175,4655,84
5746,352,15010,3502,10555,120696,4455
22300,2,125,2580,82,3134,43
24367,42,812,2482,639,5498,173
24204,1,50,2489,38,1797,12
36678,6,171,1865,151,7476,20
39468,12,170,1684,129,2400,41
24638,16,789,2467,594,11042,195
13522,2,87,3054,69,2710,18
23608,8,465,2516,342,10692,123
31447,0,259,2126,210,8083,49
1633,4,194,3673,147,18491,47
17126,11,335,2843,286,3939,49
30775,2,31,2158,26,2520,5
6202,2,58,3483,47,2564,11
40239,6,172,1636,141,7535,31
26635,39,1018,2380,770,18317,248
3923,6,253,3584,199,9958,54
7800,143,6811,3399,4759,37600,2052
7072,11,1011,3442,781,10083,230
36961,4,75,1847,56,6704,19
37096,344,13547,1839,8091,77219,5456
7008,12,295,3446,230,11300,65
20990,10,996,2653,785,4855,211
3253,25,670,3598,555,3593,115
11274,4,148,3191,118,9471,30
41429,34,1570,1507,1197,7349,373
31478,9,208,2124,162,4442,46
7013,118,8182,3446,6095,54523,2087
43693,5,150,979,99,2905,51
20472,3,138,2684,113,4875,25
18295,9,425,2788,370,4799,55
40931,9,122,1573,98,3796,24
33167,6,153,2045,95,4246,58
9343,113,2977,3292,2410,15569,567
38656,1,33,1733,26,2400,7
7250,11,183,3433,150,3787,33
9174,45,1320,3302,1051,25215,269
16559,6,654,2875,510,9337,144
18618,5,228,2775,182,12052,46
24180,25,696,2490,540,8891,156
7663,185,7488,3408,5129,41980,2359
13398,424,21582,3064,14864,113059,6718
21862,644,13232,2604,10167,51647,3065
31108,25,495,2144,406,3514,89
25180,2,36,2444,32,2305,4
15458,10,674,2927,494,9520,180
28506,0,63,2277,53,2524,10
44848,32,356,745,234,10412,122
3607,16,357,3592,294,4603,63
30352,2,102,2181,84,4205,18
45804,10,129,419,90,2013,39
25516,0,21,2431,16,2277,5
10470,51,2843,3235,2166,58328,677
15225,66,6140,2936,4559,27659,1581
26058,1,108,2405,95,3642,13
14426,18,847,2986,623,9904,224
41459,9,251,1502,190,6288,61
42952,14,244,1210,164,13623,80
12199,20,1434,3145,1136,4811,298
18467,7,152,2781,104,6564,48
2884,56,1969,3605,1538,33213,431
40752,285,5362,1589,3860,36921,1502
39727,7,128,1669,115,2830,13
7032,0,93,3444,73,3236,20
30472,13,580,2174,444,5800,136
18453,9,724,2782,568,7974,156
38076,11,96,1775,76,2086,20
39284,17,1067,1693,818,12987,249
11704,20,696,3168,539,21387,157
12483,36,1293,3128,1020,13362,273
19154,112,10417,2753,7335,81710,3082
19806,19,778,2720,637,13728,141
16226,39,1074,2891,848,8533,226
3660,5,297,3590,252,8149,45
21724,272,19459,2611,13045,143570,6414
41574,80,822,1489,604,9897,218
35465,8,319,1944,252,6690,67
19087,12,824,2755,644,13058,180
8113,434,15091,3369,11059,65418,4032
24122,0,131,2492,108,5118,23
29477,2,90,2225,79,2976,11
40574,9,273,1604,208,5416,65
8192,8,188,3364,158,8623,30
44942,15,318,721,276,5898,42
13325,4,214,3070,166,8651,48
8246,7,385,3361,267,7452,118
20323,12,621,2692,509,24901,112
46368,0,46,197,35,1402,11
19656,3,345,2728,256,6444,89
43787,3,166,950,152,7478,14
5255,30,742,3527,551,5770,191
45884,23,170,389,139,2839,31
11172,63,6115,3196,4518,92937,1597
43013,64,1399,1192,1121,36353,278
41028,2,56,1565,39,1968,17
10479,79,7150,3235,5327,57820,1823
5118,1114,50166,3535,23429,98539,26737
6528,5,388,3469,301,5009,87
4669,25,2601,3557,1950,52872,651
39524,2,75,1681,39,3330,36
6502,13,300,3470,244,3927,56
39946,63,2621,1654,1970,20923,651
22182,53,1576,2586,1162,10023,414
2889,73,3347,3605,2582,23179,765
23026,67,1644,2545,1166,8447,478
19425,1,312,2739,217,7196,95
14707,13,3824,2967,2684,75192,1140
4476,13,208,3564,160,14755,48
10944,4,61,3208,50,2251,11
40731,328,5442,1592,4476,39172,966
2519,15,612,3611,466,16323,146
10726,107,2298,3220,1745,47215,553
39960,14,202,1653,169,3639,33
37225,26,911,1831,721,12616,190
19073,1,262,2756,195,6456,67
31191,0,124,2139,91,2586,33
11852,14,593,3162,475,8633,118
35156,5,147,1960,124,4141,23
41357,11,191,1518,158,3932,33
13710,45,2207,3040,1703,35187,504
32120,17,888,2090,668,10712,220
2842,4,170,3606,149,10752,21
4579,61,1288,3560,957,15759,331
24136,8,321,2492,269,10294,52
37897,62,2883,1786,2203,42783,680
36124,38,669,1894,510,6439,159
13206,6,183,3078,151,3773,32
23465,5,378,2523,318,5132,60
35338,5,303,1951,241,4624,62
15709,0,3662,2914,2825,17398,837
39248,8,173,1695,141,13935,32
5905,3,47,3494,36,3116,11
4992,22,412,3542,343,5465,69
40462,551,12301,1615,9125,65438,3176
6422,268,14368,3473,10823,119314,3545
21217,39,1831,2638,1416,12656,415
41561,536,10342,1490,7814,83948,2528
10163,13,618,3250,497,7830,121
15003,12,1326,2949,881,13285,445
39469,10,1164,1684,829,13124,335
46120,1,17,292,14,577,3
16857,71,3147,2858,2294,21064,853
1799,148,9190,3626,6802,50747,2388
39526,3,186,1681,154,5516,32
1099,5,208,3897,159,4716,49
5923,15,340,3493,160,4030,180
36370,1255,29281,1881,20850,135171,8431
30331,17,368,2182,291,9020,77
30145,12,250,2193,191,5736,59
39472,1,42,1683,37,5084,5
22217,9,540,2584,400,4579,140
30534,32,504,2170,417,3946,87
20195,13,628,2698,488,2998,140
31013,5,312,2149,226,4675,86
18934,1,254,2762,208,7176,46
9407,24,1356,3288,1053,15309,303
10067,61,3164,3254,2536,42952,628
21266,0,32,2636,24,1112,8
37420,251,7960,1819,5818,49923,2142
11124,127,7669,3199,5929,44415,1740
41858,2,144,1436,107,2552,37
38044,16,1315,1777,1048,19029,267
43508,10,253,1046,193,6618,60
46155,36,595,272,513,8870,82
19665,63,2603,2728,1993,12488,610
30235,13,456,2188,325,8335,131
39427,5,81,1686,63,6487,18
27072,18,511,2361,377,8344,134
24885,5,111,2458,76,5601,35
46117,1,36,292,23,1480,13
26414,35,1184,2389,995,6355,189
35578,38,1891,1935,1466,17202,425
6576,4,36,3467,33,2769,3
13966,222,9607,3018,6987,76461,2620
19180,60,2486,2752,1832,15132,654
31588,23,1581,2118,1297,17375,284
12646,50,1585,3119,1251,51765,334
11733,29,4007,3167,3005,27401,1002
1427,55,2107,3739,1610,24328,497
5620,55,1577,3509,1138,38900,439
13968,44,2914,3018,2149,32576,765
46118,106,3006,292,2559,20078,447
9218,193,10899,3301,7514,31869,3385
28458,16,402,2280,322,5389,80
30983,16,618,2150,475,8051,143
8060,10,71,3371,51,4611,20
3769,2,102,3588,86,8032,16
12298,6,343,3139,278,11754,65
15491,5,259,2925,197,8405,62
28356,106,3007,2285,2275,21967,732
22944,2,232,2548,180,9957,52
45076,12,154,674,115,4086,39
34482,1,108,1998,94,10822,14
2118,49,1465,3618,1106,27348,359
1961,12,331,3620,262,9005,69
11430,19,3361,3184,1654,21887,1707
8665,1234,57646,3333,39948,177580,17698
4510,6,263,3563,207,5915,56
42617,2,23,1291,19,2326,4
17268,15,377,2835,298,4954,79
4186,801,39229,3575,26836,110260,12393
23162,126,2028,2538,1659,15356,369
33490,19,511,2033,399,4520,112
14781,19,682,2961,473,12384,209
23984,26,283,2498,230,4125,53
4254,208,8291,3573,6088,132839,2203
24417,136,7686,2479,5719,35484,1967
43050,138,1701,1183,1479,28187,222
43054,17,150,1181,125,3103,25
3864,1,48,3586,44,3556,4
10111,2,40,3252,34,2089,6
38009,19,527,1780,444,5595,83
43502,9,110,1047,87,2431,23
45060,15,223,681,185,5218,38
38204,1477,102889,1766,72813,285664,30076
26872,7,629,2368,477,10879,152
36276,13,1916,1886,1298,22304,618
13456,3,96,3058,80,6696,16
14969,35,1230,2951,906,19473,324
13051,930,85164,3095,50661,332981,34503
39769,4,71,1667,59,2870,12
29440,19,771,2227,619,8102,152
45194,80,1007,626,801,7630,206
40749,113,4292,1589,2794,33190,1498
39348,21,2895,1690,2144,12727,751
8311,114,4755,3356,3708,53156,1047
29929,0,47,2203,37,2727,10
14675,2,74,2970,61,4219,13
11032,19,292,3204,215,2925,77
23209,0,16,2536,10,3286,6
36296,17,608,1885,443,8699,165
41525,3,96,1494,81,7803,15
6295,28,1273,3479,897,15547,376
22909,14,564,2550,449,8319,115
42153,24,813,1384,557,9398,256
3857,65,215518,3586,80678,17495,134840
26200,794,39905,2399,28774,125059,11131
7374,44,924,3425,758,4974,166
33194,2,133,2045,113,3930,20
11366,214,16254,3187,12003,56534,4251
38632,2,163,1734,123,6399,40
13834,2600,373480,3031,264198,641064,109282
20886,2,95,2660,76,2294,19
35271,248,11755,1954,8457,68946,3298
9919,7,170,3262,146,3317,24
10945,26,662,3208,487,3447,175
12433,26,1782,3130,1252,30064,530
36886,23,310,1852,246,4696,64
8165,2,31,3366,28,1938,3
41246,154,3988,1535,2795,52226,1193
29411,0,181,2228,146,4199,35
20591,4,167,2678,137,6448,30
10378,4,463,3240,359,20696,104
27239,4,166,2351,138,3729,28
10817,11,113,3215,90,4709,23
6090,9,226,3487,174,2586,52
9280,56,2110,3297,1380,31210,730
8694,10,308,3331,241,3167,67
5633,28,662,3508,483,11848,179
6752,59,2122,3460,1690,22895,432
31311,8,428,2133,358,8517,70
15150,825,66971,2940,43072,355330,23899
11925,10,489,3158,404,8553,85
8689,4,75,3331,66,9723,9
8850,24,1381,3322,1108,33041,273
38857,101,1334,1721,1005,19033,329
42015,128,3362,1412,2365,31157,997
2254,7,365,3616,313,19798,52
38406,36,958,1752,733,9655,225
39591,363,5126,1676,3728,29677,1398
10179,2,90,3249,57,2151,33
25801,2,95,2417,80,5033,15
6779,262,8194,3458,6222,87487,1972
25982,14,645,2409,477,10828,168
12660,9,255,3119,177,5254,78
46121,5,48,290,33,1128,15
15081,50,1125,2944,934,10020,191
20554,21,998,2680,793,8301,205
28221,1,89,2293,73,1276,16
5383,301,9272,3520,7272,66246,2000
4213,11,254,3574,193,5852,61
20123,26,1525,2702,1267,28154,258
36050,15,386,1899,330,13119,56
1935,72,2346,3621,1936,21386,410
26544,2,89,2383,76,1724,13
35046,2,137,1966,107,3570,30
36108,1,92,1895,80,4632,12
26098,35,815,2404,654,8168,161
42556,96,2733,1303,1974,19583,759
24997,14,603,2453,423,10028,180
37791,4,63,1794,53,4010,10
17320,3,72,2833,58,6991,14
31553,4,148,2120,108,4296,40
10538,18,774,3232,683,32914,91
21187,7,234,2641,198,5515,36
19383,13,479,2741,391,5769,88
14944,8,699,2952,512,8881,187
3464,175,6295,3594,4756,49581,1539
1669,5,65,3662,51,4391,14
8326,5,134,3355,107,5198,27
6759,6,124,3459,97,2917,27
14166,0,145,3007,112,4164,33
14358,108,3450,2991,2607,38619,843
24276,18,1863,2485,1347,20516,516
46087,7,134,302,121,1874,13
41144,4,41,1550,35,1999,6
42538,1,143,1306,104,5685,39
9124,50,1043,3307,792,12363,251
21969,8,311,2597,274,6363,37
9295,22,791,3296,632,7482,159
45432,29,298,558,239,4962,59
3234,67,2501,3599,2022,13126,479
25599,46,1749,2426,1361,25663,388
43348,11,254,1096,194,15920,60
46221,2,30,251,21,1600,9
13169,193,6482,3079,4802,55163,1680
44382,15,210,855,150,6327,60
19344,11,3357,2743,2436,11864,921
10285,4,79,3244,69,2772,10
14674,13,990,2970,765,13780,225
38643,18,707,1734,539,7158,168
27329,1126,36608,2346,25367,256221,11241
15073,18,881,2945,656,30048,225
3013,80,2897,3603,2226,42533,671
37227,20,588,1831,364,11445,224
18832,6,485,2765,395,4873,90
15922,13,435,2906,328,3629,107
24656,31,1250,2467,985,16719,265
38218,6,508,1765,408,4419,100
40816,55,1605,1582,1173,17804,432
37004,254,17377,1845,13789,71366,3588
40073,0,148,1646,101,2907,47
27618,4,319,2328,247,8736,72
2187,13,280,3617,241,7518,39
12592,63,2010,3123,1648,28794,362
32780,17,253,2062,221,4363,32
31014,6,255,2149,189,8215,66
35055,8,229,1966,197,4883,32
31965,5,236,2099,195,11233,41
14629,15,1930,2972,1313,13432,617
10078,100,3901,3253,3094,29992,807
31721,3,57,2111,51,2948,6
9109,1,63,3307,29,2495,34
2061,8,337,3618,255,24642,82
26761,18,564,2373,447,12816,117
32771,25,791,2062,631,7361,160
42740,5,112,1262,82,3763,30
26426,7,257,2388,220,8616,37
14998,2,105,2949,87,3360,18
14453,73,7174,2985,4593,60743,2581
19088,221,13446,2755,10239,107243,3207
30093,341,17321,2195,11317,54056,6004
2310,24,1463,3615,1047,27707,416
15548,14,668,2922,530,18374,138
44877,16,95,739,86,1947,9
15490,39,1819,2925,1356,19211,463
29204,8,169,2240,136,6421,33
44788,60,519,767,383,5439,136
38683,81,2378,1731,1775,14224,603
46165,2,35,268,32,876,3
34075,9,166,2013,134,5929,32
20049,106,15885,2706,12074,54595,3811
8176,26,891,3365,691,13595,200
23681,28,1478,2512,1191,17793,287
39217,3,81,1698,62,8389,19
4457,80,224660,3565,76524,48346,148136
30402,13,517,2178,402,7671,115
29807,49,3866,2209,2975,35609,891
19797,4,118,2720,97,2192,21
36608,59,2963,1868,2460,38462,503
36791,2,68,1858,45,2688,23
18796,6,452,2767,321,9093,131
23380,13,449,2527,367,9478,82
5261,5,107,3527,75,4317,32
12348,15,766,3136,605,12519,161
19135,56,6465,2754,4756,39349,1709
3389,41,1114,3596,900,11644,214
9664,10,449,3273,300,7507,149
43644,17,908,995,735,7759,173
3383,17,755,3596,568,14107,187
27976,3,380,2307,302,7381,78
46333,11,159,212,121,2388,38
34162,63,2107,2011,1635,11974,472
43340,142,1699,1097,1277,17007,422
38627,4,151,1735,123,6108,28
12469,76,6697,3128,4559,53139,2138
29321,114,2760,2232,2135,16572,625
21016,2,76,2651,64,4086,12
24108,0,2568,2493,1885,19011,683
1830,914,47607,3624,31516,266593,16091
11921,11,211,3159,153,4671,58
1214,2,95,3861,86,4768,9
25717,15,625,2420,523,5747,102
10468,3,63,3235,54,3106,9
34684,4,197,1986,155,4460,42
39215,434,8336,1698,7126,42986,1210
43287,288,5222,1112,3989,40291,1233
12181,14,667,3145,528,12979,139
25628,2,120,2424,105,2469,15
19365,0,144,2742,109,2116,35
45169,27,257,633,213,7602,44
18209,40,1864,2792,1441,21959,423
18251,615,30524,2790,21488,110193,9036
14557,15,42664,2977,12077,6459,30587
16402,9,731,2882,442,11767,289
45035,6,67,691,54,2270,13
29495,416,20811,2224,14013,116656,6798
32026,5,120,2096,84,3061,36
24717,8,1306,2464,935,6311,371
18250,12,499,2790,368,4073,131
31465,62,3716,2125,2500,46245,1216
7212,163,9307,3435,6571,55815,2736
29615,5,63,2219,48,2060,15
7980,3,21,3381,16,1883,5
9595,4,164,3276,121,2087,43
28839,4,70,2258,58,2252,12
29538,26,2165,2222,1559,15594,606
44955,20,322,717,168,10006,154
11181,83,5371,3196,4037,61701,1334
37062,1,84,1841,61,2988,23
46381,8,121,190,115,3386,6
12171,3,30,3146,25,2308,5
11352,59,1658,3188,1335,32509,323
24044,81,7743,2496,5918,50474,1825
8298,993,87443,3357,57888,155140,29555
3022,64,2897,3602,2234,39340,663
28455,3,59,2280,52,2963,7
43301,350,6644,1108,5003,68227,1641
32688,13,600,2066,426,14140,174
46136,10,190,283,142,1737,48
9237,32,926,3300,761,17320,165
9151,285,7876,3304,5964,27916,1912
17492,189,9709,2824,7001,57958,2708
24289,2,101,2485,80,6036,21
23921,10,527,2502,424,8726,103
17194,55,1276,2839,985,9747,291
42998,68,1543,1197,1086,35133,457
7664,5,224,3408,184,3225,40
25537,0,60,2430,46,2311,14
31792,5,245,2107,193,3720,52
37354,1,73,1824,49,4134,24
41925,96,2055,1426,1545,30328,510
38403,2,120,1752,90,3808,30
28204,31,1230,2294,983,18306,247
17227,4,226,2837,163,2945,63
43493,20,520,926,333,3581,187
46127,44,652,288,570,5867,82
28736,39,2005,2263,1639,20782,366
43484,109,1302,1055,1001,13101,301
38273,94,3047,1761,2267,26145,780
36943,69,1317,1849,1092,17067,225
43086,1,38,1170,28,2146,10
25839,146,3269,2415,2440,24869,829
22155,36,2444,2587,1882,15485,562
16446,3,114,2880,89,2264,25
40353,7,154,1625,119,9915,35
39155,19,613,1702,460,7258,153
27280,16,588,2349,492,8080,96
4315,32,651,3570,524,18533,127
27518,56,4325,2334,2636,20800,1689
6248,8,258,3481,204,4741,54
4434,6,176,3566,138,5481,38
43836,0,298,941,236,4841,62
18994,7,271,2759,175,2562,96
36731,10,643,1863,415,6796,228
29638,547,27374,2217,20183,69830,7191
32591,9,705,2069,557,9796,148
28487,35,563,2278,412,6812,151
4470,5,275,3565,172,10248,103
18822,36,2827,2765,2324,22244,503
17205,9,240,2839,188,6798,52
2924,1,392,3604,312,24013,80
18948,5,169,2761,129,2578,40
13394,67,1521,3065,1171,25669,350
1980,258,9494,3620,7503,65825,1991
5452,61,2929,3517,2153,42167,776
29644,15,755,2217,601,18410,154
39926,75,841,1656,598,7109,243
15119,5,142,2942,108,2212,34
25079,114,3521,2449,2642,26870,879
27951,0,0,2308,0,15911,0
4942,19,613,3545,470,8344,143
45935,9,110,366,94,3578,16
43073,62,1150,1174,783,9092,367
14868,116,3853,2956,2809,12579,1044
23893,5,164,2504,145,8311,19
34539,16,406,1994,339,7815,67
5225,5,182,3529,154,12689,28
9904,0,62,3263,47,1879,15
12528,10,361,3126,271,5381,90
41533,122,3079,1493,2368,33999,711
5222,16,508,3529,388,10226,120
28713,8,220,2265,177,5439,43
26792,34,1812,2372,1387,13087,425
43309,82,1906,1106,1472,21858,434
28205,18,409,2294,325,3679,84
16051,11,359,2899,263,5824,96
29146,3,118,2242,92,2022,26
19162,0,142,2753,65,3426,77
44474,97,2192,841,1578,26928,614
12491,30,1051,3128,844,10046,207
17230,29,1423,2837,1062,24544,361
17817,12,638,2811,503,10471,135
8827,6,78,3323,65,8253,13
32432,64,1422,2076,1060,16537,362
11398,13,858,3185,611,7066,247
13691,260,30552,3042,20535,89697,10017
39212,2,358,1699,286,7033,72
16768,21,915,2863,698,10567,217
29436,3,134,2227,104,4936,30
11137,10,235,3198,197,5865,38
6066,56,1297,3487,1064,9976,233
19792,89,5549,2720,4228,32780,1321
17503,58,3389,2824,2247,37098,1142
22684,10,1028,2562,872,4839,156
34116,1,19,2011,15,1124,4
30504,64,3313,2171,2380,27554,933
35907,89,2503,1910,2011,20875,492
38601,11,640,1737,514,8099,126
32297,6,183,2082,149,4085,34
9185,436,19616,3302,14604,187687,5012
23453,28,1178,2524,956,12622,222
12163,38,988,3146,757,12635,231
13527,10,350,3054,246,23121,104
45419,249,5887,561,4520,21154,1367
25661,0,138,2423,111,3503,27
40815,5,58,1582,51,5153,7
30964,100,2506,2151,1887,17600,619
19843,94,5764,2717,4578,41585,1186
42554,32,1051,1303,666,19160,385
46186,1,23,260,13,1200,10
43513,9,214,1045,155,4089,59
42148,25,492,1386,365,14517,127
4872,453,24092,3549,15688,200213,8404
19863,4,507,2716,368,11599,139
23040,10,111,2545,86,1760,25
43495,114,1235,1051,925,13019,310
29606,37,1278,2219,1043,16824,235
40026,1,58,1649,46,2930,12
8628,254,7812,3336,5959,73720,1853
45541,3,47,528,37,955,10
16272,1,120,2889,93,3096,27
20060,43,1853,2706,1455,10007,398
7156,9,313,3437,263,10000,50
29899,21,1152,2204,888,9717,264
5346,6,118,3523,97,2732,21
45700,1,31,461,25,2655,6
9417,29,852,3288,647,7294,205
27611,0,0,2328,0,2969,0
28341,38,1916,2286,1457,27275,459
36314,9,186,1884,154,4430,32
24898,0,50,2457,41,2307,9
28670,0,85,2267,70,3060,15
9219,229,16579,3301,11826,102208,4753
36554,124,3381,1873,2471,29788,910
18700,70,2552,2771,1871,17242,681
8859,3,108,3322,87,4389,21
17273,0,60,2835,53,2827,7
8177,13,756,3365,551,29462,205
20175,1,142,2699,121,7447,21
27241,1,116,2351,79,4356,37
10090,197,11675,3253,8939,61769,2736
5527,0,113,3514,86,6502,27
24503,7,162,2475,130,6769,32
42889,80,1993,1227,1350,18644,643
6615,791,39443,3465,27263,236099,12180
39675,12,174,1672,148,4135,26
8294,13,519,3358,390,13305,129
24220,2,321,2488,273,9124,48
16095,3,216,2896,141,2886,75
14213,3,250,3003,138,7804,112
16943,278,25813,2854,18593,129914,7220
1672,19,491,3661,419,8676,72
40959,88,2247,1570,1597,18864,650
11547,9,919,3176,635,10097,284
23173,49,1819,2538,1342,6999,477
13929,50,3454,3021,2600,33133,854
38325,19,463,1757,351,9349,112
1478,0,69,3712,57,3121,12
11709,8,334,3168,268,4569,66
45310,72,1045,589,778,8081,267
21185,5,262,2641,195,6604,67
19916,6,420,2714,334,12071,86
43610,18,515,1007,421,8816,94
17294,6,346,2834,263,2486,83
15416,16,809,2929,575,9026,234
24465,58,1410,2477,1116,12825,294
23552,32,1249,2520,997,10480,252
31509,12,1046,2122,851,13976,195
33191,236,6297,2045,5037,39824,1260
44717,9,180,788,134,2356,46
6801,10,614,3457,450,20239,164
42926,66,1690,1217,1258,13389,432
34425,2,83,2000,66,1988,17
39747,21,1065,1668,779,13607,286
18064,27,2021,2798,1536,13247,485
9586,6,153,3277,109,6988,44
38056,1,148,1777,113,6237,35
42356,6,174,1343,119,8238,55
1981,9,221,3620,176,13196,45
31011,3,58,2149,49,1779,9
36505,0,31,1875,25,2379,6
9835,135,4363,3265,3326,39084,1037
24688,15,662,2466,517,6884,145
23268,522,24839,2533,17789,140336,7050
30920,86,1900,2152,1477,24181,423
18985,21,1217,2760,950,22432,267
8385,156,5017,3351,3946,64280,1071
34292,14,131,2006,109,4059,22
10688,62,2826,3222,2019,42870,807
16879,241,12066,2858,8265,55055,3801
32460,7,204,2075,174,3589,30
24640,13,397,2467,325,5704,72
10638,383,7075,3225,5355,31779,1720
42351,1,35,1345,28,3079,7
1939,33,589,3621,478,23234,111
20225,1,145,2696,113,3282,32
7948,14,685,3384,554,34708,131
45445,38,334,554,285,11240,49
15716,10,736,2914,583,8264,153
23064,494,22027,2543,16133,78818,5894
18448,16,828,2782,649,11923,179
30993,19,514,2150,451,7581,63
26352,188,6877,2392,4793,29346,2084
14498,145,5066,2981,3897,38689,1169
36268,19,833,1886,673,13119,160
14857,88,31143,2957,11805,45292,19338
33399,10,260,2037,225,7636,35
3757,26,264993,3588,91987,27441,173006
40371,8,170,1623,142,4713,28
25326,52,1363,2439,1045,17025,318
40405,23,1255,1621,951,10231,304
37493,4,159,1814,130,6417,29
5621,17,674,3509,557,8817,117
13020,49,1514,3097,1117,14593,397
14542,24,1055,2978,757,5164,298
27945,7996,382629,2308,188859,1025153,193770
27163,14,427,2356,340,21734,87
5580,77,3326,3511,2465,57073,861
26651,99,2449,2379,1890,20362,559
7197,10,377,3435,274,8848,103
43342,18,297,1096,208,5921,89
11626,5,288,3173,207,4867,81
16352,24,1079,2884,857,18321,222
46444,16,345,153,294,6169,51
3309,50,1279,3597,1015,12445,264
16245,1,94,2890,75,10424,19
2077,19,433,3618,320,6247,113
17329,20,799,2832,677,7564,122
32621,5,364,2068,278,4992,86
26461,35,2030,2387,1364,9640,666
27720,124,3988,2322,3175,22421,813
17863,301,16649,2809,12684,110896,3965
4453,6,229,3565,188,9152,41
23362,12,173,2529,131,5615,42
42897,7,185,1225,133,4766,52
31944,3,183,2100,141,6715,42
43207,16,255,1138,186,4759,69
14392,4,172,2988,142,4508,30
43225,53,1414,1132,992,16078,422
41466,4,121,1501,92,3305,29
6270,60,1472,3480,1180,24397,292
7246,10,234,3434,193,7477,41
13350,450,47845,3068,31891,203671,15954
6070,4,64,3487,51,2211,13
36492,249,3126,1875,2406,21169,720
37767,32,1226,1796,1000,25127,226
14787,101,3033,2961,2056,12957,977
18331,2,120,2787,97,2930,23
14784,309,19514,2961,13742,89577,5772
18323,34,5151,2787,3621,22534,1530
5007,31,770,3542,573,16639,197
45053,2,46,684,36,1746,10
16146,45,1690,2894,1232,18785,458
29909,7,239,2204,187,3130,52
16334,2,322,2886,175,4960,147
38824,1,36,1723,30,1589,6
45537,2,51,529,31,2598,20
37547,8,156,1810,131,4955,25
29198,87,2323,2240,1839,12901,484
34878,75,2220,1975,1765,21657,455
42695,5,166,1273,121,4824,45
15098,12,536,2944,443,8236,93
40102,140,6263,1645,4245,62344,2018
40738,5,74,1591,63,2318,11
10256,391,25136,3245,16043,104093,9093
41799,0,39,1447,34,8182,5
1109,7,150,3894,114,5099,36
11090,22,354,3201,267,5164,87
3395,13,477,3596,394,16072,83
4424,9,250,3566,214,4134,36
43194,2,69,1141,53,1964,16
38705,44,1372,1730,1168,16093,204
28396,2,84,2283,68,1671,16
33071,4,91,2049,79,3110,12
20206,2,318,2697,283,6293,35
3114,182,9693,3601,6924,57737,2769
12957,19,86109,3101,28425,8480,57684
4916,21,573,3546,453,10306,120
6515,10,703,3469,537,10256,166
16457,284,15528,2880,10425,79535,5103
12892,39,1673,3106,1244,26844,429
10123,14,242,3252,195,2868,47
38546,199,3926,1741,3117,14200,809
5828,38,1057,3498,769,16168,288
4324,52,1465,3570,1153,19652,312
10245,21,459,3246,387,6405,72
30158,4,133,2193,122,8535,11
1629,15,216,3675,176,7333,40
31558,7,898,2119,631,10450,267
41757,58,2451,1456,1796,19301,655
23667,157,6508,2513,4731,44331,1777
5697,13,554,3504,414,5518,140
41012,468,9818,1567,7537,45275,2281
7525,82,4186,3417,3279,70027,907
43311,12,338,1105,227,10167,111
35786,6,524,1918,389,8749,135
29236,4,309,2238,244,4399,65
5844,16,212,3497,170,2687,42
2022,13,379,3619,285,6196,94
26444,26,527,2387,449,7357,78
4709,32,1129,3555,900,8245,229
28210,11,210,2294,155,2008,55
10487,1807,122119,3235,81319,215493,40800
9560,1,115,3279,93,3745,22
29682,1,138,2215,100,2956,38
10261,1,132,3245,93,5207,39
23135,3,132,2540,111,2972,21
20455,21,780,2685,595,6511,185
45341,81,1055,582,833,10097,222
17353,5,327,2831,278,3910,49
2917,107,4280,3604,3236,24764,1044
5192,10,187,3531,152,7408,35
26304,5,466,2394,345,12589,121
1725,4,154,3651,122,6644,32
3371,9,610,3596,482,5666,128
22904,574,41953,2550,29779,187206,12174
39630,13,495,1674,375,10902,120
4461,75,912,3565,765,23407,147
31773,1511,57849,2108,43166,228165,14683
38585,780,31331,1738,21988,122183,9343
33492,11,177,2033,147,5178,30
3365,12,196,3596,165,4070,31
21807,2,162,2607,131,4283,31
34509,31,655,1996,543,5910,112
42065,35,526,1403,389,12836,137
22962,1247,112179,2547,73301,303139,38878
13536,704,26087,3053,18522,82275,7565
3685,29,1728,3590,1299,32545,429
23302,3,277,2531,219,3358,58
28950,22,1143,2253,917,5817,226
23744,13,715,2510,487,6031,228
33838,14,567,2020,427,9312,140
3062,25,899,3602,746,20199,153
35151,2,202,1961,164,3711,38
12548,7,195,3126,113,15470,82
20607,2,176,2677,144,5638,32
6740,15,1402,3460,974,14486,428
18451,20,1116,2782,856,9392,260
37610,3,127,1806,101,4170,26
13117,19,1782,3090,1353,29266,429
1441,5,258,3737,206,7836,52
25291,1,69,2440,57,3458,12
32259,53,3809,2084,2890,27820,919
9234,45,1616,3300,1373,14023,243
24560,14,246,2472,188,4549,58
45275,326,4154,600,3517,17162,637
39422,228,2879,1686,2227,21776,652
35794,0,17,1918,15,1653,2
44850,167,2079,745,1745,19281,334
35973,25,1245,1905,952,12800,293
42756,11,355,1259,235,7011,120
36660,26,870,1866,591,4802,279
45914,11,104,380,73,2419,31
9202,5,252,3301,169,8459,83
25304,54,1234,2440,958,9174,276
26841,13,831,2369,637,8064,194
6016,1,68,3489,63,6087,5
11793,2,85,3164,73,2417,12
26034,0,25,2406,23,2514,2
9139,628,29409,3305,21026,98272,8383
35249,24,728,1955,563,9470,165
32136,25,651,2090,502,17056,149
17270,16,801,2835,629,9957,172
44900,8,174,733,100,3768,74
36774,2,27,1859,24,1957,3
34042,11,394,2014,320,25608,74
15418,22,1143,2928,872,10475,271
2724,12,71,3608,54,9274,17
45502,25,213,542,164,3836,49
15555,48,1628,2922,1289,6796,339
18153,6,305,2795,249,5690,56
30417,33,1392,2177,1068,21096,324
14245,15,2050,3001,1550,79069,500
2936,15,571,3604,483,5090,88
16073,3,248,2898,182,9443,66
14367,22,625,2990,494,9407,131
8037,48,2019,3372,1286,28444,733
22539,2,58,2568,48,2344,10
15725,2,307,2913,214,7964,93
25780,0,18,2418,13,3128,5
33335,327,10809,2039,7792,35756,3017
46201,3,56,256,50,908,6
19068,59,2703,2756,1761,27908,942
35680,3,139,1926,106,3836,33
39830,122,4278,1663,3264,22284,1014
30975,0,36,2150,35,2587,1
8680,57,1539,3332,1131,14367,408
19885,58,3196,2715,2380,54378,816
43591,66,1274,1015,985,23337,289
45222,0,12,617,10,921,2
43773,101,1558,954,1343,23788,215
2448,1,19,3612,14,3618,5
3794,69,6060,3588,4509,30117,1551
4520,662,42682,3563,30464,174449,12218
28182,20,385,2295,311,3310,74
19011,29,1292,2759,940,16388,352
19688,2,315,2727,259,6107,56
24669,7,543,2466,405,18405,138
3175,6,259,3600,220,8463,39
20105,86,2049,2703,1565,13480,484
11277,27,1184,3191,856,29656,328
9564,55,2713,3278,2028,20957,685
40918,20,626,1574,477,11742,149
7199,3,79,3435,66,4021,13
29036,13,468,2248,372,10747,96
2500,5,165,3611,118,24728,47
37458,9,465,1817,328,7757,137
2883,22,846,3605,643,17542,203
25924,10,442,2411,339,5673,103
29288,25,603,2235,501,4633,102
2137,9,832,3617,537,11406,295
11780,115,4800,3164,3590,28021,1210
13345,67,6418,3068,4989,12353,1429
23318,7,293,2531,240,10451,53
38061,1096,33269,1776,25793,96719,7476
22072,12,459,2591,315,11875,144
5247,8,195,3528,151,5144,44
32419,6,233,2077,168,9610,65
38842,94,7688,1722,5806,57008,1882
34734,87,878,1984,671,8455,207
16020,493,20531,2901,14764,55289,5767
29083,20,532,2245,408,5332,124
23177,57,1416,2538,1058,17815,358
17859,9,949,2809,763,16071,186
17552,6,210,2821,161,6571,49
31506,25,694,2122,546,6681,148
18294,214,20427,2788,14195,88269,6232
19362,170,12732,2742,8927,59750,3805
32926,136,4372,2055,3529,22883,843
41863,36,308,1435,223,4258,85
20526,149,3699,2681,2770,20470,929
15820,2,299,2909,250,2833,49
3908,247,9177,3584,6758,31734,2419
11317,31,2213,3190,1761,25349,452
13189,21,1114,3079,889,26191,225
15096,143,5848,2944,4172,28094,1676
39308,1,80,1692,60,3228,20
32707,23,713,2065,557,10084,156
22084,115,3144,2590,2451,14388,693
39405,4,198,1687,163,3486,35
41066,5,392,1560,284,15359,108
15751,8,342,2912,276,5050,66
42662,8,70,1281,60,2882,10
5968,10,578,3491,362,12997,216
30286,1,41,2185,34,1645,7
9775,10,318,3269,259,12643,59
19638,3,79,2729,69,1892,10
30398,16,1164,2178,888,12342,276
10607,43,1430,3227,1103,15175,327
36617,44,2301,1868,1724,24560,577
21495,39,1780,2624,1359,16969,421
35411,3,89,1948,75,7234,14
16875,50,3234,2858,2436,21360,798
1806,29,594,3626,485,8353,109
26383,14,1115,2390,846,15023,269
34582,46,1382,1992,1116,11414,266
27642,2,29,2326,24,2187,5
24496,10,350,2475,250,3942,100
3228,0,52,3599,37,3911,15
46179,20,130,262,103,1893,27
5468,33,495,3517,390,5924,105
10759,43,820,3218,605,7606,215
26800,36,1092,2371,847,17876,245
5263,22,2299,3527,1728,17746,571
33019,13,285,2051,221,5321,64
29057,4,234,2247,195,4146,39
27419,5,339,2340,278,4775,61
22565,33,1035,2567,883,14745,152
25310,1,151,2440,123,2634,28
20772,25,2898,2668,2309,30457,589
29780,9,259,2210,202,4496,57
33859,2,39,2020,32,2954,7
11312,31,1102,3190,911,10494,191
11106,5,49,3200,40,3164,9
36695,3,284,1864,230,7414,54
43575,24,629,1024,523,8279,106
32007,2,115,2097,88,6156,27
14920,243,6846,2953,5390,35799,1456
8571,7,945,3339,714,8601,231
1315,7,420,3822,317,16333,103
31270,5,175,2135,147,5889,28
44697,222,3019,796,2551,25293,468
23657,30,727,2514,548,4957,179
2927,144,4904,3604,3811,47715,1093
32006,84,4916,2097,3951,22836,965
28595,3,128,2270,109,2780,19
6180,13,518,3484,443,11291,75
17905,41,5790,2807,4204,39781,1586
20418,51,3675,2686,3020,13977,655
19918,4,236,2713,162,14497,74
43037,109,2366,1186,1769,31235,597
12320,5,186,3138,147,3764,39
13833,0,103,3031,65,5519,38
28666,45,1040,2267,838,8776,202
25198,1,59,2444,48,2138,11
13224,4,111,3077,96,6639,15
44729,122,3124,785,2286,38084,838
1889,118,4556,3623,3518,61498,1038
4666,189,8139,3557,5944,48277,2195
30931,24,663,2152,550,8008,113
8889,4,63,3320,51,2338,12
37026,3,205,1844,159,7143,46
29356,31,652,2231,502,10240,150
3434,3,275,3595,213,7987,62
38918,28,255,1718,194,3381,61
38719,1,52,1729,42,5691,10
19045,0,28,2757,22,1111,6
3194,16,575,3599,453,7958,122
17729,24,3220,2815,2603,16279,617
20728,45,1481,2671,1093,11439,388
33679,8,447,2027,375,8381,72
39002,22,580,1712,492,10460,88
26951,6,127,2364,119,3981,8
3232,86,3399,3599,2632,31891,767
31063,438,15641,2146,11812,73890,3829
18765,17,378,2768,303,8305,75
29754,3,380,2212,297,9979,83
31343,6,153,2132,126,7683,27
40395,14,457,1621,388,8255,69
29160,22,600,2242,448,5135,152
11451,660,54213,3182,34515,176960,19698
4747,35,1514,3554,1050,23907,464
30452,10,511,2175,410,14251,101
4943,35,803,3544,637,5603,166
35116,9,234,1963,178,4925,56
5217,446,30602,3529,22331,114062,8271
30054,9386,729609,2197,460618,1909401,268991
36337,26,695,1883,549,6489,146
38623,22,628,1735,505,12876,123
34937,18,700,1972,563,17073,137
34794,0,145,1980,113,5077,32
8905,1,35,3320,18,1079,17
37645,87,933,1805,681,8383,252
42023,0,44,1411,31,5816,13
35066,6,179,1965,133,3311,46
25446,0,298,2434,236,9483,62
45901,8,89,386,63,1177,26
8658,14,1388,3333,1002,6485,386
8374,56,1402,3352,978,6789,424
18339,7,887,2786,708,14383,179
7565,3,43,3415,39,2867,4
36906,20,423,1851,309,6545,114
45830,21,181,410,158,4387,23
43689,36,243,979,211,3732,32
36047,5,156,1900,141,14354,15
38176,1,68,1768,58,3725,10
4609,13,410,3559,319,16799,91
5600,0,91,3510,68,2618,23
34121,5,322,2011,229,5421,93
26205,7,525,2398,404,5279,121
6950,18,692,3449,482,12853,210
3778,51,1525,3588,1095,26906,430
42280,23,607,1358,467,7236,140
29225,4,320,2238,256,7271,64
39739,4,67,1669,55,11179,12
18509,26,941,2779,735,6812,206
6702,18,412,3462,336,8132,76
21787,63,2918,2608,2232,38006,686
32095,0,119,2092,78,4555,41
40486,35,809,1613,597,9071,212
28240,1,157,2292,135,2126,22
35709,1,50,1924,42,4409,8
23274,1,165,2533,142,5288,23
11918,20,789,3159,606,8527,183
32313,5,121,2081,95,3471,26
32957,79,4453,2054,3516,49678,937
20416,21,943,2687,750,12531,193
39371,71,2621,1689,1945,19396,676
33119,20,278,2047,216,3698,62
29851,17,550,2207,416,8123,134
28660,2,190,2267,147,3962,43
31676,10,764,2113,632,9062,132
42754,11,204,1260,180,3865,24
11075,19,993,3202,774,14638,219
25902,37,3360,2413,2447,55955,913
31143,293,12823,2142,9534,62094,3289
46024,6,90,329,50,2880,40
37640,5,217,1805,174,4855,43
37696,5,380,1802,305,14628,75
5040,7,219,3540,165,9986,54
39163,53,873,1702,633,7905,240
10990,10,1402,3206,1102,15418,300
42426,32,615,1329,450,8352,165
5534,85,2571,3514,2064,12228,507
3888,103,3434,3585,2529,19097,905
29183,3,179,2241,151,29612,28
27791,160,4998,2317,3837,37399,1161
40398,4,233,1621,181,5911,52
35038,6,225,1967,174,7311,51
21234,15,377,2637,291,3330,86
19527,0,35,2734,26,4771,9
35593,459,11582,1934,8854,51276,2728
46401,0,6,179,4,567,2
3418,27,1079,3595,765,5462,314
27392,16,363,2341,313,6400,50
11767,2,89,3165,76,9068,13
30072,7,1234,2197,908,9017,326
33460,4,138,2035,105,2768,33
4008,4,82,3581,72,2286,10
33712,5,204,2025,166,3783,38
6876,3,154,3453,114,6910,40
9052,4,224,3311,182,6605,42
3255,18,401,3598,345,2668,56
32383,145,3278,2078,2719,18003,559
29863,14,408,2206,326,8232,82
40464,14,245,1615,160,4419,85
15474,88,3679,2926,2654,24284,1025
20355,1,130,2690,107,10606,23
15115,19,356,2942,277,7481,79
27538,2,162,2332,139,5376,23
14156,2,151,3007,103,5477,48
19086,548,46506,2755,31133,241737,15373
23730,1,86,2511,75,2176,11
42452,1,54,1324,39,7074,15
33511,21,701,2032,536,7146,165
36619,100,1765,1868,1340,14631,425
29244,26,484,2238,388,3705,96
10976,10,333,3207,261,3713,72
4193,86,5908,3575,4455,87248,1453
42882,3,63,1229,52,3554,11
23916,0,66,2503,54,7241,12
7350,49,1349,3426,1011,32118,338
21056,3,149,2650,101,5522,48
4162,11,141,3576,103,6472,38
39255,2166,60890,1695,41587,277034,19303
38188,51,2737,1767,2140,20965,597
41425,22,1036,1507,746,7776,290
9585,63,2374,3277,1655,23369,719
9538,7,320,3280,252,7172,68
24186,0,45,2490,36,3585,9
32966,9,888,2054,655,8911,233
18389,5,503,2784,408,2959,95
21268,2,74,2636,66,3425,8
37502,9,338,1813,299,2703,39
16373,55,1668,2883,1228,15019,440
24019,0,951,2497,769,18659,182
35206,9,348,1958,276,7298,72
8675,4,200,3332,164,8049,36
28719,14,1023,2264,797,14898,226
42536,10,155,1306,111,5589,44
18034,19,1448,2799,1217,7045,231
29526,66,3332,2223,2616,25923,716
39536,107,3835,1680,2832,29484,1003
25999,5,368,2408,313,14031,55
25777,66,4063,2418,3232,25344,831
22214,39,874,2584,698,10768,176
6942,45,1757,3450,998,37837,759
23288,3,80,2532,60,1836,20
13250,44,1473,3075,1066,15387,407
32985,10,600,2053,484,10647,116
25157,0,43,2446,29,3566,14
43451,84,1171,1064,857,7931,314
13697,75,5960,3042,4322,46620,1638
37611,34,2501,1806,1915,20879,586
18933,11,359,2762,271,5217,88
22590,2,34,2566,29,2770,5
17945,6,700,2805,561,26602,139
9528,36,610,3281,478,6032,132
45516,1,15,536,12,1581,3
24226,5,492,2488,425,14563,67
17566,30,3467,2820,2795,35292,672
5340,10,276,3523,200,11405,76
5570,3276,142670,3512,93613,498509,49057
2735,4,113,3608,91,4792,22
6386,134,3984,3475,2854,22851,1130
14739,91,2609,2965,2068,11855,541
29548,4,252,2222,208,3677,44
32830,120,6713,2059,5309,25610,1404
29574,2,126,2220,104,6951,22
27982,3,81,2307,68,2206,13
28569,4,244,2272,201,14901,43
3852,407,13771,3586,10606,92525,3165
16235,107,6944,2891,5507,62697,1437
8837,8,294,3323,239,5303,55
11238,118,8345,3192,6112,58616,2233
26837,5,286,2370,236,3016,50
5078,7,335,3538,256,3379,79
45751,12,69,437,55,3100,14
45210,36,272,622,195,3418,77
11311,1,49,3190,35,3235,14
13779,1,91,3035,77,3009,14
31957,33,956,2100,658,13234,298
44667,28,262,807,229,6955,33
10940,12,188,3209,145,5106,43
8395,92,5565,3350,4358,68064,1207
36916,28,383,1850,312,4395,71
15821,1,234,2909,202,4369,32
12284,107,6887,3140,4855,56274,2032
45968,6,71,353,53,1377,18
25972,0,655,2409,506,8182,149
6446,181,8692,3473,5742,40242,2950
42373,1,45,1341,28,4713,17
25584,6,446,2427,358,8705,88
39062,57,1420,1708,1108,9875,312
31096,211,7756,2145,6236,48582,1520
4346,2,140,3569,107,2416,33
41348,166,3405,1519,2660,20594,745
37087,456,14902,1840,11171,106375,3731
27292,0,68,2348,55,3070,13
1846,335,10825,3624,8190,81222,2635
11511,8,323,3178,264,18261,59
5080,3,23,3538,21,2338,2
46111,0,10,295,8,858,2
21626,33,1613,2616,1240,11086,373
4726,3,238,3555,186,13122,52
4881,1,97,3548,84,3015,13
45971,4,79,352,48,1671,31
44215,14,208,870,154,3302,54
32084,10,407,2092,304,10212,103
35374,15,608,1950,466,11413,142
36545,215,6072,1873,4662,40602,1410
36966,266,3875,1847,2924,23334,951
8754,6,393,3328,327,7173,66
7026,15,735,3445,364,5156,371
12180,34,1275,3145,1001,10057,274
36425,15,237,1879,188,4469,49
20053,2692,257865,2706,182233,552360,75632
44425,80,750,851,563,10554,187
13963,50,1375,3018,1113,7243,262
25600,16,707,2426,535,5020,172
42622,7,345,1290,245,7039,100
29925,5,487,2203,363,6403,124
45866,14,111,401,88,3686,23
3436,12,461,3595,366,5503,95
6902,4,199,3452,161,5922,38
39826,13,437,1664,324,15335,113
23180,3,196,2538,177,3331,19
21498,33,1221,2624,826,11836,395
15409,0,57,2929,40,2820,17
36178,7,191,1891,151,3930,40
30653,5,73,2164,53,3247,20
5200,63,1202,3530,932,24040,270
10684,20,710,3222,532,11411,178
14425,285,13916,2986,9634,93236,4282
8233,7,128,3362,82,2530,46
23534,35,1676,2520,1161,20016,515
10301,11,589,3244,418,11069,171
35263,143,3291,1954,2297,17178,994
29708,23,1053,2214,767,14299,286
26604,1,51,2381,36,1489,15
25619,0,67,2425,63,5372,4
26928,136,7801,2366,6252,54124,1549
35891,9,246,1911,199,5809,47
9590,0,57,3277,49,1877,8
2206,34,737,3616,582,15216,155
28229,7,423,2293,297,7098,126
33732,20,1835,2025,1397,50431,438
21118,0,58,2647,51,3434,7
19071,3,48,2756,41,4161,7
45193,22,124,626,104,3466,20
3256,19,385,3598,323,2639,62
13702,74,3752,3041,2804,37139,948
16982,3,174,2852,125,3085,49
20913,45,697,2658,507,10797,190
44091,15,992,892,734,6972,258
35048,32,931,1966,738,10018,193
36308,12,311,1884,243,12417,68
34931,219,5739,1972,4646,27964,1093
3699,60,713,3589,586,14439,127
30708,25,949,2161,729,15232,220
2553,21,1771,3610,1444,16808,327
32374,45,883,2078,660,5369,223
34150,12,375,2011,285,6420,90
14902,19,815,2954,622,13649,193
10343,10,176,3241,156,5127,20
40070,0,71,1646,56,2994,15
33488,22,842,2033,654,9074,188
43770,25,569,955,499,9095,70
11109,19,482,3200,373,10923,109
42211,38,663,1372,487,7335,176
2458,5,118,3612,98,3774,20
22785,16,449,2557,364,2052,85
6588,105,3150,3466,2403,50816,747
25346,100,2164,2438,1546,10032,618
13085,248,28265,3093,19109,95220,9156
2454,60,2629,3612,2084,37268,545
4261,6,88,3573,71,4573,17
38111,14,241,1772,189,5040,52
6953,49,5860,3449,3939,89057,1921
32241,0,71,2084,58,1997,13
8399,39,1584,3350,1228,23603,356
44643,22,398,816,289,6342,109
29605,2,137,2219,119,3229,18
21368,88,9537,2631,5850,42051,3687
22525,19,1357,2569,1038,14524,319
42581,41,2008,1298,1501,29144,507
27091,68,3119,2360,2165,34401,954
11864,17,770,3162,599,12587,171
45836,3,79,409,65,2598,14
14886,45,2351,2955,1896,31251,455
2111,7,134,3618,109,4852,25
26406,61,3981,2389,3021,19718,960
46300,6,109,226,102,2255,7
20784,60,2470,2667,1994,10224,476
46204,2,12,255,11,1303,1
40504,16,218,1611,167,3139,51
11108,398,24062,3200,17515,227544,6547
29512,44,1138,2223,918,15358,220
12135,4,129,3148,95,4627,34
44862,201,2428,741,1917,15420,511
28176,39,1495,2296,1151,13401,344
7037,631,25019,3444,17108,95685,7911
43430,18,316,1068,276,8115,40
20383,79,3802,2689,2868,21362,934
24601,2,369,2469,275,5735,94
42768,7,167,1257,129,10180,38
39148,7,186,1703,150,4894,36
35126,18,1071,1962,881,19206,190
14176,52,2808,3006,1931,16731,877
33500,149,10737,2033,7692,81091,3045
21441,136,16607,2627,11770,79816,4837
26546,0,528,2383,433,4996,95
32242,5,97,2084,82,3801,15
19175,25,1906,2752,1521,18786,385
32339,2,142,2080,79,3901,63
14273,23,1349,2999,1142,15841,207
8542,6,243,3341,181,3447,62
14952,10,318,2951,276,11186,42
42761,4,94,1258,73,5870,21
23535,15,1264,2520,912,16594,352
25228,138,3414,2443,2603,34151,811
17189,959,137770,2839,96689,273511,41081
1313,1,208,3822,171,4412,37
37903,87,2053,1786,1615,17395,438
35956,55,2610,1907,2135,33006,475
39264,5,174,1694,133,5546,41
19307,81,3668,2745,2874,27627,794
7030,0,13,3444,10,1831,3
18530,87,4356,2779,3150,27855,1206
2501,26,1421,3611,1121,20661,300
29119,2,28,2244,23,2287,5
1962,611,29764,3620,20254,189685,9510
15469,463,49195,2926,32224,187702,16971
4515,5,125,3563,102,3661,23
44660,486,7209,809,5508,31102,1701
28897,4,502,2255,385,11160,117
38959,32,599,1714,495,7345,104
27578,15,369,2330,321,6258,48
28737,2,20,2263,15,1791,5
41633,4,279,1478,200,7852,79
9364,11,492,3291,373,3892,119
5373,3,170,3521,129,15319,41
20091,31,1985,2704,1667,17050,318
24084,30,972,2494,760,8653,212
12220,14,493,3144,405,5568,88
45304,23,184,592,147,4270,37
43065,114,3747,1177,2610,55326,1137
25095,28,867,2448,690,13041,177
3892,288,15043,3585,10895,96497,4148
40941,32,906,1572,669,15670,237
23402,9,950,2526,721,12742,229
25556,4,168,2429,151,3121,17
8561,27,1267,3340,909,13122,358
28963,101,4094,2252,2900,39179,1194
42032,1,23,1409,22,5387,1
6533,4,187,3469,151,2447,36
39201,20,715,1699,584,14135,131
7482,21,154,3420,124,6786,30
27865,146,9885,2314,7200,72589,2685
41132,7,305,1551,178,8909,127
32435,29,1521,2076,1252,10638,269
10349,16,124,3241,105,8086,19
15254,14,1053,2935,805,9388,248
1552,3,155,3688,131,4700,24
19084,5,67,2756,56,2257,11
6065,6,120,3487,89,2899,31
20395,18,923,2688,726,9266,197
27083,2,76,2361,71,3400,5
4362,326,9697,3568,7231,106101,2466
42864,26,193,1234,152,4636,41
7365,52,1686,3426,1269,28229,417
7935,25,1323,3386,990,15681,333
27237,38,1353,2351,1066,17069,287
36016,37,1018,1902,869,13668,149
40576,41,781,1604,560,5007,221
33713,95,2014,2025,1517,11408,497
14341,1,177,2992,152,6193,25
23628,314,5928,2515,4735,23364,1193
34173,21,1137,2010,736,8730,401
3084,379,11710,3601,9082,260131,2628
34918,59,1680,1973,1397,11429,283
35589,93,1005,1934,772,9341,233
11212,51,3766,3194,2756,38217,1010
31837,5,428,2105,352,3459,76
22657,0,5026,2563,3858,46685,1168
16633,216,11119,2872,8329,84063,2790
23501,1,145,2522,117,9427,28
40778,33,628,1587,483,13320,145
25212,12,518,2443,431,8389,87
44652,5,186,813,156,4251,30
17862,6,678,2809,577,8283,101
4474,42,789,3564,566,14352,223
2306,20,351,3615,286,14060,65
34683,31,492,1986,388,9501,104
2238,0,22,3616,18,3112,4
16870,10,1060,2858,813,16031,247
17769,1,64,2813,49,1608,15
41921,3,147,1427,132,18319,15
41880,47,1046,1432,786,30092,260
3978,43,3301,3582,2520,64509,781
7320,2,111,3429,82,2299,29
17647,13,418,2817,318,11951,100
8252,28,801,3361,555,7265,246
28696,1,164,2265,143,7502,21
20079,31,2055,2704,1642,31730,413
24947,0,10,2454,8,3220,2
7184,1,21,3436,14,1865,7
19185,1,200,2751,165,3641,35
40548,72,835,1607,604,7247,231
41679,7,159,1470,106,3863,53
38564,2,442,1740,304,5805,138
2428,43,1445,3612,934,10305,511
18238,33,2197,2791,1534,11350,663
12666,24,2514,3118,1904,27187,610
6969,19,487,3448,350,7911,137
45752,10,145,437,106,2723,39
42962,57,1272,1208,1025,33331,247
3448,16,859,3595,624,14542,235
19106,4,240,2755,195,8807,45
30599,146,7248,2167,5572,48581,1676
26647,29,709,2379,584,13983,125
46109,2,44,295,30,1650,14
5421,143,9660,3519,7076,61997,2584
22355,10,290,2578,230,4010,60
10254,120,3648,3246,2639,18977,1009
28589,17,399,2271,299,4090,100
45139,28,298,641,169,5274,129
4336,4,339,3569,263,7803,76
38411,70,624,1751,475,5787,149
13263,10,273,3075,193,12321,80
36092,314,18439,1896,13745,105012,4694
20379,21,650,2689,515,4981,135
5169,10,676,3532,540,10269,136
12137,1,90,3148,75,4215,15
9720,30,926,3271,725,26683,201
33984,21,1269,2016,1041,10117,228
27722,11,887,2322,749,4809,138
40168,5,116,1641,86,2147,30
22112,17,1135,2589,870,11360,265
8899,6,300,3320,202,8036,98
45195,6,95,625,88,4200,7
35888,1,90,1911,79,4274,11
13988,56,2734,3017,2217,27106,517
3640,41,875,3591,679,20994,196
30088,93,2792,2196,2301,15001,491
7027,0,140,3445,122,4355,18
46000,131,1414,342,1171,14623,243
15609,38,659,2918,463,5788,196
28651,10,490,2267,396,6966,94
21043,13,328,2650,266,3800,62
34307,20,954,2005,730,11477,224
10936,98,6741,3209,5227,102208,1514
41146,0,87,1550,67,4143,20
17577,26,1219,2820,807,6678,412
35383,27,1100,1949,814,14710,286
39801,286,19048,1665,13796,89630,5252
3561,10,530,3592,373,9466,157
43269,6,334,1117,205,3272,129
3151,10,172,3600,130,10372,42
5519,21,1226,3514,831,10639,395
4638,10,344,3558,284,4406,60
32498,6,296,2074,233,5796,63
5571,29,571,3512,421,7813,150
2165,17,230,3617,176,8690,54
37083,34,576,1840,505,5383,71
37848,68,2453,1789,1959,16788,494
22317,4,278,2580,221,6333,57
30175,2,329,2191,228,5442,101
18751,19,724,2769,608,6505,116
28334,2,251,2287,194,7138,57
15523,122,5761,2923,4366,18991,1395
37898,4,146,1786,112,3518,34
38825,0,37,1723,32,2499,5
7817,1,51,3398,46,1790,5
10314,13,527,3243,433,17812,94
26056,4,128,2405,104,2916,24
39080,0,46,1707,38,5033,8
29470,2,104,2225,85,2433,19
20301,7,666,2692,540,16794,126
29685,0,153,2215,115,2638,38
34098,1,93,2012,75,2949,18
5577,4,83,3511,66,2588,17
16344,42,1641,2885,1241,14014,400
11383,2,98,3186,73,3598,25
40051,26,914,1647,653,8742,261
25763,11,314,2419,248,4429,66
45693,13,70,464,55,1790,15
13588,59,4500,3049,3367,18226,1133
3582,12,401,3592,325,7321,76
21322,0,382,2634,322,2473,60
12869,221,23418,3106,13975,103705,9443
18113,51,3938,2796,3081,21105,857
10142,91,2034,3251,1415,23299,619
36708,13,196,1864,153,2805,43
37558,35,964,1810,692,17907,272
29018,8,138,2249,112,3308,26
19179,24,1820,2752,1416,21312,404
40758,42,1230,1588,975,13526,255
2792,42,1682,3607,1420,23029,262
41195,11,234,1544,168,5948,66
30725,4,291,2160,229,4473,62
29182,5,213,2241,171,3919,42
27553,37,1426,2331,1031,13594,395
17717,18,1233,2815,911,8135,322
23415,12,279,2526,213,9293,66
2862,16,361,3605,272,10010,89
32499,50,2380,2074,1941,20063,439
36486,67,1499,1876,1043,9346,456
40280,1,218,1633,171,7746,47
5585,1,17,3511,15,3137,2
45286,20,154,596,135,7471,19
11459,125,3755,3181,2679,17769,1076
25067,6,287,2450,214,5380,73
9406,37,2042,3288,1610,17462,432
2954,110,3454,3604,2747,99646,707
6534,56,1392,3468,1018,16675,374
17497,639,20582,2824,13387,67743,7195
12307,34,1021,3139,832,6508,189
28755,3,239,2262,186,4398,53
35682,12,233,1926,193,2547,40
11282,6,216,3190,174,6134,42
6062,6,74,3487,56,3782,18
24132,165,8078,2492,5924,62730,2154
9485,4,82,3283,66,5104,16
16062,1,174,2899,124,3617,50
7262,76,2106,3433,1660,36817,446
40485,20,788,1613,553,13602,235
39354,36,1942,1690,1443,33833,499
8918,5,99,3319,87,2149,12
15100,2,30,2943,23,1948,7
28521,145,2016,2275,1453,10846,563
10768,623,26150,3218,20586,98725,5564
40195,11,383,1639,267,4582,116
41987,69,2802,1415,2243,14675,559
23847,20,527,2506,416,4728,111
27356,14,573,2344,445,8127,128
18223,8,266,2792,199,4579,67
19197,7,262,2751,211,3499,51
23418,0,54,2525,47,2319,7
33870,60,584,2019,448,5950,136
22397,7,158,2576,130,10691,28
46005,6,77,338,57,943,20
6221,16,326,3482,253,3807,73
40380,91,2003,1622,1434,39084,569
23084,1,42,2542,37,3303,5
20906,5,262,2658,199,6034,63
14988,4,138,2950,118,5863,20
28118,8,395,2300,336,5377,59
10666,50,1673,3224,1211,16670,462
36177,96,4439,1891,3510,41670,929
38490,33,1153,1746,879,14588,274
45028,69,615,695,474,4971,141
9318,3,41,3294,29,2088,12
17666,34,3905,2816,2793,48252,1112
24054,0,62,2496,52,2167,10
2024,13,415,3619,309,7568,106
4374,16,888,3568,655,21516,233
9669,11,724,3273,477,4250,247
13057,31,48712,3095,17750,17451,30962
39021,9,248,1711,185,7933,63
22037,2,132,2593,113,4861,19
36120,3,181,1894,144,3465,37
37443,26,585,1818,458,9434,127
30560,14,328,2169,254,5481,74
38503,0,100,1745,82,3790,18
8610,8,412,3337,325,14571,87
23356,167,6066,2529,4555,56123,1511
35731,22,548,1923,440,16909,108
26839,33,848,2370,651,7261,197
30829,499,21771,2156,16193,90115,5578
5333,49,2150,3523,1566,32194,584
15033,0,916,2947,702,4147,214
11837,3,65,3163,53,2613,12
4969,396,17014,3544,12392,79415,4622
27593,8,162,2329,131,7869,31
3182,20,529,3599,344,13836,185
3398,12,366,3595,289,8212,77
10682,31,768,3223,591,9600,177
18240,3,116,2790,97,6419,19
19377,22,1241,2742,885,7406,356
5051,640,11777,3539,8909,185753,2868
21513,5,278,2623,208,6420,70
28366,7,1148,2285,922,8047,226
25296,3,206,2440,165,7777,41
1862,35,821,3623,637,9227,184
15728,21,3315,2913,2233,10385,1082
22796,2,101,2556,83,2839,18
3130,37,1699,3601,1262,27561,437
34122,23,1704,2011,1302,16465,402
30517,16,414,2171,338,4709,76
41848,0,0,1438,0,3742,0
21381,27,702,2631,564,13780,138
22845,11,651,2553,392,4340,259
44185,3,40,883,31,1761,9
36839,3,230,1854,203,6039,27
42765,71,1022,1257,903,20879,119
13469,34,1841,3057,1564,21750,277
2774,23,401,3607,356,7906,45
13337,174,10343,3069,7206,34071,3137
45146,276,2668,639,2074,15797,594
28026,3,237,2304,206,5847,31
32157,20,902,2088,706,11241,196
6496,24,433,3470,359,5621,74
26272,0,957,2396,735,15167,222
41626,3,389,1479,314,6748,75
28019,113,18598,2305,12958,59780,5640
27908,10,1377,2311,1126,18989,251
5334,29,923,3523,766,8804,157
15704,17,940,2914,767,10550,173
42006,5,317,1413,230,15893,87
17155,9,196,2841,157,10482,39
18043,7,590,2799,446,14027,144
3363,11,277,3596,228,5077,49
1430,21,681,3739,574,11484,107
27590,287,13816,2329,9873,80980,3943
22578,39,2817,2566,2064,22261,753
30140,60,1991,2193,1457,20910,534
46420,39,540,169,492,6048,48
4321,1,102,3570,87,12346,15
43191,11,302,1142,226,8284,76
42866,6,58,1234,49,3488,9
38334,19,563,1757,444,7180,119
15112,61,3888,2943,2754,27243,1134
37993,1,111,1780,96,3863,15
9374,45,1740,3290,1334,23392,406
38566,46,1398,1740,1004,16626,394
44896,245,2807,734,2397,21366,410
20636,117,4323,2676,3262,19060,1061
6756,11,90,3459,79,3711,11
21595,32,2947,2618,2215,55585,732
45548,14,378,523,251,9247,127
24965,0,14,2454,13,1494,1
7673,6,169,3408,139,8361,30
26975,14,261,2364,213,6534,48
39845,5,187,1662,136,5320,51
36207,21,516,1890,361,6710,155
12430,39,2395,3130,1829,22362,566
15974,10,497,2904,402,5176,95
17047,5,176,2848,142,9040,34
18566,95,2482,2777,1695,24448,787
43678,116,1437,985,1243,11797,194
41868,37,647,1435,486,9355,161
9963,20,1101,3259,861,11900,240
46464,1,27,142,24,1371,3
7189,20,2251,3436,1554,46647,697
14568,165,15367,2976,12016,131783,3351
39356,3,208,1690,154,3776,54
10132,14,1120,3251,838,30024,282
14212,16,316,3003,259,5442,57
8411,3,190,3350,146,3267,44
7398,7,311,3424,247,4000,64
16941,18,1107,2854,897,12212,210
21074,74,2777,2649,2229,47781,548
14473,14,555,2983,439,7035,116
23144,44,3602,2539,2733,26352,869
39101,11,557,1706,429,12833,128
17892,11,1154,2808,908,15404,246
45067,18,190,677,175,3983,15
45434,3,65,558,42,2096,23
13327,56,4447,3070,3283,32963,1164
16232,27,1504,2891,1197,25935,307
45743,5,97,437,71,3627,26
45567,26,502,516,403,4423,99
42925,7,231,1217,161,7133,70
3569,6,280,3592,217,9423,63
1971,25,417,3620,310,9358,107
11574,7,606,3176,488,18422,118
18436,14,586,2782,447,8543,139
28576,6,427,2272,330,8118,97
30450,9,203,2175,172,4437,31
42939,15,543,1213,375,7880,168
8805,28,1027,3324,834,8547,193
14974,1,35,2950,28,2347,7
6411,85,3117,3474,2421,64073,696
11800,1,98,3164,72,4851,26
9013,35,1261,3314,994,27225,267
18695,39,1364,2771,1100,10057,264
45515,43,458,536,304,9397,154
1011,8,156,3929,141,4982,15
16562,10,408,2875,344,3609,64
27702,3,234,2323,183,8716,51
43213,3,146,1136,107,7284,39
41491,7,196,1498,166,9143,30
42384,62,985,1339,775,10123,210
3075,118,4281,3601,3087,13331,1194
11039,115,5817,3204,3835,34439,1982
45188,1,17,627,8,1586,9
6276,20,758,3480,532,6910,226
29059,4,95,2247,78,3333,17
20506,23,625,2683,472,5562,153
41531,20,207,1494,170,4242,37
7413,9,175,3424,145,5094,30
3680,12,256,3590,173,2658,83
5996,2,424,3490,318,18930,106
2079,21,591,3618,479,6897,112
21189,4,180,2641,149,11703,31
25164,12,1556,2445,1159,41448,397
35697,3,89,1925,74,10568,15
39611,200,10630,1675,7876,59752,2754
4851,3,88,3550,68,2145,20
15413,35,1175,2929,954,5692,221
34939,99,1459,1972,1164,9512,295
22428,0,1119,2575,913,13364,206
6625,34,2091,3465,1342,15501,749
30212,5,114,2189,97,2235,17
42992,7,161,1199,120,5746,41
45701,13,169,461,134,3135,35
28297,101,3523,2289,2818,34835,705
29742,193,8351,2213,6331,99633,2020
29458,111,4322,2226,3107,31085,1215
38257,106,4933,1762,3051,45551,1882
32277,1001,48956,2083,34194,155572,14762
8546,4,286,3341,223,9851,63
11492,2,61,3179,42,2575,19
11992,1,166,3155,116,6772,50
14251,18,833,3000,647,11677,186
35590,39,843,1934,699,9422,144
41809,2,53,1445,45,2945,8
43007,11,433,1194,292,10383,141
32045,20,886,2095,644,11647,242
35568,0,24,1936,19,4661,5
11449,1316,114554,3182,71532,418689,43022
37955,92,1174,1782,899,16544,275
33595,68,1548,2030,1250,10254,298
18158,57,2534,2795,1951,19200,583
20427,26,1801,2686,1461,9259,340
33086,165,6140,2049,4458,44466,1682
40161,1,34,1641,27,4043,7
12966,15,949,3101,687,24871,262
8930,31,758,3318,600,8487,158
13905,27,2811,3023,1658,20378,1153
36517,3,374,1874,294,3231,80
20696,3,206,2672,169,2849,37
32365,45,809,2079,640,10541,169
10724,3408,167306,3220,94431,355551,72875
6303,4,46,3479,33,3545,13
10626,25,670,3226,528,14557,142
23507,24,749,2521,554,11648,195
31709,21,542,2111,431,8551,111
38933,0,19,1716,17,6109,2
14862,26,803,2957,648,8465,155
8800,10,117,3325,84,1647,33
9546,13,575,3280,431,10198,144
21501,16,1528,2624,1151,16720,377
31306,15,1007,2134,782,10205,225
13383,1,56,3065,42,5361,14
31879,3,309,2103,254,6661,55
42551,17,182,1304,137,3466,45
15681,36,1248,2915,941,13076,307
41385,2,34,1514,24,3378,10
27030,4,50,2363,41,2241,9
13879,2104,78324,3026,52324,360411,26000
4267,66,4143,3572,2872,28191,1271
30134,29,1757,2194,1370,23217,387
2431,52,1165,3612,860,12232,305
9279,88,5829,3297,4267,33015,1562
27914,19,686,2310,532,11567,154
8432,4,84,3349,70,2266,14
44581,13,212,822,141,3305,71
10714,9,291,3221,223,10985,68
1926,11,355,3622,245,7544,110
42020,9,89,1411,73,3382,16
2627,20,485,3609,414,8957,71
20760,3,197,2669,159,7392,38
10233,142,3512,3247,2642,39725,870
4551,37,1086,3562,824,11291,262
10407,54,2017,3239,1620,21126,397
43782,48,626,952,498,5758,128
11635,17,457,3172,374,7655,83
36052,47,5219,1899,3677,17539,1542
22370,71,4423,2577,3319,35358,1104
7739,340,16112,3404,11711,134639,4401
9540,9,206,3280,158,8775,48
21305,151,11070,2635,7262,56741,3808
1839,31,580,3624,479,11719,101
40700,1,52,1594,41,3136,11
37270,68,1425,1828,1092,13018,333
28041,1,148,2303,106,6795,42
42713,28,456,1271,360,7657,96
36625,2,141,1867,112,5719,29
20332,432,16467,2692,13050,53781,3417
26593,0,78,2381,70,3763,8
2604,24,734,3610,601,11356,133
32844,26,769,2058,611,13130,158
34409,0,17,2000,15,1954,2
25789,29,1178,2417,922,9660,256
12697,2,259,3117,159,4582,100
37116,10,170,1838,150,5737,20
24313,28,657,2484,534,10096,123
6761,8,90,3459,77,2322,13
18606,16,563,2775,458,14922,105
43584,45,634,1019,553,10596,81
9371,5,425,3290,317,14583,108
4340,115,4787,3569,3584,63055,1203
22545,2,167,2568,131,5971,36
20693,267,12906,2673,9322,102440,3584
40705,49,1062,1594,794,13735,268
20251,45,2914,2694,2349,8969,565
34883,69,2359,1975,1888,22404,471
2129,20,803,3617,667,7410,136
14791,5,309,2961,259,4211,50
45154,25,296,638,199,4714,97
45132,2,22,643,16,1536,6
18145,8,244,2795,196,11524,48
15514,527,29998,2924,21957,109197,8041
29952,6,288,2202,229,6196,59
11444,37,4862,3183,3613,24221,1249
16638,1,153,2871,119,2327,34
20006,28,1608,2708,1245,9251,363
4752,67,2012,3554,1465,14908,547
43081,14,297,1172,229,11552,68
4222,5,97,3574,86,5019,11
46094,19,427,301,355,5220,72
20073,12,269,2705,201,7023,68
15647,34,3154,2917,2332,30036,822
36564,0,114,1872,99,2652,15
9277,79,2600,3297,1992,22957,608
46247,15,122,245,105,1552,17
9434,121,5870,3287,3532,50815,2338
35913,94,1692,1909,1294,15141,398
14971,5,205,2951,182,3346,23
36704,14,924,1864,719,5481,205
36477,2,132,1877,96,9723,36
16700,59,5055,2868,3544,36718,1511
32770,5,690,2062,553,10867,137
39569,5,281,1678,222,6451,59
14452,10,798,2985,562,29147,236
27354,7,89,2344,69,3712,20
16756,9,365,2864,294,9064,71
11193,99,2809,3195,1963,29804,846
7750,31,378,3403,313,4915,65
37693,8,269,1802,179,10259,90
13847,54,1859,3030,1336,39250,523
16044,7,559,2899,459,6610,100
20173,47,3593,2699,2809,13268,784
13299,49,1108,3072,784,5564,324
38375,1515,66801,1753,46815,216837,19986
44673,70,1064,804,798,9164,266
14292,6,110,2997,84,2714,26
36671,35,421,1865,343,7698,78
38777,117,3422,1726,2669,14209,753
39211,118,2978,1699,2195,28362,783
33172,0,42,2045,39,3878,3
9588,27,436,3277,331,11647,105
7145,2,248,3438,213,4780,35
12232,7,236,3143,188,3787,48
34166,2,89,2010,78,3281,11
4703,1082,42551,3556,28766,211636,13785
2580,2,64,3610,55,5654,9
43179,10,435,1144,268,6426,167
46187,33,453,260,388,4226,65
30712,39,880,2161,708,9331,172
9458,3,85,3285,50,4849,35
24625,11,1744,2468,1339,14817,405
38172,29,369,1768,281,4884,88
34599,15,1163,1992,952,17348,211
45283,3,113,598,84,1992,29
3566,44,1231,3592,972,13337,259
33020,4,135,2051,106,2820,29
19030,300,5985,2758,4486,24873,1499
31840,2,92,2105,62,2184,30
27087,33,574,2361,453,7261,121
14117,28,664,3008,517,9186,147
7253,157,4440,3433,3154,46615,1286
43378,1,63,1082,46,3368,17
32450,220,5746,2076,3972,36468,1774
28855,2,149,2257,124,4794,25
11850,11,247,3163,208,5938,39
30491,22,926,2173,678,10950,248
22291,43,1177,2580,847,13516,330
6785,14,398,3458,327,14274,71
46183,0,33,261,12,1130,21
31924,2,65,2102,53,3774,12
24668,25,501,2466,328,6784,173
43288,0,30,791,22,880,8
28957,2,191,2252,136,7370,55
38039,67,3391,1778,2444,24130,947
44678,1099,62248,803,48633,146436,13615
6816,17,892,3456,631,17717,261
3466,42,495,3594,424,20205,71
18068,20,1259,2798,936,14783,323
12828,97,5177,3109,3761,27416,1416
8090,49,777,3370,613,11081,164
12511,2,115,3126,95,2413,20
31007,5,158,2149,126,3062,32
2530,96,2568,3611,1917,30080,651
43396,90,2494,1077,1770,15794,724
25355,13,326,2438,259,8318,67
42612,16,607,1292,418,10058,189
39099,15,494,1706,364,5682,130
43893,6,101,935,87,2056,14
36824,11,364,1855,283,9684,81
13724,19,462,3039,370,4983,92
3974,67,1627,3582,1258,10759,369
43968,11,151,924,104,1973,47
27711,119,5505,2322,4133,56611,1372
35401,16,932,1948,688,12409,244
34917,5,498,1973,340,6843,158
34371,12,823,2002,662,16236,161
35261,58,1253,1954,985,12219,268
21781,18,717,2608,563,7930,154
35211,31,830,1958,654,12897,176
8167,9,266,3366,204,5556,62
46329,16,137,214,119,3723,18
36658,8,386,1866,282,12599,104
9922,2,132,3262,109,2601,23
4630,6,55,3558,48,2898,7
42794,3,80,1248,59,4185,21
22694,36,2484,2561,1986,27336,498
28311,92,8335,2288,6417,22508,1918
25152,48,1587,2446,1318,9218,269
43522,12,258,1042,214,6160,44
4904,63,1490,3546,1185,13658,305
22711,1,85,2560,68,2724,17
26381,12,854,2390,710,18075,144
2970,10,331,3603,252,7028,79
42517,0,0,1310,0,2500,0
8576,30,801,3339,645,26103,156
11636,2,86,3172,73,4658,13
29666,9,472,2216,338,11654,134
35192,36,820,1959,606,3720,214
28466,8,474,2279,387,13526,87
8652,8,366,3334,265,5931,101
11734,31,1883,3167,1437,32468,446
35813,77,7397,1917,5597,16774,1800
5562,50,653,3512,537,6991,116
43017,9,149,1192,137,5324,12
36885,27,325,1852,260,3115,65
12638,68,2636,3120,1694,52079,942
12489,2,233,3128,186,6080,47
6282,2,157,3480,124,2903,33
28032,7,306,2304,270,11982,36
38424,14,656,1750,481,15200,175
41103,36,676,1555,479,3423,197
45824,88,872,412,717,9881,155
20715,58,5014,2671,3808,32867,1206
37265,130,3669,1828,2676,20954,993
45969,7,90,353,66,2206,24
12675,176,7369,3118,5811,20766,1558
2414,2,122,3613,99,3854,23
27422,1,61,2340,49,1863,12
38821,11,317,1723,253,5338,64
11348,4,219,3188,158,7894,61
19429,34,1582,2738,1213,25754,369
25458,0,70,2433,52,3566,18
17609,59,1766,2818,1397,19551,369
18262,11,352,2790,268,6555,84
26143,149,2182,2402,1718,19100,464
23472,38,2130,2523,1622,22093,508
27515,8,581,2334,403,5226,178
17384,16,1270,2829,900,18383,370
16008,139,11857,2902,9265,62377,2592
18494,28,1505,2780,1123,11437,382
5951,5,165,3492,142,3349,23
33431,28,761,2036,448,6921,313
42749,42,1148,1261,878,11218,270
37410,8,214,1820,175,5822,39
31178,7,283,2140,236,8202,47
29942,1271,91004,2202,57338,321006,33666
5301,14,242,3525,195,7261,47
25610,17,1503,2425,1202,9320,301
14946,3,174,2952,111,5259,63
15322,11,1483,2932,1173,15649,310
29461,44,4573,2225,3628,11864,945
4834,5,122,3550,79,6035,43
12268,35,1634,3141,1256,36594,378
15828,0,85,2909,73,2745,12
36822,22,1441,1855,1152,13295,289
10438,18,763,3237,651,9064,112
5789,55,1199,3501,935,7860,264
45702,25,240,460,152,5134,88
29391,170,5918,2229,4322,45228,1596
14237,48,2094,3001,1634,13930,460
34768,1,307,1982,238,9658,69
15539,1,65,2923,50,3286,15
22639,19,802,2564,615,6428,187
43064,20,209,1178,163,3518,46
18752,365,20104,2769,13671,109940,6433
12342,4,315,3137,251,13463,64
37471,13,346,1816,288,6212,58
22203,6,230,2585,169,3527,61
17448,463,38551,2826,26907,117240,11644
19477,0,38,2736,32,2052,6
31433,12,725,2127,598,11566,127
5367,249,11102,3521,8263,129187,2839
20496,31,1974,2683,1522,14333,452
8584,13,473,3338,373,5829,100
36228,3,141,1889,105,2665,36
4613,13,401,3559,328,10288,73
39631,17,552,1674,449,8654,103
12827,6,451,3109,376,9711,75
17413,148,3778,2827,2812,20093,966
5361,26,717,3522,543,11900,174
44063,6,68,906,49,3040,19
5748,6,364,3502,284,15575,80
15558,0,129,2921,102,4295,27
25057,0,12,2450,11,3769,1
7493,16,417,3419,338,8454,79
13030,9,154,3097,132,12848,22
30631,223,7581,2165,5494,37508,2087
23079,20,824,2542,662,13840,162
9784,9,244,3268,200,8055,44
39616,12,458,1675,367,4758,91
33470,30,875,2034,692,15161,183
9194,19,1114,3302,933,12401,181
8990,10,246,3315,190,4236,56
28329,56,1638,2287,1350,14678,288
1875,32,238,3623,188,5532,50
2439,14,372,3612,209,8683,163
29445,4,73,2226,61,4560,12
32603,8,139,2069,112,2736,27
31960,1,62,2100,50,4880,12
38837,35,536,1722,430,6472,106
43583,2,23,1019,20,1601,3
29508,91,3605,2223,2994,25755,611
41493,6,114,1498,94,4513,20
26611,50,2631,2380,2107,25042,524
32889,2,107,2057,86,4160,21
46062,6,45,310,37,1277,8
14648,16,485,2971,342,12926,143
19472,17,1016,2736,824,10494,192
46302,3,41,224,37,1596,4
10745,18,592,3219,461,9365,131
9008,2,126,3314,98,6394,28
16791,8,405,2861,300,3026,105
29377,24,1105,2230,879,27378,226
42876,127,6185,1231,4440,47517,1745
23470,6,336,2523,285,7065,51
36031,81,1712,1901,1313,9150,399
20932,0,45,2657,41,2094,4
29875,8,433,2205,342,11633,91
34723,51,550,1985,418,5239,132
20265,69,2400,2693,1872,9929,528
31859,7,186,2104,121,3799,65
10525,15,628,3233,481,5820,147
4816,9,354,3551,299,4278,55
33425,33,818,2037,654,8670,164
1655,0,21,3666,18,1590,3
18183,4,132,2793,96,3598,36
4431,9862,652270,3566,327046,2298636,325224
20321,2,208,2692,169,4925,39
23817,10,230,2507,183,6701,47
31804,139,3226,2107,2232,21165,994
15385,12,623,2929,462,8037,161
12134,532,43845,3148,28602,244841,15243
28003,4,102,2305,86,1458,16
9885,7,62,3263,55,3706,7
10202,4,284,3248,226,8469,58
42059,6,123,1404,101,5793,22
21849,8,309,2605,240,17026,69
6529,3,42,3469,35,1628,7
21376,91,5156,2631,3843,37439,1313
20537,4,100,2681,78,2561,22
8649,64,2157,3335,1669,18146,488
25765,12,224,2418,166,3122,58
15404,33,3528,2929,2774,28504,754
8305,17,669,3357,539,7843,130
32730,60,1317,2064,1039,21719,278
45261,19,116,543,96,2245,20
17188,12,1467,2840,1102,12052,365
39137,11,375,1704,232,3914,143
25871,532,61856,2414,43741,205976,18115
10529,1,64,3232,50,2721,14
38770,0,32,1726,30,2930,2
42807,3,107,1244,82,6451,25
34234,11,542,2009,429,5758,113
34386,10,733,2002,572,10824,161
7694,964,42871,3406,29822,143947,13049
1833,16,277,3624,223,6584,54
2106,148,2926,3618,2280,49799,646
22251,1,74,2582,70,2230,4
4153,66,1724,3576,1322,35172,402
37192,42,553,1833,415,5875,138
5462,1,191,3517,151,6165,40
6222,3,41,3482,38,2559,3
14601,1017,67043,2974,45964,304874,21079
20141,56,2124,2701,1647,27839,477
35705,1,56,1924,42,3693,14
20333,8,570,2691,488,21892,82
7513,37,1610,3418,1260,25504,350
43235,148,3625,1127,2325,20219,1300
44034,8,93,910,76,2536,17
37514,30,946,1813,663,15471,283
35970,0,18,1906,16,3771,2
21102,100,2471,2647,1782,13244,689
8428,13,792,3349,632,9237,160
10505,2183,170640,3234,113817,853730,56823
40547,2,38,1607,29,2605,9
8711,1322,79866,3330,55784,188546,24082
39495,81,1264,1682,967,12638,297
4947,56,1934,3544,1551,9674,383
20201,4,433,2697,313,3433,120
39837,8,148,1663,104,5336,44
13512,18,640,3055,461,21753,179
3834,174,17448,3586,12633,61417,4815
36877,15,639,1852,440,6063,199
2059,43,1702,3618,1374,47526,328
28316,0,450,2288,350,5807,100
2387,333,14161,3613,10956,55786,3205
6929,0,145,3451,116,3796,29
41295,63,1273,1526,990,15022,283
16952,0,86,2854,74,5827,12
31185,17,453,2139,378,4854,75
16189,3,127,2893,86,3284,41
19996,1,79,2709,65,3182,14
24508,33,2008,2475,1465,15728,543
41428,94,1973,1507,1502,28828,471
35675,154,2592,1927,1752,16129,840
2995,1,250,3603,212,6796,38
7272,6,118,3432,100,2136,18
45792,35,256,424,209,4670,47
33888,369,10168,2019,7659,82195,2509
29918,4,177,2203,144,4861,33
40843,8,88,1580,66,3263,22
45649,9,124,484,93,4231,31
42647,12,287,1285,221,7396,66
40862,48,889,1578,625,17798,264
25666,10,384,2422,304,5964,80
4791,119,6186,3552,4811,47168,1375
45928,9,119,371,95,4426,24
18772,43,1334,2768,1051,12558,283
24030,4,111,2496,92,2021,19
19141,12,1085,2754,883,9458,202
7028,369,10208,3445,7666,96258,2542
46110,0,8,295,4,856,4
10996,86,5125,3206,3451,36088,1674
12147,5,195,3147,149,4849,46
8806,10,400,3324,316,12105,84
10435,16,497,3237,396,24310,101
29642,218,16130,2217,10525,88365,5605
2475,8,229,3612,181,27106,48
41374,17,618,1515,460,8381,158
2357,58,448457,3614,128059,16300,320398
26876,13,533,2368,409,5088,124
18945,10,459,2761,347,8392,112
4143,52,1725,3577,1359,11487,366
15349,70,2679,2931,1962,31851,717
42739,24,324,1262,247,5347,77
7001,4,66,3446,55,2213,11
14246,35,1408,3001,1088,25239,320
28732,14,321,2263,246,3654,75
26496,52,3125,2385,2245,18365,880
20246,0,95,2694,78,4279,17
36755,10,250,1861,200,2978,50
3158,13,474,3600,380,20829,94
37309,21,874,1826,710,10524,164
35420,104,1216,1947,929,13635,287
28239,9,400,2292,327,9428,73
27786,55,2539,2317,1984,14619,555
9293,6,199,3296,149,8562,50
23057,73,1249,2543,1005,6644,244
41344,17,154,1520,132,3442,22
5451,4,171,3517,143,7518,28
8284,83,3294,3358,2538,23738,756
5956,1,30,3491,23,2856,7
39112,3,169,1705,113,4335,56
39424,90,2975,1686,1988,15939,987
34718,60,1329,1985,1086,12554,243
26698,0,43,2376,38,2185,5
46312,2,16,217,13,791,3
2029,28,1156,3619,897,21181,259
39721,0,77,1669,60,5386,17
43238,61,1463,1126,1157,11574,306
41226,11,692,1539,433,11036,259
40083,0,417,1645,269,3547,148
2051,24,253,3619,190,4316,63
7270,4,189,3432,143,4078,46
45192,5,80,626,41,2963,39
24462,52,1591,2477,1127,11308,464
28941,12,495,2253,406,5848,89
22362,5,280,2578,238,12676,42
23419,129,5216,2525,3854,28253,1362
11494,4,233,3179,193,13055,40
21800,20,918,2607,714,2254,204
26085,29,2106,2404,1498,14738,608
4264,4,349,3573,255,4038,94
20320,21,1046,2692,821,24437,225
45873,29,490,397,366,6804,124
37603,48,1180,1807,880,19076,300
36520,1,70,1874,59,1846,11
34157,74,1780,2011,1308,11085,472
3128,26,1699,3601,1298,35656,401
4593,5,194,3560,136,8745,58
40751,43,1372,1589,1071,25937,301
45990,81,756,344,618,6015,138
26952,2,67,2364,54,2086,13
31777,4,198,2108,141,7817,57
15371,3,156,2930,133,4527,23
43469,34,621,1056,512,14036,109
22223,2,91,2584,59,3492,32
14053,1,42,3012,34,2603,8
43532,77,898,1038,634,11623,264
43035,87,2173,1187,1544,14898,629
43855,5,124,939,98,3563,26
6928,22,821,3451,596,8021,225
3074,48,1993,3601,1580,11581,413
32923,0,0,2055,0,18395,0
24370,2,105,2482,89,10583,16
8672,9,260,3333,211,23788,49
38183,61,2537,1768,1947,30610,590
10305,62,3143,3244,2416,23086,727
39298,10,431,1692,334,7527,97
25201,49,3537,2443,2605,32077,932
26289,2,61,2395,52,4620,9
2256,49,1450,3616,1158,35247,292
45186,9,124,627,95,4078,29
43293,34,536,1111,376,4961,160
6616,21,701,3465,393,12086,308
36250,77,2027,1888,1358,19322,669
43048,72,777,1183,619,14255,158
44362,30,572,857,465,11972,107
26875,16,617,2368,524,8755,93
15492,54,1061,2925,834,6228,227
41908,9,230,1428,197,8478,33
20799,1150,81265,2666,54828,318292,26437
19747,8,363,2723,293,15076,70
27887,572,12440,2313,9444,68475,2996
36381,1,125,1881,98,5968,27
26423,0,15963,2388,12660,85978,3303
38645,11,368,1734,311,9570,57
38701,15,356,1730,284,5162,72
34441,0,56,1999,48,1718,8
27770,48,3002,2319,1790,11894,1212
29052,5,51,2247,43,5188,8
22667,0,8105,2562,5995,46767,2110
30978,9,466,2150,387,7112,79
43423,3,245,1069,194,3100,51
39975,24,501,1652,366,10249,135
24439,6,397,2478,326,8567,71
25894,7,193,2413,158,2809,35
36460,0,24,1877,19,3522,5
35796,0,18,1918,16,1539,2
8761,27,909,3327,646,7313,263
21713,64,3197,2611,2675,19664,522
23267,35,1675,2533,1374,13400,301
4411,37,876,3567,671,9187,205
15220,12,810,2937,654,9807,156
41521,2,37,1495,30,1465,7
39661,4,147,1673,124,9223,23
36933,4,243,1849,186,7030,57
30333,11,292,2182,253,7962,39
18150,5,244,2795,186,7334,58
25613,139,3740,2425,2713,17233,1027
43116,0,17,1161,13,3337,4
18722,118,7615,2770,5873,79518,1742
22611,35,1323,2565,918,5665,405
20977,155,5183,2654,3726,27459,1457
40648,59,2575,1599,2033,17107,542
29700,11,275,2214,232,5312,43
14826,1,78,2958,62,8089,16
41536,6,240,1493,184,6184,56
31222,18,421,2138,347,5417,74
26594,0,66,2381,57,2711,9
19532,4,228,2734,171,3482,57
22899,10,480,2550,406,6377,74
33965,0,17,2017,12,1754,5
41613,39,870,1481,633,7523,237
35298,5,178,1953,154,1848,24
13457,14,65941,3058,16520,7348,49421
8021,35,722,3379,585,5324,137
41007,155,4273,1567,2627,78118,1646
37316,0,95,1825,72,2948,23
35890,24,1355,1911,1082,9311,273
19132,139,17612,2754,13111,81933,4501
23575,68,1560,2518,1240,8969,320
32962,27,785,2054,652,6759,133
33678,10,701,2027,543,8051,158
12158,15,90451,3146,23723,11736,66728
41349,6,143,1519,100,7241,43
42604,19,490,1294,366,6859,124
30574,13,214,2168,186,3296,28
35351,9,480,1950,346,5948,134
18288,2,179,2789,153,2515,26
13951,9,414,3020,346,8572,68
13387,15,727,3065,611,10033,116
4437,7,230,3566,163,4208,67
38526,5,132,1743,111,4332,21
6346,133,6327,3477,4530,73894,1797
38599,41,1481,1737,1162,11802,319
28037,927,40478,2304,23740,265699,16738
15354,11,417,2931,344,9948,73
9211,6,294,3301,227,3938,67
41998,14,480,1414,340,16106,140
18658,6,270,2772,221,5634,49
26361,8,791,2391,652,8208,139
25383,18,1116,2436,940,8785,176
8414,470,19394,3350,14016,70088,5378
7325,4,134,3428,106,4686,28
20519,1,109,2682,92,3422,17
10444,30,1343,3237,1082,13707,261
2864,5,193,3605,145,7496,48
26863,4,479,2368,404,6876,75
25500,21,2940,2431,2111,21500,829
34069,5,55,2013,45,6245,10
45759,14,231,434,194,3185,37
38266,18,607,1761,471,7520,136
27949,33,2835,2308,2297,19427,538
45961,30,386,355,325,10659,61
26626,3,134,2380,115,5370,19
12332,15,554,3137,420,3961,134
8587,47,1476,3338,1101,12221,375
3534,126,3619,3593,2047,13809,1572
13892,217,5710,3025,4470,33080,1240
45491,40,419,543,309,4861,110
13734,4,200,3038,153,7990,47
1931,23,1949,3621,1624,13045,325
4158,146,7396,3576,4648,35708,2748
5958,30,2076,3491,1690,52058,386
39110,0,25,1705,20,2537,5
26769,2,95,2373,72,2738,23
35694,1,88,1925,74,3876,14
6099,4,300,3486,248,6733,52
7918,25,770,3388,616,12921,154
5022,1240,54400,3541,39173,274554,15227
8605,4,106,3337,77,3493,29
37509,0,73,1813,66,2358,7
44830,98,960,752,858,18211,102
33176,11,559,2045,426,6880,133
21309,8,309,2635,232,7135,77
31485,4,119,2124,103,3503,16
31172,6,159,2140,131,3424,28
35616,19,546,1932,447,9907,99
3033,3,166,3602,117,3859,49
2271,24,997,3615,813,51543,184
42716,7,229,1270,169,6019,60
24059,28,944,2496,661,8490,283
7484,359,20032,3420,11106,75238,8926
15987,11,193,2903,165,2236,28
36075,562,12962,1897,10050,51309,2912
29901,155,6385,2204,4690,60111,1695
33403,290,12163,2037,9066,35920,3097
14736,72,2250,2965,1738,17672,512
32876,26,586,2057,466,5153,120
45949,84,662,360,564,9398,98
45520,276,3490,535,2769,15262,721
5426,7,326,3518,252,7449,74
37639,1,88,1805,71,3134,17
21905,20,933,2602,729,10158,204
43914,7,98,930,82,1921,16
7180,16,1909,3436,1524,47221,385
3065,24,1533,3602,1204,25435,329
22854,29,731,2553,568,11762,163
38543,62,3376,1741,2537,21221,839
18466,15,1808,2781,1332,16412,476
18317,51,2205,2787,1706,14591,499
1379,1,37,3772,34,7608,3
17856,10,708,2810,555,12018,153
15684,4,171,2915,149,3675,22
29285,3,319,2235,251,6579,68
31597,4,63,2118,55,2268,8
9310,158,9823,3295,7731,53007,2092
36399,57,903,1880,767,12748,136
34872,15,467,1975,392,7804,75
36729,0,2593,1863,2022,30008,571
27029,748,17694,2363,12744,65481,4950
12041,17,408,3153,303,5966,105
39267,47,1430,1694,969,19446,461
4064,6,175,3579,134,5316,41
30722,8,416,2160,354,5652,62
2876,568,29038,3605,19887,184710,9151
38815,1,148,1723,122,3123,26
39053,3,51,1709,38,3384,13
34399,357,14318,2001,10319,98375,3999
26088,2,258,2404,213,7880,45
15403,7,132,2929,108,4322,24
26764,27,1640,2373,1327,24894,313
38999,148,5701,1712,4179,39765,1522
28785,7,174,2260,121,1551,53
35242,3,102,1955,83,5713,19
32118,92,3419,2090,2684,26243,735
4246,3,96,3573,76,11592,20
2186,5,187,3617,161,16724,26
15520,1,84,2923,69,2391,15
16247,713,42811,2890,28867,74119,13944
46015,3,53,331,42,2328,11
38144,35,664,1770,527,8984,137
26025,3,156,2407,133,3744,23
9492,10,234,3282,179,3750,55
41743,22,1146,1459,739,22590,407
42871,6,107,1232,88,2574,19
7179,10,126,3436,93,5525,33
43607,11,178,1008,149,7414,29
17641,10,3014,2817,1985,35310,1029
27319,0,13828,2346,10701,88577,3127
28731,173,5452,2263,4202,33142,1250
33443,2,89,2035,63,2266,26
16904,22,859,2857,614,15675,245
5283,10,273,3526,219,16275,54
28490,166,6363,2278,4582,64121,1781
21221,9,567,2638,447,5661,120
22848,197,7780,2553,5601,22552,2179
32837,20,1468,2059,1181,18872,287
32338,6,720,2080,484,4812,236
9886,40,825,3263,601,8851,224
8823,104,4989,3324,3894,40581,1095
28766,44,2992,2261,2178,18616,814
19372,0,42,2742,33,1564,9
20183,1,138,2699,103,6350,35
33260,48,3167,2042,2263,22056,904
32459,14,242,2075,194,4519,48
30823,30,1820,2156,1351,37778,469
2000,20,1067,3619,832,11800,235
21262,15,357,2636,280,7740,77
29313,42,1439,2233,1056,13427,383
28436,33,746,2281,619,17443,127
14724,0,644,2966,518,25614,126
20068,48,1095,2705,797,13373,298
4129,7,256,3577,213,8546,43
8437,4,210,3348,178,8495,32
14574,757,62737,2976,45418,278849,17319
18770,50,2707,2768,2075,14801,632
5590,10,310,3511,224,5619,86
10868,2,82,3213,65,1981,17
20632,0,2643,2676,2022,45860,621
21063,28,1137,2650,910,16583,227
30994,14,338,2150,283,3927,55
6777,30,1313,3458,910,13136,403
21174,13,1761,2642,1415,18979,346
14217,53,2533,3003,1802,16719,731
4656,67,4630,3558,3030,88692,1600
35197,44,768,1959,632,5493,136
37700,55,1195,1801,918,12490,277
35360,265,20046,1950,13224,95429,6822
8564,272,18165,3339,12469,120426,5696
23634,19,533,2515,411,6016,122
34025,75,4796,2014,3072,41131,1724
44948,40,572,719,407,4728,165
13617,33,1175,3048,904,28457,271
12151,31,863,3147,658,15706,205
19735,6,278,2724,231,7965,47
20859,1,92,2662,71,2528,21
44845,2,71,746,50,2194,21
2464,2,66,3612,60,4064,6
46119,10,165,292,112,2570,53
19437,6,419,2738,258,6130,161
5965,20,619,3491,493,5389,126
12708,11,368,3116,278,7222,90
34965,44,4696,1971,3329,28690,1367
38404,10,247,1752,201,5416,46
5356,33,852,3522,563,17210,289
11721,246,8052,3167,5409,43636,2643
14324,20,1812,2994,1323,19288,489
4039,22,1914,3580,1187,26380,727
28653,247,7524,2267,5153,41547,2371
4572,24,726,3560,617,7619,109
13113,29,2761,3091,2010,30826,751
7857,157,109728,3394,40173,46950,69555
39417,39,583,1686,457,13131,126
7889,18,641,3391,544,7723,97
33184,11,179,2045,144,5972,35
9053,19,987,3311,849,6509,138
35714,27,898,1924,729,6095,169
10217,218,13342,3247,9709,87546,3633
5146,99,2334,3533,1824,24790,510
44365,18,543,857,380,15104,163
43422,5,240,1069,144,7335,96
40065,13,1534,1646,1210,11638,324
10421,9,129,3238,112,2434,17
3766,5,75,3588,65,3580,10
24514,2,199,2475,159,4691,40
17382,370,15288,2829,11392,96448,3896
4113,2,61,3577,51,4045,10
14369,24,650,2990,529,8622,121
37824,25,359,1791,273,8045,86
42411,302,5036,1333,3808,49330,1228
15874,24,423,2908,345,5245,78
24623,200,9295,2468,7076,73116,2219
30541,44,879,2170,674,12890,205
6760,3,65,3459,54,1976,11
29533,6,319,2223,234,4366,85
25949,29,1543,2410,1161,7769,382
40012,1,100,1650,69,7915,31
24783,3,593,2462,490,8153,103
12442,48,1432,3130,1257,10925,175
28765,552,16121,2261,12142,117217,3979
21962,4,135,2597,94,10400,41
43323,3,67,1103,44,2244,23
30903,4,207,2153,168,3420,39
29954,7,253,2202,207,11532,46
41176,1,20,1546,17,3933,3
22843,338,18068,2554,12340,114562,5728
24282,6,577,2485,442,10116,135
12100,90,3630,3150,2711,23751,919
8856,76,4701,3322,3779,38853,922
29661,5,297,2216,249,19114,48
20829,12,746,2664,630,12946,116
22463,17,382,2572,330,3271,52
35439,63,1387,1945,1081,17863,306
15055,0,121,2945,112,3972,9
14128,41,1442,3007,1181,24179,261
46274,13,135,236,102,1575,33
43025,20,195,1191,139,3515,56
23901,65,1461,2503,1113,6697,348
25005,7,908,2453,763,12457,145
12196,48,2287,3145,1699,23017,588
45094,25,233,662,176,4822,57
13550,21,827,3052,627,5804,200
11657,2,102205,3171,26519,7672,75686
21728,94,4439,2611,3369,37714,1070
30577,160,3110,2168,2530,25777,580
12438,14,445,3130,346,12148,99
34178,6,164,2010,117,3746,47
23642,0,62,2514,49,4840,13
45130,13,149,644,119,2263,30
4145,216,5292,3577,4029,77719,1263
39093,18,463,1706,382,10213,81
8228,25,1406,3362,1066,16232,340
41114,45,612,1553,501,6588,111
2704,8,186,3608,143,5978,43
25826,42,1551,2416,1212,9714,339
7920,117,3737,3387,2899,22981,838
16276,16,527,2889,423,5142,104
25911,8,579,2412,463,6856,116
39363,2,208,1689,166,7184,42
29507,18,264,2223,187,1975,77
20144,42,1305,2701,1055,13805,250
35235,22,1123,1956,835,8150,288
6278,6,134,3480,108,2952,26
4827,4,354,3551,283,15455,71
37181,1,33,1834,29,1058,4
41465,4,274,1501,190,4020,84
31291,35,3407,2134,2425,31162,982
25312,66,2188,2439,1658,17453,530
40818,60,1496,1582,1095,19824,401
19731,60,2321,2724,1819,10437,502
41598,13,189,1482,144,4831,45
18534,3,162,2779,129,3649,33
4842,19,991,3550,724,13858,267
9378,14,676,3290,549,6390,127
33784,1,69,2022,55,4343,14
16566,56,2864,2875,2153,33120,711
21469,9,273,2626,211,3443,62
25406,13,345,2436,267,3741,78
4070,26,456,3579,354,7699,102
46102,19,261,298,207,7614,54
7902,504,58118,3390,37960,234681,20158
39934,6,179,1655,144,5219,35
25764,5,151,2419,118,8289,33
28995,1,54,2250,47,3508,7
21540,5,489,2621,342,10051,147
3695,7,263,3590,219,15945,44
21602,6,293,2618,226,29718,67
16055,207,6877,2899,5303,33874,1574
20952,57,2139,2656,1559,75003,580
35104,3,396,1964,330,5963,66
4677,25,487,3557,368,9938,119
1964,27,1517,3620,1153,15705,364
20099,21,823,2703,604,6884,219
32577,2,46,2070,40,5122,6
11438,9,768,3183,537,16315,231
11796,3,193,3164,158,11800,35
7134,25,1154,3439,954,13335,200
44873,11,143,740,90,4348,53
10762,190,10107,3218,7427,74521,2680
7840,28,920,3396,742,20837,178
7971,26,647,3382,515,12244,132
4812,0,27,3551,20,2689,7
35392,2,103,1949,96,3110,7
42290,8,213,1356,164,4454,49
6548,66,2317,3468,1814,18248,503
43415,11,313,1071,214,5484,99
28822,10,436,2258,369,3577,67
16636,20,1244,2871,985,11724,259
42944,6,76,1211,66,2045,10
29971,23,513,2201,393,3907,120
7891,53,1984,3391,1632,27814,352
39796,15,605,1665,444,5028,161
35631,271,18616,1931,13361,106096,5255
21886,5,166,2602,131,4898,35
41847,16,670,1438,547,11362,123
39361,21,380,1689,268,5415,112
32522,48,1566,2073,1207,19566,359
2517,11,137,3611,113,9564,24
20653,5,267,2675,226,5234,41
36179,1,81,1891,72,1783,9
43602,57,547,1011,359,5843,188
12599,83,3322,3123,2527,27173,795
26165,10,215,2401,181,3900,34
6269,4,39,3480,27,1624,12
20546,43,3151,2680,2623,17854,528
5672,58,1461,3506,1118,20721,343
8722,149,10154,3330,7518,83900,2636
18257,163,9264,2790,6425,70938,2839
10300,11,253,3244,199,6392,54
24068,26,755,2495,533,10504,222
18160,166,12656,2795,9477,34324,3179
19335,6,333,2744,232,4689,101
39527,0,0,1680,0,3899,0
43075,6,376,1173,233,7486,143
44516,11,123,837,79,3794,44
38847,3,370,1722,302,14325,68
9594,0,155,3276,112,3143,43
19911,97,9826,2714,6774,30551,3052
22615,0,65,2565,53,4158,12
43600,6,105,1012,85,3750,20
17109,3,73,2844,62,6921,11
15894,2,232,2907,144,2684,88
2898,57,1369,3605,1060,20123,309
18498,4954,1427480,2780,905828,1487909,521652
33422,3,120,2037,90,2269,30
1927,6,190,3622,155,12137,35
25101,274,12168,2448,10194,93078,1974
39186,0,26,1700,18,1971,8
43145,0,37,1153,30,5193,7
38642,75,4660,1734,3056,32726,1604
29908,57,1621,2204,1330,11960,291
25265,20,563,2442,385,7425,178
45005,112,1307,702,1021,21194,286
22546,8,259,2568,206,8531,53
15095,24,1066,2944,715,13477,351
33779,49,1325,2022,1044,11415,281
28132,42,1465,2299,1122,8400,343
6550,20,348,3467,284,4365,64
19183,4,648,2752,514,16408,134
29703,0,376,2214,323,5924,53
35869,8,401,1913,331,5806,70
7675,118,4783,3408,3769,36842,1014
7341,238,7081,3427,4932,37172,2149
8293,136,4466,3358,3440,38198,1026
10063,4,92,3254,70,2990,22
33212,105,4453,2044,3482,38744,971
14626,27,2119,2973,1667,21632,452
5516,71,2300,3515,1775,38398,525
11414,42,1037,3185,818,10535,219
4208,1,32,3574,29,1949,3
37084,4,171,1840,132,6024,39
36843,36,950,1854,760,12442,190
41160,181,6775,1548,5078,37493,1697
17017,51,3704,2850,2368,33902,1336
30572,3,132,2168,98,3819,34
40833,43,1542,1581,1087,15273,455
36087,55,1767,1896,1362,15067,405
13026,21,1378,3097,1111,33193,267
12327,4,117,3138,84,5942,33
13696,3,262,3042,203,4998,59
3925,47,844,3584,646,9779,198
12822,82,8810,3109,6635,56417,2175
17932,12,442,2806,363,7956,79
10608,2,185,3227,165,3599,20
6725,24,628,3461,469,14459,159
12136,8,472,3148,380,7573,92
2457,15,480497,3612,143761,8788,336736
29546,10,316,2222,272,5143,44
39423,0,33,1686,26,2389,7
13432,86,2759,3062,2091,35320,668
15678,8,341,2916,290,2924,51
35417,53,512,1947,408,4016,104
24179,14,1034,2490,853,8533,181
5347,76,2467,3523,1904,14276,563
25333,136,7351,2438,4938,45600,2413
43571,51,1067,1024,834,16555,233
30723,55,3167,2160,2451,12716,716
25523,8,320,2430,234,8183,86
19995,0,30,2709,25,1551,5
38774,35,793,1726,667,9664,126
20575,348,13866,2679,10390,51658,3476
19331,421,31200,2744,23189,98798,8011
32885,7,358,2057,289,3730,69
31154,0,73,2142,64,3064,9
1610,31,1627,3678,1328,22910,299
4762,13,280,3553,229,4595,51
22142,19,622,2588,464,13895,158
22991,6,296,2546,211,3770,85
1979,21,612,3620,526,10013,86
10376,71,2562,3240,2057,27477,505
32973,4,146,2054,123,5253,23
17722,6,184,2815,142,2488,42
19974,1155,70308,2710,45013,323578,25295
3012,36,790,3603,620,21634,170
26581,3,150,2382,125,3268,25
43117,347,12964,1161,7285,85197,5679
42176,0,0,1379,0,1634,0
10234,11,354,3246,261,8426,93
26458,4,506,2387,347,6622,159
3610,10,247,3591,186,4633,61
45230,200,2125,616,1783,29482,342
41888,13,319,1431,256,7788,63
41688,189,2990,1469,2115,39496,875
37546,58,1898,1810,1546,19748,352
24339,12,1077,2483,898,12947,179
2710,138,5221,3608,3883,54619,1338
7574,3,31,3414,25,1964,6
36418,5,155,1879,125,5036,30
12544,1,102,3126,65,1779,37
9628,5,273,3275,226,12671,47
34230,149,6210,2009,4507,44671,1703
45218,39,781,618,509,6823,272
15916,3,292,2907,221,7803,71
1684,0,28,3660,22,1703,6
43150,35,825,1152,664,26907,161
18192,0,112,2793,83,10475,29
32038,0,0,2096,0,9674,0
10033,19,645,3256,491,10065,154
28629,5,729,2268,568,12246,161
40582,64,1830,1604,1375,21339,455
24274,94,1852,2486,1347,14145,505
5098,343,14404,3536,10898,57852,3506
3024,6,296,3602,198,12153,98
42709,83,1545,1272,1090,14834,455
4433,6,100,3566,85,4996,15
43756,26,192,961,154,3070,38
15288,7,321,2933,273,18267,48
6287,79,1968,3480,1678,16688,290
21339,56,4468,2633,3094,37362,1374
11121,11,442,3199,350,3856,92
43347,22,279,1096,206,5056,73
31448,41,1697,2126,1327,8412,370
13632,125,10728,3047,8280,43709,2448
19364,9,376,2742,297,13217,79
29447,55,2692,2226,2010,25828,682
42589,6,60,1297,46,4470,14
27701,37,939,2323,705,9610,234
8510,11,799,3343,597,17607,202
8319,5,34,3356,28,1898,6
22264,4,256,2582,209,4183,47
34073,6,127,2013,95,3565,32
18617,505,49715,2775,32452,207701,17263
29523,213,5954,2223,4510,24741,1444
5778,32,1157,3501,894,13302,263
5478,301,12419,3516,9497,53082,2922
36088,3,130,1896,111,5238,19
19091,1,34,2755,27,3359,7
46465,5,53,142,34,758,19
13448,85,5222,3059,3899,18308,1323
30311,14,473,2183,400,3936,73
26062,120,5113,2405,3533,31528,1580
32751,5,146,2063,127,5630,19
22108,108,6446,2589,5200,71162,1246
46043,18,229,316,155,4216,74
34495,0,69,1997,63,2640,6
33629,3,113,2029,88,3258,25
45663,4,46,479,34,1416,12
16518,91,2999,2877,2279,28740,720
42674,37,878,1279,695,13889,183
14290,15,280,2997,201,6460,79
43259,7,186,1120,126,1968,60
36898,7,150,1852,135,2613,15
15207,2,113,2937,93,5059,20
41975,42,2000,1417,1526,26683,474
21929,8,320,2600,272,2669,48
45853,128,1401,402,977,6958,424
16533,1160,61020,2876,42515,140592,18505
7670,5,249,3408,190,11782,59
17229,202,13952,2837,10375,88832,3577
36552,51,906,1873,692,16201,214
35630,15,242,1931,201,4270,41
12788,12,378,3111,324,15792,54
27874,0,115,2313,100,3791,15
27962,7,257,2308,187,8263,70
46378,4,82,191,62,1024,20
27109,100,3065,2359,2498,17071,567
3387,31,1876,3596,1486,20233,390
36064,41,430,1898,312,3815,118
17626,71,1522,2818,1182,25594,340
9095,7,232,3308,174,5268,58
27165,16,637,2356,481,18921,156
23405,8,173,2526,147,2379,26
19585,79,2901,2732,2156,13314,745
29886,3,222,2205,127,5225,95
2177,8,280,3617,182,12029,98
16434,99,9338,2881,6958,49435,2380
27097,12,352,2360,272,3811,80
37936,39,2167,1783,1644,27515,523
4757,22,252950,3554,84484,6085,168466
9534,1564,85316,3281,56787,305550,28529
32949,2,110,2055,86,2706,24
2541,108,8977,3611,6744,36288,2233
38609,19,742,1736,517,5013,225
22049,1,32,2593,29,1619,3
37562,5,173,1810,126,9654,47
16897,123,5242,2857,3767,38299,1475
3627,24,343,3591,264,5309,79
14896,48,1838,2955,1347,25429,491
30013,20,636,2199,522,7293,114
19761,6,314,2722,262,11072,52
45787,152,1847,425,1600,17678,247
40145,65,1584,1643,1191,20466,393
13768,7,448,3035,359,9507,89
35773,10,415,1920,332,11198,83
20335,174,5382,2691,3639,33425,1743
23894,0,9,2504,7,2282,2
20954,35,1340,2656,1050,14773,290
2447,48,988,3612,796,8457,192
4687,208,8223,3557,6474,98759,1749
9925,2,34,3262,29,3851,5
15427,246,15309,2928,11583,77550,3726
23073,75,1709,2543,1187,10541,522
5123,17,433,3535,324,4736,109
34356,0,81,2003,58,3481,23
38148,1,29,1769,23,4218,6
2718,23,413,3608,313,6572,100
29178,15,337,2241,262,4732,75
37744,18,341,1797,271,7281,70
16412,6,210,2881,168,4695,42
36089,17,709,1896,543,15917,166
25931,5,575,2411,465,13469,110
26282,2,127,2395,104,4145,23
45895,235,3469,388,2714,15510,755
42472,57,1070,1319,782,13158,288
28296,7,394,2289,293,4938,101
20253,4,119,2694,106,2792,13
6602,16,461,3466,338,6182,123
13203,15,527,3078,436,20139,91
45259,20,752,606,619,8211,133
24758,5,243,2463,197,4847,46
44688,70,691,800,596,8256,95
31234,35,2199,2137,1634,17618,565
7743,10,266,3404,216,13929,50
40123,0,0,1644,0,2381,0
14403,1,111,2988,82,4207,29
19553,69,9047,2733,6588,48368,2459
22239,83,1628,2583,1305,17999,323
19829,4,240,2718,209,2629,31
8637,15,147,3335,115,5185,32
8654,67,1811,3334,1224,19867,587
30031,9,375,2199,319,9253,56
32627,666,34709,2068,25751,181775,8958
29163,280,7755,2242,5845,74335,1910
39849,27,419,1662,342,13149,77
21833,68,5505,2606,3808,38120,1697
11610,39,2125,3174,1577,26355,548
45017,22,316,699,223,4219,93
2733,17,481,3608,399,5769,82
34538,2,76,1994,63,2885,13
39977,4,143,1652,115,6392,28
34165,56,1341,2010,1105,12668,236
37704,25,246,1801,185,3303,61
9262,54,909,3298,793,16700,116
21110,4,111,2647,91,3603,20
2944,41,1133,3604,879,32111,254
26122,4,154,2403,129,6120,25
44108,179,2391,897,1462,21018,929
4999,97,2289,3542,1902,15978,387
29401,12,387,2229,316,9747,71
16427,23,1251,2881,1003,16718,248
37210,2,87,1832,45,5437,42
12570,17,541,3124,458,14700,83
45501,6,192,542,104,3246,88
7514,65,1937,3418,1547,17811,390
10183,248,11640,3249,7494,74449,4146
44944,91,1290,720,1088,15466,202
5036,26,600,3540,453,7702,147
34769,10,334,1982,255,5643,79
20767,31,701,2668,579,7505,122
10816,1,81,3215,56,2941,25
34585,36,524,1992,422,7348,102
45893,15,160,389,127,2832,33
39121,19,241,1704,195,4436,46
28377,4,433,2284,357,11647,76
36364,127,5952,1881,3948,55526,2004
16396,363,65411,2882,41668,130318,23743
4149,11,273,3576,213,9679,60
39202,122,4597,1699,3468,55023,1129
13581,149,11068,3050,7748,73006,3320
39546,0,42,1679,34,3080,8
35161,3,69,1960,63,3416,6
30421,7,392,2177,310,9398,82
11392,21,528,3186,368,3160,160
14280,1123,115587,2999,76525,255324,39062
12305,8,252,3139,175,8241,77
21530,27,1288,2622,961,12274,327
5407,3,33,3519,29,1953,4
10284,7,258,3244,179,3512,79
33588,27,762,2030,600,4331,162
30495,2,138,2172,106,3949,32
42113,1,64,1395,47,4608,17
37592,14,356,1808,271,6385,85
15286,16,866,2933,705,22421,161
38038,0,543,1778,425,8228,118
38775,47,1029,1726,796,10849,233
1136,3,158,3889,130,7658,28
13945,13,498,3020,327,9934,171
20127,16,592,2702,509,7799,83
22887,14,1809,2551,1357,53022,452
33739,143,3507,2024,2550,24724,957
20681,15,491,2673,371,4144,120
13935,185,7392,3021,5742,30261,1650
18857,9,380,2764,258,4307,122
15136,58,2427,2941,1909,22590,518
44746,23,229,779,160,4300,69
35480,16,447,1943,344,10634,103
18895,19,2112,2763,1685,6113,427
34978,32,1402,1970,1086,8272,316
29528,4,102,2223,77,2663,25
32948,37,1270,2055,1048,24447,222
5635,5,118,3508,88,2465,30
38569,0,37,1739,28,4069,9
22488,1,70,2571,45,1857,25
42454,28,1033,1323,697,15950,336
31463,424,21034,2125,15234,127757,5800
22051,7,259,2593,205,5404,54
3845,5,298,3586,243,11196,55
5925,38,1366,3493,1048,21118,318
23558,305,15285,2519,11111,80987,4174
41723,152,3878,1463,2913,47600,965
29176,6,347,2241,290,5622,57
36821,5,86,1856,71,3016,15
27675,218,4460,2324,3203,40282,1257
7728,8,273,3405,183,3947,90
43157,57,550,1150,442,8638,108
29806,82,5188,2209,3931,28293,1257
5252,66,2616,3527,1940,50683,676
44936,42,333,724,247,5827,86
2901,4,231,3605,181,19022,50
23518,33,4868,2521,3609,36255,1259
39914,6,91,1656,77,4326,14
18233,11,1177,2791,798,8495,379
37901,65,592,1786,472,7773,120
35545,12,261,1937,223,5338,38
5722,116,2404,3503,1774,43924,630
19529,891,88627,2734,58516,373563,30111
18008,23,1473,2801,973,33945,500
30172,6,180,2191,127,2839,53
33585,6,154,2030,123,5934,31
14412,1,106,2987,78,4544,28
21955,11,459,2598,382,7724,77
18793,0,362,2767,281,9744,81
34125,71,3482,2011,2543,21745,939
11908,20,885,3160,712,8715,173
10680,9,109,3223,75,2005,34
36537,55,723,1873,550,5992,173
32152,12,666,2089,520,5619,146
25655,86,4184,2423,3225,22545,959
6142,6,83,3485,63,2767,20
38293,3,73,1759,58,3647,15
8915,22,1080,3319,820,8605,260
5120,111,3311,3535,2507,40373,804
21899,112,3704,2602,2927,22688,777
11954,368,11520,3157,8488,110861,3032
28312,24,1273,2288,962,17429,311
20765,8,393,2669,300,12757,93
7809,18,653,3399,485,4326,168
14008,51,2404,3015,1810,31592,594
31242,12,824,2137,638,11048,186
13335,2,138,3069,113,3276,25
24722,26,1504,2464,1220,21266,284
31936,7,450,2101,366,8671,84
16716,9,366,2867,303,6414,63
38221,2,170,1764,130,3368,40
14420,32,1054,2987,824,13005,230
11640,2,141,3172,119,2963,22
18696,21,1500,2771,1047,20466,453
3812,12,293,3587,246,2996,47
42636,0,15,1288,13,1787,2
41332,3,100,1521,80,2448,20
11986,48,1463,3155,1082,26225,381
31732,24,1065,2111,766,9602,299
5032,9,90,3540,68,3910,22
38252,83,3680,1762,2598,32915,1082
43551,26,827,1030,616,10052,211
3007,16,357,3603,293,13020,64
45172,19,128,632,101,1977,27
35929,18,165,1908,126,2898,39
17585,10,458,2819,363,12872,95
33926,19,2036,2018,1494,18224,542
7187,87,1632,3436,1293,36816,339
36390,3,92,1880,64,5678,28
31331,115,4080,2132,3221,32434,859
36857,8,222,1853,169,2919,53
23437,3,258,2524,205,4284,53
6332,11,455,3477,377,8295,78
45755,7,73,436,64,3095,9
45562,5,72,518,36,2537,36
5755,4,209,3502,174,4769,35
34028,21,643,2014,485,14951,158
3043,8,254,3602,203,13751,51
2014,15,449,3619,383,11344,66
5175,3128,307350,3532,195173,1050327,112177
27599,17,513,2329,415,4397,98
46198,11,283,257,170,1975,113
29721,10,412,2213,339,16849,73
25224,408,14886,2443,11300,85948,3586
12213,15,603,3144,430,6946,173
6516,3,93,3469,80,3564,13
13087,40,1510,3093,995,31872,515
20097,34,1224,2704,913,9880,311
14288,5,313,2997,232,8780,81
28073,1,40,2301,29,4863,11
34345,1,41,2004,33,1775,8
20897,12,900,2659,754,26176,146
5202,4,62,3530,52,3427,10
7512,6,327,3418,240,4001,87
10725,12,595,3220,486,18048,109
44932,14,167,725,152,4168,15
16120,3233,427071,2895,259307,1197660,167764
8356,167,1950,3353,1563,53950,387
16684,1,18,2868,14,1781,4
4699,42,1177,3556,858,7553,319
17085,5,387,2846,305,3423,82
39035,26,645,1710,504,12665,141
27684,100,9073,2324,7056,76419,2017
14799,210,15740,2959,10828,33876,4912
9950,5,366,3260,284,10520,82
27502,1,107,2334,88,4916,19
43090,45,1209,1169,766,18454,443
14999,1596,109334,2949,74217,679310,35117
8648,0,56,3335,42,1848,14
22629,4,70,2565,61,3184,9
36214,4,84,1890,72,2646,12
27990,96,3420,2306,2340,21765,1080
7804,26,2390,3399,1895,31970,495
24018,0,5848,2497,4333,38671,1515
15618,8,414,2918,366,8577,48
25772,15,719,2418,544,14852,175
26758,21,539,2374,425,12139,114
43650,2,15,994,12,1548,3
46054,23,218,312,172,2413,46
2370,36,787,3614,639,18292,148
1901,22,1392,3622,997,10783,395
12223,13,924,3144,707,10352,217
14413,32,3884,2987,2952,69953,932
20151,7,326,2700,271,7484,55
20055,1,138,2706,115,2812,23
18457,2,99,2782,71,5028,28
3435,15,1032,3595,735,14879,297
24725,389,17265,2464,12470,113769,4795
11167,321,20051,3196,14995,94058,5056
2682,18,491,3609,360,10365,131
24268,16,491,2486,390,6476,101
32819,26,892,2060,682,17979,210
12139,33,839,3147,640,13848,199
40881,22,463,1576,370,6807,93
45587,0,58,513,50,3529,8
31216,19,906,2139,665,6584,241
38281,2,174,1761,129,4555,45
45535,0,14,530,8,969,6
32257,14,275,2084,200,5068,75
2504,5,231,3611,211,9898,20
7452,207,5013,3421,3561,28857,1452
3672,1,101,3590,75,2982,26
4525,16,1212,3563,892,11073,320
11027,131,6216,3204,4590,39919,1626
2210,790,48894,3616,33810,269838,15084
6997,234,14291,3447,9283,59776,5008
33580,22,2028,2030,1554,25002,474
7966,17,353,3382,302,5812,51
44211,26,337,878,268,8186,69
42416,30,823,1331,611,13873,212
39557,1,42,1679,33,2191,9
23378,1,130,2527,99,5869,31
15559,11,462,2921,387,8509,75
17178,5,330,2840,242,8196,88
18914,102,6503,2762,4941,26272,1562
1974,13,358,3620,293,12633,65
5081,10,63,3538,48,3075,15
45627,52,417,495,375,5736,42
19092,66,3875,2755,2842,30338,1033
36728,2,22,1863,18,3129,4
10141,134,5038,3251,3806,40607,1232
46437,41,1237,159,897,9496,340
24521,4,167,2474,122,3582,45
1271,5,91,3843,72,3501,19
45100,8,167,659,148,7429,19
16377,47,4613,2883,3251,33830,1362
44858,44,524,742,463,6933,61
33771,46,2001,2023,1375,26660,626
14440,2,245,2985,182,8560,63
5784,0,26,3501,17,1665,9
23448,6,366,2524,249,4708,117
37081,16,324,1840,242,7463,82
14933,4,170,2953,134,2633,36
1209,8,345,3861,304,11562,41
31445,2,233,2126,178,10447,55
39684,4,69,1671,56,4773,13
3248,27,1033,3598,852,5932,181
6010,7,208,3489,163,2025,45
41468,3,37,1501,37,1507,0
40345,5,196,1627,150,4910,46
36880,1,48,1852,41,1530,7
8937,4,113,3317,84,3366,29
31932,12,357,2101,265,8159,92
24651,0,33,2467,30,3501,3
37641,7,292,1805,243,6643,49
28072,0,34,2301,26,6065,8
14524,12,826,2979,621,9880,205
30961,1,102,2151,89,2810,13
5772,1,53,3502,40,1399,13
37027,21,647,1844,528,12181,119
18553,66,2076,2778,1663,22016,413
34266,25,1243,2007,895,16409,348
2629,7,211,3609,178,11714,33
4555,9,541,3561,393,19569,148
11700,47,1497,3169,1188,13918,309
46224,0,14,250,8,1123,6
19159,0,91,2753,76,5148,15
7301,12,166,3430,126,5231,40
26043,2,352,2406,219,2631,133
45738,13,203,441,139,2636,64
10108,0,72,3252,55,1889,17
10911,13,1524,3210,1011,22127,513
36681,0,49,1865,35,1982,14
19617,6,247,2730,176,4938,71
34311,10,375,2005,272,8116,103
43473,129,2801,1058,2396,35906,405
42131,153,1921,1391,1488,16662,433
19385,6,327,2741,249,9880,78
25249,9,522,2442,405,12983,117
10701,85,2745,3222,2087,13233,658
33000,7,217,2053,180,3637,37
6319,54,1154,3478,895,34816,259
40472,11,947,1614,722,12214,225
21232,2,114,2637,96,2987,18
13190,27,2259,3079,1675,21178,584
39588,8,210,1676,162,12468,48
18297,346,27352,2788,20417,116843,6935
39482,6,142,1683,119,8435,23
22363,32,1837,2578,1391,22052,446
19406,36,2521,2740,2015,12260,506
5416,49,1354,3519,1101,26341,253
8451,94,8596,3348,6245,58204,2351
7451,97,6210,3421,4540,43958,1670
11596,24,517,3175,406,8958,111
2219,108,4324,3616,3382,47610,942
38916,87,1087,1718,854,10295,233
33573,50,1049,2030,851,18803,198
45469,2,22,550,18,1253,4
39753,8,224,1668,171,4087,53
11113,358,28073,3199,21300,167589,6773
24185,10,748,2490,565,7802,183
43614,1,67,1006,52,6905,15
43675,15,176,986,121,4081,55
35011,21,381,1968,293,10077,88
12404,44,1931,3132,1506,22421,425
40611,11,227,1601,184,2324,43
30394,0,21,2178,15,3717,6
40962,19,286,1570,211,4525,75
25834,0,39,2416,35,1777,4
40578,168,3847,1604,2852,23429,995
6129,2,193,3486,148,6548,45
44882,17,120,738,99,2271,21
29227,10,421,2238,348,4944,73
37199,2,66,1832,54,2968,12
6985,20,271,3447,194,5175,77
23371,183,18115,2528,13474,81700,4641
18143,2,61,2795,55,3418,6
46028,243,7362,327,5165,35476,2197
32370,13,344,2079,268,8479,76
33729,2,147,2025,119,5835,28
30877,58,4082,2154,3386,25601,696
9801,26,421,3267,328,9138,93
34067,4,264,2013,228,5749,36
3787,102,5082,3588,3878,45766,1204
41550,389,11130,1491,7889,83894,3241
40675,1,94,1596,80,3275,14
37800,1,42,1793,35,3463,7
21108,188,5416,2647,4282,38212,1134
40629,13,318,1600,247,15086,71
17437,188,10588,2826,7687,54005,2901
34905,3504,124572,1974,82002,391783,42570
9715,6,803,3272,669,12877,134
34554,6,158,1994,130,2589,28
10965,10,215,3207,165,3020,50
20525,130,3494,2681,2673,14804,821
32746,10,357,2063,272,5840,85
8857,0,73204,3322,25092,2111,48112
39713,9,173,1670,128,4062,45
2379,16,767,3613,629,9981,138
44655,255,3039,810,2595,18381,444
20811,11,528,2665,419,6682,109
17073,37,2304,2846,1893,7211,411
37105,31,493,1839,365,4187,128
43445,6,72,1065,50,2384,22
2838,41,1358,3606,1067,20537,291
16090,3,523,2897,401,6465,122
30375,4,257,2179,191,6692,66
24633,4,156,2468,134,1962,22
9123,57,2638,3307,1827,12578,811
18013,72,4974,2801,3314,45100,1660
42678,27,410,1277,266,4608,144
11897,25,592,3160,453,3756,139
3500,749,31083,3594,23319,98696,7764
3471,264,19495,3594,14850,136160,4645
44849,6,67,745,54,2136,13
7146,5,146,3438,122,3173,24
41807,139,3262,1446,2224,36859,1038
16520,102,4291,2877,3266,22559,1025
35343,201,5269,1951,3495,38653,1774
21627,15,0,2616,0,42196,0
27196,4,324,2354,274,2523,50
4150,15,501,3576,403,10546,98
5174,21,1304,3532,1060,12400,244
2669,5,127,3609,93,4911,34
41695,65,2274,1468,1722,23374,552
5707,2,56,3504,41,1649,15
31018,123,3816,2148,2929,18190,887
17631,45,4295,2817,3237,30416,1058
45986,15,221,347,140,5003,81
46071,0,14,305,14,1077,0
21386,83,7060,2630,5017,38900,2043
3152,54,2307,3600,1766,15065,541
35408,32,857,1948,699,13951,158
37798,107,12183,1794,9010,52461,3173
35185,8,633,1959,496,8088,137
24989,162,5626,2453,4012,59121,1614
21546,720,67030,2621,44416,266396,22614
17531,159,7475,2822,5584,40659,1891
41801,68,1309,1447,1087,18965,222
23444,8,382,2524,281,4270,101
39921,2,134,1656,103,3319,31
19631,30,886,2730,665,10726,221
38768,6,227,1726,187,4314,40
23941,6,414,2500,314,7263,100
31982,7,397,2098,319,9312,78
32192,2,164,2087,133,9892,31
5943,29,733,3492,583,21686,150
30683,1,221,2162,162,3807,59
27626,21,588,2327,518,7941,70
12525,1,38,3126,27,1416,11
35267,0,626,1954,503,18133,123
20828,28,1115,2664,862,14767,253
15541,13,692,2923,545,6214,147
22965,847,31543,2547,24101,115265,7442
20958,4,601,2656,499,8626,102
12449,1,184,3129,145,3806,39
4948,3,40,3544,33,2985,7
29795,75,4847,2210,3587,43819,1260
42963,19,630,1208,440,17947,190
7950,13,138,3384,113,7616,25
5027,64,1363,3540,1031,28804,332
37598,5,201,1807,145,4604,56
12767,28,1656,3112,1219,13247,437
29428,28,905,2227,703,9630,202
8843,43,1430,3322,1016,16188,414
36548,25,813,1873,590,8764,223
16202,154,13662,2893,9720,60928,3942
44491,97,1258,841,1134,21589,124
38313,325,6174,1758,5095,26925,1079
34254,34,695,2007,540,7292,155
41700,112,2392,1466,1801,17434,591
16729,2,314,2866,253,10929,61
41994,7,283,1415,224,9877,59
5613,9,436,3510,337,8963,99
31956,6,191,2100,145,3256,46
14865,10,412,2957,339,8459,73
14584,51,2212,2975,1866,13721,346
45999,2,34,342,30,1770,4
24002,0,216,2497,170,3282,46
8483,3,121,3345,77,2354,44
23577,1,130,2518,115,3368,15
21746,45,4459,2610,3309,23363,1150
24740,3,109,2463,75,3524,34
12614,1,87,3121,77,9636,10
14252,0,31,3000,24,2769,7
21847,58,1943,2606,1531,19266,412
34563,1,67,1993,54,2843,13
18523,1,148,2779,138,2977,10
12667,10,505,3118,386,14329,119
31158,0,0,2141,0,1227,0
5354,31,389,3522,314,4838,75
46199,314,15910,257,12190,45667,3720
32363,169,7290,2079,5527,39536,1763
22612,79,2801,2565,2019,23066,782
43841,4,59,940,50,3319,9
25864,5,265,2415,210,2969,55
30084,79,1914,2196,1430,21632,484
4732,5,214,3555,185,5487,29
36249,51,1750,1888,1331,10923,419
19012,138,8370,2759,6061,25372,2309
9414,5,185,3288,158,4396,27
14957,64,20005,2951,7970,16525,12035
31664,25,807,2114,576,13594,231
31544,8,569,2120,446,7401,123
1125,1,34,3891,30,2749,4
22413,23,900,2575,682,9544,218
4847,37,2114,3550,1538,14451,576
11510,55,1202,3178,926,12119,276
12076,1,61,3152,45,2346,16
26886,1,101,2367,82,2643,19
33890,3,96,2019,81,1841,15
13505,25,1117,3055,870,13607,247
41680,12,361,1470,291,6535,70
40418,9,208,1620,169,5385,39
14899,30,1355,2955,1052,16702,303
44209,6,87,879,74,3316,13
21912,18,446,2601,359,5840,87
35870,2,99,1913,84,3069,15
28511,21,497,2276,369,5445,128
34110,96,1280,2012,1021,10937,259
27150,67,2218,2356,1767,14514,451
41167,71,2788,1547,1966,33966,822
21767,42,2710,2609,1870,15825,840
7118,2,177,3440,136,4839,41
4731,2,45,3555,37,8614,8
9381,4,79,3289,59,3188,20
1673,7,204,3661,169,7099,35
5110,12,544,3535,439,14571,105
35537,24,1613,1938,1137,13063,476
25252,1,46,2442,37,2216,9
15557,20,362,2922,287,6575,75
40642,39,2013,1599,1635,17615,378
38661,212,8470,1733,5529,34296,2941
19962,34,1940,2711,1510,30123,430
36223,8,236,1889,179,5776,57
25115,17,604,2447,462,13312,142
22821,111,5473,2555,3849,50132,1624
18541,17,601,2778,463,13077,138
37413,480,20219,1820,12517,95650,7702
4531,0,2,3563,1,818,1
23678,177,5823,2512,4353,68179,1470
10897,4,57,3211,52,3553,5
39686,23,525,1671,430,10749,95
1831,10,138,3624,118,4667,20
45909,165,1665,383,1357,19751,308
40066,0,1276,1646,913,22277,363
37692,64,466,1802,352,4791,114
38228,7,687,1764,489,14759,198
32069,3,168,2093,110,9123,58
9271,33,1028,3298,685,9872,343
34404,5,235,2001,199,5535,36
7110,491,22609,3440,15948,147833,6661
6030,3,47,3489,43,1541,4
25658,32,804,2423,638,6344,166
39716,25,1353,1669,1109,26098,244
6611,625,30543,3465,19599,124774,10944
23244,0,2646,2534,1916,37808,730
17819,3,124,2811,92,2941,32
21582,28,1978,2619,1521,15650,457
19164,41,1659,2752,1300,28094,359
32075,5,150,2093,109,3708,41
41424,75,2013,1507,1357,30798,656
33370,7,334,2038,274,3033,60
38231,12,245,1764,183,6739,62
27631,23,953,2327,762,8209,191
19098,7,392,2755,306,9644,86
29905,51,1265,2204,984,14161,281
1844,505,30061,3624,20404,81306,9657
21350,7,566,2632,461,13802,105
38341,4,242,1755,175,10206,67
46026,23,365,328,302,4850,63
15395,66,3785,2929,2724,23140,1061
43183,37,570,1144,464,10444,106
18413,128,8442,2783,5798,47136,2644
38713,13,458,1730,363,5774,95
11483,384,27780,3180,17789,141585,9991
33885,0,152,2019,121,4385,31
2994,27,1186,3603,980,18069,206
28278,23,417,2290,347,10201,70
17266,4,148,2835,124,2432,24
26788,176,6105,2372,4300,49666,1805
7400,31,1237,3424,967,16296,270
7921,0,36,3387,28,1727,8
11070,5,102,3202,78,2939,24
11217,11,663,3194,534,10134,129
27257,2,66,2350,56,2965,10
32104,1,105,2091,69,3937,36
45875,11,171,397,134,1723,37
42887,8,113,1227,74,3130,39
12832,31,1477,3108,1218,30202,259
23408,1,89,2526,76,6736,13
20205,88,23439,2697,15933,58901,7506
17154,18,551,2841,446,5354,105
27632,9,190,2327,159,4902,31
39342,3,183,1690,139,4748,44
45774,9,93,427,80,2597,13
4991,137,6571,3542,4769,41064,1802
16178,25,1727,2894,1180,34528,547
29422,98,1609,2228,1214,11496,395
39545,4,142,1679,113,7725,29
31248,5,147,2137,123,4871,24
46125,8,125,288,86,2330,39
45110,8,127,654,85,4007,42
30219,13,692,2189,563,13350,129
21911,7,429,2601,341,4816,88
16282,2140,93721,2888,66069,181041,27652
27260,298,6001,2349,4419,29973,1582
5660,30,1793,3507,1410,22153,383
33069,2,148,2049,119,3298,29
33005,28,524,2052,447,9727,77
14305,7,394,2996,271,14232,123
39446,0,25,1685,23,2472,2
30501,26,898,2172,712,19595,186
3300,10,436,3597,365,9514,71
37705,3,98,1801,80,7779,18
36259,2,60,1887,48,3614,12
2002,6,602,3619,481,21939,121
35902,8,486,1910,404,9399,82
4766,46,1343,3553,1090,9878,253
41587,39,1023,1485,759,12731,264
43284,26,1261,1113,992,20979,269
39592,15,424,1676,336,5250,88
35607,3,95,1933,77,2776,18
36240,38,829,1889,665,10298,164
37000,1,85,1845,73,3397,12
11314,42,884,3190,707,4246,177
41306,11,325,1525,225,5495,100
6747,0,63,3460,50,2763,13
38555,5,148,1740,105,4543,43
37387,154,2861,1821,1971,21312,890
32884,15,411,2057,308,6504,103
35070,59,1435,1965,1133,9542,302
1815,5782,299788,3625,180056,660978,119732
27187,6,172,2354,132,2817,40
20635,4,391,2676,325,5508,66
46035,16,78,321,56,7453,22
45823,3,153,413,108,1759,45
39029,33,710,1711,564,10123,146
6595,3,144,3466,121,7734,23
28790,0,14,2260,12,1939,2
6018,6,248,3489,98,2611,150
23186,6,568,2537,468,15381,100
14362,63,3699,2991,3111,45368,588
36263,19,431,1887,354,6944,77
45479,62,950,547,817,11409,133
36494,16,220,1875,186,5637,34
3687,31,3451,3590,2761,81273,690
24868,26,595,2459,464,5414,131
2568,1,50,3610,20,3822,30
42309,22,495,1353,391,6114,104
25859,23,505,2415,377,4555,128
4133,3,50,3577,42,3402,8
21876,6,619,2603,510,9713,109
45152,36,329,638,226,4614,103
12413,3,68,3132,59,2518,9
5119,66,4405,3535,3484,40111,921
34702,42,1071,1985,771,7422,300
21609,6,730,2617,536,12467,194
16214,22,1969,2892,1532,11904,437
8379,9,503,3351,402,19749,101
39705,24,806,1670,622,8839,184
39278,37,963,1694,741,12796,222
45820,16,122,414,92,3041,30
14439,12,1220,2986,828,15947,392
35804,10,193,1917,146,3807,47
26665,54,2793,2378,2193,24147,600
32861,10,648,2058,477,11568,171
27170,1,46,2355,38,2255,8
28124,30,6713,2299,5563,23089,1150
2226,11,267,3616,234,8837,33
9004,27,1087,3314,850,18447,237
31607,5,99,2117,83,1570,16
36963,319,9571,1847,6771,85826,2800
41481,43,1285,1500,991,32143,294
17943,294,26411,2805,18881,98949,7530
23741,12,535,2510,381,5505,154
15233,6,225,2936,165,7788,60
16389,23,807,2882,604,9714,203
4075,13,349,3579,278,5774,71
6499,33,1000,3470,779,24149,221
8222,14,402,3362,294,16054,108
9113,32,1640,3307,1265,14492,375
15255,23,516,2935,395,4808,121
18712,222,13343,2770,10475,79686,2868
7496,2,119,3419,90,4243,29
44069,342,3497,906,2716,18458,781
40450,15,613,1616,437,18535,176
9508,12,134,3282,107,3091,27
9165,74,2310,3303,1763,14687,547
32266,416,8683,2083,6307,44350,2376
23747,34,1294,2510,1023,16161,271
2127,24,617,3617,445,8012,172
9769,2486,131524,3269,86264,676525,45260
24960,0,2168,2454,1564,3629,604
36653,2,79,1866,72,3358,7
13567,18,845,3050,655,15230,190
8024,50,1767,3378,1389,20317,378
42661,6,74,1281,67,2826,7
24217,0,87,2488,60,3613,27
28924,104,10056,2254,6842,30243,3214
2039,38,833,3619,646,10134,187
32061,4,251,2094,189,7231,62
18529,158,11746,2779,8982,77348,2764
10954,96,2394,3208,1828,45979,566
12962,3,112,3101,63,2347,49
13446,62,2773,3059,2050,14301,723
38895,2,153,1719,128,5300,25
21778,12,466,2608,365,8229,101
28819,16,569,2258,438,8262,131
16812,28,1080,2860,810,11114,270
33383,27,734,2038,596,12338,138
2365,300,19254,3614,14723,134001,4531
974,7,619,3941,501,9162,118
17308,3,61,2833,40,4437,21
31107,8,161,2144,122,5231,39
34958,31,807,1971,653,22590,154
27671,52,2373,2325,1873,7669,500
28387,8,290,2284,216,13732,74
19579,29,2090,2732,1610,20934,480
29140,10,301,2243,247,6320,54
22318,30,2803,2580,2096,26599,707
23659,1,66,2513,56,3627,10
2154,21,699,3617,581,12715,118
21607,21,897,2617,643,9422,254
12240,5,112,3142,87,3034,25
21735,4,584,2611,447,12787,137
34720,8,153,1985,117,2827,36
14124,0,129,3008,102,3312,27
27707,14,235,2322,184,8089,51
21680,116,7142,2613,4846,48264,2296
20686,1,164,2673,126,4200,38
42518,10,394,1309,287,12068,107
6023,3,14,3489,13,2785,1
34921,0,130,1973,111,4760,19
10060,2,55,3254,47,2389,8
23590,246,18849,2517,13201,99409,5648
17322,23,534,2833,433,4138,101
42958,5,129,1209,97,4607,32
35710,4,57,1924,49,2719,8
7128,56,1204,3439,946,15531,258
25750,1,140,2419,104,2756,36
39150,0,36,1702,25,1790,11
41320,6,122,1523,90,3344,32
37725,6,135,1799,106,2384,29
38960,13,335,1714,239,6742,96
41042,194,4520,1563,3402,27751,1118
12953,1,26,3102,18,1644,8
33358,7,399,2039,312,6131,87
46446,28,556,150,416,2997,140
33024,3,228,2051,176,6314,52
16034,8,363,2900,293,6684,70
25667,1,88,2422,74,3766,14
21989,890,29985,2596,20433,163778,9552
25971,107,7322,2409,5592,43691,1730
45128,13,123,644,76,4197,47
15512,6,80,2924,63,4000,17
15477,13,765,2926,608,16505,157
29007,246,3889,2250,3131,16145,758
43499,5,127,1048,104,3872,23
38387,6,137,1753,112,5265,25
36174,9,344,1891,278,5123,66
27462,14,622,2337,431,7915,191
19320,10,871,2744,669,11707,202
15534,2,177,2923,143,6198,34
8214,45,2035,3363,1655,17506,380
23451,1,31,2524,25,2220,6
41611,32,1414,1481,1082,12002,332
21628,175,8181,2616,5734,38473,2447
45466,1,21,550,15,1070,6
6764,31,2630,3459,2004,23916,626
30206,16,318,2189,275,4752,43
27549,0,82,2331,69,2035,13
14104,11,466,3009,377,7576,89
25641,2,90,2424,77,3025,13
45591,87,650,512,576,7432,74
9129,31,422,3306,330,4544,92
31177,4,145,2140,107,4121,38
36252,28,857,1888,650,7330,207
31560,15,1980,2119,1615,19244,365
4379,12,208,3568,161,6038,47
13774,6,370,3035,300,8553,70
9643,33,1187,3274,762,8627,425
46314,0,28,216,16,1100,12
37483,12,599,1815,475,19894,124
4854,23,443,3549,351,3431,92
42953,1,179,1210,121,6436,58
32828,0,0,2059,0,6087,0
42250,5,94,1364,70,3610,24
42030,2,122,1410,91,5162,31
39221,19,654,1698,544,17192,110
11233,1,133,3193,100,7077,33
36417,8,475,1879,390,6558,85
17534,14,1062,2822,765,13843,297
5814,54,5624,3499,3750,39750,1874
30405,32,1343,2178,1018,14642,325
18792,16,806,2767,647,10395,159
3894,5,128,3585,99,9184,29
34791,27,482,1980,361,3705,121
35284,2,112,1953,87,4055,25
15562,959,43317,2921,31556,197504,11761
42974,9,573,1205,321,7360,252
23786,32,903,2509,629,5884,274
3001,5,110,3603,88,8027,22
32215,2,156,2086,132,5467,24
4257,29,177419,3573,65115,3605,112304
27749,7,356,2320,279,11229,77
24899,12,1001,2457,748,17309,253
4247,3,57,3573,48,3600,9
25471,0,76,2433,62,1817,14
13712,0,73,3040,60,2868,13
26110,6,325,2403,257,3458,68
34470,1,39,1998,29,3115,10
44933,28,275,724,248,6478,27
36596,16,467,1870,381,14525,86
34200,13,678,2009,564,11069,114
1837,10,386,3624,277,14297,109
39677,6,162,1671,139,3581,23
3523,51,974,3593,722,22521,252
26225,448,25373,2398,17175,146925,8198
19407,64,2694,2740,2100,22481,594
9042,2,97,3312,76,2818,21
45863,8,130,401,107,5529,23
10289,102,4782,3244,3356,27796,1426
14287,17,649,2997,427,12547,222
4400,41,1973,3567,1535,25176,438
23025,19,1139,2545,866,4132,273
34536,71,1591,1995,1283,9350,308
24246,34,1831,2487,1386,21322,445
43270,118,2567,1117,2080,34216,487
34232,556,31032,2009,19783,182509,11249
45966,32,257,354,224,4862,33
32669,0,22,2066,18,4992,4
21207,34,1780,2639,1316,11274,464
38972,41,1052,1714,767,6899,285
46128,1,35,287,30,985,5
43372,21,434,1085,340,7755,94
40460,0,0,1615,0,4004,0
33186,4,129,2045,104,3398,25
6003,9,209,3490,169,8721,40
3349,5,129,3597,111,3788,18
1809,67,2275,3626,1794,18805,481
12990,14,686,3098,555,9450,131
40191,6,170,1639,125,1984,45
7711,11,622,3406,409,5812,213
7579,6,181,3413,157,5450,24
34542,1,52,1994,45,2145,7
8227,137,4062,3362,3064,23301,998
43592,4,29,1015,22,5955,7
42266,22,891,1360,756,13417,135
35724,20,668,1923,559,8556,109
10083,52,3250,3253,2316,31184,934
21761,7,352,2609,279,6980,73
17163,14,740,2841,550,10797,190
20731,22,1809,2671,1328,13223,481
27033,43,2580,2363,1846,28385,734
17622,4,207,2818,155,5254,52
7011,42,1095,3446,903,13326,192
23407,30,3400,2526,2533,18713,867
40706,8,298,1594,222,8991,76
27158,2,68,2356,59,2407,9
5152,319,13223,3533,8346,77212,4877
4684,1,37,3557,31,3601,6
40721,23,423,1593,349,13899,74
34667,11,585,1987,472,12611,113
3486,0,14,3594,12,1862,2
46041,1,51,318,32,5459,19
14660,476,25155,2970,17973,90297,7182
6660,41,1299,3464,1014,13506,285
43290,20,307,1112,249,12061,58
19288,68,4106,2746,3174,33632,932
16426,86,6130,2881,4117,33626,2013
33851,466,23649,2020,15777,186757,7872
26066,2,97,2405,83,3313,14
33991,36,756,2015,595,6805,161
39082,0,83,1707,69,2696,14
7828,19,233,3397,196,9280,37
28007,19,509,2305,437,6189,72
2875,110,2982,3605,2162,22830,820
25329,12,511,2438,414,12813,97
16973,34,6227,2853,4613,20093,1614
2130,12,389,3617,321,8501,68
4581,288,9788,3560,7796,84912,1992
36011,10,390,1902,293,9129,97
11680,14,719,3170,560,7151,159
19025,6,300,2758,235,4816,65
22122,28,1723,2588,1292,14953,431
6986,9,198,3447,143,4885,55
33368,19,425,2038,338,5128,87
32996,24,837,2053,714,10047,123
4536,76,1932,3562,1495,42507,437
26595,21,511,2381,431,6175,80
40397,12,195,1621,158,2530,37
34721,62,725,1985,544,7071,181
32560,12,218,2070,184,3819,34
31994,556,25352,2098,18233,154181,7119
13563,21,1331,3050,998,9036,333
20589,3,371,2678,317,6559,54
5716,18,558,3504,492,7555,66
45448,4,17,553,11,2072,6
25464,0,17,2433,14,1198,3
6052,5,64,3488,52,1856,12
36680,1,37,1865,31,2258,6
23266,34,966,2533,831,6600,135
9589,1,73,3277,63,2873,10
28879,21,1034,2256,836,10202,198
37285,88,1602,1827,1298,17697,304
32265,115,2831,2083,2186,17408,645
29038,141,3974,2248,3203,30800,771
17055,1,178,2847,140,32934,38
40221,0,76,1637,49,4487,27
27057,1,42,2362,37,1949,5
42272,7,228,1359,195,11171,33
12444,11,1016,3130,841,24650,175
25363,9,492,2437,410,9608,82
35618,10,206,1932,179,15040,27
43695,1199,24158,977,18188,130857,5970
14677,5,213,2969,153,2539,60
44761,4,43,775,31,2353,12
6655,5,53,3464,42,2618,11
12878,37,2498,3106,1836,14386,662
2982,8,305,3603,239,6831,66
32031,10,563,2096,453,7742,110
2171,19,735,3617,545,9618,190
14503,13,682,2981,535,14345,147
25734,2189,87060,2420,60120,473788,26940
9756,15,433,3270,333,3528,100
6329,63,1540,3477,1208,25612,332
18018,12,410,2800,284,9208,126
20473,10,297,2684,228,10743,69
41579,7,188,1487,148,7832,40
15505,5,362,2924,268,9566,94
4124,1,26,3577,20,1694,6
37828,14,432,1791,342,6649,90
16074,0,87,2898,49,2529,38
9944,6,124,3261,108,3119,16
5306,2,32,3525,27,2187,5
39637,71,2478,1674,2017,28565,461
43498,22,579,1049,401,13855,178
33803,0,23,2021,21,1899,2
11840,2,85,3163,68,5347,17
37909,224,3837,1785,3031,25256,806
12906,10,647,3105,494,11108,153
16660,5,369,2870,308,6359,61
45690,54,837,466,625,12626,212
39064,15,441,1708,351,5497,90
12067,44,1165,3152,867,14379,298
40296,152,5806,1632,4523,43576,1283
30760,53,1871,2159,1404,23975,467
18507,399,17337,2779,12254,62222,5083
39825,10,288,1664,221,8415,67
38323,5,215,1757,172,4812,43
15519,59,3374,2923,2342,15487,1032
29153,42,2260,2242,1678,23703,582
37461,3,129,1817,105,6401,24
27298,18,910,2347,704,19021,206
14926,7,275,2953,212,5402,63
7777,86,2392,3400,1680,31429,712
43458,8,147,1062,127,6109,20
23680,32,957,2512,805,9169,152
45046,32,325,687,218,5879,107
23420,19,634,2525,497,6389,137
25609,0,881,2425,661,10988,220
19594,87,6180,2731,4653,16047,1527
36725,3,91,1863,73,3929,18
16733,7,671,2866,447,9655,224
6867,86,4030,3454,2607,16108,1423
13626,38,4923,3047,3508,38317,1415
4031,7,402,3580,302,5011,100
4318,82,3009,3570,2277,17177,732
36924,69,2148,1850,1483,30256,665
4293,9,176,3571,131,5782,45
5113,8,245,3535,184,5945,61
13851,3,120,3029,95,3316,25
27957,420,10056,2308,7459,46922,2597
10377,0,81,3240,49,1938,32
30713,13,510,2161,410,3130,100
26099,12,1483,2404,1157,5778,326
20308,2,41,2692,31,4241,10
44677,296,4055,804,3108,20449,947
2761,7,119,3607,98,2683,21
37835,33,357,1790,273,3319,84
45311,72,1253,589,898,14296,355
33009,10,319,2052,269,4792,50
32598,4,147,2069,116,6517,31
13994,58,1992,3016,1426,12879,566
8707,53,968,3330,775,12280,193
40372,19,465,1623,338,8070,127
33249,78,3009,2043,2244,25789,765
41506,3,73,1496,62,8471,11
36546,368,24667,1873,17610,143692,7057
40203,13,421,1638,324,4840,97
19848,43,2255,2717,1745,52572,510
36761,0,31,1860,26,3723,5
42615,11,360,1291,276,10087,84
19112,3,54,2755,39,2876,15
20984,40,661,2654,481,7249,180
5026,6,54,3540,39,3744,15
8902,17,622,3320,489,8314,133
9977,7,336,3259,254,2898,82
46370,6,51,196,37,1717,14
5131,26,1295,3534,976,8824,319
35380,4,125,1949,108,3877,17
35941,329,6493,1908,4924,30147,1569
29763,9,253,2211,205,8233,48
34312,22,251,2005,195,2764,56
6228,19,587,3482,403,10555,184
10889,9,433,3211,367,11680,66
20124,1,84,2702,69,2796,15
30473,13,520,2174,439,9612,81
41685,80,2021,1469,1618,29218,403
6696,570,26484,3462,18940,138605,7544
39886,96,2039,1659,1515,13343,524
29980,6,192,2201,164,3195,28
6713,22,713,3461,594,5105,119
940,7,647,3950,453,6535,194
15888,15,560,2907,393,8121,167
11402,183,3409,3185,2683,87109,726
30492,29,1070,2173,821,9204,249
4843,98,3015,3550,2224,46325,791
30850,4,144,2155,117,2646,27
27291,26,225,2348,185,3578,40
16668,285,12993,2869,9296,68246,3697
31026,46,1950,2147,1524,21531,426
13781,14,657,3035,477,6581,180
6505,92,3264,3470,2468,31634,796
9349,124,6324,3292,4736,75221,1588
30086,19,1073,2196,800,10207,273
14726,15,820,2966,664,23630,156
38888,16,334,1719,247,3377,87
41036,7,250,1565,196,5812,54
31370,114,2644,2131,2145,24232,499
15463,1,59,2927,48,7758,11
34225,5,471,2009,373,5184,98
6984,2,28,3447,26,3456,2
31215,42,804,2139,620,6942,184
16678,8,282,2869,241,4373,41
43088,16,265,1169,201,4016,64
45212,6,45,620,42,2153,3
17784,1734,170777,2813,109045,525356,61732
18703,22,696,2771,513,9015,183
10445,7,394,3237,288,18358,106
35476,45,1261,1943,1024,22645,237
25175,6,194,2445,162,5837,32
21681,13,362,2613,305,2109,57
25884,2,163,2414,125,2618,38
5413,14,212,3519,182,12077,30
39219,14,523,1698,384,15712,139
21997,100,3001,2595,2275,20094,726
26067,411,38964,2405,28042,154082,10922
3157,17,210396,3600,75721,6961,134675
4858,8,101,3549,78,3584,23
8520,128,7377,3342,5474,44689,1903
37868,123,1092,1788,775,8645,317
38693,7,110,1731,90,2100,20
24799,23,1816,2462,1428,13298,388
18291,26,1781,2789,1283,26718,498
15546,6,589,2922,450,11134,139
34256,15,1300,2007,990,14215,310
23502,1,81,2522,49,2937,32
44178,48,550,886,462,11308,88
25203,0,2154,2443,1615,11256,539
2696,8,1675,3608,1257,16577,418
38019,188,3932,1779,2972,25755,960
23578,62,8585,2518,6264,68754,2321
23469,2,0,2523,0,2633,0
2012,23,798,3619,514,9712,284
32995,4,135,2053,105,4307,30
25120,2,26,2447,23,1509,3
17181,583,26864,2840,18879,110573,7985
1840,1786,108860,3624,66933,320667,41927
8821,5,263,3324,176,6668,87
26878,2,321,2368,263,4295,58
8738,10,636,3329,524,7914,112
39911,5,137,1657,114,3604,23
30923,2,142,2152,119,7459,23
17187,0,75,2840,70,2315,5
32943,5,645,2055,445,13532,200
24197,241,16743,2489,11074,135600,5669
26747,11,897,2374,695,17810,202
24163,1,107,2491,89,5130,18
33625,1,19,2029,12,2045,7
29180,0,25,2241,22,2131,3
24828,4,109,2461,95,5952,14
15945,0,80,2905,71,2659,9
6490,17,557,3471,455,11115,102
37634,60,724,1805,563,10228,161
25797,8,538,2417,447,4096,91
5532,9,166,3514,122,6096,44
6231,10,340,3482,269,35539,71
46284,0,18,233,11,1488,7
21588,0,54,2619,44,2324,10
32625,3,132,2068,102,2902,30
9578,1,25,3278,19,993,6
33259,1,155,2042,122,7725,33
41714,1,90,1465,80,2853,10
5338,184,17262,3523,12313,85223,4949
34392,7,170,2001,149,4710,21
18492,6,294,2780,189,10453,105
33237,8,260,2043,201,5582,59
23772,7,324,2509,281,3429,43
28920,68,1507,2254,1175,12953,332
5501,16,969,3515,772,12951,197
20385,3,147,2689,131,2954,16
8206,7,240,3363,186,12117,54
23475,9,1066,2523,891,12752,175
31853,14,247,2104,195,3637,52
19387,726,77972,2741,50752,180973,27220
45257,6,65,607,51,1775,14
10495,3,228,3234,183,2838,45
34764,139,1608,1982,1147,12228,461
44042,64,1175,909,1031,29730,144
34473,10,342,1998,269,6895,73
14378,27,2787,2989,2078,28823,709
39671,23,203,1672,144,3290,59
11141,22,700,3198,578,14059,122
21608,706,98930,2617,64699,209347,34231
37412,10,213,1820,184,3171,29
10839,11,1336,3214,1005,14064,331
39572,4,73,1678,59,4867,14
38902,95,1507,1718,1180,13309,327
37368,2461,340474,1822,164789,889046,175685
43135,5,257,1156,182,10275,75
13256,3,503,3075,402,5746,101
36227,4,159,1889,127,2553,32
23716,68,3862,2511,2919,30744,943
37108,19,281,1839,236,4818,45
30439,36,1432,2176,1057,16026,375
15326,20,686,2931,570,14426,116
36115,6,469,1894,370,5088,99
16005,1670,95878,2902,66132,233228,29746
34206,89,3756,2009,2745,36749,1011
5400,32,572,3519,386,6799,186
7431,68,2336,3422,1682,22093,654
5689,25,579,3505,428,9235,151
6808,10,43,3456,34,4952,9
20132,1,283,2702,216,6360,67
10540,46,1578,3232,1227,13909,351
7940,12,364,3385,269,9678,95
42894,145,10072,1225,7403,36353,2669
39227,22,500,1697,392,9104,108
41553,117,2222,1491,1686,26771,536
32662,170,7709,2067,5287,43998,2422
4813,22,434,3551,360,5761,74
20305,13,329,2692,230,6840,99
13319,8,153,3070,104,3635,49
42631,18,330,1289,212,8113,118
14230,10,486,3002,373,7716,113
28120,6,774,2299,561,7659,213
1661,8,253,3665,196,8967,57
31288,1164,50101,2134,31280,153157,18821
27689,27,629,2324,478,10059,151
15563,39,2735,2921,1977,8022,758
35079,0,239,1965,188,16752,51
30281,30,552,2185,451,2839,101
31748,424,12353,2109,8760,68401,3593
12427,1,102,3131,64,2609,38
30098,2,264,2195,169,5419,95
44712,7,95,789,86,2702,9
29937,9,600,2202,453,17950,147
26233,24,891,2398,659,6326,232
40598,2,72,1603,51,2939,21
23722,1,69,2511,64,2452,5
15907,27,843,2907,629,8358,214
31803,7,169,2107,153,2952,16
22520,141,3648,2569,2562,24332,1086
16193,5,73,2893,55,2491,18
12673,26,1429,3118,1135,18857,294
45554,118,2589,520,1902,22186,687
36773,83,4856,1859,3852,26984,1004
39143,41,1703,1703,1235,22182,468
46112,10,116,294,87,1065,29
19099,62,4645,2755,3410,42637,1235
18888,2,125,2763,81,1463,44
30182,14,691,2191,584,4752,107
18405,248,11587,2784,8552,68294,3035
41852,57,2162,1438,1617,23337,545
8969,5,175,3315,130,3193,45
14978,0,104,2950,80,5281,24
40637,12,524,1600,364,4675,160
26495,4,190,2385,168,4667,22
35155,50,725,1960,538,5111,187
44233,16,214,877,157,5268,57
22631,12,707,2565,497,8456,210
31707,5,280,2111,228,6659,52
38747,19,2503,1728,1633,16110,870
4108,92,4496,3578,3536,20798,960
10955,287,12326,3208,9489,183171,2837
2578,128,9863,3610,6398,36767,3465
43382,3,40,1082,32,2064,8
40362,4,539,1624,399,8395,140
44629,1899,89342,816,66495,253582,22847
16487,4,73,2878,58,7016,15
19284,0,573,2746,461,5308,112
22515,0,77,2569,62,3420,15
36969,8,784,1847,668,11494,116
2488,2,39,3611,29,3713,10
22535,21,2009,2568,1420,33457,589
16317,22,1149,2887,855,10883,294
39372,21,776,1689,588,7459,188
42898,10,304,1225,221,6964,83
37049,0,141,1842,113,5161,28
17553,264,31731,2821,22632,120632,9099
8776,5,136,3327,112,3488,24
43470,52,1023,1059,846,22541,177
5914,6,214,3494,176,5603,38
20436,23,932,2686,701,9238,231
17691,20,6563,2816,4838,31974,1725
40473,138,4328,1614,3239,22189,1089
43260,7,190,1120,132,2773,58
12508,59,3471,3126,2398,29657,1073
31586,2,77,2118,62,6691,15
29199,122,4703,2240,3541,36198,1162
23384,130,5095,2527,3748,33091,1347
36095,23,861,1896,665,7803,196
25384,0,24,2436,18,2173,6
25725,34,1128,2420,915,7688,213
26627,4,90,2380,81,2316,9
43879,3854,89086,938,60242,323708,28844
26910,4,147,2366,118,2109,29
41361,10,275,1517,199,5192,76
30602,3,95,2167,69,3080,26
16170,17,1361,2894,1005,33282,356
41886,3,172,1432,142,3513,30
4894,19,365,3547,297,6529,68
43127,12,231,1159,183,6810,48
35253,5,137,1955,114,4259,23
18219,26,1803,2792,1318,15842,485
4959,3,95,3544,74,2409,21
10647,39,1896,3225,1421,39652,475
12716,3,236,3116,198,12766,38
21965,11,759,2597,625,11138,134
21147,14,1037,2644,830,31863,207
25286,3,165,2441,132,4331,33
45118,0,36,648,24,1396,12
25501,0,317,2431,281,8626,36
42208,201,3812,1373,2617,58812,1195
43128,2,113,1159,74,2868,39
41009,15,357,1567,281,4979,76
37314,0,83,1825,60,4595,23
41957,19,251,1420,177,8887,74
28272,7,269,2290,204,3921,65
27440,18,1370,2339,1054,22366,316
9146,12,478,3305,355,5241,123
36562,20,466,1872,373,15814,93
40341,16,341,1627,263,7979,78
32757,2,120,2063,86,2862,34
27820,2,74,2316,61,2549,13
15153,9,235,2940,178,5194,57
19543,3,224,2734,186,8888,38
37571,0,119,1809,101,4326,18
37037,6,193,1843,163,14076,30
22004,43,1804,2595,1469,19509,335
19279,4,136,2746,106,5081,30
45343,208,3665,582,3082,26583,583
2438,25,835,3612,556,9397,279
31471,10,252,2124,214,7433,38
4506,8,198,3563,165,4936,33
11197,2,115,3195,94,3205,21
42564,8,175,1302,137,6570,38
45019,21,175,698,99,2069,76
39927,40,1719,1656,1306,17542,413
16523,10,614,2876,467,6656,147
13265,16,461,3075,357,10191,104
30633,1,29,2165,26,1970,3
22372,145,4201,2577,3349,37983,852
11889,6,103,3160,94,1766,9
30619,14,411,2166,342,8203,69
30776,23,466,2158,355,4364,111
37165,50,2141,1835,1594,28303,547
23809,10,430,2508,342,4055,88
13995,49,3079,3016,2010,28729,1069
26765,17,825,2373,654,7289,171
10075,8,105,3253,85,4451,20
28767,65,2334,2261,1828,10597,506
32395,7,275,2078,191,5212,84
42459,38,710,1322,551,16305,159
14272,11,261,2999,198,4939,63
45781,9,67,426,61,2067,6
1643,4,104,3670,86,3815,18
33276,320,5923,2042,4799,55666,1124
15313,24,1313,2932,1080,7343,233
22908,0,42,2550,34,3374,8
22083,108,9358,2591,6960,36044,2398
3315,15,1635,3597,1280,21643,355
27395,50,3994,2341,2847,22336,1147
39850,10,148,1662,115,5983,33
9474,12,379,3284,301,4708,78
37394,124,4245,1821,3268,23956,977
35745,13,365,1922,295,3332,70
3710,59,2404,3589,1742,16771,662
44740,42,654,781,438,6306,216
7416,56,3264,3423,2198,35356,1066
26497,1,43,2385,14,2627,29
5307,5,552,3525,420,6888,132
36860,5,193,1853,154,2165,39
26557,1,77,2382,64,2426,13
36096,3,81,1896,75,3902,6
8706,26,986,3330,818,18088,168
13766,13,617,3035,474,4707,143
13922,69,3060,3022,1961,104420,1099
31941,1,28,2101,22,1643,6
39195,14,349,1700,268,6143,81
45678,6,83,470,55,4307,28
12189,53,2242,3145,1688,20687,554
3501,7,300,3594,221,4693,79
14309,1,75,2995,62,2596,13
12354,1,54,3136,44,3163,10
42082,6,259,1398,173,4077,86
40463,647,22774,1615,16582,136056,6192
27288,5,932,2348,706,12251,226
13241,12,263,3076,198,4536,65
39403,128,3614,1687,2659,39191,955
35762,208,9148,1921,6815,60711,2333
31213,18,946,2139,754,14697,192
35272,393,49842,1954,35236,155885,14606
40177,0,0,1640,0,6794,0
34710,2,28,1985,22,1968,6
38925,1,34,1717,26,3304,8
39953,14,870,1654,705,6754,165
12360,13,678,3135,543,22207,135
26257,8,286,2396,203,5340,83
22765,7,559,2558,453,16375,106
40240,2,181,1635,138,6135,43
17982,1,100,2802,78,5178,22
6678,198,15120,3463,10276,79856,4844
9618,0,28,3275,20,3899,8
8939,95,4528,3317,3096,33004,1432
24825,1,113,2461,98,2981,15
36349,49,900,1882,689,9886,211
42597,71,1749,1296,1308,18486,441
8329,20,396,3355,332,5751,64
21419,4,256,2629,194,5961,62
14831,11,648,2958,511,9272,137
24822,0,32742,2461,22368,49296,10374
36277,47,1536,1886,1181,14868,355
5586,2,98,3511,80,3123,18
16036,19,941,2900,619,7130,322
27776,1,50,2318,44,2546,6
16360,1322,144057,2884,108476,322372,35581
6514,3,57,3469,45,2305,12
11516,2,40,3178,33,3108,7
38430,146,3400,1750,2555,36832,845
39387,3,89,1688,71,3018,18
4221,2,112,3574,76,6078,36
15392,79,3782,2929,2794,11694,988
34168,10,389,2010,257,4498,132
21422,7,918,2629,678,16014,240
19522,32,1135,2734,974,14603,161
10853,10,206,3213,158,7794,48
36759,1,42,1860,31,3862,11
2434,5,408,3612,319,19231,89
23205,0,1454,2536,1104,14957,350
32362,6,295,2079,235,5702,60
10224,2,53,3247,32,3041,21
36634,5,98,1867,85,3083,13
26939,21,3192,2365,2522,22061,670
35445,104,1088,1945,799,6411,289
37095,27,914,1839,711,16659,203
23253,11,1147,2534,830,10564,317
10084,11,413,3253,325,5985,88
2356,79,4779,3614,3641,178684,1138
16940,12,453,2854,344,4427,109
11063,13,359,3203,277,3633,82
5139,29,952,3533,795,8453,157
15871,24,1239,2908,953,7835,286
3869,81,5107,3585,4046,55641,1061
32722,21,555,2064,410,11507,145
8406,22,825,3350,647,16808,178
43486,2,65,1054,49,2165,16
3742,91,4128,3589,3075,32765,1053
25193,5,278,2444,214,4735,64
23862,43,1977,2505,1636,22490,341
6553,196,7791,3467,5452,64030,2339
21700,11,640,2612,493,8766,147
34674,10,271,1987,207,6324,64
28644,2,156,2268,113,5707,43
14667,40,2215,2970,1529,23212,686
18955,8,937,2761,661,6405,276
30390,14,571,2178,476,1899,95
2506,130,5768,3611,4482,75760,1286
2678,47,3344,3609,2616,27251,728
46058,3,20,310,11,1065,9
39281,10,996,1693,770,15134,226
12569,10,1055,3124,781,11407,274
38679,6,148,1732,128,9382,20
40247,10,195,1635,124,2743,71
23390,13,345,2527,283,3690,62
40684,4,112,1596,86,6214,26
46346,5,87,206,79,1911,8
34268,2,98,2007,81,6542,17
32150,87,5495,2089,4161,30485,1334
45027,33,302,695,209,4917,93
39116,15,390,1705,305,6246,85
10706,9,309,3221,250,11675,59
24923,5,208,2456,181,10512,27
45037,63,510,690,392,11717,118
25372,428,17087,2437,12418,65449,4669
2749,13,513,3607,424,6445,89
12917,6,1152,3104,839,9918,313
38940,4,83,1716,65,3220,18
8502,100,6012,3344,4707,77814,1305
25233,47,1688,2442,1353,18989,335
33359,4,213,2039,190,11637,23
33140,0,43,2046,39,3571,4
35806,0,52,1917,44,2857,8
10418,92,2841,3238,2054,22601,787
19207,49,826,2750,644,14206,182
42625,1,180,1290,138,6085,42
8948,14,287,3317,247,6133,40
35327,7,128,1951,111,4157,17
1915,12,290,3622,220,9009,70
4183,0,68,3575,55,4000,13
12319,55,1673,3138,1212,10619,461
16859,3,239,2858,197,3912,42
27612,61,1604,2328,1281,14848,323
18536,19,881,2779,669,13327,212
2076,64,4397,3618,2739,21157,1658
32709,279,8617,2065,6655,34695,1962
20101,85,15257,2703,11044,50507,4213
35934,2,56,1908,48,2781,8
23125,2,84,2540,62,3305,22
43603,229,3768,1007,3228,31697,540
27885,22,1308,2313,953,16111,355
1917,7,230,3622,191,11167,39
15046,25,704,2946,526,7870,178
36106,23,391,1895,329,7791,62
40722,109,2451,1593,1725,23131,726
36971,1,51,1847,37,2830,14
35604,3,22,1933,21,3819,1
8554,14,392,3340,309,7290,83
23651,1,50,2514,43,1694,7
36939,1459,67233,1849,46923,291553,20310
3947,16,602,3583,516,18308,86
42368,9,216,1341,173,6367,43
38096,6,207,1774,172,6174,35
2515,10,214,3611,180,5391,34
13642,20,2669,3046,1873,15290,796
15134,42,3993,2942,3107,22726,886
2929,1,156,3604,118,4725,38
11477,43,2838,3180,2198,13262,640
41308,87,872,1525,689,9521,183
38510,1,90,1744,67,6683,23
43550,78,1342,1030,1096,24049,246
24119,68,2344,2493,1851,30714,493
18693,111,15214,2771,10864,89139,4350
6889,19,254,3453,196,4273,58
43044,16,241,1184,175,4553,66
18397,7,512,2784,364,7889,148
37370,11,177,1822,142,4993,35
20789,22,717,2666,541,5344,176
3286,32,1025,3598,760,9528,265
3035,5,142,3602,112,5463,30
33051,13,445,2050,346,13417,99
34413,21,444,2000,375,4969,69
40459,6,221,1615,177,14588,44
45666,792,19467,475,12129,79209,7338
24235,2,78,2488,60,4144,18
44150,26,341,892,297,8522,44
37019,5,283,1844,206,10358,77
40000,22,470,1651,372,5810,98
14363,24,788,2991,647,23898,141
38222,55,1245,1764,965,9241,280
4739,25,818,3554,618,18860,200
34637,115,1813,1989,1470,18697,343
7572,243,6538,3414,5036,41887,1502
41398,38,1581,1512,1127,14068,454
3468,5,150,3594,111,9976,39
36856,5,123,1853,87,2723,36
32052,4,175,2094,109,4770,66
42171,13,496,1380,377,9937,119
27994,0,138,2306,119,3821,19
23478,7,137,2522,108,2886,29
9331,15,486,3293,385,9357,101
19147,5,143,2753,123,3166,20
26791,0,94,2372,80,1382,14
43240,28,637,1126,458,10129,179
44964,190,1862,715,1574,18966,288
24969,0,22,2454,20,16761,2
27190,3,118,2354,102,1872,16
19234,10,532,2749,424,6212,108
19568,19,1116,2732,865,31318,251
21792,0,326,2608,265,5667,61
24942,4,155,2455,127,3423,28
7093,9,138,3441,111,5779,27
42496,23,845,1315,606,11987,239
9533,0,213,3281,177,3688,36
3408,28,890,3595,662,21462,228
22509,52,2316,2570,1753,23402,563
12521,3,114,3126,99,2743,15
13957,120,68156,3019,18205,32618,49951
13603,26,1755,3048,1282,12381,473
28135,38,1544,2299,1265,22586,279
38461,24,383,1747,304,6417,79
24368,12,425,2482,307,4530,118
34380,28,554,2002,453,4523,101
29688,546,29971,2215,21363,131671,8608
4076,70,3279,3579,2493,42910,786
10809,39,1789,3215,1430,19114,359
40236,18,377,1636,265,8205,112
36666,23,883,1865,728,9739,155
7676,243,10744,3408,7721,91336,3023
37843,27,749,1790,579,9237,170
18235,2,174,2791,120,3376,54
11553,4,328,3176,264,7086,64
34986,19,363,1970,304,6620,59
36968,24,542,1847,423,6089,119
35852,3,122,1914,101,4481,21
22811,7,278,2555,209,3870,69
22170,290,17016,2587,11913,56374,5103
19895,26,1220,2714,946,21094,274
12381,0,30,3134,25,2009,5
25932,3,92,2411,73,6672,19
40411,4,159,1620,113,5571,46
6249,313,22204,3481,15760,101121,6444
14715,89,7901,2966,5697,56398,2204
39258,41,1333,1695,1028,14075,305
26202,41,1523,2399,1261,10931,262
28360,8,542,2285,461,2698,81
12623,3,104,3121,80,3204,24
12376,27,903,3134,691,30158,212
12510,27,655,3126,524,7940,131
1642,2,114,3670,99,2607,15
25429,185,3034,2434,2385,11969,649
46385,0,5,187,4,912,1
2537,201,11234,3611,8395,54138,2839
4865,65,2256,3549,1728,15455,528
18505,8,611,2779,433,8333,178
19858,28,1926,2716,1468,29810,458
13275,701,30814,3074,20597,141005,10217
45426,22,294,559,244,6708,50
31297,6,142,2134,111,3494,31
5826,9,187,3498,154,2564,33
19513,26,872,2735,705,14104,167
39944,1,75,1654,58,2599,17
35521,15,847,1940,663,13506,184
5281,8,53,3526,40,2876,13
35740,1,41,1922,33,6016,8
29776,37,894,2210,675,8795,219
26637,0,445,2380,372,6238,73
32304,161,14719,2082,11539,55766,3180
45571,17,346,515,250,5413,96
28826,7,257,2258,212,6942,45
28443,50,1790,2281,1321,11219,469
19241,16,700,2749,540,16628,160
26624,17,344,2380,292,4507,52
43066,4,64,1177,49,1566,15
45948,550,7413,360,6051,46084,1362
2048,21,817,3619,625,17340,192
15084,13,799,2944,624,11334,175
10908,9,451,3210,355,8849,96
16209,0,175,2892,133,2513,42
5757,69,88509,3502,35293,15227,53216
32971,2,81,2054,60,3966,21
4505,20,991,3563,725,13777,266
12552,26,941,3125,731,12953,210
26077,0,63,2405,52,2039,11
43781,120,2340,951,1902,23081,438
19728,5,110,2724,86,7164,24
31224,24,632,2138,519,4110,113
11984,2,92,3156,71,4084,21
9735,3,117,3270,83,4271,34
29427,23,692,2228,566,8475,126
7621,14,419,3411,338,8128,81
34393,22,618,2001,500,14981,118
20352,3,613,2691,491,8947,122
23564,9,387,2519,319,7670,68
5559,21,840,3512,592,10070,248
45410,16,427,562,325,5896,102
40571,3,112,1604,74,1353,38
10622,121,6124,3227,4673,50768,1451
25752,31,640,2419,502,7173,138
33772,5,156,2023,132,2387,24
14819,32,1736,2959,1231,36862,505
25718,36,2360,2420,1880,18329,480
2933,11,548,3604,381,8046,167
23959,6,811,2500,666,14852,145
30246,3,92,2187,79,4800,13
24619,11,376,2468,285,4865,91
8876,51,1826,3321,1304,15812,522
2456,6,209,3612,142,24597,67
43632,84,1179,999,974,21876,205
17785,47,2134,2813,1657,28125,477
40811,20,488,1583,347,8976,141
16217,216,7307,2892,5048,25053,2259
17706,408,17527,2815,13372,54842,4155
36463,74,1440,1877,1070,9805,370
23406,126,5560,2526,4269,57033,1291
10170,91,7483,3250,5615,74649,1868
35986,18,574,1904,469,10899,105
32416,5,87,2077,72,4381,15
7612,51,3396,3412,2373,29448,1023
35456,6,377,1945,278,10000,99
28238,1,62,2292,48,2934,14
11206,346,15074,3194,10727,90468,4347
10053,91,4031,3255,3072,36206,959
44633,17,181,816,154,2113,27
42655,132,2786,1283,1952,38831,834
20827,42,2149,2664,1711,23272,438
29189,6,303,2241,245,7676,58
44142,18,306,893,227,11758,79
37224,0,94,1831,75,5646,19
12621,70,2809,3121,2228,24084,581
11041,6,90,3204,79,2461,11
44792,35,470,766,342,9148,128
7725,20,458,3405,368,8335,90
2940,10,457,3604,348,13764,109
18698,83,1686,2771,1283,11935,403
43764,201,2614,958,2169,29832,445
19803,8,263,2720,213,4202,50
12200,3,249,3145,207,12941,42
39806,7,227,1665,183,3967,44
31102,12,397,2144,307,5384,90
2797,35,995,3606,781,13355,214
38942,7,450,1716,346,15323,104
26334,2,93,2393,85,3544,8
9478,8,114,3284,97,3164,17
12407,2,94,3132,80,11241,14
13557,9,37211,3051,13490,10412,23721
30508,1,67,2171,53,3330,14
9172,0,79,3302,64,2525,15
2639,10,262,3609,218,4107,44
3110,36,1000,3601,762,13044,238
9322,246,12175,3294,8312,64128,3863
1874,3,99,3623,87,6664,12
4367,5,167,3568,137,6419,30
37127,24,608,1837,491,14622,117
32507,2,240,2073,180,4237,60
33338,45,1802,2039,1463,13498,339
31003,63,6599,2149,5184,27825,1415
25572,9,162,2428,130,4980,32
17314,5,220,2833,200,5927,20
11512,47,2237,3178,1711,70491,526
6452,86,2721,3472,2058,29450,663
40757,779,53097,1588,39201,152823,13896
38906,20,555,1718,422,9031,133
39136,8,265,1704,200,7877,65
19166,1,162,2752,127,2309,35
39998,0,63,1651,49,4690,14
25760,13,346,2419,286,9359,60
8438,33,770,3348,548,18589,222
28649,523,17560,2267,12397,150804,5163
10696,0,19,3222,14,2932,5
9367,10,483,3290,351,18634,132
15433,3,351,2928,259,4542,92
4863,6,317,3549,242,5090,75
19269,5,232,2747,144,10418,88
26159,0,47,2401,39,2085,8
36132,8,379,1893,301,9174,78
41345,2,136,1519,110,2623,26
7293,1,24,3431,21,3003,3
29643,2,162,2217,139,7572,23
32110,21,735,2091,587,5164,148
41686,109,3386,1469,2465,27871,921
36983,2,43,1846,40,5604,3
19640,12,268,2729,220,4786,48
9597,21,687,3276,527,18305,160
36030,6,294,1901,228,9977,66
31037,17,689,2147,552,6036,137
9071,45,1379,3310,1080,13704,299
39860,16,829,1661,631,11116,198
44820,17,194,755,168,6016,26
10294,31,1544,3244,1153,13355,391
36170,2,382,1891,304,6585,78
20357,118,5917,2690,4338,21149,1579
34263,10,263,2007,208,4936,55
39379,6,121,1688,104,4011,17
12393,6,133,3133,107,5392,26
38450,5,230,1748,192,11812,38
14725,117,3259,2966,2456,24041,803
33068,23,1683,2049,1322,27730,361
25815,0,150,2416,129,8260,21
32743,121,1910,2064,1403,10330,507
36952,14,517,1848,448,13158,69
35535,2,90,1938,81,2846,9
3973,878,40880,3582,29810,166270,11070
26479,0,3165,2386,2234,21294,931
44691,21,627,799,448,8828,179
3094,12,508,3601,426,5845,82
45568,64,1158,516,957,6253,201
20719,52,6008,2671,4746,29273,1262
43867,4,64,939,44,2122,20
13453,209,13245,3058,9071,92069,4174
24120,0,140,2493,110,5141,30
15410,5,700,2929,608,9350,92
41003,83,3128,1567,2424,30168,704
5405,2,57,3519,44,3789,13
18399,9,879,2784,735,4939,144
29556,6,126,2221,104,3016,22
6011,8,211,3489,172,2130,39
38514,41,662,1744,517,7058,145
6465,1,29,3472,22,1916,7
29010,45,2150,2250,1681,24840,469
39157,15,450,1702,365,11975,85
25061,6,171,2450,144,2567,27
22648,0,27,2563,22,1755,5
14056,9,272,3012,219,3984,53
3734,3,241,3589,186,12331,55
15891,105,4349,2907,3466,44918,883
41919,1,91,1427,80,4681,11
2420,37,883,3613,694,65783,189
44782,16,166,768,134,2282,32
34592,7,228,1992,175,4353,53
32379,1,27,2078,21,1694,6
1659,7,483,3665,362,9140,121
33979,221,3111,2016,2431,17001,680
11812,8,207,3164,167,6637,40
6642,6,268,3464,191,5410,77
32163,9,633,2088,524,13419,109
1894,56,1682,3622,1262,11380,420
23106,11,698,2541,540,8285,158
9692,8,278,3272,215,4702,63
2381,63,1890,3613,1423,18046,467
8309,1,50,3357,42,3840,8
39895,9,273,1658,218,8312,55
11647,2,53,3172,43,3572,10
32958,38,710,2054,601,11681,109
16365,89,3524,2884,2712,37271,812
14830,392,20772,2958,13946,130793,6826
33774,19,495,2023,394,9793,101
43926,4,72,927,65,3166,7
22486,1,117,2571,104,8015,13
24832,64,2984,2460,2182,26446,802
25460,0,155,2433,118,2993,37
18614,68,3834,2775,2741,17628,1093
7034,149,5061,3444,3811,58046,1250
8598,8,717,3338,566,9241,151
37269,44,2205,1828,1399,37621,806
43628,23,660,1002,544,11543,116
39838,20,283,1663,228,7456,55
32213,4,388,2086,265,5583,123
18227,174,13387,2791,9909,80940,3478
24977,5,241,2453,202,8289,39
46018,2,23,331,14,765,9
17110,25,1889,2844,1462,24676,427
28070,57,1350,2301,1105,8170,245
17072,43,3480,2846,2708,27539,772
35154,2,178,1960,127,3537,51
28876,33,2877,2256,2388,31005,489
37248,31,485,1830,411,14238,74
5800,18,1541,3500,1096,17910,445
36053,7,210,1899,187,7834,23
42690,21,487,1274,387,9944,100
43253,92,1537,1121,1261,21269,276
1670,2,259,3662,203,6905,56
6982,185,13557,3447,5666,32838,7891
17618,15,1263,2818,860,21037,403
32762,1,20,2063,18,2150,2
26762,2,70,2373,63,2026,7
7007,4,262,3446,220,7795,42
26877,10,400,2368,340,5852,60
28588,1,50,2271,36,2588,14
41773,1,24,1453,18,5313,6
31595,119,2475,2118,1842,14226,633
24806,51,1476,2462,1128,12723,348
12451,155,7398,3129,5894,71323,1504
6630,16,465,3465,339,10456,126
9796,7,506,3267,395,15275,111
21247,0,19,2637,15,2262,4
3873,4,176,3585,156,4838,20
38198,31,2225,1767,1515,25527,710
34275,33,986,2007,727,15434,259
37815,3,78,1792,65,7662,13
30853,2,111,2155,88,12335,23
17572,0,219,2820,155,4647,64
32855,469,14468,2058,11041,99806,3427
16872,2,59,2858,44,4115,15
3510,12,405,3593,330,9119,75
15795,164,24505,2910,17189,56491,7316
35904,5,137,1910,109,3405,28
41405,6,149,1510,113,7754,36
9346,3,94,3292,79,4120,15
25012,134,4167,2452,3310,19237,857
40342,10,288,1627,235,11929,53
41758,11,187,1456,143,8873,44
31656,6,290,2114,241,3381,49
41064,79,3521,1560,2567,31157,954
28518,135,8284,2275,6124,64956,2160
4392,14,153,3567,126,5826,27
41763,12,376,1455,294,10438,82
26105,29,1679,2404,1391,19395,288
15475,7,222,2926,177,6211,45
43031,21,465,1189,361,20283,104
14457,5,31995,2984,10743,8336,21252
14222,18,689,3003,529,7822,160
7494,20,794,3419,593,5525,201
45219,12,112,618,81,2710,31
4838,12,301,3550,218,4943,83
5867,28,832,3496,628,6759,204
25978,1,21,2409,19,4514,2
37623,2,79,1805,69,3017,10
42395,32,666,1337,449,12450,217
38965,15,619,1714,460,8905,159
2725,13,465,3608,363,7064,102
16150,269,13292,2894,10164,47906,3128
45215,4,28,619,18,1991,10
35239,4,256,1955,213,6524,43
10062,11,207,3254,176,4005,31
5994,38,1043,3490,784,10148,259
19507,10,624,2735,483,4776,141
45113,11,105,652,89,4227,16
38284,171,8833,1760,6140,71180,2693
34923,8,557,1972,432,9083,125
37466,22,744,1816,580,11155,164
13438,5,91,3061,64,3346,27
8263,1,79,3360,50,1471,29
18916,1,130,2762,107,2382,23
9958,3,62271,3259,24314,2579,37957
4963,30,1731,3544,1372,16708,359
31290,14,656,2134,495,6562,161
36519,52,1164,1874,839,12628,325
28501,24,859,2277,677,12622,182
22947,10,393,2548,289,5661,104
17408,1,81,2827,68,2650,13
7408,49,1053,3424,875,18296,178
25102,21,603,2448,497,13672,106
33179,50,1770,2045,1434,24074,336
35868,123,4564,1913,3524,28720,1040
38790,2,105,1725,92,3177,13
5132,83,8958,3534,6390,126517,2568
6935,30,601,3451,447,10042,154
41384,0,46,1514,37,1560,9
36699,8,533,1864,399,8096,134
29510,2,82,2223,66,4640,16
1792,126,8143,3627,6077,45577,2066
14471,124,4102,2984,3022,20770,1080
32162,21,1743,2088,1351,18472,392
6306,103,5185,3479,4008,28979,1177
41602,11,325,1482,246,7680,79
36243,48,1798,1888,1459,15118,339
20867,202,10338,2662,6440,121663,3898
5481,6,132,3516,99,5205,33
29617,12,342,2218,298,12573,44
36527,841,34388,1874,26372,201893,8016
21457,10,468,2626,353,8833,115
7658,10,276,3409,233,7744,43
3842,16,245,3586,179,4338,66
44886,21,173,737,140,3354,33
14119,243,24485,3008,17920,128782,6565
31991,93,2164,2098,1550,13623,614
45625,35,391,496,318,3855,73
30364,49,2083,2180,1612,16272,471
38588,39,1370,1738,1132,14447,238
5266,36,1322,3526,1041,29533,281
11363,3,98,3187,77,2008,21
11519,10,356,3178,273,16099,83
8240,3,188,3361,150,3826,38
15232,41,2743,2936,2220,31930,523
28388,114,7212,2284,5549,44230,1663
32989,2,80,2053,68,3564,12
13491,1,107,3056,85,2780,22
41008,39,1427,1567,1018,24256,409
40351,1,38,1625,34,1820,4
20428,9,638,2686,450,9213,188
39134,6,166,1704,124,2902,42
14916,43,3420,2954,2530,28546,890
14535,31,1596,2979,1234,15456,362
40321,11,370,1630,307,4785,63
37750,5,161,1797,127,3916,34
45765,262,4247,426,3242,19107,1005
9195,41,1280,3302,954,19313,326
27301,57,13066,2347,10680,42223,2386
22063,44,1886,2592,1313,9074,573
13237,422,15041,3076,10785,91683,4256
14555,56,2216,2977,1802,28914,414
12259,0,0,3141,0,3537,0
7546,25,2980,3416,2147,61809,833
7810,84,1702,3398,1135,29290,567
31827,57,3712,2105,2826,23067,886
37432,57,1218,1818,933,7502,285
39695,51,1746,1670,1289,16860,457
45703,24,204,459,179,5438,25
38675,1,73,1732,49,4100,24
38736,63,1029,1729,769,7111,260
25040,219,6236,2451,4610,23741,1626
33376,54,3582,2038,2659,40215,923
7377,149,5168,3425,4025,52754,1143
2416,7,410,3613,341,18869,69
29854,5,603,2207,483,7610,120
35199,0,317,1959,253,3769,64
17802,0,70,2812,52,5077,18
3656,20,673,3590,533,9141,140
9516,3,102,3281,72,4399,30
35320,40,625,1952,457,8686,168
17939,4,180,2805,152,2622,28
18057,4,108,2798,100,2499,8
22379,22,1843,2577,1370,12796,473
17900,3,172,2808,97,1848,75
6812,60,1647,3456,1369,19141,278
30519,183,2281,2170,1575,14888,706
30409,34,682,2177,539,5912,143
23273,180,10922,2533,8273,85180,2649
17946,13,580,2805,438,5144,142
16723,10,283,2866,230,4752,53
34546,54,2264,1994,1697,28258,567
18855,15,1289,2764,948,9214,341
7310,3,121,3429,98,3488,23
39051,217,9821,1709,6566,67671,3255
24650,4,188,2467,168,8739,20
11462,53,1420,3181,1121,12682,299
9187,436,21244,3302,16252,90031,4992
6822,124,5049,3456,3737,67205,1312
42869,23,650,1233,433,7799,217
25145,33,3114,2446,2257,22466,857
43615,11,125,1005,104,5950,21
40993,104,4171,1568,2972,44105,1199
20411,3,194,2687,126,5556,68
9302,16,535,3296,462,15665,73
20556,20,650,2680,518,10720,132
23688,11,505,2512,407,11355,98
41355,10,244,1518,175,5668,69
39648,15,618,1673,458,9616,160
34330,90,1227,2004,964,8571,263
26128,4,227,2403,170,2700,57
35252,110,1420,1955,1172,14998,248
38766,8,851,1727,524,10930,327
19967,3,250,2710,218,4055,32
31233,3,269,2137,198,4797,71
14811,35,2017,2959,1580,28035,437
38728,16,235,1729,190,3689,45
27494,443,13352,2335,10306,48097,3046
19341,3,260,2743,217,4314,43
8391,95,3462,3351,2515,55829,947
2698,4,101,3608,70,4732,31
45009,74,1536,701,1052,16540,484
32656,9,279,2067,232,5068,47
5979,4,468,3490,329,8010,139
46406,77,1577,175,1394,13756,183
29725,58,2187,2213,1701,18544,486
20165,43,2897,2700,2349,21726,548
31855,832,26632,2104,19069,118651,7563
44614,62,2717,817,1860,20611,857
15364,4,214,2930,170,4580,44
16764,32,792,2864,634,8518,158
26046,9,287,2406,235,4077,52
9252,342,34092,3299,23225,147642,10867
3488,22,1365,3594,1134,11523,231
12204,10,303,3144,252,9053,51
16311,10,298,2887,221,12155,77
31111,2,120,2143,100,4272,20
41292,7,326,1526,249,6276,77
17607,9,274,2818,230,5285,44
37093,0,72,1839,56,2564,16
4197,39,1437,3575,1110,13334,327
35928,0,35,1908,29,1812,6
23781,12,389,2509,323,10259,66
18669,612,21962,2772,14985,93457,6977
14563,39,1291,2977,955,14170,336
16305,28,2711,2887,2073,19325,638
39132,8,137,1704,116,5453,21
17291,4,204,2834,174,6799,30
28678,5,336,2266,241,4751,95
33577,0,21,2030,20,1678,1
17299,4,279,2833,238,6685,41
6138,6,357,3485,288,5779,69
42427,17,398,1328,288,4543,110
35732,2,73,1923,68,3914,5
17589,22,532,2819,409,3898,123
45330,30,318,584,234,7071,84
28499,19,1201,2277,811,22925,390
13823,32,1131,3032,872,20884,259
39087,17,277,1706,197,9347,80
8446,3,83,3348,63,6122,20
12124,1,205,3149,163,4269,42
11894,8,244,3160,196,6866,48
31888,10,780,2103,659,9539,121
15530,12,659,2923,569,8367,90
10379,31,2056,3240,1522,21665,534
17278,1,135,2834,97,3161,38
8608,50,1188,3337,947,32367,241
3752,6,341,3588,278,6302,63
12719,19,840,3115,641,6672,199
22644,6,383,2563,284,6220,99
17901,1,224,2808,150,3095,74
24455,28,933,2478,741,15195,192
10812,248,15233,3215,11161,57186,4072
39907,2,201,1657,155,6618,46
30677,51,2118,2162,1644,50061,474
7200,4,159,3435,125,4549,34
27430,6,216,2340,166,5777,50
42741,3,146,1262,131,9456,15
7489,10,366,3419,221,5411,145
29368,23,671,2230,485,10394,186
13732,5,213,3038,169,4223,44
27290,0,1339,2348,766,6910,573
29143,5,220,2243,186,4048,34
34000,13,226,2015,181,3493,45
6545,74,2004,3468,1538,45020,466
28047,9,425,2303,347,13246,78
43568,3,149,1026,116,4800,33
41153,32,560,1549,386,12394,174
5411,34,1568,3519,1196,32811,372
2664,68,3195,3609,2544,28114,651
22984,126,2801,2546,2217,13065,584
31164,14,302,2141,238,5271,64
22356,102,2928,2578,2284,28918,644
18054,1125,28747,2799,22112,134526,6635
43697,4,95,977,51,3010,44
32600,22,497,2069,404,4603,93
13176,26,954,3079,712,4281,242
28222,4,305,2293,235,8631,70
44951,403,4935,718,4252,26934,683
35375,18,592,1950,480,11500,112
23788,14,403,2509,338,7959,65
29224,8,270,2239,204,6484,66
42722,120,2361,1268,1589,34128,772
27021,59,2855,2363,1993,25263,862
35203,10,207,1959,177,10920,30
41865,11,370,1435,303,11922,67
3605,9,303,3592,229,4770,74
41171,101,3222,1547,2411,19892,811
13482,6,184,3057,145,4009,39
33882,2,161,2019,135,10218,26
39618,8,406,1675,327,11111,79
33707,9,182,2026,148,3217,34
15856,3,193,2908,152,6317,41
14337,15,632,2993,507,6028,125
28895,6,437,2255,359,9212,78
28091,14,675,2301,533,9287,142
10832,87,3078,3214,2385,32393,693
38350,124,5983,1755,4471,23216,1512
28748,283,6452,2262,5104,44801,1348
29012,692,37540,2250,26293,123094,11247
26628,8,315,2380,254,4292,61
22031,18,1098,2593,836,8117,262
19511,14,919,2735,713,14928,206
22127,2,47,2588,40,1939,7
44296,1,75,870,58,2231,17
21859,57,1604,2605,1232,9595,372
27529,1,206,2332,184,4957,22
42502,21,296,1313,212,7380,84
30897,1,51,2153,49,2680,2
13143,12,1086,3089,843,8993,243
10671,110,5811,3223,4450,31301,1361
29651,13,322,2216,254,8854,68
42782,4,497,1252,332,13525,165
19749,89,3729,2723,2860,29196,869
28153,11,526,2297,446,7319,80
6026,0,90,3489,79,6777,11
41543,71,3098,1492,2301,22075,797
31649,51,776,2114,607,6986,169
27655,14,293,2326,264,4603,29
12886,185,8473,3106,6339,61692,2134
23417,1,256,2525,199,7264,57
38036,42,413,1778,319,3931,94
35646,2,80,1930,68,4268,12
3776,21,491,3588,330,8745,161
46232,34,697,249,575,7697,122
45728,1,24,444,19,1637,5
9630,3,89,3275,74,4520,15
19042,0,105,2757,84,2439,21
29055,5,151,2247,115,3028,36
7778,2,44,3400,35,1451,9
28675,17,1077,2266,796,11571,281
22150,10,578,2587,447,8111,131
12759,10,495,3113,378,5808,117
2881,11,237,3605,189,6329,48
11756,4,95,3166,83,1726,12
16076,1,28,2898,26,3088,2
33035,13,485,2051,407,9970,78
36518,18,704,1874,530,11468,174
23599,77,4960,2517,3704,43516,1256
42400,1716,58864,1336,46090,191535,12774
10373,20,598,3240,507,11435,91
24792,25,1243,2462,901,15588,342
19316,32,537,2744,446,5635,91
18716,38,1331,2770,1022,12602,309
25532,10,476,2430,402,7734,74
3166,14,354,3600,301,15029,53
45506,4,52,541,34,1547,18
36480,23,1010,1876,800,13393,210
16960,152,5148,2853,3821,20486,1327
17509,77,2631,2823,2006,18489,625
46077,84,1852,300,1565,11723,287
19443,93,4230,2738,3310,18382,920
12358,2,41,3135,32,3765,9
38586,6,238,1738,180,4429,58
37463,178,3591,1817,2500,21689,1091
14754,44,2331,2963,1778,25432,553
45706,7,93,456,66,4194,27
16974,15,966,2853,777,9163,189
10227,5,175,3247,144,2703,31
11670,9,453,3170,353,13744,100
28150,29,952,2298,741,12309,211
25122,18,224,2447,169,3102,55
3164,1,27,3600,21,2665,6
42096,39,821,1396,639,13577,182
36482,10,188,1876,156,5461,32
20370,4,271,2690,217,14939,54
8774,24,329,3327,251,3213,78
12080,46,1241,3151,944,18726,297
43997,48,826,918,741,14977,85
32302,0,34,2082,29,2136,5
16567,79,1972,2874,1535,23971,437
14910,3,103,2954,77,2860,26
17252,12,606,2836,482,13066,124
39707,10,255,1670,191,8614,64
10126,194,6798,3252,5103,40513,1695
45087,103,1120,669,899,8796,221
22365,122,5855,2577,4022,43330,1833
30336,63,2059,2182,1506,21447,553
7161,5,213,3437,177,5759,36
27476,102,3573,2336,2416,28068,1157
38356,0,41,1754,28,3791,13
23514,0,100,2521,76,3182,24
8849,12,359,3322,296,14562,63
18656,1,200,2772,160,2967,40
3884,10,152,3585,121,3838,31
8936,10,295,3318,202,2312,93
19118,3,262,2755,205,4969,57
38191,11,196,1767,139,7653,57
2699,39,1243,3608,961,15379,282
18883,8,287,2763,226,2725,61
2665,1,65,3609,58,6766,7
8487,4,111,3345,84,3341,27
29214,419,83956,2239,51318,306317,32638
11372,8,394,3187,295,6627,99
21013,49,1588,2651,1172,26751,416
31820,52,1490,2106,1182,7018,308
21366,8,555,2631,430,4379,125
30361,2,80,2180,64,2631,16
31303,127,4498,2134,3428,39145,1070
41822,44,970,1442,824,19060,146
12314,20,1426,3138,1006,20930,420
37003,47,1603,1845,1251,13470,352
24183,0,712,2490,576,12251,136
43531,63,1107,1038,871,22111,236
22429,127,9570,2575,6776,71185,2794
43766,101,1524,957,1066,23689,458
7379,82,2844,3425,2184,31572,660
46193,106,1258,258,1112,14028,146
35273,74,2072,1954,1663,27278,409
32436,8,333,2076,256,8957,77
6100,15,1304,3486,996,16193,308
8938,72,1592,3317,1244,19046,348
43370,28,485,1085,406,11895,79
16460,65,1922,2879,1491,13554,431
31660,1,81,2114,63,2572,18
21782,3,200,2608,141,6768,59
32768,16,1229,2062,971,13132,258
15895,2,131,2907,103,2911,28
43102,17,498,1166,312,6213,186
25710,7,136,2421,118,4531,18
45801,41,299,421,225,4386,74
14647,30,2928,2971,2174,27567,754
4044,23,810,3580,610,13574,200
41029,29,583,1565,385,4507,198
2122,2,373,3617,283,16702,90
16442,618,34086,2880,24648,235366,9438
19546,48,1298,2734,932,7330,366
28354,39,1562,2286,1249,10701,313
43011,2,43,1193,37,3007,6
2804,203,6471,3606,5062,25612,1409
26038,343,24300,2406,17650,93495,6650
45338,2,27,583,19,2249,8
42008,1,61,1412,45,2218,16
28179,30,1140,2296,888,12190,252
19584,3,184,2732,155,5392,29
10221,23,395,3247,308,6316,87
13365,0,21,3067,18,1868,3
24243,9,243,2487,182,5406,61
43995,2,61,919,49,3232,12
22148,5,308,2587,216,3257,92
30350,23,374,2181,289,4786,85
11419,4,119,3185,94,2902,25
26510,616,12208,2385,8857,39087,3351
36169,62,1540,1891,1274,7076,266
45006,3,68,701,51,2224,17
21410,149,12809,2629,9560,64080,3249
25336,52,1149,2438,862,7092,287
30060,91,3431,2197,2675,35060,756
20120,40,2334,2702,1735,14933,599
18605,19,1372,2775,1081,17163,291
11880,401,20488,3161,15116,210101,5372
10465,21,603,3235,474,6363,129
18947,22,853,2761,663,10696,190
29675,21,618,2215,498,6130,120
40020,7,234,1649,174,6480,60
6914,2821,117680,3452,78803,409253,38877
39288,328,15257,1693,11306,80524,3951
12060,97,4452,3152,3376,50082,1076
31522,2,219,2121,165,7066,54
22176,52,1883,2586,1431,24433,452
18287,27,1836,2789,1435,15263,401
42943,6,110,1211,81,2442,29
9447,45,906,3286,727,37248,179
35872,3,73,1913,59,4452,14
4734,138,3648,3555,2610,34625,1038
11874,523,31637,3161,20089,199650,11548
42528,37,782,1308,569,17479,213
28284,0,70,2290,65,1905,5
34449,143,7357,1999,5738,58125,1619
29766,57,4354,2211,3504,25815,850
39629,1,64,1674,56,12382,8
45299,176,2369,593,1856,23258,513
3674,51,2865,3590,2438,34237,427
36334,5,228,1883,190,6544,38
29165,1,86,2242,76,3903,10
43750,15,236,963,207,4224,29
2583,23,229,3610,179,6533,50
31453,16,536,2126,435,5284,101
39795,91,1807,1665,1344,19456,463
29827,270,12463,2208,9506,61918,2957
43730,21,201,967,186,9265,15
9097,43,1148,3308,939,19388,209
5857,41,175349,3497,64700,38855,110649
10504,3,410,3234,315,6104,95
2960,16,1210,3604,800,27758,410
40610,10,133,1601,104,2479,29
42682,30,428,1276,362,3968,66
38402,21,808,1752,664,11364,144
16730,3,146,2866,112,3433,34
21711,26,3623,2611,2425,18731,1198
14797,17,438,2960,342,6280,96
11191,33,822,3195,650,7439,172
4397,85,3462,3567,2524,31821,938
20798,12,430,2666,298,7371,132
31383,27,835,2130,683,7527,152
3176,36,1546,3600,1052,17031,494
38216,5,250,1765,199,7675,51
2679,52,1712,3609,1339,33082,373
29504,4,82,2223,66,4094,16
29276,4,84,2236,67,2441,17
5363,85,4203,3522,3391,34444,812
35397,220,5709,1948,4296,54915,1413
27485,600,23018,2336,16491,143915,6527
33846,17,782,2020,639,10553,143
46044,16,196,316,135,5457,61
36578,4,105,1871,92,3493,13
25367,78,1245,2437,950,15263,295
8619,18,530,3336,434,23346,96
5918,14,493,3493,368,7961,125
42801,13,115,1245,99,2239,16
43165,65,695,1148,513,13669,182
3998,10,568,3581,460,5997,108
40197,1,14,1639,11,1175,3
33946,37,559,2017,453,6512,106
18445,6,378,2782,314,11288,64
35621,1,115,1932,89,2744,26
4004,16,444,3581,359,6995,85
2126,27,1120,3617,854,10690,266
4103,26,1509,3578,1079,42292,430
24413,1,110,2479,91,4163,19
43332,4,57,1100,40,2133,17
16656,408,36605,2870,25108,165363,11497
38434,13,373,1749,287,6112,86
1836,166,8500,3624,6385,38183,2115
19459,8,319,2737,254,5297,65
13672,110,3948,3044,2771,14492,1177
27988,158,15458,2306,10951,89931,4507
17478,11,171,2825,145,2703,26
45726,2,33,445,25,854,8
17366,63,1266,2830,916,8706,350
9711,228,11323,3272,8592,81632,2731
44763,8,65,775,59,3560,6
11263,4,37,3191,27,2010,10
41086,103,1030,1557,728,11433,302
1905,36,467,3622,374,9565,93
4327,1,72,3570,42,1701,30
35808,28,1189,1917,951,15618,238
44790,15,128,766,91,1935,37
10670,235,9859,3223,6198,47158,3661
35323,21,827,1952,622,6787,205
25380,28,811,2436,640,6778,171
46266,0,7,240,6,554,1
16064,9,510,2898,390,3689,120
18089,15,444,2797,354,4933,90
13065,9,383,3094,295,13906,88
11717,42,3329,3168,2452,42171,877
14075,7,606,3010,502,15652,104
19245,228,9898,2748,7041,42701,2857
12336,41,1223,3137,961,5095,262
22410,4849,160432,2575,98557,405537,61875
32067,15,1055,2093,725,8685,330
26347,7,389,2392,330,2240,59
13009,125,6377,3098,5142,22176,1235
18920,2,83,2762,73,2289,10
32691,24,1008,2065,811,13584,197
19583,7,425,2732,334,9889,91
12996,69,3439,3098,2713,19792,726
25515,8,449,2431,380,4019,69
18119,5,282,2796,207,15224,75
41901,4,247,1429,193,5561,54
45507,2,36,540,27,1747,9
34660,13,326,1988,259,7110,67
39789,1,18,1666,16,2525,2
34557,2,153,1994,135,4185,18
21157,3,115,2643,104,3240,11
9938,12,488,3261,393,6852,95
2032,203,10128,3619,7159,76582,2969
29864,4,74,2206,57,1903,17
20387,56,2157,2689,1699,13625,458
9205,4,157,3301,127,3851,30
18308,14,803,2788,617,7332,186
12981,44,1170,3099,912,7606,258
17304,24,1308,2833,1016,26917,292
31313,3,148,2133,121,3642,27
3284,43,2660,3598,2058,26994,602
35044,32,841,1966,643,9733,198
23018,40,4277,2545,3005,42671,1272
25068,7,227,2450,186,4647,41
13252,5,427,3075,303,6833,124
8588,3,355,3338,273,8954,82
8811,40,2783,3324,1951,24506,832
35312,47,470,1952,380,4147,90
19360,21,1023,2743,863,4493,160
17397,12,1073,2828,790,7087,283
8342,2,83,3354,74,3119,9
33352,159,5747,2039,4510,43504,1237
31779,0,79,2108,68,2153,11
46070,45,711,305,607,9304,104
41948,153,1927,1422,1445,15403,482
44762,50,1035,775,761,13215,274
28752,13,208,2262,175,5295,33
19053,14,393,2757,311,5294,82
20459,2712,196815,2685,122745,458593,74070
28427,531,35304,2281,26114,175609,9190
7060,129,5014,3442,3742,17712,1272
8011,4329,181515,3379,125829,503830,55686
30887,36,862,2154,693,19069,169
4399,40,547,3567,425,16202,122
23167,2,109,2538,93,5403,16
13316,8,316,3070,250,10710,66
40661,6,68,1598,57,3973,11
19432,31,1409,2738,1135,17160,274
12367,608,46138,3135,32810,116874,13328
37628,5,80,1805,59,3230,21
44200,9,126,882,83,3767,43
28938,564,22554,2253,16032,149527,6522
43184,29,314,1144,228,7549,86
15702,10,294,2914,240,10282,54
20456,40,1949,2685,1491,20958,458
17456,67,2312,2826,1743,18147,569
8513,58,1566,3343,1109,27801,457
42139,27,273,1387,219,3216,54
30586,29,1175,2168,920,12658,255
29485,23,448,2224,316,5759,132
45931,139,3651,368,2895,16054,756
7690,1112,59152,3406,40415,407887,18737
20520,14,526,2682,416,10979,110
44998,63,823,704,703,13143,120
25349,39,762,2438,616,6185,146
3553,3,106,3593,86,2996,20
37390,25,711,1821,556,6619,155
25917,15,497,2412,368,5586,129
31208,49,994,2139,809,6816,185
18664,68,3238,2772,2274,32134,964
36350,116,2938,1882,2246,18613,692
32056,1,74,2094,47,5489,27
26899,127,4863,2367,3745,27289,1118
44879,17,291,738,236,4851,55
30629,6,105,2165,85,2555,20
36931,178,8982,1850,7248,47612,1734
45258,77,815,607,656,15701,159
36344,0,5,1882,4,3311,1
35018,8,279,1968,232,6491,47
15468,33,956,2926,722,12064,234
11177,35,2043,3196,1488,54483,555
23562,16,487,2519,396,12541,91
2044,99,4199,3619,3342,30817,857
30707,2754,250791,2161,153380,760820,97411
13699,303,20438,3041,15158,76250,5280
8720,6,209,3330,182,9939,27
16704,902,21241,2868,15384,91401,5857
33015,3,151,2051,125,7933,26
18854,3,311,2764,195,1979,116
11757,0,160364,3166,41537,2374,118827
5576,69,1751,3511,1407,36244,344
42830,54,1790,1240,1348,17476,442
7297,6,99,3430,67,6430,32
27191,0,64,2354,59,2582,5
17143,53,1685,2842,1270,12876,415
38646,6,207,1734,156,11201,51
18159,3,242,2795,189,2929,53
31835,223,5009,2105,3635,31208,1374
17199,13,908,2839,733,11689,175
38225,2,318,1764,249,11186,69
26397,6,254,2389,189,5195,65
2231,36,1510,3616,1119,14026,391
14308,99,7181,2995,5281,47476,1900
36359,242,7435,1882,5350,79413,2085
42448,66,718,1324,551,5006,167
46364,2,73,199,48,1526,25
28147,21,1185,2298,898,14112,287
32138,7,117,2090,91,5133,26
11597,1,36,3175,30,4072,6
45397,1,16,566,12,1261,4
13163,13,656,3080,506,7973,150
40755,0,79,1589,43,10331,36
39920,14,266,1656,220,12603,46
25544,18,1316,2429,937,18501,379
8057,3,46010,3371,17605,3341,28405
27100,6,104,2360,78,2492,26
5945,12,186,3492,133,5547,53
7329,15,835,3428,376,8872,459
31047,289,24107,2147,18114,100586,5993
22069,30,587,2591,479,5767,108
26266,0,3303,2396,2611,35757,692
13021,42,1453,3097,1011,20106,442
41389,3,75,1513,57,2308,18
39875,3,115,1660,80,7134,35
16680,8,560,2869,434,6641,126
38398,2,97,1752,67,4115,30
35536,1,63,1938,49,3529,14
13010,1,56,3098,41,7753,15
32001,25,952,2097,699,14888,253
37930,75,2724,1784,2043,19035,681
2863,45,1003,3605,801,21739,202
7331,8,63,3428,55,5302,8
2690,3,132,3608,102,3933,30
4712,51,1292,3555,1056,37680,236
22185,588,30223,2586,21695,158761,8528
7654,21,809,3409,637,11474,172
31822,197,7683,2106,5457,60782,2226
41548,6,411,1491,293,7776,118
28216,3,131,2293,103,2282,28
8322,2,82,3356,73,4422,9
10113,21,1346,3252,1078,26872,268
3077,51,1999,3601,1513,22917,486
38162,12,321,1769,238,7337,83
24795,76,5303,2462,3839,31964,1464
14500,5,253,2981,210,6274,43
31038,11,629,2147,517,6757,112
12798,159,11005,3111,7918,84549,3087
28605,4,608,2270,519,4751,89
33305,13,1286,2041,1065,7685,221
16091,74,5920,2897,4323,46250,1597
20037,66,1243,2706,930,7022,313
41386,16,1070,1514,800,15395,270
8825,0,32,3323,24,3664,8
33384,44,1278,2038,889,10046,389
9480,10,513,3283,387,15989,126
30938,45,1143,2152,921,15322,222
45699,33,373,463,274,5968,99
42306,61,1706,1353,1255,22428,451
35734,6,525,1923,413,27859,112
9993,30,911,3258,756,7029,155
3090,23,360,3601,284,5027,76
29420,16,827,2228,676,5834,151
30161,1,55,2193,47,2743,8
3493,0,41,3594,22,2870,19
37529,167,3650,1812,2765,33268,885
12573,17,584,3124,461,5707,123
31645,3,197,2115,136,7680,61
38716,0,109,1730,80,3943,29
4053,25,638,3580,496,7746,142
45498,7,71,542,46,1965,25
37931,8,533,1784,407,6935,126
36061,0,53,1898,42,2308,11
40670,16,562,1597,433,15847,129
32610,6,165,2068,138,4972,27
22906,187,6731,2550,4910,37581,1821
13591,279,20378,3049,14101,111318,6277
19605,121,6277,2731,4858,58065,1419
19796,670,32109,2720,21984,234272,10125
25735,31,6263,2419,4519,28566,1744
18179,5,124,2794,89,5110,35
28947,3,93,2253,70,2590,23
22202,2,35,2585,32,2216,3
31344,46,1261,2132,1059,21106,202
7343,1124,73623,3427,50701,456211,22922
25581,0,79,2427,74,2246,5
11675,3,47,3170,42,2947,5
35202,86,4673,1959,3520,25956,1153
42557,6,145,1303,109,3491,36
18599,235,10802,2776,7553,92469,3249
29218,6,833,2239,537,7343,296
14510,32,2616,2980,1691,21481,925
3588,41,1681,3592,1246,18835,435
945,8,400,3948,317,5095,83
1682,0,36,3660,34,1634,2
27453,8,212,2338,172,9072,40
27090,2,46,2360,40,1827,6
19913,100,7780,2714,6221,35453,1559
8785,17,871,3326,682,25061,189
29114,17,525,2244,389,3455,136
20964,14,663,2655,498,11076,165
29081,548,20794,2245,15707,129018,5087
26353,68,4249,2391,3307,32941,942
1664,1,25,3663,22,1722,3
22065,81,2858,2592,2200,18042,658
30601,336,15933,2167,11653,77111,4280
46080,0,34,303,18,2532,16
8117,29,612,3369,452,7499,160
39547,3,81,1679,66,3239,15
18174,13,122,2794,101,4056,21
33756,55,1454,2023,1077,13109,377
12418,27,662,3131,539,16383,123
9871,5,242,3264,208,5549,34
45864,126,1959,374,1513,11720,446
19599,0,47,2731,45,1915,2
12612,370,19867,3121,13734,142878,6133
23887,5,202,2504,173,4602,29
38087,61,1451,1775,1040,10780,411
2662,6,160,3609,136,6052,24
2644,11,410,3609,341,16362,69
29405,2,80,2229,71,2995,9
10402,10,479,3239,332,18385,147
26490,545,20969,2386,14735,168934,6234
8507,11,310,3343,268,6196,42
18515,2,142,2779,116,2671,26
26705,1,31,2376,26,1844,5
15259,5,158,2935,143,5740,15
6077,73,8866,3487,6495,33630,2371
43890,10,199,935,163,6247,36
20203,112,8507,2697,6093,60771,2414
4562,7,390,3561,189,5248,201
36806,3,126,1857,102,4171,24
20532,8,480,2681,418,8918,62
21935,2,115,2600,92,4547,23
40615,22,885,1601,688,12218,197
37313,3,103,1825,74,4535,29
3820,23,1156,3587,926,20189,230
1950,2941,143011,3621,96847,550582,46164
30865,8,368,2154,255,5590,113
15414,191,9954,2929,7090,25312,2864
20796,7,425,2666,361,4985,64
4058,5,160,3579,120,6579,40
9964,5,507,3259,341,6092,166
35498,4,160,1941,128,3607,32
41870,21,1040,1434,694,24089,346
15786,1,42,2911,37,2900,5
6251,24,553,3481,398,6929,155
5414,645,31107,3519,22217,274971,8890
11182,558,78189,3195,52179,226622,26010
5887,27,1210,3495,968,16791,242
37161,71,1289,1835,1042,20314,247
21390,4,141,2630,101,5420,40
37643,2,45,1805,39,4313,6
45449,28,371,553,287,7582,84
40909,136,3445,1574,2594,28460,851
4826,60,1790,3551,1468,9231,322
5701,2129,90063,3504,62121,334183,27942
36262,6,110,1887,88,4481,22
22633,8,333,2565,271,5304,62
39725,5,105,1669,92,2931,13
27210,79,1629,2353,1233,9837,396
34692,28,905,1986,746,10097,159
35429,141,1506,1946,1197,10311,309
28006,22,856,2305,691,12329,165
6994,44,1333,3447,1043,17561,290
14267,85,1943,2999,1516,14708,427
38006,29,648,1780,538,11122,110
29314,162,4436,2233,3460,25184,976
19557,42,4876,2733,2902,22531,1974
37147,130,4793,1836,3692,36158,1101
21643,98,5354,2616,3935,31507,1419
39050,59,957,1709,787,59292,170
39803,1,40,1665,32,2609,8
35047,10,263,1966,218,7708,45
27782,19,1236,2318,1030,22806,206
16089,3,259,2897,199,4772,60
7679,45,1702,3408,1354,7476,348
32025,0,69,2096,46,2408,23
35460,0,104,1944,86,9166,18
24144,6,415,2491,340,8108,75
41538,70,693,1493,557,7614,136
5916,38,782,3493,639,17504,143
45463,2,44,551,20,1621,24
42444,3,138,1325,95,5996,43
22945,11,390,2548,319,9203,71
3981,2,69,3581,60,5424,9
3859,1,46,3586,40,2097,6
15372,34,2048,2930,1624,4635,424
35544,27,1075,1937,875,10265,200
42118,12,238,1393,195,5978,43
13311,8,424,3071,325,35388,99
43700,25,363,977,312,5718,51
3579,19,340,3592,284,8659,56
1984,24,917,3620,709,5793,208
18444,23,1542,2782,1135,11094,407
38287,6,213,1760,178,5465,35
20691,109,3514,2673,2544,15903,970
19841,20,1155,2717,876,14472,279
7096,1,175,3441,147,12289,28
37599,7,566,1807,410,14071,156
8327,12,130,3355,114,3645,16
42462,32,735,1321,664,13742,71
25732,11,600,2420,497,4909,103
2261,0,30,3615,24,1810,6
14506,298,25799,2981,19743,114386,6056
18542,7,909,2778,686,10219,223
14210,27,1054,3004,811,14937,243
34265,28,737,2007,568,14902,169
30955,4,200,2151,149,5185,51
9579,25,1155,3278,890,13186,265
16778,31,2160,2862,1775,15223,385
13264,70,4815,3075,2999,41579,1816
29148,10,253,2242,200,4434,53
16474,14,531,2879,371,10162,160
10189,15,301,3249,216,9589,85
33977,30,1318,2016,1055,5674,263
7832,46,2722,3396,2144,21221,578
11755,742,74926,3166,50200,299634,24726
9272,20,920,3298,728,14324,192
44970,16,114,712,80,2050,34
5408,1,20,3519,16,3979,4
17253,58,2200,2835,1668,21278,532
11692,49,994,3169,795,37674,199
45290,26,322,595,265,6355,57
15650,2,41,2917,35,2304,6
30632,1,54,2165,44,3394,10
15182,1,50,2939,36,4683,14
8877,65,2023,3321,1535,11561,488
44765,11,178,775,132,4662,46
39038,3,89,1710,74,8016,15
6707,112,2587,3462,1767,28639,820
39840,45,2526,1663,1603,22248,923
6344,16,1087,3477,820,6249,267
38801,120,2096,1724,1623,20192,473
39026,5,107,1711,95,3479,12
33924,2,574,2018,431,13006,143
4287,3,84,3571,68,2539,16
18032,3,341,2800,288,7120,53
23468,23,612,2523,497,13310,115
28160,2,65,2297,48,2170,17
25505,31,579,2431,481,7103,98
43663,8,161,989,129,6649,32
39701,49,1800,1670,1439,30201,361
31847,9,621,2105,445,7279,176
13746,8,242,3037,191,2755,51
16342,1,77,2885,62,5808,15
41228,81,1726,1538,1206,22488,520
21176,1362,130301,2641,91414,385663,38887
25362,29,1326,2437,1037,11397,289
30136,41,1478,2194,1221,9119,257
46164,7,181,268,162,4241,19
3676,18,313,3590,266,4715,47
28788,0,123,2260,93,4609,30
9617,3,258,3275,219,4904,39
25604,285,9370,2426,6793,46956,2577
31890,3,78,2103,65,1921,13
3498,1,13,3594,10,2009,3
13320,16,582,3070,443,8434,139
40703,28,761,1594,587,14158,174
10207,4,341,3248,280,5830,61
10932,106,3018,3209,2336,48903,682
39139,0,64,1704,54,3363,10
28515,26,475,2276,337,5874,138
34512,20,697,1996,520,9257,177
13840,2,141,3030,106,4775,35
11582,1,81,3175,67,1610,14
39715,23,403,1669,314,5885,89
11690,16,1046,3169,839,6092,207
43849,11,96,940,76,2244,20
34530,0,73,1995,58,2092,15
29898,8,271,2204,200,4364,71
16612,5,466,2873,330,6035,136
19647,6,201,2728,175,3992,26
2218,6,114,3616,86,3100,28
33807,0,136,2021,118,2557,18
31599,19,732,2118,585,10092,147
26558,0,63,2382,53,2110,10
45513,78,690,538,529,13445,161
37239,14,483,1830,383,8360,100
42374,39,646,1341,514,9845,132
45764,27,243,432,213,3640,30
28527,3,575,2275,460,16756,115
44535,8,146,830,105,5887,41
28469,100,4849,2279,3454,29196,1395
15422,3,262,2928,201,6288,61
39376,4,56,1689,37,3089,19
19017,33,1544,2758,1233,17797,311
2327,33,2339,3614,1835,23006,504
19768,0,624,2721,457,12744,167
42540,68,2158,1305,1630,40307,528
10685,4,113,3222,73,2527,40
39541,2,33,1680,29,2117,4
34700,10,355,1985,285,8701,70
13199,11,572,3078,416,8967,156
5058,12,191,3539,140,3344,51
2740,122,4353,3608,3399,24035,954
19833,11,509,2718,403,13474,106
42068,69,2217,1402,1615,21631,602
4538,14,273,3562,204,13913,69
20324,20,1590,2692,1263,26018,327
2349,6,165,3614,118,7892,47
35454,52,1592,1945,1216,12041,376
12804,57,6288,3110,4734,65711,1554
36530,4,81,1873,73,3842,8
42362,2,77,1342,57,5925,20
34810,16,1395,1978,999,17679,396
39481,193,6967,1683,5047,63938,1920
4492,225,11352,3564,7909,83013,3443
40889,13,442,1576,337,4233,105
39318,0,24,1691,19,2805,5
9403,92,3114,3288,2066,11971,1048
4526,8,283,3563,242,4977,41
27400,11,664,2341,492,14011,172
24411,11,591,2479,406,14498,185
1828,8,103,3625,84,8609,19
13511,11,222,3055,177,5183,45
36985,7,273,1846,207,7857,66
18276,9,432,2789,325,4778,107
12783,3,116,3112,83,2086,33
24281,13,524,2485,437,6682,87
5703,132,3065,3504,2240,21369,825
23597,46,3227,2517,2547,26038,680
15596,13,408,2919,362,3643,46
31000,51,2713,2149,2005,32852,708
17929,120,5612,2806,4437,56566,1175
11466,1,14,3181,7,3043,7
2584,21,962,3610,680,17791,282
32841,4,231,2059,189,5702,42
41813,75,1898,1443,1461,40339,437
30274,15,496,2186,416,13454,80
17119,27,989,2843,780,6711,209
23098,2,113,2541,80,3279,33
18687,21,2254,2771,1461,22387,793
18122,7,277,2796,213,4622,64
35549,2,207,1937,165,5556,42
45370,12,65,574,53,2924,12
43516,3,41,1044,26,4053,15
39335,16,184,1691,135,3221,49
45024,12,125,697,103,7311,22
3858,10,462,3586,315,11739,147
28307,58,3165,2288,2470,18560,695
36892,49,817,1852,663,10603,154
8710,5,270,3330,215,6572,55
6084,2,142,3487,104,8577,38
43540,71,1575,1035,1240,30358,335
2865,9,351,3605,303,5990,48
17455,34,1545,2826,1101,13862,444
41456,29,588,1503,456,9512,132
18688,168,12657,2771,9289,80540,3368
43626,0,22,1002,16,2102,6
45323,3,56,585,42,2495,14
32086,28,898,2092,609,5235,289
40711,285,11308,1593,8039,66408,3269
36431,58,1266,1879,947,9572,319
40830,176,4239,1581,3131,39193,1108
9283,5,125,3297,110,5507,15
26380,6,310,2390,256,6240,54
24771,33,1216,2463,996,6755,220
39001,12,696,1712,492,14877,204
23145,6,287,2539,229,10949,58
28086,2,35,2301,30,3431,5
23283,1,45,2533,41,2890,4
40805,281,9394,1584,6021,82659,3373
14917,237,7699,2954,5389,41749,2310
40859,21,526,1578,406,10166,120
11650,1,24,3172,19,4698,5
14238,4,267,3001,206,4140,61
37125,182,5015,1837,3667,33274,1348
2330,487,15904,3614,10977,231177,4927
15615,31,1282,2918,993,12363,289
4718,33,1145,3555,876,7741,269
29378,59,2067,2230,1631,15374,436
29243,109,2566,2238,2099,22540,467
3793,0,29,3588,23,3130,6
14984,246,9619,2950,6670,53909,2949
28420,1,149,2282,122,4243,27
15860,14,440,2908,344,6967,96
27225,1,68,2352,53,3160,15
24214,1,89,2488,79,5398,10
2624,4,389,3609,299,6220,90
26295,7,423,2395,319,6682,104
17958,150,10453,2804,7727,53569,2726
8853,10,416,3322,344,12679,72
35210,12,324,1958,292,5759,32
28043,0,42,2303,35,2181,7
40327,28,1030,1629,828,12352,202
28151,324,14318,2298,10921,66708,3397
12262,3,149,3141,119,3223,30
46134,27,300,284,248,2913,52
1898,75,3583,3622,2836,21442,747
28226,9,149,2293,113,4165,36
5279,4,71,3526,52,4742,19
19398,8,388,2740,311,17352,77
39890,3,174,1658,150,7221,24
36567,129,5216,1872,3951,45615,1265
7582,48,1246,3413,972,12250,274
30800,9,813,2157,624,20972,189
33587,10,428,2030,331,7990,97
28751,9,447,2262,385,4321,62
9278,3,120,3297,92,9441,28
38358,5,112,1754,89,3374,23
1871,42,2202,3623,1701,26995,501
41185,45,1688,1545,1100,27463,588
40172,1291,38381,1641,25753,192668,12628
35387,76,806,1949,653,7374,153
37813,38,2229,1792,1559,21831,670
35548,3,166,1937,124,3579,42
17479,385,30802,2825,20449,140472,10353
9256,48,1989,3299,1551,14351,438
26481,4,361,2386,315,4450,46
39784,187,3830,1667,2954,23071,876
32980,1,44,2053,37,3414,7
4634,0,40,3558,32,2180,8
27330,3,282,2346,222,4425,60
31354,11,295,2131,246,2339,49
29379,1,62,2230,54,4523,8
10212,3,95,3247,84,2828,11
8040,92,560,3372,435,14843,125
17485,44,1340,2824,1063,24026,277
7645,3,219,3409,176,8666,43
13739,10,297,3037,223,6724,74
3912,55,2014,3584,1410,33392,604
10635,49,2093,3225,1681,13897,412
33034,2,70,2051,53,3193,17
21470,19,708,2626,557,6488,151
8258,1,10,3360,9,1668,1
14437,38,2010,2986,1572,25061,438
9321,555,24202,3294,17991,137793,6211
33791,2,172,2022,133,5353,39
35701,1,59,1925,42,3065,17
35265,444,17391,1954,13192,125759,4199
6081,93,4024,3487,3004,22686,1020
30431,8,161,2176,124,3278,37
10169,5,114,3250,96,4596,18
6905,17,927,3452,718,7514,209
28214,64,2096,2293,1514,14967,582
10886,7,453,3211,370,3547,83
28753,73,2156,2262,1681,30396,475
11891,3232,238833,3160,160136,389820,78697
20227,230,13087,2696,9366,38836,3721
5878,9,174,3496,136,8476,38
34925,16,457,1972,342,6946,115
24326,30,1830,2483,1412,22072,418
28999,8,232,2250,213,14262,19
21085,7,436,2648,359,8237,77
7257,468,237706,3433,82154,131052,155552
31404,39,1906,2129,1456,18264,450
41661,5,217,1473,140,11383,77
15917,3,540,2907,460,33419,80
10953,4,79,3208,66,9828,13
34580,15,531,1993,413,7449,118
15329,83,3100,2931,2323,25568,777
12889,22,987,3106,795,8325,192
25947,2,140,2410,113,6848,27
1118,1,59,3892,54,5685,5
29421,0,75,2228,58,2937,17
35207,42,1430,1958,1046,14388,384
15058,9,251,2945,199,8519,52
33128,22,463,2047,370,6017,93
44943,13,189,720,157,2585,32
4429,403,16558,3566,11928,54341,4630
39232,76,780,1697,604,12560,176
35359,32,360,1950,278,3853,82
31744,42,1136,2110,874,13968,262
27408,9,249,2341,210,6820,39
11054,153,24490,3203,14522,185854,9968
38620,3,166,1735,135,6595,31
41677,19,1946,1470,1195,18159,751
19447,42,2331,2737,1543,12110,788
22749,0,57,2559,40,2905,17
2030,15,2044,3619,1496,12673,548
19109,62,4103,2755,3214,29499,889
21846,16,1361,2606,1055,15122,306
12369,22,1592,3134,1061,15278,531
10850,0,33,3213,27,2893,6
10255,16,962,3246,743,14064,219
17001,9,499,2851,365,8037,134
35610,154,3846,1932,2679,30667,1167
43541,13,328,1034,252,6703,76
13426,40,3381,3063,2554,30202,827
6150,204,16808,3485,10533,47548,6275
8963,7,270,3316,207,6166,63
37260,6,162,1829,124,2829,38
25555,32,582,2429,437,5680,145
13105,258,16664,3091,12821,174364,3843
29769,12,335,2211,266,4342,69
969,15,480,3942,397,6691,83
36045,81,2256,1900,1735,42579,521
22662,8,416,2563,323,4066,93
4764,107,2195,3553,1632,43977,563
22610,1,49,2565,36,1665,13
23942,12,460,2500,384,21426,76
18127,10,660,2796,507,10124,153
35873,1,18,1912,16,6263,2
20993,209,7182,2653,5498,50567,1684
32848,4,261,2058,162,5014,99
33308,23,350,2041,251,6657,99
44119,10,183,897,165,5129,18
34731,13,147,1984,110,3363,37
45484,22,278,545,200,5284,78
31612,154,5543,2117,4359,44800,1184
36139,361,9219,1893,7451,45400,1768
34085,22,383,2013,305,4147,78
42326,5,127,1350,85,4889,42
11464,167,4330,3181,3271,54041,1059
37128,2,114,1837,96,4396,18
27064,157,12821,2361,8822,47822,3999
9014,24,491,3314,380,7709,111
39817,11,584,1664,419,8180,165
32201,1,91,2086,82,5436,9
4993,3,21,3542,17,2437,4
5856,1,203,3497,170,6615,33
18993,2,510,2759,402,7827,108
34779,8,465,1981,365,6592,100
35668,3,352,1927,274,11766,78
7753,9,351,3403,288,11679,63
2707,13,327,3608,242,7479,85
23030,21,653,2545,468,6020,185
35333,1688,65679,1951,45247,286327,20432
35953,4,301,1907,255,3862,46
35561,1,58,1937,51,3952,7
40056,9,256,1647,208,4874,48
38389,5,307,1753,237,3341,70
28243,38,910,2292,726,6098,184
16049,12,326,2899,250,9158,76
45372,38,520,574,377,6059,143
45592,17,182,511,86,3035,96
18154,7,427,2795,331,14370,96
39982,2,55,1652,38,2310,17
7555,13,539,3415,439,10832,100
36206,5,201,1890,165,3198,36
27727,25,1042,2322,760,8825,282
32137,22,1193,2090,825,8062,368
41530,80,1307,1494,920,15080,387
45249,123,1558,609,1379,16878,179
29042,25,2643,2248,1775,14946,868
17886,14,616,2808,468,9167,148
11235,2,97,3193,67,2601,30
21575,11,655,2619,499,7306,156
25909,182,13599,2412,9516,69269,4083
42591,75,1379,1297,1000,11880,379
38491,8,218,1746,179,4986,39
9731,47,1787,3271,1401,23957,386
28505,7,462,2277,353,5187,109
2139,13,380,3617,319,14189,61
38506,7,417,1745,333,3094,84
25055,49,2488,2450,1817,18700,671
39238,81,2037,1696,1599,18766,438
35954,29,1237,1907,1018,10983,219
42097,23,232,1396,181,5173,51
42802,4,105,1245,90,3186,15
2802,74,1403,3606,1109,10978,294
33635,41,911,2028,664,13597,247
31608,7,215,2117,164,2881,51
2161,50,1489,3617,1195,15755,294
2685,138,3912,3608,3110,32011,802
36189,22,500,1890,360,11800,140
21831,13,419,2606,359,5193,60
37272,157,1894,1828,1526,15606,368
25107,0,908,2448,689,13391,219
3931,155,5712,3584,3984,86975,1728
12048,517,26520,3153,18235,186379,8285
7904,3,65,3389,55,4149,10
45921,9,192,376,103,3181,89
38098,39,1884,1774,1363,10130,521
35831,2,54,1916,44,2871,10
35729,14,555,1923,464,5866,91
30959,11,344,2151,258,3940,86
4377,19,432,3568,330,12203,102
37377,1313,117087,1822,67615,376735,49472
3970,0,83,3582,38,1826,45
28450,1,56,2280,44,4717,12
19133,574,55231,2754,40889,277358,14342
32212,3,66,2086,58,2813,8
36405,2,44,1880,36,3053,8
35641,2,83,1930,72,8203,11
2879,11,336,3605,281,5262,55
9260,0,68,3298,55,4605,13
2985,12,344,3603,266,3279,78
32747,496,11590,2063,8896,47825,2694
26562,8,590,2382,455,6906,135
7615,26,880,3411,713,4771,167
13985,129,8855,3017,6352,160044,2503
27858,2,59,2314,47,2571,12
36401,9,211,1880,189,3070,22
12520,2,278,3126,222,3590,56
29275,19,401,2236,305,6514,96
5294,480,18914,3525,14049,219045,4865
26955,15,392,2364,333,4939,59
44031,7,114,911,99,2557,15
4394,353,16372,3567,12468,180078,3904
35042,16,501,1967,380,7819,121
13926,5,335,3022,240,8555,95
29312,38,1078,2233,813,12791,265
42147,52,937,1386,679,19880,258
1863,32,2108,3623,1647,35722,461
25708,6,130,2421,81,4295,49
13713,27,1096,3040,918,14615,178
14871,6,268,2956,217,8361,51
45897,30,421,388,343,5491,78
39179,11,264,1701,225,4973,39
43056,9,149,1181,112,3843,37
3481,0,16,3594,14,2111,2
19105,10,748,2755,438,13991,310
44804,8,82,760,61,4238,21
11518,11,516,3178,374,12433,142
30671,1,35,2163,26,5716,9
15952,133,8438,2905,6784,33799,1654
2829,142,9635,3606,6680,103815,2955
46414,7,157,167,122,1760,35
20403,1,226,2687,170,2891,56
18629,5,350,2774,273,4775,77
30243,57,2656,2187,2028,20696,628
27434,38,3264,2339,2575,29111,689
41632,22,807,1478,542,18435,265
19608,7,441,2731,325,18811,116
43737,27,432,966,333,7236,99
15697,787,33831,2915,22911,129752,10920
10486,19,1423,3235,1079,24792,344
23605,191,10725,2517,7585,68801,3140
35629,5,219,1931,129,4293,90
16291,108,7734,2888,5434,125720,2300
14090,28,630,3009,477,5247,153
22330,483,30474,2579,23017,153744,7457
7288,47,2042,3431,1602,41090,440
14981,2,138,2950,114,2508,24
13551,67,7084,3052,5353,82700,1731
16652,0,174,2870,124,4597,50
39576,8,376,1677,311,6690,65
36105,0,100,1895,83,3280,17
28548,140,3631,2273,2880,28373,751
29430,8,136,2227,112,5672,24
41843,32,756,1439,554,13207,202
45595,4,115,510,59,1838,56
8698,495,15123,3331,9692,96092,5431
7455,124,3910,3421,3011,67250,899
4583,38,1420,3560,1131,13046,289
41454,168,3675,1503,2819,24853,856
2482,36,1170,3611,870,8722,300
12387,0,30,3134,23,1255,7
30155,12,479,2193,402,9669,77
44559,22,241,828,167,4979,74
43616,7,201,1004,187,7559,14
37536,136,3040,1811,2296,21832,744
2125,6,113,3617,95,6521,18
8713,9,265,3330,226,7538,39
34407,120,3877,2001,3186,30565,691
3326,17,289,3597,235,12520,54
22894,167,5552,2551,4205,26626,1347
9301,9,211,3296,156,5756,55
19896,3,202,2714,146,6827,56
28537,915,56207,2274,38709,149330,17498
24872,23,957,2459,757,8067,200
14512,8,938,2980,710,13214,228
33169,0,77,2045,69,2602,8
9242,51,2462,3300,1904,24672,558
11178,218,4006,3196,2972,18787,1034
39580,4,171,1677,134,3788,37
25455,2,192,2434,167,4302,25
34740,5,490,1984,347,10575,143
17424,10,310,2827,240,3066,70
39513,3,52,1681,39,3863,13
6335,40,2763,3477,2042,26056,721
37948,22,575,1783,416,8944,159
23908,29,1414,2503,1138,9069,276
9592,11,316,3276,234,4764,82
21018,7,282,2651,231,2526,51
30241,24,1332,2187,1128,15250,204
2786,21,402,3607,286,5037,116
5084,6,102,3538,76,3094,26
16493,93,1541,2878,1072,14680,469
2925,48,1481,3604,1221,17613,260
35571,3,250,1936,182,4797,68
46363,0,29,199,29,1028,0
23255,8,188,2534,144,3091,44
14221,210,18612,3003,13692,88420,4920
26313,41,1090,2394,799,11154,291
5902,1205,60758,3494,36097,318120,24661
42595,15,827,1296,571,9606,256
9405,73,2981,3288,2393,22448,588
7345,5,270,3427,188,4529,82
42031,4,198,1409,143,6503,55
30051,57,3150,2197,2317,23328,833
9021,0,32,3313,28,2014,4
30587,4,239,2168,193,4958,46
35886,1,89,1912,75,8723,14
5767,20,348,3502,278,4768,70
1812,22,787,3625,617,17116,170
3716,29,773,3589,541,8028,232
5412,3,200,3519,150,3631,50
31710,18,309,2111,252,4148,57
17096,35,3047,2845,2357,12807,690
46382,3,30,190,20,1451,10
10956,84,1906,3208,1458,12709,448
2131,6,102,3617,90,4964,12
14400,6,106,2988,79,6939,27
3379,40,2703,3596,2129,25211,574
31995,11,278,2098,229,4082,49
12101,1,146,3150,118,9126,28
43527,4,55,1040,39,3662,16
37584,0,136,1808,114,4878,22
35473,3,83,1943,66,3966,17
40493,1,76,1612,63,7318,13
15951,176,8606,2905,6533,64030,2073
35260,69,1636,1954,1312,22547,324
1530,3,144,3696,109,3624,35
18053,14,524,2799,416,10892,108
40268,10,441,1633,359,10139,82
10134,72,1419,3251,1037,24017,382
27320,8,2051,2346,1554,24009,497
2345,6,478,3614,320,8517,158
19214,6,360,2750,295,4555,65
9087,1,77,3309,49,2586,28
45369,25,210,574,172,4141,38
25405,1,18,2436,15,857,3
5473,8,175,3516,138,4097,37
45176,2,22,631,16,2407,6
35900,16,256,1910,222,7142,34
39175,0,42,1701,36,2605,6
43312,29,454,1105,345,5926,109
37685,8,94,1802,76,1750,18
2009,61,1538,3619,1271,16362,267
38707,19,669,1730,557,6361,112
6492,272,14814,3470,9728,143524,5086
24558,9,624,2472,504,14010,120
16805,11,370,2861,295,6154,75
10466,126,4124,3235,3284,31345,840
38336,633,22845,1756,17014,110656,5831
24316,26,621,2484,500,22416,121
33988,2,75,2016,63,3191,12
5351,10,128,3522,100,3030,28
42598,32,1037,1296,793,15114,244
45112,40,629,654,492,4130,137
32698,52,2084,2065,1652,17520,432
43406,52,598,1074,426,7582,172
13647,3,236,3045,179,4642,57
3338,41,570,3597,466,6059,104
14530,3,187,2979,151,3206,36
26319,41,752,2394,577,8152,175
36000,314,6050,1903,4378,76984,1672
25895,9,354,2413,286,4379,68
25551,68,3088,2429,2260,31128,828
11691,20,1901,3169,1511,27136,390
8394,102,7166,3351,5470,28167,1696
4343,31,739,3569,441,9889,298
9652,1,74,3273,60,4665,14
12484,26,1405,3128,1100,13960,305
27387,1,42,2341,36,8070,6
20394,46,3734,2688,2960,34784,774
23596,0,48,2517,42,4384,6
7597,70,1401,3412,1118,23398,283
18385,646,34706,2784,26218,161642,8488
12466,2726,168529,3129,116173,616207,52356
32275,1,127,2083,106,8184,21
3281,214,7054,3598,5243,27562,1811
20524,33,1795,2681,1346,5469,449
26610,78,3804,2380,3009,33460,795
38121,44,2759,1771,1905,35785,854
8216,18,630,3363,465,8898,165
14293,4,93,2997,79,4179,14
32738,89,3802,2064,2833,25118,969
7706,241,15338,3406,11305,94533,4033
7140,2,46,3438,34,2888,12
21673,75,3977,2613,3022,28532,955
5522,76,4905,3514,3539,45076,1366
13459,26,1357,3058,845,15481,512
4637,7,109,3558,88,2451,21
38798,21,322,1725,263,2622,59
8080,83,2829,3371,2251,28043,578
43536,44,674,1036,563,18494,111
42094,11,402,1397,318,8917,84
34806,12,408,1979,328,5984,80
10958,31,3066,3208,2265,29637,801
42136,15,438,1390,354,4629,84
12274,7,431,3140,360,14835,71
41894,79,1617,1430,1241,34219,376
6882,15,463,3453,347,9366,116
14720,591,24783,2966,19433,84497,5350
5128,19,387,3534,329,10919,58
25562,17,619,2428,463,4698,156
26978,0,0,2364,0,34854,0
41383,4,149,1514,111,3893,38
9574,36,1727,3278,1365,8910,362
34518,6,280,1996,241,5011,39
31493,12,442,2123,361,5539,81
39044,11,327,1710,241,10375,86
36672,17,508,1865,411,5065,97
19490,36,1115,2735,841,8307,274
17065,0,103,2846,86,6255,17
3559,0,165,3592,126,8823,39
34248,18,880,2008,661,6903,219
24589,459,18425,2470,13405,58845,5020
5574,0,113,3512,89,3966,24
14527,131,9751,2979,7662,77108,2089
28021,6,293,2305,238,5357,55
43724,279,3171,969,2673,27477,498
33177,3,137,2045,109,3760,28
5813,29,619,3499,459,7128,160
4127,4,126,3577,93,4527,33
17686,3,107,2816,92,3388,15
29056,3,272,2247,222,12834,50
13034,43,3132,3096,2309,45324,823
37424,19,465,1819,358,9032,107
28931,27,1283,2253,976,7097,307
36476,4,151,1877,125,4286,26
3117,2036,210633,3601,97128,1054033,113505
3487,145,9501,3594,6482,49997,3019
13084,34,1194,3093,1013,7919,181
38727,12,483,1729,363,10056,120
29946,2,138,2202,110,1578,28
26568,12,470,2382,376,7159,94
40660,131,2278,1598,1633,31899,645
4230,17,292,3574,212,18562,80
24056,3,190,2496,147,2830,43
25003,0,2307,2453,1823,27656,484
7162,118,7573,3437,5574,37372,1999
36138,80,3863,1893,2875,28913,988
38344,3,97,1755,79,3427,18
12837,2,517,3108,402,14298,115
3806,278,28937,3587,19636,67450,9301
40970,7,185,1570,151,4595,34
29926,33,2651,2203,1885,10574,766
30446,37,1754,2175,1222,18787,532
43452,9,193,1063,145,4799,48
18286,0,82,2789,60,3113,22
34608,0,72,1991,45,4755,27
27323,0,75,2346,64,2366,11
25512,28,569,2431,425,4504,144
15518,24,888,2923,673,8009,215
29019,0,147,2249,107,4499,40
10734,4,394,3219,321,10786,73
39465,0,66,1684,53,3740,13
19395,18,560,2740,350,4047,210
33996,791,17581,2015,13477,74485,4104
22989,33,3200,2546,2279,35169,921
23160,3,114,2538,93,2602,21
21409,16,863,2629,722,12095,141
3305,5,141,3597,118,4731,23
37294,3,248,1826,210,13867,38
21440,24,2264,2627,1806,21690,458
5427,5,112,3518,86,7804,26
9857,162,161115,3264,59870,105979,101245
32329,6,200,2081,168,5425,32
22152,59,4154,2587,2822,47901,1332
23686,4,454,2512,343,8410,111
40820,8,157,1582,127,4526,30
31408,41,1045,2129,793,13710,252
9051,301,13395,3312,9874,58884,3521
7207,77,4486,3435,3281,13652,1205
14548,21,995,2978,761,10677,234
18071,164,10585,2798,7528,52381,3057
41122,78,549,1552,428,5467,121
20372,255,35568,2689,23498,118096,12070
23750,14,395,2510,285,5843,110
3788,27,248,3588,207,9187,41
41157,14,209,1549,159,3122,50
12728,181,18143,3115,12144,91121,5999
1557,5,24923,3687,7277,1927,17646
25989,76,2422,2408,1868,13754,554
27275,130,6495,2349,4569,68066,1926
1062,4,76,3909,67,3444,9
25439,0,0,2434,0,2336,0
46391,6,113,184,93,1741,20
17642,14,962,2817,752,5048,210
41159,3,281,1549,218,7953,63
39666,44,546,1672,416,10466,130
36863,3,196,1853,169,3456,27
2394,90,2824,3613,2364,21554,460
45402,10,163,565,115,2975,48
14074,94,4198,3011,3265,38172,933
9355,6,73,3291,62,8466,11
25186,0,12,2444,10,1274,2
17701,43,6578,2815,4902,48804,1676
38677,4,76,1732,64,4997,12
5004,0,142,3542,103,2547,39
33427,6,432,2037,350,7562,82
35883,18,2009,1912,1617,20596,392
33419,125,5550,2037,3819,48316,1731
14911,82,2988,2954,2318,20234,670
45314,167,3463,588,2909,28005,554
44738,19,331,782,245,5354,86
32922,14,566,2055,428,5426,138
6647,98,1624,3464,1320,26592,304
22718,5,235,2560,183,8146,52
8367,1,22,3353,19,1165,3
37415,2,103,1819,82,7266,21
13212,21,718,3078,598,28515,120
6258,18,195,3481,169,5652,26
29272,2,53,2236,47,3465,6
6356,3,125,3476,91,12557,34
19278,23,825,2746,658,31265,167
4652,32,505,3558,411,9041,94
32021,21,780,2096,528,10819,252
29311,16,608,2233,444,5046,164
28175,2,215,2296,190,3139,25
18503,7,461,2779,389,8666,72
12655,5,151,3119,117,2789,34
4040,156,8839,3580,6254,44906,2585
4055,18,746,3579,569,14732,177
9439,106,4460,3286,3387,63022,1073
19285,70,3136,2746,2305,13398,831
3526,7,151,3593,134,3035,17
20717,47,1704,2671,1271,10419,433
45052,16,247,684,193,4617,54
21220,12,447,2638,311,4718,136
17997,0,601,2801,469,17340,132
30866,25,788,2154,591,8774,197
14048,83,3041,3012,2453,52517,588
40425,16,428,1619,306,8214,122
25156,203,7805,2446,5001,45313,2804
30967,5,68,2151,51,2427,17
37773,43,933,1796,786,14174,147
33658,4,64,2027,56,3446,8
31529,13,431,2121,346,6963,85
43097,134,3672,1167,3165,40668,507
25331,128,5961,2438,4547,45880,1414
2848,46,1853,3606,1327,33946,526
3439,20,668,3595,505,16135,163
32309,0,48,2082,41,6708,7
26264,2,451,2396,314,4736,137
19659,14,819,2728,651,16935,168
2645,4,70,3609,48,2060,22
9421,26,808,3287,578,12107,230
24546,57,3030,2473,2157,17984,873
40874,111,3848,1577,2818,40640,1030
15968,21,2021,2904,1533,31735,488
40846,5,106,1579,78,3770,28
22556,48,3598,2567,2348,15929,1250
32020,8,403,2096,307,11729,96
41720,2,37,1464,35,2498,2
12975,12,514,3099,427,8573,87
35681,1,92,1926,78,5592,14
10194,218,9659,3248,6862,64955,2797
44388,6,66,854,46,2702,20
32237,4,49,2084,42,2984,7
7171,3,165,3436,134,4830,31
33558,2,45,2031,28,3036,17
32827,0,181,2059,145,6982,36
45735,16,155,442,132,2301,23
6025,42,1383,3489,1065,22022,318
14635,28,1245,2972,967,11747,278
29220,13,579,2239,434,21063,145
6910,10,245,3452,188,4598,57
36810,4,211,1857,170,3040,41
21271,2,64,2636,54,1258,10
37170,8,316,1835,171,8062,145
42623,7,143,1290,125,5172,18
28139,8,293,2299,237,7323,56
15239,4,152,2936,123,5628,29
9967,54,6020,3259,4570,14786,1450
18521,1,148,2779,115,3555,33
19388,1178,111481,2741,70808,558769,40673
29911,81,4754,2203,3444,36227,1310
25866,29,582,2414,479,8263,103
17632,3,237,2817,180,10238,57
7985,10,249,3380,210,8304,39
30169,24,544,2192,462,9148,82
12141,15,788,3147,663,9426,125
28838,2,84,2258,74,1965,10
23307,0,59,2531,47,2482,12
6659,2,16,3464,13,2588,3
28034,2,75,2304,58,3334,17
6140,56,3174,3485,2401,114741,773
25400,28,1895,2436,1520,19288,375
41076,250,5303,1558,3627,37580,1676
39649,13,444,1673,353,8333,91
36496,0,31,1875,25,3270,6
32965,6,178,2054,132,5159,46
36063,13,324,1898,260,11515,64
19233,11,360,2749,294,3519,66
31780,6,394,2108,324,3712,70
42886,73,2251,1228,1721,21479,530
16047,14,639,2899,486,6664,153
36451,15,300,1878,265,8328,35
35823,1,108,1916,90,3358,18
23690,55,1067,2512,866,8220,201
27251,10,487,2350,416,6484,71
30353,4,115,2181,89,4606,26
1954,99,4798,3621,3686,31853,1112
32144,31,1209,2089,984,15175,225
27652,2,260,2326,176,5203,84
4695,266,14929,3556,10589,50532,4340
31512,3,140,2122,110,3551,30
43466,4,123,1059,93,3352,30
28009,31,437,2305,369,4971,68
25709,99,3403,2421,2645,36448,758
13300,22,605,3072,437,7197,168
41835,202,4715,1440,3378,41631,1337
23372,248,16026,2528,11293,67038,4733
20054,478,21518,2706,15795,146993,5723
12615,7,409,3121,315,8027,94
41430,7,243,1507,170,7101,73
7850,17,389,3395,323,5423,66
13067,170,12026,3094,8443,101612,3583
42573,133,3193,1300,1934,40540,1259
2998,5,258,3603,216,6737,42
29559,774,28631,2221,20410,145896,8221
11094,2,137,3200,100,5273,37
42865,107,5278,1234,3962,53041,1316
8051,29,571,3371,416,6209,155
37018,15,552,1844,444,10287,108
14346,315,7014,2992,5548,37791,1466
19340,24,1310,2743,1047,17968,263
27639,8,432,2327,325,12019,107
41021,0,23,1566,20,1527,3
37397,3,113,1821,88,5429,25
21294,0,244,2635,183,6823,61
19696,69,2742,2726,1970,18512,772
15977,14,958,2903,744,30724,214
35795,1,162,1918,138,4716,24
28395,61,3643,2283,2664,43723,979
5107,30,441,3536,385,6249,56
20474,147,8540,2684,5473,42707,3067
38181,0,106,1768,76,8868,30
6252,197,6747,3481,5305,34893,1442
27967,20,522,2307,442,3424,80
11208,678,36421,3194,26171,155018,10250
8977,1,37,3315,33,1869,4
6671,46,1627,3463,1299,28021,328
10112,17,214,3252,167,4725,47
19950,6,137,2712,112,4552,25
2185,35,1167,3617,903,18459,264
26320,1,89,2394,66,4300,23
2855,14,327,3606,251,8926,76
5453,1,68,3517,52,3090,16
12154,1,93,3147,73,7490,20
2094,8,383,3618,287,6369,96
40854,0,74,1578,52,4779,22
32975,10,294,2054,249,8306,45
36018,92,4444,1902,3152,42078,1292
18141,2,108,2795,82,4899,26
39113,125,2460,1705,1929,20972,531
34368,25,800,2003,566,7811,234
10887,4,97,3211,73,3600,24
19905,60,1962,2714,1560,8614,402
41073,26,538,1558,391,5476,147
35942,31,496,1908,417,5457,79
16509,8,185,2877,132,5462,53
15446,313,20327,2927,13560,95255,6767
6438,0,19,3473,14,1333,5
8799,1,35,3325,32,2106,3
14097,12,613,3009,502,9984,111
45107,4,50,655,38,2809,12
43714,32,187,973,163,2746,24
41223,80,3094,1539,1496,33059,1598
24124,27,1686,2492,1280,23836,406
20202,19,197,2697,156,6737,41
9238,84,1450,3300,1106,36984,344
4066,34,900,3579,728,16675,172
5330,5,52,3523,51,5244,1
27915,24,379,2310,286,3803,93
42495,238,5608,1315,4067,39036,1541
37496,2,124,1814,88,2566,36
22095,5,264,2589,211,2765,53
9412,1169,51117,3288,31697,182546,19420
33609,1,23,2029,20,2361,3
35322,72,853,1952,646,6834,207
5434,2694,188736,3518,129237,466913,59499
37727,20,561,1799,453,9960,108
11107,666,24983,3200,18238,118131,6745
10630,0,0,3226,0,4851,0
32121,12,303,2090,225,4529,78
29395,9,310,2229,260,5128,50
35901,5,274,1910,219,7640,55
24174,53,2537,2490,1825,47304,712
38310,11,211,1758,174,3818,37
27516,8,314,2334,237,2717,77
2149,41,1272,3617,1039,15406,233
12824,0,205,3109,162,6716,43
23368,150,5552,2528,4405,32735,1147
39755,8,290,1668,197,4841,93
43725,14,244,969,183,4792,61
28551,5,88,2273,74,2939,14
36724,22,571,1863,478,14507,93
23443,3,194,2524,159,11234,35
8032,27,469,3372,379,10679,90
8759,140,6161,3327,4610,48986,1551
45799,11,132,422,115,4223,17
40389,180,2986,1622,2348,17545,638
27247,13,1021,2350,798,11649,223
2182,2217,112758,3617,76105,728605,36653
17884,19,1379,2808,1036,15632,343
19573,2,39,2732,33,1647,6
41486,73,1214,1499,820,19109,394
35688,98,3697,1926,2763,16632,934
8962,311,16365,3316,12248,97292,4117
20382,392,19565,2689,14465,110001,5100
13674,0,496,3043,367,7757,129
44481,8,82,842,64,2459,18
7444,8,388,3422,319,8857,69
41328,20,428,1521,326,4671,102
37383,31,536,1822,393,6030,143
35510,14,182,1940,154,5492,28
11028,8,233,3204,150,11571,83
24569,10,465,2471,351,5391,114
22387,3,134,2576,107,1887,27
26310,32,804,2394,641,9015,163
29215,3,276,2239,232,3902,44
25024,5,303,2452,227,2325,76
43950,43,341,925,275,3062,66
23874,11,376,2504,270,7944,106
17873,20,1130,2809,780,9047,350
16954,3,81,2854,66,3556,15
25521,4,107,2430,92,4032,15
10821,6,211,3215,153,10487,58
43703,51,866,975,680,10179,186
42190,106,1211,1376,897,17280,314
37221,57,705,1831,539,6324,166
41829,9,664,1440,519,17324,145
16403,17,1538,2881,1215,12116,323
15937,8,514,2906,399,6736,115
40924,1,29,1573,24,2318,5
32900,0,85,2056,62,4098,23
40826,180,4524,1581,3306,47348,1218
5634,5,392,3508,293,10938,99
20331,4,412,2692,331,12145,81
16156,12,575,2894,437,5931,138
37507,21,707,1813,590,11549,117
2240,7,100,3616,87,2982,13
24663,10,609,2467,460,8014,149
44070,3,31,906,21,1588,10
29364,16,1501,2231,1238,12664,263
6461,0,71,3472,58,3635,13
39983,16,625,1652,490,25533,135
2392,122,2912,3613,2285,44459,627
38151,0,16,1769,14,4803,2
40640,1,63,1599,50,3772,13
1488,10,246,3711,210,4987,36
45141,71,1186,640,878,6654,308
13903,34,1331,3023,976,9764,355
39461,161,3603,1684,2796,18998,807
7745,40,971,3404,745,14831,226
26129,25,790,2403,591,7129,199
2922,232,7355,3604,5517,34332,1838
7545,16,466,3416,380,8224,86
25601,19,1058,2426,884,15661,174
36091,29,1621,1896,1218,14170,403
31591,41,1335,2118,988,18870,347
31583,25,472,2118,396,3833,76
40120,3,91,1644,67,3095,24
6185,31,1096,3484,859,29113,237
10295,55,2208,3244,1444,13983,764
20363,30,1206,2690,867,10356,339
17328,6,413,2832,280,3310,133
5429,117,3038,3518,2191,11699,847
34383,109,3940,2002,3001,45778,939
11134,4,154,3199,111,2606,43
26392,7,209,2390,172,5180,37
31065,13,296,2146,231,4028,65
23672,36,4741,2513,3383,61532,1358
10866,7,523,3213,434,10621,89
14229,63,2933,3002,2322,29059,611
37518,7,433,1812,283,8158,150
43776,14,238,952,168,5372,70
42900,10,229,1225,185,8322,44
12794,11,259,3111,203,2818,56
37964,66,2392,1782,2011,31254,381
23585,98,3303,2517,2698,18031,605
31211,0,179,2139,65,3327,114
6931,1,24,3451,18,1686,6
9184,5,225,3302,186,2341,39
3243,2,118,3598,100,4102,18
15146,64,1492,2940,1160,9360,332
10251,5,72,3246,63,5300,9
7752,28,698,3403,523,8798,175
36192,14,399,1890,314,9275,85
3772,54,1812,3588,1353,23607,459
45960,145,2356,355,1948,26048,408
2280,249,11615,3615,8905,70214,2710
41872,21,451,1434,378,21095,73
22179,3,177,2586,143,7171,34
31182,1,181,2140,153,3699,28
8122,12,311,3369,235,2690,76
29089,1,41,2245,37,1626,4
19496,101,4766,2735,3638,31379,1128
35652,19,287,1929,236,4488,51
40505,9,371,1611,303,7257,68
20329,7,389,2692,308,8851,81
37676,46,1719,1803,1304,12336,415
21878,47,1702,2603,1329,11922,373
42755,212,2309,1260,1874,17510,435
5243,308,10672,3528,7852,65872,2820
24382,274,18108,2481,12132,76476,5976
3930,14,585,3584,460,6461,125
25574,1248,97165,2428,67510,289703,29655
19473,206,7996,2736,5675,27464,2321
23778,8,290,2509,215,5148,75
39028,20,1890,1711,1443,15228,447
42295,5,249,1355,189,2943,60
44732,71,1115,784,968,10704,147
46338,6,199,210,143,1476,56
19101,72,2879,2755,2198,45238,681
45643,43,556,486,338,7044,218
22772,22,789,2557,615,3301,174
19976,40,2351,2709,1865,20892,486
45596,19,346,510,261,5779,85
7677,60,3102,3408,2430,25894,672
8954,344,25940,3316,19079,52475,6861
7792,18,336,3399,257,4361,79
3979,1308,70201,3582,48366,206091,21835
17906,6,610,2807,482,19635,128
43767,26,301,956,257,3935,44
46457,2,58,146,57,1275,1
23184,11,931,2538,714,12793,217
15904,42,2500,2907,1915,28772,585
9363,352,14077,3291,10407,92791,3670
8029,10,271,3372,213,3434,58
45784,2,15,426,12,939,3
10079,248,11787,3253,9173,38558,2614
8861,351,25926,3322,17488,111095,8438
36032,41,1046,1901,852,14972,194
41497,50,901,1497,651,8234,250
3823,14,529,3587,442,10200,87
39804,3086,123054,1665,87055,291382,35999
30432,11,353,2176,261,5459,92
16292,14,575,2888,448,7948,127
2833,36,789,3606,609,19412,180
11563,2,74,3176,58,1581,16
33204,0,63,2044,53,6815,10
10820,33,604,3215,451,5521,153
30192,47,685,2190,552,4791,133
4694,3,397,3556,328,6473,69
2156,185,5485,3617,4301,33685,1184
2135,24,399,3617,308,10351,91
20882,5,208,2660,154,2683,54
22581,10,584,2566,453,8661,131
5499,9,401,3515,319,6892,82
1059,6,222,3909,182,10645,40
5300,12,107,3525,81,3184,26
5394,6,310,3520,251,8977,59
37875,69,651,1787,494,6731,157
4102,8,344,3578,268,11485,76
1608,5,380,3679,310,12484,70
15132,12,649,2942,560,13727,89
3533,9,206,3593,167,6174,39
20844,5,173,2663,143,5193,30
4419,56,1605,3566,1310,12517,295
28114,9,697,2300,536,20862,161
23237,77,6504,2535,4638,36697,1866
10129,29,1393,3251,1021,11650,372
33951,37,1676,2017,1282,28896,394
17383,6,445,2829,359,10069,86
17940,48,3592,2805,2615,40687,977
33907,16,466,2018,380,9259,86
11268,0,26,3191,20,1798,6
40063,459,9692,1646,7013,54767,2679
6266,4,60,3480,49,3538,11
14311,6,233,2995,195,12291,38
25738,9,892,2419,713,9336,179
37512,7,363,1813,292,4418,71
7795,5,133,3399,92,7039,41
5430,10,138,3518,121,6444,17
38635,2,86,1734,63,4095,23
6981,832,53394,3447,35705,170259,17689
39734,8,451,1669,296,15395,155
37434,42,626,1818,504,11938,122
19065,2,221,2756,199,10323,22
43130,2,118,1158,87,6006,31
5561,32,1381,3512,1068,10744,313
46188,0,14,259,10,971,4
2932,1,82,3604,64,4470,18
1807,63,3547,3626,2666,32885,881
28340,57,8054,2286,5976,29454,2078
45965,14,101,354,77,2724,24
22235,22,1157,2583,927,15419,230
2621,20,706,3609,591,7737,115
8987,2,135,3315,111,8941,24
9045,3,111,3312,92,5419,19
37158,2,134,1835,104,7196,30
32444,20,952,2076,794,9344,158
13996,6,218,3016,173,4351,45
18998,82,5011,2759,3653,31824,1358
1944,31,859,3621,668,27835,191
20415,6,116,2687,97,2728,19
16654,21,1481,2870,1200,22245,281
34502,3,243,1997,210,3874,33
14853,129,3576,2957,2636,23025,940
42872,1,65,1232,41,2737,24
11620,9,282,3173,219,5350,63
40036,222,6697,1648,4734,44770,1963
19618,1,125,2730,98,2582,27
35802,7,321,1917,234,10753,87
37033,142,3630,1843,2406,48901,1224
30400,12,1139,2178,894,25045,245
27413,9,245,2340,189,3457,56
38057,10,350,1776,280,5152,70
19155,12,1015,2753,737,7758,278
29756,8,412,2212,355,6952,57
43439,6,146,1063,81,2722,65
28639,7,337,2268,251,10041,86
14283,42,1980,2998,1621,37507,359
38415,5,306,1751,246,5667,60
20802,220,7871,2666,5048,68504,2823
15363,5,205,2930,164,4564,41
2133,14,557,3617,423,6352,134
37575,3,81,1808,69,2145,12
16958,32,2036,2854,1589,25416,447
39438,7,105,1685,86,5031,19
30618,113,6872,2166,4718,44774,2154
4056,41,1185,3579,938,14448,247
27433,11,357,2340,277,2749,80
38472,5,360,1747,294,2756,66
34308,15,681,2005,564,12521,117
8696,42,1195,3331,982,27429,213
31675,4,134,2113,118,2795,16
2939,2,65,3604,55,4744,10
22089,22,611,2590,465,4820,146
18704,40,2539,2771,2077,15695,462
9047,10,1216,3312,958,27728,258
23960,36,1566,2500,1237,11136,329
2196,62,2120,3616,1541,13746,579
40902,10,700,1575,519,23348,181
39906,71,1508,1657,1141,23728,367
45268,5,58,602,39,2918,19
7688,8,176,3407,131,2722,45
22290,12,972,2580,754,18700,218
14782,9,299,2961,238,7664,61
34314,123,4040,2005,3209,43893,831
32438,4,156,2076,116,3129,40
43442,131,1515,1066,1183,8585,332
32483,5,321,2074,254,4770,67
22114,21,1313,2588,1042,14440,271
12864,14,849,3107,639,10817,210
36057,9,252,1898,190,3665,62
28935,6,145,2253,121,2452,24
23548,54,2743,2520,1902,9199,841
30184,6,226,2191,176,6142,50
2959,0,71,3604,61,6713,10
30028,497,22216,2199,16374,126322,5842
23568,30,1615,2518,1222,19342,393
35721,0,75,1923,66,3208,9
38170,44,3336,1768,2698,12782,638
23541,41,3646,2520,2865,20262,781
4845,39,1402,3550,1061,27846,341
16270,6,365,2889,296,4643,69
36224,154,2297,1889,1909,20408,388
5658,0,60,3507,53,2737,7
38949,7,243,1715,181,11347,62
40252,14,206,1635,171,8371,35
6944,230,12099,3450,8244,72414,3855
1843,606,19372,3624,11351,76089,8021
9727,132,5557,3271,4185,39238,1372
41946,21,314,1422,240,7126,74
24321,4,192,2484,155,4155,37
16469,1,52,2879,42,6803,10
42931,49,904,1215,688,14100,216
39485,26,1214,1683,851,10294,363
39901,1,45,1657,36,4027,9
42436,2,121,1326,93,2486,28
18586,29,770,2776,555,9517,215
29188,19,794,2241,626,11764,168
38291,96,3391,1760,2543,37839,848
39955,19,236,1654,190,5606,46
25573,28,835,2428,642,9076,193
39768,0,0,1667,0,4962,0
2353,18,440,3614,280,16580,160
8790,25,1272,3325,1088,28982,184
34035,2,66,2014,56,2824,10
20530,80,2526,2681,1894,11385,632
7302,1,29,3430,22,2563,7
32695,28,685,2065,482,8335,203
17720,13,1079,2815,835,9840,244
31205,6,135,2139,111,11799,24
8508,35,1241,3343,971,10233,270
43485,42,1076,1054,731,10482,345
2535,6,345,3611,283,4740,62
13225,6,94,3077,67,2209,27
9312,12,426,3295,334,9451,92
27823,10,324,2315,264,7675,60
14821,35,1557,2959,1273,16749,284
14623,9,281,2973,232,12349,49
31187,2,198,2139,158,4900,40
27734,27,1296,2321,1099,12113,197
8403,61,1623,3350,1193,14376,430
43488,4,45,1053,39,6321,6
44422,16,129,851,100,3976,29
3690,1,37,3590,27,5899,10
37819,77,4016,1792,3094,25714,922
42845,15,791,1238,484,10720,307
31979,32,1530,2098,1139,11109,391
32324,9,463,2081,344,7148,119
35741,21,336,1922,274,4658,62
34631,63,2806,1990,2097,37143,709
40384,11,291,1622,230,10683,61
9229,38,1441,3300,1127,54232,314
30886,10,266,2154,212,7082,54
13838,519,23080,3030,17533,114698,5547
26892,669,58487,2367,41973,145766,16514
7913,5,152,3388,121,5577,31
3125,2,47,3601,38,4219,9
25509,57,2803,2431,1989,30357,814
10398,20,467,3239,367,10594,100
45794,34,345,424,267,4199,78
27893,7,219,2312,193,5382,26
42149,205,4537,1386,3325,23953,1212
19069,4,123,2756,102,1779,21
45996,97,896,343,720,7354,176
2834,7,198,3606,174,4493,24
27884,4,135,2313,119,7866,16
14294,14,1044,2997,759,33879,285
35241,8,178,1955,136,3051,42
42728,50,1635,1267,1167,11030,468
28942,4,205,2253,168,12720,37
1822,51,8780,3625,6395,31866,2385
10715,240,10516,3221,8056,40639,2460
39930,16,443,1655,360,7978,83
42776,8,133,1255,98,2598,35
18278,27,757,2789,575,5121,182
28265,3,83,2291,66,4113,17
6778,104,7435,3458,5123,58693,2312
38160,19,664,1769,472,10935,192
27026,15,891,2363,694,14145,197
7505,11,662,3418,534,6567,128
19567,4,539,2733,399,11560,140
39916,13,727,1656,521,11197,206
23812,5,218,2508,168,3682,50
34543,167,4773,1994,3606,31452,1167
10206,25,736,3248,557,15366,179
35800,48,758,1917,560,8226,198
5655,3,41,3507,33,3393,8
4357,31,418634,3569,127497,8790,291137
28397,2,71,2283,62,2502,9
34587,23,552,1992,389,6950,163
46421,7,90,166,75,1453,15
2472,11,189,3612,152,10077,37
14064,16,803,3011,651,15610,152
2775,81,3642,3607,2931,34901,711
7234,81,2683,3434,2110,19299,573
35097,416,24425,1964,18657,96127,5768
28337,20,915,2286,705,10956,210
15980,60,1304,2903,1010,7699,294
7717,97,2028,3405,1642,22500,386
39362,88,3458,1689,2593,19932,865
46339,7,58,210,53,1660,5
41394,65,1661,1513,1264,24837,397
5086,31,664,3538,537,6172,127
11194,9,517,3195,401,4509,116
7174,1,142,3436,107,9442,35
36636,1,38,1867,34,2754,4
18616,312,13985,2775,9390,85972,4595
19215,7,339,2750,267,3323,72
45335,69,922,582,793,5457,129
3066,2004,134060,3602,84759,513711,49301
37305,13,308,1826,268,3016,40
9666,4,0,3273,0,15807,0
15610,2,108,2918,78,2162,30
44921,15,330,726,269,5671,61
13033,409,14414,3097,10400,77341,4014
46387,26,246,186,209,4338,37
10210,62,3334,3247,2276,18318,1058
46235,0,11,248,7,748,4
19397,3,238,2740,176,9511,62
4547,4,291,3562,146,4918,145
38035,10,263,1778,197,4741,66
23636,21,1682,2515,1116,27193,566
8338,4,105,3354,84,3199,21
39848,22,620,1662,461,9032,159
41501,16,293,1496,229,7739,64
9778,41,2321,3269,1668,17237,653
3020,3,99,3602,79,5362,20
38920,18,682,1717,508,12407,174
13533,27,1140,3053,893,23378,247
31567,211,7027,2119,5072,52327,1955
39144,36,651,1703,520,7184,131
45357,82,1617,578,1084,15465,533
16769,50,2548,2863,1833,18996,715
40766,136,4172,1588,3206,25273,966
8453,83,3839,3347,3046,18968,793
22430,0,11,2575,10,1964,1
12313,16,288,3138,213,4185,75
11712,1,19,3168,12,2648,7
31928,3,104,2101,84,8147,20
24896,300,20739,2457,15305,96931,5434
46021,47,462,330,357,5725,105
2602,14,776,3610,646,40989,130
16975,418,24262,2853,16822,148562,7440
36407,142,3325,1880,2442,30838,883
16677,553,25154,2869,19745,69865,5409
19415,19,3402,2739,2454,22815,948
11506,7,265,3179,213,9420,52
20328,354,14690,2692,9986,64141,4704
14380,3,107,2989,91,17316,16
26069,11,471,2405,403,22472,68
9419,8,239,3288,196,8356,43
24603,5,102,2469,83,3982,19
38486,6,192,1746,160,10024,32
1356,5,109,3799,97,2856,12
25653,5,226,2423,177,5449,49
34600,65,2315,1992,1752,26959,563
22885,11,1441,2552,1146,12921,295
3068,40,1490,3602,1102,25506,388
11458,671,28083,3182,22024,112701,6059
38509,1,72,1744,63,4901,9
11259,26,1251,3191,963,28249,288
4065,1530,48677,3579,33626,188655,15051
14278,17,817,2999,657,19176,160
12447,36,1476,3130,1239,22000,237
21650,6,705,2615,543,8246,162
6968,19,571,3448,425,8454,146
4585,3,37,3560,29,3657,8
17746,1,72,2813,54,1419,18
7363,40,2251,3426,1804,29767,447
42026,24,290,1410,211,8254,79
20479,25,727,2684,606,15239,121
32869,0,16,2057,12,2114,4
36828,4,124,1855,100,5074,24
4086,7,110,3578,92,4788,18
2201,8,435,3616,350,11107,85
15878,0,4527,2908,3222,15579,1305
34699,2,83,1986,69,2776,14
8762,8,191,3327,141,2813,50
27161,10,331,2356,288,9037,43
45659,4,33,480,29,1574,4
21550,3,121,2621,87,2031,34
42951,0,50,1210,36,2556,14
7316,20,721,3429,554,17400,167
45652,8,117,483,98,4704,19
5035,62,2415,3540,1914,43168,501
39936,259,7575,1655,5490,32027,2085
34846,5,469,1977,343,6271,126
22199,1,79,2585,58,2644,21
21380,3,197,2631,161,4221,36
17026,15,461,2849,361,6488,100
11842,1,71,3163,53,3618,18
22408,41,2154,2575,1698,10389,456
38483,17,622,1746,461,12434,161
12702,54,1510,3116,1091,7082,419
24210,1,429,2489,368,13842,61
29282,8,334,2236,265,4201,69
39096,196,10564,1706,7348,46893,3216
8126,3,239,3369,188,5734,51
26781,27,716,2372,558,8347,158
30496,1,139,2172,115,3625,24
26023,7,287,2407,232,4228,55
29144,33,1887,2243,1439,20652,448
8266,27,444,3360,370,11310,74
36270,220,6983,1886,5327,48505,1656
16151,1,129,2894,100,3885,29
41111,30,541,1553,415,10452,126
30383,28,1360,2179,1033,25511,327
45566,50,729,516,339,5806,390
4724,2,95,3555,76,5986,19
26844,31,601,2369,463,18149,138
31563,5,390,2119,315,3155,75
2247,34,1576,3616,1202,16124,374
36618,321,4987,1868,3852,26347,1135
12629,8,405,3120,354,18962,51
29013,11,350,2250,276,7569,74
35257,47,847,1954,657,8435,190
2011,63,1510,3619,1039,9439,471
13560,1,49,3051,40,3208,9
30716,0,66,2161,56,4655,10
38734,107,1817,1729,1236,32460,581
15843,5,610,2909,459,25325,151
9370,7,667,3290,502,19822,165
25557,36,1120,2429,893,11440,227
11227,1,20,3193,17,3324,3
46219,1,18,228,14,978,4
19816,5,211,2718,176,7116,35
26683,2,81,2377,69,6548,12
17041,6,146,2848,114,5614,32
10806,38,1788,3216,1417,16993,371
45428,8,157,559,110,3908,47
38518,539,33461,1744,24283,123630,9178
11627,125,4486,3173,3530,66361,956
20846,35,1947,2663,1488,19633,459
30834,6,231,2155,193,4473,38
13050,153,37839,3095,26520,72542,11319
19452,144,8890,2737,6487,53274,2403
15724,5,477,2913,308,12782,169
2518,1529,89983,3611,54703,468988,35280
15845,55,1823,2909,1348,20369,475
11146,28,1096,3197,844,21634,252
21512,44,7347,2623,4469,24433,2878
42804,18,175,1245,125,3694,50
37535,1,69,1811,55,4587,14
44140,364,5639,894,4546,49152,1093
6155,10,591,3485,488,21336,103
16550,17,835,2875,627,6638,208
20825,41,1988,2664,1596,38246,392
21006,102,3054,2652,2321,24535,733
40088,1,57,1645,41,2613,16
13828,32,987,3031,796,5776,191
43548,117,2690,1032,2042,31589,648
29955,12,858,2202,688,10835,170
34480,3,80,1998,67,3008,13
5443,37,1082,3518,881,14812,201
32477,10,1327,2075,1020,14614,307
22392,147,6827,2576,5509,33794,1318
14772,91,5064,2962,3576,39977,1488
29649,155,4508,2216,3719,23255,789
18532,28,1517,2779,1138,19819,379
11876,7,315,3161,257,3712,58
45021,99,1131,697,872,9891,259
8540,8,291,3341,232,8946,59
36760,12,402,1860,294,15203,108
16591,52,1835,2874,1511,26265,324
24147,289,31663,2491,22403,118116,9260
38896,44,1253,1719,960,7772,293
1211,5,144,3861,115,5998,29
44460,54,797,846,576,10218,221
38435,16,375,1749,287,4485,88
11249,166,7429,3192,5751,35946,1678
9703,3,190,3272,153,3528,37
37655,593,9773,1804,7705,54971,2068
5017,16,538,3541,421,5516,117
2253,27,1729,3616,1381,32895,348
25945,12,1018,2410,810,13541,208
46337,0,19,210,16,955,3
12072,1,94,3152,78,6525,16
31175,1,44,2140,36,3191,8
27386,15,862,2342,676,11858,186
17243,41,865,2836,688,13735,177
13509,88,2426,3055,1756,16204,670
9114,100,3535,3307,2570,11473,965
33640,13,551,2028,330,6518,221
20986,1,90,2654,78,4704,12
30396,83,9483,2178,6972,81976,2511
41257,35,789,1532,599,14885,190
3214,2,71,3599,50,6000,21
12178,145,4957,3146,3441,57011,1516
20018,9,435,2707,328,5909,107
14813,2,330,2959,236,11605,94
41882,124,5477,1432,4022,42311,1455
27761,10,241,2320,204,5776,37
7926,52,1026,3386,835,22868,191
36501,28,866,1875,742,17346,124
35750,0,68,1922,50,3294,18
6875,343,15570,3454,11107,124014,4463
18355,39,1124,2785,900,9160,224
7158,7,66,3437,50,3180,16
42412,52,1757,1333,1268,16221,489
36908,15,316,1851,249,6006,67
30690,3,84,2162,74,2152,10
14918,567,24437,2954,17067,73831,7370
19304,93,5807,2745,4112,55420,1695
45815,16,134,416,112,2596,22
5355,39,2796,3522,2024,49928,772
18677,407,71454,2772,52017,127456,19437
35090,85,4388,1964,2984,41943,1404
22710,3,275,2560,224,5698,51
2342,109,2762,3614,2009,33430,753
14198,29,640,3004,497,4199,143
35700,0,16,1925,14,3092,2
18348,2,91,2786,70,3998,21
25672,3,126,2422,102,3870,24
33649,20,276,2028,205,3688,71
34193,29,998,2010,774,8053,224
6068,10,459,3487,307,4225,152
10823,81,2563,3215,2003,19816,560
3987,61,1962,3581,1554,16345,408
2028,42,1158,3619,892,14629,266
28306,16,493,2288,372,4996,121
6974,162,5466,3448,4321,31255,1145
20679,64,2155,2673,1753,21280,402
11374,2,55,3187,44,3305,11
38657,60,703,1733,547,5971,156
2649,17,1591,3609,1224,7447,367
46373,12,161,194,128,3368,33
39169,5,141,1702,114,3943,27
20434,11,473,2686,380,9662,93
25705,20,2570,2421,1690,9376,880
15680,2,72,2915,59,3459,13
22766,26,3063,2558,2077,30896,986
32925,579,65408,2055,50468,95655,14940
34805,4,253,1979,211,7512,42
41735,52,466,1461,329,12220,137
11211,205,11695,3194,7698,60242,3997
37252,6,373,1829,295,10973,78
31281,10,234,2135,165,5503,69
13788,11,294,3034,246,7596,48
19027,297,27556,2758,19032,164830,8524
19718,23,819,2725,590,7297,229
13832,29,696,3031,551,13688,145
23102,32,7068,2541,5326,82341,1742
11278,153,11793,3191,9201,59660,2592
11924,26,2607,3158,1865,25335,742
17806,5,248,2812,170,3451,78
40566,95,2025,1605,1535,11682,490
36402,12,321,1880,249,3432,72
24587,140,4722,2470,3553,41979,1169
15925,9,470,2906,370,7364,100
2732,268,9715,3608,7218,127206,2497
29635,6,180,2217,135,3348,45
7821,9,172,3397,153,5799,19
40901,127,3348,1575,2496,31182,852
23784,0,113,2509,97,10965,16
4179,14,143,3575,118,2753,25
5274,14,298,3526,232,8262,66
40770,4,124,1587,100,8938,24
43381,22,355,1082,262,4517,93
22563,10,404,2567,319,7753,85
25200,0,121,2443,95,10617,26
2769,23,421,3607,356,6473,65
40262,4,194,1634,154,8254,40
22771,67,4484,2557,3292,24353,1192
2576,8,239,3610,186,9282,53
27027,5,399,2363,295,9421,104
15240,56,3646,2936,2560,37275,1086
16799,5,478,2861,370,7350,108
23896,4,287,2503,220,5120,67
10065,166,5089,3254,3644,57972,1445
13942,30,1314,3020,1033,18172,281
34428,34,969,2000,777,12191,192
20051,66,1265,2706,926,8354,339
35815,0,61,1916,48,3474,13
18488,8,329,2780,236,4203,93
24662,3,102,2467,76,7434,26
19169,0,47,2752,40,4676,7
9575,1,113,3278,95,2730,18
14589,107,8339,2975,6123,63033,2216
4564,12,442,3561,219,5182,223
34333,4,105,2004,88,8129,17
5134,118,5876,3534,4030,36263,1846
11614,5,116,3174,99,5378,17
3149,48,1308,3600,1037,12962,271
40948,83,1497,1571,1128,17263,369
19231,3,351,2749,261,11253,90
9721,46,1208,3271,980,39323,228
45455,8,102,553,82,4325,20
9018,9,337,3313,260,9372,77
11030,0,48,3204,39,2398,9
1477,0,38,3712,31,1657,7
38908,23,924,1718,676,12500,248
2975,8,343,3603,279,7095,64
2010,1,23,3619,19,1917,4
42888,34,1111,1227,832,30365,279
41291,62,2686,1526,2113,26324,573
38913,11,228,1718,174,3342,54
39047,43,1018,1709,827,13689,191
4568,188,7721,3561,5683,65100,2038
29561,80,5025,2221,3634,20141,1391
13223,32,972,3077,750,11799,222
28050,84,1087,2303,816,7002,271
7209,50,2360,3435,1811,21484,549
11151,0,52,3197,48,3891,4
13911,15,769,3023,520,18576,249
7861,7,275,3393,218,7326,57
37565,14,311,1809,201,4211,110
41360,1,24,1517,19,1568,5
43483,30,389,1055,283,5242,106
9340,1,104,3293,83,4237,21
16937,352,35300,2854,23158,190420,12142
2312,29,1063,3615,747,6204,316
12773,2,126,3112,101,2298,25
9204,8,147,3301,103,3214,44
15617,879,138891,2918,91898,422984,46993
45409,8,61,563,49,2128,12
39808,263,6374,1664,4890,48575,1484
13294,26,1722,3072,1484,18274,238
2955,41,1917,3604,1501,23068,416
46042,14,120,316,80,2703,40
33314,24,1389,2041,1045,15661,344
9593,65,2909,3276,1909,26604,1000
32652,93,2527,2067,2066,21095,461
20866,0,26,2662,22,2211,4
45539,44,420,529,283,5483,137
22548,5,289,2568,224,11284,65
34342,1,24,2004,19,4549,5
46133,3,72,282,57,1611,15
40650,17,659,1599,531,7295,128
41798,47,1006,1447,772,18772,234
2896,4,189,3605,158,7299,31
41495,6,147,1497,112,5943,35
3988,131,9374,3581,6934,69983,2440
30138,14,548,2193,439,3993,109
11155,10,516,3197,425,7638,91
36419,10,747,1879,547,10320,200
25132,21,598,2447,487,7953,111
15359,7,723,2930,517,25947,206
30720,1,104,2160,88,5401,16
32513,36,1109,2073,881,12599,228
39722,58,2695,1669,1804,14079,891
20801,21,1070,2666,873,10450,197
12239,1,55,3143,39,2592,16
3767,2,38,3588,34,1952,4
43858,36,258,939,222,4483,36
1880,11,288,3623,238,8182,50
16243,6,221,2890,195,11774,26
26208,19,558,2398,468,12506,90
36443,14,260,1878,204,4242,56
8956,2,61,3316,42,2522,19
14708,2,201,2967,145,11303,56
23020,60,2147,2545,1643,22720,504
2543,5,154,3611,124,4413,30
36205,71,2469,1890,1866,16609,603
12343,6,243,3136,179,4565,64
17628,7,558,2817,403,3098,155
4270,3,201,3572,135,2846,66
45111,239,2976,654,2354,14433,622
13037,167,11743,3096,8415,69764,3328
33410,23,874,2037,617,11324,257
40958,2,153,1571,120,5334,33
2276,0,48,3615,37,3261,11
26370,3,113,2391,84,3213,29
15714,18,595,2914,456,4978,139
12085,10,446,3151,337,3191,109
18191,3,94,2793,76,3570,18
4082,5,169,3579,135,8103,34
27181,2,100,2354,77,3539,23
27037,7,240,2362,199,3085,41
45383,51,1347,571,920,6890,427
18723,203,27738,2770,17324,165750,10414
20557,6,1888,2680,1197,11237,691
8742,9,497,3329,378,9578,119
27533,12,476,2332,360,6903,116
35707,5,321,1924,267,10568,54
25154,10,538,2446,416,13012,122
29531,11,212,2223,177,4701,35
42857,5,96,1237,69,4780,27
5276,337,11046,3526,8250,65460,2796
30376,1,105,2179,78,4372,27
21727,11,344,2611,265,6016,79
27544,120,4778,2332,3692,34163,1086
43674,33,304,987,265,4584,39
6574,10,113,3467,96,7213,17
27259,164,4896,2349,3845,21080,1051
11487,51,5120,3180,3999,38031,1121
2921,74,1225,3604,969,12387,256
45870,29,263,400,198,2256,65
16836,101,7225,2859,5238,48537,1987
15430,4,307,2928,243,4992,64
24565,108,3939,2472,3159,32105,780
32175,29,1159,2087,869,18307,290
1985,69,3945,3620,2934,59722,1011
25867,43,1458,2414,1076,14067,382
15076,22,1013,2944,800,9378,213
3385,59,3424,3596,2299,13382,1125
42870,260,5318,1233,3979,34012,1339
17411,428,12287,2827,8892,36067,3395
14951,139,6396,2952,5011,39733,1385
13760,206,9705,3035,7170,60832,2535
27406,2,48,2341,44,2025,4
13876,39,809,3027,607,6076,202
17162,42,3402,2841,2554,46788,848
8874,8,77,3321,54,2030,23
16079,14,445,2898,354,4626,91
29219,12,515,2239,374,3915,141
22481,4,262,2571,206,5496,56
29156,3,107,2242,90,6361,17
28590,3,69,2271,50,2280,19
1842,262,7184,3624,5556,34965,1628
18972,11,421,2760,308,4357,113
24786,4,66,2462,55,3329,11
7104,5,132,3441,107,3812,25
13701,32,1864,3041,1308,26480,556
9440,11,156,3286,131,9711,25
12496,75,7188,3127,4992,53305,2196
19519,2,81,2734,68,3617,13
1883,126,6904,3623,4715,58412,2189
14611,17,671,2973,572,14281,99
26464,2,75,2387,63,2391,12
36703,41,1778,1864,1221,24881,557
35246,242,7807,1955,5588,84177,2219
5692,60,3423,3504,2364,19703,1059
2164,8,174,3617,134,5683,40
35424,2,147,1946,115,6028,32
3519,10,520,3593,388,11559,132
31289,1,118,2134,93,3363,25
21332,22,1137,2633,923,7211,214
4097,7,145,3578,111,4606,34
45208,109,1261,622,1027,10049,234
27249,3,195,2350,174,8666,21
39554,6,192,1679,152,3207,40
40276,4,70,1633,62,3669,8
6237,7,99,3482,78,7390,21
29610,3,58,2219,51,6069,7
36234,39,1218,1889,941,10685,277
17911,70,2773,2807,2200,25353,573
18613,61,6965,2775,4826,27214,2139
18973,1,182,2760,141,4344,41
18666,26,5625,2772,3678,55965,1947
30168,65,2107,2192,1731,12414,376
7356,4,103,3426,89,4838,14
13651,24,1334,3045,1073,19074,261
40158,45,834,1642,630,10022,204
17872,0,122,2809,99,3666,23
29563,1,63,2221,49,3876,14
30426,7,280,2176,232,7742,48
21414,6,168,2629,120,1982,48
10595,49,1245,3228,1052,41372,193
7063,54,1562,3442,1209,11416,353
43354,29,710,1093,503,7528,207
33704,7,270,2026,203,11447,67
23353,228,17219,2529,13020,91905,4199
42649,477,7450,1285,5077,37349,2373
6504,0,36,3470,30,2763,6
13842,38,1005,3030,685,6442,320
43454,4,169,1063,104,4376,65
27681,1,37,2324,31,1051,6
30451,0,60,2175,43,3362,17
27480,14,483,2336,315,5588,168
9348,27,2065,3292,1659,13323,406
4305,23,513,3571,349,8562,164
8808,8,514,3324,372,2917,142
5915,25,497,3493,379,4695,118
2305,29,1949,3615,1541,9513,408
35221,71,2324,1957,1778,51855,546
14239,63,3886,3001,3014,31767,872
21483,222,10621,2625,6992,80146,3629
22645,12,1197,2563,948,22748,249
40157,118,5939,1642,4085,52380,1854
22816,38,1536,2555,1117,23359,419
9786,3,276,3268,236,7810,40
22262,82,3622,2582,2729,42962,893
36590,4,97,1870,84,5364,13
41583,17,684,1485,483,10107,201
40178,0,28,1640,21,2848,7
27136,34,1506,2357,1166,13979,340
17264,1,176,2835,122,3315,54
2828,67,2275,3606,1807,21963,468
43147,9,243,1153,170,7870,73
28442,5,350,2281,290,4934,60
21526,156,7674,2622,5481,41144,2193
6420,71,2301,3473,1631,14943,670
36324,163,5533,1884,4081,58748,1452
18225,8,359,2792,287,10782,72
33980,41,998,2016,819,12192,179
13019,10,647,3097,490,6353,157
17838,58,2370,2810,1804,19283,566
37971,7,217,1781,165,9951,52
34303,5,99,2006,80,2037,19
21471,338,24650,2626,15954,96643,8696
46498,1,13,126,13,996,0
41838,128,4124,1439,2879,44842,1245
22104,24,2044,2589,1472,26658,572
45686,12,49,467,39,1345,10
21026,95,6473,2651,4594,42774,1879
27023,123,3039,2363,2388,15071,651
6152,8,173,3485,127,5767,46
8752,12,435,3328,351,7604,84
31341,886,36831,2132,25873,195180,10958
23168,29,2089,2538,1500,41993,589
16105,20,1045,2896,826,8662,219
14702,18,755,2968,607,12108,148
14714,1457,54982,2966,40255,261732,14727
34630,8,253,1990,186,7157,67
40546,208,4422,1607,3323,28816,1099
15379,44,3038,2930,2286,26627,752
17245,4,210,2836,161,8276,49
26462,0,36,2387,29,1848,7
25881,15,677,2414,567,7756,110
5632,54,1424,3508,1076,17977,348
12149,387,18098,3147,13942,76862,4156
41410,30,782,1510,553,12481,229
36951,10,271,1848,241,10382,30
3604,37,1182,3592,865,19710,317
2455,201,16535,3612,11024,54492,5511
18878,6,681,2763,582,6917,99
17099,1,537,2845,382,11706,155
7258,2,42,3433,37,2904,5
41715,48,873,1464,640,10548,233
29749,11,475,2212,385,6049,90
44565,72,1197,827,960,18686,237
9767,43,1539,3269,1073,11667,466
4239,45,1345,3573,1048,19202,297
1789,11,830,3628,675,10754,155
8454,0,70,3347,58,7582,12
32791,9,438,2061,314,3276,124
23085,14,743,2542,614,6679,129
40564,15,241,1605,197,2837,44
13198,10,551,3078,463,6545,88
3369,84,4176,3596,3132,29737,1044
17810,55,3881,2811,2968,29786,913
6384,43,2186,3475,1552,35346,634
40033,0,141,1648,84,4947,57
15397,12,417,2929,339,10353,78
38729,7,148,1729,106,3766,42
18003,60,3564,2801,2879,30019,685
27067,1,159,2361,125,2240,34
14297,3,148,2996,95,3369,53
15411,341,27025,2929,18175,96929,8850
6078,6,142,3487,107,3923,35
25798,3,104,2417,87,2738,17
10198,30,2620,3248,1817,28353,803
38884,32,932,1719,729,9933,203
32029,15,437,2096,328,3926,109
18083,10,512,2797,439,5501,73
27854,1,203,2314,155,5111,48
20318,5,329,2692,272,9088,57
19919,2,65,2713,61,1529,4
42910,13,292,1222,215,3190,77
17033,25,1148,2849,884,12725,264
33845,30,691,2020,589,14499,102
1687,0,23,3660,21,1505,2
29945,1,65,2202,47,2767,18
27124,32,546,2358,420,6058,126
9307,43,2812,3295,2147,31428,665
18560,33,2243,2778,1452,16922,791
31594,2,56,2118,45,2655,11
42946,12,124,1211,95,3502,29
37388,0,52,1821,38,3657,14
44801,19,319,761,232,2926,87
7826,7,539,3397,451,8030,88
8323,4,298,3356,190,8690,108
13661,7,50716,3044,16218,23765,34498
25476,19,606,2433,471,9528,135
27381,25,989,2342,772,14308,217
40799,90,3045,1585,2128,34973,917
26561,1,66,2382,57,2302,9
38380,1,62,1753,52,2705,10
39517,18,219,1681,177,3940,42
34714,38,1195,1985,954,12720,241
45533,108,1849,531,1505,24903,344
36686,62,1810,1865,1421,16173,389
43712,121,1786,973,1579,12229,207
26288,37,883,2395,599,7614,284
45621,6,62,497,37,2873,25
35769,45,2186,1920,1719,21134,467
19861,83,4552,2716,3441,21982,1111
2785,11,391,3607,228,12106,163
26884,7,294,2367,239,5829,55
38349,4,339,1755,272,9612,67
4674,5,126,3557,105,8116,21
21245,0,512,2637,311,11582,201
4608,11,128,3559,113,4677,15
43931,26,348,927,263,3151,85
41937,20,303,1424,243,8162,60
37914,6,213,1785,169,5592,44
10609,14,1033,3227,805,11516,228
27870,13,257,2314,209,3764,48
46167,15,204,266,182,3798,22
36844,654,15536,1854,11310,66948,4226
10122,6,148,3252,114,2636,34
1920,12,295,3622,242,4654,53
40545,104,1111,1607,912,69949,199
40526,172,4055,1609,3072,23674,983
3082,38,1460,3601,1211,15250,249
10901,110,5347,3211,4048,24683,1299
17995,6,419,2802,332,22657,87
27025,19,378,2363,305,7012,73
44953,230,2512,717,2092,21439,420
16137,151,5471,2895,4163,23173,1308
17211,11,359,2838,280,4285,79
31686,14,283,2112,226,4361,57
11572,6,454,3176,379,21910,75
27729,11,420,2322,298,6963,122
18721,32,1326,2770,1059,18180,267
16494,30,1475,2878,1115,15312,360
11923,6,276,3158,207,7001,69
29450,3,190,2226,145,3534,45
22211,9,456,2584,371,4897,85
23539,2,47,2520,38,6323,9
8865,3,160,3321,123,3064,37
15886,0,451,2907,350,8394,101
9330,1,82,3293,74,1791,8
29205,35,444,2239,345,6326,99
24307,50,4427,2484,3348,47898,1079
18432,3,324,2782,240,6627,84
45240,10,178,613,145,4931,33
8879,29,1013,3321,798,14373,215
7202,16,313,3435,255,4686,58
43375,11,185,1083,143,7354,42
37753,55,1359,1797,1060,12823,299
3952,13,201,3583,176,4713,25
38040,5,124,1778,107,4952,17
12757,20,78770,3113,23920,13767,54850
36840,4,129,1854,92,5358,37
46261,5,60,241,36,1936,24
4180,6,164,3575,133,11141,31
3818,33,807,3587,650,9577,157
15158,6,55,2940,48,5173,7
43336,76,2160,1098,1431,15192,729
45656,17,254,481,202,7191,52
10709,79,4135,3221,3174,43390,961
38498,2,78,1745,65,4018,13
9181,120,4038,3302,3157,29336,881
22745,24,509,2559,412,4880,97
41346,80,3840,1519,2908,26737,932
22210,19,901,2584,657,14165,244
45239,2,48,614,32,1563,16
2246,1025,54092,3616,38788,209229,15304
29726,6,274,2213,196,11074,78
43877,18,281,938,215,7450,66
28234,3,97,2292,74,4007,23
22982,174,9795,2546,7366,78726,2429
35341,0,321,1951,262,7621,59
5646,30,989,3507,823,15033,166
30771,81,2700,2158,2204,14284,496
10288,19,975,3244,614,8876,361
37233,1,219,1830,183,6333,36
36659,0,72,1866,60,3998,12
21671,8,196,2614,160,12079,36
18425,14,1004,2782,811,8683,193
40756,27,494,1588,376,6116,118
12900,17,270,3105,225,11750,45
7740,9,276,3404,192,4331,84
24184,5,87,2490,69,3438,18
33181,3,110,2045,91,2775,19
14158,40,3807,3007,2576,23343,1231
23861,17,462,2505,368,3593,94
6925,42,2795,3451,2132,30417,663
12355,13,534,3136,424,16877,110
38504,36,965,1745,752,25894,213
25822,111,2734,2416,2156,16947,578
35258,0,598,1954,483,12842,115
42363,96,5040,1342,3456,44412,1584
40155,3,75,1642,36,1637,39
44842,46,412,747,323,5351,89
35464,377,12102,1944,9616,83670,2486
30735,20,500,2160,422,7224,78
6448,146,7820,3473,5263,20636,2557
41883,2,230,1432,160,6998,70
27149,208,5966,2356,4240,31767,1726
30464,2,114,2174,85,2890,29
16623,8,749,2872,593,8206,156
30557,38,900,2169,706,7787,194
10310,13,333,3243,271,13678,62
43239,343,6353,1126,4955,42185,1398
23735,8,264,2510,175,3836,89
32315,4,105,2081,92,4306,13
34568,8,340,1993,281,4411,59
29008,20,553,2250,384,4830,169
5737,2,29,3503,25,1948,4
36550,86,1978,1873,1581,18173,397
41446,9,158,1504,128,6514,30
30245,19,893,2187,727,9171,166
5353,11,249,3522,191,12520,58
2396,11,232,3613,188,8172,44
21716,18,478,2611,385,9242,93
14485,28,2684,2982,2167,23621,517
41907,0,53,1429,39,3357,14
46140,49,611,281,538,11458,73
8852,16,1305,3322,1014,24506,291
8434,20,1405,3349,1016,22145,389
42673,23,596,1279,476,16747,120
6316,49,1746,3478,1411,25988,335
27646,18,486,2326,376,5861,110
26290,2,30,2395,26,1291,4
14318,40,2995,2994,2402,23401,593
14688,17,882,2969,659,12408,223
5952,41,821,3492,653,18603,168
29047,0,547,2248,438,6574,109
27751,45,1497,2320,1109,22742,388
17024,10,381,2849,322,7463,59
4514,4,138,3563,113,1942,25
25379,20,564,2436,480,23987,84
7886,31,799,3391,652,14202,147
30032,0,20,2199,15,4561,5
33878,3,84,2019,70,2208,14
11590,88,6944,3175,4817,86923,2127
13964,17,2371,3018,1781,14984,590
26644,171,14979,2379,10945,85056,4034
26082,28,733,2404,579,10245,154
41783,0,87,1451,63,5167,24
36280,3,82,1886,63,6359,19
37444,23,513,1818,398,12693,115
20348,274,11057,2691,7940,59427,3117
41022,2,120,1566,93,3851,27
14078,21,681,3010,487,9265,194
4330,48,1206,3570,895,33620,311
43789,5,76,948,53,2923,23
32661,172,6758,2067,4716,26217,2042
3678,4,66,3590,54,4138,12
33821,55,1792,2021,1120,31164,672
3325,4,124,3597,95,3053,29
11748,10,492,3166,398,7677,94
34943,1,301,1972,226,15223,75
24778,71,3148,2462,2262,23695,886
33663,3,168,2027,140,6220,28
6408,9,804,3474,607,8325,197
37194,26,987,1832,737,20869,250
5766,14,808,3502,472,11958,336
43752,11171,267549,963,175594,700196,91955
8291,43,838,3358,638,25280,200
24555,10,328,2472,265,7636,63
19423,59,2915,2739,1960,10788,955
11662,7,221,3171,178,3332,43
33477,2,54,2034,41,4065,13
41590,30,1642,1484,1169,31366,473
28956,11,451,2252,361,4826,90
17439,74,1660,2826,1276,9100,384
10104,45,811,3252,601,7502,210
5799,230,7036,3500,5183,68724,1853
16607,12,1026,2873,867,12745,159
3222,10,329,3599,261,17720,68
6472,262,9435,3471,6918,45515,2517
22759,36,2086,2558,1544,32053,542
30037,38,764,2198,595,6140,169
26465,19,2053,2387,1656,23363,397
28555,18,586,2273,458,7485,128
33317,11,571,2041,470,11441,101
14941,59,2535,2952,1899,24666,636
17883,188,16123,2808,11688,86584,4435
39070,5,118,1707,93,2825,25
1635,1,220,3673,183,5029,37
5727,179,8966,3503,6570,74166,2396
25242,48,1717,2442,1380,19864,337
26807,50,2035,2371,1583,38293,452
7190,314,15400,3436,11273,55013,4127
1826,1298,43791,3625,28066,124538,15725
13161,17,770,3080,545,9683,225
45976,1,43,349,30,2255,13
35760,44,782,1921,578,6468,204
8998,2,80,3314,55,2768,25
1462,5,133,3717,115,2794,18
15616,5,118,2918,91,3901,27
31488,98,6035,2123,4394,56921,1641
8383,120,5322,3351,4243,74398,1079
7468,2,37,3421,32,4292,5
3514,9,475,3593,341,4445,134
22975,7,316,2547,242,5586,74
11303,25,448,3190,373,6040,75
9552,24,378,3279,269,5005,109
40333,17,540,1629,392,13702,148
2800,48,1094,3606,759,8912,335
27877,5,314,2313,265,7332,49
32558,1,124,2071,95,5493,29
15465,53,2684,2927,2196,18238,488
7042,26,918,3443,694,7067,224
32475,0,23,2075,21,2141,2
3746,17,324,3588,255,3617,69
14870,83,6264,2956,4695,64632,1569
13298,4,134,3072,109,2930,25
14474,48,3674,2983,2831,23912,843
37921,1,35,1784,28,2606,7
3801,415,33409,3587,24242,198401,9167
41032,3,93,1565,71,4822,22
38670,16,488,1733,392,11425,96
43062,24,193,1178,163,3013,30
41115,14,257,1553,202,4435,55
17832,1,71,2810,46,3308,25
21615,19,1872,2617,1427,27009,445
43624,1,34,1003,28,2475,6
13434,6,283,3061,228,5955,55
26843,24,922,2369,716,8924,206
13127,18,695,3090,515,10771,180
4000,37,1122,3581,832,17172,290
44429,54,672,849,573,6083,99
42110,3,177,1395,137,8106,40
7625,50,1172,3411,964,8282,208
13400,11,173,3064,134,3086,39
36441,2,22,1879,17,6590,5
3843,0,43,3586,29,1905,14
3051,6,130,3602,94,3452,36
21267,7,202,2636,148,1837,54
5908,1,181,3494,153,21210,28
45003,30,340,703,239,6249,101
2001,13,306,3619,258,15007,48
7160,0,93,3437,68,4350,25
4921,65,1390,3545,1086,30402,304
35276,50,1026,1954,848,16609,178
15189,1,174,2938,130,7193,44
36638,25,2024,1867,1581,11805,443
11175,1,41,3196,35,4799,6
43692,9,107,979,81,2385,26
16112,6,452,2896,349,5708,103
3467,16,510,3594,412,15827,98
42455,2,111,1322,64,5517,47
41057,40,2077,1560,1274,19422,803
41767,7,187,1454,154,4542,33
44048,23,203,908,144,4009,59
6589,5,282,3466,232,7845,50
35985,67,521,1904,422,5052,99
12183,50,2041,3145,1679,16752,362
27798,0,174,2317,138,5994,36
2401,16,401,3613,319,18871,82
37794,1126,34461,1794,25944,153036,8517
6296,35,2182,3479,1519,25625,663
32200,6409,247943,2086,176227,499751,71716
12965,79,1942,3101,1345,45478,597
28922,21,254,2254,208,4106,46
9338,62,2578,3293,1738,16553,840
18823,17,1628,2765,1288,18677,340
34006,5,161,2015,115,8011,46
9449,1,117,3286,51,4723,66
4760,2,106,3554,82,10579,24
16673,49,2683,2869,2157,26331,526
24430,174,15055,2479,11488,72489,3567
46173,3,44,265,33,1907,11
37965,124,3779,1782,2627,23316,1152
31860,11,357,2104,280,5801,77
35994,46,532,1903,404,5860,128
38395,7,260,1752,212,5401,48
5999,95,3707,3490,2792,24820,915
14982,619,46321,2950,29995,152853,16326
40898,20,493,1575,378,7272,115
2003,2,40,3619,33,5818,7
3331,19,464,3597,353,4872,111
25257,23,707,2442,501,5561,206
10496,2,235,3234,181,8339,54
7712,16,705,3406,580,9559,125
34890,142,2532,1974,2005,17958,527
3433,1,31,3595,24,3786,7
21976,1,95,2596,76,11422,19
15166,49,1779,2939,1380,10795,399
15092,2,82,2944,67,3894,15
41965,53,1559,1419,1213,39307,346
11413,18,795,3185,636,17218,159
25435,18,1052,2434,843,11273,209
43622,11,98,1004,70,3137,28
45772,33,254,428,210,5127,44
44744,114,1618,780,1241,11457,377
32701,6,421,2065,314,3955,107
45375,4,70,573,61,3478,9
5950,3,56,3492,50,2444,6
7973,5,156,3382,127,7170,29
34059,2,88,2013,60,2646,28
6093,43,1489,3486,1080,14283,409
39959,240,7845,1653,5749,56864,2096
19093,21,828,2755,670,11818,158
24986,5,236,2453,186,6634,50
22187,72,3995,2586,2706,24004,1289
15527,6,139,2923,120,3289,19
5512,11,260,3515,214,2325,46
44389,139,2230,854,1910,27313,320
3476,1,44,3594,36,1513,8
18931,137,7906,2762,5757,36087,2149
27393,7,229,2341,183,3836,46
3378,21,381,3596,309,10111,72
1968,47,1145,3620,933,39796,212
3651,5,130,3591,107,3563,23
14285,26,2195,2997,1672,35543,523
23927,214,9091,2501,6761,55084,2330
16829,4,152,2860,133,2243,19
12328,22,736,3137,598,11632,138
19489,77,6194,2735,4639,29113,1555
16306,51,1814,2887,1387,16281,427
6253,34,906,3481,723,8914,183
28974,9,175,2251,138,2705,37
45739,5,67,441,59,1948,8
40144,37,795,1643,632,8223,163
34051,21,391,2013,303,5812,88
15243,83,5265,2936,4032,35961,1233
14729,4,354,2966,291,9620,63
17477,115,13426,2825,9401,55688,4025
29488,10,361,2224,314,9844,47
24498,109,2369,2475,1722,21495,647
46303,33,706,224,620,6881,86
42179,74,2709,1379,2123,37058,586
35012,1,215,1968,168,7490,47
5193,17,200,3530,161,5621,39
44437,125,1658,848,1264,18995,394
7471,386,16634,3421,11936,157316,4698
34793,186,12739,1980,9435,49241,3304
44723,16,164,787,153,5715,11
7098,1,86,3441,67,2488,19
2225,7,189,3616,167,5542,22
34291,28,542,2006,384,4195,158
39641,41,1230,1674,960,20912,270
32336,16,346,2080,277,4731,69
27897,4,155,2312,118,4147,37
31139,11,303,2142,237,8184,66
3525,4,229,3593,196,28553,33
32999,77,1164,2053,935,21961,229
18222,7,292,2792,230,6136,62
39751,27,963,1668,775,10823,188
3557,0,180669,3592,68702,1659,111967
29943,21,662,2202,500,10643,162
32942,1,42,2055,35,2635,7
2495,216,9328,3611,7206,60076,2122
19582,18,849,2732,620,5908,229
13439,25,600,3060,492,8066,108
45431,9,110,558,98,5864,12
31892,236,7726,2103,5460,82605,2266
37126,7,170,1837,133,6073,37
7960,4,77,3383,68,2932,9
22276,17,1083,2581,793,12143,290
28008,9,217,2305,194,2949,23
15456,6,721,2927,529,8705,192
35925,7,114,1909,87,2331,27
28636,45,1325,2268,946,10930,379
40316,1,177,1630,98,4766,79
16516,12,573,2877,449,6089,124
42667,9,282,1280,205,10359,77
43005,19,260,1195,182,3887,78
31836,1,116,2105,84,3641,32
45213,3,46,619,28,1936,18
20177,26,3826,2699,2878,54240,948
36929,1,357,1850,284,7084,73
14680,2,277,2969,208,4588,69
19309,15,771,2745,611,9524,160
4729,20,850,3555,670,14158,180
42217,5,104,1370,83,2839,21
7412,180,5303,3424,4040,45518,1263
28468,17,443,2279,355,2897,88
16519,1,61,2877,53,2831,8
46082,3,70,303,59,1382,11
35355,160,4463,1950,3671,20233,792
2487,143,4068,3611,3299,51709,769
41711,73,2132,1465,1676,20564,456
8325,15,590,3356,439,13800,151
1903,90,3098,3622,2219,35309,879
41380,3,127,1515,95,5680,32
44930,7,74,725,70,3008,4
13023,7,579,3097,454,29015,125
38605,36,912,1736,715,9883,197
40244,3,400,1635,292,9309,108
6406,258,11206,3474,8283,79215,2923
6299,11,603,3479,457,14492,146
27315,6,130,2346,111,2272,19
26612,17,463,2380,372,6130,91
13451,1,404,3059,295,7308,109
21625,2,0,2616,0,2162,0
2632,18,402,3609,287,4141,115
2343,9,219,3614,137,7576,82
11561,8,386,3176,279,3794,107
19990,13,469,2709,348,7240,121
12943,47,1858,3102,1332,17697,526
34612,48,1439,1991,1102,11134,337
40241,20,598,1635,451,13046,147
11532,33,1032,3177,834,15844,198
14989,14,294,2949,230,3441,64
23304,35,1757,2531,1325,21975,432
38260,8,266,1762,225,4900,41
35226,2,28,1957,22,3367,6
6351,22,886,3476,702,21231,184
8569,37,1121,3339,913,11189,208
29907,5,222,2204,188,3506,34
24516,214,4852,2474,3516,19228,1336
45952,2,49,358,41,1366,8
36502,11,160,1875,128,3255,32
45985,45,680,347,581,16392,99
36953,54,915,1848,708,9948,207
32342,113,2576,2080,1876,10369,700
19156,194,9369,2753,6492,50125,2877
7182,2,66,3436,55,3256,11
37883,80,1289,1787,957,8486,332
35975,5,119,1905,96,3981,23
7653,76,4260,3409,3212,51170,1048
31196,73,4898,2139,3780,36241,1118
11287,16,1092,3190,828,23106,264
35146,4,46,1961,39,3181,7
37722,8,163,1799,136,8297,27
40174,23,598,1640,433,9077,165
18595,1091,73449,2776,53022,158518,20427
2831,24,496,3606,407,18269,89
16288,609,27279,2888,19458,60618,7821
16861,44,2214,2858,1621,9454,593
29273,29,1955,2236,1661,12042,294
27687,38,1229,2324,1004,7675,225
39025,38,1045,1711,677,12395,368
15307,14,509,2932,399,7630,110
30918,51,1044,2153,847,13988,197
9712,8,117,3272,72,6271,45
2683,47,950,3608,715,11843,235
22815,59,2694,2555,1795,26076,899
4586,12,364,3560,308,4426,56
29586,41,1432,2220,1207,14018,225
23129,7,649,2540,505,5269,144
21570,12,426,2620,352,4309,74
30554,0,27,2169,23,7346,4
7535,9,264,3416,216,19476,48
21834,66,1904,2606,1519,18083,385
8655,16,438,3334,304,10898,134
41665,17,792,1472,596,16093,196
31962,22,933,2099,713,11210,220
24666,4,544,2467,411,14001,133
9705,1,7,3272,5,1551,2
44797,12,135,763,99,5071,36
27205,28,1373,2353,1084,9870,289
5180,28,493,3531,403,12586,90
35129,0,93,1962,71,5137,22
6869,4,60,3454,47,2576,13
42810,5,146,1244,110,4263,36
36919,29,451,1850,349,7012,102
23609,2,77,2516,57,3472,20
39832,119,2143,1663,1651,20446,492
32952,35,1073,2055,814,8719,259
31483,13,437,2124,337,7750,100
4725,6,134,3555,100,5057,34
12431,15,409,3130,277,6401,132
39505,4,93,1682,76,7752,17
30962,28,809,2151,679,5457,130
7103,828,32263,3441,22900,115825,9363
14353,0,157,2992,131,4804,26
4154,3,20,3576,17,2046,3
8945,30,992,3317,736,27675,256
29103,2944,220012,2245,137898,833111,82114
20509,260,5388,2682,3779,22236,1609
24102,0,28,2493,24,1672,4
35008,22,956,1969,650,14304,306
3865,6,189,3586,154,20821,35
32928,2,440,2055,345,7652,95
11329,25,878,3189,607,11764,271
5485,8,209,3516,177,9827,32
42278,9,204,1358,163,5521,41
39925,0,18,1656,16,1102,2
8523,111,3392,3342,2095,10394,1297
26948,5,288,2365,204,11743,84
17907,98,4690,2807,3590,58460,1100
44856,3,61,743,49,1742,12
36097,19,423,1896,311,4801,112
11745,2,191,3167,159,7264,32
6543,51,2150,3468,1733,49111,417
6236,4,283,3482,235,4461,48
23852,83,2358,2505,1784,27861,574
37894,420,17539,1786,12968,97419,4571
19652,3,114,2728,94,3040,20
37349,4,59,1824,46,2960,13
45810,15,122,418,100,2818,22
9822,13,907,3266,729,13115,178
42382,19,551,1339,389,19551,162
23940,2,105,2500,90,2627,15
29967,19,562,2201,428,10996,134
34336,4,141,2004,112,1926,29
6361,8,280,3476,236,10341,44
43561,4,62,1028,53,4909,9
7784,2,72,3400,55,1968,17
15959,39,7270,2904,5402,34686,1868
45361,23,419,577,312,4533,107
25634,40,5697,2424,4070,32192,1627
24277,50,984,2485,730,10363,254
10119,5,70,3252,59,2604,11
7709,18,483,3406,392,16066,91
18014,5,358,2801,275,5426,83
8467,5,94,3346,66,2481,28
6987,15,182,3447,130,3666,52
35931,0,12,1908,10,1929,2
9106,6,215,3307,182,13911,33
37648,7,339,1804,280,4698,59
2461,7,238,3612,154,9048,84
12116,17,271,3149,218,5777,53
7704,39,1156,3406,884,17769,272
9749,3,170,3270,131,3638,39
29109,2,174,2244,131,7167,43
23760,32,2483,2510,1985,20911,498
14906,109,3350,2954,2395,16275,955
13500,80,4761,3056,3630,39047,1131
32327,0,37,2081,30,2959,7
3623,20,380,3591,300,9051,80
4856,7,193,3549,128,6509,65
39961,92,3034,1653,2282,31230,752
20140,6,480,2701,372,7183,108
19470,164,8325,2736,5793,44402,2532
32023,42,3105,2096,2380,34612,725
17285,38,2312,2834,1730,25349,582
23303,24,1186,2531,939,16212,247
9622,39,999,3275,781,11839,218
41039,246,6351,1564,4569,55723,1782
6087,4,96,3487,66,2387,30
28504,28,747,2277,609,6559,138
34541,4,436,1994,363,25260,73
18550,227,10001,2778,7480,111377,2521
40383,4,68,1622,61,2104,7
39782,88,1952,1667,1515,19944,437
25908,105,8311,2412,6136,53957,2175
3587,27,1140,3592,835,16391,305
17298,24,588,2833,476,18941,112
20218,1210,68778,2696,50771,170683,18007
13281,28,615,3073,444,8414,171
38891,103,2731,1719,1838,26152,893
28078,7,252,2301,200,3741,52
21539,12,374,2621,267,3862,107
31883,15,267,2103,230,3535,37
1369,4,125,3785,102,10573,23
43542,5,103,1034,85,5625,18
32465,8,438,2075,345,5928,93
45395,5,28,568,24,2188,4
19090,0,216,2755,177,4611,39
28962,8,420,2252,327,12248,93
14028,13,626,3014,475,8768,151
43990,33,289,920,209,4853,80
2335,58,4953,3614,3358,42372,1595
34126,3,90,2011,74,2230,16
12928,5,248,3103,211,7182,37
4868,413,17710,3549,13135,79594,4575
39222,108,2322,1698,1847,9759,475
45710,30,483,454,357,8332,126
36894,1,18,1852,16,2994,2
19282,85,3605,2746,2651,20196,954
1726,1,70,3650,55,3604,15
4720,3,108,3555,88,3087,20
36056,7,224,1898,191,7759,33
14972,10,182,2951,145,4049,37
35285,8,327,1953,272,10227,55
17177,1,62,2840,53,2868,9
35520,4,158,1940,127,7077,31
13602,119,5228,3049,3893,22434,1335
6464,7,130,3472,102,10017,28
43653,83,1361,993,1192,17041,169
7101,2,103,3441,87,3387,16
31587,76,2882,2118,2077,32745,805
25300,14,698,2440,581,5066,117
24526,10,322,2474,283,5350,39
39776,55,1067,1667,874,21192,193
10165,40,1421,3250,1089,5738,332
40190,1366,59549,1640,37197,190501,22352
28403,10,408,2282,330,6987,78
19776,1,31,2721,24,3287,7
10475,21,976,3235,747,20960,229
44311,12,113,867,85,2596,28
9675,9,288,3273,224,7137,64
7135,1,33,3439,22,1762,11
35538,1,110,1938,93,7205,17
9503,38,1672,3282,1247,20932,425
43051,43,409,1182,333,6559,76
43471,41,944,1058,714,12931,230
43296,60,1046,1110,778,31958,268
43524,15,256,1042,196,8393,60
6440,28,592,3473,475,4129,117
32908,1,119,2056,82,8655,37
27889,4,198,2312,157,1767,41
40949,6,104,1571,87,5479,17
43554,4,68,1030,65,4829,3
2794,2,136,3606,102,3588,34
34677,0,20,1987,16,4341,4
46280,0,14,234,9,508,5
2224,15,301,3616,239,12581,62
40989,5,141,1568,121,3627,20
41250,41,1389,1534,1099,13356,290
6673,3,112,3463,90,2173,22
6033,3,95,3488,74,6140,21
30680,13,908,2162,696,12922,212
18570,20,1042,2777,846,23017,196
29390,2,114,2229,93,3017,21
27712,0,3553,2322,2820,44866,733
17458,16,1117,2826,813,8369,304
7747,3,297,3403,229,13763,68
2904,8,190,3605,163,3546,27
16249,2,159,2890,121,6416,38
12535,2,43,3126,29,1072,14
35998,6,268,1903,228,4737,40
11555,1,46,3176,39,1960,7
38934,0,59,1716,52,3634,7
42827,7,105,1242,84,9508,21
11351,571,43753,3188,32541,172834,11212
26190,0,156,2401,110,7570,46
45117,134,989,648,874,11379,115
23059,19,432,2543,334,4325,98
22193,15,418,2586,319,5042,99
41089,8,143,1557,104,4521,39
40730,198,7629,1592,5709,64777,1920
19646,5,414,2729,311,10845,103
26014,1,77,2407,63,5197,14
34091,26,420,2012,354,9028,66
10689,12,276,3222,239,16740,37
30304,467,16190,2184,11446,105677,4744
1857,39,424863,3623,120715,26792,304148
12468,8,857,3129,689,7406,168
39444,41,593,1685,464,8602,129
3304,25,619,3597,504,4898,115
19773,9,686,2721,563,9186,123
39325,21,330,1691,255,3700,75
13585,38,1350,3050,1113,26526,237
45907,3,118,384,87,3413,31
38521,1,106,1743,85,4218,21
14405,23,1275,2987,873,10626,402
38270,128,2288,1761,1762,16455,526
30535,1,195,2170,161,5641,34
30094,273,30305,2195,18970,140918,11335
9022,8,241,3313,175,4632,66
3375,48,1375,3596,1077,10550,298
9641,56,2521,3274,1777,47868,744
23083,2,153,2542,120,2238,33
27443,0,96,2338,72,2854,24
29138,23,2200,2243,1179,13612,1021
18537,5,708,2779,507,9244,201
25033,3,471,2452,375,6814,96
31079,12,236,2145,198,5316,38
12341,2,68,3137,56,4128,12
8635,63,1902,3336,1425,18370,477
5030,24,546,3540,403,19414,143
45953,15,183,356,162,2924,21
24273,3,406,2486,313,9815,93
3225,39,1410,3599,975,8778,435
31907,3,167,2102,119,8701,48
15667,7,319,2916,251,5611,68
2693,5,184,3608,153,8648,31
24687,22,1591,2466,1111,9347,480
30127,6,99,2194,94,1739,5
31961,84,3182,2099,2319,26529,863
17969,20,684,2803,518,7353,166
13462,8,506,3058,382,8973,124
12269,45,1331,3141,989,13497,342
18016,10,537,2800,463,5823,74
38836,2,103,1722,85,2324,18
21855,3,175,2605,142,3125,33
24661,18,690,2467,532,8286,158
35313,41,478,1952,379,4175,99
46432,3,57,160,47,854,10
19419,104,5059,2739,3009,35008,2050
36202,3,123,1890,103,3668,20
19413,34,5005,2739,3663,30247,1342
11117,1,141,3199,97,7468,44
15012,6,259,2948,210,10251,49
14583,22,636,2975,522,9462,114
6726,21,766,3461,628,30069,138
9551,7,203,3279,156,11923,47
11465,9,417,3181,320,5533,97
22646,0,19,2563,17,1641,2
41110,1,52,1553,36,5734,16
20678,1,27,2674,22,3721,5
30749,15,687,2159,577,16754,110
15423,8,276,2928,225,12142,51
21250,11,328,2637,272,10768,56
5627,77,2639,3508,2149,34528,490
40077,0,101,1646,85,3621,16
22274,0,44,2581,37,3211,7
36449,0,29,1878,21,4656,8
1717,14,235,3653,195,5223,40
30242,6,333,2187,270,4778,63
35307,5,93,1952,82,2253,11
9166,22,1109,3303,891,15657,218
41215,30,535,1541,396,9597,139
22763,28,1581,2558,1128,14638,453
2886,12,569,3605,442,6732,127
31221,2,446,2138,334,7027,112
42783,294,7013,1252,5359,60897,1654
12010,28,407,3154,310,9526,97
12624,49,3377,3121,2304,28768,1073
45814,5,62,416,39,1841,23
29525,3,209,2223,170,6236,39
15097,142,6141,2944,4390,37602,1751
37226,37,1932,1831,1307,26961,625
6656,7,52,3464,46,3144,6
8862,145,5722,3322,4166,45724,1556
8226,3,47,3362,36,3396,11
8975,21,775,3315,650,16297,125
2425,2,251,3613,193,12422,58
26116,88,6286,2403,4432,35756,1854
21064,18,793,2650,634,5036,159
21027,17,461,2651,359,9511,102
22855,5,252,2553,187,6187,65
3386,13,365,3596,306,4704,59
9357,764,160530,3291,69165,134102,91365
25651,5,127,2423,108,2507,19
15693,16,943,2915,670,6875,273
25883,211,7842,2414,5335,57078,2507
26630,0,45,2380,7,3488,38
12185,10,252,3145,201,6056,51
25539,0,73,2430,61,2206,12
44475,42,336,844,236,4141,100
36290,21,615,1885,467,13042,148
4778,1,47,3553,43,2594,4
19641,272,29665,2729,14962,129838,14703
8935,3,176,3318,115,13461,61
31666,244,10983,2114,7689,73670,3294
39229,10,432,1697,329,10545,103
37764,5,117,1796,90,2543,27
20706,11,1184,2672,914,9948,270
25963,37,3179,2410,2575,21399,604
40165,5,94,1641,83,2047,11
45828,13,221,411,144,4458,77
43039,70,1206,1185,1002,29345,204
6218,7,237,3483,165,7380,72
21597,9,298,2618,225,7718,73
11173,55,2074,3196,1611,39203,463
40205,43,490,1638,375,7993,115
4371,6,186,3568,151,10834,35
37788,2,27,1795,24,4221,3
1009,22,1430,3929,1132,21905,298
20085,118,3747,2704,2868,40850,879
1413,5,134,3741,120,7868,14
16147,0,74,2894,60,3047,14
45805,5,98,419,67,1350,31
26341,45,1773,2393,1362,15380,411
2371,8,126,3613,104,3747,22
44854,11,210,743,130,3817,80
16860,16,582,2858,463,4533,119
39522,4,312,1681,211,7301,101
41301,10,548,1525,425,16276,123
22910,18,733,2550,597,5318,136
17965,142,10219,2804,7512,97799,2707
21059,81,4645,2650,3630,30795,1015
22442,3,97,2574,78,2169,19
19224,51,1583,2750,1187,7468,396
26711,0,27,2376,25,3352,2
45635,0,1128,492,984,12100,144
14344,435,26662,2992,18800,63245,7862
42620,4,274,1291,176,4599,98
17292,0,195,2834,150,4752,45
37257,1,57,1829,43,3332,14
30144,18,269,2193,228,5185,41
45973,3,46,351,36,1884,10
45525,5,58,534,49,2709,9
16916,5,215,2856,174,4587,41
10087,10,130,3253,117,8551,13
45923,2,153,375,116,3473,37
39447,0,0,1685,0,3740,0
27098,4,142,2360,118,4813,24
26789,5,372,2372,318,5501,54
7587,20,658,3413,449,11026,209
8264,55,1801,3360,1432,40038,369
13726,0,22,3038,16,2948,6
15285,18,616,2934,469,5053,147
15614,122,2587,2918,1968,26107,619
45629,40,779,493,629,8893,150
28031,230,21856,2304,14173,79623,7683
20134,4,106,2702,91,1534,15
29931,505,14554,2203,10336,69942,4218
6048,6,212,3488,152,9435,60
25568,60,1874,2428,1410,13898,464
18954,8,450,2761,376,4496,74
38805,2,108,1724,87,4196,21
16035,13,920,2900,675,15899,245
42055,0,44,1405,28,5400,16
43426,2,93,1069,61,4796,32
12266,3,428,3141,349,7719,79
40370,21,878,1623,665,11250,213
2803,20,871,3606,711,13089,160
2141,58,2468,3617,1961,25991,507
31983,5,314,2098,250,5248,64
17590,0,2497,2819,1846,28377,651
22143,36,1412,2588,1177,12822,235
38515,47,1994,1744,1448,28850,546
22220,3,431,2584,357,6356,74
11248,91,2256,3192,1771,46857,485
38125,40,987,1771,627,8704,360
30187,2,74,2190,66,8841,8
7646,7,407,3409,338,6322,69
22147,0,0,2588,0,28775,0
19762,5,94,2722,81,11786,13
20112,260,16901,2703,10124,96525,6777
20432,432,45415,2686,29425,118313,15990
19122,15,429,2754,331,5773,98
37886,12,412,1787,313,5644,99
29136,16,549,2243,440,7592,109
12551,278,14622,3125,10826,116934,3796
13133,463,33551,3089,22694,253534,10857
23717,44,1085,2511,828,11872,257
40633,18,316,1600,243,14537,73
25073,44,2116,2450,1666,8342,450
4938,3,46,3545,38,2270,8
14898,11,263,2955,199,4542,64
1899,17,469,3622,376,17078,93
15116,130,3496,2942,2598,15314,898
19571,7,572,2732,433,7204,139
37144,141,4724,1836,3451,36981,1273
28459,17,790,2280,613,8183,177
22395,1,303,2576,249,4405,54
22289,2,74,2581,56,2001,18
38903,10,484,1718,384,6204,100
3354,151,6347,3596,4992,56488,1355
30816,267,6688,2156,5136,39843,1552
2677,6,232,3609,185,5569,47
33092,49,1520,2048,1224,35532,296
40915,8,129,1574,99,6308,30
31692,308,19618,2112,12502,147839,7116
30755,5,116,2159,94,4364,22
18151,7,469,2795,361,8800,108
6060,1,138,3488,121,3333,17
21324,2,129,2634,98,1978,31
15936,9,929,2906,767,7568,162
10605,11,539,3227,429,16322,110
26029,28,1326,2406,1059,7576,267
40378,83,2014,1623,1547,19501,467
18465,2,214,2781,176,4430,38
43092,51,1856,1168,1251,24382,605
46455,1,22,148,21,725,1
6038,13,615,3488,487,7081,128
8312,3,297,3356,234,5814,63
7869,21,408,3393,336,25574,72
13645,15,907,3045,601,13114,306
32270,8,250,2083,203,3817,47
19968,12,833,2710,642,15124,191
20662,40,1832,2675,1522,41357,310
24444,87,4696,2478,3404,63595,1292
9068,6,314,3310,235,12423,79
8304,5,173,3357,132,7467,41
9436,33,1220,3286,957,22504,263
18663,1,63,2772,55,1700,8
44742,14,152,781,138,4834,14
31865,1,28,2104,23,2454,5
22384,100,4660,2576,3223,43865,1437
17179,55,1397,2840,1061,12594,336
28273,43,1220,2290,910,15918,310
24001,15,411,2498,319,6680,92
38302,1,64,1759,52,4503,12
33616,60,1474,2029,1217,23845,257
19022,531,33503,2758,24001,181646,9502
21806,29,778,2607,543,4030,235
41447,182,2907,1504,2075,17770,832
27961,3,222,2308,188,3855,34
17812,17,747,2811,602,11055,145
17764,2,391,2813,269,3299,122
46394,2,78,182,54,1548,24
9065,14,575,3310,471,6814,104
35409,46,529,1948,381,6733,148
25113,120,6680,2447,4605,43372,2075
22374,5,393,2577,333,6729,60
19932,8,261,2713,202,5770,59
4130,25,593,3577,472,8716,121
16439,18,403,2880,310,10741,93
29326,33,1026,2232,772,9939,254
22599,5,243,2565,203,3698,40
42922,61,1737,1218,1181,10492,556
22781,7,228,2557,176,3963,52
3454,27,994,3595,795,15601,199
39299,58,1662,1692,1184,18556,478
43434,63,1406,1067,1103,22484,303
2850,31,1129,3606,725,14732,404
7691,14,777,3406,648,11932,129
6352,7,55,3476,48,4093,7
25453,0,400,2434,329,13551,71
2727,6,190,3608,129,4674,61
34226,2,64,2009,50,1331,14
11624,3,154,3173,107,7221,47
21918,4,197,2601,152,4974,45
6941,9,322,3450,221,4111,101
46276,32,479,236,421,7701,58
37085,5,197,1840,164,3981,33
42489,47,1144,1316,839,19590,305
18923,11,694,2762,590,4255,104
26673,21,628,2378,463,5187,165
12505,39,1167,3126,798,35347,369
10454,7,279,3236,221,6784,58
1802,37,2212,3626,1632,25457,580
16994,81,4087,2852,2936,30270,1151
5517,16,928,3515,734,8945,194
9303,24,438,3296,340,5673,98
4509,10,267,3563,222,14311,45
18269,25,1634,2789,1231,12580,403
28071,8,562,2301,437,7407,125
11052,1,63,3204,47,3015,16
35296,60,1274,1953,987,7641,287
32883,78,2032,2057,1499,14439,533
2073,111,4008,3618,2917,49799,1091
6900,31,1196,3452,951,28899,245
40950,91,2263,1571,1571,18799,692
18298,38,1201,2788,959,22118,242
32586,3,92,2070,76,4175,16
10541,7,157,3232,125,6334,32
25591,130,4598,2427,3178,23010,1420
35502,0,27,1941,21,3259,6
17697,11,779,2816,588,14337,191
2658,4,169,3609,140,7513,29
22602,78,2289,2565,1678,20170,611
15500,144,5874,2925,3942,23030,1932
44166,66,803,888,618,25276,185
7491,18,550,3419,398,12156,152
19072,0,190,2756,151,4177,39
26216,59,1681,2398,1270,17102,411
36925,13,344,1850,285,6943,59
8372,0,22,3352,17,1234,5
6569,5,50,3467,39,3250,11
5218,11,440,3529,324,4761,116
32840,59,4532,2059,3380,45045,1152
43599,52,745,1012,634,22415,111
4339,11,127,3569,101,4666,26
1881,7,176,3623,140,8533,36
23891,4,308,2504,236,5335,72
34240,3,77,2008,59,2300,18
28413,5,87,2282,70,3015,17
8221,21,624,3363,516,12425,108
12523,1,73,3126,35,1267,38
40567,5,121,1605,89,3375,32
30762,1,108,2159,84,2010,24
20171,2,128,2699,114,5589,14
2421,7,339,3613,285,5297,54
33045,6,125,2051,106,3606,19
31641,8,205,2115,169,6503,36
3483,9,269,3594,210,4437,59
3490,11,289,3594,217,7114,72
19703,7,573,2726,458,9269,115
29021,7,676,2249,533,13141,143
41659,3,182,1474,134,5444,48
42531,4,118,1308,89,3609,29
33512,13,482,2032,383,10788,99
7105,4,38,3441,32,2448,6
14180,5,263,3005,182,7935,81
28799,37,1162,2260,864,30547,298
3546,4,57,3593,47,2687,10
25695,215,14468,2421,10695,63689,3773
42929,218,2798,1216,2110,22859,688
38985,170,5151,1713,3846,38985,1305
2545,15,771,3611,583,27018,188
41588,6,116,1485,85,5857,31
46286,23,305,233,263,5350,42
42769,55,675,1257,533,10222,142
3100,5,167,3601,140,3607,27
18675,38,1866,2772,1469,18912,397
15103,67,3138,2943,2620,26193,518
19075,4,728,2756,511,13448,217
3518,61,2609,3593,1956,26648,653
13283,125,8512,3073,6398,97716,2114
41819,1,68,1442,54,3206,14
3831,2,100,3587,77,4120,23
46013,1,79,332,65,2530,14
23757,132,4117,2510,2846,26030,1271
41294,59,1333,1526,1060,13257,273
24807,185,8208,2462,5587,69947,2621
24667,35,536,2467,409,4938,127
30042,0,18,2198,15,2069,3
11148,9,432,3197,322,10842,110
13707,326,17970,3041,13195,67179,4775
1936,3,122,3621,87,8327,35
2620,31,873,3609,730,12085,143
29514,3,922,2223,730,25052,192
4979,120,3334,3543,2669,32348,665
42799,25,887,1245,665,11363,222
9424,1063,52342,3287,36137,161733,16205
45742,9,76,441,71,2477,5
19633,10,631,2730,481,10001,150
26204,22,974,2399,755,12796,219
37072,21,911,1841,717,9689,194
32335,8,1083,2080,905,18614,178
38427,104,3270,1750,2511,14728,759
26103,1221,79548,2404,53673,226152,25875
4402,11,62,3567,52,6012,10
42083,24,876,1398,671,21149,205
41684,0,39,1469,27,2272,12
11827,3,66,3163,45,4640,21
5525,6,165,3514,142,5984,23
24835,65,5895,2460,4553,75730,1342
2987,95,7232,3603,5389,27353,1843
12169,38,1072,3146,788,15181,284
10480,12,926,3235,706,42361,220
31134,3,326,2142,241,4920,85
12098,3,75,3150,67,7715,8
2411,278,13329,3613,9944,68871,3385
38016,50,1568,1779,1183,18576,385
34742,4,144,1983,114,5174,30
4781,151,4990,3553,3639,70812,1351
35492,33,871,1942,661,8488,210
38820,1,65,1723,49,2027,16
37022,7,240,1844,200,10027,40
3700,1886,95645,3589,67212,324433,28433
29669,34,1940,2216,1441,15047,499
39550,758,30407,1679,14750,189724,15657
24831,250,11518,2460,8928,90431,2590
2074,113,3189,3618,2574,21490,615
37522,16,428,1812,367,8659,61
42248,16,948,1364,698,11763,250
2957,5,239694,3604,84731,7343,154963
2047,7,234,3619,182,6291,52
29338,15,525,2232,426,4327,99
44852,38,422,745,298,5086,124
29723,0,57,2213,52,4395,5
9884,6,46,3263,39,2977,7
26689,144,3547,2377,2559,13955,988
5122,95,2192,3535,1756,14399,436
14370,94,5719,2990,3461,36224,2258
20310,0,86,2692,72,3171,14
6962,32,1135,3448,936,10197,199
20390,8,226,2689,176,7249,50
17044,8,359,2848,289,5632,70
9905,0,21,3263,15,1938,6
15269,0,41,2934,36,2395,5
31578,16,271,2119,212,3732,59
8596,13,387,3338,323,4377,64
18731,31,1759,2770,1301,15299,458
21553,10,585,2621,486,6691,99
37279,84,1116,1828,854,9584,262
11165,550,23556,3196,18331,79178,5225
21106,257,10646,2647,7345,41762,3301
19866,16,298,2716,253,3058,45
7912,9,199,3388,165,4441,34
42227,122,2003,1368,1431,27501,572
17034,548,31573,2849,22236,109531,9337
7417,2,97,3423,86,4851,11
45589,187,3377,512,2526,17503,851
19127,0,1080,2754,812,15133,268
32587,6,158,2070,137,3757,21
43760,0,55,960,40,4546,15
43534,18,403,1036,301,8556,102
31359,52,2314,2131,1715,22354,599
34916,29,776,1973,605,7073,171
38117,20,272,1771,219,4968,53
25278,4,682,2441,546,5435,136
22098,86,3239,2589,2544,31308,695
45974,49,883,351,745,11648,138
16957,77,2562,2854,1914,17000,648
40101,1,46,1645,36,2985,10
6573,3,74,3467,49,2647,25
45179,1,12,629,6,3359,6
28369,8,365,2285,298,5455,67
45563,15,200,518,172,1743,28
37657,30,690,1804,548,4890,142
18905,50,1272,2762,977,11763,295
4135,393,18312,3577,13446,82175,4866
36086,2,56,1896,44,2147,12
40415,295,7387,1620,5210,37775,2177
36436,23,749,1879,567,20474,182
18975,5,211,2760,173,10545,38
39102,8,264,1706,204,10920,60
15085,27,999,2944,767,11623,232
26586,10,150,2381,111,2924,39
18403,13,812,2784,689,8297,123
29474,3,149,2225,122,3130,27
33738,248,16230,2024,10972,83838,5258
40858,4,138,1578,114,6270,24
3878,101,9938,3585,7431,54795,2507
37459,4,250,1817,208,5848,42
13976,10,506,3017,391,4067,115
38343,12,421,1755,338,9225,83
36563,676,31272,1872,23254,145102,8018
19125,39,1266,2754,1053,13315,213
10450,362,26671,3237,17334,255912,9337
3376,9,95,3596,84,4186,11
5933,11,1164,3493,812,16958,352
30462,2,51,2174,42,1932,9
39566,6,164,1678,138,10999,26
35372,24,270,1950,224,3574,46
18123,7,197,2796,166,2774,31
24762,77,3307,2463,2357,28825,950
25037,29,800,2451,602,8057,198
44812,12,136,759,112,6436,24
17344,16,409,2831,337,4605,72
29307,50,1072,2234,850,6862,222
2595,9,223,3610,171,6490,52
2433,4,194,3612,150,4204,44
45940,0,14,362,11,1182,3
14193,19,814,3004,612,9770,202
8147,14,263,3368,211,16563,52
9740,5,177,3270,150,2370,27
20955,4,204,2656,169,6698,35
7132,57,3957,3439,2521,30549,1436
8803,3,162,3325,132,5291,30
21941,0,6691,2599,5001,43791,1690
37375,25,924,1822,765,15948,159
21960,79,5747,2597,4345,21001,1402
19246,142,8934,2748,6782,73051,2152
21125,287,22626,2646,17004,103230,5622
36854,989,44838,1853,30481,226378,14357
9069,3,654,3310,507,10199,147
29392,14,2375,2229,1707,34090,668
7961,7,203,3383,169,5177,34
3016,127,7624,3603,5689,55695,1935
37857,7,152,1789,109,9422,43
2853,41,2590,3606,2103,34976,487
27638,813,16471,2327,11899,54316,4572
8504,3,77,3344,65,2563,12
26060,41,3539,2405,2623,35884,916
41200,0,0,1544,0,2542,0
35957,21,786,1907,607,15875,179
35711,7,185,1924,137,4218,48
41625,0,25,1479,20,1923,5
7176,80,4625,3436,3339,14365,1286
2770,36,500,3607,408,11062,92
15265,24,1248,2935,1027,25761,221
41178,3,198,1546,120,5151,78
21117,9,744,2647,618,11561,126
6402,12,420,3474,311,14444,109
11521,11,1173,3178,1029,6277,144
39626,539,32153,1674,24593,164641,7560
11557,8,84029,3176,28242,4760,55787
25936,6,458,2411,367,9318,91
7458,10,79,3421,66,6245,13
28921,0,45,2254,39,5531,6
17629,98,5289,2817,4006,44675,1283
31715,0,43,2111,35,3597,8
8197,45,2229,3364,1783,115766,446
27437,235,15761,2339,11073,61240,4688
42433,8,265,1327,192,6377,73
30233,0,189,2188,145,4155,44
19875,16,1151,2716,873,10184,278
28392,0,131,2283,88,2396,43
35232,23,542,1956,415,7880,127
29130,2,217,2243,195,4570,22
34959,10,436,1971,298,7171,138
17306,1,45,2833,40,3749,5
17118,607,42396,2843,25427,226636,16969
25090,3,123,2449,98,2373,25
5060,9,137,3539,113,3526,24
11751,41,1627,3166,1290,33835,337
22846,742,29920,2553,22819,155791,7101
34377,26,459,2002,381,6123,78
32244,12,316,2084,257,4125,59
44725,8,80,786,51,2827,29
39702,21,811,1670,578,14009,233
36665,88,1851,1865,1412,11956,439
9457,9,109797,3285,38148,16564,71649
33096,1,136,2048,106,6686,30
9287,167,6430,3297,3943,19562,2487
11676,69,2846,3170,2289,24036,557
27340,0,10,2345,10,1756,0
9668,3,267,3273,211,3589,56
30444,5,255,2175,190,3941,65
28541,2,48,2273,27,2700,21
24811,28,978,2461,790,13009,188
20860,5,202,2662,155,3186,47
7710,4,137,3406,105,1695,32
4973,11,718,3543,580,15805,138
6413,3,124,3474,98,7035,26
6445,15,606,3473,450,10114,156
8566,6,292,3339,186,13723,106
37361,15,508,1823,387,5866,121
40824,267,10381,1581,7545,69627,2836
33014,0,31,2052,25,1792,6
21384,59,2630,2630,1859,39885,771
38952,8,299,1715,230,8542,69
46379,5,94,191,70,2117,24
34970,1,63,1970,57,3116,6
39231,17,236,1697,180,5944,56
3808,27,942,3587,782,25745,160
33954,0,31,2017,27,1469,4
28977,5763,351942,2251,247900,1256161,104042
20561,0,1698,2679,1254,8055,444
45737,2,53,441,45,1784,8
9537,6,362,3280,286,7655,76
23529,7,549,2521,426,8197,123
33700,37,1114,2026,846,15029,268
41535,4,367,1493,276,10128,91
23748,29,1118,2510,888,12568,230
28432,266,8301,2281,6204,40590,2097
38744,19,717,1728,455,9342,262
2512,107,3040,3611,2109,25276,931
11435,11,162,3183,130,15538,32
35291,46,473,1953,374,4165,99
43018,192,3367,1192,2503,44690,864
23864,0,60,2505,51,4930,9
46023,145,1752,330,1434,12405,318
33574,522,6679,2030,5332,24178,1347
12299,90,7854,3139,5573,70385,2281
35596,1,30,1933,24,1936,6
8198,201,6213,3364,4719,62740,1494
3756,162,7376,3588,5658,34747,1718
22817,10,1106,2555,812,8414,294
5664,8,465,3506,341,8307,124
8050,24,657,3371,519,10588,138
12813,6,237,3110,192,8350,45
18149,11,511,2795,401,8487,110
18694,6,485,2771,380,4932,105
13016,34,1641,3097,1334,11079,307
3091,34,1352,3601,1025,28227,327
7954,2,206,3383,159,8699,47
26582,11,663,2382,520,7503,143
4490,126,4763,3564,3621,34414,1142
12494,25,738,3127,606,4435,132
8677,294,13492,3332,9914,78710,3578
46246,4,16,245,12,998,4
17464,206,7012,2825,5012,49504,2000
30822,25,1554,2156,1070,16303,484
26002,6,248,2408,212,1807,36
16371,3,225,2883,186,3989,39
2393,27,1019,3613,782,22322,237
8929,17,508,3318,424,8005,84
20217,21,488,2696,363,14481,125
9569,50,2871,3278,2187,23466,684
31815,5,152,2106,120,7327,32
13692,207,14721,3042,11330,65875,3391
35557,16,410,1937,337,5296,73
30338,22,422,2181,317,5735,105
42706,3,145,1272,103,4992,42
5121,26,1039,3535,819,15025,220
33379,5,107,2038,85,2405,22
8062,11,1555,3371,839,11325,716
20316,4,150,2692,123,4601,27
37312,0,33,1825,25,4540,8
43155,0,43,1151,31,2518,12
32749,3,407,2063,353,6210,54
19324,25,925,2744,744,10593,181
22880,26,951,2552,744,4363,207
16069,9,478,2898,352,6462,126
3311,959,36482,3597,23753,154744,12729
28217,5,225,2293,167,2779,58
39027,33,807,1711,610,8639,197
10761,37,673,3218,512,4342,161
33621,30,592,2029,499,10859,93
22021,20,2502,2594,1806,13538,696
13267,160,8770,3074,5943,56535,2827
34547,24,1780,1994,1292,28365,488
26709,128,6561,2376,4836,39459,1725
7003,0,16,3446,15,1147,1
3391,29,908,3596,702,9043,206
24838,0,2086,2460,1572,24289,514
45137,8,93,641,73,2192,20
43659,21,325,990,278,8259,47
39019,37,1388,1711,1138,8279,250
11171,0,51,3196,37,4172,14
16832,29,982,2860,810,9535,172
44815,2,19,757,14,1357,5
42979,5,173,1203,128,7626,45
14863,7,391,2957,314,7180,77
11142,121,5734,3198,4330,43247,1404
25181,36,2530,2444,2052,15776,478
33452,6,223,2035,165,6655,58
38631,4,165,1734,110,5878,55
18155,0,11,2795,9,1454,2
41300,20,1455,1525,1052,24696,403
7372,52,2146,3426,1547,50315,599
12000,11,315,3155,241,6794,74
24748,25,668,2463,508,11498,160
23903,28,868,2503,699,8770,169
19552,16,466,2733,375,6103,91
31531,9,151,2121,114,2122,37
16914,22,1624,2856,1303,16987,321
12814,3,344,3110,287,22406,57
19889,14,597,2715,428,8021,169
29647,7,478,2217,361,5624,117
3093,21,1930,3601,1474,21663,456
40733,9,225,1592,162,3472,63
21641,100,8183,2616,5102,81275,3081
28061,66,7912,2302,5712,19934,2200
42590,9,355,1297,238,9007,117
12400,4,175,3133,144,3775,31
26696,2,151,2376,84,5580,67
4260,12,280,3573,225,11449,55
25511,160,4955,2431,3664,16543,1291
44670,9,151,806,112,5730,39
32769,2,73,2062,67,6056,6
16500,1417,185899,2878,116930,421859,68969
8083,9,47,3370,39,4555,8
9249,0,85,3299,56,2478,29
29046,16,477,2248,335,13970,142
9361,4,141,3291,105,12944,36
7807,17,299,3399,241,12343,58
40225,2,141,1637,118,2394,23
26512,11,409,2384,341,5083,68
15682,10,516,2915,413,7354,103
40985,5,259,1569,199,4731,60
4493,4,56,3564,48,1931,8
12959,838,48527,3101,34409,461475,14118
42106,3,90,1395,79,6154,11
21545,4,190,2621,151,2658,39
13797,15,566,3034,444,4307,122
37329,111,2035,1825,1432,59261,603
9274,4,142,3298,110,5572,32
4068,56,973,3579,800,20413,173
7983,57,2323,3380,1765,14840,558
18845,5,367,2764,284,6317,83
32739,83,1295,2064,997,10974,298
36996,35,684,1845,510,10398,174
3323,90,5331,3597,3665,29326,1666
23007,12,462,2545,348,5985,114
24419,1,188,2479,144,9760,44
42313,8,121,1352,88,3351,33
37935,76,737,1783,558,6654,179
10737,35,2102,3219,1689,21243,413
23204,54,1501,2536,1201,9508,300
24438,11,423,2478,368,5144,55
30635,96,3287,2165,2629,22071,658
9604,1,30,3276,25,1667,5
34669,104,1021,1987,765,9229,256
4441,33,697,3566,553,15628,144
43633,9,129,1000,98,6296,31
37851,50,728,1789,551,8650,177
40100,5,373,1645,294,11048,79
35299,6,154,1953,129,1634,25
30374,16,426,2179,333,4028,93
6850,15,366,3454,271,8315,95
8059,0,34,3371,30,2905,4
18961,38,1270,2760,988,12155,282
36577,2,51,1871,38,3068,13
35150,4,165,1961,141,5192,24
30639,5,236,2165,173,6565,63
12676,8,175,3118,135,4173,40
34212,4,136,2009,111,8037,25
14434,69,8613,2986,5766,79647,2847
6830,37,1607,3455,1304,36287,303
33604,17,968,2029,734,12391,234
21099,0,432,2648,369,10764,63
34155,113,9668,2011,7398,53278,2270
43962,171,3289,925,2425,36908,864
26223,67,8440,2398,5886,30137,2554
2830,1,25,3606,18,2609,7
18006,10,607,2801,482,6047,125
42658,132,1835,1282,1471,13742,364
13673,57,2182,3043,1576,14014,606
33994,95,2562,2015,1962,12561,600
20622,38,4010,2677,2819,33728,1191
24647,298,11969,2467,8840,51338,3129
23939,16,600,2500,508,7084,92
26064,3,249,2405,202,7831,47
25059,2,91,2450,86,8787,5
1794,25,717,3626,568,10083,149
26850,0,1895,2369,1514,27189,381
16544,1183,114593,2875,86158,240226,28435
37330,3,197,1825,160,3687,37
9084,53,2356,3309,1838,24946,518
23523,105,2194,2521,1672,14785,522
23860,15,1272,2505,1051,11990,221
2520,302,13582,3611,9929,82509,3653
40163,83,3155,1641,1980,18460,1175
17525,281,15285,2822,11297,56567,3988
18592,117,5895,2776,3951,63816,1944
17331,13,639,2832,462,3276,177
27946,1,33,2308,29,3309,4
31021,2,96,2148,76,4938,20
40105,7,311,1644,237,8345,74
43391,1,77,1079,46,4754,31
40603,5,99,1602,78,1591,21
32285,0,25,2083,20,1809,5
8288,105,5109,3358,4014,49621,1095
45992,67,597,343,468,6370,129
23395,12,641,2527,470,11931,171
27787,6,494,2317,414,9798,80
41557,6,223,1490,175,9820,48
30849,3,103,2155,85,1534,18
41566,5,67,1489,54,4632,13
3854,25,697,3586,534,35578,163
15415,29,1307,2929,982,6274,325
12499,1,15,3127,12,1719,3
18647,63,1638,2773,1128,13009,510
46262,21,283,241,249,5623,34
40061,2,117,1647,65,5079,52
10924,1,90,3210,59,3677,31
37893,9,297,1787,238,5101,59
18163,22,1206,2795,986,25044,220
42903,4,63,1224,55,7304,8
40467,6,119,1614,90,6269,29
39767,5,153,1667,105,5627,48
6996,372,20159,3447,14278,112070,5881
24902,35,1478,2457,1257,20499,221
12529,1,109,3126,43,1344,66
38997,6,195,1712,165,9224,30
2762,4,71,3607,62,2686,9
16260,13,357,2889,285,4116,72
13107,44,2027,3091,1534,24808,493
21549,8,306,2621,231,2531,75
11140,1,182,3198,130,6401,52
30453,14,1272,2175,1053,9991,219
18486,26,2120,2780,1545,19924,575
25480,27,889,2432,756,13244,133
12861,5,122,3107,89,2322,33
5805,3,201,3500,145,11709,56
18275,173,6642,2789,4708,33989,1934
44676,12029,338741,795,239801,1294496,98940
24013,22,2092,2497,1431,5345,661
9432,46,1681,3287,1218,20105,463
29207,38,2797,2239,2153,27912,644
24371,0,55,2481,46,3048,9
29691,4,68,2215,62,4444,6
15297,60,3134,2933,2457,24573,677
3861,831,23922,3586,18473,127227,5449
26388,5,323,2390,268,6539,55
39487,370,7034,1683,5415,32266,1619
20689,9,422,2673,342,4105,80
18778,6,431,2767,335,19978,96
41599,987,23104,1482,16768,123869,6336
7137,13,191,3439,151,4874,40
31339,10,889,2132,803,5883,86
25585,18,878,2427,650,11886,228
29781,4,107,2210,80,6929,27
3916,19,107,3584,101,14246,6
30870,77,3155,2154,2275,16507,880
8415,5,163,3350,124,5564,39
3174,4,160,3600,130,2310,30
43468,4,160,1059,115,4697,45
45707,2,18,455,13,1510,5
4118,94,4820,3577,3826,67646,994
10869,5,255,3213,211,7472,44
24381,36,1497,2481,1123,16687,374
3574,113,9945,3592,7297,162912,2648
32238,55,2292,2084,1749,12639,543
42714,43,590,1271,422,8247,168
15649,30,3273,2917,2484,54807,789
33198,70,2736,2044,2152,57717,584
18635,22,566,2774,434,6561,132
17579,1,65,2820,54,2561,11
31655,6,111,2114,95,1357,16
13825,24,1920,3032,1447,20325,473
15400,7,233,2929,165,4668,68
30308,11,342,2184,275,3563,67
8834,29,789,3323,609,7195,180
44079,90,3378,892,2531,10275,847
10312,613,23713,3243,17832,310021,5881
25996,337,19173,2408,11247,84102,7926
21679,6,672,2613,543,6804,129
4746,19,422,3554,339,8210,83
25394,41,2672,2436,2015,24666,657
8184,167,5031,3365,3885,38561,1146
31250,1,105,2137,85,1979,20
45915,19,174,380,146,5919,28
1972,35,1155,3620,904,15953,251
17788,9,339,2813,245,12364,94
15406,27,1109,2929,858,10039,251
19378,23,799,2742,637,11138,162
31636,153,4580,2115,3485,24437,1095
28353,2,287,2286,231,10477,56
39559,61,1134,1679,895,12119,239
31948,1,101,2100,85,3472,16
32634,38,1843,2068,1310,22912,533
34887,9,300,1974,252,10226,48
36611,0,196,1868,153,4151,43
28328,13,790,2287,618,10999,172
7794,99,5633,3399,4411,43066,1222
6963,17,428,3448,364,15571,64
22862,2,221,2553,192,5305,29
8904,52,2632,3320,2121,17408,511
31734,100,1496,2110,1143,13509,353
39642,386,7164,1674,5738,37788,1426
13410,4,172,3063,134,5041,38
34058,12,383,2013,312,15671,71
25733,17,1102,2420,888,19532,214
39654,1,79,1673,60,4604,19
24412,0,8596,2479,6527,33089,2069
31093,3,171,2145,146,3728,25
3361,133,5716,3596,4193,37811,1523
14454,649,35336,2985,24642,163801,10694
28757,0,44,2262,37,1818,7
9188,9,635,3302,521,11634,114
20773,12,443,2668,356,5071,87
29919,17,1543,2203,1315,13551,228
30936,17,406,2152,308,4326,98
25056,0,87,2450,73,7319,14
6328,13,494,3477,318,10530,176
5345,8,808,3523,617,8656,191
8417,4,96,3350,76,3539,20
8642,5,107,3335,78,2302,29
41460,13,245,1502,187,5158,58
33998,2408,144758,2015,102451,396767,42307
8212,0,11,3363,10,1487,1
9829,204,36274,3265,23956,72356,12318
34241,43,697,2008,576,6608,121
13953,242,8877,3019,6400,61103,2477
7605,4,119,3412,98,2552,21
21837,5,325,2606,265,2624,60
40001,66,763,1650,596,5516,167
16152,27,979,2894,766,14857,213
10907,39,721,3210,583,12917,138
3302,6,148,3597,112,7415,36
6855,1394,72452,3454,47331,417005,25121
5497,6,158,3515,140,2318,18
22569,12,380,2566,311,13294,69
29037,63,1431,2248,1175,24009,256
30552,5,151,2169,117,3421,34
39254,11,207,1695,149,4890,58
5292,3,88,3525,63,10122,25
16983,53,2203,2852,1588,16264,615
44939,10,170,722,115,4924,55
12296,6,449,3139,383,7352,66
35379,23,1663,1949,1247,10014,416
36195,103,1231,1890,972,21244,259
26416,2,135,2389,108,4161,27
7517,1,76,3417,69,2532,7
12188,49,1270,3145,993,24550,277
15013,33,3152,2948,2244,16782,908
35262,25,380,1954,304,6877,76
31466,0,91,2125,68,3450,23
4970,159,8728,3543,5698,50348,3030
15923,7,194,2906,151,5919,43
37538,3,172,1811,147,3462,25
43783,23,418,951,296,13717,122
31717,0,44,2111,30,4038,14
4420,36,1177,3566,909,34035,268
33134,34,884,2046,724,14096,160
30549,15,637,2169,500,8459,137
5399,5,219,3519,156,4840,63
36673,871,37023,1865,25593,187785,11430
20562,3,54,2679,49,3032,5
5912,7,85,3494,57,6182,28
22832,0,115,2554,88,4218,27
20517,90,7075,2682,4113,33613,2962
42289,8,217,1356,159,4412,58
23661,118,8729,2513,5967,43495,2762
11473,193,11210,3181,8430,62499,2780
13192,24,1649,3079,1330,21026,319
4248,31,1008,3573,852,13065,156
5047,15,349,3540,294,10855,55
41729,40,1464,1462,1003,30589,461
11362,309,17233,3187,12005,52698,5228
23454,28,629,2524,524,5924,105
12516,3,114,3126,81,1477,33
21535,0,60,2622,48,4546,12
31706,5,325,2112,251,8558,74
5378,4,85,3521,55,2311,30
27447,2,85,2338,72,3001,13
16571,27,1496,2874,1137,13413,359
6021,960,27265,3489,19543,165014,7722
7208,87,5329,3435,3901,56223,1428
15053,11,288,2945,223,4137,65
39237,13,451,1697,364,9080,87
40471,302,10570,1614,7821,67270,2749
21875,8,532,2603,461,16136,71
30092,8,310,2196,253,8748,57
33170,117,4328,2045,3414,41202,914
24606,529,14617,2469,10207,59865,4410
16121,161,7484,2895,5537,60917,1947
6498,4,160,3470,84,4112,76
5827,4,175,3498,132,4843,43
5955,2,47,3491,33,5259,14
43302,22,487,1108,319,5019,168
32982,5,227,2053,184,5796,43
18578,3,122,2777,99,6571,23
15047,23,493,2946,421,14577,72
29409,20,1481,2229,1084,29384,397
27645,6,453,2326,359,8554,94
37754,5,210,1797,169,4911,41
12166,6,64,3146,52,2156,12
37907,4,150,1785,124,4251,26
41098,25,1912,1555,1340,18718,572
20948,6,409,2656,325,10347,84
5164,8,324,3532,228,16345,96
40980,119,1858,1569,1335,10012,523
2945,8,168,3604,141,8463,27
1779,5,153,3632,128,3025,25
29745,0,126,2213,100,2846,26
29139,19,589,2243,455,6037,134
43811,13,249,947,199,6466,50
13782,64,1599,3035,1253,11147,346
24483,81,3242,2476,2355,18110,887
14480,2,110,2983,97,4937,13
45972,17,142,351,114,2146,28
22226,442,20548,2583,13403,125210,7145
20905,27,1758,2658,1243,16732,515
38080,3,59,1775,53,3180,6
7125,14,258,3439,183,9446,75
39404,124,2138,1687,1594,12282,544
4189,641,26867,3575,18764,63042,8103
15309,5,394,2932,301,8799,93
5397,52,1976,3520,1308,21074,668
42348,8,279,1346,207,14723,72
8657,78,124638,3334,35360,19369,89278
39948,74,2303,1654,1740,23133,563
42506,30,951,1312,624,11284,327
38359,6,84,1754,68,7548,16
19790,0,0,2720,0,1451,0
18590,582,54076,2776,40360,331579,13716
21714,14,190,2611,148,2271,42
45505,70,1070,541,771,8584,299
45583,10,136,513,65,1988,71
12399,3,146,3133,118,2571,28
18538,12,651,2778,552,12687,99
26700,40,1453,2376,1162,9351,291
3589,15,322,3592,223,4423,99
40777,30,1298,1587,959,21695,339
5537,20,569,3513,443,12365,126
42028,135,2611,1410,1805,29807,806
5170,184,5539,3532,3864,27417,1675
41123,10,163,1552,129,4405,34
14199,208,10115,3004,7186,88286,2929
40431,16,431,1618,313,8685,118
6173,66,1976,3484,1556,21134,420
13423,14,518,3063,406,13419,112
28734,28,1662,2263,1246,29133,416
2027,87,3098,3619,2621,25227,477
6459,1,321,3472,269,5840,52
6907,7,110,3452,94,2713,16
39761,66,2299,1668,1813,16341,486
7339,11,636,3427,519,9570,117
35944,65,2411,1908,1855,30871,556
27114,2,199,2359,163,3607,36
12255,42,2696,3141,1947,31646,749
29414,10,250,2228,201,5920,49
27460,8,627,2337,492,4101,135
21541,29,1119,2621,839,17615,280
7079,286,12378,3442,8934,66180,3444
9562,12138,957184,3278,577702,3027924,379482
7931,118,5914,3386,4327,42292,1587
39196,25,757,1700,571,15408,186
25565,0,646,2428,476,9953,170
16410,20,1108,2881,836,6077,272
16258,9,417,2889,357,3428,60
22948,2,198,2548,156,2743,42
11132,58,2025,3199,1620,33797,405
21120,154,8845,2646,6244,48119,2601
46462,18,273,143,251,3091,22
14836,7,357,2958,290,7518,67
43131,26,396,1158,333,12921,63
14000,93,9115,3016,6829,43519,2286
4575,4,107,3560,94,1889,13
9159,286,25584,3304,12561,125513,13023
4810,59,1882,3551,1273,9019,609
26774,15,202,2373,162,3660,40
36366,37,395,1881,324,5913,71
4570,5,318,3561,244,7100,74
37651,9,254,1804,203,7501,51
37739,7,783,1798,586,17900,197
2150,44,1445,3617,1156,23629,289
8623,21,300,3336,223,13708,77
13852,9,417,3029,295,6939,122
40863,86,1222,1578,891,11356,331
11883,17,250,3161,209,5252,41
30743,3,283,2159,224,5893,59
9558,49,184881,3279,55575,26791,129306
35609,5,865,1933,642,8275,223
16800,7,758,2861,600,13921,158
12554,108,8062,3125,5336,61156,2726
29738,13,441,2213,342,8809,99
30511,50,1172,2171,934,21721,238
19041,3,313,2757,234,2986,79
37237,41,3050,1830,2069,28799,981
42413,17,411,1333,287,9294,124
36689,12,253,1865,193,4753,60
39596,12,405,1676,303,14555,102
45138,136,979,641,752,12043,227
3427,68,2747,3595,2104,38267,643
8290,4,50,3358,43,2771,7
41887,6,373,1432,311,5399,62
9580,28,848,3277,628,13551,220
25811,14,309,2416,271,9777,38
5244,13,1288,3528,948,11169,340
32042,44,1867,2095,1412,20701,455
15382,3,120,2930,97,2524,23
12596,27,1053,3123,857,7983,196
11223,100,9270,3193,5184,61335,4086
2498,8,267,3611,192,9236,75
3779,129,4599,3588,3615,70093,984
43363,7,110,1089,72,5679,38
38413,135,4035,1751,2962,21725,1073
27690,104,4266,2324,3587,24000,679
32920,1,181,2055,142,3930,39
27173,23,466,2355,397,3311,69
29992,4,114,2200,91,3229,23
39274,64,819,1694,597,7567,222
32176,1,99,2087,75,4434,24
33253,6,379,2043,310,8477,69
5223,22,860,3529,687,9321,173
2403,79,3560,3613,2747,35614,813
15604,14,659,2918,476,5646,183
7894,1,120,3390,98,4070,22
41832,179,2936,1440,2096,18247,840
9567,5,160,3278,124,4996,36
10599,3,61,3228,47,3529,14
3529,106,3305,3593,2598,27901,707
12741,61,2852,3114,2301,25337,551
9757,9,82812,3270,27815,13199,54997
33913,14,196,2018,168,7133,28
15981,56,1975,2903,1555,12066,420
43033,13,323,1187,219,4614,104
21166,43,2386,2642,1727,30044,659
17042,345,23026,2848,16527,90720,6499
18665,4,337,2772,276,11617,61
13556,17,1434,3051,1124,34038,310
37188,32,663,1834,471,7203,192
23500,1,12,2522,10,1327,2
11159,3,140,3197,83,2956,57
28580,46,2386,2271,1800,23475,586
2793,10,316,3607,230,11167,86
22865,7,172,2553,146,2322,26
45911,22,180,382,137,3636,43
43605,24,482,1008,387,16316,95
10105,6,276,3252,217,3634,59
25065,12,215,2450,179,3799,36
27201,9,778,2353,580,9871,198
13845,28,1548,3030,1191,17637,357
24066,2,67,2495,50,3203,17
26778,14,373,2373,285,6325,88
32102,40,2912,2091,2162,36533,750
24690,5,294,2466,221,10963,73
17151,1,259,2841,204,9502,55
46388,3,18,186,17,1233,1
2479,36,657,3611,489,7136,168
3575,236,12099,3592,9080,79868,3019
22819,899,33338,2555,23609,109938,9729
10099,30,851,3252,698,9936,153
6168,10,411,3484,346,5632,65
12558,24,1579,3125,1231,13717,348
43094,6,298,1167,196,7418,102
22961,365,26904,2547,15688,105702,11216
13288,11,550,3073,419,7411,131
15374,21,2584,2930,1972,12647,612
19961,5,254,2711,198,6904,56
6975,66,1671,3448,1369,17662,302
39950,19,618,1654,387,19636,231
24432,59,2024,2478,1454,12900,570
3402,231,9913,3595,7284,70398,2629
2308,213,16132,3615,11713,75568,4419
31131,24,1037,2143,791,13227,246
4702,24,742,3556,549,10223,193
38414,41,953,1751,665,6102,288
32293,48,1530,2083,1226,16612,304
38755,1,99,1727,81,5494,18
32133,15,494,2090,372,4346,122
38869,1016,31391,1720,22719,208085,8672
11565,2,78,3176,60,1147,18
30416,3,132,2177,114,3216,18
19690,3,123,2727,92,6036,31
14954,6,267,2951,223,4717,44
5309,4,212,3525,110,3974,102
30848,87,2396,2155,1863,22586,533
14732,1,123,2965,97,4415,26
31155,4,257,2141,195,5939,62
25361,11,610,2437,462,6715,148
33830,7,703,2021,612,3397,91
6400,49,882,3474,697,11367,185
6720,2,124,3461,107,2819,17
32455,159,4484,2076,3306,25414,1178
4774,153,2911,3553,2080,15771,831
42770,82,3201,1256,2334,38433,867
41705,46,1778,1465,1345,16668,433
14173,24,671,3006,535,6036,136
14039,10,523,3013,444,13076,79
29836,6,240,2208,200,2967,40
23732,18,740,2510,547,7642,193
31582,14,430,2118,347,4748,83
13232,173,10512,3077,7959,103421,2553
5868,59,1568,3496,1239,17336,329
19257,0,204,2747,161,6083,43
15760,5,325,2912,270,4872,55
24594,4,100,2470,78,2471,22
3219,44,1695,3599,1387,27080,308
18086,27,1782,2797,1332,29964,450
24279,337,164749,2485,114608,106134,50141
6667,12,284,3463,226,17284,58
13586,2,138,3049,110,7428,28
45032,74,878,692,770,12694,108
28915,23,773,2255,605,8957,168
2101,32,846,3618,684,7231,162
41412,4,70,1510,51,4736,19
39486,42,1203,1683,893,17795,310
39665,30,1389,1672,1085,10780,304
14345,50,3429,2992,2459,21728,970
27835,0,63,2315,43,4522,20
4541,31,1795,3562,1356,14105,439
3236,13,439,3598,374,8703,65
3835,12,166,3586,141,29974,25
42837,23,1457,1239,958,11439,499
27964,24,801,2307,605,7042,196
44312,11,101,866,84,6934,17
1735,2,76,3647,67,3232,9
44713,822,19552,789,15226,76711,4326
40933,8,465,1572,333,11715,132
37223,14,452,1831,386,12037,66
37036,8,488,1843,403,8676,85
4083,21,995,3579,780,14431,215
2426,30,1485,3613,1208,20870,277
2617,4,160,3609,131,3525,29
32924,3,77,2055,64,3128,13
14083,3,101,3010,76,4260,25
43118,6,204,1161,124,2387,80
9462,9,235,3285,192,2691,43
12234,184,7030,3143,5358,60952,1672
18477,101,6802,2781,4899,59633,1903
3145,5,172,3600,136,13561,36
20920,14,857,2657,701,10509,156
28394,1,64,2283,59,4881,5
3199,20,492,3599,382,21623,110
5740,12,286,3503,154,5143,132
3209,360,19713,3599,12817,102635,6896
11861,8,692,3162,480,12522,212
7939,5,114,3385,97,3335,17
6064,4,92,3487,78,2837,14
10652,2,37,3225,29,1550,8
39565,2,191,1678,143,9038,48
14407,7,573,2987,425,17844,148
43717,38,243,972,193,2963,50
3277,37,995,3598,715,21269,280
2208,123,3916,3616,3150,35740,766
3911,1,106,3584,84,3005,22
45207,18,177,622,116,2894,61
4279,20,427,3572,333,4792,94
19177,187,5785,2752,4126,36606,1659
43639,41,678,997,546,9409,132
6004,11,240,3489,194,10039,46
24954,0,7,2454,6,3731,1
46484,0,14,134,10,573,4
35821,6,181,1916,155,3251,26
4312,160,6403,3570,4265,49784,2138
10985,156,3237,3206,2511,21532,726
4822,66,1459,3551,1100,22805,359
18117,9,309,2796,250,8264,59
8404,4,58,3350,53,2430,5
40445,171,4086,1616,3034,22675,1052
4626,7,144,3559,117,4255,27
8845,14,1333,3322,1014,34553,319
46166,9,87,266,65,923,22
3465,27,952,3594,754,15336,198
30260,319,14554,2187,10447,48027,4107
23793,22,668,2508,537,11938,131
10905,24,866,3210,628,6751,238
2902,64,3270,3605,2447,36422,823
39416,18,246,1686,196,5489,50
17687,53,1434,2816,1135,20915,299
12810,11,355,3110,286,6224,69
16187,13,274,2893,205,6520,69
29632,24,983,2217,798,10434,185
22177,85,3774,2586,2744,48260,1030
24467,9,331,2477,269,7481,62
11832,0,44,3163,32,1395,12
27416,4,108,2340,89,2649,19
16506,14,1264,2877,982,13885,282
32299,102,3575,2082,2798,31795,777
24479,41,1625,2476,1280,13187,345
25809,1,81,2416,62,1718,19
45941,20,94,361,79,1349,15
14731,23,2707,2965,2067,19584,640
10448,64,4644,3237,3611,29411,1033
40682,7,245,1596,195,5771,50
12980,129,12241,3099,9501,70049,2740
7349,4,61,3427,47,2605,14
39419,69,792,1686,628,9052,164
45609,130,1421,506,1093,10403,328
14624,20,908,2973,731,10578,177
4038,1,64,3580,47,2190,17
2113,42,675,3618,528,13026,147
42774,84,1401,1255,1100,11864,301
32173,6,260,2088,232,11237,28
6897,14,626,3453,526,12411,100
39552,7,84,1679,71,3353,13
40692,58,1393,1595,1074,13893,319
45020,60,673,698,460,10013,213
43385,16,362,1080,227,8500,135
2331,116,3221,3614,2487,44357,734
23779,48,1958,2509,1517,39200,441
20868,18,712,2662,559,8457,153
28171,11,245,2296,209,4709,36
30984,125,3997,2150,2918,33462,1079
2205,69,2190,3616,1464,17975,726
8412,17,384,3350,327,5785,57
45561,13,249,518,170,3062,79
42743,127,4890,1261,3367,34443,1523
12701,40,1203,3116,828,29330,375
21318,12,1041,2634,815,25431,226
6972,85,3619,3448,2977,26971,642
1562,1,67,3685,58,2821,9
35988,13,283,1904,232,11519,51
33759,2,100,2023,83,5601,17
37510,64,2022,1813,1495,18422,527
30921,16,516,2152,373,11689,143
15387,5,476,2929,407,12241,69
43617,19,290,1004,203,8047,87
42243,42,2280,1365,1458,25091,822
12159,2,160,3146,136,6984,24
22175,20,1496,2586,1125,10328,371
41079,2,115,1557,92,5493,23
10121,63,2053,3252,1506,10884,547
40392,2116,73200,1621,55358,229390,17842
30321,4,141,2182,104,9334,37
14382,53,3652,2989,2435,40793,1217
17557,316,11842,2821,8520,54349,3322
39967,4,121,1653,106,5486,15
34414,24,977,2000,726,7387,251
25632,0,23,2424,19,1771,4
21466,8,155,2626,128,2585,27
21435,6,568,2628,422,17043,146
40223,4,106,1637,82,3996,24
32203,5,71,2086,63,2375,8
1471,2,27,3713,20,1926,7
35867,0,129,1913,98,6801,31
31319,50,1422,2133,1132,9730,290
33603,3,80,2029,60,2113,20
17405,30,594,2827,451,22935,143
3544,22,639,3593,523,10620,116
40699,252,5959,1594,4556,44243,1403
33653,22,553,2028,379,5943,174
6350,217,8965,3476,6841,34621,2124
9650,103,8305,3274,6069,85372,2236
8063,25,748,3371,548,14594,200
36470,9,219,1877,180,6456,39
40965,3,65,1570,55,8724,10
15623,6,711,2918,537,30508,174
29524,1,258,2223,210,7159,48
44875,4,116,740,102,5291,14
28065,82,2360,2302,1701,31955,659
3558,16,440,3592,334,23451,106
43566,39,534,1026,424,3873,110
12910,125,6069,3104,4466,36752,1603
26155,3,195,2402,170,4130,25
10790,45,1947,3217,1405,42232,542
30363,1,55,2180,40,2495,15
38155,23,287,1769,231,3676,56
42481,4,197,1317,137,8842,60
41781,31,695,1452,570,12174,125
30819,0,24,2156,22,1673,2
31017,58,1446,2148,1149,20684,297
38864,34,879,1721,626,10747,253
21159,94,4984,2643,3162,50515,1822
4284,45,2623,3571,1713,29018,910
17029,16,550,2849,384,16896,166
4033,14,282,3580,237,4623,45
2440,6,100,3612,83,4256,17
16302,2,98,2887,87,4269,11
26201,241,16411,2399,12492,81933,3919
43271,13,126,1117,94,3415,32
44114,92,1992,897,1468,15994,524
36487,7,307,1876,247,5342,60
24626,12,307,2468,212,2730,95
14438,345,16600,2986,12745,151615,3855
4445,103,2851,3565,2220,31344,631
7824,44,1115,3397,868,23524,247
32179,4,33,2087,30,3806,3
29547,0,0,2222,0,1394,0
24429,1,98,2479,87,2784,11
20442,27,1917,2685,1459,19296,458
20303,495,28561,2692,20822,73501,7739
33366,43,2571,2038,1757,29583,814
16309,15,573,2887,386,8007,187
30645,21,737,2164,580,7452,157
40910,14,550,1574,434,12706,116
12074,129,4666,3152,3419,23809,1247
28089,35,973,2301,731,7157,242
8784,32,991,3326,773,7430,218
12029,231,8506,3154,6061,52200,2445
19724,9,1003,2724,753,10400,250
30499,8,127,2172,99,2747,28
4098,5,225,3578,153,13116,72
31260,27,591,2136,469,6364,122
12997,1346,67131,3098,49409,539677,17722
7082,4,133,3442,99,5659,34
12138,65,1477,3147,1102,10104,375
8633,12,494,3336,400,6703,94
33350,0,28,2039,24,1457,4
40343,346,5159,1627,4040,29644,1119
33372,3,70,2038,65,5378,5
9937,217,12980,3261,9342,42449,3638
30389,2,67,2178,57,2304,10
7264,20,417,3432,335,8484,82
3116,4,113,3601,95,4425,18
6292,18,940,3479,778,20946,162
37184,38,2302,1834,1751,20732,551
944,8,530,3949,432,12923,98
27895,9,684,2312,586,7418,98
37385,519,16845,1821,13987,105164,2858
36834,14,280,1855,217,5312,63
6506,9,215,3470,186,4990,29
14595,29,1486,2974,1180,11282,306
14935,20,692,2953,552,14885,140
26866,0,1607,2368,1057,15426,550
30312,32,645,2183,489,7700,156
29361,127,4632,2231,3580,48665,1052
32906,1,48,2056,39,5591,9
15921,24,1003,2906,786,16249,217
10401,6,85,3239,73,4776,12
22313,8,305,2580,257,4193,48
20871,7,508,2662,398,21705,110
43903,20,275,933,199,4604,76
35065,87,1745,1965,1435,21507,310
40540,7,157,1608,124,6818,33
10215,1,61,3247,51,2086,10
23142,2,66,2539,49,6231,17
34822,4,112,1978,95,7201,17
46423,0,20,166,19,997,1
17960,135,5852,2804,4488,38275,1364
24403,50,2359,2480,1843,28890,516
2914,32,833,3604,582,10387,251
29654,11,217,2216,170,5742,47
39928,79,1483,1656,1178,15689,305
39778,7,225,1667,182,7722,43
13422,60,1949,3063,1644,14041,305
42907,3,86,1223,60,6088,26
28986,19,560,2251,455,7324,105
30604,163,5396,2167,4068,28866,1328
35248,0,391,1955,311,4558,80
1870,13,217,3623,189,8395,28
20831,47,4224,2664,3283,39607,941
40759,13,274,1588,230,5144,44
39120,35,902,1704,640,8061,262
3377,2,113,3596,95,3540,18
16950,316,19721,2854,14232,44202,5489
25086,5,148,2449,124,4079,24
12456,8,122,3129,93,2187,29
43702,55,941,976,697,5265,244
11467,30,882,3181,713,15439,169
44922,13,128,726,103,3348,25
17474,3,130,2825,113,2945,17
3254,17,438,3598,376,2805,62
41903,42,874,1429,674,8681,200
24689,3,91,2466,75,5024,16
7355,5,138,3426,106,4377,32
43318,16,481,1104,331,13501,150
33961,20,1270,2017,1041,18054,229
1622,25,1770,3676,1337,19046,433
28092,16,3255,2301,2468,15247,787
9036,5,27,3313,21,1788,6
24618,1,63,2468,57,4678,6
4304,26,644,3571,503,8197,141
6572,8,119,3467,102,5967,17
16338,15,1589,2886,1238,13414,351
37902,11,519,1786,415,4193,104
38610,1,45,1736,41,4267,4
20150,34,720,2700,587,2802,133
33582,28,725,2030,589,7467,136
36322,13,348,1884,269,6534,79
31348,39,1450,2132,1137,11847,313
11825,2,144,3163,114,3483,30
44899,43,489,733,354,5632,135
32046,5,363,2095,189,4131,174
6650,5,48,3464,41,4541,7
4878,14,133,3548,108,2982,25
9001,15,398,3314,319,4489,79
7600,7,75,3412,39,2782,36
12038,221,14422,3154,10507,99298,3915
29228,4,144,2238,111,3339,33
29674,1,177,2216,125,3867,52
10974,123,7108,3207,5457,35869,1651
21682,4,378,2613,307,6216,71
6559,0,42,3467,29,1105,13
22472,7,230,2572,186,8063,44
16882,115,7791,2857,5547,48093,2244
4558,7,278,3561,189,2891,89
38365,136,7778,1754,5149,49608,2629
3617,10,290,3591,226,5854,64
22493,55,3427,2571,2485,28094,942
32415,0,22,2077,12,1441,10
9568,26,801,3278,612,10553,189
38843,26,762,1722,538,7084,224
33523,56,3811,2032,2883,39097,928
26534,63,3068,2383,2348,22177,720
23413,19,572,2526,458,4185,114
40691,10,190,1595,138,3974,52
6114,20,424,3486,321,9978,103
42702,185,2969,1273,2208,34619,761
39015,2,269,1711,229,4633,40
21325,1,62,2633,55,2609,7
21079,2,73,2649,61,6952,12
43460,185,1700,1061,1247,10218,453
34216,29,764,2009,578,5359,186
3593,4,227,3592,189,7056,38
19897,9,336,2714,262,7763,74
41368,19,541,1516,411,14898,130
13841,2020,72929,3030,46347,238795,26582
17248,6,281,2836,217,3660,64
8079,1,35,3371,30,2009,5
17250,66,4684,2836,3839,45993,845
6635,35,1659,3464,1176,37842,483
11905,12,615,3160,488,9166,127
18996,29,3728,2759,2598,27322,1130
2241,15,345,3616,291,20748,54
10446,59,1501,3237,1210,13668,291
16751,6,539,2864,448,9616,91
9688,0,131,3272,109,5686,22
37183,36,1172,1834,912,7541,260
3047,25,2023,3602,1425,12844,598
11585,8,295,3175,238,6816,57
8223,29,612,3362,487,20348,125
37274,6,238,1828,194,4434,44
45809,4,56,418,35,2206,21
26158,0,286,2401,224,4064,62
21810,3,75,2607,61,2106,14
39389,30,1261,1688,985,17085,276
22160,2,121,2587,94,2548,27
16742,67,4184,2865,3238,24835,946
44592,1,9,821,7,1556,2
29767,13,317,2211,272,8970,45
40072,0,212,1646,156,3384,56
21888,7,301,2602,233,3490,68
37842,1160,31112,1790,24684,155442,6428
27526,15,830,2333,665,10969,165
5326,6,133,3524,99,8725,34
44806,11,80,760,70,1563,10
45771,51,501,428,436,7381,65
8804,105,5357,3324,3804,50052,1553
15209,2,122,2937,93,3327,29
23615,59,1862,2516,1395,13735,467
29030,30,1625,2248,1100,49884,525
42883,27,866,1229,646,10496,220
25281,0,58,2441,51,2566,7
13138,21,656,3089,521,9885,135
21281,29,652,2636,501,9456,151
41037,38,808,1565,643,20539,165
33327,4,163,2040,134,3782,29
4964,12,151,3544,112,8358,39
19686,79,2335,2727,1715,21720,620
14901,51,1374,2954,1067,15763,307
15747,65,2599,2912,2046,9408,553
6234,5,248,3482,171,9837,77
4584,31,1154,3560,914,10364,240
39811,9,247,1664,207,6328,40
17739,2,58,2814,46,1889,12
4347,24,472,3569,366,15760,106
28948,10,553,2253,465,7416,88
24286,18,1955,2485,1491,6033,464
8245,8,182,3361,134,6776,48
46411,17,147,174,120,3158,27
18852,46,2168,2764,1650,21094,518
8771,314,17767,3327,12512,109448,5255
15544,7,355,2923,270,4035,85
41154,46,5240,1549,4422,24439,818
44019,11,97,914,73,1373,24
14692,96,6535,2968,4483,46120,2052
43383,25,474,1081,316,6003,158
1723,11,250,3651,203,5559,47
3966,4,105,3583,74,8000,31
35166,22,457,1960,303,4521,154
14743,13,265,2965,213,6593,52
25799,456,15102,2417,12438,51510,2664
3142,5,142,3600,115,4773,27
39338,54,800,1691,664,8661,136
9584,12,146,3277,114,10863,32
36186,11,534,1891,396,5728,138
41124,12,280,1552,209,5133,71
16322,46,1655,2886,1283,18196,372
24635,8,446,2468,380,5316,66
5161,36,1046,3532,766,8605,280
17694,7,3273,2816,2558,54608,715
37451,68,1885,1817,1342,17808,543
11846,31,1262,3163,1040,10245,222
13783,883,33791,3035,22718,84128,11073
46196,2,43,257,31,1517,12
2619,15,411,3609,331,7423,80
33963,142,7674,2017,5465,45887,2209
17793,100,6350,2812,4166,25634,2184
17562,557,22652,2821,17468,61175,5184
6229,4,119,3482,78,2121,41
7448,3,66,3422,60,3123,6
16145,70,3223,2895,2519,39629,704
26715,0,3705,2376,2925,18194,780
36509,12,139,1874,121,6220,18
2019,84,1906,3619,1433,34606,473
4814,52,2638,3551,1941,37706,697
4713,23,584,3555,436,19385,148
2234,1256,54543,3616,39381,220813,15162
12077,97,4430,3152,3536,25650,894
25025,22,1982,2452,1346,10595,636
29158,2,76,2242,68,2688,8
6447,144,8129,3473,5432,23911,2697
35054,8,323,1966,271,6812,52
15664,18,1729,2916,1353,30365,376
31006,12,496,2149,395,7476,101
12497,1,110,3127,89,3731,21
16464,0,134,2879,103,5412,31
44915,86,1454,730,1178,17432,276
28647,56,1547,2268,1306,16534,241
40696,2,83,1595,61,2327,22
15995,37,1120,2902,875,15772,245
41096,91,2675,1555,2137,28847,538
31638,89,7238,2115,5064,52628,2174
38892,40,941,1719,713,16277,228
5049,15,481,3540,394,5866,87
15023,2,232,2948,189,8322,43
21202,36,894,2640,678,8522,216
5909,1,186,3494,153,7237,33
37025,4,322,1844,266,5340,56
12742,20,648,3114,521,9264,127
17365,31,801,2830,545,6184,256
15517,95,7590,2924,5783,74793,1807
25437,2,164,2434,149,2853,15
41651,62,763,1474,590,9901,173
41668,274,10375,1472,7057,83976,3318
17018,222,22385,2850,13839,78550,8546
31201,7,116,2139,102,3334,14
2178,207,7519,3617,5580,90639,1939
28170,38,563,2296,447,7035,116
45657,5,140,480,79,5087,61
27295,10,755,2347,608,9190,147
28694,11,253,2265,198,15628,55
34420,3,74,2000,54,5000,20
17745,2,142,2814,123,2154,19
4850,14,542,3550,432,8997,110
21979,12,622,2596,482,4114,140
28821,84,1054,2258,793,5756,261
20698,331,15170,2672,9764,35223,5406
41940,87,1436,1424,1108,17670,328
8435,293,8916,3349,6591,42364,2325
3506,12,348,3593,146,12867,202
42262,15,114,1362,84,1778,30
28302,13,460,2289,325,6496,135
26022,12,259,2407,205,2728,54
25483,5,376,2432,303,7378,73
13627,44,953,3047,763,19957,190
26795,65,2738,2371,1900,43818,838
12607,0,128,3122,92,6737,36
3586,136,2553,3592,1904,26896,649
20665,13,599,2674,473,7570,126
36265,0,44,1886,37,1881,7
7719,41,1366,3405,1062,14510,304
5439,17,333,3518,225,3533,108
25268,17,527,2442,445,5093,82
27873,16,274,2314,219,8930,55
32854,12,486,2058,341,5839,145
9336,29,1153,3293,811,6140,342
30411,23,737,2177,608,8784,129
5862,82,2502,3496,1894,17538,608
7844,23,781,3395,593,34510,188
12486,78,2156,3128,1663,15529,493
26772,85,2695,2373,1965,14183,730
41019,227,6010,1566,4335,51003,1675
28355,17,2201,2286,1697,25688,504
14463,17,583,2984,474,17749,109
24694,38,1819,2465,1381,18050,438
5837,12,207,3497,154,2599,53
22400,16,1597,2576,1254,5530,343
3837,2,144,3586,90,3334,54
4563,1,31,3561,23,2181,8
3025,41,1241,3602,771,8896,470
12152,17,288,3147,252,3638,36
22939,49,2999,2548,2289,17756,710
9737,12,445,3270,266,9180,179
24837,20,371,2460,310,5633,61
4918,17,182,3545,136,6825,46
13821,10,250,3032,201,16153,49
34924,226,11063,1972,7751,50907,3312
37822,24,776,1791,623,12154,153
24111,2,194,2493,156,5530,38
13479,31,1498,3057,1199,9892,299
26770,21,647,2373,500,7827,147
1252,2,25,3850,23,2236,2
33705,24,1506,2026,1126,26342,380
40668,152,7813,1597,5741,40094,2072
4804,2226,133935,3552,87736,726141,46199
40607,7,283,1602,218,4116,65
43052,418,12088,1182,9130,89179,2958
34175,503,14656,2010,11046,53905,3610
29821,0,23,2209,21,2830,2
14427,2,101,2986,81,3256,20
3028,203,6129,3602,4266,99155,1863
2160,74,2333,3617,1869,17023,464
7681,18,357,3407,296,10649,61
16021,36,2140,2901,1656,27558,484
13636,8,176,3046,147,4586,29
14612,373,19357,2973,14250,148542,5107
12526,1,104,3126,69,3677,35
28643,100,4797,2268,3614,28525,1183
28040,6,248,2303,205,3406,43
35737,0,145,1922,107,4401,38
36612,1,63,1868,54,3852,9
2170,515,30095,3617,22195,136281,7900
20514,61,1917,2682,1518,7799,399
10260,16,309,3245,257,4114,52
37381,35,701,1822,574,11103,127
16259,113,3794,2889,2776,21675,1018
2949,39,1046,3604,846,24706,200
45509,3,65,540,44,1460,21
38715,20,492,1730,356,5530,136
15324,61,3960,2932,3192,16973,768
6585,1,23,3466,21,3079,2
42537,62,1081,1306,828,22554,253
19345,25,929,2743,735,9400,194
40625,5,98,1600,82,2562,16
13644,15,1058,3046,630,6930,428
9906,9,355,3263,273,6190,82
19188,74,4769,2751,3684,50025,1085
22692,0,179,2561,145,4366,34
3749,14,352,3588,263,6967,89
14800,58,2689,2959,2026,28066,663
26407,4,145,2389,127,2462,18
19444,11,218,2738,180,8211,38
36226,10,823,1889,562,7922,261
23857,0,57,2505,46,2044,11
22248,1,67,2582,40,1711,27
34830,251,16338,1977,11308,35860,5030
17829,3,154,2811,124,8234,30
32553,80,1610,2071,1321,16133,289
16896,46,2366,2857,1777,12371,589
38062,22,401,1776,329,6356,72
31564,2,425,2119,341,5573,84
3614,19,647,3591,527,7432,120
6437,13,544,3473,385,4925,159
35825,5,108,1916,90,3776,18
43076,34,415,1173,319,4018,96
30736,3,49,2160,44,1657,5
45843,6,59,407,40,3994,19
5738,40,1329,3503,1032,17704,297
2089,4,202,3618,154,11418,48
40785,25,826,1586,532,13617,294
12937,23,1099,3103,884,37937,215
9479,52,858,3284,572,9716,286
28769,6,117,2261,109,5750,8
8425,30,1285,3349,1043,6576,242
42994,3,193,1198,131,6101,62
29722,1,81,2213,67,1976,14
46372,8,149,192,124,3185,25
23000,27,1048,2546,819,16454,229
22261,9,272,2582,213,7348,59
39528,0,98,1680,82,11855,16
34999,7,321,1969,246,5263,75
10469,4,67,3235,50,3670,17
21116,1,26,2647,24,1484,2
39185,34,667,1700,557,7617,110
27941,0,105,2308,87,5757,18
43738,32,381,966,333,12608,48
24576,8,398,2471,321,5305,77
32902,3,77,2056,57,3655,20
12209,73,4008,3144,2862,55474,1146
31083,8,261,2145,223,6408,38
45224,13,276,617,233,6215,43
23392,8,360,2527,281,5820,79
26631,13,1178,2380,868,22931,310
42260,14,417,1362,340,12125,77
30697,4,314,2161,254,5538,60
19518,48,2239,2734,1776,23527,463
19094,0,764,2755,571,14971,193
28902,254,17393,2255,8823,89306,8570
37763,6,753,1796,582,13131,171
2268,209,24153,3615,16408,126717,7745
45651,12,115,483,98,5381,17
34269,3,29,2007,22,1309,7
35946,4,111,1907,96,5457,15
10535,5,169,3232,137,4940,32
23821,60,2535,2507,1886,30091,649
20995,1,73,2653,61,2565,12
8685,11,343,3332,291,3591,52
45890,49,404,389,344,5114,60
8749,4,186,3328,149,5353,37
21424,423,16684,2628,12333,86965,4351
4754,176,6992,3554,4966,59636,2026
44249,133,1791,873,1382,24202,409
6825,44,2651,3455,2108,27119,543
45109,34,345,655,254,4442,91
32563,4,273,2070,219,10332,54
5598,75,1659,3510,1307,28898,352
22889,8,227,2551,181,6493,46
16816,2,128,2860,102,5088,26
25420,0,64,2435,56,3056,8
27219,37,1295,2352,950,14842,345
38731,69,2093,1729,1572,9817,521
31332,23,611,2132,487,12623,124
22529,4,360,2569,298,5421,62
40573,70,1709,1604,1258,12131,451
27117,1,64,2359,60,2805,4
27404,1,52,2341,46,2522,6
2378,10,87,3613,75,3888,12
11584,7,501,3175,401,15041,100
42434,31,601,1327,459,7866,142
4972,61,1523,3543,1275,35127,248
27882,130,1948,2313,1458,10535,490
6683,7,656,3462,480,15861,176
27758,97,1875,2320,1518,10101,357
37009,3,200,1845,169,6275,31
25914,22,2008,2412,1553,21774,455
43711,90,1404,973,1058,25072,346
9329,4,224,3293,173,9574,51
2053,85,7243,3619,5209,32422,2034
38629,18,428,1735,366,8142,62
21282,7,339,2636,256,7879,83
24776,8,591,2463,487,6437,104
1219,6,279,3861,225,9450,54
19337,21,712,2744,511,5691,201
34854,9,784,1976,658,21607,126
3638,7,87,3591,65,5564,22
23907,21,599,2503,442,4372,157
41520,9,190,1495,149,4391,41
12648,3,161,3119,134,7154,27
8334,76,4180,3355,3366,35415,814
30568,532,38728,2168,27798,100865,10930
26412,0,46,2389,34,1419,12
9517,1,116,3281,86,4705,30
23049,26,798,2544,571,5689,227
26410,74,2729,2389,2148,12774,581
5940,19,340,3492,265,5024,75
7266,26,601,3432,450,14565,151
9648,1,42,3274,36,1695,6
9827,22,1133,3265,759,10710,374
25418,9,585,2435,479,7662,106
39475,0,24,1683,16,4469,8
1459,6,56,3718,48,2363,8
14329,19,845,2993,696,4411,149
37587,300,9817,1808,7743,79259,2074
23246,17,559,2534,453,9233,106
43419,1,58,1070,49,3420,9
11144,1,0,3198,0,2594,0
29106,320,18033,2244,12641,122826,5392
25700,4,445,2421,377,7912,68
4141,29,700,3577,539,23193,161
35444,172,7184,1945,5510,62883,1674
5348,3,77,3523,45,6370,32
34741,14,606,1984,486,6922,120
32700,39,850,2065,671,8656,179
20734,0,35029,2671,23161,359296,11868
23918,4,164,2503,131,3190,33
42424,94,4622,1329,3220,62497,1402
27936,10,624,2309,465,11749,159
41024,2,143,1566,113,5424,30
40911,0,53,1574,38,3898,15
34697,41,3476,1986,2499,18633,977
16289,45,1335,2888,1049,10195,286
29872,13,1042,2205,834,9611,208
35462,1,117,1944,96,2438,21
1443,2,91,3737,81,2087,10
24550,3,92,2473,81,3031,11
9064,47,1525,3310,1190,14142,335
37781,4,362,1795,268,17156,94
30004,71,1057,2200,810,7937,247
35269,44,836,1954,681,11135,155
17166,3,136,2840,107,2907,29
28059,9,156,2302,121,4429,35
7428,11,1135,3422,680,18017,455
1937,165,6503,3621,5067,59598,1436
37441,13,347,1818,276,14425,71
32311,8,120,2081,94,2088,26
12436,15,543,3130,433,7937,110
45877,2,31,395,25,1108,6
17993,11,951,2802,692,12899,259
45669,49,669,473,565,9970,104
9949,339,21345,3260,15744,104990,5601
19271,5,287,2747,213,6764,74
34052,0,62,2013,44,4409,18
5203,25,1005,3530,549,19643,456
38452,21,859,1748,710,12016,149
10674,114,5071,3223,3608,23426,1463
15602,41,1621,2919,1127,6397,494
3914,22,794,3584,630,11955,164
15421,6,240,2928,188,5078,52
4543,129,5383,3562,4133,55758,1250
19273,12,671,2747,487,12069,184
13266,2,128,3074,101,4926,27
9745,32,2016,3270,1528,17235,488
10096,7,472,3253,366,12960,106
18218,5,100,2792,85,3938,15
5041,35,753,3540,599,14439,154
44791,66,534,766,393,15480,141
41559,63,1470,1490,1061,23020,409
4462,34,822,3565,667,15126,155
24627,4,265,2468,205,8417,60
36005,17,539,1902,412,4529,127
5961,57,1777,3491,1353,38494,424
11870,8,505,3161,416,15661,89
41854,51,465,1438,357,6602,108
38596,20,606,1737,425,5572,181
28546,41,1987,2273,1623,21748,364
42912,31,658,1221,480,7168,178
43100,341,4186,1166,3410,36585,776
29625,10,328,2218,284,3475,44
2449,9,335,3612,266,18733,69
12883,3,203,3106,171,4823,32
37086,6,198,1840,163,8377,35
42811,23,450,1244,332,11086,118
2872,2,75,3605,60,7588,15
23640,16,711,2515,521,13289,190
5213,32,539,3529,450,10559,89
45495,17,258,542,178,5928,80
5105,7,299,3536,212,3600,87
22124,0,0,2588,0,74780,0
28786,1,242,2260,177,3209,65
40590,4,78,1603,62,1621,16
16502,1,128,2878,111,11988,17
46438,0,17,158,14,778,3
6430,284,19886,3473,15710,68722,4176
25646,41,1833,2423,1463,15409,370
20295,2,151,2692,129,4329,22
14195,53,2784,3004,2071,28269,713
39367,1,80,1689,60,2652,20
46345,2,67,207,53,1043,14
30039,4,108,2198,86,2958,22
15612,22,4059,2918,3032,68872,1027
23711,3,82,2511,64,8515,18
31042,15,367,2147,270,5271,97
31212,26,595,2139,448,6405,147
25625,22,1367,2425,1075,29996,292
4767,37,697,3553,582,13526,115
8285,63,1911,3358,1448,9735,463
14915,15,522,2954,441,10082,81
18131,352,19023,2796,13989,136715,5034
35093,3,453,1964,349,7559,104
32080,33,1760,2092,1294,17323,466
17858,51,2100,2809,1659,7971,441
5579,82,2174,3511,1705,39094,469
20950,114,10213,2656,7707,54344,2506
2586,13,425,3610,331,10197,94
41401,20,382,1511,283,7735,99
5596,14,196,3510,159,9532,37
24342,42,2119,2483,1484,15243,635
15578,29,1334,2920,990,12084,344
18713,4,209,2770,113,1695,96
29983,0,1160,2201,918,25529,242
37539,0,184,1811,148,3259,36
28227,4,101,2293,79,4335,22
15050,8,339,2946,288,4297,51
35670,11,153,1927,124,5024,29
10757,72,137388,3218,39580,46648,97808
39638,14,577,1674,445,9408,132
30801,1,209,2157,181,4861,28
22527,3,84,2569,64,2230,20
13215,23,599,3077,478,10394,121
20633,77,1441,2676,1041,11805,400
34032,1,396,2014,312,4937,84
19150,142,7070,2753,4924,91116,2146
14196,97,5212,3004,3919,49481,1293
19869,5,247,2716,191,5842,56
11026,1,171,3204,128,6955,43
4128,7,209,3577,156,2477,53
40147,264,7852,1642,5411,46439,2441
36859,4,308,1853,239,8682,69
24614,286,5634,2469,4411,29566,1223
15051,53,2596,2946,1673,15773,923
31825,5,406,2105,314,11500,92
31778,0,78,2108,42,3497,36
13270,6,513,3074,402,6931,111
11711,13,565,3168,417,12174,148
45650,52,801,483,689,7337,112
34812,33,736,1978,537,5347,199
37531,17,318,1811,219,9770,99
32049,3,153,2094,111,4012,42
15067,5,271,2945,192,5869,79
13201,25,1301,3078,1039,35917,262
27649,15,647,2326,427,11157,220
24934,40,1862,2455,1418,20214,444
32974,1,51,2054,36,2395,15
31824,49,1861,2106,1261,22237,600
40605,26,756,1602,567,16267,189
29376,6,397,2230,338,5070,59
30463,4,248,2174,190,8596,58
34727,1,76,1985,63,2575,13
14792,10,299,2961,258,4877,41
18429,71,2019,2782,1515,16018,504
2919,7,315,3604,248,15675,67
16510,8,288,2877,209,7744,79
6880,29,1269,3453,914,16006,355
31421,9,573,2128,454,8001,119
21785,84,2541,2608,1912,18160,629
45825,4,53,412,42,1892,11
1054,1,85,3910,75,3966,10
5888,40,864,3495,684,7259,180
6751,15,359,3460,294,8600,65
16817,56,2676,2860,1988,14621,688
6831,8,380,3455,307,10361,73
26854,63,2705,2369,1857,29793,848
2502,148,2532,3611,2107,21793,425
35702,55,1688,1925,1353,13239,335
5601,8,241,3510,199,10910,42
27287,4,498,2348,419,15883,79
41777,57,925,1453,719,8524,206
8170,5,416,3366,317,5553,99
43327,2,62,1101,44,2072,18
6536,198,8552,3468,6062,50541,2490
28877,9,357,2256,284,6502,73
13856,15,1304,3029,727,16048,577
25472,35,1738,2433,1294,16585,444
8600,6,273,3338,214,4088,59
4309,7,145,3570,113,7848,32
46234,8,61,248,47,1094,14
25886,1,149,2413,121,5124,28
2483,23,724,3611,582,8666,142
19695,165,6804,2726,5174,70065,1630
5314,25,785,3524,642,16130,143
38937,7,161,1716,132,5084,29
10851,8,102,3213,85,4654,17
34695,70,727,1986,568,8388,159
45631,2,38,493,24,1345,14
28255,28,1209,2291,938,8532,271
4021,4,283,3580,226,6804,57
3165,36,1333,3600,1063,19140,270
33721,1,65,2025,48,4321,17
14469,73,6059,2984,4887,44698,1172
2950,33,871,3604,699,23950,172
9654,29,879,3273,599,5701,280
21361,61,2381,2631,1637,11820,744
36620,2,138,1868,112,3612,26
9273,11,477,3298,352,28682,125
33325,21,538,2040,391,7504,147
4871,27,861,3549,659,21795,202
8639,112,2627,3335,1914,23609,713
7044,31,328,3443,246,4262,82
6320,158,13194,3478,8225,126391,4969
17941,5,255,2805,199,3839,56
43716,55,643,972,568,11990,75
34177,9,487,2010,382,6984,105
3115,27,2492,3601,1234,61637,1258
26713,0,97,2376,83,2311,14
45332,4,86,584,45,2850,41
9637,5,209,3274,168,4829,41
27635,12,1073,2327,863,17599,210
30659,78,4097,2163,3127,29526,970
6008,25,1667,3489,1356,12516,311
44455,90,1222,846,913,20256,309
30035,50,1728,2198,1295,12775,433
16323,898,74923,2886,49046,246247,25877
5296,27545,1528486,3525,964238,4327454,564248
30790,65,4585,2157,3660,47222,925
38624,336,21161,1735,16197,110581,4964
26573,0,68,2382,60,1896,8
9581,169,8186,3277,5970,120373,2216
45121,33,314,647,239,6010,75
12691,14,1473,3117,1132,13123,341
5679,8,190,3506,147,4857,43
42414,285,10266,1332,7160,95661,3106
3826,0,47,3587,28,2341,19
46129,7,108,286,77,2897,31
38447,39,820,1748,615,7789,205
33135,0,92,2046,77,5213,15
29084,1,170,2245,139,5347,31
4524,10,106,3563,75,7772,31
9327,184,8885,3293,6949,113396,1936
46052,3,44,312,31,1512,13
14980,17,956,2950,762,12230,194
45182,29,365,629,269,7420,96
27055,3,233,2362,175,4175,58
32344,32,1392,2080,1035,17869,357
32317,15,686,2081,512,7986,174
4111,12,258,3577,214,6194,44
20956,45,1724,2656,1372,12497,352
45399,16,367,565,309,11740,58
41982,8,325,1417,240,11130,85
34776,4,221,1982,185,5288,36
38466,938,15437,1747,11780,62564,3657
20787,24,903,2667,693,9369,210
38418,4,151,1751,131,6385,20
25762,7,413,2419,281,7133,132
4502,7,208,3564,184,8868,24
35857,0,23,1914,21,2274,2
34774,7,310,1982,249,8453,61
37236,11,360,1830,263,8502,97
20558,13,609,2680,488,14171,121
15060,36,1383,2945,1014,10585,369
19097,7,320,2755,250,7658,70
32255,5,131,2084,103,2851,28
36038,2,169,1900,140,4670,29
25835,100,4580,2416,3496,41278,1084
28002,4,58,2305,52,2320,6
9063,8,1019,3310,797,26912,222
9088,51,1849,3309,1472,12309,377
6300,28,1212,3479,899,29189,313
36549,7,245,1873,206,3878,39
38739,3,95,1728,72,3518,23
26351,17,840,2392,670,13157,170
17983,23,2509,2802,1980,30375,529
26012,14,259,2407,184,6313,75
25841,57,2492,2415,1933,22578,559
23029,8,189,2545,161,3965,28
5511,10,259,3515,143,5495,116
14478,8,237,2983,176,4441,61
43779,27,330,952,268,5536,62
26731,8,348,2375,290,4699,58
37120,578,21663,1838,15948,109483,5715
9984,39,1037,3258,805,29974,232
39548,1,45,1679,32,2805,13
28991,5,326,2250,253,13949,73
43175,25,509,1145,363,9156,146
6728,6,128,3461,86,4235,42
12682,135,6333,3118,4862,63496,1471
31966,3,246,2099,207,6107,39
2052,167,7566,3619,5780,45222,1786
20361,5,80,2690,70,2153,10
35958,21,1149,1906,883,8590,266
23489,95,9022,2522,6817,41863,2205
38497,5,79,1745,60,2708,19
20386,27,402,2689,332,5887,70
20618,2,732,2677,576,9066,156
39090,4,128,1706,106,3395,22
22404,6,160,2576,134,3852,26
33491,1,41,2033,34,2594,7
19426,15,738,2739,546,14372,192
18519,4,215,2779,189,1821,26
16695,5,182,2868,141,3961,41
20271,27,1298,2693,920,16336,378
39523,6,158,1681,119,5636,39
41117,28,312,1552,249,5615,63
35717,8,178,1923,137,3075,41
24895,158,826,2457,619,15180,207
22441,4,81,2574,59,1617,22
45531,16,128,531,117,2814,11
12942,1,52,3103,44,2833,8
4468,25,1331,3565,1143,8974,188
37091,4,71,1839,56,3032,15
14271,149,4966,2999,3385,34137,1581
4753,19,282,3554,218,8013,64
4965,7,122,3544,107,6231,15
21200,20,1649,2640,1175,23950,474
30945,7,74,2152,60,2810,14
29093,4,101,2245,88,2464,13
19685,6,212,2727,179,3307,33
4243,34,1310,3573,1021,9081,289
19714,47,1412,2725,1092,15691,320
11536,5550,152462,3177,113927,517496,38535
20347,3,253,2691,202,3894,51
11972,0,80,3156,67,2002,13
34347,2,111,2004,92,1979,19
10437,17,496,3237,390,14763,106
18124,2,88,2796,76,2185,12
30174,13,135,2191,109,4179,26
4448,129,3485,3565,2714,46354,771
36219,106,2323,1889,1768,22868,555
25270,4,90,2441,75,1051,15
14059,21,423,3011,347,4022,76
44207,25,126,880,111,3383,15
26649,4,197,2379,171,5119,26
42629,18,870,1289,555,10982,315
3616,22,589,3591,492,9605,97
23752,12,399,2510,316,6632,83
24048,3,84,2496,74,2216,10
15661,0,44,2916,40,1796,4
26133,85,4859,2403,3765,51467,1094
9682,1,66,3273,53,2419,13
13680,35,1415,3043,1115,27542,300
35410,9,425,1948,363,12890,62
16268,24,1033,2889,853,12204,180
14749,3,86,2964,73,3449,13
37079,4,95,1840,81,4778,14
36823,14,635,1855,491,16983,144
23970,75,2129,2499,1740,17336,389
3313,15,318,3597,264,4731,54
11703,1,134,3169,91,4936,43
34255,4,130,2007,104,5394,26
8773,551,39562,3327,26984,155076,12578
37088,1602,37091,1839,27821,217411,9270
19606,3,76,2731,54,2157,22
21568,0,37116,2620,27718,167272,9398
42677,82,2625,1277,1902,24903,723
40845,2,92,1579,76,4421,16
32180,12,176,2087,143,2241,33
7495,23,767,3419,582,6151,185
7131,19,240,3439,160,5591,80
23569,3,155,2518,122,5047,33
39464,2,184,1684,150,7392,34
42960,47,815,1209,671,12690,144
2815,10,254,3606,222,6435,32
8544,34,1158,3341,743,14374,415
40992,6,297,1568,223,4141,74
33075,209,11122,2049,8532,61978,2590
13233,184,6419,3077,4711,38582,1708
45957,16,111,357,87,1890,24
1867,14,859,3623,697,26989,162
37498,10,450,1814,365,8574,85
1677,0,30,3661,25,1858,5
38390,10,488,1752,396,8008,92
4728,5,255,3555,195,9814,60
37082,13,244,1840,186,7389,58
32564,1,133,2070,106,3736,27
15850,2,46,2909,40,2503,6
29487,3,240,2224,205,8108,35
36827,61,1097,1855,902,6424,195
42453,118,2527,1323,1878,31034,649
13066,39,1182,3094,943,7164,239
4823,5,108,3551,90,3020,18
24535,6,297,2474,212,4247,85
3239,9,217,3598,184,7556,33
14837,47,3982,2958,3205,20290,777
33228,208,8033,2044,6156,55657,1877
1832,24,483,3624,398,11698,85
39764,8,230,1668,181,6220,49
29949,7,278,2202,232,3433,46
3121,9,427,3601,289,30661,138
17186,175,18833,2840,11404,85377,7429
8439,7,164,3348,135,6668,29
15630,36,2846,2917,2089,21397,757
43825,106,1266,943,971,8310,295
44201,0,33,881,23,4253,10
26476,3,305,2386,260,12103,45
4165,200,9413,3576,7498,43770,1915
2660,21,562,3609,462,10231,100
11498,99,3415,3179,2616,31656,799
36710,1,55,1863,48,2643,7
11290,149,6845,3190,5180,54770,1665
41696,14,486,1468,335,8054,151
38540,111,2638,1741,1944,15744,694
33753,2,84,2024,61,3253,23
7014,16,660,3446,506,16966,154
45013,58,601,700,515,8398,86
6943,5,171,3450,146,3384,25
7754,22,680,3403,564,13013,116
9119,67,2650,3307,2100,27836,550
28155,5,512,2297,399,7819,113
21100,23,2353,2648,1686,14881,667
5647,122,11204,3507,8080,69486,3124
9441,53,907,3286,702,8376,205
20452,19,1529,2685,1232,16420,297
6463,50,3074,3472,2324,15801,750
33547,2,629,2031,484,24016,145
41644,18,372,1475,295,19605,77
13765,14,505,3035,374,5542,131
28623,29,673,2269,496,7148,177
30966,7,177,2151,124,3598,53
33510,15,434,2032,360,7084,74
38227,1,98,1764,87,3349,11
45398,25,370,566,202,4352,168
42599,37,843,1296,572,15993,271
15841,281,9392,2909,6199,68165,3193
40543,0,72,1607,56,6307,16
27569,12,2195,2330,1676,24358,519
24128,49,3239,2492,2744,10630,495
10700,45,1219,3222,913,29171,306
45903,2,29,386,25,2733,4
5418,3,59,3519,43,2234,16
29289,16,375,2235,296,5544,79
7273,9,336,3432,264,4558,72
5089,46,576,3537,465,8567,111
44417,2,55,852,38,2306,17
10743,19,587,3219,485,7590,102
3910,213,9832,3584,7536,59357,2296
16977,60,2316,2853,1867,21351,449
22025,23,1714,2593,1399,19242,315
37710,58,1424,1801,1152,18003,272
17576,20,949,2820,774,6088,175
45553,130,1383,521,1010,10832,373
3036,29,1098,3602,914,9088,184
14390,57,2001,2988,1631,19192,370
42084,13,573,1398,412,11238,161
2546,39,556,3611,481,25775,75
6791,5,42,3458,35,3005,7
6672,3,151,3463,125,5883,26
39574,0,0,1677,0,3061,0
14460,98,3503,2984,2695,25290,808
40039,10,207,1648,157,3168,50
31876,5,116,2104,97,10016,19
20973,135,12700,2655,9371,62060,3329
32594,58,4468,2069,2829,14246,1639
32544,8,659,2072,466,11484,193
10097,48,1260,3253,1036,20170,224
37932,1,192,1784,159,7105,33
44521,0,20,837,15,1882,5
44764,14,210,775,135,2723,75
37360,13,1147,1823,906,5781,241
24721,25,1871,2464,1509,25478,362
31304,20,1483,2134,1093,15905,390
19834,11,862,2718,701,10194,161
39685,5,114,1671,90,6149,24
8618,6,197,3336,153,5392,44
36595,65,1723,1870,1222,23245,501
33957,59,1069,2017,863,15206,206
10718,66,3625,3221,2832,28958,793
9605,50,2482,3276,1819,37254,663
37431,1,43,1818,39,2881,4
28607,272,11239,2269,7362,59471,3877
24843,1,133,2460,109,3723,24
38513,31,679,1744,554,11505,125
13262,0,1228,3075,1006,15434,222
29469,4,179,2225,146,3704,33
37228,1,49,1831,40,5735,9
29628,7,132,2218,99,2421,33
32953,11,654,2055,496,10141,158
22391,46,1512,2576,1193,14925,319
7776,77,3671,3401,2748,44178,923
25813,27,686,2416,563,11561,123
37827,0,119,1791,87,2555,32
27438,8,416,2339,330,3607,86
32376,284,15144,2078,10538,100974,4606
6946,56,2226,3450,1602,29554,624
17540,6,1020,2821,806,8171,214
15192,1,23,2938,16,2587,7
41187,34,992,1545,694,9409,298
17877,3,318,2809,254,6059,64
37487,153,3049,1814,2176,24304,873
25714,386,8022,2421,6129,24889,1893
27062,0,229,2362,173,2301,56
12064,41,1023,3152,764,14380,259
34211,9,332,2009,271,5824,61
30288,301,14107,2185,10083,110099,4024
28873,5,343,2256,281,8291,62
42759,17,902,1258,604,9928,298
5471,6,160,3517,127,5643,33
20966,3,229,2655,188,3315,41
22959,141,11949,2547,9068,52615,2881
27723,9,247,2322,193,2715,54
22305,60,2596,2580,1995,16210,601
40114,46,1326,1644,950,23785,376
14843,0,86,2958,69,5492,17
19095,14,558,2755,426,10491,132
5690,23,577,3505,463,7019,114
16708,72,6268,2867,4462,38249,1806
44985,224,1910,708,1274,17903,636
34341,11,466,2004,384,11874,82
10412,8,399,3239,329,11714,70
20489,17,4137,2684,3052,56512,1085
7076,6,174,3442,151,10437,23
34897,18,569,1974,447,5383,122
43276,47,1103,1115,830,12660,273
3449,28,2254,3595,1827,40112,427
7058,0,95,3443,69,7362,26
23003,57,3374,2546,2459,25046,915
21655,12,759,2614,628,14090,131
18708,1,236,2771,189,9590,47
15566,94,8010,2920,5971,41911,2039
15587,566,21068,2919,15722,122188,5346
37880,19,459,1787,395,7234,64
31456,7,168,2125,135,4045,33
40403,69,1020,1621,829,10933,191
26323,6,176,2394,139,4124,37
5971,22,539,3491,404,11007,135
38463,42,1106,1747,843,11757,263
44776,13,307,769,215,6135,92
4352,186,7799,3569,6026,37416,1773
1995,21,804,3620,624,8011,180
17705,15,760,2815,606,12528,154
25969,13,292,2409,217,4043,75
3021,33,865,3602,664,13835,201
41846,16,532,1438,401,10695,131
7330,12,670,3428,497,8023,173
7696,52,1590,3406,1216,25092,374
3264,21,477,3598,357,3149,120
22713,45,2529,2560,1958,9090,571
10403,628,32999,3239,23747,90160,9252
39094,3,65,1706,51,3209,14
8473,75,6250,3346,4779,57604,1471
37585,0,44,1808,36,2134,8
15275,51,1795,2934,1341,15525,454
34729,16,405,1984,308,8926,97
34817,8,213,1978,171,5378,42
14560,286,23235,2977,15663,93085,7572
15001,12,1215,2949,831,11045,384
27034,17,374,2363,319,5444,55
38527,19,1344,1743,1010,12519,334
4994,21,574,3542,465,6625,109
29835,130,6067,2208,4841,46787,1226
12948,14,442,3102,324,9485,118
26543,252,16455,2383,11985,75365,4470
31964,9,747,2099,573,10833,174
9671,24,578,3273,473,4425,105
3886,107,3979,3585,2969,55109,1010
32345,24,591,2080,474,10330,117
18811,8,334,2766,260,2180,74
33743,22,616,2024,488,4970,128
8543,155,8593,3341,6639,168520,1954
27284,0,60,2348,53,7315,7
28181,49,1660,2295,1252,23560,408
21937,21,2401,2600,1885,58565,516
41240,168,5030,1536,3757,39422,1273
27830,2,86,2315,69,3257,17
44684,12,102,801,92,2441,10
33131,23,408,2046,341,7952,67
43071,4,117,1176,82,2897,35
4496,1,87,3564,70,4340,17
30828,7,290,2156,227,5770,63
28806,0,38,2259,31,3533,7
13431,114,5970,3062,4671,64511,1299
45393,54,706,568,558,9305,148
20840,25,937,2664,742,6742,195
19541,3,178,2734,143,4628,35
1918,20,630,3622,491,17210,139
36579,6,207,1871,171,6554,36
5776,2,102,3501,75,12853,27
19249,6,837,2748,671,8137,166
14224,7,226,3002,177,4665,49
3595,695,27672,3592,19294,186298,8378
32734,21,616,2064,474,11748,142
43153,9,211,1151,145,2456,66
35894,381,11454,1911,8308,49824,3146
37636,39,353,1805,284,3403,69
39210,10,507,1699,416,11328,91
32003,8,257,2097,212,4240,45
42051,128,2729,1406,1961,15316,768
43217,16,457,1134,311,13777,146
32699,292,12299,2065,8594,97552,3705
36868,9,92,1853,65,2502,27
28793,6,274,2260,228,8890,46
35603,79,3240,1933,2594,21216,646
25473,35,3297,2433,2403,14324,894
13936,12,684,3021,480,12221,204
45298,15,118,594,89,1534,29
16637,125,5471,2871,4067,41307,1404
41145,24,620,1550,463,12052,157
13378,28,3244,3066,2254,51633,990
40903,225,5049,1575,3579,36509,1470
17955,4,307,2804,256,7093,51
45712,28,350,452,301,8167,49
19810,1,61,2719,45,3988,16
4219,8,260,3574,186,5147,74
28112,0,96,2300,82,4312,14
28127,39,1187,2299,932,7093,255
27650,78,5346,2326,4269,29760,1077
43136,71,1432,1156,1025,20959,407
11562,1,68,3176,54,1417,14
45468,2,88,550,41,1906,47
10168,2167,159294,3250,96684,1179278,62610
38955,408,14155,1715,10188,96967,3967
16782,3,187,2862,152,6415,35
3153,16,733,3600,574,13955,159
37409,10,113,1820,96,3825,17
30135,5,320,2194,249,4481,71
38386,7,136,1753,108,4498,28
26148,8,493,2402,413,5414,80
34481,0,735,1998,561,14024,174
34942,1,219,1972,178,3626,41
6239,1440,84719,3482,56610,430141,28109
3287,48,1252,3598,976,11080,276
6260,0,59,3481,40,3131,19
4057,176,297513,3579,94330,66117,203183
40465,2,79,1615,67,3811,12
7533,36,867,3417,601,6902,266
20065,63,4458,2705,3458,40838,1000
4602,8,87,3559,73,3746,14
8636,64,2731,3335,2168,22948,563
16780,12,334,2862,294,5634,40
41423,63,821,1508,666,7913,155
12909,89,2114,3104,1764,7585,350
32692,51,2184,2065,1715,14159,469
27203,9,244,2353,200,6719,44
15121,2,50,2942,45,4055,5
25840,2,73,2415,48,2891,25
23626,62,2573,2515,2001,18090,572
43072,367,6179,1174,4700,43457,1479
15726,14,1511,2913,1110,16793,401
41915,90,4012,1427,2790,34548,1222
28398,6,385,2283,241,8872,144
38947,3,108,1715,91,4134,17
26166,0,40,2401,36,2328,4
27725,1,126,2322,109,4354,17
1994,26,2085,3620,1415,40918,670
11273,110,8185,3191,5885,127291,2300
18177,4,84,2794,63,3663,21
23782,4,287,2509,218,5118,69
8758,55,3865,3327,2697,24151,1168
46389,61,2066,185,1724,9573,342
16644,4,98,2871,56,6368,42
4772,10,511,3553,393,11272,118
33361,12,310,2039,238,4970,72
3200,21,985,3599,753,29623,232
22221,2,188,2584,164,6537,24
19223,6,302,2750,205,5421,97
30253,1,51,2187,46,1879,5
21813,34,1500,2607,1188,16234,312
38282,1,84,1760,68,3680,16
10530,19,926,3232,715,3945,211
46163,51,907,268,743,7294,164
20458,8,964,2685,745,20616,219
37567,5,504,1809,434,11442,70
37768,17,983,1796,697,9309,286
45839,40,256,409,200,3761,56
23919,3,70,2503,64,3829,6
42301,19,1077,1355,831,11887,246
45500,6,61,542,40,2162,21
2694,24,1383,3608,1055,26879,328
44664,4,83,807,58,2526,25
32727,25,721,2064,595,15022,126
8621,108,2719,3336,2039,17347,680
7464,9,432,3421,310,3806,122
32645,0,93,2067,74,6018,19
20036,6,355,2707,280,6479,75
37304,18,207,1826,148,9204,59
22121,7,193,2588,155,5172,38
15564,60,3463,2921,2532,29173,931
21756,4,340,2610,281,7789,59
17431,113,5627,2827,4308,35881,1319
31181,4,117,2140,88,2938,29
24360,12,600,2482,483,6079,117
14856,17,2758,2957,2175,25055,583
21104,4521,255292,2647,152391,763914,102901
13162,80,3596,3080,2568,34051,1028
30738,28,970,2160,762,19891,208
37408,17,353,1820,288,5189,65
30770,2,197,2158,148,3734,49
21340,11,633,2633,502,6839,131
8676,96,1768,3332,1334,17429,434
40011,2,121,1650,88,4524,33
12465,0,35,3129,26,2032,9
23645,34,1671,2514,1302,20066,369
2597,17,308,3610,241,4412,67
35479,17,526,1943,424,6189,102
26645,12,514,2379,435,6942,79
10728,126,4758,3220,3712,53836,1046
5011,1260,66492,3541,45603,263801,20889
17146,3,283,2842,237,4072,46
24064,13,506,2496,411,21206,95
25385,9,289,2436,229,4728,60
999,2,50,3932,40,3450,10
9297,31,1355,3296,967,23794,388
43970,2,22,924,17,1738,5
30474,8,250,2174,201,4862,49
27353,23,375,2344,308,4790,67
15450,9,375,2927,312,5967,63
10482,5,144,3235,102,1512,42
37526,6,467,1812,337,3203,130
20492,23,1682,2684,1360,35803,322
27721,23,1967,2322,1560,10207,407
12595,15,1158,3123,926,12415,232
20039,7,619,2706,452,9352,167
5388,6,66,3520,58,2348,8
44753,2,60,776,28,2362,32
4650,28,877,3558,738,7407,139
43273,92,2945,1116,2017,26709,928
40233,10,923,1636,658,14386,265
9512,18,820,3282,627,6166,193
36557,3,85,1872,73,3134,12
34468,18,661,1999,530,7913,131
1731,2,75,3648,54,3204,21
10867,4,125,3213,95,8973,30
28123,9,335,2299,277,5520,58
26901,1,80,2367,70,2589,10
22271,31,5371,2581,3733,38130,1638
38983,1,45,1713,38,3334,7
27602,50,1347,2329,1082,23475,265
39612,3,62,1675,49,5152,13
40774,1768,49372,1587,32621,242701,16751
21123,1,228,2646,190,5756,38
38984,68,2019,1713,1559,21019,460
31251,4,566,2137,430,8884,136
20500,9,427,2683,342,4315,85
35936,20,1008,1908,760,9617,248
32024,1,46,2096,40,3130,6
21803,6,223,2607,180,3138,43
25737,6,740,2419,582,18959,158
7674,7,121,3408,103,6773,18
38364,7,150,1754,119,3445,31
9482,13,686,3283,515,26648,171
8365,0,21,3353,18,1127,3
22618,3,268,2565,233,3483,35
28244,29,1336,2292,971,18643,365
9823,4,165,3266,141,6449,24
42988,13,90,1201,72,4362,18
26835,0,47,2370,38,2816,9
42274,4,62,1358,57,2739,5
14932,37,1826,2953,1394,28128,432
31241,8,98,2137,90,5140,8
38101,83,3124,1773,2412,17748,712
4018,2,176,3581,138,4845,38
7789,1,47,3400,41,2907,6
7337,2,84,3428,74,6466,10
34827,0,41,1978,31,2389,10
27950,0,156,2308,129,2831,27
37273,16,297,1828,236,4944,61
19972,29,3407,2710,2613,15442,794
31280,42,1819,2135,1390,12267,429
33262,22,1028,2042,786,13294,242
2364,44,2169,3614,1660,17079,509
22246,0,34,2582,28,4083,6
13671,2,96,3044,78,4383,18
3380,5,269,3596,221,5030,48
7112,24,906,3440,656,5249,250
37054,1,61,1841,49,2738,12
31075,8,183,2146,139,4552,44
19370,7282,372111,2742,271067,1233011,101044
3954,104,5775,3583,4098,57112,1677
40269,36,1106,1633,840,15290,266
15721,21,982,2913,792,4846,190
13864,17,979,3028,764,9164,215
13597,111,7000,3049,5158,43506,1842
29853,118,3112,2207,2297,45180,815
2810,11,209,3606,173,5830,36
31605,23,549,2117,456,30640,93
20377,17,569,2689,460,4968,109
35672,3,162,1927,140,2665,22
10490,43,2120,3234,1490,29721,630
17380,1,121,2829,107,4332,14
37414,2,26,1820,19,2437,7
30036,2,212,2198,148,5426,64
4663,6,291,3557,241,6106,50
25804,306,10200,2417,7869,48972,2331
44976,48,408,711,305,4290,103
40835,29,833,1581,609,13775,224
42692,44,1173,1274,912,21869,261
2980,10,481,3603,391,18708,90
16043,7,264,2900,223,4312,41
22751,417,17463,2559,12017,64206,5446
39457,78,1575,1684,1203,21912,372
20476,31,578,2684,489,6645,89
7089,61,2869,3441,1970,34534,899
36544,0,50,1873,31,2287,19
17295,13,434,2834,360,2983,74
6535,2,110,3468,95,1976,15
20812,6,245,2665,200,3251,45
25160,13,432,2446,330,13529,102
18552,23,759,2778,599,19065,160
19615,2,37,2730,32,3347,5
6274,4,96,3480,77,4933,19
15884,5,338,2908,277,5065,61
1852,304,14060,3623,10466,55255,3594
43636,16,189,999,158,4997,31
25829,11,1009,2416,777,10752,232
11598,1615,66098,3175,42392,406617,23706
20000,90,2924,2708,2265,25037,659
40814,52,1529,1583,1195,19566,334
29279,21,479,2236,389,7094,90
13312,138,8769,3071,6090,77799,2679
4192,682,32506,3575,22563,76485,9943
6272,12,299,3480,240,2620,59
45524,61,549,534,454,7956,95
2778,12,399,3607,325,31663,74
3704,75,3566,3589,2706,30871,860
29126,762,28709,2243,21080,123933,7629
4895,16,513,3547,410,4469,103
34249,1,106,2008,87,3131,19
16324,98,2827,2886,1989,10665,838
42170,26,317,1380,245,6114,72
3507,44,1586,3593,1215,8521,371
19173,3,168,2752,144,3399,24
27703,19,472,2323,395,11306,77
27089,19,766,2361,641,9572,125
4063,5,69,3579,59,3114,10
17853,1,144,2810,115,3816,29
43420,33,540,1070,421,11765,119
1555,10,219,3687,179,4031,40
43431,26,549,1068,434,12928,115
2739,17,615,3608,454,12734,161
41431,26,618,1506,493,16693,125
4217,42,1605,3574,1196,29716,409
12880,15,776,3106,650,7712,126
3320,164,10007,3597,7265,71290,2742
44269,88,1193,872,887,12236,306
13773,4,171,3035,142,2774,29
31071,1,96,2146,75,1599,21
40927,4,225,1573,164,6315,61
30223,69,1588,2188,1221,16519,367
46271,1,13,238,12,1217,1
27311,75,2133,2347,1675,27715,458
19737,31,1481,2723,1119,25731,362
23991,4,120,2498,96,3139,24
2119,658,21841,3618,16842,116432,4999
42340,9,847,1347,565,15789,282
23823,4,301,2507,227,5618,74
36623,33,562,1867,460,11839,102
4187,1,83,3575,46,1783,37
18207,315,15014,2792,9756,113504,5258
11535,15,349,3177,279,2909,70
2783,17,361,3607,309,11754,52
39058,10,266,1709,197,11742,69
16201,26,656,2893,532,11198,124
29530,125,2736,2223,1854,10294,882
26906,34,737,2366,607,6615,130
23155,2,349,2539,285,11767,64
46253,0,3,243,3,3733,0
27520,448,20430,2333,16258,75752,4172
21585,7,256,2619,216,4420,40
42583,7,325,1298,220,6576,105
12815,28,604,3110,509,25325,95
31893,27,1569,2103,969,14144,600
6610,60,1735,3465,1389,31083,346
45770,0,134,429,95,2347,39
23295,75,3203,2532,2170,26398,1033
19332,9,1241,2744,920,11357,321
39560,40,955,1679,703,12132,252
38439,24,501,1749,399,3800,102
45813,57,465,416,382,6471,83
1973,40,860,3620,741,19572,119
3817,14,429,3587,321,5891,108
18539,639,63762,2778,46726,336739,17036
4210,2,67,3574,52,3211,15
5811,3,78,3499,63,5342,15
44013,33,524,915,388,5690,136
10411,4,212,3239,172,6597,40
41376,53,577,1515,447,9340,130
29264,5,235,2237,163,6912,72
1906,17,164,3622,121,6592,43
26798,99,2438,2371,1958,34509,480
7707,41,816,3406,624,10817,192
2631,145,3754,3609,3053,21303,701
40928,34,760,1573,551,13800,209
41266,12,255,1531,187,7192,68
5016,105,4553,3541,3446,44074,1107
39624,77,2066,1674,1552,18333,514
10172,89,6087,3250,4249,39362,1838
2652,2,48,3609,45,3850,3
12211,47,1366,3144,1023,24648,343
38630,2,126,1735,91,5026,35
27843,13,675,2315,542,5482,133
2988,44,3725,3603,2915,17356,810
32366,9,405,2079,337,6832,68
31464,644,13556,2125,9676,48236,3880
24866,20,523,2459,428,3149,95
6360,31,1018,3476,745,23755,273
7549,52,1589,3416,1128,23653,461
1947,347,21825,3621,14741,73178,7084
5403,368,15713,3519,12411,100477,3302
2719,1,27,3608,22,4405,5
40641,1,50,1599,40,2349,10
44600,14,122,820,116,7002,6
19630,3,299,2730,238,2989,61
25662,5,556,2423,444,10991,112
5541,30,949,3513,793,39807,156
26638,35,1016,2379,703,8216,313
35024,1,80,1968,64,2670,16
11226,9,619,3193,536,7393,83
42431,14,591,1328,385,9010,206
30956,18,670,2151,539,7848,131
45605,2,57,508,33,2472,24
30229,52,1434,2188,1203,19377,231
6311,38,965,3478,744,9006,221
38153,0,43,1769,35,3741,8
6014,14,2289,3489,1345,24054,944
9240,9,339,3300,271,10750,68
29856,0,107,2206,85,4577,22
29394,37,1925,2229,1626,4415,299
1032,7,117,3918,99,3496,18
22325,1,58,2579,43,2125,15
29085,3,70,2245,56,1514,14
40740,3,378,1591,269,6235,109
46452,0,23,148,19,800,4
1878,25,606,3623,518,8638,88
43166,448,9849,1148,7107,63950,2742
23497,11,319,2522,253,5262,66
8373,9,117,3352,80,2129,37
42966,22,220,1208,168,9535,52
31458,8,421,2125,335,5655,86
3761,1,117,3588,100,5400,17
43133,11,133,1157,111,4978,22
36796,19,391,1858,302,4952,89
17217,9,1209,2838,872,15031,337
37839,53,897,1790,679,8163,218
31990,9,308,2098,222,9837,86
13694,106,9726,3042,6008,76857,3718
36651,4,187,1866,146,7179,41
46039,1,60,320,24,1965,36
24156,14,542,2491,367,4619,175
2092,36,1818,3618,1481,15619,337
23554,29,1494,2519,1204,15677,290
36471,0,295,1877,232,5782,63
46459,8,144,144,117,1153,27
14885,8,471,2955,371,9370,100
16743,18,922,2865,720,6816,202
26790,6,155,2372,134,2640,21
35340,35,2187,1951,1701,18496,486
2505,28,1052,3611,812,14677,240
21170,84,5111,2642,3997,40710,1114
15710,0,1431,2914,1048,12445,383
1803,77,1981,3626,1466,38117,515
11683,5,350,3170,250,24099,100
2470,16,408,3612,351,9759,57
22824,6,237,2555,184,3241,53
3946,6,103,3583,91,12237,12
2091,41,2160,3618,1570,16952,590
37566,1,46,1809,38,2277,8
18604,20,542,2775,437,9611,105
33404,72,2812,2037,2170,14145,642
21467,16,443,2626,362,5726,81
9305,2,120,3296,97,2820,23
35757,43,1128,1921,835,10296,293
38397,68,1528,1752,1211,20559,317
33657,13,398,2027,328,10192,70
30188,40,788,2190,598,6742,190
45272,18,85,600,64,2289,21
42430,68,714,1328,526,5840,188
18352,83,3841,2785,2826,77060,1015
25703,27,756,2421,634,6443,122
12994,251,28250,3098,19815,153285,8435
36991,0,78,1846,66,5014,12
44756,4,87,776,58,3346,29
3876,15,351,3585,297,4439,54
16196,50,6127,2893,4482,35696,1645
41612,14,366,1481,263,12426,103
24443,1007,111831,2478,72283,315774,39548
45695,8,171,463,129,3241,42
12009,10,819,3154,673,61967,146
38250,1,99,1762,85,4210,14
10872,1,102,3212,73,6282,29
13790,7,201,3034,163,4376,38
42748,34,2532,1261,1888,18181,644
14966,14,620,2951,493,11704,127
15637,302,15909,2917,11206,123797,4703
42505,19,296,1312,225,5445,71
36355,2,36,1882,29,1860,7
6143,11,797,3485,633,12452,164
45165,3,34,633,23,2922,11
11368,134,4523,3187,3552,23660,971
30608,1,19,2166,16,2776,3
1480,0,12,3712,10,1505,2
43887,44,295,936,244,4754,51
5876,15,578,3496,420,5973,158
22823,14,378,2555,289,2935,89
5724,0,23,3503,20,6287,3
38561,57,1828,1740,1391,8850,437
33011,11,586,2052,436,14840,150
7348,16,357,3427,278,4090,79
8398,45,1441,3350,1088,15278,353
20215,2,432,2697,326,7161,106
37057,20,534,1841,398,10028,136
33719,61,1684,2025,1310,19090,374
13002,131,4734,3098,3587,41536,1147
42021,7,135,1411,106,5342,29
30262,3,109,2187,83,2087,26
23649,133,5410,2514,4231,37796,1179
4052,25,1915,3580,1553,41337,362
11385,53,1026,3186,773,9611,253
42594,40,940,1296,706,10326,234
35491,7,167,1942,143,5839,24
41815,7,238,1443,161,5964,77
17837,48,2722,2810,2017,12381,705
23450,8,417,2524,281,3435,136
9563,17,742,3278,597,9634,145
41657,15,929,1474,737,13961,192
7123,15,498,3439,429,13232,69
43556,31,1058,1028,846,20995,212
36598,0,102,1869,90,3327,12
33225,1,25,2044,20,4547,5
35727,192,5424,1923,4382,29588,1042
9761,30,826,3269,587,14943,239
35935,12,329,1908,272,5969,57
2232,18,910,3616,737,10867,173
35428,2,70,1946,57,2955,13
34739,3,179,1984,152,3033,27
22154,8,182,2587,142,3732,40
16690,55,6670,2868,4970,37124,1700
10859,30,200855,3213,53345,29127,147510
10228,1,32,3247,25,1655,7
45560,11,119,518,103,3399,16
24050,28,666,2496,585,7071,81
2134,44,1050,3617,793,27819,257
18735,219,17515,2769,11792,118438,5723
14709,20,699,2967,560,8546,139
14950,33,1603,2952,1172,15544,431
31318,17,593,2133,469,4438,124
19052,9,208,2757,153,5593,55
31043,3,80,2147,66,4726,14
2899,2,156,3605,127,14841,29
38829,10,677,1723,553,12716,124
13723,19,991,3039,791,11245,200
14670,1,101,2970,71,3067,30
7897,18,588,3390,466,4873,122
43638,52,700,998,584,20432,116
27692,3,613,2324,499,11372,114
17454,10,621,2826,483,10091,138
17621,488,99175,2818,66617,142578,32558
41556,8,117,1490,89,3927,28
21783,2,368,2608,276,6563,92
5788,21,886,3501,713,5721,173
43774,0,14,954,8,1582,6
42189,47,1053,1376,785,22370,268
8163,106,3866,3366,3185,27507,681
23934,86,2736,2501,1985,49240,751
22586,2,148,2566,122,5015,26
9997,19,565,3258,475,6891,90
23141,40,1082,2539,847,5138,235
3247,11,368,3598,311,4796,57
7396,52,948,3424,704,9644,244
43351,171,4246,1094,3196,41940,1050
3511,16,415,3593,350,13197,65
6978,70,1290,3447,804,14261,486
4285,2,37,3571,29,2013,8
45418,11,79,561,67,4814,12
14713,25,703,2966,548,9950,155
12429,1,95,3130,84,8088,11
33323,170,7713,2040,5862,48699,1851
12756,9,389,3113,314,8625,75
24283,14,342,2485,272,4802,70
43883,54,421,937,349,7062,72
5695,118,3169,3504,1901,9267,1268
14066,11,629,3011,478,10582,151
12374,30,1649,3134,1376,64443,273
40868,12,689,1577,480,9417,209
24211,14,487,2489,394,6024,93
6039,21,662,3488,529,6292,133
12394,32,2401,3133,1866,21328,535
5860,11,189,3496,160,5266,29
34708,12,290,1985,208,6508,82
35960,423,20955,1906,16408,63818,4547
25711,6,598,2421,476,5292,122
23885,4,104,2504,86,2984,18
39992,7,130,1651,93,3065,37
13924,14,689,3022,524,10783,165
10114,6,218,3252,124,2111,94
40015,1,77,1650,57,3642,20
4957,35,305354,3544,101672,14322,203682
11732,82,4847,3167,3649,54851,1198
19172,1281,119335,2752,80955,423288,38380
6523,31,1032,3469,759,5853,273
6135,6,107,3486,94,3743,13
16046,32,1004,2899,779,14097,225
32874,1,60,2057,46,6500,14
34537,20,1465,1995,1156,9328,309
26413,26,1279,2389,1082,8472,197
24143,117,3620,2491,2704,20359,916
36815,5,207,1856,154,4809,53
21183,18,479,2641,392,9644,87
3178,21,682,3600,506,25755,176
38074,13,317,1775,238,6134,79
30909,4,142,2153,115,4119,27
26868,27,673,2368,570,7042,103
3049,29,1516,3602,1173,10352,343
46327,3,18,214,17,832,1
40487,17,388,1612,312,7359,76
40340,23,954,1628,743,21982,211
11474,653,27013,3181,18030,95433,8983
26949,7,551,2365,439,8985,112
46095,5,64,301,57,1747,7
14559,0,158,2977,117,4857,41
12082,612,35566,3151,23554,230638,12012
12670,38,645,3118,509,11539,136
39085,36,716,1707,561,8640,155
44618,193,4712,817,3105,29456,1607
46294,0,13,229,11,581,2
11376,182,4553,3186,3220,43290,1333
40795,6,122,1585,86,2809,36
18889,4,361,2763,263,5999,98
44289,7,107,871,93,3449,14
14089,3,146,3009,126,4981,20
20001,44,799,2708,653,7790,146
44486,8,67,841,54,4313,13
40452,3,202,1616,149,5641,53
46383,2,15,189,14,1808,1
41896,0,101,1430,81,2811,20
46321,1,50,215,38,1075,12
27797,120,2689,2317,1931,17978,758
35101,40,605,1964,502,8200,103
40945,107,3400,1571,2497,46226,903
45403,32,813,562,641,11625,172
13385,137,7948,3065,5515,44595,2433
18575,12,321,2777,244,4644,77
13326,85,3747,3070,2981,40474,766
40109,262,7505,1644,5324,43908,2181
32328,1,371,2081,297,10519,74
38085,26,983,1775,752,8400,231
17894,275,10732,2808,8071,75549,2661
16188,4,146,2893,121,5098,25
33569,16,439,2031,339,6730,100
34041,81,4279,2014,2730,39833,1549
40090,2,107,1645,81,3610,26
36002,130,3303,1903,2634,26745,669
40142,13,344,1643,247,6775,97
27240,4,100,2351,83,2582,17
44434,5,87,849,48,5845,39
29578,117,7276,2220,4985,45829,2291
30326,8,174,2182,132,2367,42
26636,8,156,2380,134,4203,22
27784,3,133,2318,107,3185,26
19454,0,49,2737,38,3286,11
42285,57,1814,1357,1387,22023,427
14174,46,4482,3006,3063,22055,1419
43398,44,583,1076,481,16386,102
28913,0,56,2255,47,4890,9
36954,535,32176,1848,24196,178344,7980
37761,40,1145,1796,832,15837,313
33912,7,177,2018,145,4602,32
15041,90,6448,2947,4314,45625,2134
13287,13,1307,3073,971,8943,336
34421,0,118,2000,91,5986,27
16624,0,134,2872,92,6504,42
7522,47,1981,3417,1453,21045,528
43676,154,3066,986,2530,28645,536
34757,4,152,1983,124,13080,28
21856,295,28757,2605,20611,96096,8146
5463,2,128,3517,103,4137,25
3556,47,2392,3593,1749,35877,643
20344,7,398,2691,320,4740,78
26871,2,206,2368,177,7172,29
39874,841,31232,1660,22822,186478,8410
11280,5149,338989,3190,202647,939446,136342
7580,18,275,3413,223,6000,52
15147,62,4182,2940,3252,41507,930
17851,26,1041,2810,861,19428,180
42092,100,3047,1398,2324,28513,723
16111,9,303,2896,247,5697,56
32921,22,1586,2055,1272,18389,314
38512,41,1938,1744,1454,12679,484
24207,73,2488,2489,1928,30156,560
15750,1,70,2912,55,4193,15
40595,12,282,1603,230,6058,52
4302,30,578,3571,513,9611,65
28423,9,196,2281,158,4256,38
2380,9,330,3613,287,11045,43
8813,5,118,3324,95,8371,23
41094,7,148,1555,115,3108,33
7238,16,197,3434,175,9619,22
14840,37,907,2958,728,10738,179
27481,3,500,2336,388,13237,112
38366,66,3930,1754,3000,19582,930
10558,54,1044,3231,813,9861,231
41184,17,979,1545,732,21693,247
17088,64,2007,2846,1452,22664,555
38753,0,173,1728,138,5885,35
39873,15,643,1660,493,12823,150
20650,27,2127,2675,1601,16778,526
19859,0,142,2716,109,3181,33
7304,0,53,3430,45,1882,8
27510,4,132,2334,91,3339,41
19382,34,2221,2741,1633,40089,588
38617,135,4118,1736,2991,41638,1127
41869,113,2273,1434,1648,18841,625
18990,2,148,2759,124,2597,24
40212,4,155,1638,137,3762,18
34613,113,2455,1991,1994,26613,461
35665,66,1752,1928,1436,16930,316
15946,14,1035,2905,807,26671,228
2128,2,55,3617,46,4912,9
5963,157,4539,3491,3500,21283,1039
39991,2,96,1651,71,3890,25
7893,8,34,3390,27,2786,7
10193,59,1805,3248,1290,36233,515
21454,26,1013,2626,878,15098,135
38370,15,578,1754,445,5418,133
31084,1166,57845,2145,37139,222031,20706
19046,3,234,2757,165,1889,69
45734,5,69,442,48,3290,21
8390,19,499,3351,416,6215,83
37783,4,147,1795,117,3595,30
18753,0,103,2769,85,5710,18
17843,206,7714,2810,5684,26930,2030
39563,28,1737,1678,1368,20105,369
8684,24,751,3332,641,11165,110
11086,135,5465,3201,3751,31782,1714
17032,3549,482335,2849,312087,1311356,170248
29785,9,149,2210,116,4355,33
23130,14,1477,2540,1035,4878,442
38432,5,83,1749,76,6732,7
23958,6,103,2500,88,2367,15
46299,5,76,226,49,1325,27
13933,3,297,3021,229,10761,68
33836,52,1512,2020,1240,23668,272
31848,32,889,2105,702,9703,187
10034,11,239,3256,185,5085,54
11369,10,400,3187,325,8005,75
38104,85,2173,1773,1542,14218,631
37352,68,934,1824,764,6794,170
29741,7,227,2213,177,7269,50
24484,23,718,2476,589,5270,129
1561,6,57,3686,51,2646,6
26780,62,8929,2373,6039,48185,2890
35546,182,7279,1937,5256,54402,2023
22136,229,5268,2588,4107,24297,1161
23231,11,1001,2535,792,7762,209
24187,4,521,2490,419,7135,102
39490,2,83,1682,70,3327,13
46384,0,7,188,3,491,4
23624,11,266,2516,218,4584,48
24981,3,153,2453,126,4091,27
4953,3,42,3544,23,4424,19
1965,5557,397490,3620,256695,1444868,140795
39800,5,94,1665,62,7819,32
26013,3,410,2407,323,11678,87
14684,15,75,2969,55,10812,20
14529,8,199,2979,169,6923,30
29545,12,1047,2222,780,37545,267
33767,298,11201,2023,8694,81767,2507
43308,84,1544,1106,1146,16660,398
4934,32,330,3545,286,12770,44
39127,11,243,1704,194,6016,49
26525,0,115,2384,93,3482,22
23982,0,22,2499,15,2584,7
8795,52,649,3325,514,6915,135
3258,12,554,3598,433,3303,121
19784,2,106,2720,90,3447,16
37476,48,756,1816,584,15438,172
33247,3,127,2043,112,3028,15
4480,49,1004,3564,780,11232,224
34278,14,985,2007,777,10109,208
9325,18,530,3293,432,7542,98
29063,7,247,2247,197,6718,50
22032,39,3851,2593,2926,18005,925
9741,17,986,3270,772,20024,214
2513,1,37,3611,30,4798,7
31793,4,73,2107,55,5988,18
35010,5,322,1969,219,4126,103
36805,4,106,1857,92,5194,14
15222,3,122,2936,97,3448,25
42383,68,1794,1339,1339,28841,455
46398,88,1161,181,1000,10495,161
7678,7,340,3408,273,9251,67
44772,681,19670,761,11799,62018,7871
34331,4,270,2004,191,9111,79
33395,24,717,2037,543,7287,174
29358,88,1706,2231,1385,9298,321
36976,16,601,1847,476,16682,125
19020,3,95,2758,83,3617,12
42784,2,128,1251,96,9763,32
23505,36,1281,2521,974,17867,307
3131,9,393,3600,279,9518,114
41326,72,3013,1522,2197,38880,816
42684,201,5430,1275,4130,36201,1300
42228,3,101,1368,78,4052,23
33291,49,1478,2041,1188,23647,290
18801,325,13169,2767,9692,44937,3477
31317,49,1289,2133,968,8809,321
20515,13,1204,2682,804,8203,400
2606,2,66,3609,53,3390,13
45602,5,59,509,42,2301,17
44780,171,1987,768,1697,26784,290
6058,2,60,3488,51,3359,9
17601,2,194,2819,145,4808,49
13216,6,493,3077,410,6218,83
30359,38,1093,2180,826,13722,267
33199,109,5968,2044,4638,56286,1330
2336,54,2488,3614,1846,44777,642
22822,46,3197,2555,2298,26229,899
46440,20,286,156,226,2875,60
42035,76,1064,1408,838,17238,226
8254,91,3747,3360,2761,18683,986
39322,78,2630,1691,2017,14551,613
9701,9,344,3272,251,5041,93
43300,94,1489,1108,1106,28849,383
2759,3,45,3607,33,9378,12
20126,4,295,2702,217,6359,78
21475,462,44771,2625,30317,188545,14454
10243,11,180,3246,124,2519,56
3213,15,257,3599,216,3295,41
35073,10,458,1965,385,5118,73
29049,11,573,2248,451,12265,122
12826,4,58,3109,49,2404,9
4982,8,344,3543,284,6879,60
5549,1,107,3513,83,6569,24
8200,14,489,3364,413,8224,76
31151,56,1083,2142,910,20406,173
3171,14,398,3600,320,18306,78
28200,17,1324,2294,971,7904,353
11367,2422,90987,3187,63727,213742,27260
24299,0,2616,2484,2006,22012,610
28228,9,194,2293,149,4971,45
22930,19,584,2548,497,4774,87
25298,0,86,2440,65,7240,21
22550,4,41,2567,32,4437,9
6860,3,98,3454,77,2553,21
2257,6,240931,3615,86261,8431,154670
35318,69,556,1952,458,6340,98
41082,4,236,1557,176,4407,60
43509,4,54,1046,45,2745,9
2417,26,663,3613,565,21489,98
2738,14,353,3608,250,6208,103
9806,0,54,3266,44,3680,10
12565,29,1476,3124,1078,14279,398
22421,20,811,2575,630,15518,181
37790,79,1607,1794,1127,14047,480
8458,7,97,3347,85,8850,12
7256,31,793,3433,540,14201,253
43058,43,1134,1180,904,10732,230
40442,9,222,1617,175,3459,47
22446,963,39568,2574,29722,146967,9846
24304,20,437,2484,306,2845,131
26528,2,183,2384,146,10113,37
41766,15,301,1454,219,11555,82
19627,155,6535,2730,5175,53908,1360
16164,23,3731,2894,2711,16664,1020
46019,4,127,331,87,2276,40
19343,11,385,2743,301,11892,84
39017,42,5409,1711,4433,24796,976
3000,23,341,3603,257,7773,84
35413,17,458,1947,365,3292,93
8630,31,2015,3336,1599,44693,416
18672,0,28,2772,21,2062,7
40943,76,2310,1572,1620,16811,690
32865,83,4670,2058,3474,43261,1196
13353,54,1213,3068,905,37029,308
21010,0,2984,2652,2405,59576,579
13954,16,1952,3019,1365,7092,587
14769,8,1002,2962,730,35735,272
21945,144,6462,2599,4584,36159,1878
33665,0,115,2027,92,3169,23
36700,5,106,1864,94,2529,12
5008,3,112,3541,82,6011,30
43525,40,299,1040,248,6384,51
36022,17,352,1902,288,8598,64
21225,0,272,2638,200,10191,72
36922,2,33,1850,26,2462,7
12056,2,134,3153,97,3256,37
11394,5,361,3186,285,13280,76
32298,74,3923,2082,2925,26504,998
37395,1,30,1821,24,2404,6
33995,207,5768,2015,4420,39072,1348
1978,12,479,3620,348,20118,131
5467,7,225,3517,182,4536,43
42731,74,2033,1266,1529,22086,504
29620,0,76,2218,59,3578,17
31569,50,3091,2119,2348,26040,743
8597,0,39,3338,37,2913,2
6032,6,206,3488,161,6766,45
9781,76,7219,3268,5725,34138,1494
46454,26,502,148,397,3973,105
8289,13,582,3358,478,15474,104
21041,35,1438,2650,1190,6045,248
6050,5,270,3488,226,2781,44
34335,3,170,2004,144,8353,26
6125,2,153,3486,132,4443,21
17202,9,366,2839,287,15307,79
36570,0,0,1872,0,1653,0
20032,7,484,2707,354,7195,130
37002,10,338,1845,284,11323,54
4919,46,761,3545,634,16072,127
39261,2,136,1694,111,4461,25
31603,16,2002,2118,1422,19805,580
45692,11,158,466,115,3091,43
44853,12,207,744,136,8593,71
26220,1512,60028,2398,41953,228513,18075
40274,3,140,1633,106,4656,34
25481,0,514,2432,393,8718,121
25696,6,356,2421,303,3524,53
6682,15,594,3462,438,9041,156
9212,19,680,3301,523,6138,157
44889,53,492,736,368,6509,124
31627,39,901,2116,696,5834,205
44749,3,40,777,33,2114,7
8703,10,143,3331,121,2557,22
40568,1,31,1605,24,1888,7
14336,237,15874,2993,9533,76337,6341
45371,5,83,574,56,3539,27
25364,77,5352,2437,4000,34067,1352
16670,7,112,2869,96,2022,16
8545,11,580,3341,423,9240,157
35143,1,72,1961,61,3070,11
40596,438,10942,1603,7842,78660,3100
34726,47,1443,1985,1135,15088,308
17457,5,276,2826,221,4661,55
3415,40,1570,3595,1073,10631,497
20544,26,922,2680,760,10741,162
14055,72,6580,3012,4853,45308,1727
36333,2,61,1883,48,3207,13
23001,4,205,2546,136,4794,69
41892,3,102,1430,79,5313,23
5809,178,7800,3499,6049,71604,1751
6103,2,154,3486,132,3436,22
43355,22,624,1093,437,8505,187
33094,0,13,2048,10,2525,3
4361,49,1641,3568,1293,18087,348
1043,3,97,3914,85,7673,12
29080,27,2162,2245,1653,14876,509
45386,11,132,570,104,2477,28
38771,11,656,1726,514,14850,142
46101,7,76,298,52,1430,24
18419,19,452,2783,344,5582,108
42186,8,572,1377,385,11311,187
30673,33,835,2163,688,8295,147
20397,18,703,2688,581,10725,122
19877,4,686,2716,509,14305,177
19622,11,559,2730,413,7518,146
10139,8,296,3251,250,2971,46
17924,72,3482,2806,2751,67110,731
7666,17,525,3408,409,6842,116
17716,49,3673,2815,2706,43274,967
2659,39,1117,3609,909,14595,208
2753,5,292,3607,242,5216,50
33294,0,42,2041,35,1869,7
7538,8,368,3416,266,11725,102
42327,2,152,1350,85,4720,67
20649,34,1818,2675,1436,35521,382
5924,3,102,3493,85,2747,17
7286,40,2484,3431,1565,15544,919
17257,15,1211,2835,847,13207,364
42342,3,102,1347,82,6731,20
8740,2,178,3329,152,5556,26
14779,6,138,2962,106,2832,32
3494,31,602,3594,502,11229,100
5042,8,32,3540,23,3182,9
11845,2,49,3163,41,1381,8
41617,24,555,1480,424,10872,131
6688,7,197,3462,160,2460,37
2560,64,2482,3610,1820,16861,662
8601,7,280,3338,221,14231,59
29437,0,0,2227,0,9088,0
38797,1,44,1725,31,1980,13
3765,10,265,3588,214,6606,51
41905,19,369,1429,316,8493,53
3134,95,3281,3600,2610,38101,671
31930,15,417,2101,308,6617,109
10068,72,4118,3254,3158,49548,960
30746,60,1512,2159,1207,10780,305
8471,9,318,3346,259,5791,59
25360,19,878,2437,706,14990,172
6435,3,73,3473,60,4934,13
8044,80,2481,3372,1909,21234,572
39319,27,605,1691,416,8107,189
36171,4,104,1891,87,2271,17
16963,49,1813,2853,1313,18029,500
15215,6,214,2937,138,5179,76
12244,89,5578,3142,4163,27375,1415
3462,140,4882,3594,3836,44054,1046
8922,63,932,3318,708,8283,224
22010,5,213,2595,166,4412,47
5855,4,65,3497,53,2803,12
15509,367,24563,2924,17946,130374,6617
20659,7,366,2675,291,7200,75
44015,6,116,914,100,2107,16
23843,16,891,2506,712,4867,179
32130,30,956,2090,690,8107,266
22163,266,7436,2587,5697,48034,1739
19260,3,199,2747,177,8042,22
42523,10,135,1309,99,3124,36
39245,15,1017,1695,759,19184,258
3585,229,4720,3592,3510,16931,1210
42375,36,809,1340,607,18380,202
10723,2,61,3220,55,3077,6
10764,11,255,3218,210,2670,45
987,4,87,3936,74,3377,13
23547,22,1051,2520,577,18317,474
25323,9,203,2439,156,4072,47
42151,34,560,1385,430,5979,130
22168,6,440,2587,305,3652,135
16297,37,3802,2888,2735,18252,1067
35547,21,799,1937,670,13017,129
17232,5,330,2837,248,6137,82
3512,14,589,3593,493,5826,96
33417,11,306,2037,250,6903,56
11677,29,1672,3170,1313,39809,359
32759,2,88,2063,64,3613,24
45167,0,7,633,5,1065,2
34406,80,2862,2001,2137,38015,725
3181,7,245,3599,194,9625,51
22109,165,9013,2589,6697,64194,2316
11043,41,1158,3204,900,16440,258
46424,0,17,165,12,533,5
36114,8,333,1895,264,4466,69
23136,13,1394,2540,1023,17987,371
26943,21,765,2365,603,31240,162
13747,38,2291,3037,1679,49656,612
21693,742,38301,2612,27134,175067,11167
14163,67,3004,3007,2454,12348,550
8236,137,5848,3362,4311,44156,1537
36814,559,7787,1857,6110,30331,1677
43394,17,513,1078,285,10077,228
17476,7,446,2825,373,6117,73
41697,40,1661,1468,1200,19494,461
32305,5,74,2082,60,1858,14
41951,0,0,1421,0,5386,0
22964,13,298,2547,237,4755,61
25482,6,268,2432,201,14808,67
23005,10,532,2545,417,4118,115
2768,10,243,3607,178,3451,65
3725,169,9532,3589,6423,93984,3109
12375,29,1677,3134,1227,23861,450
9368,4,134,3290,108,4248,26
32112,21,506,2091,356,12268,150
41231,0,0,1537,0,10508,0
41140,20,460,1550,331,11672,129
40533,17,560,1609,434,16244,126
2532,2,29,3611,27,3554,2
44239,5,55,876,40,3453,15
29087,561,31482,2245,22637,163587,8845
29351,3,106,2231,86,2130,20
46031,0,9,326,6,864,3
32672,38,2051,2066,1384,13263,667
42378,0,64,1340,39,4401,25
13566,5,183,3050,153,5099,30
3367,204,9723,3596,6822,64591,2901
34009,2,30,2015,25,2092,5
19775,0,84,2721,57,2748,27
14087,0,89,3009,74,3525,15
4716,26,869,3555,616,9486,253
21375,13,499,2631,414,3028,85
35127,65,914,1962,682,6584,232
42698,7,206,1273,154,8578,52
28291,1,113,2289,93,4988,20
4140,0,33,3577,29,2590,4
31374,0,0,2130,0,3744,0
36415,20,299,1879,245,6087,54
8549,67,1415,3340,1187,8341,228
3528,24,644,3593,522,24492,122
4019,20,768,3581,637,23744,131
36335,3,102,1883,84,3878,18
11076,4,123,3202,91,5550,32
43079,157,4211,1172,2979,34798,1232
37591,4,91,1808,74,2705,17
29280,10,644,2236,537,16604,107
11773,12,816,3165,621,11057,195
32753,296,13888,2063,10281,99325,3607
45425,3,50,560,43,3275,7
43670,21,454,988,362,9022,92
45366,47,478,576,389,10717,89
41209,17,1034,1542,740,7911,294
33154,11,321,2046,257,7292,64
16472,59,1589,2879,1244,22276,345
39470,0,39,1683,33,3771,6
16565,19,597,2875,400,4794,197
34508,67,1748,1996,1301,16307,447
12830,2,136,3109,118,2679,18
20957,14,1886,2656,1264,38960,622
19409,103,2436,2739,2012,21955,424
7568,140,5413,3414,4145,53640,1268
8620,2,243,3336,201,5520,42
15524,47,3099,2923,2454,30499,645
3649,14,877,3591,590,17338,287
23320,55,5443,2531,3785,28729,1658
13381,2,18,3066,14,1940,4
32171,0,0,2088,0,4917,0
36764,39,1077,1860,774,14523,303
30100,16,290,2195,232,7570,58
7376,20,483,3425,358,5009,125
9189,4,106,3302,88,3507,18
30901,492,12125,2153,8714,68595,3411
5520,11,116,3514,100,4716,16
38055,39,555,1777,438,6578,117
34320,260,11542,2005,8089,71903,3453
16529,5,150,2876,114,4124,36
22805,12,352,2556,271,3468,81
43386,240,3839,1063,2851,47798,988
29808,360,16811,2209,11863,66400,4948
8235,2729,142581,3362,94732,703243,47849
40137,3,57,1643,43,2932,14
10528,14,501,3232,384,10036,117
3221,3,134,3599,108,8485,26
24298,4,217,2484,153,3967,64
4425,12,159,3566,132,8572,27
29592,9,321,2220,240,3763,81
25816,7,753,2416,591,11822,162
21329,9,557,2633,423,6515,134
38175,2,165,1768,130,6015,35
2820,10,506,3606,413,7055,93
4998,4,42,3542,37,1635,5
36027,9,326,1901,263,7550,63
21369,0,58,2631,50,2054,8
45829,10,73,410,71,2884,2
2143,154,4675,3617,3705,37998,970
33932,5,214,2018,158,9928,56
45209,278,2639,622,2163,22415,476
15026,6,417,2947,347,6745,70
8014,15,257,3379,205,4049,52
1515,3,56,3705,45,2545,11
10838,2,104,3214,84,11718,20
46036,8,134,320,85,2715,49
32593,10,581,2069,486,7736,95
11415,457,20588,3185,14477,79515,6111
19441,15,595,2738,431,8635,164
991,9,228,3934,192,7313,36
24592,12,610,2470,487,7132,123
11884,1,95,3161,75,4451,20
45423,34,443,561,377,10710,66
38308,2,128,1758,96,4547,32
20737,0,101,2671,69,2693,32
29989,10,545,2200,408,11351,137
6692,8,308,3462,231,11338,77
24881,46,3735,2458,2844,30974,891
4278,50,2329,3572,1804,41838,525
34752,15,670,1983,529,18049,141
37728,94,862,1799,679,7981,183
36818,37,1177,1856,876,9599,301
39663,7,103,1672,77,5629,26
46100,4,58,299,48,1594,10
15218,14,255,2937,214,3788,41
9092,137,6500,3308,4861,47893,1639
36021,3,42,1902,30,3165,12
18022,12,883,2800,618,15721,265
15740,16,797,2913,583,12228,214
34811,6,143,1978,118,5898,25
24427,9,227,2479,165,11870,62
45416,0,22,562,14,2200,8
17583,99,8092,2819,5116,43742,2976
38671,3,129,1733,102,5809,27
29004,6,136,2250,119,6644,17
21274,68,7122,2636,5415,41031,1707
17999,8,324,2801,241,3866,83
8560,52,2568,3340,2081,23257,487
31832,1,47,2105,37,3984,10
37895,15,270,1786,212,3992,58
14120,6,1153,3008,947,20371,206
32778,4,168,2062,145,4015,23
9600,4,342,3276,264,3118,78
43196,2,251,1140,176,4684,75
16286,4,178,2888,134,5914,44
45876,21,440,396,324,7064,116
7223,1,23,3435,20,2202,3
45719,18,506,449,389,8728,117
45778,43,502,426,434,10197,68
17770,1,106,2813,89,6069,17
2991,20,696,3603,579,14223,117
42038,554,11673,1407,9150,96592,2523
2956,8,383,3604,271,3559,112
21566,12,870,2620,685,8823,185
11150,3,150,3197,119,3959,31
41754,143,3905,1456,3043,30328,862
8497,293,6238,3344,4835,30542,1403
4594,118,2387,3560,1854,44061,533
17849,4,116,2810,91,5885,25
24774,5,531,2463,423,10537,108
18001,20,508,2801,359,4562,149
38164,11,154,1769,116,2134,38
8886,44,2488,3320,1897,34037,591
46301,40,363,225,319,4859,44
44081,10,217,892,161,5445,56
45029,129,1258,695,959,14012,299
41740,53,2342,1460,1564,16243,778
37699,6,225,1801,163,5837,62
16265,8,1483,2889,1189,23002,294
3341,13,606,3597,416,8568,190
34416,11,262,2000,210,7882,52
26300,10,144,2394,111,5419,33
38089,11,261,1774,211,11375,50
16536,12,912,2876,698,9551,214
44158,3,27,889,20,4862,7
4090,38,692,3578,517,7658,175
23189,41,1027,2537,794,14199,233
26829,3,74,2370,61,2780,13
3172,1596,74759,3600,50436,275074,24323
18241,4,463,2790,330,9014,133
42357,43,850,1343,622,12555,228
14975,33,1620,2950,1260,18132,360
40503,74,1773,1611,1431,17567,342
29091,1,85,2245,70,2106,15
37219,13,535,1831,448,12710,87
14167,59,2376,3007,1874,26045,502
35172,12,715,1960,562,11928,153
8232,2,48,3362,37,4834,11
9161,12,827,3304,690,6682,137
27111,33,1986,2359,1099,12770,887
30071,5,293,2197,234,4517,59
28510,29,638,2276,532,11775,106
15063,221,11917,2945,8823,57822,3094
23660,76,1515,2513,1128,15508,387
27449,26,1298,2338,1062,11271,236
16385,1,184,2883,140,5510,44
15844,3,231,2909,174,3775,57
9258,137,8750,3299,6625,40068,2125
13186,92,4356,3079,3449,50458,907
30291,24,402,2185,345,5960,57
25582,4,292,2427,227,5542,65
37712,1,139,1800,120,5784,19
17954,8,423,2804,362,4746,61
36434,27,1357,1879,1109,15821,248
17909,616,90787,2807,57995,224848,32792
3303,3,203,3597,173,6115,30
39843,569,33958,1662,24132,138449,9826
23319,14,351,2531,293,2743,58
34497,1,179,1997,142,3712,37
6337,21,1712,3477,1251,12655,461
46162,111,2289,269,1679,11499,610
41745,29,664,1458,515,6377,149
12924,3,199,3104,165,5179,34
19067,66,2523,2756,1907,14268,616
28559,11,305,2272,244,4561,61
24566,4,381,2471,266,5448,115
30302,43,1303,2184,954,7064,349
17206,258,11712,2839,8348,50480,3364
9690,14,398,3272,308,7008,90
41694,51,1043,1468,821,8883,222
43685,64,531,981,485,16205,46
4215,38,2450,3574,1856,24635,594
45069,9,102,677,95,3908,7
26639,2,67,2379,55,1742,12
2083,82,1901,3618,1520,42595,381
29768,7,622,2211,491,7748,131
37888,12,198,1787,158,5741,40
40332,47,1068,1629,823,11525,245
39521,98,3645,1681,2824,20163,821
5375,4,53,3521,38,4610,15
26569,0,74,2382,65,1829,9
18780,111,13345,2767,9871,54890,3474
46220,12,208,251,159,1602,49
36426,6,215,1879,147,2900,68
33839,22,228,2020,188,2883,40
19253,6,738,2748,588,9211,150
33226,7,242,2044,204,8057,38
26195,4,185,2399,168,5136,17
8324,10,520,3356,371,27374,149
42386,2,109,1339,82,7200,27
41808,2,122,1445,90,4695,32
46209,0,12,253,8,2139,4
17074,38,1867,2846,1310,15602,557
25227,3,130,2443,77,10448,53
7106,93,2936,3441,2125,40471,811
41826,18,549,1441,441,17668,108
32863,6,326,2058,259,5008,67
31821,350,14718,2106,9435,98304,5283
45934,4,121,366,60,2946,61
20807,0,924,2665,732,12033,192
16465,12,332,2879,256,4113,76
31757,312,11386,2109,7763,34949,3623
26100,17,859,2404,700,10755,159
5433,250,10888,3518,7935,54352,2953
22886,8,707,2551,574,7059,133
2114,320,8647,3618,6387,48935,2260
37403,11,251,1820,167,4359,84
10257,430,184213,3245,60668,71044,123545
46272,66,1615,237,1098,17465,517
17799,5,272,2812,206,5362,66
17578,8,657,2820,532,10623,125
13812,140,7173,3033,5533,105723,1640
21573,2,203,2619,163,2638,40
38714,2,82,1730,64,5172,18
44920,1,30,726,23,2197,7
36216,22,365,1889,272,7718,93
22773,1,210,2557,182,7401,28
33586,5,137,2030,109,7486,28
4882,11,309,3548,248,4900,61
5273,55,2664,3526,2220,13685,444
3516,58,3043,3593,2436,42321,607
21737,7,517,2610,433,5849,84
18734,4,151,2769,114,2729,37
45688,152,4629,467,3515,22849,1114
29641,80,3567,2217,2796,36285,771
4011,47,1223,3581,970,9347,253
34936,2,52,1972,45,3629,7
2408,19,1495,3613,1232,10355,263
14051,143,9063,3012,6684,57807,2379
2846,64,1210,3606,985,18264,225
43004,149,2123,1195,1607,22523,516
44795,33,590,764,427,3369,163
37007,2,181,1845,154,4322,27
18142,1,31,2795,27,4272,4
39276,30,843,1694,683,10826,160
4923,165,4894,3545,3590,79162,1304
15679,7,319,2915,248,4500,71
36650,156,4794,1866,3693,55168,1101
7682,22,605,3407,486,4679,119
14815,1,123,2959,101,3320,22
32196,6,193,2086,157,2983,36
30194,9,370,2190,277,11433,93
39575,1,46,1677,38,3036,8
13573,354,20588,3050,14513,153956,6075
21731,10,1123,2611,878,18853,245
46239,34,496,246,435,6384,61
30969,52,5121,2151,3765,37710,1356
6145,11,517,3485,391,8025,126
33472,27,1389,2034,1041,21145,348
38804,0,36,1724,23,4872,13
45730,1,14,443,9,1776,5
41582,5,103,1486,89,4430,14
25788,16,339,2417,272,5052,67
29585,29,2206,2220,1668,23626,538
29589,546,11848,2220,9233,58342,2615
7685,3,63,3407,55,2799,8
42001,22,543,1413,388,15728,155
15920,7,259,2906,213,5471,46
43255,6,229,1121,189,6287,40
27361,19,2209,2343,1709,49154,500
38320,6,193,1757,158,5095,35
7000,3,46,3446,30,2188,16
8121,0,13,3369,11,902,2
28206,4,352,2294,271,6585,81
7222,14,214,3435,174,10572,40
19268,91,11040,2747,8762,41476,2278
27053,2,160,2362,123,6911,37
31397,15,443,2129,358,15646,85
41097,52,589,1555,441,5802,148
20172,243,8890,2699,6667,78920,2223
9870,1066,114739,3264,69786,400458,44953
20498,92,3919,2683,3023,29652,896
4077,45,2175,3579,1713,29874,462
28165,3,45,2296,40,3843,5
10780,81,2145,3217,1713,44797,432
40606,4,108,1602,88,1661,20
39593,19,517,1676,391,8751,126
22232,733,35442,2583,24655,192155,10787
41540,12,136,1492,111,7213,25
2912,351,12712,3605,9947,101615,2765
40531,3,196,1609,142,6445,54
22011,3,193,2595,157,11064,36
32502,38,903,2074,734,11995,169
43369,94,2151,1083,1544,30365,607
22023,20,638,2594,502,14535,136
35363,62,593,1950,478,4495,115
9079,13,1015,3309,853,4181,162
27660,0,1296,2325,1005,15179,291
44527,23,324,835,263,4796,61
9624,6,354,3275,283,6602,71
30578,33,1214,2168,942,5914,272
24691,3,89,2465,68,3464,21
34685,30,1018,1986,747,10419,271
41031,4,106,1565,88,6413,18
28164,88,3172,2297,2637,20459,535
46469,0,21,141,9,1140,12
18692,12,974,2771,686,4131,288
10926,1,23,3209,17,2003,6
39140,26,835,1704,654,7639,181
17011,55,1931,2851,1538,8238,393
25579,98,3070,2427,2417,42474,653
6743,53,906,3460,700,10894,206
1639,1,56,3671,48,1613,8
21863,49,4400,2604,3198,22505,1202
6821,29,714,3456,572,9266,142
5889,33,934,3495,792,18033,142
41500,3,146,1496,111,6486,35
36535,57,918,1873,736,7755,182
17869,110,3046,2809,2240,15258,806
4092,16,1247,3578,1005,30095,242
22976,0,3339,2546,2474,23885,865
24256,17,498,2487,418,4960,80
31931,0,97,2101,86,5279,11
3058,12,375,3602,282,5842,93
27344,134,5809,2345,4176,48525,1633
38921,60,1622,1717,1098,18844,524
17695,14,456,2816,361,3172,95
35264,30,1157,1954,921,13333,236
1957,6,579133,3621,152509,13550,426624
8049,221,20684,3371,15785,101167,4899
21186,93,8926,2641,6720,38370,2206
20241,38,1192,2694,876,17547,316
15191,85,7014,2938,5364,45021,1650
43279,46,637,1115,489,16826,148
19460,3,180,2737,141,3828,39
37684,5,156,1802,133,2695,23
29933,2,57,2202,50,3787,7
32633,7,235,2068,167,6503,68
3259,14,497,3598,412,3547,85
45665,61,684,475,585,15818,99
9164,3,209,3303,162,7770,47
7531,793,42758,3417,29828,235904,12930
4163,18,468,3576,393,4950,75
42539,1,41,1305,29,4788,12
13875,17,1199,3028,921,23877,278
31694,6,285,2112,223,5995,62
38787,26,526,1725,448,8839,78
32927,15,301,2055,246,2715,55
32481,15,547,2074,440,8957,107
8705,18,1278,3330,1017,11801,261
24915,481,14185,2456,9898,64204,4287
39656,561,17733,1673,13500,113587,4233
28051,9,1985,2303,1654,15157,331
10970,17,666,3207,530,16235,136
32081,24,568,2092,389,8716,179
12792,1,44,3111,40,2899,4
6242,2,42,3482,35,3057,7
37594,206,6704,1808,4883,54491,1821
43440,21,236,1066,181,4760,55
20842,1,199,2664,162,3184,37
12709,118,4056,3116,3057,32370,999
24263,54,3053,2487,2123,29372,930
8810,17,421,3324,354,16740,67
28807,13,629,2259,510,4399,119
8907,5,94,3319,74,1866,20
19064,9,514,2757,387,15316,127
46448,0,18,150,12,454,6
8900,3,174,3320,136,6561,38
19217,2,164,2750,140,3498,24
36490,3,156,1876,125,2987,31
37966,3,127,1781,95,3813,32
6489,1,15,3471,11,3298,4
29462,0,57,2225,43,1360,14
41547,4,296,1491,224,6227,72
14409,98,2528,2987,1864,21851,664
36864,14,516,1853,417,21321,99
14314,97,4709,2995,3763,69599,946
3688,30,2296,3590,986,26698,1310
35472,42,1256,1943,1004,10748,252
19280,23,1653,2746,1123,16263,530
38911,23,395,1718,311,4298,84
7856,3,85,3394,60,3627,25
15798,0,0,2910,0,1892,0
39073,0,0,1707,0,4269,0
14793,9,206,2961,162,3814,44
42510,137,1862,1311,1321,17085,541
46456,1,64,148,50,1456,14
40855,4,72,1578,63,3401,9
38357,52,1083,1754,755,23368,328
35504,7,287,1941,225,7008,62
43496,237,7137,1050,5553,39880,1584
2628,9,372,3609,283,5464,89
31986,2,81,2098,69,3222,12
22244,10,517,2582,417,11318,100
29168,4,440,2242,298,4159,142
41963,19,329,1419,247,4329,82
5023,21,683,3541,429,11218,254
12611,116,5397,3122,4172,64472,1225
22542,3,149,2568,97,2557,52
43450,94,1916,1064,1524,27316,392
28018,0,41,2305,33,2877,8
7278,1,186,3432,143,4347,43
19420,9,665,2739,552,6068,113
39411,116,3651,1686,2556,42960,1095
3397,19,412,3595,304,18293,108
9978,4,132,3259,98,2957,34
11337,53,4891,3189,3304,34910,1587
15672,29,1134,2916,785,12317,349
12908,5,71,3104,53,3506,18
42720,6,58,1269,42,4352,16
16820,9,515,2860,431,6585,84
5474,32,678,3516,553,11077,125
41475,59,1304,1500,954,27517,350
5739,3,64,3503,50,2104,14
16887,15,1189,2857,931,10302,258
11335,0,25,3189,14,2917,11
4395,19,556,3567,405,8965,151
13530,382,39610,3053,24315,237952,15295
15464,12,1185,2927,934,7480,251
15083,91,4291,2944,3099,39019,1192
44880,45,292,738,241,6827,51
31382,32,2267,2130,1733,15933,534
17515,94,2448,2823,1922,15773,526
8627,44,653,3336,508,7814,145
21771,7,273,2609,229,6007,44
12723,8,729,3115,600,10502,129
35853,12,298,1914,251,10421,47
24517,0,32,2474,28,4839,4
29964,43,1453,2201,1091,6632,362
35563,0,45,1937,38,3437,7
25547,0,35,2429,27,4191,8
14286,24,1101,2997,749,18655,352
6884,3,121,3453,108,2821,13
25424,11,553,2435,437,8572,116
24240,12,383,2488,257,5785,126
46030,49,309,327,265,4859,44
4316,17,197,3570,144,4360,53
39689,18,303,1671,245,9954,58
31867,1,149,2104,85,2151,64
6668,43,1050,3463,781,12094,269
22799,2,123,2556,103,3091,20
42421,17,871,1330,605,10062,266
7806,32,775,3399,650,12674,125
5126,11,212,3535,166,6999,46
46281,11,88,234,75,1589,13
39340,7,220,1690,158,7927,62
20837,25,1372,2664,1064,9448,308
21444,27,1285,2627,1052,18652,233
25232,804,21588,2443,17321,77049,4267
46470,3,92,141,79,3257,13
35222,254,10922,1957,7351,44823,3571
19823,17,422,2718,345,7829,77
14177,0,50,3006,37,2559,13
27571,53,5114,2330,3777,25144,1337
8895,7,287,3320,218,6977,69
27866,159,5220,2314,3749,28963,1471
21051,1,58,2650,48,3998,10
4590,95,2613,3560,1996,16165,617
4617,73,1741,3559,1365,36596,376
17049,1,162,2847,131,10453,31
24130,31,1585,2492,1165,16496,420
37217,91,1744,1831,1302,22320,442
41283,20,653,1528,507,13441,146
27550,0,30,2331,27,1015,3
19562,5,129,2733,104,7083,25
43844,7,156,940,112,4488,44
21465,5,273,2626,227,3506,46
1662,5,152,3664,130,4057,22
2189,17,292,3617,190,9846,102
32798,2,54,2061,46,3232,8
5163,25,1281,3532,1015,35991,266
40832,81,1862,1581,1467,25271,395
31104,2,198,2144,144,2989,54
31300,7,289,2134,224,6898,65
4905,144,6357,3546,4591,42802,1766
5959,13,518,3491,414,5035,104
4907,13,610,3546,405,7487,205
9316,8,271,3295,229,3123,42
29353,6,200,2231,151,2633,49
13944,70,5562,3020,4231,35552,1331
13024,6,119,3097,92,4325,27
28136,1,107,2299,90,3279,17
45384,4,39,571,26,1821,13
28520,232,17323,2275,12842,73108,4481
13587,44,2091,3049,1543,15504,548
6547,3,75,3468,63,5290,12
20937,29,4732,2657,3516,23798,1216
38492,6,213,1746,175,8170,38
45180,75,906,629,639,9125,267
43511,8,176,1046,145,11851,31
30367,29,1539,2180,1324,6133,215
41085,73,4364,1557,3263,21361,1101
24957,11,968,2454,806,12640,162
8158,79,103731,3367,37350,16560,66381
12506,3,60,3126,50,2341,10
7862,17,401,3393,323,8645,78
16498,9,464,2878,359,6964,105
26621,94,4821,2380,3823,53670,998
42858,20,550,1236,393,11665,157
8911,30,633,3319,485,9901,148
31329,84,3599,2132,2584,27195,1015
3844,147,3009,3586,2260,21417,749
4087,5,66,3578,57,3387,9
16906,145,6565,2856,4411,45565,2154
35560,1657,69983,1937,52587,268710,17396
33903,3,135,2018,113,4505,22
37968,17,459,1781,358,6368,101
17977,12,335,2803,282,5688,53
31977,1,53,2099,41,4277,12
8910,33,1029,3319,677,7087,352
46275,2,27,236,24,557,3
34309,3,150,2005,128,5709,22
30643,0,11,2165,10,1405,1
31005,16,451,2149,332,6556,119
29304,20,569,2234,449,6020,120
37836,7,334,1790,243,5797,91
22704,0,82,2561,64,1556,18
40988,28,1331,1568,986,12497,345
23813,29,1657,2508,1347,15301,310
15819,37,2471,2910,1845,19792,626
27224,40,1326,2352,1046,21220,280
29068,2,44,2246,34,5199,10
46412,18,271,172,229,3494,42
9040,19,516,3312,429,6855,87
32961,4,100,2054,72,4032,28
4280,9,398,3572,306,8770,92
2260,50,1476,3615,1116,15728,360
38219,17,371,1765,292,4698,79
4678,8,121,3557,88,3653,33
1110,5,223,3894,179,5006,44
6455,11,1050,3472,851,16557,199
7393,31,1198,3425,901,19017,297
1683,0,50,3660,41,1776,9
15208,7,383,2937,323,5076,60
2486,19,487,3611,415,8696,72
42219,91,1867,1369,1304,12689,563
28280,16,447,2290,346,8085,101
19708,8,467,2725,364,12629,103
17650,12,714,2817,552,6906,162
17604,11,623,2819,511,8427,112
36299,18,499,1885,374,9577,125
22503,177,15069,2570,12040,79575,3029
21851,24,1160,2605,969,25690,191
35525,11,476,1939,378,17823,98
5096,61,2140,3536,1733,9046,407
24598,6,288,2469,256,5917,32
27388,2,129,2341,105,3845,24
37896,1,196,1786,151,4456,45
27145,309,5999,2356,4549,35379,1450
6324,48,2320,3478,1797,15975,523
25844,82,2887,2415,2257,37802,630
39107,244,11700,1705,8983,85274,2717
12214,38,1180,3144,990,13491,190
43686,90,1837,981,1623,24811,214
3290,309,18542,3598,13339,88818,5203
12443,276,16979,3130,12189,79280,4790
45904,2,14,385,13,2402,1
20893,0,129,2659,104,8507,25
32205,6,80,2086,69,3137,11
32826,10,363,2059,300,3972,63
45305,62,573,592,449,4512,124
4218,3,104,3574,86,2235,18
29887,19,687,2205,487,5871,200
42608,0,0,1293,0,2096,0
20864,11,618,2662,505,8025,113
44360,143,2639,857,2160,21225,479
16928,15,1552,2855,1196,24600,356
25042,0,36,2451,30,1445,6
2587,21,762,3610,594,22649,168
5188,6,363,3531,290,8941,73
11331,19,577,3189,469,3017,108
24518,43,983,2474,747,7109,236
43780,5,115,952,97,5363,18
29541,5,164,2222,126,3840,38
41928,30,440,1425,321,9252,119
17224,83,3846,2837,2957,41606,889
25693,13,813,2421,648,5972,165
42983,22,404,1202,321,16591,83
33414,167,3450,2037,2298,17394,1152
17302,2,81,2833,53,9342,28
2144,71,3674,3617,2607,25694,1067
6557,11,159770,3467,59883,14917,99887
26339,35,693,2393,537,12633,156
27789,4,206,2317,152,4345,54
36783,3,116,1859,97,7481,19
36430,50,1237,1879,891,15633,346
24597,1,56,2469,44,2269,12
24470,0,347,2477,284,7164,63
34962,1,64,1971,52,2929,12
42155,176,3550,1384,2280,46485,1270
11544,116,13423,3176,6623,63614,6800
20485,60,3038,2684,2127,21484,911
39477,48,2162,1683,1492,22772,670
20210,3,194,2697,143,3936,51
41340,23,548,1520,437,7386,111
8164,20,307,3366,239,4092,68
37711,11,267,1800,212,9532,55
9809,187,13034,3266,8418,95094,4616
15898,8,307,2907,218,6237,89
33206,6,138,2044,113,2931,25
31772,18,400,2109,330,7232,70
6094,42,898,3486,680,21760,218
11608,13,607,3174,478,15391,129
3312,16,301,3597,248,5134,53
44332,5,80,862,52,4498,28
32892,35,831,2057,594,9828,237
13134,15,754,3089,542,7263,212
36062,31,1003,1898,787,66593,216
41440,12,716,1505,488,13913,228
37290,31,846,1827,648,8854,198
45994,11,99,343,87,2109,12
7557,263,121358,3415,47253,47106,74105
4363,88,9870,3568,7595,17007,2275
9962,146,8474,3259,6637,44851,1837
11095,6,246,3200,169,7502,77
18166,58,2826,2794,2285,14947,541
19822,592,26905,2718,19419,164672,7486
19574,5,319,2732,252,3651,67
2870,15,497,3605,418,5768,79
35884,11,572,1912,430,12442,142
20002,3,238,2708,176,2518,62
7433,6,462,3422,317,13366,145
37533,19,423,1811,346,13649,77
4479,108,5517,3564,3907,23241,1610
25273,3,303,2441,245,9026,58
13436,6,312,3061,271,10670,41
7896,5,126,3390,106,6398,20
29322,48,2265,2232,1624,18697,641
42140,89,1974,1387,1275,21885,699
44941,24,154,721,141,6319,13
30576,15,541,2168,445,11278,96
18357,8,555,2785,414,6796,141
2579,272,12882,3610,10029,72528,2853
24085,488,15160,2494,11493,56084,3667
5236,39,2452,3528,1885,14206,567
31271,17,619,2135,484,7283,135
22787,708,41565,2557,26426,243456,15139
26692,1,171,2377,148,5913,23
31415,10,857,2128,638,15901,219
43112,21,480,1163,348,10335,132
4126,1298,42206,3577,30050,151267,12156
17499,24,612,2824,441,9515,171
10162,132,5489,3250,3879,41020,1610
37241,13,432,1830,351,9999,81
45478,22,145,547,123,4443,22
13866,6,360,3028,270,10867,90
5881,88,4413,3496,2973,38795,1440
4893,79,2868,3547,2196,11914,672
6951,5,203,3449,139,3630,64
39275,6,199,1694,145,9342,54
37182,60,1044,1834,841,8593,203
7478,0,35,3420,31,3029,4
44946,86,880,719,751,11620,129
36478,20,801,1876,617,4994,184
34901,10,422,1974,349,9707,73
30615,13,625,2166,434,9176,191
10610,59,3562,3227,2864,41212,698
31195,2,122,2139,101,2243,21
45534,117,1742,530,1302,20936,440
38816,164,2716,1723,2125,25344,591
34696,3,99,1986,67,2233,32
43649,21,349,994,241,4291,108
9313,7,53,3295,42,4212,11
46249,52,759,244,595,7352,164
2811,59,1820,3606,1503,50127,317
15256,4041,440454,2935,289221,1458658,151233
4303,7,245,3571,204,7945,41
18030,0,62,2800,52,2931,10
17147,1013,42496,2842,29232,119090,13264
5708,48,1760,3504,1287,8044,473
17627,2,82,2817,61,4830,21
16103,16,1693,2896,1255,15403,438
11785,37,3798,3164,2963,34515,835
31032,1,32,2147,28,3161,4
36993,10,201,1846,162,2660,39
6088,2,45,3487,37,3115,8
23853,33,865,2505,636,8999,229
19267,38,2300,2747,1790,20012,510
45273,19,250,600,197,6515,53
17115,0,25,2844,19,2078,6
31791,20,459,2107,366,5216,93
30460,51,2427,2174,1994,21496,433
43256,6,161,1121,108,5422,53
46293,14,223,229,171,5047,52
20196,2,130,2698,94,2883,36
44884,5,63,738,55,3260,8
8535,8,378,3341,298,15006,80
38269,30,813,1761,648,9241,165
12277,6,580,3140,432,5425,148
21089,152,9518,2648,7051,53882,2467
21925,156,7084,2600,5017,59107,2067
2097,27361,1742557,3618,876876,4392937,865681
10801,84,1787,3216,1387,62582,400
20513,11,379,2682,341,3567,38
26641,20,629,2379,500,5810,129
13809,1,74,3033,57,3848,17
10244,2,187,3246,141,6316,46
20461,54,3790,2685,2804,17204,986
22229,400,26326,2583,18508,135008,7818
3463,15,263,3594,218,12348,45
28057,8,341,2302,243,4838,98
2049,111,1866,3619,1181,19024,685
28399,71,3847,2283,3045,34575,802
15642,32,2517,2917,1877,11284,640
42339,207,5018,1347,3559,81304,1459
38306,15,740,1759,575,9019,165
9864,4,80,3264,63,3389,17
12539,2,109,3126,86,2456,23
30226,0,33,2188,26,2410,7
44304,7,114,868,97,3709,17
11476,3,225,3181,175,8659,50
36920,11,1589,1850,1193,14028,396
26596,0,33,2381,28,1587,5
2181,5,142,3617,109,4670,33
5847,21,763,3497,623,6017,140
37495,2,225,1814,191,4001,34
34744,263,4801,1983,3639,22910,1162
7955,79,4459,3383,3531,90936,928
29493,1,109,2224,88,2621,21
27680,18,473,2324,401,10731,72
40514,6,277,1610,196,5900,81
33654,3,176,2028,146,5253,30
3606,63,6884,3592,4881,34197,2003
23193,4,197,2537,148,12333,49
38694,26,1365,1731,1026,14931,339
7332,65,1646,3428,1257,22813,389
7526,0,13,3417,11,2061,2
15334,57,2066,2931,1365,10082,701
12253,16,139,3141,108,2769,31
15696,2,233,2915,184,6147,49
1489,15,627,3711,506,9813,121
27901,16,525,2311,443,11421,82
14343,120,3498,2992,2630,19166,868
28745,88,4476,2262,3256,21287,1220
44966,6,103,713,65,3059,38
16898,2,99,2857,83,4250,16
19328,23,722,2744,536,15517,186
15444,6,163,2927,131,3061,32
33033,73,1094,2051,819,12073,275
39022,2,73,1711,56,1589,17
40608,8,123,1601,102,2742,21
7774,2,160,3401,119,4219,41
21821,32,1718,2606,1260,18566,458
16927,37,1175,2855,914,22381,261
46344,12,201,206,179,2677,22
7835,0,70,3396,45,2314,25
22522,7,170,2569,142,7395,28
39544,7,210,1680,176,4937,34
8847,18,450,3322,400,3425,50
45889,10,133,389,74,1622,59
11246,7,3300,3192,2460,18094,840
23391,1,98,2527,87,3592,11
18838,2,247,2765,193,3625,54
25470,17,453,2433,364,4903,89
6179,10,269,3484,219,4521,50
20658,10,1028,2675,562,9526,466
37267,11,365,1828,283,3085,82
2555,6,260,3610,194,3824,66
5981,3,49,3490,42,3081,7
29412,32,610,2228,474,5695,136
18879,10,395,2763,294,2930,101
41341,0,46,1520,31,3315,15
29350,4,117,2231,95,3216,22
18474,40,3178,2781,2293,49377,885
37733,0,127,1799,99,6884,28
38120,6,245,1771,203,4640,42
42909,84,1474,1222,1179,27714,295
36789,1,42,1858,34,2084,8
42196,39,574,1375,457,8369,117
13435,7,255,3061,199,6893,56
9633,4,66,3274,59,5598,7
29317,40,3694,2233,2615,25211,1079
22512,1,53,2569,31,3807,22
3310,20,1771,3597,1211,14202,560
28430,278,10370,2281,7678,65147,2692
31069,0,104,2146,80,4551,24
37622,3,272,1805,214,7735,58
40228,107,2196,1636,1647,14570,549
43668,4,117,988,88,4002,29
24848,123,8974,2459,6235,52249,2739
32775,184,19441,2062,14040,86387,5401
37945,4,119,1783,97,9036,22
37631,10,417,1805,323,17490,94
39420,112,1500,1686,1194,16137,306
12391,5,90,3134,77,3972,13
38298,15,436,1759,348,12928,88
38954,1,81,1715,61,3725,20
28381,6,324,2284,270,6846,54
3663,0,30,3590,24,1851,6
10581,5,338,3229,269,5068,69
27911,4,414,2310,258,3752,156
4707,3,26,3556,21,2103,5
30313,90,2407,2183,1748,15629,659
35576,81,2269,1935,1627,17091,642
43045,27,346,1183,278,10922,68
5723,24,287,3503,219,7153,68
30162,37,1611,2193,1162,8452,449
33785,2,80,2022,67,3166,13
6988,5,161,3447,123,3244,38
5472,17,647,3517,503,19230,144
8132,8,267,3368,181,11840,86
20457,49,3356,2685,2579,22911,777
24076,1,154,2495,132,8290,22
34636,14,594,1989,488,7995,106
24070,28,1360,2495,1060,14574,300
35961,65,1114,1906,839,9850,275
28121,12,597,2299,488,8587,109
25965,1,158,2409,134,6218,24
38476,2,189,1747,151,6913,38
7479,3,111,3420,98,4732,13
17003,106,4977,2851,3724,29707,1253
22254,636,104790,2582,69253,288484,35537
11552,2,155,3176,118,2662,37
43134,72,2257,1157,1639,18608,618
1628,2,85,3675,77,3853,8
3419,66,2630,3595,2061,51769,569
2508,74,2702,3611,2157,17366,545
29466,4,266,2225,191,4403,75
36035,20,1247,1901,964,13741,283
24958,32,922,2454,755,5485,167
28669,4,204,2267,183,6983,21
28513,1,34,2276,29,2727,5
34754,3,101,1983,84,3441,17
38477,24,364,1747,309,3199,55
39979,130,7386,1652,5011,53306,2375
11813,2,58,3164,52,2616,6
11788,155,5642,3164,4395,68175,1247
34451,5,171,1999,135,4719,36
5720,79,2716,3503,2158,20199,558
20030,25,684,2707,522,3336,162
35034,10,282,1967,218,5200,64
38448,6,276,1748,219,5218,57
24475,216,10596,2476,7936,69870,2660
27566,0,152,2330,139,1445,13
38010,4,280,1780,235,9206,45
5619,22,373,3509,298,15512,75
40429,11,237,1618,175,5598,62
36675,6,209,1865,163,11316,46
32453,19,1417,2076,1089,13626,328
32983,4,247,2053,212,8280,35
18661,3,429,2772,190,3402,239
45927,220,3480,371,2579,15480,901
26471,1,95,2387,82,5130,13
24707,56,1833,2464,1394,20192,439
6373,10,223,3475,169,3324,54
2252,7,615,3616,516,15846,99
8764,2,170,3327,123,7032,47
5493,32,603,3516,483,11680,120
14065,642,42544,3011,31217,224833,11327
8729,1,259,3329,220,7561,39
16142,54,1466,2895,1180,12480,286
14113,2,172,3008,114,4429,58
40875,0,49,1577,32,3531,17
20469,0,142,2685,100,6072,42
4341,43,807,3569,610,13459,197
21129,6,258,2646,199,10813,59
20541,1,147,2681,124,4080,23
33280,43,1511,2042,1209,8893,302
26335,1,35,2393,29,1906,6
39059,12,277,1708,234,5498,43
18237,58,4401,2791,3226,32293,1175
37549,27,633,1810,444,14865,189
12454,47,1677,3129,1237,17664,440
22039,0,1544,2593,1106,33591,438
17036,33,2347,2849,1747,29229,600
37581,11,317,1808,228,14435,89
40982,21,791,1569,599,9252,192
31797,25,566,2107,440,8558,126
45938,5,52,363,35,2188,17
20071,20,807,2705,645,8685,162
40152,3,197,1642,142,3587,55
15213,8,181,2937,151,8487,30
31854,35,2622,2104,1901,38050,721
5033,17,379,3540,294,6524,85
5953,6,180,3491,133,5016,47
15939,98,2218,2905,1686,10041,532
25230,0,1174,2443,955,10889,219
38583,14,331,1739,245,3007,86
17968,7,158,2803,125,3349,33
12461,11,718,3129,564,6094,154
20250,4,370,2694,287,9579,83
40597,5,429,1603,328,10660,101
28597,74,2336,2270,1769,14300,567
44665,1,32,807,25,1057,7
45844,6,76,406,50,2407,26
32390,32,670,2078,543,10354,127
14442,1252,109732,2985,70360,299050,39372
7006,70,1998,3446,1529,38846,469
31364,7,122,2131,105,3753,17
2058,21,332,3619,287,5339,45
11744,129,7629,3167,5606,68718,2023
18418,64,5258,2783,3250,34182,2008
45753,2,103,437,56,2641,47
19270,14,1180,2747,644,5919,536
14712,39,1345,2966,1012,9440,333
3927,64,3022,3584,2259,18019,763
32930,1,78,2055,65,3134,13
13219,8,215,3077,159,2976,56
1103,6,251,3896,211,7152,40
7866,20,597,3393,460,10609,137
10027,16,843,3256,568,16913,275
31873,9,274,2104,219,4001,55
36529,1,27,1874,23,1832,4
27357,96,13633,2344,10171,58460,3462
44038,9,284,910,187,4726,97
6392,4,218,3475,152,9600,66
34375,3,452,2002,349,15715,103
43582,3,34,1019,31,2573,3
11417,99,5966,3185,4439,81286,1527
18435,8,663,2782,404,4945,259
21365,118,3987,2631,2896,23339,1091
15356,37,3992,2930,3016,25156,976
45951,29,356,359,306,5219,50
11895,46,3686,3160,2783,14471,903
44925,36,284,726,221,4156,63
38157,58,2207,1769,1557,18345,650
6685,1,84,3462,76,1867,8
20118,2,196,2703,153,4039,43
11129,47,3707,3199,2896,25621,811
32559,18,889,2071,691,9375,198
21578,26,887,2619,714,11492,173
35275,6,165,1954,134,3618,31
29147,2,197,2242,172,4651,25
12416,11,1702,3131,1237,15517,465
41878,17,169,1433,136,2812,33
36152,116,2130,1892,1647,12952,483
36316,29,1606,1884,1308,22230,298
30521,211,5203,2170,3944,46887,1259
18000,111,2817,2801,2167,10451,650
3573,105,8948,3592,6612,90089,2336
32222,86,2190,2085,1618,15912,572
43771,151,2777,955,2282,54879,495
14084,21,1244,3009,968,16355,276
1228,29,863,3859,708,8600,155
2404,23,1219,3613,935,20125,284
31751,22,1900,2109,1340,16408,560
19862,34,995,2716,733,9905,262
32281,46,1003,2083,669,11682,334
20904,5,217,2658,179,4894,38
3008,3,77,3603,33,4802,44
41474,47,802,1500,560,5508,242
16603,6,141,2873,104,4009,37
5927,3,38,3493,32,2591,6
45427,71,945,559,771,19097,174
23641,18,484,2515,375,7668,109
16988,355,35740,2852,23100,147907,12640
4727,501,12621,3555,9407,51153,3214
44733,13,343,784,233,5755,110
3187,114,3736,3599,2918,81027,818
18362,7,303,2785,244,5229,59
10928,220,13166,3209,9786,69680,3380
17896,28,1580,2808,1183,24291,397
13110,15,1606,3091,1208,10523,398
39978,15,619,1652,467,11731,152
5389,4,155,3520,133,11086,22
43641,4,107,996,73,3727,34
24718,0,39,2464,36,3198,3
4569,18,2725,3561,2091,20048,634
9970,58,4303,3259,3217,58115,1086
36266,1,38,1886,29,8093,9
22868,2,80,2552,69,4183,11
12641,337,17808,3120,12790,155927,5018
3027,1864,101673,3602,64015,503137,37658
13290,46,1974,3073,1558,20340,416
3992,16,356,3581,216,9782,140
10509,8,98,3233,86,4172,12
39268,12,158,1694,117,2922,41
20896,232,20098,2659,14716,126881,5382
14987,3,232,2950,178,8985,54
35892,98,5142,1911,3884,42540,1258
2930,29,1256,3604,1013,12700,243
8625,2,19,3336,14,1253,5
22303,2,33,2580,28,1834,5
26411,2,132,2389,85,3690,47
45123,187,2630,646,1611,12840,1019
17045,3,122,2848,105,11655,17
14016,16,319,3014,268,4512,51
29849,2,117,2207,93,4132,24
45891,3,40,389,30,1530,10
21053,2,75,2650,67,5154,8
31438,0,47,2127,41,1842,6
20687,9,189,2673,146,5551,43
27394,163,6003,2341,4471,39477,1532
42991,61,1326,1199,984,13942,342
38301,226,5357,1759,4049,34819,1308
32681,19,611,2066,499,7158,112
24704,1,47,2464,35,4183,12
11868,21,823,3162,521,16062,302
22329,50,1677,2579,1382,10380,295
6693,3,45,3462,39,3056,6
2034,18,792,3619,564,8844,228
33064,130,3015,2050,2382,17057,633
38584,46,1466,1739,1210,10091,256
29712,7,137,2214,114,6411,23
15963,8,487,2904,416,8614,71
43105,15,231,1165,164,2734,67
9350,7,237,3292,203,9465,34
6469,11,354,3471,294,7934,60
12121,195,7098,3149,5660,81021,1438
24153,6,168,2491,136,2493,32
18729,0,37,2770,34,3826,3
32658,68,2891,2067,2239,23409,652
25654,0,392,2423,299,4311,93
29611,6,130,2219,96,3609,34
6510,14,417,3469,327,6616,90
40807,17,798,1583,572,10468,226
7742,13,233,3404,183,10806,50
35309,1,160,1952,135,4656,25
41432,4,165,1506,134,4674,31
7157,3,253710,3437,74231,5973,179479
8056,2,53,3371,44,2826,9
10799,11,1054,3216,828,9513,226
15245,1151,78937,2936,53839,194687,25098
34640,1,64,1988,51,5101,13
31036,115,1611,2147,1269,10833,342
46203,3,51,255,35,789,16
41656,27,959,1474,685,20071,274
2920,110,4402,3604,3504,76061,898
31238,124,3574,2137,2910,12926,664
36746,5,140,1861,119,4401,21
35840,3,99,1915,74,3355,25
3759,7,222,3588,187,9865,35
31386,1,86,2130,69,3419,17
17191,50,5581,2839,3767,21659,1814
20240,89,1745,2694,1354,8916,391
3089,0,30,3601,28,2673,2
41490,8,187,1498,139,5831,48
15412,6445,344495,2929,231909,1042700,112586
18732,6,375,2770,237,4272,138
18075,12,460,2798,382,3532,78
8986,4,104,3315,91,1556,13
1856,10,140,3623,114,7312,26
41135,10,111,1551,88,4546,23
24679,0,1050,2466,837,9057,213
29916,287,18145,2203,12690,67203,5455
6652,8,133,3464,104,4255,29
18072,532,23376,2798,17231,97390,6145
37708,7,234,1801,207,3344,27
41262,3,208,1532,150,10441,58
16300,4,138,2888,112,3898,26
46360,71,995,202,880,10094,115
7941,11,528,3385,361,8870,167
34174,1,60,2010,48,2360,12
34552,16,314,1994,236,5090,78
42964,20,532,1208,371,18173,161
26891,6,557,2367,486,6664,71
12293,33,902,3140,709,8968,193
12876,36,2052,3106,1693,24137,359
37777,8,269,1795,211,13407,58
46143,1,107,278,97,2858,10
42542,4,79,1305,55,2819,24
38043,47,1417,1777,1012,23491,405
22747,4,359,2559,276,12310,83
39189,42,910,1700,688,10073,222
17537,11,508,2822,414,5074,94
42320,161,7913,1351,5708,43196,2205
2723,48,2829,3608,2015,37190,814
19010,6,433,2759,370,11579,63
24182,13,291,2490,220,7035,71
19301,36,959,2745,751,9106,208
18798,3,69,2767,60,4632,9
18908,28,1683,2762,1252,21012,431
5335,9,72,3523,65,2510,7
2142,12,380,3617,318,12448,62
27872,42,959,2314,574,9983,385
24201,8,155,2489,137,5182,18
21241,6,302,2637,250,7339,52
10101,1,75,3252,63,4054,12
5091,39,1072,3537,846,28798,226
32178,2,116,2087,93,5359,23
20922,20,452,2657,359,3005,93
21264,8,435,2636,365,4304,70
40266,43,1735,1633,1326,20528,409
43911,20,688,931,472,8499,216
32808,41,872,2060,655,10928,217
39933,62,2137,1655,1654,27553,483
21487,15,425,2625,352,3951,73
5215,23,576,3529,479,12262,97
10645,37,1059,3225,812,8518,247
40089,1,174,1645,96,6833,78
30989,4,445,2150,389,14438,56
31874,0,138,2104,116,2948,22
4322,38,868,3570,687,18965,181
13817,23,421,3032,318,5416,103
45811,2,64,418,50,1341,14
5067,184,4526,3538,3071,29878,1455
8744,177,5990,3329,4435,76700,1555
42161,3,149,1382,104,11773,45
12295,57,1649,3140,1244,20719,405
43374,13,216,1083,173,6332,43
12089,0,0,3151,0,2606,0
35882,17,448,1912,351,7418,97
13872,8,924,3028,672,8856,252
33849,19,576,2020,467,7011,109
10686,2,66,3222,51,3096,15
23482,1,34,2522,30,4295,4
7936,3,99,3386,82,2865,17
17213,10,302,2838,236,5511,66
32941,20,571,2055,474,9141,97
38189,11,262,1767,192,6519,70
16140,9,467,2895,366,6586,101
8748,10,544,3328,461,5394,83
1819,92,2553,3625,1993,21659,560
5447,8,273,3517,200,4316,73
1222,4,90,3860,81,4012,9
6608,19,435,3465,324,3410,111
13040,7,506,3096,397,11171,109
12145,53,1084,3147,843,13805,241
37331,0,35,1825,28,1809,7
25648,23,687,2423,498,10460,189
43677,15,307,985,250,9622,57
25427,0,798,2435,600,11009,198
8242,5,117,3361,108,4384,9
36589,1,63,1870,53,6103,10
11982,7,167,3156,136,3799,31
32853,3,216,2058,178,5735,38
46208,1,47,253,30,633,17
43002,16,349,1195,206,5916,143
31735,11,234,2110,165,5150,69
8253,0,34,3360,32,2733,2
38034,1,58,1778,47,4479,11
42422,10,329,1330,218,8856,111
31646,17,702,2115,539,16666,163
42419,3,146,1330,105,7379,41
6186,35,1533,3484,1092,15474,441
37524,0,75,1812,50,5129,25
39016,6,200,1711,154,3662,46
38251,226,3323,1762,2340,21023,983
14333,37,887,2993,722,6609,165
10334,103,1972,3242,1510,33131,462
46407,35,338,175,322,4433,16
23691,10,229,2512,163,5168,66
41274,5,347,1529,239,6841,108
12589,2,58,3123,52,3965,6
42954,14,219,1210,150,4085,69
43732,13,100,967,84,2522,16
41476,8,146,1500,109,5285,37
3061,48,956,3602,689,11875,267
42241,1,27,1365,24,3089,3
27561,0,104,2331,80,7085,24
6315,11,143,3478,125,9525,18
8251,10,519,3361,423,6102,96
15280,4,1289,2934,873,15899,416
13441,10,597,3060,486,6657,111
33044,1366,103014,2051,68714,282020,34300
4329,13,547,3570,446,28638,101
24962,10,409,2454,305,3896,104
6250,6,388,3481,304,6484,84
30196,1,123,2190,106,8350,17
45499,0,93,542,62,1355,31
25208,61,2121,2443,1587,25189,534
46107,1,9,295,7,971,2
18979,85,2339,2760,1752,11338,587
35719,2,94,1923,79,3488,15
42569,7,203,1301,146,4326,57
16995,14,489,2852,360,5731,129
39997,22,688,1651,522,12623,166
38315,15,521,1758,417,7446,104
20058,112,12713,2706,8739,39191,3974
36575,27,310,1871,262,4032,48
16168,20,725,2894,541,8416,184
41995,165,4903,1415,3233,40969,1670
10054,450,25391,3255,18969,131858,6422
45715,4,161,452,103,2916,58
45761,25,297,433,242,4253,55
14939,277,16255,2952,11728,95970,4527
17751,3,377,2813,287,5156,90
41191,0,7,1544,6,988,1
46410,12,281,174,223,3017,58
25888,1,37,2413,33,2819,4
23937,1,173,2501,135,3905,38
38140,2,47,1770,33,3283,14
13208,685,34942,3078,24941,351533,10001
40027,11,439,1649,329,10617,110
26050,4,72,2406,60,1782,12
3601,5,330,3592,254,5796,76
32243,14,448,2084,282,5388,166
36682,23,603,1865,471,6396,132
18863,15,542,2764,436,5034,106
46194,0,10,258,6,999,4
36080,47,1671,1897,1206,19019,465
45442,11,157,555,124,3348,33
21629,34,1190,2616,981,12110,209
4137,26,1105,3577,832,20214,273
31882,192,6132,2103,4159,22552,1973
42919,22,406,1219,253,4565,153
37163,9,402,1835,334,8245,68
20447,0,56,2685,50,2372,6
22401,628,30773,2576,21891,137608,8882
44679,44,443,802,358,5516,85
14223,11,542,3002,418,8502,124
33273,526,31666,2042,21565,170931,10101
12153,1,239,3147,172,6580,67
15276,3,49,2934,41,4662,8
19265,78,3403,2747,2590,22701,813
13580,39,1685,3050,1384,33134,301
32160,30,2239,2088,1812,23013,427
14854,5,388,2957,308,8577,80
5211,31,732,3529,537,7980,195
12495,4,88,3127,59,2717,29
36771,12,643,1860,492,13562,151
34153,198,7814,2011,5772,69339,2042
40761,209,4644,1588,3590,51067,1054
45441,55,568,557,429,6020,139
24936,1700,100601,2455,75807,1000106,24794
17150,194,11246,2841,8271,46938,2975
42902,218,4308,1224,3396,39195,912
7423,58,1626,3423,1224,39145,402
26228,24,1182,2398,947,14098,235
37449,53,1171,1817,951,13516,220
34163,0,0,2010,0,2447,0
41527,48,1268,1494,920,10009,348
38182,4,46,1768,39,2112,7
19537,0,76,2734,53,3849,23
25425,98,4818,2435,3531,66497,1287
3017,14,705,3602,567,8943,138
8831,4,76,3323,66,1770,10
8344,94,1980,3354,1569,14130,411
14001,20,597,3016,444,8671,153
5726,17,976,3503,747,8073,229
38141,182,4674,1770,3795,34288,879
8586,12,516,3338,391,7470,125
11185,31,1107,3195,888,12025,219
15698,9,556,2915,439,9830,117
8735,7,184,3329,128,3449,56
46211,3,25,252,20,664,5
8366,166,9443,3353,7252,54192,2191
32752,0,0,2063,0,19123,0
26625,44,1697,2380,1296,13293,401
18206,86,5604,2793,4159,31348,1445
19240,106,4125,2749,3142,27210,983
35177,3,186,1959,142,13908,44
29132,6,535,2243,378,6569,157
23178,351,31389,2538,20732,106817,10657
9182,12,24,3302,21,2626,3
2469,24,389,3612,312,4945,77
3345,701,39737,3597,29260,116708,10477
2574,14,377,3610,276,7043,101
36891,2,89,1852,70,2052,19
37450,13,351,1817,275,6027,76
34394,3,178,2001,148,7724,30
45197,335,4408,624,3811,33825,597
11605,10,498,3174,422,12437,76
15206,19,1289,2938,947,17339,342
37220,3,274,1831,192,3506,82
23093,1,70,2541,61,2019,9
19497,7,508,2735,391,7209,117
13740,6,272,3037,208,10285,64
15985,10,500,2903,385,14446,115
41922,108,2753,1426,1935,31757,818
25755,5,104,2419,79,3741,25
9094,18,480,3308,373,37372,107
46144,9,135,278,110,2991,25
3728,14,571,3589,483,7238,88
28194,4,297,2294,243,10050,54
22412,503,22072,2575,14973,113969,7099
15800,7,585,2910,467,7595,118
14303,7,790,2996,701,22065,89
31173,23,1712,2140,1390,10850,322
7680,18,546,3407,437,6420,109
33927,0,62,2018,50,2090,12
18622,3,184,2774,136,7511,48
9179,0,135,3302,105,4256,30
6089,8,241,3487,174,5938,67
7988,59,4367,3380,3317,31943,1050
3839,7,185,3586,123,7657,62
42763,10,397,1258,274,8735,123
45043,727,12876,688,9730,84300,3146
33146,0,21,2046,18,2301,3
18390,464,61485,2784,35684,321747,25801
17318,15,769,2833,578,18676,191
34595,1,260,1992,210,5688,50
40130,198,4767,1643,3616,36227,1151
27636,55,2757,2327,2000,18503,757
42366,12,615,1342,391,11686,224
37600,2,73,1807,61,6568,12
24247,4,485,2487,394,9412,91
29152,19,1202,2242,930,18092,272
34790,8,1546,1980,995,10736,551
46350,25,495,206,441,3755,54
30884,15,418,2154,302,3705,116
21146,15,691,2644,535,9083,156
7914,153,7205,3388,5092,29973,2113
45126,117,965,644,837,8476,128
33048,2,32,2050,27,3373,5
38154,14,233,1769,199,5050,34
17889,10,757,2808,572,12216,185
17203,7,774,2839,554,25273,220
42920,4,28,1219,24,3871,4
27926,41,970,2310,823,8949,147
3143,7,102,3600,83,7409,19
32289,6,130,2083,109,4879,21
3796,1,32,3588,24,3177,8
12288,2,103,3140,76,3722,27
6546,12,440,3468,384,11037,56
11792,1,85,3164,62,4881,23
31130,67,2070,2143,1584,17388,486
22054,4,237,2593,192,8821,45
2376,75,3188,3613,2377,49534,811
36989,8,260,1846,215,5776,45
946,20,966,3948,802,6643,164
39432,16,432,1686,316,6624,116
7313,3,108,3429,94,5680,14
38107,2,64,1772,53,8073,11
42877,11,206,1231,171,6472,35
15317,609,30417,2932,20479,92914,9938
3052,31,933,3602,723,8111,210
17400,88,4189,2828,2969,38106,1220
38745,4,151,1728,118,8685,33
2446,379,14581,3612,10791,172402,3790
20919,4,171,2658,143,5165,28
16830,6,162,2860,131,2686,31
5636,5,376,3508,301,10937,75
29035,102,4737,2248,3525,25672,1212
10980,178,13063,3207,10057,47025,3006
6122,10,411,3486,334,11441,77
8350,28,485,3353,389,8696,96
11638,34,2386,3172,1948,18296,438
17597,197,10443,2819,7544,64836,2899
43360,127,2324,1091,1926,27691,398
9402,2,142,3288,113,5295,29
9942,11,433,3261,330,4105,103
11432,18,388,3183,343,12017,45
39282,81,1297,1693,946,8873,351
16447,58,2575,2880,2094,21632,481
37561,10,467,1810,384,7329,83
31077,1,138,2145,123,5391,15
4988,103,4162,3543,3084,13979,1078
6796,13,647,3457,512,13269,135
43096,6,134,1167,92,3182,42
4100,3,80,3578,65,2334,15
10730,25,797,3220,622,3877,175
32580,3,192,2070,169,4037,23
17529,3,107,2822,90,3506,17
36119,39,554,1894,443,5953,111
42441,39,503,1326,364,7983,139
22074,259,11933,2591,8030,78135,3903
10679,14,506,3223,401,8585,105
13358,52,3087,3067,2314,63093,773
4660,61,1456,3557,1108,19660,348
20031,6,67,2707,59,2660,8
45758,8,100,434,89,1573,11
26298,0,143,2395,118,3233,25
15648,173,15188,2917,10966,36712,4222
7697,9,218,3406,146,5800,72
4940,84,5150,3545,3882,32510,1268
37670,6,181,1803,156,4280,25
27862,8,641,2314,482,19917,159
2233,0,70,3616,63,6963,7
42723,254,11022,1268,7558,63138,3464
23183,4,483,2538,378,12287,105
20540,11,358,2681,263,2034,95
39604,10,464,1675,377,6770,87
11460,56,1664,3181,1279,10546,385
14991,18,346,2949,279,5142,67
21405,3,323,2629,245,2598,78
42312,14,198,1352,141,4359,57
35274,10,124,1954,109,4260,15
43078,25,637,1173,450,7727,187
11397,4,117,3185,90,2547,27
15384,9,260,2930,202,5289,58
14422,8,330,2986,258,5076,72
15343,85,5717,2931,4669,59972,1048
37102,16,653,1839,486,14641,167
35370,18,1075,1950,852,10973,223
5337,101,2506,3523,1932,81580,574
7819,7043,451578,3398,272223,1222823,179355
37470,10,261,1816,196,4485,65
44511,65,860,838,700,10131,160
44986,81,1317,708,1006,11642,311
23993,5,428,2498,327,8066,101
16240,19,889,2891,626,7670,263
41936,0,35,1424,30,6145,5
28987,25,1392,2251,1052,9581,340
20219,10,255,2696,208,12727,47
13013,182,8718,3098,6785,112389,1933
41889,30,364,1431,286,8711,78
5419,3,66,3519,55,1989,11
37455,0,52,1817,43,4225,9
23087,6,500,2542,376,7996,124
24461,4,121,2477,87,6953,34
46059,15,117,310,95,2154,22
42648,187,3295,1285,2481,14632,814
38844,95,4476,1722,3717,30317,759
35228,3,87,1957,75,1814,12
42639,6,69,1288,52,5192,17
43350,10,377,1094,283,7952,94
45183,245,1651,629,1394,17026,257
24708,26,1343,2464,972,11394,371
3703,34,1318,3589,1042,25906,276
11538,1,80,3177,64,2713,16
28697,4,131,2265,69,2858,62
46316,4,84,216,69,3145,15
9342,1,99,3292,75,2887,24
5578,68,3440,3511,2653,48829,787
10760,39,712,3218,532,3723,180
1912,38,668,3622,525,7470,143
11848,375,28041,3163,18142,129104,9899
34550,14,281,1994,214,4181,67
10330,92,3027,3242,2362,22083,665
19722,13,1039,2724,842,7489,197
40542,0,4421,1607,3241,30726,1180
16949,5,197,2854,173,5402,24
29595,35,1417,2220,1104,29353,313
45790,16,208,424,154,4389,54
30494,6,215,2172,175,4110,40
2068,13,323,3618,282,6445,41
40166,55,1512,1641,1133,19250,379
30371,28,1743,2180,1176,28755,567
42780,1433,28420,1253,22981,317610,5439
26213,0,692,2398,549,18081,143
34567,2,72,1993,61,6086,11
8179,5,85,3365,78,7215,7
35141,3,101,1961,82,4674,19
3407,12,643,3595,510,4131,133
8671,41,2072,3333,1515,37768,557
32972,3,171,2054,147,5072,24
20967,3,77,2655,63,1844,14
15048,3,119,2946,97,4453,22
41290,4,90,1526,65,2740,25
11059,66,4398,3203,3443,59697,955
29662,4,198,2216,162,7227,36
23633,105,1929,2515,1414,19605,515
43032,51,561,1188,508,5420,53
25177,11,599,2445,467,8772,132
11772,7,229,3165,192,5209,37
5988,4,55,3490,48,2797,7
36833,26,667,1855,490,10405,177
32035,10,287,2096,210,14489,77
26273,1,56,2396,49,2031,7
3905,9,446,3584,330,12916,116
7141,79,1151,3438,955,24173,196
42750,17,568,1261,386,6815,182
39728,6,129,1669,116,3483,13
22269,85,2327,2581,1908,12194,419
10430,43,889,3238,680,13363,209
30784,0,40,2158,32,2731,8
22342,72,3013,2578,2227,34119,786
45858,113,2776,374,2235,15131,541
38709,305,9151,1730,6350,43395,2801
34402,98,2646,2001,1951,13067,695
16640,857,28129,2871,18874,68149,9255
3306,113,3337,3597,2438,40215,899
32319,0,39,2081,37,2079,2
23886,3,118,2504,96,3841,22
16554,53,1808,2875,1521,18614,287
37153,119,2988,1836,2389,24130,599
25135,44,1003,2446,726,14084,277
36469,1,212,1877,177,6621,35
3289,38,1192,3598,915,40902,277
31969,2,136,2099,123,3389,13
41841,3,97,1439,80,4064,17
38827,0,11,1723,9,1697,2
23114,69,2556,2540,1741,17739,815
3675,1,112,3590,84,1826,28
19942,17,688,2712,564,4547,124
29569,630,16982,2221,11828,87186,5154
38807,0,625,1724,495,14449,130
16421,4,556,2881,441,4481,115
7040,1,74,3443,66,2165,8
10442,3,155,3237,121,6370,34
40653,26,428,1599,340,6828,88
22236,37,1301,2583,1081,12764,220
35173,0,81,1960,73,3002,8
26211,4,139,2398,99,4941,40
16415,36,1372,2881,1031,10988,341
33248,733,12351,2043,8639,43977,3712
27313,0,48,2347,38,1749,10
41768,2,89,1454,78,2195,11
5153,46,2371,3533,1832,24915,539
41414,10,222,1509,169,2669,53
8727,4,163,3329,134,4417,29
32651,104,3587,2067,2466,16592,1121
6388,2,82,3475,69,2508,13
17339,59,1358,2832,990,7257,368
29658,0,10,2216,9,1809,1
9116,4,172,3307,113,2357,59
26585,72,2684,2381,1927,11979,757
4166,20,524,3576,428,10719,96
40104,1,33,1644,23,3667,10
3829,1,23,3587,17,2124,6
28608,122,4282,2269,3305,26985,977
13132,15,377,3090,283,4674,94
14827,11,280,2958,214,19133,66
32348,0,41,2079,32,2442,9
22297,21,774,2580,644,7289,130
5638,32,1358,3508,962,21443,396
22634,20,823,2565,586,21155,237
34860,12,636,1976,500,11206,136
15105,8,756,2943,593,15966,163
29386,103,3694,2229,2793,21320,901
3509,11,436,3593,340,19129,96
19721,3,150,2724,124,5456,26
39942,11,77,1654,57,4140,20
37658,7,160,1804,119,6222,41
5710,1,46,3504,37,8169,9
33626,868,37266,2029,26869,206139,10397
41857,4,99,1437,85,2803,14
13778,30,895,3035,696,9802,199
41458,46,2350,1503,1640,24820,710
6240,5,176,3482,151,4281,25
9389,22,618,3289,456,21385,162
45900,13,232,387,205,6089,27
21119,26,1134,2646,782,12658,352
28919,11,132,2254,112,2355,20
43070,38,1404,1176,958,23895,446
30863,4,106,2154,63,3350,43
39720,234,4976,1669,3744,19834,1232
14639,44,1817,2971,1391,15180,426
26907,8,210,2366,168,8382,42
26457,76,882,2387,709,5794,173
28119,1,97,2300,86,2291,11
8085,46,1102,3370,866,22698,236
28046,9,436,2303,355,8305,81
10017,80,3244,3257,2525,46372,719
40659,177,5410,1598,3961,51701,1449
42079,31,1107,1399,853,19006,254
36601,224,7075,1869,5477,42185,1598
39122,3,265,1704,196,6428,69
12018,92,2780,3154,2242,43097,538
1073,6,116,3906,102,4427,14
32673,19,779,2066,600,11949,179
5989,14,150,3490,125,5104,25
9610,12,438,3275,334,11163,104
6177,13,675,3484,580,44561,95
3273,144,7762,3598,5395,98258,2367
16718,63,2621,2867,2115,18792,506
38381,0,71,1753,56,4706,15
25596,5,182,2426,144,4375,38
20757,6,189,2669,146,10366,43
12182,69,4000,3145,3003,71885,997
10353,24,1689,3241,1246,18358,443
21403,25,2319,2629,1817,17003,502
34947,20,502,1971,414,9681,88
38217,3,126,1765,100,4061,26
16747,196,4974,2865,3716,19279,1258
10036,13,320,3256,249,6591,71
42618,6,201,1291,161,5592,40
10414,4,178,3238,137,13906,41
40977,4,140,1569,96,2618,44
35565,21,1469,1937,1074,8055,395
31812,1,156,2106,112,4105,44
32494,28,616,2074,483,8103,133
3496,6,234,3594,192,4653,42
11085,2,84,3201,54,4517,30
1886,112,2634,3623,1603,21585,1031
41731,47,1522,1462,1131,18609,391
1678,0,37,3661,34,1668,3
31200,2,32,2139,30,1808,2
26301,25,1636,2394,1337,14745,299
23570,93,12987,2518,8479,46099,4508
14765,75,4745,2963,3768,19199,977
20190,17,527,2698,420,7973,107
32048,50,1204,2094,905,8704,299
25642,213,20960,2424,16822,67876,4138
1882,137,3932,3623,3208,36792,724
15011,114,9961,2948,7563,50537,2398
36055,118,2876,1899,2079,41608,797
41856,7,204,1437,157,7999,47
33723,1,207,2025,166,3425,41
40264,64,2757,1634,1928,29897,829
2755,119,4182,3607,3290,35310,892
22866,12,390,2553,317,6216,73
26570,4,308,2382,239,9092,69
24302,19,524,2484,409,5931,115
28011,2,52,2305,45,4113,7
13296,33,1281,3072,1042,12393,239
5186,43,300,3531,246,20680,54
43820,9,111,944,93,4574,18
6475,15,514,3471,449,8867,65
5643,2344,137938,3507,91401,512959,46537
44994,1,26,705,17,3338,9
15251,461,19449,2935,13105,109893,6344
34313,16,261,2005,196,3273,65
13859,5,405,3029,308,12731,97
17713,4,350,2815,271,4043,79
18315,8,296,2787,245,5378,51
3940,27,812,3584,646,24469,166
43224,430,8984,1132,6425,48165,2559
21292,4068,270768,2635,186817,515502,83951
44089,289,14050,892,9351,64102,4699
40635,19,344,1600,273,5779,71
38783,12,126,1725,105,3976,21
46156,89,2271,272,1631,24035,640
23842,1,34,2506,22,3703,12
41035,18,531,1565,382,14668,149
43151,12,286,1151,203,7218,83
43059,29,464,1179,326,7822,138
15445,0,92,2927,76,1658,16
34257,67,2410,2007,1818,30241,592
42323,27,1286,1350,910,14690,376
34020,5,237,2014,180,5171,57
4654,117,6645,3558,4638,22452,2007
32412,2,64,2077,48,2149,16
12914,50,2483,3104,1903,31593,580
7017,1,89,3445,73,4885,16
16481,6,420,2879,324,4153,96
37920,5,72,1784,56,2859,16
35784,7,304,1919,229,6654,75
6908,16,159,3452,133,4552,26
10061,11,240,3254,184,5419,56
21030,12,213,2651,167,3849,46
27077,8,1169,2361,940,11643,229
18951,16,331,2761,267,6102,64
40537,45,1258,1608,987,27496,271
20779,53,830,2667,593,5997,237
12225,1,137,3144,106,4505,31
2332,16,1162,3614,939,18515,223
38975,5,111,1714,85,5701,26
23236,28,1132,2535,877,12923,255
19590,5,209,2731,160,7858,49
21069,21,867,2649,680,9424,187
7727,7,221,3405,176,9341,45
21730,31,2894,2611,2101,15951,793
5984,30,2358,3490,1897,23911,461
7133,3,82,3439,55,1935,27
4532,12,1218,3563,533,5588,685
11965,20,376,3157,282,3697,94
40604,4,91,1602,74,1968,17
4574,202,8326,3560,5969,32772,2357
29473,10,253,2225,213,3984,40
30147,25,349,2193,277,3132,72
44095,61,2735,892,2003,11837,732
36652,35,605,1866,478,7748,127
16220,105,8562,2892,5803,49302,2759
28817,43,1118,2259,858,18014,260
15377,9,375,2930,332,4487,43
27752,91,3907,2320,2917,12778,990
3999,4,95,3581,78,5149,17
44819,6,87,755,73,2688,14
23254,317,14644,2534,10716,71284,3928
10510,2917,211603,3233,113481,551124,98122
35391,51,454,1949,365,5800,89
41585,328,4400,1485,3379,28749,1021
35158,110,5541,1960,4167,74669,1374
31896,4,159,2103,134,3682,25
22820,49,1555,2555,1131,5610,424
22918,39,652,2550,503,7700,149
3106,7,267,3601,215,5257,52
18983,4,366,2760,304,10043,62
3202,10,308,3599,216,11197,92
32512,304,11904,2073,7251,81850,4653
33834,50,1092,2020,900,14591,192
40892,30,888,1575,642,10697,246
31395,3,114,2129,85,3146,29
2640,2,111,3609,83,3749,28
8982,2,71,3315,49,1422,22
12992,4,272,3098,191,5336,81
4744,97,5973,3554,4541,30840,1432
40192,8,133,1639,102,3390,31
23263,6,416,2533,296,4605,120
2255,6,103,3616,84,4867,19
25643,19,558,2424,462,6970,96
13855,7,531,3029,326,4156,205
33462,369,6368,2034,4932,28557,1436
8753,5,54,3328,44,2967,10
21075,11,1530,2649,1266,18258,264
46426,3,63,163,54,2326,9
21415,13,436,2629,362,14627,74
35152,2,253,1960,210,6728,43
7947,9,488,3385,375,13365,113
25309,853,52721,2440,35278,130767,17443
21765,11,336,2609,271,3162,65
18189,0,167,2793,127,4934,40
20454,66,4017,2685,3001,29301,1016
6456,6,741,3472,611,13475,130
26812,48,2614,2371,1911,23805,703
17581,1,116,2819,99,10223,17
44405,8,53,852,36,1800,17
46065,13,146,307,97,3486,49
12987,16,746,3099,599,7731,147
32599,188,7503,2069,5514,59765,1989
11783,220,11979,3164,8995,148194,2984
37926,16,290,1784,239,5884,51
30871,11,379,2154,293,4624,86
1948,65,2255,3621,1483,11450,772
29381,43,3648,2230,2753,32313,895
3641,54,1276,3591,983,18471,293
16378,92,4278,2883,3260,59236,1018
7596,34,660,3412,540,5628,120
43757,27,359,961,223,9465,136
40441,82,2650,1617,1880,22216,770
3677,0,25,3590,23,2115,2
9995,11,236,3258,174,12450,62
31762,14,308,2109,233,4064,75
11844,60,2025,3163,1366,12967,659
3942,18,580,3584,360,28992,220
41174,63,1859,1547,1265,35963,594
18461,98,1856,2781,1429,9214,427
36462,66,2348,1877,1827,27926,521
7619,214,8403,3411,6039,71737,2364
5551,26,785,3513,599,29995,186
19648,22,915,2728,697,9980,218
1122,7,146,3891,121,6387,25
9921,1,57,3262,48,2272,9
32937,5,172,2055,138,5268,34
30985,2,89,2150,76,2941,13
15335,56,4790,2931,3332,33958,1458
4209,52,1271,3574,963,20850,308
13492,4,98,3056,88,3065,10
46395,22,479,182,343,6969,136
35974,19,290,1905,222,3746,68
5242,1,123,3528,97,4592,26
14423,2,79,2986,68,7302,11
45954,65,619,357,482,5947,137
2646,10,406,3609,314,5276,92
29398,32,1940,2229,1588,14350,352
17814,1,89,2811,72,4886,17
14368,56,2495,2990,1912,26799,583
13209,2,124,3078,77,3448,47
37954,5,235,1782,194,8759,41
23332,12,941,2530,679,6156,262
33796,83,2921,2022,2112,34098,809
19691,88,3331,2727,2341,23287,990
41093,28,801,1556,650,16812,151
21824,32,2277,2606,1505,9378,772
19218,9,595,2750,471,7853,124
25860,8,372,2415,292,12740,80
11985,1,23,3156,19,1581,4
39520,4,279,1681,209,4822,70
35316,33,466,1952,356,4298,110
3112,9,143,3601,122,4830,21
34825,2,162,1978,133,4166,29
28233,8,149,2292,132,3547,17
43465,21,601,1060,443,10471,158
1785,6,296,3630,240,4744,56
14355,14,491,2991,359,10186,132
25488,7,570,2432,464,12444,106
18987,31,2006,2760,1544,15865,462
10281,27,1130,3245,855,6788,275
29704,77,1783,2214,1278,30062,505
19100,3,65,2755,60,1812,5
32530,56,1943,2072,1340,32862,603
4670,13,990,3557,761,9478,229
6457,56,128429,3472,46555,33039,81874
10451,121,5129,3237,3246,26900,1883
5034,17,328,3540,234,7464,94
37891,6,90,1787,67,2977,23
38256,54,1170,1762,988,10015,182
41407,6,183,1510,149,4538,34
17998,12,703,2801,560,5874,143
33367,6,228,2038,183,6112,45
32602,0,52,2069,43,3097,9
35057,7,243,1966,148,6157,95
10978,205,6426,3207,4668,118057,1758
24107,11,518,2493,426,8234,92
31624,46,1005,2116,797,9272,208
9939,30,730,3261,506,5809,224
36628,7,263,1867,215,9061,48
3745,3,284,3588,221,6081,63
12130,35,1483,3148,1154,16313,329
16024,21,562,2901,443,10904,119
19393,14,587,2741,450,13423,137
37887,57,2290,1787,1809,33892,481
38833,7,206,1722,164,2598,42
38342,5,168,1755,138,3147,30
25687,1,152,2422,105,2988,47
3644,43,3787,3591,2790,25310,997
5510,9,304,3515,256,6824,48
28970,2,167,2251,137,5838,30
10969,17,703,3207,559,5785,144
1420,17,443,3739,387,4926,56
37177,329,14033,1834,10735,88874,3298
16675,6,438,2869,311,9938,127
42911,21,176,1221,169,5500,7
14921,72,5320,2953,3654,29996,1666
18484,2,139,2780,119,4829,20
42270,2,81,1360,62,3788,19
11333,103,4587,3189,3426,35246,1161
37402,8,152,1820,112,6043,40
39564,6,432,1678,328,6684,104
11630,66,2111,3173,1558,12430,553
42694,43,680,1274,513,16365,167
20724,8,226,2671,180,10214,46
15683,9,199,2915,175,3874,24
14683,60,2518,2969,1944,21643,574
33522,3,219,2032,177,6094,42
43393,2,31,1078,24,4439,7
34623,55,1294,1990,953,12384,341
6171,6,69,3484,61,2062,8
4596,133,3820,3560,3031,29015,789
46226,0,8,250,6,1016,2
3085,36,3639,3601,2886,21599,753
29286,131,3325,2235,2520,32038,805
11569,5,347,3176,260,2588,87
18903,25,685,2762,537,4570,148
4976,2,53,3543,45,3985,8
31918,80,3523,2102,2785,44209,738
43557,4,49,1028,39,2376,10
21562,649,24217,2620,18833,81278,5384
36403,0,31,1880,27,4004,4
28909,2,178,2255,146,3311,32
21591,4,147,2618,117,6519,30
10943,20,1319,3209,1046,16576,273
18625,200,17636,2774,13355,111103,4281
6342,16,1396,3477,1030,6887,366
39863,12,431,1661,303,6682,128
42999,18,340,1197,251,11913,89
40593,229,6283,1603,4762,37553,1521
43008,14,494,1194,350,15075,144
32124,14,352,2090,287,5808,65
2098,17,339,3618,271,5565,68
6977,463,21894,3448,14509,147472,7385
6784,35,1631,3458,1247,24182,384
2013,15,199,3619,155,10957,44
43139,50,835,1155,601,9989,234
21005,0,81,2652,67,2000,14
45202,40,452,623,359,7354,93
7573,20,425,3414,353,14210,72
7788,7,300,3400,236,15072,64
4886,3,34,3547,26,1476,8
22748,10,413,2559,298,7355,115
27883,9,281,2313,242,5872,39
42246,28,499,1364,362,14466,137
14411,40,1038,2987,766,19812,272
34106,15,214,2012,183,3864,31
17594,14,1433,2819,1010,12132,423
41560,28,1143,1490,794,17113,349
36508,4,137,1874,99,6677,38
37572,73,2530,1809,1706,23715,824
37321,18,528,1825,439,5757,89
36870,3,235,1853,172,5158,63
7608,53,1822,3412,1461,23064,361
14364,8,528,2991,375,15251,153
15762,0,76,2912,63,2784,13
37230,55,2138,1831,1704,19020,434
27724,142,10517,2322,6983,58350,3534
16233,111,8653,2891,6309,70063,2344
6838,131,4482,3455,3458,24876,1024
34994,1,319,1969,252,8729,67
15975,4,225,2904,185,5558,40
39449,86,1499,1685,1186,17889,313
2626,9,192,3609,153,4373,39
15435,9,168,2928,134,9034,34
33412,64,1918,2037,1470,22564,448
18648,52,2277,2773,1772,25482,505
3081,36,802,3601,638,4909,164
22058,20,3011,2592,2447,6977,564
12236,18,1226,3143,919,16833,307
20337,14,1085,2691,822,6441,263
9670,16,534,3273,436,4599,98
30457,100,9109,2174,5614,56174,3495
40634,3,205,1600,151,5800,54
21493,19,1653,2625,1361,12667,292
9713,7,106,3272,71,3730,35
40667,7,384,1597,293,12698,91
24416,7,291,2479,197,3222,94
45913,2,79,380,54,1056,25
24757,6,195,2463,150,2998,45
12982,56,2637,3099,1972,20274,665
9708,0,24,3272,15,1236,9
9744,131,4370,3270,3361,18359,1009
11875,34,1773,3161,1324,13933,449
39428,1,112,1686,81,5200,31
12739,187,14644,3114,10449,79533,4195
24544,30,4788,2473,3534,21502,1254
27047,0,119,2362,108,2216,11
43718,354,3924,972,3270,40079,654
13427,19,510,3062,376,8374,134
37731,20,2006,1799,1612,10816,394
45676,26,269,471,203,3422,66
28281,74,2470,2290,1807,18270,663
3138,28,1413,3600,1129,23627,284
5173,2,77,3532,59,2626,18
16912,14,669,2856,497,12517,172
41954,222,6868,1421,4979,62580,1889
31159,24,1026,2141,783,10563,243
42541,4,246,1305,165,5608,81
26922,217,11383,2366,8230,63683,3153
27717,7,165,2322,139,4994,26
31484,2,55,2124,46,4150,9
20129,20,863,2702,640,12894,223
21307,53,1845,2635,1344,18572,501
39421,0,10,1686,8,2082,2
6854,1702,74575,3454,53921,229051,20654
6178,76,3044,3484,2280,27120,764
41719,94,852,1464,589,22356,263
46016,7,137,331,80,3143,57
21631,33,593,2616,459,6817,134
33819,25,1563,2021,1071,20382,492
11160,35,1441,3197,1126,20283,315
27152,12,480,2356,414,6223,66
39164,9,521,1702,408,4200,113
25335,20,1205,2438,955,7972,250
24858,2,143,2459,120,4732,23
10568,607,43389,3230,29195,239109,14194
22119,276,18991,2588,13658,59806,5333
45175,10,154,631,110,3287,44
40427,24,262,1618,208,7163,54
21619,57,3134,2617,2182,10695,952
28156,11,398,2297,329,8787,69
34671,66,2803,1987,2030,28733,773
44980,13,168,710,119,3124,49
34652,12,224,1988,185,3251,39
34448,4,138,1999,108,2216,30
24608,3,197,2469,160,5382,37
8755,22,675,3328,511,8983,164
29852,11,350,2207,285,12096,65
42773,40,508,1255,367,5563,141
5050,82,2271,3539,1314,8925,957
28529,32,1467,2274,1171,10233,296
22432,7,313,2574,241,4668,72
37417,2,50,1819,43,2173,7
10803,1028,48826,3216,34399,164129,14427
27308,40,3145,2347,2521,17890,624
31008,10,144,2149,115,2576,29
18299,5,361,2788,304,6023,57
42633,25,434,1289,330,11654,104
13468,18,1686,3058,1279,27205,407
19057,12,557,2757,451,17734,106
3513,3,145,3593,116,2649,29
29170,6,198,2241,154,4740,44
21557,22,2186,2621,1685,11469,501
3547,2,22,3593,16,3067,6
11797,0,45,3164,37,2120,8
31786,22,851,2108,673,7677,178
3760,89,5593,3588,4028,66892,1565
9549,12,215,3279,171,5647,44
3015,12,512,3603,427,4984,85
30427,59,2305,2176,1686,25789,619
32970,51,1436,2054,1173,35511,263
28949,26,3255,2253,2364,29111,891
10834,11,1134,3214,891,16141,243
6920,7,91,3451,67,2097,24
31431,285,11329,2127,8072,44655,3257
20026,3,79,2707,52,2317,27
46066,1,60,307,46,1094,14
5359,2,29,3522,19,2561,10
29802,2,766,2210,567,9496,199
45216,23,522,619,323,7172,199
24471,0,476,2477,362,5729,114
44060,18,252,906,170,4083,82
9103,5,188,3308,120,5099,68
26020,213,7927,2407,6071,80398,1856
10368,37,2041,3240,1583,24976,458
21678,58,4620,2613,3328,22668,1292
5320,27,871,3524,606,17464,265
38292,23,1128,1760,778,12674,350
16572,20,1182,2874,866,14702,316
11790,1,47,3164,42,2455,5
6279,68,1724,3480,1404,30537,320
18437,385,28742,2782,16421,123913,12321
18904,12,466,2762,331,5965,135
18120,41,2704,2796,2068,18390,636
24087,145,8679,2494,6509,66291,2170
31161,0,37,2141,32,2145,5
45136,1,28,641,16,1757,12
2702,12,226,3608,192,8496,34
19138,42,1733,2754,1326,27924,407
38267,2,104,1761,78,3721,26
7119,56,2416,3440,1516,20029,900
44897,14,250,734,234,5397,16
39235,5,164,1697,131,8200,33
8951,2,291,3316,238,12182,53
36155,2,139,1892,104,3740,35
46008,3,54,335,36,1463,18
42141,51,971,1387,691,19772,280
3357,8,269345,3596,95304,8227,174041
20170,16,2402,2699,1867,41205,535
3813,43,10228,3587,6184,28814,4044
4610,13,151,3559,114,12799,37
8870,5,140,3321,109,2392,31
13098,73,2988,3092,2174,31867,814
4138,31,868,3577,685,16598,183
33773,6,148,2023,123,8015,25
20684,45,1678,2673,1242,18299,436
40336,1265,42165,1629,28946,122495,13219
24437,9,332,2478,268,5885,64
38684,19,559,1731,427,19621,132
42721,4,448,1269,286,16106,162
26330,1,55,2393,51,2580,4
35860,2,74,1914,56,4477,18
26078,0,129,2405,97,3194,32
2538,15,493,3611,394,7724,99
4167,650,51254,3576,38559,185769,12695
7267,18,797,3432,643,16796,154
45637,26,278,490,220,5983,58
6280,60,1805,3480,1412,20421,393
20834,0,163,2664,141,3774,22
43325,22,640,1102,472,13576,168
31460,13,333,2125,296,8384,37
22504,66,7403,2570,4893,35452,2510
20959,0,113,2656,106,2660,7
24604,56,1939,2469,1554,16069,385
35573,0,37,1936,32,2575,5
9197,2,62,3302,55,3718,7
32440,6,194,2076,166,3375,28
8115,32,1835,3369,1265,47521,570
17396,8,477,2828,346,11806,131
12054,15,501,3153,400,7817,101
45155,0,120,637,71,3255,49
3191,7,176,3599,141,6759,35
23328,11,460,2530,397,8698,63
39190,15,621,1700,511,4254,110
3122,10,293,3601,236,10216,57
31713,0,57,2111,39,4048,18
3917,4,407,3584,338,9623,69
8595,44,4701,3338,3228,29292,1473
14077,23,1537,3010,1254,20545,283
31980,38,2786,2098,2154,5738,632
16078,74,2542,2898,1976,53790,566
4736,4,57,3555,45,4310,12
9851,39,1974,3265,1476,18710,498
31718,0,30,2111,13,2346,17
46256,2,22,242,21,2359,1
12117,4,274,3149,220,4234,54
10712,48,1394,3221,964,21909,430
8757,80,86917,3327,31554,16998,55363
2088,12,466,3618,324,5780,142
28010,37,1865,2305,1461,11585,404
43178,15,357,1144,226,4357,131
37055,10,488,1841,361,7238,127
35530,66,1764,1938,1414,9372,350
14808,173,18610,2959,13852,147629,4758
30384,4,107,2179,69,2412,38
22496,77,7717,2570,5772,92194,1945
28029,61,3893,2304,2989,60803,904
43625,20,193,1003,180,10181,13
30992,5,267,2150,193,3598,74
25915,0,69,2412,52,2908,17
38064,209,3126,1776,2473,30278,653
31265,102,2308,2136,1794,20051,514
3955,194,6271,3583,5036,31970,1235
33002,2,135,2052,66,4225,69
28875,10,713,2256,556,26845,157
18169,16,889,2794,719,6908,170
31532,7,144,2121,107,3495,37
22279,2,101,2581,84,4481,17
8332,3,38,3355,27,1355,11
11904,16,968,3160,763,15041,205
42934,0,24,1214,17,2380,7
25130,22,1969,2447,1403,12555,566
5515,3,899,3515,711,13080,188
38614,64,1895,1736,1456,26433,439
28251,58,2476,2291,1950,16084,526
17502,0,2275,2824,1643,44713,632
31100,5,197,2144,165,6201,32
10230,164,4365,3247,3451,69055,914
45791,154,2456,424,2093,22871,363
20876,29,1352,2661,922,13714,430
9983,348,6658,3258,4377,26455,2281
6936,37,599,3450,462,8098,137
6596,19,2000,3466,1422,39989,578
28379,371,18193,2284,13496,96193,4697
11540,19,409,3176,343,15911,66
4987,70,1642,3543,1182,8997,460
44544,5,77,830,71,4495,6
36447,5,238,1878,190,5249,48
25308,23,315,2440,262,6139,53
22794,2300,118800,2557,81971,621578,36829
37653,7,198,1804,162,5203,36
13531,55,3726,3053,2776,16137,950
23996,29,1419,2498,1101,24443,318
17486,29,2579,2824,1933,26248,646
38738,47,1455,1728,1128,16621,327
41264,20,434,1532,337,12267,97
43937,1,47,926,29,1179,18
12512,1,89,3126,67,1297,22
5172,118,2773,3532,2159,22509,614
3438,7,333,3595,262,9046,71
39065,1,90,1708,68,2715,22
26157,98,7200,2402,4798,63689,2402
34930,12,240,1972,190,5032,50
32601,115,3501,2069,2833,28498,668
36079,14,973,1897,776,20175,197
42112,5,93,1395,72,5468,21
29686,0,91,2215,78,4370,13
23103,28,3119,2541,2453,13624,666
30000,494,11227,2200,8789,46759,2438
15870,4,208,2908,176,10417,32
17247,98,4218,2836,3091,40025,1127
19654,9,213,2728,169,2306,44
38568,1,111,1739,86,3771,25
21596,257,18582,2618,14082,113917,4500
7285,137,6204,3431,4567,55764,1637
3639,2,32,3591,25,3401,7
38700,9,330,1731,269,5753,61
27147,103,2085,2356,1543,14437,542
13895,1,151,3025,107,2803,44
6511,13,836,3469,634,7603,202
5438,23,726,3518,532,22152,194
33466,17,285,2034,242,4158,43
10175,0,77,3249,32,4176,45
12395,51,3479,3133,2661,24024,818
21547,4,172,2621,131,3598,41
43016,4,197,1192,121,3603,76
11327,121,6168,3189,4293,57385,1875
39452,7,212,1684,165,4869,47
24384,19,907,2481,725,5519,182
13962,125,4819,3018,3751,32284,1068
18350,31,837,2786,572,6612,265
45840,10,124,408,108,2844,16
37152,274,37905,1836,27157,133730,10748
23404,248,15394,2526,11197,45840,4197
42878,12,105,1231,88,3308,17
2581,95,3403,3610,2248,16958,1155
42215,7,374,1371,243,5673,131
30546,195,4655,2170,3187,16474,1468
44572,2,67,825,49,2954,18
40308,79,2728,1631,2169,15820,559
11011,1,90,3205,74,4947,16
6169,4,169,3484,153,3997,16
35450,24,757,1945,589,12818,168
8389,19,970,3351,694,16318,276
20237,158,7769,2695,5213,70195,2556
2816,10,670,3606,538,12179,132
30672,0,44,2163,39,2661,5
45429,1,8,559,5,1166,3
15919,51,2801,2906,2227,29556,574
33193,53,1251,2045,994,8974,257
28797,9,221,2260,174,1989,47
37541,17,289,1811,225,5859,64
44392,114,2066,854,1463,11155,603
40521,1,51,1610,43,2666,8
3267,10,181,3598,150,4860,31
22607,17,853,2565,696,9078,157
30440,3,50,2175,41,2021,9
13884,460,32316,3026,22895,160714,9421
38608,22,749,1736,568,13037,181
4107,1176,40643,3578,29077,136059,11566
2481,77,2863,3611,2090,26204,773
38371,8,186,1754,148,4216,38
7884,37,3099,3391,2308,38263,791
18691,31,1649,2771,1346,18689,303
16431,27,1715,2881,1339,26666,376
25199,17,1180,2444,934,11418,246
45204,5,39,623,26,2756,13
15263,1,81,2935,62,3181,19
26526,4,156,2384,116,2922,40
28711,135,2861,2265,2255,15020,606
42359,8,393,1343,275,6680,118
30634,2,138,2165,117,8061,21
2110,9,243,3618,185,6810,58
9400,112,6596,3289,4236,54058,2360
45440,434,7919,557,6497,41568,1422
1827,32,555,3625,439,13763,116
36312,2,67,1884,47,2255,20
2188,29,599,3617,461,22594,138
42256,113,1834,1362,1344,24827,490
2533,9,152,3611,128,4649,24
22582,169,7558,2566,5360,52305,2198
17363,32,845,2830,566,5590,279
23477,7,280,2522,202,8504,78
28327,0,98,2287,81,3609,17
6787,23,560,3458,429,6779,131
38974,4,164,1714,124,4342,40
39451,11,355,1685,255,6189,100
33682,38,749,2027,612,6151,137
3177,27,643,3600,397,5451,246
5372,8,297,3521,205,7112,92
39679,286,9979,1671,6978,46760,3001
35089,0,40,1964,37,2307,3
28330,10,167,2287,147,3722,20
19031,35,1205,2758,945,25999,260
45483,308,7257,546,5262,55726,1995
39066,7,170,1708,127,5248,43
16114,3,75,2896,64,1412,11
45851,60,774,403,585,12514,189
15699,2,151,2915,111,4045,40
3800,1,65,3587,52,2008,13
2650,9,190,3609,157,4907,33
34894,50,1128,1974,906,6584,222
4862,12,523,3549,413,19078,110
28586,108,6650,2271,4983,27025,1667
28800,0,33,2260,29,1822,4
23149,56,749,2539,604,5812,145
45071,911,14082,675,11241,71796,2841
8893,27,1536,3320,1068,28818,468
39570,1,170,1678,136,3707,34
27424,14,357,2340,276,5252,81
2477,12,245,3612,199,12016,46
35598,18,309,1933,254,2967,55
43258,1,145,1120,106,2692,39
26492,6,319,2386,267,5007,52
30704,6,145,2161,124,2236,21
44737,329,3450,783,2804,16318,646
1049,4,199,3910,166,5536,33
34432,9,721,2000,497,12380,224
40335,22,849,1629,637,14906,212
7294,183,5233,3431,3900,33469,1333
26519,5,83,2384,64,4966,19
31845,2,137,2105,102,2721,35
31972,6,202,2099,152,5347,50
41774,257,10716,1453,8076,63112,2640
28557,41,1403,2272,1187,11204,216
18232,1,53,2791,43,3787,10
22067,4,549,2592,425,7599,124
40355,5,227,1625,184,6545,43
8519,4,81,3342,64,2479,17
29257,17,422,2237,337,7639,85
4901,89,1752,3547,1323,15910,429
44537,150,2344,823,1823,15651,521
31771,21,396,2109,314,25691,82
8211,33,1089,3363,826,10003,263
39209,20,205,1699,166,3803,39
8679,7,249,3332,172,2337,77
4007,4,39,3581,36,3270,3
2069,1038,48473,3618,34202,189730,14271
2748,1,59,3607,48,4655,11
40936,9,481,1572,326,7033,155
9369,3,175,3290,131,7427,44
40654,15,387,1599,293,3459,94
25926,58,3229,2411,2562,32719,667
32169,22,538,2088,435,13015,103
12732,590,14684,3114,10966,67463,3718
36569,1,29,1872,21,4323,8
21269,1,66,2636,60,1468,6
8441,368,15777,3348,11200,70422,4577
42945,7,177,1211,139,4381,38
14671,41,4191,2970,2843,26695,1348
37654,5,185,1804,142,4838,43
43262,15,244,1119,176,7510,68
27382,4,65,2342,53,2821,12
18356,5,82,2785,70,3607,12
5572,107,3166,3512,2495,39758,671
18423,112,6349,2783,4835,40813,1514
22295,27,1689,2580,1162,15359,527
46408,10,92,175,91,2736,1
11695,2,68,3169,57,3025,11
2471,9,218,3612,187,6752,31
10738,118,8862,3219,6529,36224,2333
40839,66,1447,1580,1015,15710,432
10425,46,1417,3238,1116,37316,301
44681,52,754,802,547,8203,207
42822,23,462,1243,385,22294,77
19136,0,1315,2754,995,5642,320
36917,34,456,1850,349,7941,107
21359,19,609,2631,496,7824,113
8490,229,23545,3344,16668,57310,6877
39760,2,137,1668,112,3376,25
29202,1,99,2240,88,2740,11
24875,57,2380,2458,1817,22340,563
24701,459,29470,2465,22648,73587,6822
43364,5,131,1088,97,3337,34
36696,53,1649,1864,1282,17373,367
20926,6,277,2657,225,4964,52
21383,9,528,2631,431,6277,97
42331,21,666,1349,537,6164,129
45786,0,27,426,15,1717,12
14220,36,1146,3003,936,11732,210
21155,0,120,2643,99,2254,21
41334,19,823,1521,601,9544,222
26154,1,37,2402,31,1674,6
21926,30,725,2600,585,4498,140
43618,26,263,1004,224,6259,39
15020,24,258,2948,187,5466,71
28242,19,376,2292,276,8399,100
25334,0,42,2438,32,2974,10
20420,4,307,2686,227,8548,80
3154,20,578,3600,447,7453,131
34319,4,159,2005,116,4528,43
6187,39,892,3484,672,6125,220
40741,13,234,1591,185,5433,49
39467,5,200,1684,139,3346,61
19926,42,3475,2713,2496,39072,979
32206,2,148,2086,118,4391,30
45439,155,1800,557,1552,21848,248
8131,1,142,3368,117,2909,25
31858,13,1956,2104,1361,5761,595
18438,17,523,2782,376,11722,147
39682,3,98,1671,79,2818,19
25731,0,99,2420,86,2702,13
17544,2,47,2821,41,3211,6
25741,6,510,2419,409,4145,101
25150,396,19838,2446,14107,100301,5731
45797,47,552,422,419,4450,133
27364,11,273,2343,206,5042,67
29283,161,2719,2236,1984,15976,735
26575,7,121,2382,99,3307,22
15282,41,2964,2934,2031,35466,933
17360,194,4293,2830,3166,16407,1127
45532,59,996,531,616,8042,380
32514,10,718,2073,579,13137,139
6649,2,52,3464,44,4881,8
38462,18,700,1747,541,7148,159
10740,178,6956,3219,5233,57748,1723
17125,201,11511,2843,7981,87164,3530
4962,13,550,3544,402,16820,148
34080,7,115,2013,92,6800,23
2432,32,784,3612,642,19824,142
30360,0,58,2180,49,3652,9
36798,19,679,1858,519,5782,160
15736,8,256,2913,195,6591,61
26120,1,219,2403,186,11770,33
15124,514,27327,2942,19355,136578,7972
14760,44,2083,2963,1553,23629,530
7391,5,176,3425,158,6107,18
42160,29,676,1383,441,15617,235
39571,29,648,1678,502,19076,146
24894,123,8773,2457,7164,34045,1609
39861,5,160,1661,107,6851,53
44033,66,659,910,544,8551,115
3285,25,758,3598,563,11472,195
25934,12,957,2411,761,5179,196
21971,33,5383,2597,4012,11641,1371
7820,30,1642,3398,1265,82200,377
23709,30,1024,2511,794,9805,230
31801,271,8868,2107,6567,54108,2301
18039,3,215,2799,148,10503,67
16694,1,108,2868,61,4431,47
42415,56,2016,1331,1301,10931,715
40038,1,29,1648,23,2673,6
8072,5,92,3371,81,4733,11
38664,15,323,1733,259,4038,64
18305,6014,358432,2788,245450,1078000,112982
5286,763,20277,3525,15291,52492,4986
23949,41,4390,2500,3151,20276,1239
13503,9,995,3056,765,17647,230
4688,39,712,3556,548,13618,164
8943,23,825,3317,623,7134,202
9730,62,2515,3271,1848,11191,667
26848,93,3243,2369,2642,19229,601
46017,6,74,331,61,2747,13
45308,36,413,591,314,4262,99
26659,1,221,2379,175,2132,46
9391,8,236,3289,200,11247,36
32969,330,14804,2054,11301,89856,3503
45244,2,32,613,17,2485,15
30276,21,1944,2186,1519,7517,425
40851,43,1490,1579,1169,24826,321
27555,5,129,2331,96,6505,33
24441,51,1250,2478,990,13493,260
45616,27,456,502,372,5768,84
38479,6,224,1747,178,8452,46
15809,23,1283,2910,964,18003,319
5542,21,1353,3513,982,15539,371
20100,9,424,2703,336,5239,88
10873,45,2078,3212,1611,33675,467
35041,6,182,1967,147,8145,35
44053,8,133,907,93,3346,40
36995,14,343,1845,291,8008,52
15139,79,4136,2941,3082,30167,1054
40657,204,6634,1598,4799,53950,1835
8265,30,1317,3360,1097,23681,220
18877,2,209,2763,164,2160,45
44585,507,6318,822,5093,42232,1225
21796,6,308,2607,196,5404,112
37213,7,100,1832,82,3623,18
45351,11,90,580,66,2091,24
44810,106,2378,759,1790,25023,588
10144,269,13402,3251,10071,75761,3331
6926,76,2719,3451,1927,20683,792
34259,4,278,2007,217,8483,61
15348,53,3734,2931,3004,38354,730
26741,0,57,2374,45,4379,12
27337,26,1346,2345,1078,23170,268
3724,1,33,3589,25,2567,8
27045,61,2476,2362,1833,26615,643
37974,60,590,1781,462,6707,128
42460,5,198,1321,151,7943,47
40632,0,125,1600,81,2235,44
3123,10,232,3601,175,3825,57
13279,20,1071,3074,839,10422,232
10019,3,57,3257,47,2459,10
41534,76,987,1493,769,10961,218
6724,7,281,3461,204,3855,77
9498,1865,90618,3282,65516,181143,25102
34564,20,362,1993,263,4091,99
16617,304,15627,2872,11958,73893,3669
32596,9,442,2069,350,8442,92
16382,4,257,2883,206,3846,51
18165,2,111,2794,87,2837,24
22928,0,51,2548,44,2610,7
27888,3,149,2312,110,4490,39
22207,0,156,2585,128,3335,28
40409,171,6391,1621,3295,26080,3096
14934,6,334,2953,265,4376,69
40050,21,733,1647,538,11891,195
3936,3,218,3584,182,4298,36
42884,2,35,1229,25,2806,10
27115,8,311,2359,268,3542,43
23027,17,655,2545,503,3976,152
46258,6,43,242,41,2309,2
15038,18,321,2947,248,4495,73
1909,44,1866,3622,1299,22382,567
9612,45,1934,3275,1488,26106,446
23207,18,851,2536,680,11933,171
3921,80,1851,3584,1429,24940,422
6325,4,243,3477,182,14747,61
33277,2,81,2042,57,2785,24
31970,12,434,2099,347,6077,87
38559,7,390,1740,281,13684,109
4338,47,1465,3569,1230,23660,235
10095,12,322,3253,275,26694,47
24922,1,28,2456,27,3684,1
36734,47,1315,1862,1039,24720,276
9276,264,13710,3297,9887,63102,3823
39088,4,150,1706,124,4061,26
24175,0,94,2490,73,3151,21
24160,21,480,2491,395,2560,85
20640,40,4325,2676,3151,33352,1174
23503,38,3491,2522,2536,30122,955
38792,198,21931,1725,15157,57776,6774
8807,7,288,3324,241,7045,47
4601,3,180,3560,134,4389,46
17193,10,504,2839,376,8006,128
13565,77,6606,3050,5055,32338,1551
41426,2,128,1507,110,4790,18
36175,12,266,1891,222,10607,44
12398,2,219,3133,179,13592,40
28874,154,27386,2256,22106,60448,5280
22165,0,74,2587,49,5008,25
27609,0,118,2328,89,2122,29
8626,26,533,3336,427,5127,106
27804,10,360,2316,263,3013,97
40842,2,62,1580,51,2427,11
44168,6,109,888,90,3104,19
7344,147,4662,3427,3382,42021,1280
42449,160,4261,1324,3243,53647,1018
17059,22,1464,2847,1221,17713,243
36173,26,568,1891,430,7570,138
15691,18,1363,2915,1043,13291,320
37682,4,167,1803,140,3422,27
33233,13,258,2043,220,4755,38
4537,7,115,3562,64,1911,51
11789,3,80,3164,64,2733,16
30273,1,61,2186,41,4065,20
8733,66,3707,3329,2716,35756,991
1470,1,79,3713,72,3012,7
45641,18,336,489,253,5517,83
22528,27,1736,2569,1363,19112,373
41221,168,4209,1540,3116,44969,1093
42516,8,352,1310,238,4557,114
45203,14,167,623,105,4286,62
12545,2,196,3126,158,9385,38
5745,157,7043,3502,5237,94909,1806
33369,14,1727,2038,1301,17892,426
37841,2,191,1790,107,4515,84
42264,63,1274,1361,889,26925,385
7252,0,12,3433,10,2398,2
31728,53,1769,2111,1322,37958,447
11612,51,1260,3174,873,16984,387
10893,12,119,3211,97,8953,22
24393,6,205,2480,169,5518,36
5790,26,1088,3501,826,7677,262
10397,10,538,3239,351,11792,187
6001,44,1756,3490,1400,27254,356
34841,287,5874,1977,3958,34811,1916
44745,16,267,779,190,3912,77
21996,33,2360,2595,1784,18367,576
37637,10,201,1805,140,3045,61
8539,3,165,3341,126,4166,39
2656,11,156,3609,113,10031,43
16841,30,1709,2859,1242,13275,467
4927,275,14568,3545,10598,75596,3970
29206,11,532,2239,453,4187,79
39970,14,432,1653,331,8641,101
8388,163,11041,3351,7143,44364,3898
9376,164,12741,3290,9420,62570,3321
5543,14,640,3513,518,15040,122
21542,59,1465,2621,1163,15959,302
27603,10,552,2329,455,8975,97
17930,13,505,2806,422,8054,83
28880,4,105,2256,89,3385,16
18164,14,250,2795,197,5858,53
5482,6,227,3516,117,3806,110
40440,0,25,1617,18,2237,7
39084,18,1014,1707,773,6915,241
32083,10,620,2092,411,8788,209
2338,19,886,3614,627,21315,259
31971,3,128,2099,112,5169,16
10236,98,4983,3246,3733,51496,1250
36034,2,55,1901,45,3754,10
13399,178,7237,3064,5636,51551,1601
5817,2,175,3499,104,3271,71
35765,3,164,1920,112,6495,52
37021,0,21,1844,15,1976,6
13157,6,81037,3080,20445,4967,60592
39280,77,1963,1693,1555,13787,408
45417,15,111,561,88,4041,23
43095,9,114,1167,97,3714,17
3265,3,95,3598,81,5182,14
5165,3,78,3532,65,6825,13
30882,347,9389,2154,7143,56385,2246
18881,3,275,2763,217,4678,58
22416,2,47,2575,30,2559,17
34680,24,427,1987,317,3958,110
12003,55,2108,3155,1613,14547,495
25787,26,512,2417,421,7373,91
30142,51,2762,2193,2176,12050,586
11068,115,12818,3202,9178,42716,3640
2145,16,880,3617,703,20950,177
6952,42,478,3449,404,7844,74
28415,2,80,2282,71,4332,9
35855,1,105,1914,82,4649,23
7465,12,398,3421,293,6466,105
21715,9,232,2611,185,5451,47
31810,7,139,2107,119,3949,20
40042,3,132,1648,103,2795,29
40307,5,154,1631,88,5323,66
22474,458,37292,2572,26659,148505,10633
2689,22,603,3608,509,13592,94
6396,95,2773,3474,2114,27606,659
13771,55,3898,3035,2685,49433,1213
15304,12,986,2932,773,11380,213
40416,269,6287,1620,4683,34405,1604
16683,2,47,2868,40,4491,7
10995,4,121,3206,93,2822,28
45723,4,52,446,39,5116,13
4807,60,3070,3551,2454,19825,616
24493,3,124,2476,90,3124,34
19957,5,149,2711,126,4501,23
28101,0,23,2300,19,4119,4
40272,2,46,1633,36,4022,10
26311,12,503,2394,382,5063,121
7589,37,1331,3413,1002,20240,329
24512,15,421,2475,331,6737,90
4588,2,64,3560,60,2007,4
26312,31,1787,2394,1331,23764,456
19051,0,41,2757,33,6902,8
41945,258,9548,1422,6611,58992,2937
21990,18,2440,2596,1737,13235,703
2340,5,265,3614,212,9433,53
26106,1,60,2404,44,2165,16
10059,12,1728,3254,1294,36532,434
23466,4,69,2523,58,3089,11
24113,4,126,2493,101,3835,25
44805,28,317,760,225,3722,92
39502,33,828,1682,542,12606,286
39010,5,143,1712,102,2287,41
27864,12,264,2314,199,2886,65
32310,6,325,2082,287,6112,38
15719,5,474,2914,399,18664,75
46137,6,81,281,76,2204,5
23579,5,209,2518,161,5345,48
15976,16,708,2904,528,4722,180
11261,747,52132,3191,36241,150492,15891
40678,2,56,1596,44,8116,12
29332,7,214,2232,172,10708,42
43046,20,277,1183,207,2821,70
12426,10,1577,3131,1217,15473,360
23455,12,512,2524,352,10304,160
28723,1252,106497,2264,74756,404091,31741
26033,30,758,2406,616,16100,142
37959,446,11859,1782,8889,83676,2970
32761,0,24,2063,18,2021,6
7080,298,12512,3442,9111,172717,3401
16224,0,141,2891,113,3328,28
34182,109,4148,2010,3199,19453,949
43741,143,1764,965,1542,13433,222
9264,22,554,3298,422,17014,132
10544,2603,183129,3231,116679,1083865,66450
4131,15,627,3577,498,3897,129
42923,85,1225,1218,928,21441,297
9460,114,3134,3285,2178,14990,956
39474,152,2431,1683,1995,19705,436
46210,1,38,253,23,1142,15
14357,1,46219,2991,15499,6460,30720
10836,183,7517,3214,5438,75800,2079
45059,89,1990,682,1506,12755,484
8416,3,170,3350,123,7455,47
15635,59,4553,2917,3458,26870,1095
7492,29,857,3419,626,10077,231
32741,7,518,2064,420,7999,98
24021,20,1353,2497,956,15979,397
6710,121,5738,3461,4321,51806,1417
39092,6,199,1706,164,4532,35
14704,57,3973,2967,2822,23055,1151
20147,19,433,2701,318,4196,115
36107,31,637,1895,503,6040,134
29637,21,777,2217,601,10391,176
3426,29,1937,3595,1488,41245,449
9359,0,83,3291,72,3096,11
4456,0,48,3565,35,1940,13
42576,27,348,1300,213,3787,135
1569,6,81,3685,65,5172,16
35490,3,55,1942,40,5312,15
27040,31,646,2362,489,7075,157
39598,25,1016,1676,736,16221,280
31147,8,403,2142,308,5620,95
41296,83,2826,1526,2074,21480,752
4313,18,469,3570,374,15718,95
36279,9,239,1886,197,8596,42
24859,54,1107,2459,882,12715,225
36320,335,6597,1884,5357,32348,1240
35679,86,1688,1926,1260,18984,428
23808,0,9161,2508,7115,57552,2046
43021,21,323,1191,236,15850,87
19965,22,541,2711,461,18862,80
36283,15,715,1885,610,12743,105
26897,9,264,2367,222,2726,42
37423,22,379,1819,325,8753,54
2633,26,1472,3609,1172,20376,300
5028,12,52,3540,33,3799,19
34870,42,2092,1975,1547,17202,545
33692,4,159,2026,126,3978,33
12671,3,129,3118,103,4993,26
40984,3,94,1569,79,3155,15
3317,20,883,3597,744,7334,139
14777,5,706,2962,558,18788,148
19205,0,60,2750,49,4579,11
24065,26,1689,2495,1310,8975,379
4042,11,417,3580,313,8592,104
44893,8,80,735,59,1847,21
21525,25,816,2622,689,11583,127
40946,0,21,1571,15,2113,6
26293,13,226,2395,182,4158,44
33668,0,17,2027,14,2182,3
3747,17,626,3588,492,15233,134
38142,30,424,1770,325,5037,99
36610,9,106,1868,89,4005,17
11625,12,644,3173,523,9015,121
14150,2,68,3007,54,3313,14
21355,15,547,2632,417,15863,130
46012,40,435,334,284,5270,151
35696,229,15145,1925,11673,45262,3472
18882,3,214,2763,157,2781,57
1774,3,68,3633,58,2159,10
27966,49,3442,2307,2720,19824,722
29552,3,119,2221,93,2805,26
30189,80,4164,2190,3048,23119,1116
23126,8,189,2540,140,3923,49
9360,334,11033,3291,7752,57474,3281
26719,283,18969,2375,13602,143836,5367
4853,17,378,3549,287,9056,91
14747,268,16798,2964,12188,122848,4610
38496,29,1637,1745,1273,19732,364
6813,16,805,3456,653,15471,152
43041,14,533,1185,361,11790,172
23359,26,2420,2529,1830,14313,590
39400,26,242,1687,195,3655,47
27896,20,2445,2312,1871,21523,574
20166,362,23979,2700,16542,85128,7437
31232,7,344,2137,279,10735,65
45473,1,26,549,19,1359,7
16273,28,1887,2889,1461,53484,426
39226,74,1336,1698,986,14596,350
45267,4,70,602,39,1823,31
39177,18,253,1701,214,5338,39
21490,13,857,2625,698,10065,159
13716,3,734,3040,503,15091,231
16524,20,1695,2876,1228,23804,467
19788,104,6586,2720,4347,68260,2239
35522,25,667,1939,549,10739,118
9783,14,522,3268,422,5142,100
30007,29,3585,2200,2582,27762,1003
20388,37,1248,2689,974,17452,274
19081,32,1701,2756,1245,11410,456
2399,70,1149,3613,975,45959,174
39798,41,995,1665,806,11284,189
33742,9,444,2024,325,19247,119
38619,36,1817,1736,1476,11750,341
35415,3,153,1947,115,5236,38
45550,3,54,522,32,4567,22
15592,6,257,2919,173,6797,84
42003,9,572,1413,436,16464,136
32793,19,1152,2061,785,18570,367
9934,1043,63546,3261,44355,425400,19191
35753,103,4111,1922,3206,38000,905
29609,101,1576,2219,1304,21124,272
45438,0,15,557,11,792,4
2565,32,1218,3610,950,14381,268
39898,51,2331,1658,1848,28528,483
13756,33,1466,3036,1150,30710,316
9404,44,954,3288,749,9355,205
3477,139,9062,3594,6958,28986,2104
20850,66,3591,2663,2764,21823,827
27235,555,61267,2351,43959,261407,17308
8912,0,80,3319,61,4168,19
26550,3,123,2383,105,1817,18
19013,17,2860,2758,1941,33452,919
15834,23,1318,2909,1003,7696,315
4892,21,797,3547,594,10765,203
13166,4,183,3080,147,3425,36
8578,2,100,3338,73,4510,27
23627,40,876,2515,702,5188,174
27853,10,409,2314,326,9009,83
37779,8,214,1795,171,3551,43
8443,1,35,3348,31,1552,4
1793,63,3053,3626,2477,33334,576
30551,0,86,2169,65,4070,21
44009,37,258,915,205,4474,53
21590,46,2422,2619,1707,29602,715
46006,6,129,336,86,2936,43
31816,12,783,2106,628,5748,155
3645,152,8613,3591,6426,40355,2187
37910,493,18880,1785,13993,111238,4887
6357,23,143255,3476,50898,8355,92357
39951,8,151,1654,118,5992,33
7703,859,32454,3406,24215,107438,8239
22864,0,49,2553,36,2282,13
36010,6,191,1902,161,3554,30
40257,2,32,1634,28,2792,4
5975,57,1288,3491,1036,13068,252
1045,8,173,3911,146,5178,27
40513,0,0,1610,0,3932,0
11958,23,1182,3157,783,15587,399
31753,143,6368,2109,4653,25158,1715
12194,40,1244,3145,974,16097,270
45408,94,2072,563,1716,12693,356
31068,0,50,2146,41,2153,9
8809,5,533,3324,456,24540,77
41687,20,778,1469,548,13668,230
22511,4,249,2570,169,8676,80
23170,65,3455,2538,2801,22288,654
9282,80,2817,3297,1778,30600,1039
13919,2,109,3022,79,3904,30
32452,83,3309,2076,2605,27180,704
7129,9,178,3439,128,7569,50
8485,9,189,3345,154,6523,35
23946,120,5185,2500,3604,23193,1581
2822,38,1342,3606,957,32464,385
22543,2,0,2568,0,10502,0
11256,73,3659,3192,2703,26552,956
27956,0,45,2308,40,2603,5
23647,0,0,2514,0,6104,0
15692,5,256,2915,211,4739,45
8196,9,325,3364,238,8506,87
44710,62,468,790,344,6447,124
17718,68,3758,2815,2874,16601,884
41268,48,1539,1531,1211,14732,328
36497,25,461,1875,356,6344,105
24530,18,610,2474,488,5396,122
17284,308,9314,2834,6473,35177,2841
10813,4,115,3215,91,3410,24
15193,12,433,2938,352,5204,81
30741,12,510,2159,397,3483,113
43367,2,104,1087,66,4378,38
27339,1,178,2345,142,1824,36
43630,22,329,1001,282,14835,47
24605,67,2432,2469,1905,20872,527
32720,3,82,2064,73,2082,9
37238,3,270,1830,211,18935,59
38031,0,2777,1778,2073,20773,704
2430,19,371,3612,306,29391,65
13452,73,2288,3059,1821,30843,467
33211,11,413,2044,328,6915,85
45010,1,22,701,11,2130,11
5380,17,529,3521,434,33583,95
17638,211,41593,2817,25254,107394,16339
41810,1,42,1444,36,4354,6
39233,4,105,1697,80,4472,25
16319,5,281,2887,215,4965,66
11279,42,2822,3190,2192,46821,630
18338,24,2374,2786,1785,17409,589
3935,1,220,3584,171,4419,49
13285,134,7350,3073,5123,42410,2227
15369,40,1738,2930,1386,10288,352
30280,49,1083,2185,856,6923,227
15345,42,2453,2931,1953,26144,500
40783,133,3054,1587,2487,25244,567
16630,58,3553,2872,2805,35249,748
30603,506,33854,2167,24874,200766,8980
23484,1049,31438,2522,24419,101188,7019
22806,1,205,2556,159,2274,46
15554,18,880,2922,634,12824,246
18203,342,16172,2793,11984,108836,4188
31400,46,2138,2129,1733,18079,405
14315,262,21352,2995,15814,114293,5538
32956,6,181,2054,146,5520,35
33647,3,93,2028,76,2982,17
32437,1,136,2076,107,3842,29
41205,9,253,1543,201,6012,52
12363,66,1780,3135,1246,12715,534
24025,0,577,2497,474,6884,103
33670,68,1279,2027,998,15881,281
32051,0,51,2094,24,5704,27
10532,49,1459,3232,1100,9797,359
19856,0,137,2717,97,2415,40
46192,90,1797,258,1616,13741,181
23987,4,139,2498,102,1810,37
16169,12,615,2894,481,11295,134
7661,172,4246,3409,3227,29199,1019
28094,21,834,2301,671,14078,163
10860,2,122,3213,94,3529,28
41738,3,196,1460,143,8011,53
4841,26,989,3550,691,5891,298
37552,0,53,1810,40,2381,13
13331,54,2160,3069,1639,25427,521
14642,109,5004,2971,3802,39676,1202
37034,79,4400,1843,3507,41812,893
15470,24,2290,2926,1555,26056,735
45769,83,1321,429,1111,19500,210
24809,11,278,2461,227,3932,51
15551,22,672,2922,510,5374,162
18415,26,1807,2783,1444,18156,363
16721,63,5958,2867,4563,39506,1395
36365,803,27724,1881,21188,155445,6536
18195,12,578,2793,412,7747,166
7631,11,141,3410,121,3545,20
4980,18,605,3543,518,15846,87
46322,0,2,215,2,626,0
2388,14,577,3613,478,16468,99
33043,0,61,2051,50,4455,11
19758,8,243,2722,200,5606,43
36099,5,88,1896,70,2875,18
24488,0,227,2476,176,5812,51
7984,7,171,3380,117,2809,54
21511,1,48,2623,31,3257,17
40707,29,1210,1594,808,18773,402
18628,5,176,2774,124,1799,52
3450,11,166,3595,145,8186,21
40107,9,456,1644,327,5708,129
35921,90,1864,1909,1398,13081,466
21065,12,374,2650,282,7566,92
21243,12,573,2637,462,7371,111
27519,269,14237,2333,10376,56975,3861
26405,8,219,2389,189,4361,30
2826,83,4014,3606,2987,27968,1027
29676,244,5305,2215,4108,23766,1197
5656,32,834,3507,700,13434,134
45725,4,124,445,103,3065,21
45056,231,1994,683,1633,11772,361
8043,801,70687,3372,46665,418007,24022
18463,144,13059,2781,10034,71880,3025
30442,33,1751,2175,1131,15450,620
42388,20,778,1339,520,4926,258
1966,7,160,3620,119,10255,41
17818,125,4446,2811,3438,42256,1008
5208,83,2839,3529,2348,14299,491
34519,1,54,1996,44,3105,10
32891,1,149,2057,128,3091,21
44322,13,120,864,108,3386,12
3088,13,1527,3601,1174,31272,353
4117,108,3413,3577,2800,43713,613
38531,13,458,1742,349,13602,109
18345,4,542,2786,404,9345,138
34242,104,1517,2008,1092,33709,425
39158,132,3962,1702,3063,33747,899
10606,10,312,3227,233,6424,79
45254,19,254,608,179,3297,75
24684,25,1260,2466,964,9618,296
8822,1,35,3324,30,8173,5
8548,9,451,3340,332,4793,119
40387,20,577,1622,420,4881,157
19964,7,255,2711,197,5778,58
20528,111,4491,2681,3316,34154,1175
36709,26,1194,1863,897,12322,297
25677,31,1343,2422,1050,19543,293
36959,20,531,1848,448,13012,83
18545,22,1036,2778,812,17027,224
32240,26,518,2084,413,8879,105
5385,145,10912,3520,8251,117772,2661
2242,41,1740,3616,1447,40748,293
21429,59,6726,2628,4843,36207,1883
29710,68,3203,2214,2321,18307,882
2476,8,921,3612,777,9273,144
44869,5,43,740,31,1792,12
4350,73,1884,3569,1452,13313,432
38995,16,875,1713,612,7432,263
42163,44,1203,1382,1014,8768,189
3469,27,611,3594,507,6971,104
39690,10,626,1671,483,16003,143
28250,5,155,2291,130,2827,25
37687,2,120,1802,94,4041,26
4132,185,7187,3577,5374,68087,1813
4472,64,2935,3564,1974,17568,961
21664,63,2363,2614,1854,21747,509
28014,7,343,2305,260,6031,83
5796,12,246,3500,208,9899,38
41605,19,809,1481,600,22797,209
21688,21,498,2613,400,3399,98
43761,3,80,959,74,3442,6
42544,5,93,1304,71,7552,22
22079,2,329,2591,230,7778,99
28953,16,500,2252,422,7173,78
20857,0,372,2663,215,16095,157
43268,180,3600,1118,2698,21355,902
22929,14,373,2548,305,4719,68
12291,73,2904,3140,2228,68821,676
30181,19,275,2191,217,3908,58
20291,13,358,2692,294,8838,64
41529,19,240,1494,191,3350,49
26749,5,264,2374,217,7488,47
39579,2,98,1677,85,5453,13
2845,20,985,3606,798,12959,187
35306,68,2154,1952,1551,19863,603
7636,196,5782,3410,4199,86661,1583
24141,21,1057,2491,844,11739,213
42600,23,609,1295,497,15709,112
38203,19,606,1766,411,5995,195
27892,3,205,2312,155,5745,50
8868,12,336,3321,270,19947,66
14523,54,3093,2979,2452,33031,641
33628,29,504,2029,406,3234,98
17030,13,747,2849,603,14883,144
2050,9,561,3619,408,5713,153
18980,4,155,2760,121,3702,34
18111,77,3036,2796,2284,23231,752
27389,28,1314,2341,908,20860,406
10387,15,763,3240,475,19062,288
30885,7,364,2154,315,6200,49
30792,18,493,2157,373,8265,120
9183,3,81,3302,65,6177,16
11345,30,897,3188,682,8320,215
3420,38,953,3595,794,10146,159
15575,8,403,2920,280,7722,123
21033,13,673,2650,530,10970,143
32334,5,118,2080,101,3589,17
35903,2,33,1910,29,4380,4
9309,13,388,3295,329,5461,59
34983,4,63,1970,54,2406,9
21543,1,129,2621,88,3455,41
25415,37,1653,2435,1257,16601,396
17212,76,6961,2838,4977,39788,1984
8972,8,268,3315,228,18359,40
34828,23,302,1978,241,3474,61
13329,503,127568,3069,95748,163000,31820
10856,4,68,3213,59,4731,9
3626,15,600,3591,520,5627,80
37052,2,287,1841,219,6338,68
42019,40,1159,1411,788,6402,371
15086,26,3224,2944,2488,21464,736
41904,104,1016,1429,786,12123,230
3730,141,8770,3589,6736,104370,2034
8084,46,1243,3370,938,28423,305
30506,33,694,2171,557,10991,137
30757,91,1936,2159,1583,18948,353
30299,2,31,2184,27,1638,4
25882,23,1496,2414,1138,10206,358
28992,352,13779,2250,8260,75047,5519
43110,8,194,1164,143,7013,51
9632,5,388,3274,310,19412,78
21992,16,1668,2596,1253,10812,415
41379,8,367,1515,256,3891,111
30658,12,430,2163,272,8823,158
39881,7,145,1659,101,3258,44
13289,5,417,3073,295,7800,122
8532,73,2223,3341,1689,13383,534
27497,6,270,2335,215,5770,55
31925,2,141,2102,104,4940,37
20497,23,835,2683,704,7229,131
11900,10,320,3160,222,5275,98
4017,6,66,3581,47,3853,19
46481,5,92,135,91,1097,1
42593,37,766,1296,553,17026,213
15486,16,1091,2925,870,53359,221
8337,81,1035,3354,780,12203,255
30261,57,1523,2187,1141,13155,382
22966,1,133,2547,109,4834,24
12956,23,1519,3101,1179,11612,340
5396,39,517,3520,322,10288,195
6224,6,58,3482,50,2824,8
2843,6,608,3606,498,9401,110
23765,4,122,2509,93,5981,29
4651,25,866,3558,728,7701,138
19374,3,326,2742,247,5325,79
29208,18,620,2239,488,10453,132
43715,58,1085,972,842,17953,243
36285,9,127,1885,103,4776,24
9948,123,4852,3260,3605,32116,1247
14058,0,1618,3011,1301,13947,317
7755,16,495,3403,403,7761,92
25449,74,2631,2434,2081,15826,550
6639,16,272,3464,202,7290,70
10634,44,2233,3226,1701,20817,532
19346,55,4524,2743,3102,23412,1422
38680,9,379,1732,316,13706,63
19971,0,94,2710,77,3528,17
43149,4,193,1152,145,5266,48
35164,5,197,1960,160,5318,37
25889,2,108,2413,86,4946,22
43640,1,18,997,15,1104,3
18926,2,81,2762,68,2422,13
41967,6,189,1418,141,4817,48
37602,1,52,1807,46,2451,6
5605,2,152,3510,122,3966,30
11909,64,2739,3160,2138,18996,601
45802,90,985,420,839,9674,146
32622,46,1428,2068,1025,12719,403
12718,517,36605,3115,22789,294710,13816
41321,34,1235,1523,871,23995,364
33486,34,449,2033,354,4382,95
43461,8,105,926,67,1627,38
2384,26,1118,3613,832,17992,286
19373,153,7462,2742,5052,72449,2410
17573,179,10968,2820,7430,72120,3538
8775,7,342,3327,234,8906,108
7543,13,143,3416,123,2859,20
21345,18,726,2633,600,4087,126
34565,23,459,1993,373,7313,86
2692,53,1330,3608,1127,28572,203
38822,3,55,1723,46,1895,9
37365,52,958,1823,741,6214,217
10655,129,4372,3224,3388,27837,984
4501,13,341,3564,263,9947,78
958,6,272,3945,231,9925,41
25016,5,149,2452,127,3703,22
3260,15,496,3598,395,3254,101
34934,13,498,1972,395,10641,103
23271,12,557,2533,456,9824,101
19487,175,4137,2736,3084,16083,1053
13063,52,873,3095,695,15751,178
25080,5,378,2449,313,3149,65
19554,1,143,2733,109,6106,34
40871,32,644,1577,472,7650,172
25781,4,252,2418,195,4647,57
23947,326,30375,2500,22915,125331,7460
3748,7,187,3588,147,7653,40
2605,13,376,3609,196,9609,180
40579,525,15746,1604,11858,91037,3888
14216,142,9243,3003,7052,51089,2191
26265,1,111,2396,89,9031,22
41040,111,4497,1564,2925,40460,1572
4080,6,155,3579,118,9597,37
20128,4,237,2702,176,4549,61
19536,110,4859,2734,3561,26802,1298
26285,11,405,2395,300,2797,105
24399,100,5723,2480,4081,38501,1642
15625,22,1245,2918,880,17748,365
33239,3,365,2043,306,8988,59
38544,10,287,1741,245,7970,42
40284,14,2030,1632,1528,18682,502
38602,7,195,1737,160,3946,35
44923,12,201,726,145,3515,56
21446,20,641,2627,525,6895,116
22140,25,1512,2588,971,11987,541
21090,7,317,2648,233,9317,84
27743,4,198,2321,155,3537,43
19047,11,515,2757,408,5587,107
13577,9,838,3050,546,11720,292
5875,22,540,3496,445,5696,95
4173,0,8,3575,7,1535,1
33439,2,102,2036,66,4204,36
16671,35,1754,2869,1323,47530,431
19272,28,640,2747,489,4560,151
16714,1,598,2867,417,8474,181
29127,43,1040,2243,872,10872,168
34079,188,7238,2013,5551,40276,1687
9935,3,146,3261,122,6765,24
2926,27,793,3604,630,7401,163
42225,7,254,1369,171,4382,83
3943,9,459,3583,367,25526,92
29267,6,381,2236,281,4315,100
30357,67,1632,2181,1204,11039,428
32231,2,149,2085,127,2930,22
43329,5,168,1101,153,4402,15
7457,24,109445,3421,42563,15454,66882
8567,10,110,3339,86,2946,24
30597,1,195,2167,162,5547,33
38591,62,1743,1738,1376,30056,367
22973,4,363,2547,254,8702,109
45646,186,10362,486,6576,65376,3786
29476,5,86,2225,67,2057,19
23331,25,1525,2530,956,7648,569
2251,29,1141,3616,391,32620,750
9959,2,315,3259,234,3047,81
12012,9,391,3154,296,8692,95
35511,106,5893,1940,4476,21716,1417
7841,5,276,3396,210,3220,66
19222,29,1190,2750,944,16951,246
13844,27,984,3030,819,26979,165
43265,8,229,1119,173,5535,56
24096,3,291,2494,249,4811,42
15102,55,2385,2943,1750,28532,635
43882,43,739,938,632,14813,107
28115,3,316,2300,275,7444,41
13646,3,60,3045,50,4475,10
12173,51,1194,3146,855,5506,339
34676,32,344,1987,285,6157,59
12949,1,82,3102,46,2325,36
6654,3,35,3464,31,4640,4
8270,46,1274,3359,1017,11985,257
20963,78,3775,2655,2503,40121,1272
44832,0,11,751,10,1530,1
2459,72,3915,3612,3063,61861,852
29582,6,128,2220,101,3661,27
32654,39,508,2067,377,4862,131
42385,176,4917,1339,3664,24723,1253
17452,7,450,2826,376,10463,74
28632,2,112,2268,90,3410,22
36602,3,72,1869,65,4638,7
15236,40,2852,2936,2080,42053,772
3252,14,706,3598,570,4041,136
35016,0,21,1968,15,1982,6
35655,8,221,1929,164,3233,57
27923,16,573,2310,461,10284,112
18434,400,10557,2782,7408,25962,3149
22455,1,0,2573,0,5762,0
22344,40,1102,2578,854,7378,248
45050,3,34,686,25,2238,9
8751,5,72,3328,60,2394,12
2937,116,3058,3604,2167,19397,891
9497,47,1110,3282,883,17890,227
35774,37,2023,1919,1655,20212,368
45088,80,811,667,592,11194,219
35636,18,1034,1931,740,13949,294
13633,108,5952,3047,4723,77727,1229
4148,23,666,3576,521,14346,145
25576,21,1254,2428,973,29147,281
6809,12,155,3456,125,9618,30
34589,23,1015,1992,812,10278,203
6442,4,40,3473,33,4351,7
32566,0,155,2070,122,6041,33
33151,35,441,2046,354,6759,87
5812,18,283,3499,247,3203,36
18802,14,859,2766,665,6994,194
11696,71,2244,3169,1751,7754,493
8098,41,2483,3369,1953,9446,530
15568,2860,704139,2920,404842,1193981,299297
33833,8,483,2020,378,9676,105
22898,9,369,2551,291,8550,78
40206,31,947,1638,649,7144,298
37391,27,396,1821,310,8804,86
42851,3,140,1237,131,9177,9
36315,4,116,1884,103,1901,13
2663,3,81,3609,64,2343,17
11826,2,98,3163,78,7463,20
9931,33,1213,3261,924,10416,289
41803,4,68,1447,50,7806,18
33513,16,405,2032,324,11400,81
12938,12,913,3103,765,8347,148
28472,22,2264,2279,1726,11438,538
15188,8,114,2938,95,3241,19
2873,6,214,3605,173,5029,41
11493,53,3256,3179,2493,28991,763
39883,6,191,1659,155,5776,36
1864,7,248,3623,184,6272,64
39337,1,58,1691,48,3691,10
25475,14,334,2433,264,4922,70
20161,69,2569,2700,1965,24566,604
45365,11,95,576,70,2041,25
43286,22,442,1112,345,5529,97
5420,6,152,3519,132,3996,20
21111,100,3604,2647,2761,27109,843
27610,71,1323,2328,1012,14492,311
18361,1,81,2785,65,2782,16
2395,53,1699,3613,1384,29723,315
21703,10,454,2612,332,5906,122
42995,31,1034,1198,777,14886,257
22635,29,1591,2564,1160,27515,431
18458,1,98,2782,69,2452,29
41249,6,310,1534,228,14681,82
45746,24,264,440,196,2591,68
34935,49,676,1972,538,7661,138
31132,16,614,2142,485,12378,129
25946,102,4250,2410,3581,17569,669
17944,9,265,2805,218,9673,47
31915,12,375,2102,307,5850,68
5592,26,1430,3511,1145,41643,285
21719,26,912,2611,670,7813,242
41324,153,1875,1522,1320,15855,555
8591,6,140,3338,110,2151,30
37881,3,33,1787,27,1964,6
33130,1,150,2047,133,2673,17
43564,13,164,1026,118,5601,46
4231,11,313,3574,237,4533,76
20486,6,102,2684,87,1750,15
2977,75,6240,3603,4480,29265,1760
13068,0,113,3094,97,8390,16
3244,381,37019,3598,25017,152310,12002
32760,89,5253,2063,3366,28531,1887
17989,13,2819,2802,2105,60379,714
22549,46,528,2567,401,5385,127
19509,367,18359,2735,13103,69192,5256
32873,2,107,2057,71,2902,36
15662,25,896,2916,718,14934,178
43953,40,532,925,431,9588,101
20076,31,1017,2705,836,18379,181
2507,264,10865,3611,8486,87129,2379
3592,31,493,3592,381,13452,112
18274,10,666,2789,523,9646,143
43435,20,314,1067,254,5780,60
40746,49,1764,1590,1404,28319,360
33560,198,4102,2031,3053,22966,1049
11993,3,136,3155,109,4190,27
12898,112,4225,3105,3190,57048,1035
36631,62,3075,1867,2312,32187,763
14091,4,188,3009,145,3899,43
23710,21,640,2511,505,9600,135
13094,24,1903,3092,1313,12794,590
8187,111,3479,3364,2222,13334,1257
11551,1,52,3176,44,2403,8
26470,3,105,2387,95,3269,10
43986,18,260,920,176,5859,84
25704,184,6327,2421,4765,43163,1562
26374,2,95,2391,81,1979,14
46308,1,47,220,36,1078,11
45586,29,319,513,250,5341,69
3249,15,626,3598,487,3545,139
31476,24,830,2124,682,15577,148
38092,27,1493,1774,1141,23937,352
34758,29,1022,1983,820,11586,202
11069,2,79,3202,70,2243,9
10318,100,1651,3243,1247,37119,404
3156,5,350,3600,223,8862,127
1512,7,169,3706,128,5061,41
40366,18,693,1623,472,12892,221
2040,99,3355,3619,2751,22712,604
23322,66,2255,2530,1675,29154,580
10400,3914,360234,3239,223420,856209,136814
28775,3,207,2261,166,6353,41
25904,113,8266,2412,6050,61481,2216
32529,34,2197,2072,1776,33411,421
32279,1,19,2083,15,2099,4
23774,84,3730,2509,2964,36844,766
2124,13,329,3617,277,6159,52
42509,15,239,1312,198,7894,41
27349,12,4474,2344,3559,4127,915
19275,15,259,2746,204,4024,55
37315,29,732,1825,519,6359,213
11656,75,3701,3171,2774,36789,927
15847,60,3862,2909,2648,26902,1214
41649,1,47,1474,38,2869,9
30858,9,251,2154,206,4246,45
31610,391,39333,2117,24808,176898,14525
21311,13,461,2635,285,10518,176
36538,3,50,1873,42,1335,8
45488,40,983,544,761,7594,222
13159,6,174,3080,149,7152,25
4521,2,82,3563,71,3590,11
34172,4,207,2010,149,3175,58
3224,33,1183,3599,914,8728,269
42298,7,165,1355,116,3597,49
24853,35,2090,2459,1603,30939,487
13204,37,812,3078,578,6814,234
31679,21,1194,2113,887,27047,307
11455,85,6695,3182,5103,41570,1592
16473,0,33,2879,22,1526,11
33406,97,4662,2037,3663,33693,999
39945,10,439,1654,333,7932,106
36816,3,242,1856,204,6026,38
27682,9,424,2324,336,5497,88
36257,8,251,1888,216,5511,35
26852,29,1757,2369,1328,25220,429
11741,82,2067,3167,1658,32039,409
27546,36,1492,2332,1127,9459,365
19754,48,1901,2722,1480,21555,421
12929,11,528,3103,403,7125,125
34665,3,153,1987,133,8938,20
42188,148,3780,1376,3204,39075,576
31908,145,4547,2102,3581,27789,966
18252,8,472,2790,394,3066,78
6723,6,185,3461,153,5182,32
28496,25,964,2278,663,19250,301
40055,77,1867,1647,1415,16708,452
9519,36,772,3281,618,20105,154
20720,8,669,2671,519,6550,150
4015,7,221,3581,174,10041,47
20645,1,45,2676,39,1636,6
12102,33,846,3150,642,16483,204
29997,4,101,2200,84,2608,17
3240,47,1694,3598,1391,10611,303
2827,2,41,3606,28,5191,13
43785,58,764,950,589,11749,175
44669,27,506,806,408,16167,98
6013,8,224,3489,180,2360,44
46242,3,19,246,12,843,7
42843,82,1982,1238,1439,41991,543
23416,0,103,2525,81,9412,22
3242,11,611,3598,287,11114,324
12042,6,69,3153,57,1932,12
9929,5,413,3261,324,8845,89
21534,33,1153,2622,918,7786,235
19111,33,681,2755,496,5399,185
45672,7,62,473,48,3526,14
39787,13,155,1666,131,4283,24
7700,118,3463,3406,2648,36691,815
16999,28,507,2852,386,3974,121
41652,165,5514,1474,3813,45064,1701
36726,31,433,1863,343,6929,90
30951,23,438,2151,348,10541,90
19907,14,621,2714,496,8628,125
15993,3,274,2902,245,7769,29
10890,23,2175,3211,1716,51928,459
28097,1,32,2301,27,6651,5
39600,17,586,1675,432,14709,154
38754,2,179,1727,132,4096,47
12071,12,985,3152,623,19533,362
4093,32,1164,3578,931,11889,233
16308,1752,116937,2887,71253,574221,45684
18007,53,1918,2801,1357,33974,561
19281,9,576,2746,429,5942,147
37942,6,129,1783,118,4993,11
34641,2,90,1988,68,2397,22
31112,20,583,2143,469,6713,114
11411,7,371,3185,276,2374,95
29431,26,1151,2227,882,13666,269
6976,36,1898,3448,1370,18579,528
41058,14,169,1560,127,3744,42
43082,11,159,1172,100,3044,59
10319,12,197,3243,156,8241,41
6903,22,615,3452,495,6441,120
31274,17,1091,2135,848,15574,243
13167,13,1530,3080,1211,22725,319
12364,3,167,3135,128,3347,39
30227,2,96,2188,77,1958,19
5441,37,1284,3518,1019,12000,265
6012,6,215,3489,166,2075,49
23055,42,1143,2543,922,14290,221
20588,15,1783,2678,1399,7030,384
32979,21,562,2053,432,12573,130
19977,3,96,2709,83,5421,13
26685,108,2809,2377,2287,35166,522
2745,9,631,3608,520,8500,111
5824,76,2808,3498,1868,14940,940
27656,12,350,2325,281,3564,69
43611,0,15,1006,12,1993,3
46092,1,23,301,19,696,4
40975,221,5865,1569,4359,45531,1506
32022,15,377,2096,302,11745,75
31424,157,3849,2128,3060,39268,789
34144,4,706,2011,475,17565,231
3795,213,6927,3588,5507,174704,1420
28211,1,26,2293,21,4378,5
30948,48,966,2152,798,18429,168
15018,9,292,2948,249,6547,43
23261,65,1580,2533,1215,12382,365
6709,13,557,3461,444,7494,113
3412,3,44,3595,37,3074,7
4552,87,1352,3562,1092,15603,260
20487,45,3741,2684,2868,17690,873
36927,9,280,1850,227,12816,53
41261,62,806,1532,563,9512,243
11869,5,610,3162,527,11454,83
46291,2,38,229,24,1484,14
14645,39,2267,2971,1703,19122,564
45558,16,217,518,139,2496,78
21215,1,56,2639,45,4303,11
19002,28,610,2759,436,5762,174
13675,8,523,3043,367,6613,156
39908,1,52,1657,39,4419,13
8734,2,105,3329,73,3113,32
45131,25,212,644,144,3671,68
7120,7,152,3440,135,12742,17
45744,193,2452,440,2067,19941,385
17584,10,588,2819,419,6812,169
45105,50,487,656,391,6052,96
16417,324,19748,2881,12796,159207,6952
1267,4,135,3843,115,5164,20
45508,2,30,540,21,1477,9
17237,427,23261,2836,16253,125316,7008
16478,19,758,2879,608,12786,150
45001,27,294,704,165,4952,129
7967,6,95,3382,89,2365,6
23536,0,32,2520,27,8042,5
43552,64,1481,1030,1090,22821,391
10933,77,3188,3209,2475,34676,713
14953,0,288,2951,206,2437,82
34619,41,829,1990,623,5451,206
28362,28,790,2285,608,8311,182
6600,8,475,3466,333,5523,142
37729,43,2826,1799,2207,21122,619
22672,6,215,2562,190,5147,25
44700,36,589,796,450,13501,139
6263,21,854,3481,684,13326,170
24088,73,7832,2494,5802,88267,2030
12522,1,0,3126,0,2308,0
7185,5,139,3436,91,4076,48
2473,151,5264,3612,4060,59193,1204
29452,9,324,2226,241,3822,83
7422,2,55,3423,40,2356,15
44956,16,461,717,274,6899,187
37833,73,1560,1790,1275,22962,285
35170,21,254,1960,223,4303,31
5401,3,79,3519,62,5423,17
39309,12,456,1692,368,8093,88
38666,3,68,1733,56,2416,12
32321,29,672,2081,522,9195,150
2798,58,2391,3606,1867,17068,524
27144,74,1772,2357,1365,17542,407
3991,60,4044,3581,2617,15756,1427
39538,64,4643,1680,3564,16999,1079
9038,4,157,3312,121,5241,36
11365,2,105,3187,76,1362,29
19403,36,2235,2740,1742,43227,493
35965,21,815,1906,673,12210,142
34590,2,114,1992,94,4105,20
9131,30,1897,3306,1394,28635,503
32147,5,137,2089,116,3486,21
38234,34,1228,1764,947,14315,281
16013,2,156,2902,120,4638,36
9026,1,106,3313,85,7835,21
24372,186,5973,2481,4566,59119,1407
28191,0,182,2295,130,1879,52
37160,7,216,1835,181,5649,35
19851,18,905,2717,636,10232,269
15478,126,6375,2926,4775,60649,1600
45731,4,52,443,30,1854,22
25479,0,98,2432,78,3903,20
13785,7,316,3034,262,7403,54
19161,3,174,2753,130,3468,44
33468,5,241,2034,188,2974,53
32123,6,153,2090,122,6700,31
44501,1145,17745,839,14945,82839,2800
41399,141,3299,1511,2293,17015,1006
7852,11,430,3394,337,14377,93
41532,10,142,1494,98,5588,44
29045,11,550,2248,455,8407,95
46393,3,30,184,28,643,2
16136,23,929,2895,739,9381,190
9383,9,214,3289,186,4153,28
3023,1,56,3602,44,4328,12
18049,6,421,2799,294,8437,127
42240,37,1331,1365,883,16905,448
37150,28,1407,1836,1126,22700,281
13093,246,12809,3092,8943,46529,3866
13679,44,1106,3043,847,27074,259
33003,1086,35051,2052,26072,176404,8979
25624,5,331,2425,283,6039,48
35176,3,77,1959,62,2832,15
8691,8,188,3331,142,3476,46
33127,131,3258,2047,2519,25959,739
39198,2,143,1699,107,4423,36
13961,1,98,3019,84,3110,14
11607,40,2645,3174,2028,40932,617
14643,175,9177,2971,6359,48952,2818
38407,12,347,1752,276,7764,71
9429,39,1912,3287,1583,28899,329
37716,0,472,1800,360,12734,112
30980,92,2702,2150,2066,34432,636
11152,28,1522,3197,1198,29899,324
45987,14,101,346,88,1963,13
32520,4,130,2073,115,4630,15
18922,8,445,2762,344,10116,101
12317,28,1679,3138,1225,19041,454
18285,96,4912,2789,3594,20220,1318
32508,229,3533,2073,2823,17363,710
14876,6,743,2956,557,15381,186
20307,1,31,2692,26,4776,5
19367,19,386,2742,278,3876,108
40041,19,795,1648,533,8365,262
8281,27,1075,3359,765,16069,310
37191,1,155,1833,121,6731,34
46445,6,59,151,57,1550,2
6742,2,278,3460,158,4711,120
1929,8,115,3621,93,8512,22
32915,23,1360,2056,961,16084,399
37721,50,1078,1799,774,13735,304
43042,9,235,1185,168,3827,67
35690,1,56,1926,51,17933,5
22875,3,166,2552,120,3255,46
34753,206,3433,1983,2405,17676,1028
13060,27,764,3095,608,11089,156
44978,228,2391,710,1933,31982,458
26929,97,4907,2366,3309,42030,1598
8495,25,1169,3344,837,11039,332
29597,17,590,2220,488,11794,102
11232,141,8606,3193,6452,46657,2154
43228,33,720,1129,485,15397,235
8634,3,165,3336,140,7412,25
7877,55,1791,3392,1393,10847,398
36735,2,41,1862,30,2791,11
7989,143,8722,3380,6606,116285,2116
1855,15,277,3623,241,15299,36
8574,300,8767,3339,6930,44462,1837
21864,21,1519,2604,1141,13501,378
2096,41,1656,3618,1190,10041,466
15982,61,3640,2903,2772,19149,868
30208,38,742,2189,611,6593,131
26783,111,1646,2372,1243,12452,403
33346,202,19064,2039,12949,92744,6115
43870,133,5742,939,4265,31216,1477
31327,45,2072,2132,1639,9048,433
35002,0,49,1969,39,1961,10
11359,4,136,3187,97,7251,39
16027,2,152,2901,118,3810,34
22043,17,771,2593,594,15966,177
14169,5,82,3007,71,4609,11
38299,30,2058,1759,1503,23850,555
19982,15,345,2709,293,4755,52
17962,11,524,2804,407,4815,117
46463,14,223,143,214,2202,9
2529,51,1627,3611,1151,12667,476
41023,150,6124,1566,4039,43635,2085
10337,15,754,3242,552,10381,202
46331,2,12,154,9,550,3
26849,136,6134,2369,4812,34623,1322
23299,0,3328,2531,2218,50569,1110
30798,19,424,2157,301,3637,123
45850,7,97,404,67,3061,30
2958,25,1940,3604,1546,17745,394
23062,119,3399,2543,2548,18666,851
9049,14,539,3312,409,9527,130
8068,14,123,3371,104,5291,19
26452,7,393,2387,290,9696,103
16584,0,96,2874,76,6510,20
33104,12,516,2048,389,4532,127
16923,14,1275,2855,908,15469,367
28310,51,565,2288,471,4905,94
2435,61,6740,3612,5285,82008,1455
21055,170,7508,2650,5194,28947,2314
36742,0,41,1862,34,4052,7
1194,18,852,3864,698,16524,154
12802,3,179,3111,141,4026,38
41791,9,329,1449,285,12795,44
33221,39,1727,2044,1292,23924,435
1259,3,44,3845,39,2747,5
35777,1,26,1919,22,2284,4
5103,13,208,3536,157,2515,51
6519,0,28,3469,24,4950,4
6979,6,354,3447,276,6823,78
41779,56,2020,1452,1535,22051,485
24593,21,314,2470,250,12600,64
6275,3,60,3480,52,3098,8
10594,14,206,3228,171,5830,35
25493,16,904,2432,687,8829,217
18170,6,439,2794,337,7609,102
32054,0,40,2094,21,2727,19
25506,0,67,2431,60,1815,7
32998,9,214,2053,175,4718,39
40006,8,89,1650,72,3564,17
5939,82,2670,3492,2125,25593,545
34888,45,6824,1974,5280,30195,1544
20311,6,116,2692,90,10749,26
23783,1393,86432,2509,62936,188972,23496
34796,14,183,1980,149,4249,34
38163,246,11002,1769,8298,37791,2704
32592,2,186,2069,150,4118,36
2362,17,694,3614,560,51844,134
42267,5,358,1360,264,12030,94
30052,9,744,2197,570,7246,174
39645,20,360,1673,263,5971,97
42039,26,1012,1407,809,15507,203
11989,133,7380,3155,5836,65380,1544
3086,6,152,3601,113,11686,39
20468,23,661,2685,519,13612,142
41648,0,26,1475,20,2422,6
38123,3,51,1771,41,3077,10
27469,26,610,2337,372,5719,238
10875,9,683,3212,564,19109,119
22047,0,86,2593,69,2538,17
15580,131,5771,2920,4442,59673,1329
33691,15,541,2026,424,18886,117
32901,19,319,2056,271,4860,48
44373,18,295,857,213,4230,82
17826,36,1418,2811,1092,8871,326
4641,28,421,3558,332,11560,89
6745,2,51,3460,38,1831,13
12228,7,135,3143,116,7204,19
32221,11,1009,2085,789,11484,220
8958,743,35013,3316,25318,152942,9695
6960,1485,79191,3448,50629,495272,28562
26382,0,347,2390,277,4501,70
44775,21,205,769,180,5476,25
21084,2,180,2648,148,4507,32
33842,0,29,2020,26,1965,3
13343,2,70,3068,60,4694,10
46255,3,74,243,54,1179,20
42040,6,409,1407,280,7338,129
3137,24,1035,3600,817,9853,218
42206,16,266,1373,211,10425,55
37045,1,90,1842,71,2780,19
22703,3,0,2561,0,13346,0
10308,66,2516,3243,1840,26028,676
10947,415,17236,3208,12933,55869,4303
30558,9,297,2169,235,5082,62
14817,24,1572,2959,1108,19720,464
26149,6,376,2402,291,4951,85
39103,7,146,1705,119,4194,27
37937,4,105,1783,70,3659,35
4955,651,34409,3544,25473,91210,8936
46474,12,98,138,97,1582,1
3270,8,174,3598,134,8995,40
24073,25,808,2495,628,8413,180
33254,3,212,2043,174,6869,38
35196,5,349,1959,288,7149,61
14019,24,1432,3014,1156,29585,276
43285,120,1601,1113,1259,24915,342
12248,696,50370,3142,37606,197261,12764
24129,2,109,2492,75,3007,34
46453,10,156,148,132,1634,24
41718,110,1046,1464,732,10634,314
32693,5,228,2065,182,4989,46
8346,54,1771,3353,1272,15410,499
4099,35,776,3578,633,9970,143
951,3,126,3947,96,3941,30
30294,13,446,2185,366,10049,80
13624,0,6436,3048,4531,93544,1905
36136,0,46,1893,40,3778,6
31703,2,44,2112,37,2265,7
17895,52,1671,2808,1370,13303,301
16935,239,17452,2855,12802,108535,4650
7066,8,493,3442,389,4815,104
5622,52,3546,3509,2713,69477,833
24067,20,654,2495,519,8232,135
16418,54,3236,2881,2294,20574,942
14118,585,27088,3008,18763,103429,8325
39294,14,397,1693,319,10184,78
24929,43,2291,2456,1741,34453,550
26763,70,2902,2373,1908,35659,994
38538,6,372,1742,231,6021,141
9200,19,237,3301,191,8378,46
4356,10,378,3569,335,8279,43
28583,331,17253,2271,12616,116742,4637
21751,3,152,2610,123,3588,29
34115,6,339,2011,252,4267,87
28252,3,134,2291,113,4367,21
4922,111,3852,3545,2732,22760,1120
12866,112,5257,3106,3847,43547,1410
19922,6,614,2713,471,6353,143
31426,9,233,2127,200,4013,33
9606,34,733,3276,560,11625,173
41676,13,159,1470,112,2995,47
1743,11,522,3644,425,8406,97
5191,46,940,3531,719,7514,221
40961,30,1023,1570,818,12192,205
14172,23,1561,3006,1170,18563,391
29667,3,91,2216,80,3730,11
18636,6,683,2774,574,9541,109
5754,4,443,3502,333,11967,110
40549,883,24679,1607,18861,110079,5818
38901,2,124,1718,105,2269,19
45233,2,50,614,38,1315,12
9472,8,395,3284,292,6891,103
14839,71,3382,2958,2481,27634,901
25626,2,92,2425,77,2967,15
36858,7,210,1853,170,2946,40
4414,36,1009,3567,786,25131,223
40311,5,83,1631,59,3964,24
43916,31,289,929,233,5225,56
25343,37,1119,2438,897,6835,222
41126,7,234,1551,180,9100,54
26196,402,8708,2399,6460,40528,2248
46216,0,9,252,7,590,2
22737,54,2754,2559,1980,28668,774
31149,3,67,2142,60,2105,7
28648,2,130,2268,106,3838,24
3581,8,97,3592,79,4393,18
26782,1,93,2372,78,4104,15
30550,10,695,2169,516,7132,179
23257,44,2241,2534,1642,21416,599
8193,2,112,3364,89,3338,23
22661,14,922,2563,649,9396,273
35879,6,93,1912,81,3111,12
3819,12,565,3587,423,9785,142
40349,0,41,1626,36,3218,5
43574,78,817,1024,650,11731,167
15211,10,176,2937,143,5133,33
34355,222,7263,2003,5345,38263,1918
34171,2,61,2010,50,2299,11
41914,65,2238,1428,1561,19324,677
41607,18,730,1481,555,9157,175
3781,4,69,3588,54,3414,15
24106,15,362,2493,279,5477,83
9138,2,143,3306,107,3472,36
46053,5,54,312,35,875,19
17145,15,749,2842,616,22950,133
28763,392,12569,2261,10059,45940,2510
29775,5,352,2210,272,3703,80
31699,17,1710,2112,1331,10109,379
5147,84,2485,3533,1913,17417,572
2063,279,10545,3618,8239,81469,2306
41267,54,1184,1531,842,18565,342
28416,2,178,2282,158,3617,20
41133,2,82,1551,63,4780,19
11749,123,20452,3166,15409,99132,5043
45942,4,111,361,60,2847,51
19348,10,233,2743,189,3697,44
30089,48,1890,2196,1539,33299,351
22364,50,3179,2578,2303,29569,876
3336,10,231,3597,171,17822,60
39247,7,315,1695,233,6351,82
21532,17,1009,2622,822,5590,187
35752,24,590,1922,489,22130,101
25226,815,29651,2443,21991,114306,7660
7274,7,57,3432,48,2511,9
3594,9,548,3592,454,34580,94
15905,15,1415,2907,1074,14176,341
4799,50,1899,3552,1406,34498,493
19771,5,407,2721,339,4959,68
21326,1,72,2633,59,8584,13
12699,9,219,3116,179,7370,40
3079,216,8391,3601,6603,90021,1788
43464,151,2422,1060,1873,25330,549
39182,1,138,1701,102,4644,36
20599,7,249,2678,189,3543,60
46431,24,265,160,226,6190,39
35648,4,130,1929,112,4760,18
8357,379,200608,3353,65295,122574,135313
6555,11,299,3467,246,23375,53
42879,80,824,1231,625,8578,199
12941,22,728,3103,548,4462,180
32572,2147,106351,2070,63145,487836,43206
23013,16,1433,2545,1059,12183,374
33390,21,484,2037,372,3725,112
2992,175,10919,3603,7048,82390,3871
12868,9,302,3106,225,4820,77
42664,27,204,1280,136,4212,68
39056,62,3180,1709,2260,16950,920
24015,25,2866,2497,2141,32614,725
6770,258,6059,3458,4449,62744,1610
43487,147,2396,1054,1811,46076,585
23399,2,92,2526,77,2049,15
8180,2,71,3365,53,2140,18
13762,2,174,3035,128,3296,46
46443,2,37,153,28,1572,9
8260,9,1128,3360,832,13888,296
26393,2,232,2390,189,2388,43
4546,15,498,3562,416,8158,82
6991,9,461,3447,351,8286,110
42875,29,479,1231,362,5002,117
38090,137,7508,1774,5641,38850,1867
7359,27,832,3426,690,10304,142
22697,56,3750,2561,2481,34579,1269
14069,6,135,3011,100,3762,35
27314,26,728,2347,615,12871,113
41526,174,4059,1494,2976,27910,1083
33495,6,223,2033,184,4240,39
20576,35,1788,2679,1375,25905,413
19609,44,2134,2731,1617,22239,517
25727,15,500,2420,409,5784,91
9722,46,1146,3271,910,9170,236
25064,17,82,2450,75,9197,7
1823,20,4590,3625,3619,20829,971
10842,119,28460,3214,19273,122126,9187
33027,6,167,2051,134,3112,33
10930,4,173,3209,128,7806,45
12867,6,426,3106,354,2989,72
14794,143,10216,2960,7450,39404,2766
29940,5,127,2202,104,2107,23
35004,62,3101,1969,2368,22258,733
32951,3,191,2055,135,7374,56
20263,1,88,2693,76,2695,12
43316,10,184,1105,156,13830,28
6362,9,358,3476,266,6255,92
25188,0,212,2444,167,3983,45
8259,1,11,3360,8,1754,3
20072,84,4203,2705,3116,24182,1087
17168,21,1934,2840,1558,18187,376
32239,15,233,2084,174,3123,59
31186,11,200,2139,160,4059,40
45831,78,464,410,390,8627,74
44245,0,19,875,16,3687,3
4025,88,12219,3580,7034,63561,5185
30143,1,67,2193,57,4908,10
35308,82,745,1952,575,5652,170
36246,94,2848,1888,2244,16279,604
35718,0,53,1923,47,5248,6
9410,7,145,3288,122,6936,23
40496,89,1518,1611,1169,15852,349
26369,35,900,2391,738,6759,162
3597,15,1582,3592,1213,8452,369
21004,21,1015,2652,843,6391,172
45624,39,438,496,323,4924,115
18598,3,319,2776,261,8663,58
40998,87,4134,1568,2887,19525,1247
18360,86,2791,2785,2120,15852,671
15494,108,7659,2925,5512,38627,2147
17904,27,876,2807,688,6829,188
12649,3,559,3119,447,13960,112
37847,54,1707,1789,1390,20555,317
40764,21,597,1588,450,6989,147
36495,18,1185,1875,759,59070,426
35335,41,2163,1951,1777,19840,386
24532,2,446,2474,357,5880,89
26363,12,558,2391,446,6942,112
45775,7,187,427,149,2434,38
24374,31,2256,2481,1768,17307,488
38279,112,2185,1761,1678,16949,507
37580,33,974,1808,807,7925,167
33971,31,1182,2016,925,16584,257
9453,22,800,3285,618,6485,182
7556,7,240,3415,202,5921,38
4735,12,195,3555,167,11348,28
40059,8,131,1647,97,1943,34
39797,0,26,1665,22,2632,4
43463,56,1140,1059,879,24213,261
9145,4,163,3305,135,4812,28
43660,171,2155,990,1750,16924,405
42371,22,254,1341,168,3983,86
11678,3,170,3170,138,4466,32
3503,8,362,3594,290,7972,72
25138,0,4305,2446,3132,31422,1173
9545,46,1251,3280,898,6650,353
4533,5,66,3562,46,3352,20
24125,18,896,2492,747,6672,149
30250,2,36,2187,32,3022,4
20651,14,445,2675,321,16623,124
36201,11,366,1890,273,5901,93
26358,42,1409,2391,1056,12131,353
34417,2,89,2000,72,5329,17
32573,21,303,2070,251,4497,52
10527,227,8143,3232,6247,46375,1896
4387,1515,109314,3568,74292,331468,35022
42034,5,80,1408,67,3682,13
8104,239,10474,3369,6956,60990,3518
18259,1,55,2790,43,1999,12
10949,9,179,3208,141,4374,38
3783,5,112,3588,85,5468,27
2666,28,659,3609,491,6867,168
18943,0,6673,2761,4737,40972,1936
14236,0,232,3001,182,19565,50
38433,9,211,1749,175,5569,36
36424,1,143,1879,120,3323,23
35067,7,270,1965,201,8758,69
14742,1,48,2965,41,3210,7
7068,6,133,3442,102,4172,31
42064,0,0,1403,0,1371,0
22348,23,1165,2578,890,9098,275
7233,51,1330,3434,1042,23205,288
17868,18,512,2809,441,8441,71
9344,17,470,3292,359,10951,111
40358,4,182,1624,124,4433,58
21587,11,701,2619,555,7708,146
44007,85,547,915,438,9203,109
5872,20,272,3496,212,18188,60
15822,7,308,2909,237,16589,71
44937,13,89,724,64,3458,25
4655,20,583,3558,454,21822,129
27178,27,595,2355,467,6777,128
34464,19,455,1999,361,12646,94
12251,53,1504,3141,1145,9367,359
37825,2320,118774,1791,82422,384439,36352
20918,5,288,2658,242,2166,46
30479,5,69,2174,59,2891,10
3723,0,11,3589,10,2010,1
36500,17,418,1875,304,12921,114
39381,20,607,1688,453,6046,154
27369,1,73,2343,57,2255,16
6887,74,1100,3453,830,8429,270
35094,12,648,1964,498,10409,150
40735,8,429,1591,269,5169,160
39046,58,1876,1710,1422,20765,454
17635,8,186,2817,149,3334,37
12851,56,2741,3107,2018,18194,723
18686,18,1016,2771,798,9467,218
42469,2,241,1320,182,6666,59
4281,2,71,3572,57,6747,14
13868,35,2589,3028,1972,17568,617
19314,18,678,2744,577,25608,101
40964,329,12814,1570,8487,93229,4327
45378,224,2637,573,2208,21382,429
6061,0,35,3488,26,4227,9
37513,148,4379,1813,3086,42081,1293
45470,0,40,550,28,2237,12
42614,34,378,1291,289,5659,89
30888,8,169,2154,141,5346,28
28433,7,95,2281,78,3211,17
22957,21,978,2547,774,9336,204
17246,16,1081,2836,817,10839,264
15049,7,533,2946,417,13120,116
27116,2,123,2359,105,2935,18
3102,2,65,3601,54,2352,11
3953,10,462,3583,353,19343,109
35064,6,238,1966,182,8870,56
11801,2,116,3164,103,10172,13
13489,21,1413,3056,1051,17533,362
39129,14,592,1704,450,9560,142
46222,2,41,251,29,1635,12
22388,74,2573,2576,1929,23880,644
32442,5,422,2076,303,4216,119
38311,11,391,1758,297,11191,94
42058,5,469,1404,363,16349,106
36376,1,73,1881,62,3010,11
14259,298,7052,3000,5089,41970,1963
16738,149,9671,2865,6362,54558,3309
18709,74,2169,2771,1692,20597,477
3816,96,6308,3587,4825,35381,1483
40618,135,2817,1601,2116,26839,701
45756,0,20,436,14,1332,6
11560,3,124,3176,105,2597,19
45547,24,323,523,227,2992,96
31622,12,368,2116,306,4789,62
43198,3,70,1140,55,2497,15
37293,2,78,1827,64,4400,14
44440,59,863,848,647,9215,216
39100,11,369,1706,272,5886,97
27372,83,3030,2343,2351,32511,679
29025,5,349,2249,291,13576,58
7282,1,101,3431,89,3108,12
31116,257,20375,2143,14748,90610,5627
45878,28,755,374,573,6393,182
37989,37,2440,1780,1740,14281,700
16858,42,1727,2858,1247,28213,480
23704,0,49,2512,38,3471,11
2243,67,4867,3616,3601,64353,1266
23761,33,1908,2510,1462,34072,446
45906,1,27,385,21,1615,6
43093,9,153,1167,116,2479,37
31368,2,64,2131,55,3924,9
3037,100,7092,3602,5467,32238,1625
40658,7,229,1598,154,6527,75
41436,9,267,1505,204,8354,63
41974,26,484,1418,387,9755,97
4825,16,341,3551,229,8544,112
14737,1,65,2965,54,4253,11
4507,15,238,3563,194,13212,44
14335,11,254,2993,189,4188,65
22381,97,7105,2577,5522,39896,1583
25605,2,178,2426,145,7240,33
9291,17,667,3297,517,14033,150
20313,9,913,2692,681,7920,232
7193,0,116,3436,101,5288,15
33343,0,57,2039,48,2584,9
46154,5,190,275,135,2603,55
21168,35,4043,2642,3072,34984,971
19019,6,176,2758,153,9208,23
12114,254,6231,3149,4483,20706,1748
23775,21,1196,2509,955,14829,241
8267,46,972,3360,765,28752,207
5272,119,4236,3526,2960,20339,1276
40819,7,116,1582,95,3254,21
4896,32,2691,3547,2057,50148,634
35329,33,2439,1951,1858,21156,581
37810,576,17782,1793,13339,112540,4443
42942,6,313,1211,203,5953,110
23343,3,257,2530,211,4640,46
20637,409,27431,2676,20525,127586,6906
3986,211,10087,3581,7699,129431,2388
11528,320,12661,3177,9355,107286,3306
45708,4,67,455,54,2407,13
32333,3,257,2080,210,4123,47
22719,39,1976,2560,1497,33071,479
45857,22,605,374,506,4570,99
34869,7,322,1975,248,5414,74
31220,3,87,2138,74,3282,13
16251,800,46502,2890,33584,160072,12918
10048,47,1008,3255,799,6012,209
18454,2,173,2782,121,4965,52
29074,16,2163,2246,1601,19204,562
17159,11,646,2841,450,6010,196
14592,43,2144,2975,1630,33155,514
14599,42,2849,2974,2020,22317,829
16528,21,3126,2876,2296,25278,830
14041,45,2616,3013,1995,11837,621
6166,0,61,3484,52,1716,9
4667,17,488,3557,354,8365,134
43091,10,90,1168,79,4753,11
6340,3,137,3477,108,6920,29
41113,0,49,1553,39,3739,10
28703,4,181,2265,158,3695,23
38883,3,203,1719,148,6200,55
41455,142,2996,1503,2148,29097,848
26672,60,3215,2378,2317,25441,898
43282,34,883,1114,604,15338,279
19294,25,1360,2746,1084,15966,276
41131,2,89,1551,65,2545,24
29429,87,4258,2227,3133,21551,1125
18076,16,634,2798,454,9077,180
9388,1248,83073,3289,56268,445971,26805
28232,8,175,2292,129,11388,46
3920,2,44,3584,37,3317,7
17340,10,501,2831,389,15120,112
38147,66,1852,1769,1499,17925,353
17915,31,1882,2807,1475,23305,407
7097,0,38,3441,32,1741,6
43188,14,299,1143,234,9339,65
45002,4,45,704,27,2050,18
10345,279,25000,3241,18740,84335,6260
17854,0,188,2810,149,4232,39
39250,30,971,1695,791,9143,180
8616,13,406,3337,351,15125,55
21425,28,713,2628,545,5448,168
9842,37,2862,3265,2028,31176,834
1517,8,275,3701,239,7033,36
24537,7,524,2473,399,4702,125
27179,3,415,2355,288,9299,127
11651,27,2324,3172,1466,49054,858
15508,402,29279,2924,22087,157774,7192
14200,693,41842,3004,27182,125368,14660
2168,146,4502,3617,3646,54134,856
19705,6,256,2726,218,10382,38
44683,18,463,801,206,7720,257
8908,108,4224,3319,3180,33696,1044
20224,84,3351,2696,2701,24208,650
10807,69,3966,3215,2859,32595,1107
34219,187,7082,2009,5317,33736,1765
9491,5,87,3282,62,1818,25
13885,41,3624,3026,2838,29436,786
39888,9,558,1658,439,8599,119
36808,20,476,1857,375,8974,101
36331,38,1341,1883,1034,12906,307
44739,8,121,782,90,2173,31
32742,14,602,2064,485,5150,117
8127,1,9,3368,7,1183,2
37588,3,225,1808,186,2939,39
36046,15,196,1900,174,1592,22
2962,19,448,3604,352,8547,96
12459,24,650,3129,521,8381,129
26693,8,595,2377,489,6064,106
6255,24,1276,3481,1013,14095,263
33445,0,94,2035,84,2276,10
5374,4,718,3521,524,10739,194
29129,82,3109,2243,2066,40845,1043
29860,9,1193,2206,1028,7137,165
29961,6,235,2202,179,3497,56
8897,385,24686,3320,17130,142288,7556
29404,5,484,2229,407,6491,77
10190,10,174,3249,130,8408,44
24118,124,10799,2493,8463,40160,2336
25887,2,216,2413,187,4677,29
2722,7,108,3608,84,7463,24
8612,30,653,3337,515,21443,138
31416,16,457,2128,364,13186,93
1885,191,7734,3623,5629,63916,2105
30484,2,129,2173,107,4442,22
28626,42,2282,2269,1753,16751,529
42169,8,98,1380,76,3198,22
32211,14,298,2086,250,6026,48
35485,154,2284,1942,1770,19199,514
38726,4,83,1729,64,2877,19
37904,536,13867,1786,10245,88949,3622
29750,30,1602,2212,1321,8772,281
12031,98,17116,3154,11845,78047,5271
9254,44,1175,3299,976,17865,199
7603,252,8615,3412,6640,50128,1975
31912,23,1400,2102,993,9741,407
40170,8,426,1641,311,7697,115
27101,57,4311,2360,2998,30348,1313
5227,5,137,3528,100,4482,37
42520,1,129,1309,86,2394,43
39011,10,482,1712,337,15933,145
20208,13,745,2697,592,9455,153
18114,0,95,2796,79,2382,16
44281,134,1409,872,1141,16771,268
30946,8,338,2152,255,6769,83
28033,10,1007,2304,709,5712,298
2670,5,304,3609,263,6798,41
3342,57,1839,3597,1441,36764,398
41453,1,195,1503,156,4560,39
24272,0,259,2486,213,26170,46
45420,121,1729,561,1275,16896,454
32013,1,38,2097,32,3707,6
24536,3,192,2473,148,4474,44
26549,11,443,2383,355,7404,88
13260,0,1956,3075,1532,13339,424
28111,2,75,2300,57,3993,18
44478,3,59,842,51,6075,8
10794,8,149,3216,130,8695,19
46171,2,25,265,15,878,10
34584,54,889,1992,686,9352,203
5006,19,329,3542,260,6296,69
22361,8,166,2578,125,2457,41
45199,49,675,624,394,9793,281
22319,13,433,2580,343,5398,90
32097,6,260,2091,189,3444,71
26902,196,9846,2367,7810,47553,2036
16165,0,311,2894,241,10458,70
33802,58,836,2021,677,8535,159
17238,10,687,2836,554,5028,133
34068,10,291,2013,238,4175,53
22120,30,2808,2588,2180,20995,628
42670,4,76,1280,53,2439,23
6232,13,450,3482,356,11346,94
6881,440,21944,3453,16373,214159,5571
13718,57,1715,3039,1391,22098,324
44728,189,2171,786,1785,34200,386
9914,144,9987,3262,7353,60479,2634
33786,7,513,2022,395,7715,118
36008,8,1455,1902,1181,7280,274
17254,79,3367,2835,2502,22264,865
43490,160,4419,1052,3901,27152,518
33680,5,162,2027,139,7882,23
42660,17,645,1281,440,7556,205
43704,30,489,975,367,7895,122
6080,78,1735,3487,1329,10895,406
32657,45,1612,2067,1175,23604,437
41769,3,114,1454,89,6503,25
11222,74,2324,3193,1785,36817,539
27754,23,737,2320,625,13612,112
18249,68,1805,2790,1276,20968,529
29263,88,1642,2237,1223,11100,419
31800,10,456,2107,272,7715,184
15168,199,8368,2939,5675,33895,2693
21777,3,58,2608,36,2760,22
3774,933,31778,3588,23137,138562,8641
41479,204,5028,1500,3519,38036,1509
40488,4,71,1612,52,2755,19
6862,8,79,3454,58,10311,21
26037,14,571,2406,419,7343,152
27939,2,81,2309,73,7758,8
25397,9,351,2436,279,3979,72
42775,39,1191,1255,811,31781,380
28414,1,111,2282,92,3792,19
7317,243,13094,3429,9818,65213,3276
12849,3,174,3108,144,4597,30
40550,37,852,1607,676,14679,176
26036,4,162,2406,133,7199,29
19342,43,975,2743,777,7717,198
8844,6,211,3322,169,9304,42
11609,4,289,3174,190,8623,99
3262,18,458,3598,358,3370,100
13164,7,581,3080,444,9940,137
18279,2,79,2789,69,3586,10
26362,63,3453,2391,2648,26082,805
18398,76,7946,2784,6064,33515,1882
32787,120,8968,2061,6709,41212,2259
38663,3,76,1733,71,4892,5
30365,0,47,2180,39,2195,8
37206,1,114,1832,99,2787,15
27188,1,92,2354,68,1963,24
37548,58,1340,1810,986,9066,354
12758,3,174,3113,152,26973,22
2359,19,508,3614,360,33274,148
6624,7,283,3465,222,11032,61
40159,11,323,1641,245,6543,78
29912,41,4122,2203,3346,24770,776
11495,8526,419725,3179,240854,1111870,178871
35289,88,901,1953,713,8726,188
12174,79,4456,3146,3284,37445,1172
43687,1,118,980,88,3985,30
5765,10,210,3502,168,4288,42
6948,47,1721,3449,1200,11858,521
40986,3,94,1569,75,9171,19
3473,0,51,3594,44,3583,7
19946,0,1650,2712,1315,20962,335
39688,6,269,1671,226,5318,43
6767,1,68,3459,57,2966,11
16649,3,87,2871,67,2221,20
45458,0,15,552,13,1613,2
2463,107,5523,3612,3823,36403,1700
25885,89,2435,2413,1938,17316,497
19860,38,725,2716,587,5769,138
8020,13,426,3379,300,8298,126
5587,40,1533,3511,1201,13167,332
44968,9,104,713,77,2792,27
21516,30,2081,2622,1270,32862,811
10667,19,663,3224,555,4436,108
13880,149,7575,3026,5364,66264,2211
32361,10,323,2079,273,6619,50
17386,8,257,2828,192,4595,65
9135,16,366,3306,260,5734,106
14750,51,4145,2964,3148,26972,997
32057,0,125,2094,62,3260,63
19611,17,669,2730,519,5736,150
25399,51,2249,2436,1708,24721,541
20565,2,63,2679,55,3213,8
41528,93,1656,1494,1102,11697,554
40729,19,404,1592,303,7679,101
8424,30,1449,3349,1105,33388,344
30065,12,379,2197,274,6887,105
22809,169,8310,2555,5843,95275,2467
41182,32,1282,1545,969,6941,313
40314,4,84,1630,67,6213,17
4631,140,6000,3558,4347,58046,1653
16364,4,619,2884,493,10640,126
8815,1,121,3324,78,4154,43
10582,141,6348,3229,4641,54302,1707
37197,957,17142,1832,13654,87528,3488
34821,3,137,1978,115,4912,22
3508,4,112,3593,89,9395,23
30705,12,470,2161,362,10388,108
28554,45,1597,2273,1080,12035,517
11163,549,23656,3196,18087,82774,5569
31486,6,364,2123,295,6503,69
15094,17,1006,2944,724,13658,282
30911,1,116,2153,99,9107,17
9377,2,115,3290,84,2786,31
15777,141,11221,2911,8672,56693,2549
30011,6,224,2199,169,5196,55
38939,7,354,1716,258,9953,96
42771,84,966,1256,689,6949,277
44766,150,1709,774,1444,20261,265
27746,213,9329,2321,7193,62391,2136
30266,26,761,2186,558,8133,203
4188,30,1321,3575,1039,24717,282
31328,19,932,2132,790,5091,142
30555,112,4892,2169,3868,26123,1024
44863,2,43,738,34,1625,9
8091,4,101,3370,79,2835,22
5436,3,20,3518,17,2540,3
1527,4,51,3697,45,1715,6
40408,26,473,1621,377,8561,96
33746,3,119,2024,90,3557,29
38853,45,2775,1721,2059,25171,716
41293,0,24,1526,19,7055,5
43666,72,1273,989,1044,11622,229
15337,1,200,2931,178,10772,22
32476,9,296,2075,246,5189,50
2731,1,27,3608,21,2742,6
45066,14,181,677,141,3457,40
2697,1,55,3608,42,3930,13
20090,1,106,2704,84,3834,22
12112,59,2009,3149,1551,33435,458
9112,33,1125,3307,856,18828,269
11885,98,5202,3161,4018,54435,1184
42746,38,758,1261,614,17817,144
18433,14,494,2782,384,6534,110
40524,9,412,1610,294,5712,118
14881,42,2378,2955,1785,29838,593
31768,15,371,2109,248,4420,123
26718,0,103,2375,72,3236,31
14014,23,1610,3014,1249,26671,361
26055,453,23192,2405,16507,70795,6685
9869,5,178,3264,149,4102,29
44085,23,1427,892,1150,11383,277
38072,48,994,1775,765,9240,229
32332,2,174,2080,141,2543,33
11154,41,1656,3197,1270,14380,386
27414,58,9135,2340,7225,44592,1910
16824,318,24457,2860,16957,182705,7500
14306,11,935,2995,726,23114,209
12462,1,19,3129,17,2445,2
31714,1,55,2111,47,2742,8
7175,4,52,3436,44,3109,8
28907,3,105,2255,88,5819,17
14566,15,1022,2976,850,9761,172
3348,11,358,3597,282,10182,76
26670,289,21196,2378,15243,102648,5953
27812,45,2638,2316,1851,44293,787
45260,21,180,606,133,3046,47
6191,32,1251,3483,1016,16113,235
22042,93,1774,2593,1313,7890,461
8427,1,64,3349,53,1929,11
19997,42,1632,2709,1178,24149,454
14179,91,7623,3005,5361,61794,2262
38431,149,3317,1749,2670,27369,647
26459,0,29,2387,25,1602,4
34239,2,52,2008,43,3384,9
15164,78,3555,2939,2879,25679,676
45140,3,49,640,23,2832,26
11707,55,1567,3168,1182,32829,385
36852,308,13238,1853,10012,93241,3226
35062,2,125,1966,107,4278,18
2608,76,4361,3609,3172,43422,1189
10672,23,1324,3223,941,27638,383
45768,16,260,430,214,2900,46
16407,43,1511,2881,1188,11834,323
34561,11,166,1994,140,15096,26
24805,40,2250,2462,1687,16811,563
6690,122,4728,3462,3761,28890,967
42162,3,75,1382,57,3733,18
45280,15,209,598,171,6129,38
30470,4,218,2174,169,4955,49
40138,2,145,1643,115,4353,30
45359,173,2656,578,2134,9983,522
3856,19,358,3586,271,8497,87
45336,25,691,583,566,3795,125
42200,4,161,1374,121,3801,40
16107,12,998,2896,732,8147,266
23980,38,1253,2499,912,10061,341
18490,4,71,2780,62,5964,9
30075,0,175,2196,138,3986,37
2947,19,776,3604,637,11172,139
45496,83,855,542,627,11251,228
5480,1367,123222,3516,81349,507040,41873
39834,29,538,1663,446,13611,92
31730,0,187,2111,149,5627,38
40676,5,221,1596,186,7798,35
8599,6,302,3338,267,10285,35
2910,12,173,3605,140,11845,33
36797,6,292,1858,235,4464,57
34199,3884,146587,2009,103531,669737,43056
26633,10,899,2380,668,7112,231
28418,1,249,2282,199,4240,50
9500,329,26497,3282,19479,47870,7018
45867,10,285,400,172,5707,113
37797,58,663,1794,503,5771,160
8965,2,104,3315,79,4520,25
17879,34,3474,2809,2700,25778,774
8475,13,470,3346,327,6181,143
27118,15,458,2358,369,5802,89
20548,4,247,2680,183,5347,64
29064,7,137,2247,110,6922,27
38678,3,174,1732,139,3957,35
45358,29,257,578,209,5622,48
40899,17,261,1575,191,7889,70
38919,6,184,1718,131,5081,53
33269,94,3949,2042,3079,33760,870
29342,7,193,2231,154,2916,39
11799,3,81,3164,71,4477,10
42915,18,408,1220,332,9285,76
35649,5,371,1929,297,7013,74
29380,6,183,2230,151,6269,32
42429,8,140,1328,109,4750,31
14023,16,926,3014,770,18523,156
25377,0,300,2437,227,6397,73
45569,53,1597,515,1158,7638,439
9946,12,578,3260,429,8562,149
7518,7,332,3417,300,5316,32
23604,82,2000,2517,1468,23323,532
24864,75,3141,2459,2372,25279,769
8381,9,390,3351,321,16658,69
12297,19,519,3139,402,17605,117
20781,0,63,2667,52,2104,11
28727,0,155,2264,126,6650,29
21839,21,720,2606,575,8849,145
28587,12,293,2271,208,5562,85
32427,73,6502,2077,4949,18599,1553
18685,28,3498,2771,2665,39238,833
42293,4,44,1356,35,2855,9
26867,3,75,2368,63,1761,12
9148,16,571,3305,460,24462,111
40762,355,5090,1588,3942,28935,1148
2309,10,215,3615,177,8480,38
29613,4,120,2219,100,3515,20
13473,6,567,3057,413,7479,154
13220,216,12939,3077,9543,103269,3396
5568,227,11353,3512,8261,64207,3092
40914,37,1344,1574,1005,9510,339
15169,65,2395,2939,1735,16091,660
36411,170,3116,1880,2386,13389,730
28303,40,1700,2289,1204,17226,496
1893,31,1177,3622,912,24448,265
33215,0,29,2044,25,6534,4
12120,29,1568,3149,1299,22352,269
35099,480,10538,1964,7601,50374,2937
28305,58,1289,2288,1009,6616,280
12580,104,16056,3124,10927,109419,5129
24510,29,1435,2475,1055,13491,380
6466,9,170,3472,137,3557,33
45263,1,19,604,13,1214,6
16955,1,117,2854,89,13507,28
32527,30,683,2073,512,6777,171
38184,5,237,1768,189,9078,48
34271,49,1459,2007,1215,13591,244
11038,16,490,3204,346,4277,144
33056,5,263,2050,216,4050,47
33619,9,763,2029,599,13176,164
18261,0,185,2790,132,3288,53
31581,12,274,2118,230,3582,44
45530,87,882,532,738,6519,144
38772,1,82,1726,63,2552,19
11882,2,32,3161,25,1856,7
42399,65,2600,1337,1937,27644,663
36182,3,126,1891,107,4345,19
14214,255,14341,3003,9547,45524,4794
36184,4,170,1891,139,9557,31
12051,13,1007,3153,759,5286,248
43721,41,258,969,222,3088,36
17878,60,2454,2809,1856,31972,598
42986,19,613,1201,423,8816,190
18253,11,293,2790,224,2470,69
43765,2,83,957,50,2820,33
30910,65,2277,2153,1763,29129,514
38304,15,593,1759,482,4448,111
41378,15,347,1515,237,6161,110
12409,89,3417,3132,2547,31160,870
13780,19,853,3035,556,9739,297
26469,7,596,2387,485,8045,111
35895,124,6044,1911,4609,44393,1435
44809,8,65,760,53,1992,12
38446,1,37,1748,33,2966,4
7765,29,669,3402,544,12809,125
9007,15,617,3314,418,17515,199
30617,15,302,2166,247,5393,55
21300,4,207,2635,176,3906,31
45262,11,249,604,218,6677,31
10380,953,24785,3240,17979,197878,6806
42521,0,17,1309,14,1756,3
32141,1,71,2089,60,2906,11
35216,88,2493,1958,1947,29515,546
7919,3,206,3387,170,2427,36
39899,7,138,1658,109,6219,29
2551,19,464,3610,307,4111,157
42835,15,167,1240,137,6958,30
3841,11,164,3586,115,5198,49
42669,8,133,1280,102,3168,31
32868,0,154,2058,128,7827,26
36693,47,1419,1864,1042,9132,377
16097,0,35,2896,28,2925,7
6874,61,2909,3454,1944,25039,965
26734,6,146,2375,124,1981,22
13099,1070,40796,3092,28836,142756,11960
5928,132,6002,3493,4427,53668,1575
2614,14,193,3609,151,3580,42
41806,1,35,1446,26,3102,9
44017,4,90,914,58,2835,32
26617,0,123,2380,105,5683,18
4789,132,10112,3552,7677,77883,2435
19054,33,1787,2757,1434,7554,353
15212,12,360,2937,268,15608,92
45514,2,36,537,27,2453,9
37961,4,126,1782,98,3181,28
14325,54,1335,2994,1004,15589,331
28012,55,1058,2305,852,9758,206
6664,7,66,3463,54,3786,12
6454,137,5685,3472,4259,34636,1426
36715,182,7892,1863,5265,49305,2627
37503,210,6388,1813,5143,60253,1245
25172,20,773,2445,625,11203,148
39676,3,31,1672,29,6775,2
32977,14,417,2053,339,8943,78
32149,1,49,2089,35,2719,14
18277,2,206,2789,169,2578,37
11323,71,2862,3189,2262,20009,600
34476,17,614,1998,512,14471,102
13089,130,3657,3093,2795,38063,862
22500,58,757,2570,609,8557,148
7633,348,18658,3410,13209,112744,5449
13758,19,38486,3035,13562,10576,24924
37737,2,113,1798,94,3856,19
15069,4,92,2945,74,9136,18
32880,2,254,2057,193,4495,61
22489,22,1675,2571,1451,16468,224
17352,6,166,2831,132,10837,34
25616,68,1769,2425,1279,14480,490
27947,73,1597,2308,1247,13137,350
38878,29,779,1720,586,11281,193
15748,45,2571,2912,1898,23672,673
15754,0,48,2912,41,3668,7
38547,9,165,1741,136,12995,29
28882,17,399,2256,339,3440,60
33031,2,207,2051,170,2493,37
7515,167,6091,3418,3817,19712,2274
12904,6,301,3105,253,2452,48
39577,8,263,1677,206,13681,57
2784,57,6036,3607,4419,39385,1617
9039,3,162,3312,130,4328,32
3071,27,494,3601,413,10846,81
30287,11,729,2185,617,9362,112
33364,24,926,2038,691,12295,235
33159,0,60,2045,47,1989,13
26537,0,67,2383,57,1865,10
12517,3,124,3126,89,1130,35
38223,46,977,1764,694,7422,283
35651,1,31,1929,29,2967,2
15537,35,1391,2923,1021,16869,370
7544,13,244,3416,155,9439,89
3773,22,452,3588,346,23202,106
3405,20,473,3595,382,12635,91
29683,5,74,2215,64,4578,10
37292,2,181,1827,137,3836,44
24652,2,49,2467,37,2231,12
18065,210,11104,2798,8003,37354,3101
5381,53,3273,3521,2645,22052,628
4081,14,277,3579,205,6501,72
31758,28,660,2109,510,15572,150
18941,15,874,2761,611,7136,263
24634,98,7996,2468,5793,44961,2203
16959,0,885,2853,678,6112,207
42222,293,8798,1369,6569,60638,2229
36306,1,66,1885,48,3564,18
20711,14,422,2671,333,6853,89
45551,0,8,522,6,1291,2
28064,0,19,2302,17,1981,2
38909,29,1187,1718,848,14713,339
45482,69,1119,546,833,7735,286
34467,1,16,1999,15,2475,1
29141,5,194,2243,156,7543,38
3291,16,964,3598,655,28402,309
3560,24,743,3592,629,10351,114
14673,125,4833,2970,3599,26787,1234
21725,11,481,2611,399,3321,82
32717,5,176,2064,159,4704,17
39286,26,573,1693,455,9080,118
35785,86,1373,1918,1104,16734,269
2207,18,727,3616,567,12270,160
27378,4,118,2342,88,2952,30
13829,3,217,3031,165,10364,52
13357,60,87683,3068,25278,58857,62405
31315,8,183,2133,147,9938,36
3838,16,589,3586,396,5732,193
21028,7,112,2651,94,4535,18
12338,34,1004,3137,796,22943,208
13395,202,19128,3065,11144,124045,7984
18328,157,8700,2787,6254,73733,2446
37820,10,370,1792,308,19583,62
4701,28,1206,3556,926,13006,280
12008,0,69,3154,54,1948,15
11771,165,6435,3165,4596,83493,1839
8646,9,505,3335,427,4829,78
27932,101,5625,2309,4291,51848,1334
40004,30,724,1650,549,8928,175
6323,3,103,3478,79,4191,24
1858,44,1321,3623,1098,15988,223
21227,218,12227,2638,8750,55129,3477
36826,44,736,1855,555,9885,181
29169,2,125,2242,100,2283,25
18464,40,1069,2781,876,16369,193
1713,4,175,3653,142,4128,33
23895,111,7857,2504,5840,38166,2017
30953,0,0,2151,0,4088,0
9645,52,2927,3274,2376,22726,551
33812,9,172,2021,132,2918,40
45997,54,1208,343,875,10631,333
7095,13,273,3441,214,10963,59
4168,1,47,3576,41,2311,6
15773,134,10059,2911,6819,47526,3240
14043,221,36083,3013,25788,155335,10295
17135,47,1560,2843,1189,10656,371
32690,330,12846,2065,9770,89214,3076
10925,718,39415,3209,28592,159369,10823
14497,200,11008,2981,7995,45373,3013
31277,21,1906,2135,1519,10700,387
42330,5,130,1349,103,8039,27
8580,12,309,3338,236,7219,73
4646,12,121,3558,101,3670,20
3366,1,70,3596,59,3387,11
40058,10,142,1647,104,2424,38
2369,21,893,3614,684,12845,209
28429,8,2439,2281,1746,13428,693
6404,7,171,3474,138,2959,33
22218,12,814,2584,620,6006,194
19198,7,409,2751,309,9820,100
19293,31,2745,2746,1991,36491,754
9892,9,164,3263,143,4535,21
3565,58,4272,3592,3286,67045,986
32710,200,3866,2065,3153,35359,713
23869,6,305,2505,255,7038,50
6675,4,96,3463,83,3406,13
6284,1,131,3480,103,3724,28
31546,14,220,2120,169,3956,51
10973,12,463,3207,369,7326,94
16608,23,527,2873,420,5493,107
25615,173,10677,2425,7502,52438,3175
32772,4,196,2062,167,5693,29
25979,1,59,2409,52,2470,7
4134,5,101,3577,76,7378,25
32089,10,701,2092,523,9568,178
14814,2,185,2959,162,3295,23
11913,4,117,3159,93,3233,24
34705,6,90,1985,79,2523,11
20448,12,421,2685,322,6295,99
32424,322,7196,2077,5706,33764,1490
29580,67,1545,2220,1265,15287,280
9239,2,157,3300,127,5807,30
33149,1,30,2046,21,4080,9
42047,12,305,1406,239,4554,66
14594,6,321,2974,238,6424,83
10492,2,69,3234,59,4117,10
38152,6,250,1769,193,7219,57
40086,0,621,1645,406,10809,215
8278,4,96,3359,72,3398,24
8743,6,101,3329,91,2984,10
17520,4,216,2823,179,4480,37
42745,7,228,1261,163,7290,65
23004,8,283,2545,210,7698,73
12983,208,20821,3099,15682,127222,5139
4310,22,1643,3570,1169,18620,474
41961,77,682,1419,513,9609,169
3069,12,304,3602,223,5519,81
6423,14,469,3473,374,8535,95
32640,11,231,2067,194,4500,37
31469,38,1599,2125,1109,18392,490
29816,0,0,2209,0,1976,0
28524,3,58,2275,49,5097,9
45055,14,180,683,135,7924,45
40424,22,374,1619,296,5866,78
12631,4,192,3120,160,2956,32
33241,14,748,2043,597,10331,151
26695,0,61,2376,53,4880,8
9225,36,2527,3300,1882,25077,645
36781,15,261,1859,218,3967,43
24527,38,1356,2474,1003,5440,353
34576,99,4154,1993,3020,24952,1134
1900,1,50,3622,42,6352,8
41201,40,1192,1544,856,16489,336
42652,5,210,1284,129,6578,81
41391,44,471,1513,352,6877,119
42167,33,994,1381,772,9271,222
46289,58,2223,231,1781,13808,442
23835,0,68,2506,60,2107,8
42705,6,173,1272,113,6024,60
46323,1,11,214,8,562,3
4491,35,842,3564,627,9282,215
41175,1,38,1546,28,1473,10
27348,8,239,2344,191,4276,48
33189,29,567,2045,472,4635,95
29996,24,1118,2200,876,21226,242
24294,3,346,2484,290,3514,56
42825,11,270,1243,201,6633,69
12312,11,89,3138,72,4632,17
33037,426,29333,2051,20652,138928,8681
33328,50,936,2040,762,10073,174
11829,5,139,3163,111,3753,28
17394,10,631,2828,475,15126,156
2647,4,203,3609,178,3491,25
25956,3,350,2410,300,9495,50
2714,2,80,3608,52,4534,28
37690,27,256,1802,211,3983,45
29333,77,4287,2232,3457,24868,830
29706,0,135,2214,113,6697,22
41710,13,437,1465,331,12769,106
45796,10,81,424,70,4038,11
5059,7,266,3539,216,15792,50
2780,453,15457,3607,10435,69738,5022
3554,37,1950,3593,1509,25572,441
26095,20,1235,2404,1009,13751,226
16413,5,146,2881,117,4959,29
25015,45,1645,2452,1375,19170,270
29518,0,0,2223,0,12023,0
18452,3,65,2782,57,2785,8
34253,3,300,2007,219,13136,81
12011,61,4170,3154,3105,63880,1065
39525,2,55,1681,46,4228,9
21149,19,2346,2643,1718,17396,628
41962,24,586,1419,495,9333,91
6604,1,127,3466,103,3051,24
15984,2,538,2903,429,8912,109
26513,7,370,2384,310,6622,60
46315,25,415,216,341,6758,74
36015,135,4153,1902,3264,38870,889
7243,5,335,3434,250,6309,85
12201,4,68,3145,52,3890,16
7611,87,3499,3412,2683,22897,816
12947,10,674,3102,586,6058,88
7385,135,7381,3425,5304,48716,2077
43303,1,25,1062,22,2588,3
25352,16,911,2438,720,7625,191
41080,191,6075,1557,4511,42405,1564
22757,3,84,2558,80,1710,4
18392,5,479,2784,400,6565,79
45573,15,188,515,157,2705,31
32487,5,757,2074,620,5409,137
25267,154,5326,2442,3949,28664,1377
4956,1,157,3544,124,3243,33
41310,2,270,1524,216,7474,54
8186,2,104,3364,83,2941,21
32008,3,71,2097,63,3331,8
23723,7,145,2511,129,4306,16
31010,12,517,2149,395,6748,122
34713,61,1876,1985,1403,48907,473
28090,11,1006,2301,763,24120,243
4381,10,401,3568,343,16142,58
31088,13,219,2145,200,3543,19
2319,9,396,3614,321,11257,75
8763,37,2017,3327,1655,20831,362
12933,36,1240,3103,893,15848,347
16359,7,165,2884,128,3678,37
39964,78,2587,1653,1985,36970,602
5431,40,1637,3518,1378,23661,259
5521,304,25059,3514,17830,102594,7229
45211,17,180,620,112,2604,68
3370,9,244,3596,183,3627,61
40492,33,891,1612,578,6646,313
4883,81,3650,3548,2882,75347,768
45899,15,232,388,166,3400,66
38369,34,4076,1754,3247,13900,829
5608,41,1567,3510,1078,16601,489
38277,136,2394,1761,1950,29480,444
25116,8,230,2447,194,4051,36
17313,5,242,2833,192,4866,50
21388,195,10076,2630,7010,51419,3066
28434,3,107,2281,91,6317,16
19701,106,4263,2726,3188,14715,1075
40602,2,174,1602,135,8880,39
28198,26,951,2294,694,13237,257
26314,10,5424,2394,3151,14761,2273
41628,92,3153,1479,2305,24600,848
37012,0,29,1845,24,1919,5
23442,3,289,2524,233,10994,56
10081,30,406,3253,323,7292,83
25699,271,16693,2421,12452,56526,4241
3531,3,304,3593,240,4008,64
40551,8,205,1607,159,4219,46
38582,100,2362,1739,1742,13150,620
7686,28,877,3407,627,6415,250
26221,31,1480,2398,1114,17164,366
24834,138,6157,2460,4471,50851,1686
16263,18,1066,2889,806,21906,260
5891,25,950,3495,710,8274,240
7760,2,78,3402,63,2302,15
34376,28,701,2002,549,4129,152
13948,227,6824,3020,5015,23077,1809
26107,6,354,2404,258,5005,96
30107,39,1774,2195,1466,15831,308
1651,3,0,3667,0,4730,0
28473,17,395,2279,325,2279,70
19446,1,150,2737,125,4005,25
20378,3,188,2689,144,3757,44
10488,5,125,3234,108,7717,17
17204,235,17527,2839,11925,111431,5602
13455,2,162,3058,129,5240,33
30306,29,938,2184,729,11919,209
23522,7,108,2521,93,2544,15
6518,0,74,3469,63,3398,11
24924,95,3270,2456,2633,30049,637
39473,41,1285,1683,1014,19686,271
10756,34,3263,3218,2448,38050,815
30919,75,1686,2153,1397,24164,289
31619,23,606,2117,469,12292,137
4696,2,13,3556,11,1905,2
38156,19,706,1769,533,13315,173
25722,6,300,2420,231,6244,69
25694,1,56,2421,48,1954,8
44861,27,163,741,146,2624,17
4920,9,276,3545,207,7257,69
45741,11,139,441,119,2502,20
13282,13,339,3073,235,5660,104
42819,38,557,1243,455,8881,102
2462,35,1109,3612,780,15317,329
32584,2,190,2070,146,3283,44
36561,287,8182,1872,6290,38735,1892
7843,17,464,3395,375,9467,89
44134,23,173,895,144,11289,29
1960,12,111,3620,83,5173,28
35362,30,370,1950,310,3943,60
19023,6,233,2758,196,3386,37
3063,476,0,3602,0,297507,0
5239,39,1767,3528,1371,22140,396
17192,79,2151,2839,1593,34796,558
11581,359,15071,3175,10832,46022,4239
20878,0,867,2661,642,8154,225
8656,31,950,3334,783,9888,167
37276,6,264,1828,225,7055,39
26751,9,571,2374,473,7414,98
4591,33,483,3560,407,4515,76
40094,80,2777,1645,2088,26325,689
30202,7,263,2190,222,5635,41
11422,31,1636,3184,1263,12934,373
8524,12,482,3342,410,12128,72
5661,16,487,3506,358,5006,129
41104,2,30,1554,20,4220,10
45116,310,6095,650,4651,65946,1444
1919,32,1580,3622,1087,17038,493
42928,263,3740,1216,3000,21299,740
41233,8,366,1537,284,11635,82
12408,2,170,3132,139,3318,31
10014,31,1895,3257,1519,33778,376
10302,22,568,3244,423,13790,145
45684,4,92,470,60,3220,32
41106,15,200,1554,159,3904,41
29362,10,303,2231,232,3967,71
9070,50,2108,3310,1647,27541,461
7307,5,87,3430,76,3810,11
2211,132,8301,3616,5905,35586,2396
28039,5,200,2303,143,13532,57
46152,0,13,276,10,517,3
46260,18,197,242,149,2418,48
3805,119,6728,3587,5405,46701,1323
7790,12,325,3400,242,4598,83
34130,128,1952,2011,1460,14673,492
2216,2,98,3616,77,3782,21
44666,19,187,807,146,3638,41
17015,98,8533,2850,6257,57552,2276
37944,35,776,1783,605,9766,171
7991,24,596,3379,443,8516,153
19464,27,5097,2737,3597,22288,1500
30319,4,177,2183,148,5888,29
45333,16,165,584,152,2209,13
44661,5,76,809,43,1427,33
41645,86,916,1475,712,11074,204
40054,0,16,1647,11,1020,5
8629,1,191,3336,163,6148,28
25001,55,1031,2453,835,7881,196
2795,8,359,3606,283,8437,76
44957,20,234,716,201,3812,33
42002,8,507,1413,345,5171,162
28989,179,5492,2251,4104,55140,1388
45253,94,1227,608,1004,9271,223
7539,30,785,3416,612,10779,173
45580,0,83,513,73,2003,10
11613,34,1219,3174,835,9936,384
6669,8,245,3463,203,7699,42
9384,32,567,3289,354,3502,213
16254,24,1334,2890,1082,19050,252
16727,15,1076,2866,853,16064,223
15629,15,669,2917,536,15478,133
11237,125,6178,3192,4843,24836,1335
46435,0,14,159,10,918,4
20701,1,43,2672,42,1448,1
42570,13,269,1301,180,9856,89
12931,206,11170,3103,7781,70566,3389
9694,0,86,3272,55,11094,31
24577,8,268,2471,224,7979,44
9102,6,111,3308,99,3355,12
41177,31,597,1546,428,8149,169
21854,8,430,2605,349,6549,81
18148,77,3778,2795,2784,28416,994
26104,12,293,2404,250,4486,43
41371,4,254,1516,201,3119,53
34895,14,296,1974,222,6892,74
27505,3,191,2334,144,4489,47
7892,10,298,3391,235,13159,63
15605,18,999,2918,747,7753,252
11830,3,94,3163,83,6368,11
25631,20,884,2424,650,9403,234
25636,5,778,2424,595,19873,183
31056,4,226,2146,182,10033,44
20247,2,48,2694,40,1805,8
44083,97,5070,892,3492,25976,1578
43084,36,741,1170,509,14592,232
3018,2,106,3602,66,3899,40
44807,77,1086,760,961,13114,125
28285,7,234,2290,203,3206,31
30213,28,1467,2189,1136,22198,331
19612,0,556,2730,412,8503,144
28581,44,1854,2271,1450,33749,404
26825,4,218,2370,184,3336,34
26535,111,3780,2383,3035,19698,745
20560,2,570,2679,433,7602,137
6480,112,7869,3471,5917,58778,1952
25608,0,69,2425,45,1480,24
12385,12,958,3134,600,19081,358
37694,0,175,1802,135,2897,40
30234,15,1070,2188,842,19377,228
37437,2,304,1818,220,6817,84
25327,10,234,2439,177,7175,57
25007,1,69,2453,62,8278,7
3451,25,608,3595,482,16432,126
6338,43,1205,3477,945,25560,260
19349,20,1143,2743,809,7335,334
41168,3,205,1547,162,4283,43
4925,37,1906,3545,1458,18805,448
2491,3,229,3611,197,7360,32
39733,142,4005,1669,2951,24327,1054
30732,67,1371,2160,1128,14182,243
36832,4,110,1855,84,4992,26
18476,5,206,2781,154,3858,52
34735,1450,45899,1984,32730,205317,13169
4887,29,478,3547,329,5993,149
19371,22,832,2742,666,11485,166
8846,11,341,3322,255,3338,86
41441,34,672,1505,497,5242,175
11098,70,2133,3200,1666,59020,467
30207,2,97,2189,75,8404,22
18025,2,139,2800,118,2658,21
19935,79,5077,2713,3854,32204,1223
11161,15,372,3196,272,13727,100
31062,32,1416,2146,1099,10653,317
44261,3,117,863,85,4277,32
37858,10,375,1789,314,3650,61
44931,14,139,725,111,4609,28
21717,19,474,2611,379,4098,95
22600,28,900,2565,663,8717,237
10503,10,290,3234,232,6564,58
27039,63,1485,2362,1050,10165,435
43629,18,263,1002,201,4474,62
20630,121,9479,2676,6936,38411,2543
45642,325,4528,487,3785,41111,743
9304,8,593,3296,485,6188,108
43250,2,74,1123,52,2123,22
8756,3,28,3328,22,1510,6
17611,19,761,2818,613,6381,148
11548,3,177,3176,149,4671,28
38796,35,501,1725,426,14611,75
31086,5,210,2145,168,3560,42
40490,19,426,1612,354,12444,72
46048,8,107,314,89,3171,18
2333,10,85,3614,67,3280,18
22501,156,8284,2570,5564,66205,2720
42638,9,158,1288,119,5616,39
15641,27,930,2917,751,10411,179
46449,4,48,150,45,928,3
20346,54,4299,2691,3246,26620,1053
16866,32,1659,2858,1254,5889,405
10539,151,8665,3232,6690,44896,1975
17305,2,58,2833,26,5891,32
42238,14,232,1365,172,8482,60
9387,7,462,3289,338,5272,124
26707,19,720,2376,596,9548,124
41812,58,587,1443,417,9242,170
11441,256,25873,3183,18666,76345,7207
15330,6,252,2931,208,7771,44
12616,25,581,3121,446,8140,135
11472,13,630,3181,492,11843,138
46049,5,84,314,61,1804,23
41609,241,5430,1481,3810,58146,1620
34593,5,119,1992,90,3884,29
27343,67,10983,2345,8515,13345,2468
17596,62,5137,2819,4061,45224,1076
33122,4,161,2047,134,5833,27
4155,3,14,3576,13,1931,1
18782,1,280,2767,218,7632,62
37044,25,651,1842,490,8640,161
5342,9,188,3523,153,11016,35
3211,17,547,3599,439,18473,108
3491,12,516,3594,418,7729,98
30965,1,27,2151,21,3578,6
9793,3,201,3267,168,7396,33
40666,44,1932,1597,1516,16024,416
24244,7,252,2487,216,2315,36
46206,2,58,254,48,3625,10
25726,0,56,2420,50,3216,6
15677,306,12715,2916,9417,46569,3298
13407,4,131,3064,98,2224,33
35384,54,1371,1949,1118,12078,253
5688,7,191,3505,125,4270,66
19791,16,628,2720,477,8524,151
24884,17,311,2458,241,4140,70
5538,2,174,3513,145,10614,29
45529,32,327,533,225,6274,102
45527,12,141,534,125,3159,16
42601,1,101,1295,75,7625,26
19846,11,824,2717,618,7787,206
2045,6,249,3619,191,28423,58
32890,1,34,2057,22,2187,12
34772,4,159,1982,111,4369,48
4790,56,1682,3552,1280,22858,402
4645,64,1355,3558,1013,27096,342
24047,0,42,2496,33,1649,9
17996,1,192,2802,155,4026,37
14351,210,8825,2992,6509,66719,2316
9706,3,62,3272,49,6734,13
2329,64,3130,3614,2315,28886,815
16980,14,447,2852,335,5441,112
16019,4,329,2901,252,6502,77
29095,9,296,2245,223,3723,73
36866,30,1895,1853,1434,32814,461
11998,226,11061,3155,7746,76544,3315
14258,11,674,3000,541,22692,133
39514,1,75,1681,55,6648,20
15135,2,72,2941,58,3476,14
20289,3,362,2692,290,6417,72
13007,44,1529,3098,1211,12465,318
32755,6,416,2063,329,9156,87
20179,0,115,2699,102,2501,13
13703,19,577,3041,486,3845,91
38931,5,62,1716,50,4123,12
24324,0,68,2483,54,2470,14
8468,13,257,3346,208,4247,49
34659,71,1750,1988,1410,19449,340
2983,63,3024,3603,2444,76082,580
10534,13,935,3232,729,36972,206
3763,150,5569,3588,3801,35133,1768
23284,1,122,2533,103,3722,19
14587,5,245,2975,173,8081,72
9876,2,106,3264,90,4880,16
24022,18,2134,2497,1575,20589,559
16922,18,935,2855,761,12211,174
9314,11,222,3295,163,4556,59
34903,2,270,1974,199,9140,71
35334,14,347,1951,262,6080,85
45576,294,6816,514,4659,27295,2157
8833,24,907,3323,685,4125,222
2147,33,998,3617,745,16945,253
12534,2,59,3126,38,1311,21
45980,52,855,348,685,6054,170
24670,62,1302,2466,1080,16441,222
13363,0,35,3067,30,2012,5
43459,77,1312,1061,965,27607,347
2756,14,466,3607,390,9602,76
28965,22,1205,2252,973,19480,232
43864,12,143,939,106,4037,37
15579,343,19945,2920,14350,83220,5595
29292,28,1200,2235,962,7306,238
12897,36,2482,3105,1966,10492,516
25225,11,326,2443,274,5398,52
6627,248,9566,3465,7306,203936,2260
33392,29,745,2037,584,4898,161
11810,2,123,3164,100,5618,23
31693,7,171,2112,130,10159,41
17984,190,5997,2802,3969,22487,2028
4989,10,231,3542,187,7338,44
23849,30,1628,2506,1241,11311,387
13831,37,1859,3031,1448,14643,411
19674,12,722,2728,568,10372,154
2325,26,628,3614,515,12317,113
23998,101,7649,2498,5896,37207,1753
16484,12,748,2878,571,6288,177
16839,14,681,2859,541,11549,140
10201,12,201,3248,162,3883,39
23985,5,318,2498,270,11366,48
10556,11,192,3231,151,7376,41
15715,9,381,2914,284,5853,97
21314,15,727,2634,522,7255,205
32375,26,1115,2078,801,14368,314
3850,35,831,3586,655,22266,176
27397,19,661,2341,548,17856,113
3203,27,711,3599,578,10786,133
7581,32,1416,3413,1012,16916,404
3288,5,399,3598,329,5328,70
6035,6,328,3488,274,4551,54
18950,3,107,2761,78,7510,29
8533,22,856,3341,698,11898,158
5526,1,57,3514,47,5120,10
46288,1,33,232,28,844,5
21226,113,9445,2638,6503,42512,2942
45932,10,230,368,141,5107,89
35200,4,155,1959,118,11061,37
7497,29,388,3419,288,5848,100
25527,331,11456,2430,7887,62470,3569
35746,59,1275,1922,981,14242,294
5617,6,115,3509,84,3310,31
10040,18,450,3255,371,6766,79
24745,27,1886,2463,1428,33656,458
7260,15,431,3433,329,4482,102
35933,36,819,1908,616,8276,203
15533,0,5706,2923,4610,49163,1096
16934,12,943,2855,729,15123,214
3447,19,522,3595,365,22827,157
30968,12,273,2151,231,2744,42
32272,24,197,2083,158,3400,39
31996,3,175,2097,124,3762,51
29697,33,1485,2214,1104,25565,381
25231,265,12596,2443,8393,74875,4203
4432,1414,98384,3566,68951,396455,29433
14354,27,1273,2992,1003,11085,270
7749,18,798,3403,597,20740,201
36123,1,104,1894,76,3234,28
32128,131,3492,2090,2681,20937,811
42701,13,177,1273,135,2592,42
22588,3,173,2566,146,3172,27
13663,3,574,3044,489,17550,85
13826,9,697,3032,553,15898,144
2166,7,300,3617,211,18020,89
28149,1,74,2298,64,4769,10
45187,0,40,627,30,1862,10
41991,13,349,1415,275,13639,74
5903,14,330,3494,238,11525,92
17040,64,3844,2848,2842,35248,1002
21763,48,1631,2609,1355,12828,276
21356,4,236,2632,190,8820,46
46309,1,41,219,22,834,19
43570,4,138,1025,99,6902,39
36624,32,567,1867,462,9170,105
11051,4,104,3204,63,4891,41
22337,8,374,2579,305,15593,69
13277,179,10685,3074,8775,72235,1910
45380,172,4713,573,3725,24784,988
7757,148,158457,3403,54848,29717,103609
42504,93,2057,1312,1416,18465,641
45173,2,24,632,14,2678,10
33941,3,178,2018,126,6221,52
38412,6,139,1751,111,3664,28
23256,8,0,2534,0,37917,0
27200,294,12753,2353,9889,105522,2864
44229,47,381,877,312,5599,69
3485,111,4723,3594,3774,18541,949
45490,350,4814,544,3591,35257,1223
25627,0,0,2425,0,7704,0
40277,1,16,1633,14,1633,2
9499,46,1394,3282,1119,18908,275
22306,67,4347,2580,3034,24377,1313
43769,30,273,955,247,6064,26
5197,946,58932,3530,40929,205277,18003
39078,11,646,1707,398,11770,248
33097,8,398,2048,356,2730,42
38422,10,340,1750,270,8615,70
29210,45,853,2239,699,3173,154
21665,3,46,2614,40,2231,6
18074,32,2676,2798,1884,31371,792
44947,12,169,719,134,2654,35
7635,1,108,3410,83,3694,25
37124,15,734,1838,571,27038,163
19595,547,30262,2731,21984,179750,8278
44701,29,349,796,250,5012,99
45122,84,494,646,338,8639,156
15525,18,1670,2923,1182,14628,488
2043,21,362,3619,301,7003,61
5865,4,62,3496,49,2538,13
23726,39,2286,2511,1818,25097,468
43664,6,102,988,58,4038,44
25645,9,823,2423,663,14981,160
3392,138,3386,3596,2534,31386,852
46267,5,80,239,51,2345,29
15826,0,76,2909,60,2422,16
37811,43,1835,1793,1300,21653,535
37850,425,12345,1789,8476,93169,3869
42644,963,23551,1286,15579,105877,7972
9300,16,789,3296,618,7098,171
2635,14,434,3609,342,5336,92
29125,12,121,2243,99,3775,22
21175,836,49480,2641,35929,267881,13551
8135,4,138,3368,107,7507,31
9820,333,16312,3266,12877,67099,3435
32636,34,1601,2068,1171,17355,430
23792,9,324,2508,254,3604,70
10705,1,68,3221,57,4180,11
40643,14,418,1599,308,6337,110
32552,56,3812,2071,2895,30962,917
9888,6,238,3263,183,11619,55
34017,10,443,2014,359,8275,84
45661,19,265,480,200,3394,65
30058,73,6655,2197,5282,31328,1373
9230,35,1042,3300,814,6490,228
13017,732,27033,3097,19219,180304,7814
38332,73,2834,1757,2192,17925,642
2730,6,296,3608,255,3617,41
40916,10,179,1574,135,2224,44
23530,387,22889,2520,16134,162437,6755
37472,28,1342,1816,1126,25466,216
15380,18,904,2930,768,12903,136
14519,5,216,2979,167,5199,49
30675,46,1159,2163,865,11573,294
38045,44,452,1777,350,4319,102
22777,33,1657,2557,1202,20730,455
26480,7,829,2386,580,10868,249
41478,128,3819,1500,2969,26703,850
2270,19,610,3615,494,18637,116
4939,87,3559,3545,2838,16753,721
19914,2,89,2714,77,2071,12
2594,4,215,3610,168,4670,47
8297,9,263,3357,209,3873,54
25676,39,2785,2422,2104,13740,681
14298,2,201,2996,142,3885,59
4139,184,4881,3577,3581,43345,1300
7937,15,251,3385,193,4466,58
43786,88,2007,950,1470,19399,537
19752,12,274,2723,227,3960,47
10328,445,20446,3242,15635,263953,4811
46022,3,76,330,51,2002,25
25836,14,1715,2416,1272,38429,443
6989,15,474,3447,378,10807,96
33674,169,7957,2027,5936,64136,2021
34531,24,788,1995,596,11104,192
33400,6,141,2037,127,4849,14
20738,3,173,2671,150,2397,23
4761,17,558,3553,442,13361,116
23967,1,30,2499,26,2866,4
5125,55,3067,3535,2418,27672,649
18211,45,1385,2792,1032,14161,353
39710,6,256,1670,193,5821,63
38360,3,121,1754,94,7277,27
25880,14,442,2414,343,10152,99
44685,267,3277,801,2462,18277,815
2108,11,227,3618,183,8169,44
39307,16,555,1692,454,16059,101
7595,24,689,3413,536,9174,153
16890,21,1793,2857,1388,17293,405
42380,6,88,1339,66,2349,22
3428,521,11166,3595,8578,66214,2588
3740,8,346,3589,292,5103,54
19391,7,404,2741,303,10348,101
26371,0,47,2391,43,2207,4
21139,56,2224,2645,1725,15437,499
2767,29,400,3607,340,15428,60
25545,11,383,2429,309,6588,74
45093,68,825,663,623,8435,202
21634,27,894,2616,735,10883,159
42107,3,56,1395,50,7199,6
36082,234,7548,1897,5576,73702,1972
27548,21,867,2331,650,7112,217
40528,7,158,1609,105,6711,53
26247,70,3706,2397,3006,47080,700
43706,35,868,975,577,8803,291
13236,87,4351,3076,3034,43314,1317
24752,6,469,2463,349,10763,120
21869,12,622,2604,477,11344,145
18701,1,67,2771,54,2232,13
19642,25,514,2729,400,6901,114
20518,2,67,2682,55,5727,12
8728,13,307,3329,243,4188,64
17831,5,107,2811,84,3590,23
42605,9,176,1294,131,3168,45
42349,260,4553,1346,3405,37233,1148
17172,39,1160,2840,869,11252,291
4759,56,1532,3554,1183,20907,349
17786,1,82,2813,66,4695,16
10713,286,9302,3221,6891,44179,2411
35744,13,423,1922,343,40713,80
43648,122,2666,994,1986,21177,680
19730,21,2811,2724,2212,26303,599
4836,26,471,3550,344,20125,127
5564,6,162,3512,144,4500,18
12198,3,468,3145,357,14129,111
27375,0,32,2342,30,1167,2
37818,5,185,1792,142,5635,43
15278,1681,138904,2934,96416,315386,42488
40823,225,9067,1582,6215,51215,2852
2874,170,8514,3605,6532,62034,1982
5851,6,183,3497,103,2883,80
14265,648,23187,2999,16625,85210,6562
30505,6,254,2171,208,7588,46
41885,6,235,1432,208,4527,27
3629,325,10625,3591,7248,126860,3377
7731,72,1932,3404,1065,6453,867
20930,11,265,2657,226,2395,39
5366,24,1032,3521,750,15179,282
23192,188,9272,2537,6684,55533,2588
31630,21,552,2116,461,8945,91
14342,175,5175,2992,3700,29871,1475
25314,465,8507,2439,6466,29181,2041
24478,66,3558,2476,2727,20620,831
2923,4,163,3604,127,6876,36
38180,37,1771,1768,1247,21769,524
15863,8,1258,2908,996,18056,262
15249,44,1597,2935,1226,9011,371
33320,19,568,2040,470,7581,98
46254,11,245,243,192,1828,53
8205,55,1935,3363,1592,31457,343
34400,14,783,2001,610,7517,173
10187,69,2205,3249,1798,19217,407
2250,25,489,3616,387,9791,102
8572,8,784,3339,638,6215,146
22593,5,166,2566,137,5220,29
40929,24,941,1573,679,9281,262
46351,0,36,206,25,1108,11
38048,9,623,1777,502,9725,121
18015,12,453,2800,378,6153,75
19811,8,451,2719,375,14175,76
11288,6,297,3190,238,18785,59
2023,24,834,3619,685,7541,149
7729,27,760,3404,628,45644,132
15588,6,185,2919,146,3851,39
44351,94,1987,859,1609,19177,378
27583,107,2170,2329,1683,16754,487
40841,2,59,1580,51,3404,8
32516,53,930,2073,719,11641,211
4743,2,10,3554,9,2492,1
41316,156,3539,1523,2415,23715,1124
30497,15,227,2172,188,5217,39
2523,10,205,3611,153,4421,52
11406,17,922,3185,614,17137,308
30934,249,7798,2152,5966,70074,1832
31600,142,11290,2118,8093,87387,3197
23239,4,91,2535,74,2232,17
26725,60,2330,2375,1785,18626,545
27857,5,169,2314,137,4917,32
19401,16,370,2740,249,7786,121
16989,57,1974,2852,1529,10264,445
4891,11,846,3547,619,15168,227
17440,44,1890,2826,1539,11693,351
36048,32,1614,1899,1249,17180,365
6259,8,486,3481,346,5052,140
19299,0,1200,2745,908,21590,292
17744,9,731,2814,534,2986,197
32696,19,447,2065,385,3622,62
35951,93,1332,1907,1019,14233,313
27528,32,1212,2332,955,14507,257
5187,6,102,3531,84,2469,18
25553,3,84,2429,65,3878,19
33593,3,80,2030,67,6996,13
2569,1,86,3610,60,4703,26
24127,0,3385,2492,2368,41068,1017
42602,51,1677,1294,1310,34095,367
32405,748,15174,2077,11561,73634,3613
6174,78,2732,3484,2101,19305,631
35030,71,1578,1968,1238,13786,340
12954,5,217,3102,171,5594,46
41218,6,373,1540,299,9800,74
16807,224,19216,2860,12274,73874,6942
20887,21,2034,2660,1492,30076,542
7033,59,717,3444,513,6144,204
30069,13,227,2197,194,2173,33
25318,50,2047,2439,1520,28837,527
15833,19,1001,2909,750,7141,251
37418,31,426,1819,324,4383,102
44123,3,71,896,58,2019,13
27557,5,239,2331,204,4006,35
27383,6,451,2342,377,9390,74
30548,2,95,2169,78,7112,17
44741,90,1070,781,905,11117,165
2572,3,152,3610,129,7022,23
28345,0,55,2286,48,2422,7
41127,2,16,1551,13,2627,3
21687,357,11311,2613,8291,60944,3020
21480,633,34717,2625,25207,152211,9510
13493,43,3718,3056,2938,47933,780
41563,35,1480,1490,1116,15500,364
37494,4,102,1814,79,3111,23
35540,1,74,1937,60,2773,14
10849,19,1535,3214,1217,9871,318
9160,31,1245,3304,957,22087,288
27296,8,585,2347,480,8256,105
39757,4,64,1668,55,1767,9
45729,90,2845,444,2237,12691,608
43412,42,263,1072,211,6865,52
6189,314,7517,3484,5171,57903,2346
45556,2,40,519,17,1478,23
6687,5,23,3462,21,2102,2
24607,5,532,2469,390,5642,142
8791,16,892,3325,661,6646,231
41862,16,209,1435,163,3159,46
4664,3,107,3557,86,3287,21
13613,16,1426,3048,965,11558,461
7604,27,660,3412,545,16755,115
38665,6,256,1733,207,3193,49
16604,2,66,2873,54,2836,12
25923,10,299,2411,246,6718,53
18379,3,487,2785,392,7352,95
42379,10,440,1339,322,8424,118
28912,879,38628,2255,20987,211128,17641
45881,258,4578,393,3356,17047,1222
9619,8,137,3275,117,3746,20
18728,90,9238,2770,7090,53404,2148
29811,4,125,2209,94,4421,31
40436,172,2176,1617,1657,13532,519
3266,42,1124,3598,927,24257,197
8013,5,122,3379,106,1623,16
45732,3,60,443,33,1489,27
41558,122,1411,1490,969,15076,442
27230,45,2824,2351,2230,17470,594
25433,15,479,2434,397,10890,82
30779,1,78,2158,51,7698,27
3732,0,12,3589,9,2264,3
8380,35,1878,3351,1464,39400,414
17639,5,184,2817,154,1910,30
34138,3,120,2011,103,2612,17
3393,2,68,3596,56,3072,12
19984,36,1707,2709,1320,12807,387
41825,13,384,1441,334,3829,50
33446,2,123,2035,97,7974,26
15351,155,10441,2931,6990,85228,3451
36572,157,7841,1872,5378,48645,2463
13553,10,391,3051,290,7567,101
2169,235,11991,3617,8193,38439,3798
27738,117,10216,2321,7393,62821,2823
37101,8,459,1839,359,8530,100
30002,43,2570,2200,1948,26579,622
7501,3,124,3419,85,3108,39
8155,12,168,3367,144,4115,24
33057,9,196,2050,176,5839,20
4245,11,213,3573,171,7708,42
19060,189,6844,2757,4971,32333,1873
36655,2,67,1866,52,3030,15
19693,21,1076,2727,773,20197,303
23423,1,83,2525,65,4535,18
34816,64,1807,1978,1361,28335,446
2214,378,10181,3616,7795,48637,2386
17574,3,218,2820,156,4437,62
7480,6,138,3420,114,3079,24
7722,28,546,3405,420,9041,126
29604,0,151,2219,115,3409,36
5199,40,2190,3530,1587,41125,603
25342,0,12789,2438,9783,77321,3006
31393,11,171,2129,125,2631,46
4191,891,44187,3575,29755,127801,14432
40867,143,7518,1577,5470,79247,2048
42733,5,164,1265,119,4086,45
10020,132,5502,3257,4284,48037,1218
30009,27,1149,2199,955,15368,194
11485,24,1482,3180,1090,10323,392
10209,11,313,3248,236,6436,77
18121,8,431,2796,360,3901,71
39704,10,683,1670,491,11208,192
41390,82,2477,1513,1856,34435,621
16967,41,1663,2853,1331,11970,332
27792,6,500,2317,396,6593,104
36172,27,997,1891,868,16499,129
26348,57,10359,2392,7422,52911,2937
5369,13,398,3521,310,9718,88
8819,78,2889,3324,2187,17342,702
18407,114,6806,2784,4965,21703,1841
15290,31,520,2933,397,7871,123
5057,22,206979,3539,73158,18399,133821
45460,29,290,551,253,5770,37
21134,7,318,2645,250,12588,68
30159,43,1177,2193,963,12840,214
17082,13,449,2846,333,2737,116
4534,51,1713,3562,1309,15204,404
9452,16,579,3285,468,13043,111
41765,90,1747,1454,1373,27153,374
37107,1,57,1839,48,2229,9
27917,265,11626,2310,8581,85838,3045
11702,14,848,3169,626,32275,222
21072,136,4690,2649,3655,16688,1035
8704,21,545,3331,440,10146,105
45677,24,236,471,161,5895,75
30310,16,373,2183,325,8529,48
13304,7,458,3072,347,7750,111
27102,5,125,2360,104,7988,21
2450,21,654,3612,505,20660,149
38440,3,81,1749,68,2621,13
3562,31,1478,3592,1164,29258,314
11078,1,184,3202,143,2410,41
43762,194,2394,958,1916,22570,478
17876,17,708,2809,506,35262,202
4003,6,116,3581,96,3334,20
45869,24,297,396,231,8024,66
37433,4,207,1818,163,5797,44
23904,22,1320,2503,1063,5705,257
23964,12,1559,2499,1214,18292,345
10404,45,1004,3239,812,40851,192
25983,3,501,2409,398,28017,103
20606,37,1976,2677,1480,12817,496
2452,18,214,3612,183,9177,31
30628,7,237,2165,194,7796,43
7311,14,466,3429,366,6325,100
24212,27,781,2489,648,5102,133
21416,574,24781,2629,19241,163605,5540
3413,7,154,3595,109,6178,45
8903,9,567,3320,372,6477,195
7922,5,52,3387,44,2115,8
11765,5,109,3165,80,4585,29
25898,74,3547,2413,2144,17750,1403
11508,1,168,3179,139,5135,29
21808,8,370,2607,293,7853,77
27827,2,62,2315,49,3762,13
38865,109,2119,1721,1529,22520,590
30337,10,177,2181,152,5476,25
20655,34,1720,2675,1171,15576,549
2615,19,1016,3609,782,8393,234
20716,66,2457,2671,1822,19890,635
21698,99,15984,2612,10889,52471,5095
39230,16,742,1697,492,13271,250
21583,11,454,2619,342,5178,112
23664,4,190,2513,162,4465,28
29910,3,162,2203,106,3208,56
40955,7,318,1571,220,6074,98
18138,83,4230,2796,2826,23521,1404
28564,4,325,2272,276,4028,49
22687,4,274,2561,200,2752,74
20584,51,1352,2678,1011,11842,341
8878,2,40,3321,30,2013,10
25266,126,7083,2442,5149,22268,1934
38214,19,453,1765,344,5148,109
43938,50,414,926,328,5843,86
23616,26,570,2516,443,2706,127
41708,38,1094,1465,814,23288,280
8455,135,7498,3347,5576,59296,1922
31439,2,375,2127,291,7046,84
45806,20,280,419,206,3273,74
15045,8,857,2946,652,8325,205
38130,5,212,1770,163,5283,49
5038,110,3456,3540,2558,17618,898
27829,2,124,2315,96,2609,28
8863,130,11272,3322,8209,88768,3063
33464,1,69,2034,61,4717,8
41121,25,936,1552,694,15815,242
4553,35,679,3561,533,9993,146
23216,1,155,2535,126,7031,29
33696,27,288,2026,222,2892,66
16998,38,2819,2852,2043,49164,776
26192,42,681,2399,549,8289,132
29331,8,1234,2232,920,13108,314
38868,34,895,1720,730,8188,165
17803,3,92,2812,68,4333,24
17160,69,2270,2841,1806,40047,464
33683,184,6496,2027,4816,32055,1680
31602,0,37,2118,30,1743,7
41749,3,162,1457,126,7456,36
4041,3,147,3580,120,8244,27
9058,92,5391,3311,3899,27386,1492
38542,110,2640,1741,2091,27855,549
2773,157,7841,3607,5722,87013,2119
12170,15,1534,3146,1150,20013,384
12066,1,173,3152,144,4604,29
27868,37,750,2314,526,10144,224
43129,156,4343,1158,3082,21599,1261
27328,6,329,2346,247,3730,82
45654,24,355,481,215,8589,140
33246,32,290,2043,241,3569,49
39692,22,455,1671,330,10199,125
3396,14,998,3595,658,10769,340
46038,2,12,320,8,1733,4
28317,49,873,2288,716,15827,157
10292,144,7901,3244,5678,28648,2223
16720,20,739,2867,546,7962,193
16825,3,503,2860,402,8609,101
20244,2,81,2694,62,3271,19
4404,33,646,3567,518,10164,128
39146,44,1013,1703,751,16354,262
24346,7,321,2482,252,8855,69
40184,29,637,1640,493,6008,144
4578,44,1739,3560,1310,12620,429
5329,16,1738,3523,1330,27219,408
46089,3,48,302,37,1032,11
22591,51,1323,2566,961,7249,362
28109,9,453,2300,365,7761,88
20238,6,237,2695,195,11362,42
33557,11,325,2031,252,7445,73
19570,7,461,2732,371,10115,90
43777,38,838,952,658,13324,180
20121,29,1181,2702,895,15818,286
22008,8,487,2595,391,12136,96
43822,8,58,943,52,1222,6
21696,28,1834,2612,1258,10325,576
35771,48,1309,1920,1033,9294,276
18186,35,1832,2793,1439,36405,393
8261,499,19839,3360,13904,133032,5935
36408,27,632,1880,515,6691,117
31958,45,1328,2100,954,13689,374
28304,42,1549,2288,1190,12338,359
1051,3,64,3910,56,3166,8
40110,73,2749,1644,2111,26837,638
2273,43,1133,3615,840,13509,293
30404,98,1673,2178,1280,11030,393
19772,432,25109,2721,15695,67907,9414
46229,3,12,249,12,1354,0
40773,17,761,1587,565,11567,196
17975,4,486,2803,375,9071,111
34074,0,77,2013,61,2882,16
1297,19,494,3833,402,7630,92
2915,107,3168,3604,2521,38286,647
10778,17,233,3217,203,4447,30
28772,3,155,2261,132,3696,23
43447,9,287,1064,211,9219,76
5673,47,2988,3506,2375,35554,613
46001,13,132,341,98,1603,34
31335,0,35,2132,28,3094,7
42116,189,3480,1394,2600,26438,880
4832,27,720,3551,591,15292,129
39810,3,100,1664,73,4669,27
19980,0,144,2709,115,3697,29
20567,28,2994,2679,2145,28726,849
42045,20,553,1406,408,7334,145
43204,188,5799,1139,4195,15742,1604
45266,493,8386,602,5847,49544,2539
24219,4,1176,2488,967,37662,209
15120,19,526,2942,400,5770,126
39373,21,878,1689,617,16797,261
21764,0,100,2609,84,4213,16
15865,37,5891,2908,4466,44387,1425
37351,5,277,1824,233,5748,44
33901,31,743,2019,567,9231,176
12881,4,409,3106,327,8514,82
16075,75,4538,2898,3020,33367,1518
40763,57,1525,1588,1196,27009,329
22414,233,5482,2575,4375,31754,1107
16032,36,2510,2901,2055,6646,455
45912,3,33,381,27,1654,6
33409,5,141,2037,121,2560,20
2938,53,2151,3604,1627,15957,524
43388,4,189,1079,136,4889,53
13814,1612,111426,3032,77690,394750,33736
38990,12,349,1713,238,8323,111
2972,14,123,3603,102,5495,21
41958,38,1183,1420,900,19750,283
38362,146,4337,1754,3162,19141,1175
13240,7,249,3076,189,5916,60
22380,11,1151,2577,901,7945,250
19879,391,23696,2716,16157,103282,7539
37970,7,241,1781,180,5124,61
19939,165,20829,2713,14023,82650,6806
26057,7,304,2405,264,5088,40
13221,48,722,3077,595,41421,127
14436,39,1485,2986,1238,29533,247
33381,218,11070,2038,7703,59716,3367
23696,31,1390,2512,1118,22253,272
9608,19,528,3275,416,4525,112
3751,8,448,3588,362,6851,86
12778,17,587,3112,477,24354,110
6703,4,120,3462,103,4382,17
24340,32,1590,2483,1232,15167,358
39115,95,2165,1705,1590,17795,575
14393,30,2436,2988,1780,26486,656
29998,7,769,2200,578,14390,191
16847,77,4899,2859,3216,41537,1683
15746,16,805,2912,617,8497,188
12856,7,574,3107,417,6083,157
30327,99,1676,2182,1248,10142,428
30386,81,1672,2179,1284,16053,388
32140,3,92,2089,75,3545,17
42345,13,300,1346,213,10087,87
4802,237,7768,3552,6077,31321,1691
10675,2,138,3223,104,3075,34
43546,64,918,1033,767,17139,151
17833,21,1336,2810,1044,17177,292
17593,9,287,2819,216,6979,71
43421,85,1705,1069,1383,24634,322
5241,21,144,3528,117,4501,27
15553,24,870,2922,697,9234,173
30318,68,7683,2183,5885,10800,1798
27763,27,1273,2319,1082,10991,191
27048,7,523,2362,389,4880,134
19830,0,416,2718,324,7525,92
37952,12568,301255,1782,209276,852944,91979
17054,79,8435,2847,6426,42457,2009
19390,3,335,2741,277,10954,58
42283,17,461,1358,292,8112,169
7244,21,645,3434,501,12678,144
32986,16,776,2053,612,19682,164
6041,18,667,3488,518,11491,149
1210,12,592,3861,480,12202,112
37069,14,332,1841,258,4438,74
7614,187,4441,3412,3291,41461,1150
6095,1,89,3486,83,1490,6
4606,5,208,3559,153,6508,55
33293,0,34,2041,29,9063,5
18861,177,8924,2764,6747,82320,2177
16801,5,208,2861,178,3332,30
5686,0,19,3505,15,2660,4
36161,17,417,1892,316,3759,101
41419,36,476,1509,353,5538,123
31074,41,755,2146,607,9404,148
9169,253,15161,3303,10907,90902,4254
16592,0,73,2874,61,4798,12
22171,11,1412,2587,1157,10403,255
24890,87,1638,2458,1204,9919,434
46135,4,56,284,45,1335,11
9012,3,264,3314,199,6453,65
6359,842,47148,3476,34192,214898,12956
2103,881,25682,3618,18144,79350,7538
29779,14,742,2210,611,6092,131
41477,65,857,1500,688,9142,169
30740,6,138,2159,119,5130,19
29509,25,1184,2223,945,29938,239
20559,11,407,2679,300,15391,107
37421,9,365,1819,256,3835,109
26209,2,431,2398,298,5665,133
9339,1,42,3293,35,1767,7
33506,1,34,2033,29,2403,5
16409,34,585,2881,463,3186,122
3609,145,4671,3592,3746,58754,925
7547,68,4547,3416,3558,40361,989
42308,0,125,1353,91,4047,34
23574,12,722,2518,564,9661,158
26127,3,67,2403,56,2180,11
40619,8,172,1601,137,4112,35
17763,6,499,2813,408,16275,91
10601,36,1089,3228,856,13157,233
9489,5,286,3283,232,13930,54
5640,17,433,3507,344,4528,89
45379,25,505,573,368,8495,137
27762,4,331,2320,251,13465,80
35396,81,2788,1948,2154,37451,634
41744,11,160,1459,126,5848,34
7326,51,2089,3428,1707,22801,382
23545,62,2405,2520,1830,11523,575
31538,30,520,2120,429,6044,91
23414,6,247,2526,190,8744,57
35662,13,508,1928,428,11236,80
20510,20,946,2682,763,12086,183
8514,27,696,3343,496,4601,200
27079,197,19869,2361,13783,101287,6086
14959,1,41,2951,33,2322,8
36887,163,5557,1852,3796,20937,1761
22026,16,579,2593,435,6717,144
38348,2,173,1755,136,3829,37
21938,30,725,2600,563,3658,162
24140,28,987,2492,848,24085,139
4152,85,5321,3576,3653,78339,1668
25091,285,7829,2449,6004,37005,1825
11843,31,1123,3163,693,12526,430
33735,0,0,2024,0,2263,0
32676,78,1605,2066,1255,14437,350
9762,52,2513,3269,2061,25354,452
32032,2,101,2096,75,5958,26
38248,2,94,1762,76,6888,18
20976,5,262,2655,201,6213,61
16622,8538,364406,2872,210326,759007,154080
27286,2,76,2348,67,5456,9
34040,5,170,2014,137,3396,33
37646,1,35,1804,26,3271,9
21204,2,228,2640,180,7502,48
34297,11,464,2006,384,3356,80
40421,1,96,1619,80,3757,16
19381,7,227,2742,169,9682,58
20917,8,539,2658,409,5633,130
40849,14,436,1579,359,15954,77
42485,9,229,1316,175,4919,54
7314,0,34,3429,27,3074,7
3702,123,5779,3589,4401,50431,1378
25423,51,1558,2435,1175,8694,383
4037,7,110,3580,92,5315,18
45083,92,1019,669,836,14404,183
14371,19,638,2990,527,10183,111
7986,2,188,3380,125,9671,63
12583,0,143,3124,122,8734,21
39425,33,708,1686,545,11705,163
28249,51,3221,2291,2474,36528,747
12329,3,70,3137,63,4743,7
32947,76,930,2055,735,8481,195
16207,30,2643,2892,1998,54636,645
21360,3,132,2631,112,3796,20
13524,28,883,3054,666,5253,217
23825,0,173,2507,145,5713,28
14035,36,1591,3013,1248,42029,343
20980,790,64934,2654,45738,260971,19196
43457,55,1549,1060,1041,16252,508
11665,2,141,3171,105,2260,36
27423,0,75,2340,42,2944,33
16779,8,278,2862,207,11942,71
37399,9,312,1820,262,6042,50
2661,136,7355,3609,5667,81941,1688
3524,7,406,3593,334,19987,72
6478,88,3311,3471,2551,26462,760
4348,186,11248,3569,8922,54060,2326
34354,8,279,2003,232,3175,47
10238,275,17198,3246,12948,73869,4250
29115,1,79,2244,64,2923,15
24646,929,54912,2467,37239,160200,17673
12527,5,108,3126,81,2821,27
22786,33,800,2557,624,3631,176
4518,13,154,3563,105,4983,49
41208,4,87,1543,58,2576,29
45978,5,110,348,67,2489,43
6298,8,173,3479,144,5574,29
28896,6,327,2255,258,6709,69
26373,30,600,2391,474,5252,126
8162,33,1525,3367,1123,27640,402
18858,66,5451,2764,3996,25317,1455
3564,13,193,3592,156,4503,37
43654,0,11,992,11,2207,0
20592,2,59,2678,48,2194,11
32208,15,813,2086,637,14248,176
6549,32,1812,3468,1212,31965,600
19589,2034,161793,2731,119735,475671,42058
16773,49,1932,2863,1426,15818,506
15549,80,4275,2922,3138,50158,1137
20285,8,441,2692,365,5850,76
15398,6,215,2929,155,3493,60
12961,10,549,3101,476,6710,73
22699,55,2161,2561,1630,11742,531
38286,0,108,1760,91,2385,17
15057,153,26379,2945,11374,26964,15005
5464,13,195,3517,164,13732,31
42456,283,6847,1322,5017,41515,1830
18447,0,44,2782,38,3244,6
18870,3,271,2763,214,6431,57
35500,11,155,1941,127,4743,28
17568,9,288,2820,222,3632,66
26599,11,544,2381,453,10223,91
43399,52,713,1077,509,6947,204
19945,8,764,2712,582,10682,182
22249,38,844,2582,652,6564,192
44144,24,267,893,221,7509,46
35713,31,1591,1924,1252,15274,339
25014,483,21625,2452,15137,151133,6488
17185,0,74,2840,59,3404,15
35703,1,50,1925,42,6326,8
19542,1,183,2734,149,4436,34
14228,31,1773,3002,1446,20511,327
23388,81,3758,2527,2960,24044,798
39263,17,567,1694,407,29066,160
44221,124,1088,877,937,15763,151
29790,1073,27744,2210,23229,124904,4515
5129,337,10865,3534,8043,183168,2822
15733,1,142,2913,122,5141,20
28318,71,5089,2288,4050,27676,1039
5455,12,392,3517,286,6294,106
25984,8,214,2409,178,4063,36
4349,3,45,3569,42,3390,3
33301,7,623,2041,514,5053,109
9952,777,31653,3260,22387,114486,9266
44547,45,474,828,366,5365,108
7094,160,12436,3441,7807,82455,4629
27852,76,2632,2314,2055,14806,577
14820,9,349,2959,272,4698,77
13878,68,3713,3027,2616,28324,1097
35948,4,305,1907,208,17528,97
35720,49,2396,1923,1826,20236,570
31034,264,6613,2147,4750,68209,1863
43114,99,1809,1162,1452,14556,357
16697,4,270,2868,229,9412,41
21908,100,2359,2601,1684,16079,675
15849,2,155,2909,103,5686,52
35575,1,52,1936,44,3966,8
46033,2,74,323,44,3577,30
45444,3,27,555,19,1125,8
8183,43,1207,3365,951,7247,256
39780,14,351,1667,274,8526,77
16312,52,3216,2887,2387,49774,829
12533,1,56,3126,39,1286,17
9858,633,47860,3264,32247,162549,15613
45313,17,245,588,202,5309,43
17549,23,828,2821,640,7774,188
33706,9,117,2026,83,2682,34
4657,26,150356,3558,55547,4817,94809
39750,4,223,1668,148,3993,75
36412,1,109,1879,90,4431,19
40064,1,83,1646,63,1736,20
43612,7009,175236,1006,137288,893505,37948
1534,7,278,3693,238,9930,40
42044,2,114,1407,77,5295,37
15357,106,2160,2930,1584,14816,576
18210,56,2653,2792,1886,18960,767
21649,3,64,2615,49,4450,15
45051,4,100,684,92,4079,8
29039,7,378,2248,281,6254,97
30316,15,716,2183,559,17149,157
14304,315,21439,2996,15078,122048,6361
32408,4,82,2077,76,1843,6
27493,1,86,2335,67,2425,19
42381,258,6904,1339,5412,48614,1492
6297,9,468,3479,289,7977,179
3771,24,846,3588,696,11672,150
4542,7,79,3562,65,5643,14
41742,2,120,1460,94,6739,26
7181,4,66,3436,52,2388,14
33453,20,390,2035,314,6342,76
7387,3,73,3425,58,2953,15
25508,0,1291,2431,1019,14313,272
13278,6,231,3074,191,4850,40
16893,4,152,2857,124,2565,28
43171,3,149,1145,92,4226,57
20299,1,225,2692,190,2364,35
10029,7,226,3256,178,2417,48
10458,18,2587,3236,1994,11884,593
45920,12,181,377,135,5746,46
30781,9,474,2158,407,7503,67
14825,6,109,2958,86,3161,23
8440,1258,88982,3348,58034,616525,30948
45991,3,57,344,44,2121,13
28628,66,3375,2269,2562,26393,813
8663,19,0,3333,0,34384,0
44754,26,129,776,120,4331,9
26123,4,246,2403,216,3939,30
29015,17,535,2249,474,11234,61
33026,137,21766,2051,17183,73216,4583
44687,12,222,800,143,3820,79
34465,266,9169,1999,6614,44657,2555
30183,2,96,2191,83,6585,13
11439,293,11706,3183,9039,153834,2667
11659,7,358,3171,268,19680,90
45487,15,204,544,133,3322,71
13918,1,63,3022,58,6161,5
11097,33,605,3200,436,12299,169
18909,33,1173,2762,890,6255,283
1796,10,216,3626,174,5798,42
10272,15,315,3245,259,2727,56
31898,9,303,2103,251,8089,52
7152,42,2487,3437,1869,41719,618
38823,0,45,1723,34,2181,11
17747,177,12287,2813,8890,43089,3397
28142,2,85,2299,72,4064,13
29067,670,19582,2247,15719,85335,3863
9345,13,764,3292,583,12147,181
11934,16,692,3158,545,15670,147
30103,2,99,2195,83,6508,16
24262,3,443,2487,359,15535,84
27800,2,238,2316,189,7168,49
36385,0,64,1881,55,2373,9
7099,98,6080,3441,4021,20363,2059
7771,78,2915,3401,2168,51594,747
14597,0,405,2974,348,8023,57
13729,5,327,3038,268,10149,59
17496,8,609,2824,471,13283,138
29014,28,559,2249,438,6984,121
29930,7,891,2203,676,7834,215
16031,28,1304,2901,974,17542,330
13986,24,2050,3017,1567,16335,483
12750,10,366,3114,288,7749,78
44528,87,1648,834,1116,21106,532
18471,33,1405,2781,1163,12920,242
8161,28,1420,3367,1109,15437,311
20795,2,0,2666,0,9524,0
36363,3,50,1881,39,2343,11
29629,10,419,2218,355,10720,64
20326,2,197,2692,154,3707,43
30670,22,854,2163,622,7173,232
46190,9,87,259,74,2449,13
6389,42,1336,3475,1040,59927,296
21145,8,337,2644,271,7544,66
36264,14,314,1887,268,2060,46
35167,80,1626,1960,1327,15093,299
46306,0,20,223,17,667,3
10716,5,96,3221,71,5128,25
46257,0,51,242,21,875,30
14079,5,87,3010,64,6039,23
39218,96,3902,1698,2993,22271,909
13666,24,1169,3044,916,34544,253
34533,12,521,1995,392,5794,129
40446,203,7951,1616,5843,50280,2108
45733,9,126,443,109,3601,17
4430,7,247,3566,182,5597,65
30024,0,54,2199,45,8256,9
18092,25,705,2797,566,6227,139
29689,14,207,2215,177,5281,30
40890,23,340,1576,258,2880,82
25118,9,270,2447,172,8578,98
22653,86,3487,2563,2849,33038,638
14415,11,649,2987,533,25466,116
41165,55,1394,1548,1057,12226,337
15743,16,678,2912,560,8476,118
28274,114,3556,2290,2708,25874,848
46425,17,466,163,351,7034,115
37187,68,2395,1834,1768,15222,627
16810,4,268,2860,220,4940,48
21306,84,3837,2635,2829,41004,1008
36004,121,4797,1903,3826,22097,971
1810,48,1413,3626,1102,16370,311
16208,40,1393,2892,1116,16349,277
24275,3,68,2486,55,2207,13
16669,4,197,2869,148,2517,49
17338,122,5492,2832,3881,37894,1611
33424,68,1541,2037,1181,11830,360
43366,11,104,1087,83,2559,21
25171,66,2177,2445,1690,8025,487
23899,13,853,2503,708,15686,145
19500,9,490,2735,372,12260,118
14723,892,50094,2966,38068,249422,12026
43331,203,2789,1100,2068,14799,721
18937,22,1001,2762,764,9151,237
38346,5,105,1755,91,4209,14
39805,1,41,1665,36,4278,5
15131,39,565,2942,443,22088,122
2743,10,891,3608,749,8522,142
44871,7,63,740,54,1550,9
7751,65,1934,3403,1464,42132,470
9072,19,393,3309,320,5867,73
43278,11,176,1115,130,4922,46
2297,41,969,3615,778,16311,191
31246,51,1952,2137,1540,17869,412
42497,24,610,1314,420,7238,190
4159,18,235,3576,195,7172,40
2618,16,485,3609,377,16951,108
13022,8,394,3097,312,8523,82
34687,2,96,1986,84,2889,12
34611,310,10235,1991,7625,88957,2610
5762,3,219,3502,165,4619,54
8073,31,388,3371,314,3643,74
32194,4,80,2086,67,4473,13
31712,2,154,2111,132,6140,22
31314,48,1942,2133,1537,7455,405
7227,15,400,3434,314,10676,86
28945,292,20844,2253,14838,83430,6006
30447,8,305,2175,265,2573,40
46149,30,414,276,319,8235,95
15694,13,715,2915,521,17209,194
3862,114,2833,3586,2146,29872,687
34516,45,1586,1996,930,9320,656
2358,17,372,3614,295,24241,77
17141,4,386,2842,291,5897,95
43201,15,409,1139,287,6516,122
3197,258,15370,3599,11583,186229,3787
36309,55,1295,1884,923,14592,372
14582,62,4586,2975,3354,25370,1232
15318,9,216,2932,164,1915,52
32547,0,24,2071,18,3585,6
6922,18,202,3451,165,5073,37
45748,10,172,439,134,5804,38
35945,28,591,1908,514,11599,77
31984,16,980,2098,726,26013,254
32232,15,171,2085,139,3046,32
33210,38,3653,2044,2682,14565,971
45697,7,162,463,102,2488,60
34664,101,1096,1987,833,11237,263
3549,13,246,3593,182,4709,64
22810,1594,67775,2555,47965,289467,19810
7825,173,8550,3397,6414,54699,2136
2321,74,2897,3614,2065,42535,832
22523,9,265,2569,220,4922,45
28778,11,221,2261,171,7074,50
31688,36,1088,2112,893,9982,195
31877,12,368,2103,262,4905,106
13907,208,13302,3023,8935,79863,4367
19308,5,162,2745,138,2889,24
6043,1,210,3488,184,2463,26
42158,1,119,1384,91,5063,28
37563,7,470,1809,357,5165,113
43720,22,497,971,450,8390,47
38067,24,857,1775,629,27284,228
2465,7,253,3612,188,9376,65
31963,0,155,2099,111,3339,44
39269,2,186,1694,158,5326,28
29709,14,458,2214,350,5486,108
6159,43,1578,3485,1222,50583,356
35349,58,489,1950,390,4729,99
19404,14,615,2740,481,6530,134
34712,18,292,1985,223,2976,69
7228,124,6814,3434,4802,56078,2012
31219,3,209,2138,150,3331,59
7322,200,5517,3428,4252,24734,1265
31769,10,363,2109,291,6912,72
4413,23,567,3567,446,5718,121
21068,16,926,2649,733,10658,193
24816,43,2561,2461,1939,28073,622
2539,10,496,3611,308,5510,188
7107,51,779,3440,614,7381,165
24700,10,231,2465,176,6917,55
32256,1,37,2084,30,2187,7
43313,29,350,1105,240,5327,110
34047,10,428,2014,312,5219,116
37697,4,417,1802,322,5909,95
43103,83,1508,1166,1073,25161,435
33078,4,315,2049,246,7446,69
13318,6,627,3070,490,19922,137
7713,13,442,3406,370,7919,72
26785,237,7704,2372,5937,58545,1767
20197,4,135,2698,95,6732,40
12762,25,1104,3113,880,24463,224
42393,6,523,1337,349,10988,174
11128,4,205,3199,173,3839,32
15177,22,926,2939,774,4867,152
19302,15,874,2745,648,7625,226
3482,1,108,3594,94,2952,14
9459,3,212,3285,173,5111,39
15310,137,5913,2932,4324,32684,1589
25991,8,196,2408,161,4282,35
28349,7,344,2286,227,3087,117
25513,13,468,2431,350,4352,118
9881,92,4115,3263,2941,28375,1174
31760,77,1250,2109,921,7635,329
42577,17,1642,1299,1220,17554,422
20951,14,450,2656,344,10501,106
11084,327,20815,3201,14453,57593,6362
42989,26,601,1201,436,11889,165
8787,6,149,3326,106,6816,43
22046,7,790,2593,623,30231,167
12142,34,950,3147,738,16447,212
24208,43,2481,2489,1953,18332,528
3183,1,99,3599,76,4706,23
1114,14,572,3894,460,7951,112
45945,3,45,360,26,988,19
21640,92,1989,2616,1526,8048,463
5177,6,350,3532,296,8703,54
45349,1,39,580,26,2106,13
26214,126,7360,2398,5528,22373,1832
42464,1,57,1321,35,4437,22
21071,3,210,2649,166,5678,44
24114,51,1931,2493,1538,18049,393
44111,0,40,897,27,1944,13
40251,2,97,1635,75,7434,22
19925,20,1222,2713,918,10932,304
34987,64,3013,1970,2358,17439,655
26003,4,194,2408,137,2637,57
12753,12,227,3114,181,4165,46
7287,13,403,3431,288,4182,115
21163,11,444,2642,343,10868,101
8950,94,6428,3316,4424,30095,2004
40258,7,203,1634,155,2827,48
40647,2,63,1599,44,1549,19
14033,33,2938,3014,2110,10317,828
39075,4,98,1707,77,2965,21
6283,12,336,3480,293,4724,43
45628,70,592,494,482,6356,110
34690,19,500,1986,422,2899,78
33380,0,171,2038,120,4868,51
21653,94,4932,2615,3654,27347,1278
35779,104,5459,1919,4598,39342,861
6116,49,2583,3486,1985,54537,598
37151,4,165,1836,129,12152,36
40888,64,1194,1576,874,6975,320
34233,11,640,2009,458,9651,182
10393,5,184,3239,147,5047,37
6419,52,1565,3473,1267,18583,298
982,5,148,3938,118,7054,30
29783,3,126,2210,100,3886,26
37589,26,466,1808,402,12277,64
19431,32,2918,2738,2251,25020,667
35964,3,262,1906,220,5161,42
36851,14,634,1853,508,14483,126
38529,152,3813,1742,2849,37387,964
6488,168,9187,3471,6941,48598,2246
37146,4,106,1836,92,4668,14
8568,12,101,3339,79,6567,22
5859,55,997,3496,787,7129,210
2570,3,261,3610,189,5239,72
20968,65,1665,2655,1320,11506,345
35572,59,536,1936,426,5215,110
18224,13,1186,2792,966,19859,220
2593,14,328,3610,245,6590,83
42584,0,0,1298,0,2931,0
5009,14,245,3541,186,11284,59
29652,157,4878,2216,3642,27763,1236
44176,50,796,886,660,17233,136
42976,40,630,1205,446,7007,184
5704,487,24495,3504,16990,114579,7505
40305,1,34,1632,31,4101,3
30410,0,39,2177,22,4815,17
42104,0,53,1395,44,3015,9
2787,9,104,3607,83,3704,21
32423,13,860,2077,654,20411,206
18667,1,82,2772,65,2493,17
13187,11,719,3079,577,12929,142
6399,17,184,3474,140,11936,44
7906,11,167,3389,141,4471,26
3625,9,215,3591,177,5090,38
9473,13,790,3284,581,7811,209
10895,97,2457,3211,1931,38857,526
29575,8,644,2220,522,7784,122
32148,2,125,2089,109,2955,16
43417,15,303,1071,235,5499,68
13306,26,954,3071,775,6067,179
4700,57,3363,3556,2706,17733,657
40919,20,526,1573,381,7932,145
22888,25,1168,2551,904,10523,264
18161,1,90,2795,67,5144,23
37770,20,344,1796,267,6525,77
39162,3,44,1702,37,4863,7
7487,497,17583,3420,13141,97959,4442
25178,59,2074,2444,1597,10035,477
24292,10,240,2485,186,2732,54
28952,31,1129,2252,931,19241,198
41926,8,398,1426,284,8346,114
21094,25,801,2648,643,5344,158
24528,12,520,2474,429,4820,91
44950,10,132,718,113,2787,19
40198,132,3662,1639,2787,30193,875
1952,77,1831,3621,1426,23364,405
11456,0,100,3182,77,7149,23
13508,5,279,3055,230,4789,49
45079,1,36,673,19,2033,17
39478,0,26,1683,21,1501,5
22001,17,876,2595,650,11391,226
5711,0,54,3504,40,1902,14
43210,63,1525,1137,1090,13273,435
25660,73,2930,2423,2119,15455,811
15813,3,640,2910,479,9829,161
6772,5,390,3458,308,17308,82
40694,17,599,1595,413,13531,186
38229,26,882,1764,719,8917,163
12609,20,849,3122,651,5972,198
15597,25,808,2919,595,7743,213
12557,27,61641,3125,19040,15518,42601
22280,198,5795,2581,4475,56707,1320
10071,2,71,3254,59,3387,12
4337,13,425,3569,356,5767,69
27498,10,258,2335,192,8582,66
45452,6,78,553,52,2417,26
4176,20,688,3575,542,9694,146
42404,26,231,1335,192,6222,39
36013,9,451,1902,372,3009,79
37359,0,0,1823,0,5449,0
3692,12,386,3590,298,4335,88
10565,44,2379,3230,1838,27452,541
31869,0,0,2104,0,9929,0
2705,27,876,3608,622,12960,254
19973,3,129,2710,108,5581,21
8138,12,150,3368,127,5885,23
43305,125,2175,1107,1792,35802,383
17184,73,1668,2840,1196,13885,472
12326,0,50,3138,43,2672,7
3431,3,34,3595,31,4810,3
29221,97,3118,2239,2257,35344,861
10481,55,2174,3235,1583,11597,591
26777,28,747,2373,599,13857,148
37633,42,414,1805,313,4126,101
45698,52,422,463,363,5854,59
15127,2,93,2942,71,3329,22
2776,16,453,3607,389,11608,64
40930,35,4335,1573,3387,23052,948
45099,7,179,659,103,6642,76
34498,22,1283,1997,1049,15317,234
2858,26,974,3606,763,9015,211
19520,463,19198,2734,14315,45637,4883
7593,221,5836,3413,4615,41200,1221
21091,9,625,2648,434,17323,191
24209,1,19,2489,15,1024,4
4936,17,448,3545,369,7866,79
13309,176,12847,3071,9311,83233,3536
41488,6,142,1498,121,3822,21
19959,33,1780,2711,1396,28604,384
33681,26,634,2027,519,7552,115
45306,31,336,591,280,11258,56
28934,1,124,2253,103,3997,21
19476,192,5340,2736,3954,37942,1386
26137,2,206,2403,164,2823,42
11558,7,150,3176,125,4620,25
1895,251,8477,3622,6428,132754,2049
4773,49,1821,3553,1086,15299,735
11961,7,369,3157,290,7495,79
32541,110,4520,2072,3302,17988,1218
3445,10,1155,3595,800,21330,355
18244,161,14950,2790,11017,68932,3933
25679,37,2488,2422,1912,16625,576
37852,7,225,1789,183,11055,42
7847,2,108,3395,74,5002,34
16715,4,230,2867,195,11324,35
30115,22,316,2194,250,3115,66
35434,456,12189,1946,8944,93096,3245
11654,16,1195,3171,879,19462,316
30003,12,357,2200,295,5008,62
4497,6,373,3564,228,6316,145
18047,6,342,2799,292,7044,50
30570,2,242,2168,179,3469,63
21335,110,5118,2633,3858,37430,1260
9530,23,593,3281,493,5948,100
15383,99,2156,2930,1608,12372,548
5228,13,288,3528,227,6569,61
9954,61,2059,3260,1566,26756,493
33428,0,61,2037,52,5106,9
13742,57,1245,3037,897,11652,348
40983,81,1928,1569,1387,18758,541
38980,298,11345,1713,6882,38647,4463
36835,33,1298,1854,1069,14798,229
4603,63,1426,3559,1061,28918,365
8506,16,225,3344,170,6369,55
45594,16,233,510,164,4569,69
20404,1,54,2687,47,3987,7
4876,13,199,3548,150,7674,49
34881,14,906,1975,712,8289,194
17564,9,560,2820,453,8928,107
27199,18,644,2353,514,7027,130
38115,4,133,1772,91,4265,42
3373,19,650,3596,525,10572,125
11911,1110,61675,3159,44150,165675,17525
1838,57,1273,3624,1021,16062,252
16894,6,315,2857,260,7028,55
31061,1,131,2146,97,3333,34
46334,9,119,211,105,2035,14
38800,607,27449,1724,19348,121941,8101
27321,1,75,2346,60,2222,15
41855,519,10539,1437,7454,89039,3085
19315,0,130,2744,105,2797,25
17600,93,2933,2819,2241,22899,692
45859,179,2735,374,2079,24975,656
45526,0,16,534,11,1483,5
11871,43,977,3161,772,11473,205
2847,41,1447,3606,953,12565,494
41213,289,10063,1542,5764,64716,4299
34804,38,2118,1980,1620,21956,498
29584,104,3611,2220,2874,25557,737
6775,62,825,3458,624,5546,201
19600,12,802,2731,632,3338,170
40433,34,3806,1618,2718,21521,1088
12162,41,1542,3146,1121,43051,421
13802,22,795,3033,672,13801,123
36629,60,660,1867,501,6074,159
44197,96,1193,882,972,14533,221
8851,1,71,3322,59,4875,12
4469,46,1503,3565,1136,32813,367
2747,577,26070,3607,18577,218351,7493
19380,68,1816,2742,1386,12781,430
36203,21,416,1890,334,5183,82
9623,53,2399,3275,1744,20967,655
15852,495,14398,2909,10110,42625,4288
28207,19,1345,2294,1075,8675,270
37032,33,652,1843,487,9083,165
17488,25,847,2824,607,6507,240
25027,9,367,2452,322,9368,45
16025,19,627,2901,525,7716,102
31494,117,7804,2123,5898,42331,1906
31671,82,2877,2113,2289,17903,588
29034,5,261,2248,221,4394,40
27600,17,276,2329,205,3095,71
38973,3,69,1714,56,2610,13
17112,4,447,2844,333,12335,114
40265,10,253,1633,189,5685,64
18382,4,547,2785,369,8589,178
4580,3,100,3560,81,4576,19
5135,308,5436,3533,4356,123081,1080
23292,6,187,2532,160,2696,27
4721,135,5716,3555,3998,121564,1718
42961,18,412,1208,323,6145,89
42445,9,193,1325,148,5076,45
5343,3,23,3523,20,1564,3
29459,0,14,2226,10,1379,4
16513,8135,886189,2877,637832,2593379,248357
45143,19,180,640,124,4646,56
37010,4,212,1845,176,4764,36
33950,24,497,2017,381,11404,116
9911,3,170,3262,139,2272,31
40673,27,648,1597,458,9476,190
33432,9,470,2036,393,5952,77
10852,298,19957,3213,14065,78944,5892
25533,10,569,2430,441,6782,128
34296,0,43,2006,35,2294,8
31360,14,994,2131,775,6011,219
45510,4,39,539,38,2474,1
38469,39,899,1747,714,9821,185
34932,6,246,1972,204,3750,42
18773,8,367,2768,296,5565,71
15885,271,17538,2907,13597,90419,3941
34453,1,44,1999,36,3962,8
2322,50,1450,3614,1090,11875,360
42850,45,528,1238,365,10144,163
10650,106,15363,3225,11128,76726,4235
13062,24,3913,3095,2937,64025,976
39311,3,100,1692,82,6615,18
38263,22,885,1762,700,14301,185
38886,73,1974,1719,1376,20261,598
17754,14,1499,2813,1139,15091,360
8331,12,382,3355,305,4746,77
2777,0,20,3607,16,2199,4
30878,6,540,2154,369,5533,171
31477,56,4513,2124,3388,47801,1125
6913,17,403,3452,316,7565,87
12161,208,9981,3146,7278,115749,2703
40324,78,2914,1630,2192,31740,722
20409,31,1053,2687,861,9686,192
39314,8,304,1692,253,9989,51
10755,13,340,3218,285,3509,55
17483,135,7118,2825,5341,46467,1777
37912,6,86,1785,71,5954,15
12250,40,2487,3142,1753,45170,734
9753,28,1475,3270,1103,13687,372
14948,453,33617,2952,21514,128573,12103
31430,16,427,2127,351,3683,76
16746,591,38389,2865,24874,174758,13515
7583,5,205,3413,165,6166,40
6898,6,133,3452,101,7127,32
36468,16,455,1877,357,12361,98
30533,5,130,2170,110,2365,20
12184,94,7210,3145,5262,75599,1948
10041,34,1231,3255,975,5907,256
3235,19,370,3598,270,9605,100
39717,7,165,1669,140,4409,25
38322,7,203,1757,157,11751,46
9695,2,85,3272,56,8431,29
19375,9,295,2742,235,5565,60
40921,13,525,1573,405,9076,120
29327,23,708,2232,534,5728,174
42559,0,0,1303,0,5933,0
13558,29,2034,3051,1600,32641,434
13333,29,754,3069,586,9108,168
2037,2845,142082,3619,86502,410303,55580
37286,3,295,1827,248,6228,47
17724,8,490,2815,384,3467,106
11708,1,172,3168,136,6837,36
35915,0,15,1909,12,1959,3
30435,11,353,2176,294,3873,59
2328,134,7535,3614,4527,31793,3008
10211,34,1107,3247,884,13430,223
30567,23,702,2168,556,8674,146
10070,5,114,3254,94,4588,20
28815,1,102,2259,53,2556,49
43410,16,162,1073,130,5990,32
42937,2,17,1213,13,1956,4
28113,0,55,2300,47,1381,8
43226,2,49,1130,42,2448,7
3004,13,538,3603,424,9472,114
4094,124,4801,3578,3686,34317,1115
30387,1,228,2179,184,4158,44
12568,29,807,3124,604,6276,203
14912,21,1172,2954,904,17153,268
26735,79,2982,2375,2272,30269,710
4089,60,1281,3578,979,23623,302
35037,17,614,1967,496,9099,118
4576,38,1282,3560,1058,11938,224
4849,18,392,3550,314,4181,78
30087,19,447,2196,349,4909,98
9814,2,103,3266,75,2432,28
10966,16,878,3207,719,8774,159
30957,12,913,2151,724,7483,189
19653,14,2048,2728,1451,29369,597
15141,152,12543,2941,9544,60107,2999
8210,137,3030,3363,2211,43716,819
24300,10,179,2484,145,2413,34
36979,7,202,1846,155,4015,47
15190,7,171,2938,126,2434,45
1847,90,5327,3624,3967,42200,1360
41271,123,1450,1530,981,13473,469
6291,11,375,3479,308,7635,67
41811,68,989,1444,716,12835,273
25250,17,600,2442,478,6572,122
4405,22,681,3567,542,4585,139
46228,14,181,249,139,3079,42
20232,352,16091,2695,12398,104860,3693
8478,178,4053,3345,3235,30414,818
11629,53,2838,3173,2265,29125,573
15151,10,842,2940,645,16692,197
34083,169,7489,2013,4931,61751,2558
26474,14,996,2386,819,21654,177
20040,22,915,2706,604,4942,311
14616,48,2607,2973,1920,9726,687
3764,75,3087,3588,2333,19999,754
3009,30,908,3603,713,13402,195
27351,62,1248,2344,1014,10740,234
24081,0,1951,2494,1501,16654,450
20204,5,261,2697,225,5347,36
5947,92,3683,3492,2336,36077,1347
37953,6,293,1782,230,10527,63
24003,78,7007,2497,5412,49248,1595
1955,51,1871,3621,1544,30484,327
23044,70,3440,2544,2095,31533,1345
13908,13,1131,3023,916,6644,215
40917,15,425,1574,337,17862,88
11067,4,124,3202,104,5877,20
4839,280,12711,3550,8960,117226,3751
5264,13,275,3527,206,12445,69
10415,9,535,3238,415,7565,120
39126,21,316,1704,255,5997,61
46295,0,18,229,13,616,5
2298,27,709,3615,555,10676,154
38255,70,1554,1762,1252,11759,302
4211,246,8474,3574,6772,67571,1702
5907,39,1053,3494,739,36193,314
33623,10,738,2029,578,9937,160
40330,256,7851,1629,5263,63419,2588
4386,1,136,3568,115,2702,21
9541,66,4033,3280,3195,29102,838
9613,7,395,3275,291,6216,104
38233,251,6574,1764,5219,54422,1355
44888,39,324,737,242,4472,82
31388,1,124,2129,94,5062,30
18266,24,892,2789,707,22663,185
3230,17,586,3599,498,17060,88
17269,15,418,2835,355,4829,63
6167,1,321,3484,256,8453,65
38840,203,6788,1722,4808,46298,1980
11727,21,1216,3167,807,16869,409
1456,2,66,3720,54,2311,12
2986,4,285,3603,197,4166,88
19255,11,510,2748,422,8609,88
43733,13,240,967,132,4812,108
45766,9,155,430,127,3582,28
43978,21,706,923,498,8030,208
5659,36,583,3507,461,6628,122
5313,67,1217,3524,956,13434,261
9999,3,163,3258,118,4860,45
45988,4,52,345,37,1206,15
45711,78,817,453,717,13619,100
32845,28,2771,2058,2031,66743,740
16806,149,5758,2861,3867,48980,1891
45033,558,5994,691,4398,37447,1596
35725,0,54,1923,45,4663,9
10277,2,123,3245,93,3854,30
8573,11,419,3339,352,13678,67
5566,31,535,3512,417,15168,118
42387,4,333,1339,238,7623,95
39200,43,988,1699,775,10355,213
21528,34,1385,2622,1024,8901,361
14240,7,780,3001,482,6469,298
43427,12,124,1069,98,2310,26
17234,19,742,2836,633,12455,109
19311,27,1508,2745,1196,10596,312
5079,3,383,3538,313,12467,70
45670,104,1927,473,1576,9395,351
7284,54,2511,3431,1717,11172,794
28129,7,360,2299,279,9857,81
9765,7,276,3269,223,2826,53
31206,4,218,2139,171,2574,47
5495,48,1410,3516,1015,9314,395
7154,34,940,3437,720,8332,220
36592,625,23769,1870,18047,174781,5722
13601,34,1068,3049,777,9042,291
12186,9,356,3145,295,8608,61
32386,3,202,2078,168,4339,34
14705,44,2376,2967,1789,24215,587
9776,22,1490,3269,1094,19690,396
39272,4,117,1694,88,5052,29
15950,2,249,2905,186,3774,63
46413,3,57,172,41,876,16
38845,78,2138,1722,1581,29478,557
44625,8,170,816,157,5658,13
11571,3,179,3176,134,1668,45
45798,5,41,422,35,2456,6
30768,27,673,2158,492,7661,181
3456,44,1229,3594,906,18301,323
40232,9,215,1636,170,3698,45
32155,58,2077,2088,1593,14595,484
26309,3,409,2394,310,8895,99
5168,0,70,3532,58,4060,12
41050,362,5893,1562,4678,38635,1215
8894,5,233,3320,206,3500,27
37097,5,275,1839,225,8156,50
45465,13,156,550,78,4024,78
33583,13,701,2030,593,6771,108
28689,54,1409,2266,1137,8043,272
23975,26,996,2499,838,17128,158
23924,63,3137,2502,2275,36196,862
34194,13,250,2010,199,4316,51
19190,6,389,2751,291,13707,98
40907,30,1303,1574,919,14198,384
3754,11,329,3588,223,4302,106
29944,17,424,2202,339,7472,85
13447,13,687,3059,546,9331,141
16852,5,154,2858,117,4052,37
12397,97,2380,3133,1851,15125,529
1627,7,137,3675,117,2382,20
12229,1,53,3143,41,7719,12
43272,6,175,1117,105,3072,70
24649,481,17405,2467,12724,74711,4681
5663,55,1743,3506,1119,8971,624
6651,4,48,3464,42,2453,6
14552,5,242,2978,161,12110,81
32254,1,40,2084,32,3613,8
4615,12,368,3559,291,5082,77
37356,49,2840,1823,2179,21323,661
3933,7,193,3584,174,18795,19
34815,13,671,1978,534,13465,137
24525,12,427,2474,349,19830,78
8565,26,502,3339,430,10470,72
18869,11,431,2763,350,6897,81
3381,7,195,3596,163,5087,32
46189,8,64,259,49,1899,15
42990,11,312,1200,206,5228,106
39512,6,297,1682,227,8049,70
10003,23,497,3258,415,6719,82
4604,4,283,3559,201,10067,82
8887,14,396,3320,342,4436,54
25543,299,9643,2429,6978,55577,2665
7139,6,104,3438,86,3824,18
13643,3,166,3046,124,4058,42
38904,28,431,1718,366,5251,65
41457,1,86,1503,59,4150,27
3777,22,600,3588,465,9728,135
19039,119,2900,2757,2248,15084,652
38958,25,695,1714,509,5143,186
18787,53,1556,2767,1177,24181,379
36258,0,56,1887,39,6414,17
28087,5,387,2301,311,6927,76
3113,83,1243,3601,936,7141,307
4937,36,281,3545,215,8232,66
6938,4,281,3450,234,5837,47
40248,3,81,1635,62,7006,19
26093,11,232,2404,199,4247,33
14082,1,150,3010,107,3541,43
4806,52,1302,3551,1094,24082,208
34344,3,354,2004,295,6011,59
15881,3,229,2908,163,11812,66
9638,0,85,3274,67,4884,18
24543,31,1154,2473,886,19226,268
31444,5,287,2126,197,13880,90
1891,10,398,3623,313,11566,85
2199,24,567,3616,402,7049,165
44878,45,561,738,436,7250,125
39935,4,200,1655,167,6773,33
44704,39,388,794,306,6491,82
42177,74,1519,1379,1115,24849,404
15516,11,566,2924,408,8369,158
45540,22,255,528,222,6288,33
14699,2,137,2968,117,3628,20
46240,1,34,246,21,1116,13
26793,11,307,2372,253,10973,54
11025,312,32084,3204,22924,208923,9160
24692,2,164,2465,127,2239,37
46336,50,852,210,568,18090,284
5370,14,289,3521,230,4319,59
13870,19,719,3028,551,7114,168
31574,23,646,2119,517,15185,129
41010,66,2272,1567,1496,28548,776
12786,60,2600,3112,1799,46054,801
2086,15,1436,3618,1154,16536,282
33433,2,45,2036,41,5264,4
32789,27,1028,2061,786,17702,242
32135,60,1246,2090,878,11814,368
42134,29,376,1390,283,7129,93
14810,103,2988,2959,2259,14252,729
33471,1,84,2034,74,3607,10
15783,1,65,2911,57,3214,8
21228,2,140,2638,108,3345,32
19148,23,451,2753,382,5037,69
23355,42,2033,2529,1622,8870,411
31520,21,1081,2121,887,8316,194
27009,153,14235,2364,9701,35775,4534
21433,2,104,2628,80,4645,24
27063,2,283,2361,211,3106,72
35776,0,14,1919,12,2666,2
2179,50,2104,3617,1613,22451,491
7927,24,585,3386,443,8985,142
33589,58,1521,2030,1179,8674,342
34061,1,85,2013,63,2782,22
29536,0,51,2222,47,2936,4
15449,4,268,2927,212,5049,56
15061,28,1209,2945,980,13911,229
33402,0,14,2037,12,1335,2
4607,21,404,3559,298,3792,106
1778,2,66,3632,50,2383,16
46307,53,643,223,567,8623,76
29449,38,620,2226,518,7833,102
43099,6,120,1166,97,6896,23
22070,4,316,2591,242,11417,74
20817,6,110,2665,101,5078,9
42343,12,311,1347,262,8049,49
39442,1,45,1685,40,4180,5
14419,109,6283,2987,4992,54701,1291
2117,11,472,3618,355,4562,117
25669,30,681,2422,515,13136,166
2835,10,319,3606,250,17277,69
15940,42,1755,2905,1363,10041,392
13767,7,261,3035,220,3537,41
38289,29,613,1760,421,6443,192
3919,1,217,3584,162,6602,55
5931,12,434,3493,337,9447,97
42053,307,8202,1405,5866,78951,2336
24982,6,271,2453,203,11881,68
21270,13,577,2636,437,4910,140
28672,0,18,2267,16,1449,2
20813,9,513,2665,439,9078,74
46313,21,346,217,286,5569,60
39633,25,295,1674,257,4800,38
3452,53,1826,3595,1400,28876,426
39858,9,349,1661,253,6063,96
12532,1,49,3126,32,1586,17
25288,7,289,2441,234,2572,55
7352,14,342,3426,261,17733,81
15942,208,16301,2905,10686,41366,5615
24948,11,329,2454,270,4152,59
10896,66,3623,3211,2671,20692,952
25183,29,1227,2444,992,5120,235
29782,2,55,2210,48,5166,7
28791,2,110,2260,87,5924,23
2674,6,141,3609,117,6813,24
20522,1,106,2682,90,2111,16
29902,18,939,2204,723,7114,216
5744,27,718,3503,516,21732,202
7822,77,3602,3397,2868,30439,734
1590,14,215,3681,174,7826,41
42152,15,538,1384,385,9514,153
4952,412,27593,3544,20597,93391,6996
7671,50,2405,3408,1954,23543,451
30852,2,124,2155,96,5489,28
20642,110,3051,2676,2368,10857,683
41375,3,83,1515,59,3216,24
18841,0,108,2765,87,3449,21
6554,34,1682,3467,974,21556,708
32963,1,24,2054,18,3645,6
6716,3,110,3461,94,3911,16
23834,135,59410,2506,40284,95039,19126
26506,8,186,2385,147,4421,39
30122,5,149,2194,119,2264,30
4933,8,149,3545,118,3718,31
24609,15,961,2469,770,11903,191
1698,3,93,3659,78,3223,15
9571,118,10489,3278,6653,87400,3836
27042,13,315,2362,253,5739,62
2782,26,556,3607,399,5923,157
26708,16,861,2376,699,12191,162
15727,3,307,2913,260,10127,47
6711,96,2077,3461,1376,22868,701
29073,60,3370,2246,2670,37074,700
40944,22,438,1572,345,5628,93
13408,12,632,3064,442,13916,190
7399,12,408,3424,305,3915,103
20464,13,698,2685,584,9697,114
12772,34,832,3112,661,13163,171
2021,2,33,3619,28,4676,5
20187,0,77,2698,62,2924,15
32253,5,321,2084,265,6410,56
3515,6,388,3593,325,51172,63
43637,18,238,998,186,6923,52
37540,34,598,1811,479,11801,119
24743,5,215,2463,171,4484,44
20279,9,345,2693,297,5971,48
8313,21,668,3356,497,14328,171
32458,22,607,2075,471,9834,136
2304,4,133,3615,110,5434,23
32170,6,373,2088,290,11271,83
30022,0,65,2199,56,2547,9
13625,18,441,3047,356,4392,85
28900,11,456,2255,345,6574,111
2961,6,54,3604,45,3653,9
9334,4,285,3293,163,4300,122
3714,13,250,3589,199,5104,51
15829,1105,114254,2909,78339,363229,35915
11907,32,1720,3160,1271,14973,449
18868,0,70,2764,61,3183,9
36141,3,220,1893,173,3877,47
43416,212,4289,1071,3283,31008,1006
45590,7,133,512,67,2241,66
39341,493,15905,1690,11194,127289,4711
2854,20,1527,3606,1206,23102,321
9790,37,648,3268,542,11172,106
42809,0,76,1244,51,2173,25
44992,1,107,705,84,3156,23
36209,0,108,1890,72,3419,36
23490,51,1931,2522,1555,12361,376
41443,72,986,1505,729,9453,257
38042,5,170,1777,142,4819,28
10042,19,334,3255,271,6276,63
1798,73,1424,3626,1127,28484,297
9433,19,1325,3287,838,25956,487
27441,37,814,2339,563,5189,251
31276,52,1389,2135,1100,19607,289
36485,31,704,1876,550,14970,154
31593,10,558,2118,447,15843,111
3846,15,226,3586,180,10415,46
34273,0,37,2007,32,7715,5
12689,18,894,3117,651,24678,243
2641,120,5441,3609,4498,43534,943
11364,9411,388841,3187,273825,772573,115016
15087,1,130,2944,102,4129,28
20421,0,190,2686,132,2695,58
9167,14,610,3303,509,26759,101
4273,176,15473,3572,10914,101990,4559
45640,189,1917,489,1580,18375,337
8378,32,1676,3351,1310,21526,366
16155,14,797,2894,659,8679,138
34560,5,102,1994,88,3166,14
9136,3,156,3306,118,4814,38
17079,6,540,2846,446,6472,94
32411,16,246,2077,176,5381,70
21794,155,10748,2608,8070,53669,2678
12386,4,88,3134,69,3582,19
37956,2,69,1782,56,3821,13
39887,50,1044,1658,861,16561,183
28390,10,561,2283,406,9488,155
10297,13,315,3244,244,9772,71
32360,9,735,2079,526,7884,209
13555,118,6021,3051,4311,15444,1710
7388,3,80,3425,67,2617,13
35251,3,77,1955,65,5331,12
34071,5,47,2013,41,4720,6
18582,45,2809,2777,2250,23798,559
2716,6,113,3608,86,9712,27
6110,88,2232,3486,1559,27212,673
41358,14,215,1518,150,4872,65
29069,12,412,2246,327,7190,85
4968,30,301,3544,247,3083,54
8779,12,458,3326,359,12942,99
4417,52,1387,3567,1106,39658,281
16479,38,1431,2879,1092,15262,339
46067,11,157,306,118,2357,39
7586,15,563,3413,408,3603,155
1890,5,120,3623,96,4821,24
32858,56,1869,2058,1365,25137,504
1444,1,35,3737,28,2521,7
35959,48,621,1906,472,7021,149
35949,15,139,1907,118,3696,21
33797,60,2279,2022,1707,29411,572
19352,0,141,2743,118,4426,23
19508,2,509,2735,388,7707,121
35113,9,134,1963,114,3140,20
9393,28,618,3289,428,8525,190
9582,10,387,3277,311,14012,76
21956,20,940,2598,724,16372,216
9025,4,49,3313,38,2255,11
28798,90,4059,2260,2831,30068,1228
16786,3,109,2862,86,17544,23
6603,6,146,3466,116,2953,30
14659,79,3975,2971,2911,21960,1064
40078,2,132,1646,99,2954,33
38331,7,169,1757,128,5157,41
27579,17,381,2330,310,4807,71
20108,0,503,2703,355,6461,148
44545,164,2253,829,1834,22313,419
19129,4,103,2754,82,1306,21
3292,318,16109,3598,11662,156375,4447
15911,40,2117,2907,1604,17523,513
15855,4,77,2908,60,4174,17
7791,373,14649,3400,10847,68992,3802
16296,58,9127,2888,6689,105115,2438
43621,38,1114,1004,931,19501,183
25408,6,635,2436,481,11274,154
25031,10,262,2452,213,5426,49
31906,30,1199,2102,944,16985,255
18171,3,148,2794,126,2273,22
32158,17,336,2088,272,7392,64
13230,15,485,3077,383,13448,102
12887,10,284,3106,231,6788,53
34606,2,71,1991,62,3689,9
1695,3,135,3659,105,4058,30
1694,15,416,3659,330,5600,86
6957,56,297253,3449,81133,26748,216120
34444,3,402,1999,320,9778,82
28828,3,120,2258,91,1458,29
37644,36,382,1805,295,4470,87
20809,3,416,2665,350,9819,66
40393,34,2557,1621,1289,48332,1268
43657,21,302,991,203,5613,99
45309,0,52,590,25,1503,27
18404,142,6734,2784,4927,53593,1807
44846,57,485,746,338,8415,147
16221,0,66,2891,47,3610,19
2072,510,42983,3618,29946,141543,13037
12330,313,25762,3137,17515,154112,8247
11981,55,2473,3156,1943,58287,530
9126,641,27282,3307,20477,246903,6805
30114,87,2728,2194,2203,15930,525
4723,1,45,3555,33,8288,12
29920,0,72,2203,57,4690,15
19991,70,2556,2709,1973,21834,583
22828,861,33170,2554,24754,158245,8416
12216,41,1102,3144,847,12588,255
8477,13,313,3345,240,5432,73
11759,0,97,3166,78,4167,19
30204,10,344,2190,311,15644,33
45018,260,2430,699,1937,14292,493
45376,4,29,573,22,1353,7
21061,19,555,2650,409,5695,146
28927,3,104,2254,93,3944,11
45675,8,71,471,54,3306,17
8097,35,940,3369,734,15265,206
45271,235,2454,601,2033,23521,421
11210,1396,106767,3194,72615,525030,34152
38379,58,981,1753,819,7145,162
29716,4,137,2214,104,7345,33
39504,764,44160,1682,32120,175095,12040
30478,38,1140,2174,897,12230,243
15126,31,1239,2942,1001,11824,238
12704,2,308,3116,228,7948,80
22230,584,34566,2583,24151,149224,10415
18110,9,533,2796,423,6300,110
8209,287,16698,3363,9351,37646,7347
13472,3,44,3057,38,4772,6
30826,7,225,2156,193,4169,32
23127,19,1409,2540,979,6148,430
13889,46,1558,3025,1213,10527,345
41234,30,885,1537,660,16908,225
13238,10,483,3076,309,6437,174
15066,13,1012,2945,831,17715,181
45572,23,306,459,179,4761,127
15030,111,12931,2947,9206,63836,3725
17700,33,2186,2815,1750,14530,436
14549,17,561,2978,424,13444,137
25452,12,997,2434,818,42250,179
28457,3,169,2280,140,12183,29
9859,30,1786,3264,1444,19193,342
38347,18,605,1755,450,10529,155
45536,85,850,530,727,6127,123
18717,5,221,2770,174,11666,47
35337,1,34,1951,30,2406,4
24850,1402,100451,2459,71518,401095,28933
30341,28,2241,2181,1896,6843,345
14614,36,1272,2973,1029,43876,243
2033,29,365,3619,279,5525,86
24938,44,2728,2455,2214,29103,514
23367,64,7591,2528,5705,53019,1886
9456,50,1879,3285,1361,15298,518
33456,20,1098,2035,863,14240,235
35993,5,172,1904,145,2669,27
19442,3,225,2738,155,3770,70
34262,67,2430,2007,1962,18299,468
5269,2,95,3526,69,5943,26
31911,3,120,2102,89,2448,31
15181,3,186,2939,140,3966,46
19597,1,262,2731,199,6526,63
1676,0,26,3661,23,1650,3
22368,13324,980647,2577,672276,2131306,308371
35025,148,5113,1968,3845,42535,1268
27851,9,425,2314,337,8088,88
17902,30,1686,2808,1450,19427,236
14649,45,3006,2971,2203,17191,803
44077,31,395,903,289,10018,106
5816,1,50,3499,39,4286,11
21555,25,1118,2621,786,6663,332
12197,3,225,3145,165,10274,60
45281,152,2988,593,2261,33331,727
6634,17,785,3464,612,13239,173
5920,9,133,3493,103,7957,30
22570,11,1008,2566,817,19768,191
37250,3,259,1829,191,6460,68
39773,8,140,1667,112,5060,28
4686,16,455,3557,373,10978,82
3622,12,173,3591,135,6414,38
45780,5,44,426,36,1955,8
10536,139,3270,3232,2573,77429,697
45816,1,23,415,13,955,10
33825,4,72,2021,60,3035,12
1849,48,1892,3624,1564,16824,328
32764,0,66,2063,46,3116,20
41450,156,3119,1504,2387,12251,732
37709,18,479,1801,389,14113,90
8058,3,131,3371,103,5306,28
2790,16,358,3607,269,8734,89
35810,16,570,1917,426,7454,144
31556,60,2195,2120,1769,23413,426
35554,13,214,1937,171,3774,43
7956,13,368,3383,296,10722,72
7797,25,396,3399,323,4956,73
32218,2,123,2085,102,6524,21
18417,1596,141027,2783,90744,399785,50283
29631,1,156,2217,109,2211,47
12538,1,59,3126,35,1204,24
30623,14,532,2166,393,11396,139
7642,12,320,3410,258,8581,62
4917,83,1159,3546,910,34545,249
21601,16,2397,2618,1889,14641,508
15932,100,3107,2906,2361,13481,746
41672,8,182,1471,122,3890,60
20502,1,109,2683,84,4751,25
46359,70,918,202,805,10212,113
2016,145,3743,3619,2701,25923,1042
17153,16,1377,2841,1157,15525,220
25274,20,692,2441,578,4776,114
3791,1008,50136,3588,33925,312708,16211
28898,36,1515,2255,1167,7709,348
3657,24,285065,3590,97149,29112,187916
12703,252,10311,3116,8018,68548,2293
21463,28,1191,2626,931,10392,260
2407,7,289,3613,202,12431,87
3624,4,82,3591,61,3651,21
4156,4,28,3576,22,2167,6
16942,70,3789,2854,2903,41099,886
22253,21,719,2582,554,14029,165
1921,37,1096,3622,750,8857,346
46330,2,47,212,39,2226,8
40627,296,4749,1600,3513,39840,1236
45078,7,93,673,68,2838,25
13894,93,6516,3025,4308,44439,2208
27861,6,88,2314,76,3724,12
34751,18,592,1983,503,7921,89
34867,30,437,1975,365,5519,72
27878,3,109,2313,82,3333,27
28616,224,14285,2269,9950,92475,4335
9529,294,14456,3281,10448,114332,4008
11423,6,537,3184,405,8801,132
20943,0,124,2656,94,4127,30
6365,5,130,3476,97,3458,33
23612,51,1611,2516,1274,11541,337
12630,307,29516,3120,20911,145145,8605
37702,13,341,1801,272,3996,69
34616,42,3720,1991,2657,12857,1063
27157,1,54,2356,44,2403,10
25775,1,190,2418,168,5159,22
39891,131,4051,1658,2867,31209,1184
14620,4,65,2973,53,3693,12
26924,0,15,2366,13,1096,2
18640,9,230,2773,195,2524,35
7541,20,586,3416,484,4027,102
26650,3,167,2379,128,5815,39
2823,49,1050,3606,896,16732,154
28706,147,7733,2265,5396,33170,2337
37586,59,2159,1808,1623,12933,536
32371,7,286,2078,228,6743,58
6330,22,2339,3477,1623,8805,716
13916,11,591,3023,509,4694,82
34722,5,191,1985,151,3401,40
24010,14,403,2497,298,6216,105
25688,3,304,2422,255,12493,49
12390,2,124,3134,95,3839,29
21434,20,849,2628,659,5419,190
4554,23,717,3561,569,16298,148
16082,0,76,2897,59,5168,17
2607,125,5240,3609,4148,45100,1092
8421,10,364,3350,283,13428,81
10266,315,39086,3245,27930,174534,11156
41930,28,349,1425,273,6535,76
28730,410,19443,2263,13309,106293,6134
20555,147,4515,2680,3396,30516,1119
34861,2,79,1976,62,7159,17
39929,9,305,1656,250,5346,55
35452,5,306,1945,268,5735,38
37652,17,574,1804,413,5355,161
45297,210,2211,594,1766,16180,445
7130,64,4162,3439,3034,43652,1128
5386,6,195,3520,160,4873,35
5781,103,1698,3501,1286,38207,412
23166,19,1173,2538,932,11356,241
11953,9,390,3158,307,4430,83
17006,151,11981,2851,9624,63553,2357
25413,3,586,2435,376,13176,210
14092,68,4127,3009,2911,48694,1216
7023,21,355,3445,306,5633,49
17956,14,417,2804,346,8051,71
45385,65,1154,570,853,13670,301
32835,5,134,2059,106,3211,28
2552,60,1109,3610,739,9202,370
41442,15,278,1505,200,5294,78
14291,65,7100,2997,5006,42067,2094
35650,115,4422,1929,3366,29872,1056
46471,6,121,139,115,1779,6
21707,1,49,2612,40,1073,9
31626,9,395,2116,304,10301,91
35005,27,919,1969,742,18502,177
46126,27,342,288,248,5490,94
18612,1,113,2775,89,1881,24
26146,6,482,2402,329,4733,153
41641,46,1569,1476,1179,28074,390
12384,4,279,3134,210,7214,69
8644,25,856,3335,644,10651,212
19208,57,1144,2750,935,11067,209
19079,4,143,2756,100,5292,43
28178,7,1200,2296,949,17541,251
1621,7,363,3677,295,7891,68
41038,2,49,1564,42,5429,7
33826,5,244,2021,198,6258,46
8832,2,26,3323,24,1504,2
46349,4,40,206,38,1040,2
14805,850,74783,2959,50033,206350,24750
29670,3,280,2216,211,6447,69
41373,106,2200,1515,1495,14206,705
33061,1,107,2050,88,3213,19
33935,2,146,2018,112,7500,34
6888,27,365,3453,273,7007,92
45214,423,6101,606,4867,34934,1234
17019,61,4236,2850,3265,16720,971
15744,16,502,2912,385,10276,117
21637,553,35565,2616,25206,185724,10359
5005,57,1294,3542,879,9268,415
6486,742,73495,3471,43466,388157,30029
12784,52,4873,3112,3698,55025,1175
36090,3,217,1896,152,5450,65
5675,8,445,3506,342,8731,103
19706,8,287,2726,222,15340,65
17510,11,632,2823,465,8136,167
38712,34,613,1730,472,5352,141
46091,130,3287,301,2727,22386,560
29190,2,155,2241,133,6872,22
39668,58,592,1672,444,5610,148
12777,9,548,3112,422,11112,126
7088,3,107,3441,84,2797,23
16590,9,503,2874,416,6254,87
42129,286,6718,1391,4816,56372,1902
19759,374,25563,2722,18965,135439,6598
2781,97,2990,3607,2312,31053,678
11974,36,1601,3156,1057,15269,544
16316,687,29241,2887,22190,125412,7051
43006,6,305,1194,192,4736,113
42029,1,100,1410,69,6711,31
21975,1,65,2596,56,1973,9
45687,10,137,467,97,3197,40
35685,7,103,1926,89,3814,14
26443,35,2028,2387,1458,27360,570
41449,109,2987,1504,2134,26100,853
2355,8,160,3614,130,5331,30
6622,24,417,3465,369,7525,48
20677,17,2638,2674,2065,13280,573
34381,8,381,2002,299,7029,82
20792,3,330,2666,255,4086,75
34966,3,139,1971,111,4089,28
34109,106,4114,2012,3156,15181,958
21180,18,833,2641,724,4365,109
35225,19,784,1957,647,28300,137
32132,12,266,2090,203,10615,63
1234,10,677,3857,551,12449,126
18408,268,17479,2783,13349,121443,4130
31673,26,875,2113,676,17664,199
25137,82,4757,2446,3803,48051,954
45943,19,96,361,80,2096,16
8039,35,807,3372,640,30242,167
45178,7,118,629,80,2617,38
20628,75,2309,2676,1618,9584,691
29090,1585,165263,2245,116512,445939,48751
34385,254,9720,2002,7167,56819,2553
44811,11,133,759,97,3527,36
7384,122,11071,3425,8328,92749,2743
44314,74,1250,865,892,11896,358
40238,51,809,1636,616,5259,193
22834,225,5746,2554,4400,29875,1346
44841,45,458,747,357,4717,101
8345,3,64,3354,46,4310,18
18812,65,8641,2766,5957,40752,2684
15389,56,3973,2929,3172,37236,801
22231,391,23315,2583,17231,119397,6084
38133,6,372,1770,271,5871,101
10390,7,66,3239,54,1441,12
10018,1,55,3257,47,3369,8
3127,48,1761,3601,1285,13028,476
41207,5,310,1543,242,9025,68
2244,1,77,3616,55,4658,22
31589,13,1433,2118,1096,16460,337
19334,0,34,2744,19,2103,15
39922,1,136,1656,104,3199,32
23687,127,4031,2512,3035,29613,996
6971,22,795,3448,596,13773,199
26545,6,314,2383,233,5734,81
21039,10,386,2650,302,19748,84
19063,11,865,2757,679,10484,186
6640,69,2709,3464,2060,27258,649
1941,79,1746,3621,1474,22003,272
32352,1,17,2079,15,2673,2
12591,86,6362,3123,4556,41360,1806
41739,289,5439,1460,4034,61617,1405
29500,6,290,2223,245,8170,45
23238,6,241,2535,202,2993,39
31580,6,193,2118,155,3353,38
28348,0,53,2286,48,2729,5
9428,4,87,3287,75,3788,12
42061,83,1521,1403,1118,17874,403
15735,34,1504,2913,1237,8048,267
13654,2,24,3045,21,4615,3
45716,126,1475,451,1238,13146,237
36028,6,157,1901,124,3493,33
23573,558,18222,2518,14659,58655,3563
10902,29,1315,3211,915,6095,400
40905,11,347,1575,281,17828,66
21289,26,1266,2636,1013,13601,253
42586,206,5483,1297,4146,27075,1337
20467,8,299,2685,239,5238,60
40745,23,311,1590,254,6905,57
29054,1,24,2247,21,2402,3
35620,14,448,1932,367,12910,81
23797,23,600,2508,464,6227,136
25280,0,3170,2441,2372,29066,798
31754,101,3103,2109,2341,32642,762
38244,8,244,1763,209,5113,35
34077,4,132,2013,90,4498,42
38575,9,250,1739,210,5655,40
12524,1,69,3126,42,1327,27
21378,6,115,2631,90,3807,25
27856,78,1089,2314,801,6526,288
19201,164,12122,2751,9247,75624,2875
35297,38,493,1953,375,6722,118
29590,35,1028,2220,885,13750,143
38621,18,386,1735,279,9688,107
33622,2,111,2029,96,12258,15
7245,8,129,3434,113,2297,16
33040,4,77,2051,60,2563,17
2771,48,1512,3607,1155,10737,357
11777,15,418,3164,298,4569,120
23572,9,311,2518,260,5619,51
12899,0,89,3105,68,2581,21
40357,19,569,1624,424,8179,145
42435,49,986,1327,750,6507,236
6695,40,1740,3462,1432,19547,308
5456,100,3204,3517,2560,90751,644
10391,0,65,3239,48,2265,17
27099,99,1833,2360,1460,9836,373
8934,12,306,3318,232,6234,74
31171,29,337,2140,272,4725,65
40990,23,659,1568,505,9600,154
36809,2,95,1857,78,2654,17
34445,48,1918,1999,1473,18618,445
15165,49,4366,2939,2781,24407,1585
45564,372,4991,517,4208,34895,783
26485,236,8311,2386,6206,57717,2105
37720,5,179,1800,149,8385,30
41667,28,661,1472,494,18610,167
42803,9,157,1245,120,4082,37
10052,22,386,3255,306,8456,80
2680,1,95,3609,77,4054,18
2836,8,802,3606,625,31294,177
16517,97,4486,2877,3482,35825,1004
15065,9,235,2945,201,5722,34
45388,59,706,569,602,7011,104
23174,7,432,2538,322,8549,110
45929,92,767,369,496,6773,271
7064,9,262,3442,214,6263,48
32291,14,822,2083,699,18835,123
15701,574,44506,2914,29225,168763,15281
4861,14,585,3549,478,17041,107
30902,18,393,2153,296,8239,97
30837,47,1440,2155,1091,8080,349
4263,44,971,3573,767,7435,204
40558,107,1620,1605,1220,10417,400
43101,100,1331,1166,1133,12709,198
40592,5,88,1603,71,2269,17
10749,38,2284,3219,1781,31443,503
24905,45,8561,2457,6549,6117,2012
6354,15,326,3476,258,8344,68
27370,8,282,2343,234,4650,48
11083,28,630,3202,480,4361,150
3832,31,1080,3587,832,12071,248
7002,1,71,3446,60,3819,11
14608,17,732,2973,538,8942,194
25964,2,256,2409,201,3290,55
46400,0,15,181,11,545,4
11967,39,2072,3157,1563,24345,509
36609,90,1611,1868,1288,7826,323
18816,21,1233,2766,941,18995,292
40029,52,655,1648,465,10482,190
30080,4,107,2196,93,6165,14
37892,5,151,1787,118,3919,33
17052,10,375,2847,317,4684,58
14049,8,200,3012,148,5922,52
17625,32,1962,2818,1512,11736,450
13506,157,11652,3055,8141,82315,3511
41120,14,515,1552,401,11189,114
17013,244,12718,2850,9854,65184,2864
41760,112,2754,1455,2129,47143,625
1272,2,26,3842,21,3028,5
10673,14,541,3223,432,3699,109
38517,76,2040,1744,1511,26566,529
15302,5,287,2932,220,19299,67
36329,1,32,1883,27,2270,5
5929,72,4244,3493,3262,27882,982
43838,5,53,940,40,2632,13
23824,33,699,2507,479,6972,220
45061,35,322,680,247,5436,75
37877,57,740,1787,530,6697,210
5065,176,5592,3539,4020,24303,1572
26229,17,457,2398,372,7221,85
37247,4,182,1830,141,4005,41
21957,148,6885,2598,4966,23208,1919
6648,535,26500,3464,19812,149093,6688
14550,40,1795,2978,1413,18588,382
28743,11,744,2263,613,41847,131
7508,67,6267,3418,4330,75729,1937
37296,1,17,1826,16,9728,1
28189,105,2406,2295,1792,11689,614
1953,12,350,3621,261,9516,89
1813,9,289,3625,213,5489,76
37075,1787,76518,1840,41679,163027,34839
12871,7,493,3106,407,10390,86
45120,15,99,647,82,4984,17
21439,10,233,2627,189,4174,44
27425,190,9394,2340,7110,40795,2284
42361,24,1600,1343,1139,14846,461
42425,7,393,1329,289,9684,104
29349,19,1497,2231,1181,17173,316
42818,3,200,1244,132,3307,68
18724,19,929,2770,662,10628,267
36970,6,212,1847,174,4969,38
20914,51,1836,2658,1386,19184,450
14630,21,1196,2972,956,8839,240
22580,23,1057,2566,856,6856,201
13043,15,505,3095,412,16649,93
10962,24,2772,3207,2044,60123,728
17123,0,7809,2843,5868,39833,1941
28550,17,897,2273,644,27024,253
27825,381,10995,2315,8293,27934,2702
11349,4,217,3188,186,7284,31
26421,48,1356,2389,1067,8572,289
40624,6,81,1600,69,1167,12
35564,0,62,1937,52,5758,10
12257,17,59507,3141,17618,13806,41889
16033,10,168,2901,133,2368,35
44722,74,587,787,535,15158,52
25087,7,312,2449,252,7857,60
12926,1,165,3104,118,2703,47
25209,25,1177,2443,868,14883,309
4250,72,4007,3573,3189,50076,818
17978,65,4565,2803,3405,44831,1160
27446,43,1915,2338,1546,41448,369
28103,70,1160,2300,944,9532,216
16679,534,58286,2869,38101,249059,20185
4941,28,804,3545,640,9963,164
43049,21,232,1183,205,4899,27
7599,46,1362,3412,1070,11779,292
2522,75,1367,3611,999,11041,368
18312,10,271,2788,226,6167,45
17417,220,12976,2827,10098,124436,2878
7346,6,327,3427,189,3158,138
4495,49,1736,3564,1256,15965,480
13243,6,104,3076,81,3121,23
22268,132,7049,2581,5357,41717,1692
44576,22,582,824,437,12649,145
42862,12,384,1235,283,7901,101
30830,7,135,2156,119,1964,16
26915,120,2468,2366,1978,13911,490
12340,29,1375,3137,1054,19041,321
45148,2,46,638,26,2769,20
7726,3,232,3405,177,6443,55
22346,6,384,2578,312,7190,72
33401,2,76,2037,61,2652,15
25997,7,191,2408,146,1929,45
26895,2,133,2367,97,8500,36
3578,1244,70599,3592,38451,198607,32148
14766,42,2255,2963,1688,20967,567
8944,32,1197,3317,859,8668,338
42175,7,300,1379,247,13163,53
39347,6,381,1690,286,7713,95
46131,115,2055,285,1667,11643,388
35634,2,150,1931,110,3643,40
12761,92,4835,3113,3632,41385,1203
37063,27,714,1841,540,5181,174
36101,142,3465,1895,2687,27005,778
3275,86,3366,3598,2747,47209,619
45503,16,261,541,193,5734,68
15314,24,792,2932,606,14198,186
17105,4,414,2844,305,6081,109
41084,22,353,1557,280,4185,73
34037,3,105,2014,88,3336,17
40623,1,81,1600,58,1298,23
36964,1,78,1847,70,7034,8
45382,53,507,572,398,8576,109
46200,33,205,256,142,2787,63
30258,61,1540,2187,1324,31697,216
3076,7,133,3601,112,8091,21
2600,23,4323,3610,3249,24071,1074
44911,4,45,731,34,1737,11
41259,89,3170,1532,2365,20158,805
43579,275,4675,1021,3775,37677,900
2808,318,12851,3606,9716,61047,3135
46298,11,142,227,110,2292,32
21169,408,18386,2642,12674,156470,5712
10009,17,706,3257,564,8318,142
30502,12,327,2172,251,9384,76
35793,0,20,1918,16,1473,4
9041,3,98,3312,80,3596,18
25131,28,2364,2447,1709,18793,655
11817,20,931,3164,694,7043,237
21301,4,344,2635,273,3550,71
15163,43,1393,2939,1085,16401,308
4463,3,276,3565,216,2890,60
19469,142,11401,2736,7851,60496,3550
2717,8,118,3608,100,18600,18
24008,13,597,2497,464,3856,133
26842,55,2240,2369,1711,27349,529
1218,5,44,3861,36,3329,8
45918,143,1744,378,1417,8740,327
17959,75,4358,2804,3372,29436,986
36941,5,431,1849,233,4653,198
35346,88,837,1950,615,6549,222
18875,695,25111,2763,17450,118006,7661
16059,0,221,2899,160,5434,61
27521,316,6292,2333,4554,20722,1738
30111,9,863,2195,708,10445,155
26564,0,157,2382,140,3342,17
7632,4,320,3410,250,10808,70
39775,2,113,1667,82,2881,31
33463,31,501,2034,417,6377,84
13595,26,1784,3049,1420,54306,364
3334,155,8043,3597,6280,50522,1763
40581,65,2176,1604,1604,23087,572
36254,4,121,1888,106,4174,15
38099,32,2589,1774,1948,19066,641
33165,17,324,2045,270,7464,54
25721,144,16499,2420,11641,63573,4858
5954,81,6869,3491,5081,23700,1788
34179,1266,80559,2010,51462,397580,29097
14361,6,168,2991,134,5190,34
6870,590,19905,3454,15279,163077,4626
20503,51,1279,2683,977,11217,302
33938,1,108,2018,90,9624,18
45223,1,21,617,14,1669,7
11260,203,7467,3191,5872,43649,1595
14768,20,854,2962,673,7815,181
41393,6,269,1513,188,6769,81
4639,61,1956,3558,1613,25118,343
26075,189,4487,2405,3218,22647,1269
25992,10,816,2408,588,20718,228
14553,23,850,2978,638,12939,212
12531,1,86,3126,46,1372,40
20084,73,1496,2704,1117,13464,379
7903,34,691,3389,561,16700,130
32685,122,2317,2066,1810,21183,507
7414,8,66,3423,40,6103,26
2478,53,1083,3612,895,8718,188
4438,65,1725,3566,1308,11411,417
2832,4,184,3606,161,10061,23
24522,2,271,2474,223,7227,48
12168,12,950,3146,713,8557,237
44702,81,1165,795,834,8241,331
31782,7,551,2108,451,9573,100
25962,12,472,2410,367,6952,105
42609,9,189,1292,126,4086,63
29301,56,1583,2234,1259,5476,324
40810,16,711,1583,481,13044,230
42619,13,529,1291,377,11822,152
34038,1,134,2014,102,3185,32
26460,6,125,2387,100,7126,25
4567,18,1571,3561,1166,25451,405
27486,15,643,2335,459,9445,184
7781,41,1655,3400,1252,12440,403
34591,20,818,1992,563,5714,255
5935,16,376,3492,305,10200,71
30255,8,129,2187,109,6054,20
3571,3,100,3592,85,4036,15
21062,92,5379,2650,3519,31402,1860
24454,3,82,2478,69,2123,13
40186,17,595,1640,432,7072,163
18332,12,798,2787,579,6296,219
22050,2,66,2593,54,3219,12
41480,2,49,1500,39,1888,10
4647,13,135,3558,109,6781,26
14786,26,2893,2961,2082,19331,811
42199,0,128,1375,99,11046,29
14727,5,195,2966,159,6988,36
23656,0,30,2514,24,2270,6
11902,16,759,3160,613,10333,146
17948,4,140,2804,108,4283,32
43590,92,1900,1016,1498,29817,402
19637,69,2304,2729,1814,11757,490
41343,10,303,1520,253,8860,50
29494,3,54,2224,47,2847,7
40508,5,161,1610,127,7260,34
43402,3,54,1076,39,1397,15
11105,726,53278,3200,38514,192219,14764
32504,24,537,2073,351,7161,186
45288,78,1504,596,1104,30278,400
10485,81,13908,3235,10431,26115,3477
11382,9,186,3186,147,6700,39
3802,30,905,3587,726,13340,179
21331,11,512,2633,389,8746,123
44793,23,316,764,229,3078,87
12787,11,268,3111,219,5426,49
10471,25,1450,3235,984,9512,466
10776,5,289,3218,224,4765,65
15943,160,5429,2905,4125,86814,1304
3989,142,3677,3581,2731,34705,946
19116,39,1599,2755,1250,8712,349
38505,1,46,1745,37,2543,9
41636,8,272,1477,208,7600,64
2055,1841,56857,3619,39900,280108,16957
32866,5,120,2058,66,5174,54
38070,0,229,1775,174,3728,55
39147,12,268,1703,210,5800,58
36513,23,560,1874,459,7568,101
20466,58,2369,2685,1754,31558,615
3404,22,601,3595,425,8819,176
32725,103,2146,2064,1738,15856,408
46213,1,7,252,5,983,2
16883,57,2091,2857,1626,17291,465
14986,9,515,2950,441,10602,74
30349,2,118,2181,97,11291,21
18580,8,462,2777,376,14956,86
24332,4,135,2483,104,4251,31
31562,18,483,2119,341,3640,142
31292,7,574,2134,477,5464,97
21136,2,90,2645,81,1744,9
16688,66,3046,2868,2153,18782,893
35999,13,260,1903,219,9965,41
29017,15,414,2249,309,8051,105
7870,31,1556,3393,1157,17895,399
22884,153,6304,2552,4467,33574,1837
3669,4,238,3590,205,16110,33
21572,240,11886,2620,8935,34567,2951
14181,30,2651,3005,1798,31058,853
5475,648,20068,3516,15474,64326,4594
28497,18,427,2277,284,5268,143
17336,150,20649,2832,15155,82334,5494
12687,32,1411,3117,1104,12700,307
4737,5,154,3554,109,4037,45
10891,1003,55390,3211,38673,221047,16717
32896,11,360,2057,298,5829,62
46185,11,108,260,92,1769,16
36068,7,278,1898,185,4919,93
46223,33,710,251,602,7190,108
31058,6,154,2146,120,6825,34
41387,1,29,1514,23,2495,6
29194,5,207,2240,162,3969,45
41519,27,396,1495,310,10226,86
8724,48,1339,3329,946,12759,393
29843,0,55,2208,44,4309,11
13483,107,3461,3057,2716,48388,745
21246,15,418,2637,371,5318,47
9075,7,109,3309,83,2878,26
27035,10,777,2363,591,8725,186
12976,7,464,3099,339,10505,125
35608,112,2791,1933,2180,12922,611
35443,4,222,1945,181,8794,41
3646,422,20031,3591,14736,80134,5295
22614,17,950,2565,765,20466,185
39498,14,251,1682,207,8086,44
28382,8,407,2284,315,7987,92
44736,20,173,783,155,5653,18
30729,1,113,2160,96,2753,17
37180,2,36,1834,35,1026,1
36865,3,169,1853,122,3375,47
16459,2947,395049,2879,226581,1040155,168468
25436,98,2040,2434,1610,10928,430
8124,8,182,3369,141,4844,41
10744,1,136,3219,105,8596,31
7429,18,244,3422,189,5401,55
9655,1945,170124,3273,105257,840799,64867
42796,20,230,1247,169,6128,61
2277,124,5976,3615,4631,55617,1345
15644,1,123,2917,100,10003,23
16643,11,229,2871,190,6608,39
44653,7,161,812,134,3662,27
19660,19,1450,2728,1064,16158,386
39836,2,81,1663,59,3546,22
23576,27,521,2518,346,4072,175
12684,131,13194,3117,9159,83086,4035
36988,19,601,1846,495,7814,106
29483,9,986,2224,740,18484,246
45845,31,342,406,239,3846,103
46002,32,434,341,322,5814,112
3701,47,2303,3589,1692,51053,611
37263,25,669,1829,545,5869,124
1279,3,53,3840,43,7045,10
23526,241,12821,2521,9850,81666,2971
45955,20,441,357,281,6089,160
2806,75,5678,3606,4250,40149,1428
13487,2,237,3057,198,5693,39
8747,2,349,3328,263,6148,86
9257,27,106818,3299,36563,23385,70255
23905,43,5941,2503,3204,22815,2737
36235,83,1943,1889,1398,22982,545
36747,10,460,1861,337,9498,123
7083,0,60,3442,51,3285,9
22791,21,537,2557,437,2664,100
8075,3,115,3371,91,11758,24
2249,15,272,3616,201,5177,71
31188,2,36,2139,32,2949,4
12179,11,1583,3145,1203,17731,380
20125,1061,65192,2702,44497,337514,20695
19581,17,1074,2732,797,13040,277
20056,33,715,2706,551,6691,164
31489,14,424,2123,371,5418,53
43710,57,540,973,423,5817,117
42439,21,944,1326,598,5820,346
24861,38,1324,2459,1096,15465,228
27401,0,90,2341,73,2374,17
15485,0,135,2926,107,5206,28
15867,3,77,2908,61,3050,16
7450,10,293,3421,234,6082,59
6871,54,3731,3454,2900,29685,831
46392,3,61,184,38,2076,23
9140,41,888,3305,694,15647,194
15353,429,21716,2931,16069,118418,5647
10091,5,101,3253,82,3958,19
42501,46,1342,1313,968,27614,374
12093,28,832,3151,604,11779,228
13360,312,12430,3067,9369,63419,3061
13092,1098,62481,3092,39851,170970,22630
43376,8,248,1083,153,3519,95
11892,436,13054,3160,8955,76832,4099
43390,323,6629,1079,5036,47008,1593
34679,6,160,1987,129,6982,31
12936,12,714,3103,566,15779,148
43831,17,263,941,213,7254,50
3080,56,1191,3601,930,11510,261
18806,878,81642,2766,58182,294927,23460
29823,78,3029,2209,2376,19018,653
46441,1,10,156,9,404,1
33105,1,110,2048,98,5485,12
29672,32,4491,2216,3574,22210,917
44606,22,266,818,234,7651,32
27542,112,10418,2332,7746,66089,2672
20315,16,603,2692,486,11357,117
13429,278,22560,3062,13445,131318,9115
41910,5,389,1428,296,11014,93
7657,5,186502,3409,64647,5786,121855
2789,2,62,3607,47,4194,15
3932,54,5997,3584,4331,26220,1666
39555,1,74,1679,61,3832,13
35659,30,1120,1928,855,14681,265
4020,17,400,3581,276,22245,124
42534,2,91,1307,66,5134,25
20119,390,33141,2702,18996,137679,14145
15591,122,4536,2919,3187,51751,1349
3250,14,506,3598,420,3088,86
20351,24,488,2691,407,3937,81
41189,39,685,1545,504,7956,181
1801,21,485,3626,310,8881,175
5160,7,161,3532,133,9672,28
9481,8,223,3283,168,8843,55
25987,12,467,2409,366,8648,101
42574,119,1611,1300,1013,18075,598
25706,12,368,2421,293,4088,75
8536,3,83,3341,55,2903,28
37834,4,95,1790,78,2722,17
27180,0,26,2355,20,4383,6
30090,2,74,2196,62,2090,12
44064,17,187,906,143,3456,44
43449,154,3073,1064,2434,32541,639
41682,8,225,1470,177,9065,48
39302,57,1507,1692,1188,9951,319
21385,8,307,2630,231,4405,76
43123,11,162,1159,120,7428,42
2222,41,1007,3616,840,11384,167
27482,2,348,2336,252,4745,96
4545,16,377,3562,299,10544,78
21343,3,167,2633,142,2485,25
45668,0,29,474,18,3576,11
18526,64,2377,2779,1890,26515,487
30406,14,367,2177,312,13617,55
29492,5,112,2224,91,5435,21
4157,72,205243,3576,65844,11474,139399
19499,19,472,2735,350,6356,122
37323,3,114,1825,92,3901,22
9044,23,773,3312,575,25082,198
10519,6,250,3233,196,3646,54
46328,1,57,214,44,1297,13
6591,5,125,3466,108,3543,17
18254,1,105,2790,88,2177,17
41392,8,337,1513,239,4444,98
19485,6,359,2736,264,9213,95
38786,1,77,1725,71,2098,6
26860,70,1947,2368,1500,12571,447
13295,9,404,3072,338,6683,66
2180,21,459,3617,358,11537,101
29154,82,2152,2242,1657,11449,495
11315,8,201,3190,171,3518,30
15964,7,341,2904,222,6675,119
15581,332,28122,2920,17922,167328,10200
33413,20,1038,2037,815,13937,223
3997,9,488,3581,365,9604,123
45360,63,768,578,568,7443,200
29122,4,259,2243,222,4875,37
34862,24,638,1976,544,30966,94
37046,9,102,1842,82,4204,20
15866,128,5926,2908,4233,43152,1693
5691,12,404,3505,339,4842,65
14622,79,4442,2973,3512,39258,930
46060,15,301,310,231,2799,70
31920,0,36,2102,28,1588,8
32071,15,510,2093,356,4214,154
11344,5,100,3188,82,3323,18
42108,20,458,1395,380,12391,78
41199,0,0,1544,0,3435,0
16576,11,371,2874,275,4730,96
31272,96,4530,2135,3310,36044,1220
949,12,272,3948,234,4323,38
34250,58,1187,2008,980,7842,207
18757,28,3120,2768,2197,19958,923
24099,13,491,2493,385,8926,106
18839,55,7255,2765,5476,28105,1779
25062,200,12291,2450,9057,87406,3234
12351,33,1384,3136,999,8089,385
13421,17,855,3063,654,22914,201
30408,7,223,2177,183,5384,40
46278,6,46,235,37,898,9
39041,16,407,1710,345,6414,62
2609,10,526,3609,413,14821,113
11623,22,1474,3173,1179,33662,295
29871,2,140,2206,111,3038,29
10315,69,3197,3243,2379,13467,818
20776,18,846,2668,671,10190,175
4054,1,31,3580,25,2045,6
3394,231,9797,3596,6859,36664,2938
12819,5,254,3110,188,4504,66
23086,11,367,2542,298,9443,69
10699,10,422,3222,315,11321,107
42532,67,1353,1307,1019,40632,334
6364,2,58,3476,44,1839,14
28762,55,2831,2261,2117,41445,714
36515,36,1012,1874,720,7172,292
19445,165,10479,2737,7548,33666,2931
45685,85,842,470,648,7289,194
34055,13,265,2013,209,5525,56
3421,31,1675,3595,1318,12835,357
17558,94,3026,2821,2374,43464,652
2436,201,13785,3612,9480,87478,4305
37406,5,211,1820,159,5898,52
30821,2,504,2156,388,21594,116
41351,4,98,1518,84,3113,14
23091,0,759,2542,546,4988,213
45289,4,65,595,46,2570,19
39736,128,1907,1669,1426,13625,481
20369,102,4392,2690,3246,24443,1146
43655,51,669,992,591,8902,78
3403,20,1006,3595,840,17712,166
21913,61,1622,2601,1274,4695,348
22132,21,1680,2588,1273,37622,407
34511,14,503,1996,426,8269,77
42981,149,3628,1202,2743,54197,885
30005,30,1316,2200,842,13128,474
37015,22,635,1844,525,15407,110
23935,28,2419,2501,1879,17369,540
42747,78,555,1261,419,7676,136
40331,57,2299,1629,1652,23493,647
16197,6,166,2893,134,3726,32
33270,1,62,2042,50,3322,12
40844,5,107,1580,88,4179,19
9969,13476,493648,3259,357406,1180875,136242
3425,15,173,3595,135,5737,38
5536,15,176,3513,131,7462,45
25817,37,1715,2416,1275,11616,440
40207,1,43,1638,35,4440,8
36142,2,106,1893,69,5324,37
30579,7,202,2168,147,8268,55
3883,2,88,3585,76,2748,12
20616,87,6352,2677,4532,31784,1820
14031,16,388,3014,300,6860,88
43645,30,391,995,327,7091,64
45108,11,238,655,205,5153,33
33440,9,234,2036,183,4364,51
25767,4,172,2418,119,2049,53
32568,24,344,2070,279,3493,65
28220,1,141,2293,92,3616,49
43814,90,2676,946,2025,25193,651
2020,5,77,3619,69,4155,8
43181,6,126,1144,94,3711,32
39206,22,856,1699,702,13871,154
8957,13,106488,3316,33920,4665,72568
33153,0,108,2046,87,3501,21
36635,211,8265,1867,6240,59178,2025
19040,26,1055,2757,839,3898,216
39909,277,9348,1657,6572,48574,2776
41751,49,1292,1457,988,20473,304
45092,6,150,664,93,5576,57
16370,24,975,2884,743,4285,232
14540,3,123,2978,96,9116,27
36967,48,4041,1847,2825,26402,1216
5254,35,1122,3527,837,9520,285
7167,88,4707,3437,3396,18658,1311
26911,23,1195,2366,955,18162,240
23305,19,342,2531,309,9446,33
34634,18,903,1989,628,14134,275
16477,2,248,2879,191,4309,57
28714,129,4399,2265,3423,34723,976
41654,3,114,1474,94,3717,20
14036,46,2555,3013,1522,16963,1033
30575,8,269,2168,213,5335,56
12567,7,453,3124,375,11192,78
18804,45,1530,2766,1125,14621,405
35303,5,133,1952,112,5163,21
30395,20,1030,2178,824,12214,206
35347,5,52,1950,44,1924,8
44608,172,2402,818,2078,25171,324
18495,11,436,2780,354,14261,82
4062,12,87,3579,71,4153,16
42354,8,259,1344,184,3740,75
5075,61,1632,3538,1109,15026,523
21474,9,358,2625,304,8149,54
35723,336,7479,1923,5820,29727,1659
30721,10,720,2160,564,8845,156
36975,364,10564,1847,7997,92694,2567
5077,17,449,3538,371,8080,78
37211,2,48,1832,40,3934,8
25891,1,49,2413,47,2051,2
28408,0,177,2282,150,5882,27
46086,2,25,302,17,1441,8
16996,10,287,2852,221,9845,66
29714,1,57,2214,49,3974,8
31039,17,491,2147,377,6897,114
32733,0,48,2064,35,2056,13
26885,4,156,2367,115,4597,41
19247,119,4560,2748,3149,40761,1411
20661,7,267,2675,220,8184,47
4010,18,707,3581,398,16401,309
32129,9,570,2090,386,5110,184
45745,14,263,440,183,3577,80
20009,46,3844,2708,2800,18317,1044
22494,0,3180,2571,2194,24737,986
16761,14,747,2864,623,10059,124
35863,20,1682,1914,1027,16280,655
27352,119,2131,2344,1618,12443,513
3890,3,202,3585,149,7498,53
20708,43,1998,2672,1559,15210,439
11361,0,28,3187,22,1072,6
44705,11,222,793,140,3953,82
10199,3,157,3248,112,4465,45
36446,11,209,1878,169,3937,40
26730,0,41,2375,37,2585,4
19219,7,1080,2750,457,7822,623
7269,238,10250,3432,7404,54840,2846
44672,17,242,805,196,6457,46
25570,51,2677,2428,1866,10649,811
31230,4,353,2138,283,6249,70
32166,10,705,2088,537,11622,168
28655,31,1011,2267,699,18282,312
23286,0,141,2532,101,2792,40
36185,10,220,1891,167,11292,53
11080,40,756,3202,614,4427,142
30156,8,195,2193,169,6844,26
37445,59,2164,1818,1461,23140,703
36326,6,212,1884,163,4549,49
43743,26,483,965,368,17393,115
17043,7,725,2848,540,9997,185
37613,450,20685,1806,15054,117446,5631
34709,6,199,1985,141,4181,58
38116,6,374,1772,290,7562,84
1674,2,52,3661,47,1810,5
7241,5,51,3434,45,3194,6
23703,30,595,2512,499,7991,96
20184,200,11633,2698,8331,59841,3302
38478,6,326,1747,269,10477,57
11847,13,285,3163,216,6059,69
32732,55,2947,2064,2053,28650,894
6827,17,345,3455,250,21851,95
11554,3,118,3176,92,2035,26
16851,71,4117,2859,3154,22676,963
31884,5,384,2103,332,7302,52
4418,31,687,3566,533,9598,154
6933,2,35,3451,22,2677,13
3866,4,104,3586,90,5021,14
38131,1,82,1770,69,3086,13
32505,47,1183,2073,925,13009,258
38274,4,241,1761,180,3821,61
22209,0,38,2584,31,2244,7
46358,35,383,203,329,6082,54
24097,1,36,2493,32,1021,4
39777,17,687,1667,552,11867,135
33726,8,555,2025,433,7027,122
34284,12,489,2006,415,3673,74
5068,18,229,3538,153,11043,76
45552,27,686,521,522,10279,164
3185,22,1029,3599,771,12353,258
33829,7,262,2021,232,2950,30
46078,3,106,304,73,1476,33
15711,0,1363,2914,988,10250,375
23041,8,147,2545,119,2251,28
26101,111,6908,2404,4973,45551,1935
13011,37,2972,3098,2188,46754,784
35484,21,876,1942,625,21880,251
46184,12,150,260,126,3474,24
42194,37,1308,1375,1004,16650,304
42111,4,103,1395,78,3247,25
41844,15,288,1439,245,10213,43
14421,6,308,2987,221,4537,87
3440,15,448,3595,330,4040,118
20450,9,378,2685,258,8723,120
15396,37,2469,2929,1792,24475,677
15915,20,847,2907,679,11498,168
37691,2,43,1802,35,7311,8
8231,7,63,3362,54,6101,9
4101,22,834,3578,566,10880,268
46283,0,13,233,12,1250,1
25071,9,2672,2450,1912,9974,760
5415,4,113,3519,84,4644,29
25607,3,371,2425,305,7610,66
13649,18,876,3045,716,24903,160
6973,3,497,3448,371,13485,126
21983,28,792,2596,632,14583,160
38905,5,128,1718,92,3869,36
12543,3,102,3126,74,2463,28
40364,64,3171,1624,2395,32169,776
30581,4,166,2168,143,5634,23
29948,411,11504,2202,9309,41690,2195
21738,88,6301,2610,4251,54690,2050
21500,28,2092,2624,1427,18921,665
20322,6,297,2692,245,10042,52
36435,109,4414,1879,3375,43755,1039
25238,2,145,2442,111,6461,34
11416,33,1276,3185,1003,20880,273
40527,70,2153,1609,1602,19044,551
38964,14,270,1714,186,3052,84
27963,32,841,2307,662,8609,179
29417,1,95,2228,73,2068,22
42318,4,109,1351,83,5460,26
12480,8,403,3128,305,4307,98
34534,53,1697,1995,1248,26003,449
1988,42,1878,3620,1468,17206,410
44615,10,171,818,107,7542,64
9247,50,1114,3299,840,31548,274
2525,22,691,3611,568,20388,123
35254,6,142,1955,119,4855,23
17132,3,430,2843,299,18935,131
43057,8,188,1180,125,3742,63
27676,143,4579,2324,3569,28884,1010
20213,49,9913,2697,7370,20706,2543
13142,2,140,3089,122,6941,18
6483,12,369,3471,299,10615,70
2556,599,30800,3610,23140,149693,7660
45671,2,25,473,16,2852,9
4227,3,74,3574,61,3216,13
36065,14,676,1898,560,15152,116
25215,7,632,2443,490,4858,142
41081,2,36,1557,22,2242,14
35708,0,65,1924,52,4808,13
19200,19,1163,2751,871,9796,292
4317,54,2321,3570,1939,25204,382
27817,9,367,2316,313,5144,54
38088,22,492,1774,393,14785,99
32446,9,341,2076,274,4909,67
10352,79,2400,3241,1989,60913,411
36378,110,2612,1881,2022,27142,590
32373,2,379,2078,300,4765,79
3735,19,666,3589,499,16813,167
36972,3,80,1847,61,2986,19
44706,26,460,793,389,16001,71
9037,187,12416,3312,8057,85932,4359
21396,21,1608,2630,1265,13108,343
15088,79,5156,2944,3695,46225,1461
43728,244,3102,968,2460,14396,642
43208,11,89,1138,72,3880,17
39266,0,218,1694,174,5902,44
46051,11,147,312,103,5642,44
24305,120,7362,2484,5813,30925,1549
14372,24,709,2990,550,15357,159
30747,10,235,2159,196,4835,39
41522,2,202,1495,151,5497,51
6730,1026,66899,3461,46070,350064,20829
12752,18,742,3114,584,9382,158
38159,82,1920,1769,1360,12104,560
31022,2,57,2148,43,6148,14
9779,32,1053,3269,795,11962,258
29111,5,333,2244,253,6095,80
16553,16,766,2875,539,17529,227
43223,8,197,1132,129,3031,68
28673,0,53,2267,40,4306,13
42286,4,135,1357,108,5822,27
38750,10,282,1728,208,5507,74
13467,109,3215,3058,2501,19519,714
26364,26,1012,2391,787,5705,225
9467,5,124,3284,100,3303,24
3983,86,2903,3581,2246,12241,657
16777,12,666,2862,498,13077,168
21950,86,2954,2599,2260,24558,694
28780,8,234,2261,201,3710,33
7275,110,5072,3432,3794,53719,1278
23915,1,104,2503,93,2873,11
16976,1111,234376,2853,147788,519179,86588
15375,34,4009,2930,3213,7277,796
5358,29,429,3522,369,8407,60
41068,52,1540,1559,1132,16566,408
39872,163,3319,1660,2755,35705,564
27411,9,430,2340,336,4982,94
33041,0,130,2051,112,5125,18
2540,32,860,3611,704,21216,156
40552,2,323,1607,257,11024,66
38385,13,181,1753,120,3734,61
5090,25,579,3537,491,10880,88
37478,8,231,1815,178,4201,53
43935,18,124,926,97,2412,27
5318,28,535,3524,391,17231,144
45201,5,140,623,99,4626,41
10299,197,15266,3244,11130,144797,4136
19157,169,12062,2753,9379,81602,2683
34765,0,167,1982,136,2741,31
2263,1,21,3615,20,3674,1
27785,13,424,2317,332,11280,92
34627,14,304,1990,236,7308,68
14127,160,4207,3007,3107,34073,1100
43924,66,1296,928,896,34035,400
36197,2,126,1890,105,3610,21
42626,17,688,1290,458,7758,230
1991,160,5027,3620,3713,38410,1314
3840,16,256,3586,224,11674,32
30048,47,1483,2198,1097,14701,386
17259,3,358,2835,293,9945,65
40831,3,64,1581,56,5398,8
1452,3,58,3726,49,3981,9
18027,8,598,2800,501,7871,97
5687,9,128,3505,99,2191,29
19262,268,19990,2747,14472,101616,5518
32799,9,187,2061,158,3947,29
28593,72,2444,2271,1928,23799,516
4605,49,943,3559,639,8915,304
26074,4,281,2405,234,6274,47
39719,1,49,1669,36,2592,13
37667,5,104,1804,91,6785,13
27302,667,36414,2347,25881,117393,10533
23810,3,83,2508,71,3013,12
12150,8,110,3147,91,2638,19
30512,12,198,2171,156,3809,42
42927,143,6265,1217,4792,28730,1473
38280,1,81,1761,65,4519,16
3278,7,90,3598,81,3684,9
42852,106,2239,1237,1321,9828,918
38073,6,246,1775,194,3239,52
29671,10,265,2216,218,3294,47
41623,8,349,1479,246,9238,103
38355,1,29,1754,24,2793,5
33087,41,718,2048,584,12311,134
15284,1,139,2934,111,4199,28
6531,2,143,3469,90,3891,53
13972,216,16083,3017,11426,49082,4657
11806,14,520,3164,412,7551,108
13258,15,1036,3075,788,11186,248
10342,24,929,3242,721,6478,208
28444,8,217,2280,172,5695,45
18969,27,843,2760,634,12147,209
13486,23,1032,3057,809,8854,223
29077,8,391,2245,277,3818,114
17182,14,848,2840,623,9412,225
41302,7,337,1525,252,8648,85
45284,28,229,597,199,5689,30
2385,4,606,3613,504,18767,102
29815,48,1785,2209,1330,21788,455
22053,5,302,2593,257,3684,45
33618,146,2905,2029,2284,22302,621
37465,33,806,1816,597,11815,209
18776,17,434,2767,347,6688,87
3411,190,10215,3595,7675,51592,2540
18683,58,2672,2771,2002,14048,670
9171,64,1934,3303,1397,20249,537
20180,10,464,2699,391,5229,73
45492,253,4829,543,3913,46289,916
5614,27,2541,3510,1688,40659,853
25382,3,187,2436,152,3259,35
20603,65,3553,2678,2708,24253,845
31105,0,70,2144,56,1149,14
44711,2,132,790,83,4039,49
13900,1,124,3024,102,5161,22
39651,3,127,1673,97,4174,30
6302,23,1018,3479,778,31379,240
24880,2,440,2458,314,10115,126
37212,7,194,1832,149,4225,45
7485,0,88,3420,77,4706,11
16453,2,63,2880,54,3439,9
13629,4,4,3047,4,8235,0
16844,1,138,2859,116,3982,22
17351,0,65,2831,55,4066,10
36974,27,1168,1847,841,13741,327
21978,17,835,2596,684,8861,151
26753,0,23,2374,21,1249,2
12588,1452,136868,3123,106065,412892,30803
6370,29,1336,3475,1106,19593,230
5288,1088,57837,3525,39037,314853,18800
21047,5,246,2650,197,7817,49
29717,40,909,2213,730,7354,179
31935,19,513,2101,418,14402,95
5977,2918,159305,3490,121518,504407,37787
6513,268,9187,3469,7016,145089,2171
43154,6,232,1151,153,2656,79
38143,4,110,1770,81,2648,29
43400,14,339,1077,272,9920,67
32850,2,117,2058,88,4858,29
33398,0,0,2037,0,2359,0
2377,39,1344,3613,1179,16086,165
4880,12,262,3548,206,3717,56
43185,11,380,1144,214,6416,166
39976,25,621,1652,511,16453,110
38877,29,695,1720,536,7715,159
31028,36,1293,2147,943,24729,350
12845,12,339,3108,272,9741,67
8702,50,1913,3331,1398,22436,515
14605,0,421,2974,328,5903,93
39599,7,359,1676,272,8076,87
12047,48,2285,3153,1679,24743,606
46115,62,1076,293,938,6582,138
6371,84,1939,3475,1451,16726,488
40891,15,1036,1576,639,13392,397
32325,2,189,2081,165,5484,24
18602,76,7110,2775,5273,50156,1837
21358,5,101,2631,88,2288,13
8927,546,23267,3318,17825,74310,5442
5262,115,10466,3527,8473,92684,1993
28484,2,76,2278,65,3185,11
29968,5,195,2201,146,3881,49
5450,2,59,3517,42,3532,17
37660,3,91,1804,74,2127,17
25644,77,4205,2424,3115,45860,1090
33171,11,245,2045,198,7103,47
42073,254,4881,1401,3599,27239,1282
36024,79,1238,1902,987,8385,251
955,1,101,3946,80,5667,21
15997,29,807,2902,584,20523,223
39954,1,53,1654,43,2771,10
39987,2,92,1651,76,3336,16
46083,4,120,303,91,872,29
26847,11,343,2369,281,3797,62
25832,7,1123,2416,797,10552,326
16853,33,1061,2858,807,14174,254
26442,13,204,2388,129,5279,75
26806,7,275,2371,227,8321,48
10662,279,15399,3224,11642,86784,3757
46079,8,99,303,86,1812,13
37872,16,815,1787,593,11757,222
37551,2,215,1810,184,4246,31
9866,69,1588,3264,1151,29943,437
23088,557,22035,2542,15870,136512,6165
28712,111,2088,2265,1503,13594,585
29739,6,78,2213,59,4251,19
29489,16,201,2224,172,4164,29
10427,7,219,3238,148,4277,71
30351,23,368,2181,267,3383,101
7165,2,39,3437,33,2368,6
12891,18,483,3106,378,20993,105
30772,30,1907,2158,1511,26214,396
32473,74,1802,2075,1391,10578,411
27194,1,90,2354,78,1833,12
5151,14,126,3533,85,3073,41
1567,1,37,3685,33,2004,4
33760,17,317,2023,272,9370,45
6366,62,1543,3476,1082,11554,461
4409,17,857,3567,676,20681,181
29281,3,142,2236,131,5511,11
41753,16,213,1457,174,3519,39
37335,10,545,1824,381,18710,164
6786,6,311,3458,241,9563,70
41169,262,5518,1547,3910,48641,1608
40572,3,152,1604,117,2573,35
22803,2,90,2556,78,2060,12
43108,22,650,1164,485,16005,165
42526,9,293,1308,230,5598,63
21632,2,140,2616,96,4311,44
16264,62,2730,2889,1909,25534,821
42781,123,2346,1253,1776,30012,570
16808,11,730,2860,588,11148,142
40007,75,1385,1650,1132,6281,253
40556,15,2251,1606,1544,24990,707
9544,958,40185,3280,27523,121361,12662
28599,3,149,2270,124,3139,25
17570,11,207,2820,181,3137,26
30177,3,48,2191,43,4878,5
31716,1,59,2111,41,1982,18
41092,3,68,1556,42,9376,26
46362,3,105,199,78,1902,27
11170,0,89,3196,67,4000,22
16285,54,3432,2888,2688,26254,744
17289,2,169,2834,152,4457,17
31949,1,139,2100,113,5754,26
16129,26,1076,2895,816,7744,260
23071,0,25,2543,19,2575,6
17167,213,39773,2840,25533,106871,14240
5097,1195,43322,3536,30472,153809,12850
5014,22,578,3541,480,8450,98
20293,41,1782,2692,1486,18685,296
43462,4,36,926,29,1017,7
4311,632,27349,3570,19213,212422,8136
17532,577,42222,2822,28791,296980,13431
19225,1,49,2750,39,5541,10
21473,38,1189,2625,967,20133,222
44997,22,223,705,196,5833,27
27869,2,70,2314,56,3012,14
14253,31,1584,3000,1127,30452,457
34046,2,94,2014,82,2604,12
11420,1,80,3184,57,2005,23
9470,4,327,3284,242,8405,85
7025,9,267,3445,201,3928,66
44415,66,858,852,640,9843,218
27209,78,3094,2353,2335,9678,759
11591,13,973,3175,770,12061,203
3650,5,218,3591,155,4942,63
25686,1,134,2422,104,7235,30
32063,15,1022,2093,656,16961,366
13871,19,1382,3028,1052,17439,330
17170,2,210,2840,163,6973,47
44843,16,288,746,211,8090,77
9142,3,89,3305,74,2832,15
39963,5,201,1653,156,4417,45
11255,36,1203,3192,799,22949,404
14547,11,335,2978,275,7353,60
3103,5,77,3601,61,2413,16
6040,9,506,3488,396,3760,110
37382,1116,24239,1822,18793,147519,5446
24813,29,1734,2461,1345,27810,389
39032,43,636,1711,468,7513,168
12090,173,11401,3151,8069,90502,3332
39133,97,7384,1704,5618,31984,1766
42997,59,1486,1197,1028,8940,458
16219,53,3723,2892,2937,19214,786
42099,0,83,1396,56,5799,27
2671,2,52,3609,42,2468,10
12950,18,280,3102,229,3963,51
23499,36,2346,2522,1722,20552,624
44106,4,54,898,47,4861,7
10791,237,12174,3217,9256,128831,2918
29242,19,495,2238,348,4909,147
11319,4,246,3189,205,6178,41
37326,1,83,1825,71,4368,12
37715,13,252,1800,206,5065,46
11272,18,422,3191,314,6624,108
42076,15,582,1400,419,11650,163
32143,5,249,2089,192,3945,57
18860,10,314,2764,237,2221,77
33614,31,1365,2029,905,14482,460
18422,1,129,2783,101,3605,28
14755,9,741,2963,569,7607,172
38377,87,2945,1753,2114,24083,831
46404,2,61,177,43,687,18
45015,14,154,699,118,3147,36
6503,50,1575,3470,1169,9721,406
3698,6,149,3589,133,19441,16
42210,21,525,1372,432,11289,93
14417,125,4757,2987,3438,49205,1319
16613,38,4683,2873,3332,32762,1351
28167,3,131,2296,112,1910,19
38593,17,319,1738,232,15750,87
24677,77,2838,2466,2174,14664,664
9803,0,43,3267,33,2117,10
3010,11,405,3603,318,13864,87
39974,21,610,1652,474,11771,136
30132,300,30653,2194,21859,82245,8794
9747,2,163,3270,120,5876,43
29690,42,4440,2215,3304,30078,1136
4465,7,173,3565,124,5150,49
10658,58,3935,3224,2924,33276,1011
37358,0,0,1823,0,10074,0
23845,1,63,2506,57,2706,6
2744,45,2011,3608,1566,32300,445
7559,118,3236,3415,2466,27766,770
3602,9,299,3592,225,7805,74
1956,14,509,3621,409,23449,100
14759,19,1139,2963,882,47258,257
29922,6,110,2203,89,2661,21
20816,3,152,2665,132,3904,20
16346,31,2413,2885,1849,13830,564
29736,5,458,2213,325,5422,133
14753,23,796,2963,630,12349,166
22057,274,20330,2592,14545,136246,5785
34850,6,134,1976,108,3002,26
24074,4,124,2495,85,2165,39
3322,65,3441,3597,2397,24272,1044
41655,39,932,1474,690,10965,242
46098,23,330,300,270,5680,60
42824,88,1396,1243,1097,15867,299
12055,26,842,3153,648,9005,194
6904,19,483,3452,391,11190,92
25179,0,1552,2444,1172,9170,380
11143,2,35,3198,29,2807,6
20080,128,6882,2704,5344,63190,1538
11698,727,27447,3169,19824,160810,7623
31443,8,381,2126,319,7250,62
45975,1,40,350,27,762,13
32154,2,82,2089,70,5249,12
45793,1,29,424,21,1704,8
37732,7,438,1799,290,15133,148
39896,51,1891,1658,1324,22269,567
39406,2,112,1687,90,3879,22
7054,541,23043,3443,17159,81019,5884
20639,9,621,2676,499,8232,122
39877,299,8635,1659,6230,50183,2405
28863,369,14824,2256,9770,101141,5054
24847,181,5957,2459,4494,31610,1463
11336,7,99,3189,77,4776,22
3192,136,4723,3599,3643,41728,1080
27130,131,6148,2357,4691,60800,1457
38354,56,1384,1754,1043,12588,341
7357,8,100255,3426,38429,5414,61826
26305,14,2971,2394,1997,39998,974
33415,6,122,2037,91,1856,31
25876,320,5822,2414,4665,60125,1157
42070,5,91,1402,74,3837,17
32919,0,125,2055,101,4322,24
21780,12,298,2608,257,5566,41
5507,2,86,3515,77,2011,9
8027,2,41,3378,34,2172,7
23461,14,252,2523,199,5360,53
28534,203,15736,2274,11748,71994,3988
19998,23,513,2709,399,7587,114
39006,51,1437,1712,1133,16625,304
46047,4,78,314,61,1928,17
26701,1,69,2376,61,1500,8
25707,107,1587,2421,1190,12886,397
21633,7,391,2616,319,15089,72
31723,0,40,2111,34,3007,6
28558,70,3591,2272,2744,21431,847
4793,31,655,3552,518,5764,137
26919,5,289,2366,216,3721,73
6794,14,584,3457,451,22348,133
26005,2,319,2408,242,7638,77
41471,29,817,1501,626,9763,191
39729,7,98,1669,80,3340,18
6613,8,968,3465,785,17088,183
45817,47,1068,415,885,8401,183
25542,1,40,2429,33,3122,7
46428,6,96,162,88,2434,8
45475,9,211,548,174,3982,37
19729,2,238,2724,205,4795,33
40878,23,435,1576,342,13081,93
21784,25,672,2608,520,5338,152
35885,3,114,1912,91,2924,23
36627,0,329,1867,264,7837,65
26408,0,0,2389,0,2869,0
34624,15,450,1990,357,8088,93
26859,32,780,2369,587,7869,193
39809,3,109,1664,69,7700,40
7360,95,2914,3426,2312,40824,602
29363,3,257,2231,203,3974,54
36036,0,28,1901,25,2106,3
6467,57,1133,3471,879,13696,254
18767,4,293,2768,242,7449,51
4690,4,181,3556,136,7828,45
43192,14,142,1142,105,2462,37
16321,44,2221,2886,1591,25610,630
16345,5,151,2885,133,9838,18
44868,9,102,740,76,1853,26
3227,118,4829,3599,3609,43399,1220
6851,15,673,3454,534,9501,139
41273,35,1254,1530,879,28438,375
4177,15,1057,3575,672,7050,385
30785,45,2899,2158,2148,35623,751
46073,12,173,305,128,991,45
22555,809,61745,2567,43807,258490,17938
22194,9,602,2585,469,26979,133
43982,13,199,920,152,4959,47
2266,3,31,3615,20,4656,11
12901,7,226,3105,186,3208,40
17743,338,25005,2814,16416,126922,8589
10560,2,71,3230,63,1569,8
31802,2,94,2107,71,3623,23
24724,31,789,2464,649,8594,140
44883,16,158,738,108,3005,50
20483,113,3177,2684,2243,24068,934
39562,2,51,1678,40,2308,11
34260,9,243,2007,195,3409,48
45437,0,19,558,14,1854,5
2577,67,2901,3610,2338,56603,563
45713,12,269,452,212,8525,57
20694,40,3933,2673,3124,27614,809
5432,167,9817,3518,7365,90482,2452
38388,88,2148,1753,1758,16113,390
11633,8,508,3173,406,11582,102
38803,81,3318,1724,2643,13432,675
40880,88,3275,1576,2322,33756,953
32801,1,115,2061,94,5190,21
25022,57,3685,2452,2878,36254,807
39756,1026,37285,1668,25880,265333,11405
9646,8,421,3274,300,10915,121
43517,79,1242,1043,991,21209,251
8426,50,1286,3349,1028,13486,258
42971,10,217,1206,173,2803,44
11356,119,2675,3188,2065,22250,610
25348,14,1155,2438,939,11475,216
18768,38,2634,2768,2190,12103,444
18638,202,12258,2774,8598,127258,3660
43726,81,1227,968,962,20888,265
38856,88,2044,1721,1447,10226,597
14456,4,485,2984,329,5502,156
42102,1,101,1395,87,4545,14
28477,0,74,2279,55,2222,19
29247,38,2414,2237,1918,10381,496
16430,139,4966,2881,3782,30931,1184
9535,44,1489,3281,1147,13688,342
38741,65,2327,1728,1565,25739,762
12776,5,879,3112,652,14869,227
41746,317,6370,1457,4680,58947,1690
7616,5,231,3411,198,6575,33
961,2,213,3945,186,6589,27
39154,15,434,1702,290,6978,144
29149,20,467,2242,363,5372,104
12985,227,5663,3099,4159,27586,1504
10927,9,350,3209,273,8938,77
28680,13,316,2266,250,3866,66
14206,34,1324,3004,1034,13830,290
45807,2,54,419,39,1192,15
9918,20,424,3262,337,15968,87
9487,28,1206,3283,924,8426,282
18212,46,3146,2792,2013,17248,1133
14322,3,107,2994,65,1587,42
7830,215,11264,3397,8220,84423,3044
36656,3,79,1866,66,3981,13
31611,50,2922,2117,2127,24018,795
8662,29,1073,3333,867,12293,206
37890,34,1377,1787,1080,21176,297
18497,650,46039,2780,30365,160650,15674
29104,12,449,2245,373,2229,76
34195,34,1183,2010,885,13492,298
22921,6,545,2549,475,6724,70
9917,2,105,3262,74,5212,31
30399,7,258,2178,208,4859,50
37537,5,168,1811,139,4141,29
16672,99,6857,2869,4947,61869,1910
22907,571,44949,2550,29700,176740,15249
23296,196,4620,2532,3442,22534,1178
24171,0,17636,2490,13497,68339,4139
23828,11,848,2506,572,4817,276
11699,2,35,3169,22,3115,13
4740,4,57,3554,42,2764,15
11782,14,374,3164,292,16949,82
38122,6,284,1771,219,7164,65
3432,41,924,3595,750,18412,174
43585,16,285,1019,200,4935,85
20595,10,363,2678,305,14145,58
4866,6,48,3549,39,2656,9
38929,76,1999,1717,1567,16144,432
13786,286,23952,3034,17059,134734,6893
17927,35,1974,2806,1510,20801,464
8007,11,373,3379,296,6534,77
28650,494,18140,2267,11056,92710,7084
43304,412,9679,1107,6682,66822,2997
44902,85,800,732,633,10432,167
37606,4,106,1807,84,5998,22
14386,546,62610,2989,41200,308386,21410
21303,3,146,2635,98,2505,48
37515,58,2487,1813,1694,42657,793
44838,71,1470,748,1019,13634,451
16953,8,279,2854,211,14692,68
20309,2,107,2692,82,4736,25
10877,5,435,3212,356,12173,79
14940,34,578,2952,418,6611,160
29041,15,661,2248,542,8639,119
2080,5,156,3618,95,4421,61
43063,25,526,1178,365,6624,161
9651,3,57,3274,38,6693,19
21344,11,453,2633,349,11091,104
11205,150,4197,3194,2917,35813,1280
19715,34,3944,2725,2873,31780,1071
34247,18,290,2008,215,4568,75
25034,64,546,2451,422,25669,124
45950,1,27,359,19,1926,8
8632,31,1211,3336,888,25199,323
42975,102,1505,1205,1133,8608,372
15784,3,65,2911,53,2891,12
28657,6,992,2267,762,7610,230
13764,2,134,3035,114,2488,20
46417,7,103,169,85,2385,18
30583,13,438,2168,365,5577,73
18777,151,8111,2767,5693,25749,2418
28614,41,796,2269,618,8681,178
2799,1015,57863,3606,38961,215898,18902
24280,1,47,2485,43,5243,4
44783,5,136,767,82,3095,54
35074,14,350,1965,274,13258,76
45436,9,117,558,75,1873,42
19531,1039,60239,2734,41488,285979,18751
13425,4,103,3063,90,2869,13
23441,10,291,2524,233,5002,58
43012,1,22,1193,21,2117,1
4212,28,593,3574,476,8935,117
36633,18,226,1867,171,3527,55
23582,94,3474,2517,2597,39145,877
31575,58,1755,2119,1306,18065,449
23289,76,3303,2532,2630,19783,673
18181,8,416,2794,338,3944,78
22294,11,261,2580,222,4363,39
27662,58,2155,2325,1673,16535,482
7772,21,268,3401,205,14610,63
45579,0,67,513,54,2060,13
36930,4,176,1850,149,7821,27
11042,9,316,3204,265,4609,51
20615,5,115,2677,100,6509,15
11577,255,26079,3175,18849,117813,7230
7942,60,1587,3385,1215,15654,372
23471,14,938,2523,795,13562,143
12563,3,192,3124,154,10059,38
32503,1,244,2073,194,11391,50
41396,41,1050,1513,773,28007,277
38017,28,648,1779,510,8276,138
7196,85,5966,3435,4451,26732,1515
25535,16,283,2430,240,4362,43
8714,173,5092,3330,3994,32670,1098
27358,1,48,2344,45,2103,3
9488,21,1120,3283,863,16711,257
26973,15,831,2364,631,7379,200
39912,51,1302,1657,917,12022,385
30214,40,1493,2189,1084,19840,409
12806,26,2727,3110,1980,31314,747
35927,11,418,1909,335,10011,83
40237,50,1089,1636,811,21711,278
41312,4,98,1524,68,2163,30
41284,63,2129,1528,1410,20877,719
12821,7,406,3110,330,7884,76
19004,41,1922,2759,1512,20857,410
30296,2,287,2185,223,5526,64
36292,7,171,1885,146,3941,25
31733,2,227,2111,193,11798,34
11427,94,4191,3184,2982,22010,1209
38658,183,4439,1733,3093,25955,1346
18070,89,7918,2798,5067,56281,2851
6053,18,268,3488,196,5228,72
22734,38,2299,2559,1850,23203,449
38114,17,685,1772,505,10557,180
8349,1,257,3353,200,11393,57
21963,1,150,2597,121,5141,29
41435,47,486,1505,369,8570,117
27431,21,2267,2340,1958,14399,309
19683,30,1573,2727,1231,12920,342
42408,4,363,1334,262,6651,101
45694,10,90,464,69,1332,21
24261,8,149,2487,126,2351,23
40772,0,63,1587,52,5522,11
46502,0,9,125,8,554,1
13249,51,1524,3075,1110,21726,414
14046,59,3332,3013,2651,44367,681
32737,756,26656,2064,17772,156759,8884
41850,21,1213,1438,908,29110,305
14101,14,608,3009,464,12318,144
4225,31,428,3574,346,5105,82
20751,3,282,2670,236,5947,46
44844,17,152,746,105,3028,47
14907,9,174,2954,148,2973,26
4071,3,74,3579,58,2155,16
4636,3,191,3558,160,3219,31
14511,3,130,2980,104,7160,26
4494,43,1282,3564,931,15967,351
28881,464,19646,2256,14915,67004,4731
10473,7,114,3235,91,2949,23
32284,0,96,2083,84,4603,12
7481,56,2990,3420,2386,19955,604
23054,2,176,2543,130,3260,46
2511,24,2050,3611,1671,44823,379
40306,20,440,1632,350,9876,90
37139,12,403,1837,328,10918,75
14556,131,3707,2977,2634,31056,1073
12823,36,851,3109,634,6752,217
10739,16277,679642,3219,474154,1367398,205488
39114,1,70,1705,57,3716,13
8498,87,2663,3344,1923,48796,740
34944,5,383,1972,301,7533,82
20670,388,28073,2674,19783,175010,8290
35987,7,192,1904,151,8308,41
18828,1,54,2765,42,3130,12
33067,57,2462,2049,1929,14598,533
37317,10,269,1825,235,6364,34
10006,3,118,3258,92,7056,26
21488,4,305,2625,245,5039,60
9576,5,326,3278,236,5944,90
9017,5,435,3314,316,7985,119
7855,15,676,3394,484,5016,192
45760,134,1399,433,1169,12736,230
36241,1,40,1889,33,2023,7
6562,21,796,3467,655,10617,141
41759,5,133,1455,108,4587,25
11253,4,103,3192,77,2617,26
17649,3,129,2817,107,3750,22
30584,14,1081,2168,901,8163,180
23992,115,6776,2498,5077,36259,1699
37166,21,651,1835,513,13088,138
6836,321,17725,3455,12424,87853,5301
36384,69,2339,1881,1793,12300,546
23360,10,449,2529,358,14014,91
10950,4,121,3208,97,6489,24
19252,4,133,2748,113,3514,20
28685,5,117,2266,74,2499,43
36110,7,264,1895,207,3378,57
6385,4,132,3475,108,5413,24
42239,3,383,1365,200,11375,183
6680,669,78852,3462,50746,202536,28106
31057,9,534,2146,436,11937,98
40046,85,5300,1647,3907,35676,1393
9220,7,380,3301,245,9742,135
27322,6,305,2346,245,6470,60
13791,15,336,3034,215,5740,121
21486,12,490,2625,378,8938,112
43432,19,527,1068,352,7002,175
5871,10,533,3496,438,7585,95
15570,0,1206,2920,923,11151,283
5176,48,2326,3532,1741,70258,585
26447,3,307,2387,249,3340,58
2466,138,5588,3612,2740,33911,2848
40689,5,179,1595,127,9216,52
22471,5,208,2572,159,15528,49
31539,22,525,2120,438,17697,87
26602,10,791,2381,577,10284,214
40791,76,1447,1586,1042,14187,405
45068,19,187,677,135,5065,52
2819,22,735,3606,503,8611,232
16432,48,1672,2881,1214,16192,458
42821,55,1044,1243,826,24455,218
22386,10,464,2576,318,10431,146
12504,76,4812,3127,3280,42072,1532
11778,2053,96368,3164,64256,406947,32112
16867,11,588,2858,477,5163,111
45077,26,620,673,474,6339,146
7203,8,131,3435,101,3173,30
41931,123,3953,1425,2801,45241,1152
43529,19,298,1038,215,9404,83
23800,2,195,2508,168,5546,27
21128,5,397,2646,302,11339,95
5148,6,185,3533,159,17854,26
43807,11,142,947,106,2527,36
26622,6,137,2380,125,2930,12
2158,6,224,3617,190,6631,34
38321,41,1416,1757,1110,22072,306
41090,615,15928,1556,11017,134200,4911
12140,28,1055,3147,882,17258,173
33855,5,159,2020,136,9559,23
7827,5,104,3397,79,1926,25
22129,27,1650,2588,1220,14233,430
9266,16,509,3298,404,5574,105
31261,55,2407,2136,1912,38964,495
22979,11,454,2546,360,4778,94
4622,645,41745,3559,27224,238040,14521
10722,4,314,3221,243,10871,71
5322,27,948,3524,736,14326,212
27032,18,522,2363,405,16625,117
43806,24,317,948,252,5688,65
39071,251,14704,1707,10893,91780,3811
39802,4,282,1665,234,6916,48
35614,15,220,1932,171,3420,49
36414,89,4429,1879,3136,41727,1293
28770,1,71,2261,58,4449,13
26888,8,611,2367,495,9324,116
45163,17,179,634,139,3584,40
18229,117,5152,2791,3889,18596,1263
46251,52,682,244,602,10415,80
45243,11,121,613,82,1666,39
18234,55,1745,2791,1359,8234,386
18794,6,225,2767,194,5465,31
1756,9,149,3639,115,2568,34
43549,276,7172,1031,5607,72818,1565
39193,98,3392,1700,2320,15118,1072
27741,2,127,2321,103,4122,24
29719,50,724,2213,555,10012,169
26629,10,403,2380,319,5855,84
2931,17,714,3604,569,16296,145
28486,18,1063,2278,886,8885,177
3868,340,20460,3585,15027,95377,5433
13670,60,2190,3044,1709,17272,481
10200,46,1693,3248,1194,21161,499
10021,7,144,3257,123,4291,21
17332,1,89,2832,41,5406,48
1993,25,657,3620,553,36309,104
10542,14,794,3231,590,11291,204
7741,14,529,3404,421,6876,108
5290,22,772,3525,575,7264,197
27324,3,188,2346,137,5975,51
1699,3,74,3659,66,3456,8
29255,17,681,2237,500,5343,181
34438,3,144,2000,99,4035,45
12559,14,501,3124,398,9643,103
24390,0,1346,2480,1024,12721,322
39216,3,186,1698,148,7093,38
39871,60,1039,1660,837,7980,202
11461,31,1120,3181,827,18202,293
5025,11,420,3541,351,5280,69
34766,367,19412,1982,14053,88302,5359
20713,1060,77978,2671,59103,379874,18875
11652,112,7129,3171,4953,69135,2176
13537,14,784,3052,567,18931,217
41162,3,269,1548,197,5859,72
14433,118,10134,2986,5109,31921,5025
3414,8,229,3595,166,4893,63
31146,11,237,2142,197,10528,40
25810,0,37,2416,32,1456,5
9916,121,4376,3262,3252,26857,1124
15113,30,3116,2943,2397,22245,719
16456,35,2343,2880,1722,14647,621
3150,111,3518,3600,2647,34621,871
27686,1,185,2324,152,11167,33
17361,17,765,2830,633,14586,132
36484,31,1172,1876,918,16702,254
5232,195,5022,3528,2961,24728,2061
3279,8,185,3598,134,6382,51
42337,335,7058,1348,5350,51417,1708
22278,137,5966,2581,4570,48980,1396
29598,59,2370,2220,1754,24142,616
1866,236,9201,3623,7066,74527,2135
14218,8,626,3003,512,28081,114
21302,9,389,2635,293,4960,96
30668,15,1075,2163,830,19700,245
5926,11,907,3493,701,6509,206
10708,28,1038,3221,806,27177,232
37090,0,36,1839,28,2745,8
10612,5,25,3227,20,2671,5
9539,1,63,3280,52,3049,11
42130,14,689,1391,495,18037,194
33630,15,605,2029,470,5954,135
1526,2,94,3699,79,2908,15
3364,82,3673,3596,2843,22857,830
35075,5,175,1965,139,5493,36
9315,78,2364,3295,1828,22075,536
5280,1,64,3526,50,4427,14
23188,39,2395,2537,1883,17091,512
16788,19,811,2861,657,13013,154
5465,6,135,3517,102,5007,33
7560,32,905,3415,738,23078,167
44529,239,2505,832,2126,36961,379
30638,9,438,2165,359,6875,79
41272,24,1012,1530,726,25903,286
30489,171,4694,2173,3649,27308,1045
27223,3,200,2352,158,4523,42
45106,59,902,655,564,7104,338
19146,13,302,2753,224,3863,78
2857,393,240097,3606,87724,81351,152373
31337,72,1404,2132,1079,10270,325
19167,12,596,2752,454,6573,142
36382,7,492,1881,373,17139,119
15305,16,512,2932,368,5972,144
40996,3,207,1568,156,7124,51
14679,0,63,2969,51,2836,12
10080,496,23434,3253,16937,114336,6497
3422,29,1953,3595,1468,25542,485
3722,81,1952,3589,1599,26020,353
2657,12,273104,3609,88164,14839,184940
34902,44,1914,1974,1512,16537,402
45740,112,2300,441,1716,17500,584
36524,23,296,1874,235,3295,61
12245,247,17181,3142,11233,110963,5948
12045,24,979,3153,638,16930,341
26853,23,1249,2369,879,8126,370
2993,20,567,3603,437,11439,130
6556,133,3928,3467,2725,28238,1203
42959,22,413,1209,291,8600,122
5685,19,409,3505,322,14666,87
6262,742,19738,3481,14154,80171,5584
21489,17,634,2625,470,6881,164
6056,3,91,3488,66,4501,25
25759,432,30095,2419,22686,120362,7409
29737,26,549,2213,450,5645,99
21692,10,319,2612,248,5105,71
45736,17,101,441,81,2718,20
32273,1,114,2083,89,6335,25
10073,97,6242,3254,4850,51259,1392
10546,4,215,3231,182,3261,33
8133,7,217,3368,174,10516,43
22933,3,266,2548,219,5047,47
15301,8,429,2932,351,10644,78
37878,77,677,1787,510,6002,167
15792,0,389,2910,302,5016,87
14111,139,4605,3008,3287,34417,1318
46433,11,250,159,233,5653,17
44651,65,581,813,487,7478,94
23820,15,375,2507,292,2056,83
21115,19,694,2647,508,4954,186
16757,86,1881,2864,1444,13321,437
36831,51,816,1855,654,15399,162
14384,32,1220,2989,930,16816,290
8659,12,269,3333,231,3343,38
35455,44,459,1945,359,4478,100
16864,11,229,2858,171,4997,58
26279,5,222,2396,170,3303,52
1479,7,263,3712,203,2745,60
3005,213,5731,3603,4217,50403,1514
18702,9,301,2771,232,3446,69
11701,5,216,3169,160,7621,56
10188,82,2282,3249,1717,10588,565
35851,36,511,1914,431,7862,80
25317,3,208,2439,173,5995,35
24387,19,901,2480,732,8198,169
42524,14,188,1309,144,3870,44
38873,8,199,1720,158,3528,41
2485,28,1004,3611,851,11045,153
21456,28,1366,2626,1082,7785,284
3188,11,505,3599,394,12227,111
28795,10,511,2260,401,6790,110
1945,63,1048,3621,785,10663,263
40639,3,271,1599,206,7169,65
7217,1,77,3435,64,3875,13
30958,2,127,2151,95,2596,32
20198,4,103,2698,67,8402,36
14904,33,864,2954,630,7666,234
8892,63,2835,3320,2251,27603,584
27667,139,9426,2325,6980,76122,2446
34474,161,2574,1998,2068,17745,506
7624,77,4329,3411,3295,31278,1034
42645,83,1547,1286,1081,16133,466
44023,4,57,913,46,2561,11
20275,262,14707,2693,10909,88931,3798
35768,31,679,1920,537,7080,142
38272,6,298,1761,259,2782,39
33322,19,577,2040,473,13449,104
43138,6,215,1155,150,2591,65
35364,35,383,1950,313,4852,70
15077,261,16394,2944,12167,69172,4227
36663,0,25,1866,20,2749,5
40853,193,6720,1579,4616,85936,2104
9149,82,1873,3304,1373,12170,500
31997,1,50,2097,41,1660,9
21939,5,148,2600,113,3395,35
13251,8,219,3075,191,6647,28
41818,25,847,1442,635,14742,212
45474,10,85,548,70,2221,15
18531,7,350,2779,263,7416,87
19462,2,390,2737,269,5397,121
36070,0,87,1897,72,3347,15
37378,24,767,1822,618,20495,149
34928,78,3918,1972,2812,62281,1106
44977,7,85,711,57,1878,28
37908,34,843,1785,664,12540,179
1933,222,11428,3621,8022,66985,3406
19577,3,312,2732,264,3730,48
4328,79,3659,3570,2875,11094,784
2941,7,244,3604,197,10194,47
22116,8,106,2588,91,2188,15
27559,14,1161,2331,904,20300,257
45626,1,14,495,8,1035,6
27426,2,57,2340,48,2144,9
22159,64,4801,2587,3516,30730,1285
3104,12,262,3601,190,6409,72
9704,0,164,3272,50,1565,114
20019,97,1462,2707,1122,9693,340
37324,10,509,1825,419,6726,90
25478,34,1337,2433,1082,17854,255
36464,0,31,1877,24,3465,7
33650,0,133,2028,115,3507,18
5315,2,67,3524,46,4017,21
30456,4,95,2174,75,6256,20
3107,0,16,3601,11,1467,5
17615,9,825,2818,646,10840,179
28283,14,591,2290,461,5375,130
44907,5,144,731,109,2523,35
2041,245,10206,3619,7085,50319,3121
32248,85,1691,2084,1268,12475,423
2807,33,1407,3606,1098,14899,309
20159,155,9152,2700,6992,47393,2160
10717,169,7568,3221,5559,34702,2009
33235,8,221,2043,150,6227,71
27625,10,1003,2327,762,4007,241
34111,395,6721,2011,5110,25039,1611
3067,5,101,3602,88,5227,13
14381,45,2490,2989,1899,19727,591
43922,7,98,928,76,3789,22
26505,7,444,2385,347,13036,97
33533,89,1777,2031,1374,11288,403
31123,146,4979,2143,3864,24539,1115
37092,11,364,1839,305,13029,59
10798,65,4502,3216,3346,23356,1156
3057,5,294447,3602,92359,4345,202088
8433,110,1222,3349,987,53805,235
41840,6,702,1439,484,17593,218
38996,10,270,1712,217,4902,53
31763,1,40,2109,33,2549,7
41776,6,143,1453,102,10465,41
12167,33,1472,3146,1072,36237,400
35533,22,1068,1938,794,37945,274
3180,2,47,3600,31,2952,16
23706,14,1594,2512,1188,27253,406
39758,52,748,1668,580,7796,168
42930,16,565,1215,418,10019,147
5793,62,1605,3500,1216,21265,389
13172,4,276,3079,211,13370,65
19892,73,3272,2715,2456,13348,816
42470,3,81,1320,64,3916,17
7860,1,26,3393,25,1982,1
15663,27,690,2916,542,4666,148
13715,3,225,3040,188,14435,37
28600,5,406,2270,323,20691,83
24234,19,775,2488,629,8092,146
19124,287,16467,2754,12468,102025,3999
45777,26,390,426,276,2747,114
45356,49,480,578,407,5717,73
5331,46,2297,3523,1887,23043,410
3215,61,1045,3599,847,11057,198
34874,3,380,1975,332,8425,48
12445,14,475,3130,381,4305,94
25680,0,37,2422,31,1104,6
13165,23,412,3080,322,7233,90
28134,78,3906,2299,2752,22215,1154
24310,65,3843,2484,2997,19571,846
15764,2,109,2912,63,3401,46
36427,8,425,1879,324,5845,101
39833,13,432,1663,326,7272,106
15836,30,1552,2909,1172,15693,380
34460,11,278,1999,227,3086,51
40045,45,760,1647,602,6208,158
15242,21,1049,2936,821,5855,228
24628,6,212,2468,187,9577,25
27054,1,131,2362,109,3664,22
8318,4,441,3356,360,6588,81
11254,5,258,3192,215,7139,43
22636,1,82,2564,75,2439,7
46177,1,27,263,19,1162,8
9877,56,937,3264,734,7195,203
23233,1,169,2535,143,2589,26
3458,36,1117,3594,784,19544,333
12004,10,483,3154,370,8064,113
28591,6,111,2271,97,2593,14
25588,433,25863,2427,16803,98438,9060
9828,8,232,3265,199,10255,33
4830,99,3260,3551,2677,16265,583
44568,123,1798,826,1559,14136,239
16725,10,625,2866,528,8131,97
11855,1,65,3162,44,1592,21
31120,8,264,2143,223,6175,41
4768,372,29780,3553,18526,157580,11254
37627,9,268,1805,180,9313,88
28803,8,145,2259,118,2191,27
39543,25,401,1680,323,10845,78
42172,11,278,1380,221,30507,57
35876,4,77,1912,70,2095,7
23171,1,275,2538,222,5168,53
35194,49,896,1959,680,11247,216
12842,3,114,3108,93,4084,21
7070,110,10776,3442,6387,38192,4389
16868,120,9818,2858,7490,94791,2328
16492,1,70,2878,53,2252,17
6798,174,4829,3457,3602,37211,1227
8256,1276,29145,3360,20111,244378,9034
28702,640,14547,2265,11676,57286,2871
40025,2,77,1649,60,3050,17
18714,7,272,2770,212,3812,60
8335,19,284,3355,216,6724,68
10416,493,78053,3238,48291,253525,29762
33442,5,442,2035,334,9444,108
33315,41,1203,2041,966,12562,237
6872,21,616,3454,465,12415,151
24998,54,2740,2453,1974,29343,766
21973,4,160,2597,139,9337,21
37780,10,222,1795,180,5471,42
36836,0,0,1854,0,44784,0
993,5,227,3933,181,9227,46
41670,117,1076,1472,811,14283,265
2300,116,4521,3615,3575,35413,946
15461,48,3110,2927,2456,28674,654
11615,9,709,3174,607,7127,102
8563,8,506,3339,374,7561,132
43321,15,344,1103,274,6005,70
20152,5,159,2700,130,4391,29
38813,2,15,1724,11,2092,4
18129,148,5447,2796,4221,43821,1226
33321,5,172,2040,143,9973,29
40828,2,80,1581,63,6056,17
41830,2,77,1440,64,3256,13
39448,22,873,1685,630,12777,243
2721,36,652,3608,488,16819,164
43341,67,1424,1097,1119,23282,305
22434,14,628,2574,476,9701,152
3807,27,879,3587,661,6677,218
3956,95,3342,3583,2662,31552,680
3274,39,2003,3598,1459,67501,544
7299,3,149,3430,124,5369,25
44835,29,177,748,137,3002,40
12249,1645,143808,3142,85193,634152,58615
11720,18,509,3167,398,3186,111
27342,5,140,2345,117,5778,23
6339,2,71,3477,40,3756,31
32914,55,1865,2056,1456,21710,409
33250,8,119,2043,103,3797,16
33615,74,2343,2029,1742,47658,601
11854,2,66,3162,56,1900,10
40096,300,9090,1645,6505,47862,2585
25691,21,760,2422,623,6205,137
4719,1,82,3555,60,2611,22
19853,4,146,2717,124,4121,22
19644,6,141,2729,107,8464,34
6670,40,1486,3463,798,15253,688
13881,35,3369,3026,2177,14342,1192
6054,10,163,3488,127,2905,36
17582,69,4682,2819,3255,19671,1427
2974,47,1336,3603,1075,13396,261
3990,1160,54393,3581,36750,193806,17643
9510,141,15401,3282,9746,40974,5655
19414,5,410,2739,302,21434,108
12841,52,5436,3108,3798,46635,1638
17311,3,126,2833,96,7441,30
46467,7,126,142,121,1993,5
42640,232,3645,1287,2672,30418,973
29735,182,4910,2213,3989,23634,921
23432,5,151,2525,115,7409,36
13652,114,9758,3045,7080,77298,2678
19089,618,72431,2755,50559,223627,21872
2062,27,633,3618,513,12863,120
19555,0,86,2733,61,3359,25
32234,1,23,2084,20,2651,3
6431,2,49,3473,42,1557,7
27541,16,656,2332,533,20539,123
46202,2,55,255,30,1279,25
4599,2,39,3560,33,1522,6
28677,72,5479,2266,4580,21718,899
36677,0,83,1865,64,5931,19
6484,5,129,3471,85,6656,44
31950,14,617,2100,490,7834,127
40478,6,102,1613,84,3770,18
14029,38,1904,3014,1494,23528,410
21181,6,686,2641,406,4510,280
20944,22,1019,2656,846,7230,173
39919,36,1320,1656,797,19463,523
39511,58,2317,1682,1655,14041,662
32574,7,319,2070,259,4283,60
19535,14,1137,2734,903,17634,234
21537,8,632,2622,520,8217,112
32340,0,58,2080,48,3091,10
21662,17,414,2614,324,2879,90
5629,286,13482,3508,10658,56065,2824
8336,12,483,3355,374,7174,109
20974,8,363,2655,291,4789,72
10164,7,178,3250,124,2157,54
16991,3,346,2852,265,6697,81
39131,5,147,1704,109,4314,38
19043,1,40,2757,31,1273,9
14801,0,42,2959,32,5629,10
17787,4,253,2813,207,10221,46
45174,13,218,631,174,4310,44
45339,39,740,583,656,11861,84
43168,2,84,1146,56,2531,28
41635,1,22,1478,19,5508,3
10158,12,287629,3250,87436,5603,200193
7407,4,128,3424,111,2393,17
6387,12,394,3475,302,8292,92
19238,15,495,2749,395,23960,100
2138,3,63,3617,56,3316,7
3019,0,22,3602,17,2471,5
31384,32,1312,2130,1108,30899,204
46277,9,146,236,118,2846,28
11750,163,7324,3166,5417,57380,1907
40769,201,6538,1587,5296,40141,1242
45925,66,1042,374,817,5629,225
25144,0,183,2446,153,3862,30
30085,18,340,2196,276,5846,64
45822,54,862,413,704,14604,158
21754,12,1825,2610,1443,15875,382
13941,342,26024,3021,17942,149147,8082
37597,1,133,1808,94,3923,39
38899,22,1764,1718,1334,12064,430
27954,301,15580,2308,12028,99757,3552
23422,4,550,2525,415,8536,135
27156,44,1283,2356,1050,11635,233
18649,0,0,2773,0,1236,0
33411,31,1449,2037,1162,11688,287
6939,8,163,3450,136,3114,27
32337,4,260,2080,223,5350,37
45762,46,799,433,644,7277,155
27666,17,673,2325,579,6846,94
24347,5,409,2482,311,5875,98
15217,4,200,2937,157,4742,43
16929,16,753,2855,556,12271,197
13743,29,1124,3037,909,20621,215
1217,4,96,3861,82,2788,14
9286,5,220,3297,174,6505,46
43267,0,50,1118,41,2428,9
4036,165,6871,3580,4650,84253,2221
20569,7,174,2679,143,2843,31
2548,4,206,3610,175,3770,31
14627,1,51,2973,38,2634,13
12212,39,1103,3144,859,13009,244
1445,0,22,3737,20,1765,2
43392,9,106,1078,88,2550,18
22536,100,9158,2568,6159,42884,2999
2090,6,232,3618,167,7305,65
22105,18,932,2589,666,6202,266
40788,8,183,1586,139,3553,44
19692,9,308,2727,233,6052,75
19596,12,1658,2731,1280,24627,378
3684,3,186,3590,143,4445,43
10064,55,1405,3254,1081,14272,324
9117,9,125,3307,96,2880,29
35683,20,262,1926,213,3779,49
2183,13,452,3617,361,10042,91
14610,15,802,2973,629,12069,173
20674,29,760,2674,518,6252,242
18846,621,36526,2764,26896,163757,9630
32567,13,649,2070,500,11355,149
31373,17,885,2130,658,12497,227
20248,145,24698,2694,14687,73215,10011
17091,13,667,2845,524,11118,143
45956,22,165,357,109,1783,56
25671,22,431,2422,325,3789,106
40002,33,470,1650,373,8393,97
37135,58,2084,1837,1574,13090,510
2634,1000,76000,3609,52527,324433,23473
12530,15,364,3126,280,11015,84
5850,10,680,3497,546,14101,134
35019,17,1285,1968,944,15139,341
9813,25,441,3266,352,12326,89
30590,6,144,2167,104,4346,40
45084,106,976,669,725,8718,251
36565,18,507,1872,420,21215,87
30222,276,8168,2188,6134,65486,2034
7447,50,2186,3422,1496,17021,690
31720,32,1017,2111,788,8576,229
2373,60,1690,3613,1365,20221,325
45177,50,1047,630,796,8096,251
26710,14,413,2376,310,3706,103
32472,3,112,2075,77,3385,35
6497,3,63,3470,52,2423,11
32422,13,508,2077,320,8850,188
3608,2,69,3592,55,3199,14
25313,30,518,2439,418,10703,100
23771,1,47,2509,40,1694,7
12061,97,3775,3152,2719,22585,1056
28985,0,54,2251,41,2812,13
31669,140,2903,2113,2217,21227,686
40813,0,14,1583,10,1259,4
30646,15,401,2164,291,13438,110
10752,7,234,3218,180,3972,54
6643,41,1675,3464,1227,18064,448
20168,6,294,2699,238,9528,56
19687,42,970,2727,779,7856,191
28951,17,1379,2252,1128,7471,251
38769,5,88,1726,72,3418,16
13109,29,958,3091,779,19507,179
11489,12,587,3180,494,14220,93
43480,13,723,1056,548,14520,175
19757,170,9035,2722,7034,93717,2001
43947,148,2208,925,1551,21730,657
27220,18,323,2352,258,3795,65
38340,7,314,1756,248,8642,66
33853,1,131,2020,98,4910,33
25117,271,12067,2447,9249,106711,2818
18388,4,87,2784,70,4740,17
30970,112,5837,2151,4150,41383,1687
32803,15,241,2061,198,4120,43
16507,3,130,2877,103,5540,27
31264,38,1345,2136,1110,11531,235
46292,4,170,229,135,2224,35
21150,24,1952,2643,1462,27984,490
33047,10,299,2050,222,5514,77
43034,10,249,1187,221,6623,28
25779,4,224,2418,177,2779,47
12692,6,293,3117,245,6827,48
10827,6,128,3215,108,5250,20
42275,8,215,1358,162,3772,53
25877,18,1061,2414,841,14552,220
14757,0,29661,2963,8743,4221,20918
7563,22,716,3415,591,14312,125
45242,161,1616,613,1246,14395,370
34569,35,1707,1993,1418,33553,289
32535,21,589,2072,449,13842,140
9319,31,469,3294,341,3392,128
30180,14,697,2191,571,6482,126
24173,7,299,2490,236,3751,63
7043,9,617,3443,508,11809,109
28202,17,1029,2294,830,6599,199
36305,20,331,1885,246,4927,85
1907,18,668,3622,462,11295,206
38185,1,77,1768,65,4208,12
16424,138,9065,2881,6915,43887,2150
35788,14,215,1918,175,4482,40
24839,9,326,2460,251,8733,75
46477,1,28,137,25,1053,3
11029,10,124,3204,103,10236,21
40182,20,515,1640,372,6784,143
42442,19,336,1326,238,4496,98
30916,66,1173,2153,967,18704,206
10833,37,2280,3214,1725,13180,555
41893,0,29,1430,23,3086,6
4996,2,133,3542,106,4616,27
33737,17,603,2024,483,5559,120
13101,93,4790,3091,3719,24502,1071
34673,560,123794,1987,85675,245093,38119
43186,17,337,1143,245,4235,92
39828,0,19,1663,18,2653,1
3848,14,1046,3586,863,9650,183
20953,137,6274,2656,4827,54595,1447
3733,34,1387,3589,1050,9757,337
14256,2,81,3000,66,6234,15
43182,107,1983,1144,1325,14470,658
18750,47,2181,2769,1679,15140,502
2391,17,478,3613,376,8040,102
8781,39,1068,3326,778,12458,290
27075,82,4935,2361,3547,40779,1388
25223,760,50442,2443,33829,231942,16613
42350,10,134,1345,99,3725,35
35378,9,717,1949,591,10363,126
5665,12,275,3506,226,4957,49
3706,74,2230,3589,1767,21886,463
36127,3,80,1894,71,2747,9
41244,36,854,1535,628,11187,226
3333,8,91,3597,61,5101,30
3959,7,323,3583,222,4307,101
9573,3,145,3278,123,4719,22
27207,43,1445,2353,1110,14262,335
13514,18,634,3055,500,20711,134
4903,32,1894,3546,1543,6474,351
39079,59,2254,1707,1752,13894,502
28602,42,1170,2270,922,25410,248
23131,6,211,2540,154,2154,57
43047,242,8501,1183,6538,70121,1963
25614,4,48,2425,41,2449,7
41427,5,268,1507,201,4339,67
31353,8,719,2131,650,4267,69
22795,201,5099,2556,3768,28361,1331
35105,1,175,1963,145,2063,30
41571,100,2365,1489,1669,24582,696
30438,6,332,2176,263,5893,69
3926,9,308,3584,242,6658,66
28141,5,220,2299,184,8238,36
4022,0,53,3580,30,2304,23
10369,96,1821,3240,1500,7170,321
19602,35,1865,2731,1421,11286,444
15228,6,86,2936,73,4265,13
30660,0,38,2163,28,1774,10
27193,2,73,2354,56,1532,17
18167,124,5093,2794,3699,25081,1394
11912,2,94,3159,82,3850,12
38917,19,188,1718,146,3286,42
28456,6,153,2280,135,5082,18
23736,1,63,2510,51,4746,12
45620,2,56,501,44,2764,12
21924,285,25520,2600,18741,100780,6779
29890,3,420,2204,332,12988,88
10967,37,692,3207,548,12527,144
39730,46,813,1669,623,9307,190
9248,4,48,3299,35,2278,13
21919,10,426,2601,328,11106,98
22367,7,374,2577,298,6522,76
39343,1,124,1690,87,3055,37
9833,14,1165,3265,938,11978,227
9883,5,47,3263,41,2773,6
28099,1,43,2301,25,2703,18
4047,140,3742,3580,2952,24184,790
41507,61,1932,1496,1480,18421,452
23452,2,81,2524,67,4905,14
12707,5,286,3116,235,4889,51
7945,3,61,3385,42,1573,19
9450,111,6044,3285,4693,43684,1351
39339,3,94,1690,79,4402,15
31435,5,247,2127,200,12216,47
8885,4,115,3320,91,3949,24
40601,17,156,1602,129,5004,27
29131,19,617,2243,465,7780,152
22916,92,6401,2550,4562,36954,1839
19878,5,235,2716,201,9850,34
2213,157,5556,3616,4178,49089,1378
34783,0,48,1981,44,3584,4
6734,50,1540,3460,1168,17307,372
1825,664,60466,3625,43533,325624,16933
43690,60,1251,979,931,27912,320
24448,895,41245,2478,30001,106879,11244
27204,31,1710,2353,1290,22687,420
6308,5,227,3478,155,3952,72
45593,1,43,511,26,1837,17
21651,14,514,2615,420,11005,94
42132,66,859,1391,670,13174,189
30526,52,1255,2170,980,9704,275
7474,58,4964,3420,3873,71121,1091
1022,5,77,3922,66,2901,11
29562,22,1223,2221,960,7559,263
32646,12,309,2067,255,3978,54
11220,15,365,3193,285,7814,80
29973,17,1115,2201,867,17575,248
45800,21,300,421,267,3218,33
2035,6,123,3619,94,8422,29
30237,48,822,2188,680,9976,142
12366,2,162,3135,134,2284,28
22183,3,110,2586,90,5711,20
9620,5,293,3275,224,4335,69
2451,9,389,3612,290,8649,99
12260,26,1527,3141,1055,35575,472
40626,5,86,1600,69,1775,17
37543,79,2737,1811,1855,26709,882
10523,6,286,3233,238,4054,48
34030,50,2318,2014,1829,24916,489
32280,13,505,2083,415,11407,90
11964,15,460,3157,317,15095,143
3039,43,1396,3602,1068,13417,328
38124,9,236,1771,201,6172,35
20004,0,1061,2708,893,14751,168
15007,12,441,2949,328,4725,113
13637,245,16503,3046,11326,127886,5177
12803,44,4999,3111,3839,46837,1160
25796,29,1622,2417,1303,25204,319
18887,20,2767,2763,2035,14733,732
2750,13,299,3607,255,10598,44
34217,27,1246,2009,958,11822,288
41206,15,376,1543,289,6786,87
42218,168,4389,1369,3163,92790,1226
40444,16,386,1616,290,10290,96
1744,1,116,3644,94,5940,22
16354,89,4503,2884,3389,31935,1114
44100,6,139,882,98,3825,41
18168,12,365,2794,269,13225,96
5976,45,1993,3491,1324,6757,669
13542,102,2257,3052,1748,19896,509
28728,1,14,2264,12,883,2
33349,3,109,2039,91,9305,18
32694,3,82,2065,58,2379,24
19662,28,880,2728,657,21323,223
5993,5,200,3490,166,11318,34
24538,0,53,2473,46,2054,7
24260,12,520,2487,438,10119,82
15848,3,213,2909,165,10231,48
17704,18,529,2815,385,5678,144
2424,45,2221,3613,1790,18294,431
42607,0,18,1293,11,1254,7
9448,33,634,3286,502,12252,132
22878,10,367,2552,296,5030,71
23801,2,35,2508,31,4568,4
14116,115,2617,3008,1822,12799,795
2571,28,561,3610,448,8674,113
37442,63,1526,1818,1158,9516,368
15526,6,298,2923,236,6018,62
31308,48,722,2133,582,14198,140
46369,31,563,196,480,6143,83
11939,27,597,3158,295,6202,302
6137,62,1941,3486,1301,20577,640
23383,0,157,2527,135,5362,22
34410,176,3141,2000,2442,14919,699
7373,11,598,3425,490,8134,108
31795,79,2297,2107,1809,21522,488
43526,6,146,1040,85,3685,61
3003,10,247,3603,201,6672,46
22987,11,524,2546,401,11962,123
23140,124,5120,2539,3667,27498,1453
20676,24,883,2674,666,17461,217
37756,46,3288,1797,2420,21813,868
3803,7,135,3587,113,6948,22
8397,291,8354,3350,6468,43544,1886
33475,478,7540,2034,5529,30247,2011
41048,215,5619,1562,4073,51558,1546
28045,11,536,2303,453,9139,83
6223,3,58,3482,47,3245,11
8765,15,681,3327,548,19827,133
22598,72,4701,2566,3727,40838,974
34112,23,535,2011,439,5928,96
5676,1,66,3506,58,3320,8
2281,3,43,3615,35,3568,8
28573,7,320,2272,273,11728,47
18479,38,1102,2780,896,8153,206
42268,52,1753,1360,1268,28824,485
37983,7,248,1780,208,6242,40
24833,80,2453,2460,1936,12630,517
12423,5,104,3131,89,3092,15
17451,46,1222,2826,932,9745,290
42165,58,1416,1381,985,23655,431
36194,12,272,1890,236,4285,36
13247,1,61,3076,56,6672,5
41472,20,342,1501,245,4651,97
42157,53,1023,1384,827,10624,196
11014,271,17973,3205,14150,103847,3823
4704,65,1042,3556,768,12388,274
8347,79,2845,3353,2120,41496,725
43227,37,1247,1129,875,18984,372
36150,35,898,1892,717,25248,181
34072,80,2162,2013,1562,15166,600
29265,38,795,2237,625,8370,170
13837,51,1986,3030,1398,39291,588
19313,81,2696,2744,2054,34301,642
23644,7,319,2514,266,13066,53
2824,26,1343,3606,1113,18006,230
9423,189,8562,3287,6164,67849,2398
5117,34,919,3535,700,15429,219
6517,74,2093,3469,1613,27666,480
33591,6,182,2030,148,4873,34
1924,11,437,3622,338,15428,99
5717,137,3790,3504,2998,23330,792
25668,11,488,2422,393,5683,95
32620,2,66,2068,54,2881,12
5604,15,883,3510,656,14392,227
43651,56,1216,994,891,10237,325
3521,77,3285,3593,2639,38352,646
16599,26,1558,2874,1147,35726,411
29796,22,770,2210,647,13965,123
4452,10,239,3565,207,6241,32
10992,18,1078,3206,825,33559,253
18320,23,1137,2787,900,31045,237
39999,212,4844,1651,3539,39215,1305
34008,16,851,2015,633,14257,218
18187,7,374,2793,279,13251,95
13665,5,143,3044,120,8060,23
46139,31,376,281,350,6055,26
10092,74,3072,3253,2375,21756,697
22277,34,4403,2581,3283,33248,1120
37103,59,633,1839,491,6074,142
24449,6,314,2478,245,5605,69
20216,9,333,2696,270,4611,63
34996,62,4905,1969,3801,33804,1104
40848,2,208,1579,164,7303,44
25928,3,173,2411,118,4681,55
8128,5,576,3368,345,5847,231
1216,3,79,3861,73,1978,6
14796,31,1175,2960,887,15499,288
18035,12,554,2799,438,6833,116
34105,2,232,2012,186,5002,46
34668,30,349,1987,281,4872,68
46355,5,63,203,44,1290,19
7930,306,10300,3386,7239,72684,3061
21753,3,78,2610,66,3257,12
1879,94,4213,3623,3047,25876,1166
18837,4,336,2765,254,5130,82
38018,8,252,1779,214,3940,38
22761,7,161,2558,125,6387,36
32431,5,103,2076,83,3122,20
43576,12,121,1023,96,4810,25
8802,481,23243,3325,16425,89161,6818
15957,9,1633,2904,1131,19384,502
7073,27,444,3442,311,15073,133
18384,84,5380,2785,4043,36595,1337
3659,13,177,3590,126,4663,51
10753,478,20009,3218,13388,95861,6621
6468,5,179,3471,135,3424,44
38226,5,113,1764,92,3467,21
15708,433,16800,2914,12391,80437,4409
39054,3,68,1709,62,2923,6
23803,65,1780,2508,1308,14303,472
2307,18,307,3615,220,10777,87
31913,39,904,2102,689,8062,215
40381,16,1424,1622,943,18143,481
27208,50,1691,2353,1309,16368,382
39236,78,3145,1697,1875,37950,1270
18957,126,4174,2761,3092,28703,1082
15808,2,60,2910,45,3513,15
12396,37,1099,3133,863,29306,236
29366,0,90,2230,82,2855,8
12365,827,29152,3135,20218,141651,8934
32354,27,1556,2079,1058,28223,498
26723,245,9938,2375,7141,52087,2797
37595,30,747,1808,548,6587,199
6063,3,92,3487,75,2594,17
23210,4,466,2536,361,4379,105
35926,4,190,1909,147,4288,43
5553,29,714,3513,601,8345,113
45958,3,33,356,26,1150,7
41949,362,13936,1422,9875,78250,4061
9626,5,273,3275,218,6692,55
7295,5,349,3431,269,8507,80
20877,79,3215,2661,2106,37447,1109
41005,552,11556,1567,8773,50197,2783
25590,19,1089,2427,806,8065,283
9821,5,183,3266,146,3644,37
45098,3,101,660,70,2567,31
38361,15,530,1754,383,8047,147
5019,396,14709,3541,10545,147158,4164
46214,59,834,252,732,8135,102
3092,1,23,3601,21,2228,2
41939,297,8139,1424,5939,81038,2200
21916,6,458,2601,352,10434,106
21720,50,2101,2611,1679,23529,422
26327,24,617,2394,510,7257,107
14250,63,1821,3001,1382,18457,439
2536,13887,705205,3611,405169,2268666,300036
31668,350,20252,2113,14625,79042,5627
35153,2,115,1960,95,1962,20
1246,14,637,3851,470,5460,167
37630,6,214,1805,166,9849,48
14546,51,857,2978,675,18909,182
42370,17,581,1341,454,11555,127
26144,5,361,2402,295,10776,66
41564,31,373,1490,267,5759,106
22373,7,496,2577,380,3766,116
6126,4,120,3486,106,3628,14
11198,0,248,3194,197,4025,51
39415,316,3902,1686,3076,25256,826
9290,55,1930,3297,1499,25857,431
18574,195,14090,2777,11149,97237,2941
29499,41,1736,2223,1316,14612,420
7019,37,1728,3445,1374,5518,354
22551,43,8272,2567,5519,12920,2753
25316,50,2682,2439,2212,14575,470
26217,68,2672,2398,2067,15303,605
41917,14,510,1427,378,12727,132
35388,9,143,1949,119,6514,24
39847,91,2271,1662,1625,19155,646
29310,3,71,2233,53,2116,18
35475,9,1007,1943,734,11086,273
29751,898,58621,2212,35759,174235,22862
37683,29,670,1802,458,5623,212
41017,37,842,1566,533,11100,309
17841,3,197,2810,165,7908,32
8244,16,350,3361,261,4700,89
34773,47,1184,1982,983,12349,201
15670,16,788,2916,547,10605,241
5287,32,407,3525,343,5713,64
21081,12,283,2649,212,5182,71
19220,461,21129,2750,15381,137131,5748
25050,148,4635,2451,3520,40274,1115
8019,0,56,3379,51,4840,5
26000,20,526,2408,421,7284,105
25319,241,5826,2439,4754,40501,1072
32301,31,796,2082,600,5845,196
37957,3,137,1782,109,7055,28
35816,3,137,1916,111,3717,26
18588,1,125,2776,107,1974,18
45896,75,605,388,480,8766,125
6844,15,832,3455,628,12864,204
25665,3,221,2422,178,9386,43
1565,1,35,3685,33,1888,2
1442,10,453,3737,348,6710,105
17608,6,458,2818,341,6554,117
2916,6,189,3604,164,15768,25
14477,179,9595,2983,6449,52785,3146
10022,4,137,3257,101,3682,36
3975,220,4040,3582,3186,75747,854
10085,379,16267,3253,12767,46263,3500
2996,162,4253,3603,3215,32436,1038
8991,250,11154,3314,8123,103839,3031
7163,99,5331,3437,3609,38299,1722
35471,51,857,1943,696,11675,161
7440,1,64,3422,50,2020,14
9465,14,399,3285,292,5481,107
24945,13,1399,2454,1139,9155,260
27197,29,2959,2353,2268,25362,691
3041,21,585,3602,419,7673,166
44800,5,65,762,49,2636,16
9420,31,2093,3287,1654,26480,439
22443,4,242,2574,177,8922,65
11579,15,527,3175,434,14165,93
35188,1,63,1959,50,3179,13
41487,18,586,1498,426,12076,160
26667,81,3150,2378,2363,22350,787
25868,2,86,2414,72,2196,14
27376,80,2260,2342,1601,23025,659
41955,31,925,1421,726,18782,199
35871,16,429,1913,326,6516,103
35458,0,183,1944,148,9150,35
44257,368,7207,873,5884,30335,1323
19777,213,15953,2721,11199,88432,4754
27418,89,1650,2340,1276,10619,374
46114,0,46,293,42,1121,4
36862,1,99,1853,82,5883,17
30665,10,522,2163,412,24471,110
19587,1,50,2731,46,5461,4
20342,66,4067,2691,2659,17622,1408
29155,11,481,2242,407,11690,74
17371,12,542,2829,447,4871,95
34644,77,1356,1988,1123,9391,233
30529,13,723,2170,581,7505,142
9475,188,13801,3284,10229,195271,3572
23671,9,502,2513,378,7341,124
16573,166,8578,2874,6603,56228,1975
37480,32,591,1815,454,8798,137
27427,128,6751,2340,4713,45211,2038
11496,14,439,3179,319,6209,120
18130,124,5717,2796,4410,47625,1307
45057,6,107,683,72,4022,35
34015,11,369,2015,306,8699,63
19818,14,615,2718,508,17051,107
31459,8,324,2125,265,7157,59
4358,5,330,3569,275,17023,55
40468,265,6200,1614,4473,36663,1727
23622,30,1330,2516,1078,22303,252
23082,7,461,2542,362,8421,99
43244,38,676,1124,560,15141,116
13494,80,3714,3056,2783,43314,931
24079,51,2721,2495,1942,16394,779
40869,3,222,1577,161,7995,61
39291,10,269,1693,228,8723,41
5179,4,126,3531,110,3251,16
35591,2,35,1934,32,4171,3
13444,143,5947,3059,4129,55102,1818
4676,237,3832,3557,2897,32363,935
26551,83,3349,2383,2512,20488,837
37859,5,70,1789,63,2349,7
11116,18,667,3199,495,17918,172
20624,0,764,2677,625,26838,139
16290,14,1348,2888,1068,12583,280
39882,6,139,1659,113,4856,26
18843,6,297,2765,233,4010,64
45545,191,3038,525,2413,9335,625
19809,136,8858,2719,6232,57750,2626
4751,9,557,3554,393,5257,164
4815,18,440,3551,346,4256,94
22438,6,777,2574,616,7123,161
9289,7,190,3297,162,10631,28
30151,36,1008,2193,760,16200,248
4899,17,324,3547,263,12834,61
30674,7,196,2163,159,6215,37
16255,105,5127,2890,3821,45761,1306
31687,25,463,2112,370,9995,93
43218,26,158,1133,132,5897,26
22490,19,2019,2571,1602,15530,417
40097,15,413,1645,277,9516,136
27719,21,1217,2322,1023,9465,194
18293,6,190,2788,141,3521,49
32296,16,473,2082,356,23090,117
22592,6,366,2566,268,14796,98
31868,0,20,2104,16,1807,4
27766,9,551,2319,441,10421,110
25673,1,65,2422,49,4534,16
6096,4,142,3486,112,4270,30
20400,11,463,2688,377,5862,86
3830,173,8668,3587,6840,44329,1828
43861,18,272,939,220,5707,52
4890,404,21407,3547,15632,115793,5775
18334,0,441,2787,295,2559,146
23377,24,796,2527,571,4086,225
11442,29,1655,3183,1358,21951,297
9132,258,12019,3306,8828,45309,3191
40538,7,439,1608,333,11794,106
11517,16,494,3178,405,20656,89
17158,81,1855,2841,1468,16408,387
32103,12,334,2091,260,6034,74
6219,1,53,3483,40,2416,13
34452,0,0,1999,0,6784,0
1563,2,55,3685,45,1971,10
41411,50,1313,1510,1026,11206,287
23121,85,2414,2540,1773,28153,641
25176,15,1247,2445,921,11663,326
9284,47,1679,3297,1330,15749,349
45611,18,577,506,365,4345,212
17571,68,5044,2820,3653,18948,1391
31452,27,728,2126,563,9364,165
24711,118,4725,2464,3587,48067,1138
30073,18,823,2197,687,14358,136
7109,91,5010,3440,3739,45602,1271
26096,9,951,2404,771,8627,180
15476,70,1862,2926,1455,24856,407
42324,6,127,1350,93,6075,34
45316,11,326,588,169,3854,157
28814,51,5827,2259,4206,80548,1621
14650,0,138,2971,106,4602,32
29740,7,107,2213,93,3492,14
34299,8,270,2006,206,5346,64
42680,99,1781,1277,1344,19328,437
28431,1,184,2281,144,14915,40
26646,0,30,2379,25,2159,5
24336,3,76,2483,66,5831,10
46341,56,989,209,901,8707,88
39304,6,84,1692,71,2655,13
22926,12,688,2549,442,5837,246
37064,31,1438,1841,1063,12765,375
16602,62,1992,2873,1526,21523,466
37005,9,199,1845,155,5055,44
19934,2,77,2713,67,2110,10
26141,118,9241,2402,6799,35565,2442
28313,35,731,2288,599,15798,132
24897,262,23880,2457,17131,81698,6749
43627,2,21,1002,16,1227,5
15201,8,258,2938,187,4561,71
8494,31,2437,3344,1763,14680,674
19333,28,1966,2744,1427,24868,539
8392,68,4913,3351,3621,86721,1292
9880,11,244,3263,201,5894,43
11057,5,96821,3203,29163,2319,67658
24913,17,2736,2456,2092,65410,644
30530,17,609,2170,493,11778,116
13322,44,1307,3070,1052,10325,255
12119,6,449,3149,340,4857,109
17516,320,11624,2823,8438,47874,3186
39635,553,8718,1674,6092,38208,2626
22627,6,14,2565,14,6042,0
42820,2,185,1243,133,5238,52
8869,7,304,3321,214,11082,90
4869,12,202,3549,168,7389,34
5237,14,398,3528,335,6158,63
43739,9,103,965,81,4425,22
5099,19,914,3536,676,6197,238
17330,542,21536,2832,16936,57058,4600
32779,10,303,2062,257,9459,46
24445,18,730,2478,587,12378,143
10322,0,26,3242,22,1697,4
40712,132,3203,1593,2115,11512,1088
13406,2,23,3064,17,1877,6
39815,30,2206,1664,1661,12213,545
7610,31,1493,3412,1155,18407,338
28894,7,786,2255,595,9039,191
42018,58,1760,1411,1299,14907,461
13171,125,9535,3079,6852,65809,2683
9261,2,363,3298,291,17373,72
34462,9,361,1999,306,5588,55
28027,117,5229,2304,3491,49075,1738
29876,43,3548,2205,2684,26985,864
34968,24,693,1970,569,8354,124
35875,18,443,1912,351,5174,92
40617,176,4126,1601,3115,31872,1011
6657,12,236936,3464,80519,4932,156417
41095,155,3421,1555,2566,37078,855
23713,2,211,2511,140,5906,71
40776,42,1338,1587,978,8157,360
23161,0,57,2538,49,3306,8
38033,61,514,1778,407,4755,107
3026,22,864,3602,621,5634,243
1137,4,329,3889,263,10030,66
37492,7,238,1814,204,8118,34
34136,22,416,2011,337,7090,79
6028,2,71,3489,66,1782,5
14125,7,227,3008,182,7912,45
17891,3,136,2808,110,2868,26
12713,24,865,3116,677,4336,188
18134,0,29,2796,19,2868,10
14596,276,14338,2974,10174,31925,4164
6895,88,3184,3453,2551,19104,633
19933,6,281,2713,220,3618,61
29213,7,145,2239,137,2313,8
32606,0,29,2069,21,1291,8
6575,8,98,3467,90,3630,8
28638,37,1161,2268,967,19430,194
43161,1,57,1149,46,3947,11
35182,223,8373,1959,6573,66323,1800
3577,86,3655,3592,2932,45959,723
2653,3,159,3609,132,11373,27
42467,66,1269,1320,976,23386,293
17731,10,476,2814,365,11499,111
9794,19,506,3267,405,5551,101
23621,22,734,2516,585,11255,149
22638,32,595,2564,491,16995,104
9625,1,147,3275,112,2941,35
31662,1,169,2114,121,7362,48
16871,175,13683,2858,9920,110893,3763
3504,371,12526,3593,9625,53927,2901
43956,215,4524,925,3949,36395,575
22901,30,2880,2550,2207,18592,673
40534,1,85,1609,62,2832,23
18581,67,2261,2777,1702,15814,559
5863,63,2029,3496,1710,16319,319
20138,17,1649,2701,1235,10432,414
39724,5,105,1669,89,2293,16
25782,64,4449,2418,3309,20323,1140
16776,4,343,2862,254,3874,89
10152,1,74,3250,64,2326,10
43694,21,194,978,148,5617,46
39020,142,5399,1711,4134,30794,1265
45892,125,1382,389,1072,10958,310
7976,11,63,3381,50,5981,13
31202,15,404,2139,319,3240,85
27341,20,1225,2345,948,23068,277
4224,2,103,3574,64,3958,39
39678,4,141,1671,97,6752,44
21092,0,69,2648,60,2933,9
41400,4,207,1511,96,10819,111
29172,115,6748,2241,5305,38151,1443
35955,4,77,1907,63,3980,14
20242,0,49,2694,35,2389,14
1873,26,728,3623,617,11079,111
10366,3,164376,3241,50594,4754,113782
5631,17,604,3508,473,11695,131
6265,8,67,3480,47,6440,20
36901,26,781,1851,637,18118,144
2494,16,245,3611,205,4706,40
29320,499,21024,2232,14362,100535,6662
8094,3,29,3370,23,1952,6
44847,45,631,745,552,14362,79
6314,4,149,3478,107,2452,42
5751,58,1906,3502,1503,23555,403
14266,89,2206,2999,1728,13721,478
18506,6,467,2779,287,5105,180
45947,13,235,360,154,3739,81
21620,1,108,2617,69,2106,39
28100,23,1611,2301,1246,32479,365
25339,24,716,2438,542,4376,174
27973,52,1948,2307,1573,18968,375
16645,373,28768,2871,20476,159409,8292
9636,26,1019,3274,810,32112,209
36301,3,244,1885,203,5516,41
45406,0,17,564,13,1225,4
7276,8,138,3432,106,5344,32
14185,1,37,3005,29,2344,8
11040,3,128,3204,109,3444,19
29086,62,1124,2245,906,10732,218
13430,16,742,3062,608,27086,134
8396,6,146,3350,111,4034,35
15536,7,723,2923,556,12782,167
19917,54,5336,2713,4085,49260,1251
6244,806,45893,3481,32461,145904,13432
41311,52,506,1524,367,6795,139
17228,13,409,2837,355,11430,54
15040,2,154,2947,131,10752,23
17214,43,1923,2838,1507,15558,416
40925,3,163,1573,126,5063,37
34003,4,258,2015,209,4980,49
1975,15,482,3620,412,9166,70
32182,14,439,2087,351,5560,88
6949,37,1763,3449,1326,21354,437
14928,61,3096,2953,2528,28556,568
36600,12,171,1869,139,3996,32
44894,69,675,734,507,11493,168
43573,12,435,1024,342,7135,93
4481,192,8098,3564,6024,28783,2074
4499,30,834,3564,640,12564,194
37677,210,6852,1803,5166,48902,1686
5567,1,19,3512,16,2113,3
28620,0,543,2269,416,7187,127
10545,3,158,3231,120,3808,38
9099,1,26,3308,22,1302,4
28438,16,596,2281,480,4844,116
13735,43,1243,3038,972,13222,271
19158,19,455,2753,361,9594,94
6712,193,4984,3461,3619,62637,1365
8012,3,130,3379,114,3016,16
39687,13,266,1671,215,4663,51
6617,26,651,3465,520,9248,131
40469,91,2263,1614,1665,40112,598
12519,2,134,3126,88,1262,46
24728,44,2594,2464,1887,8687,707
6967,278,32177,3448,20344,240714,11833
24016,128,13094,2497,9522,49494,3572
18842,10,357,2765,292,5220,65
1934,83,3145,3621,2354,16941,791
1841,301,21247,3624,15226,184507,6021
36571,10,242,1872,184,9961,58
24373,1,114,2481,92,3378,22
34933,19,324,1972,247,4896,77
10917,1,44,3210,36,2534,8
12177,0,37,3146,19,1626,18
21672,3,285,2614,237,5151,48
40028,4,90,1649,73,4308,17
1805,206,5449,3626,4350,57345,1099
24686,168,8064,2466,6392,46825,1672
20417,19,630,2687,488,9785,142
4785,5,133,3553,104,2758,29
9128,4,170,3306,120,13743,50
17748,43,5341,2813,4066,22583,1275
26387,0,63,2390,53,1669,10
2474,58,1854,3612,1204,12636,650
37662,22,781,1804,605,12007,176
25093,27,618,2449,456,4029,162
4682,18,782,3557,594,8526,188
27016,2,167,2364,128,4125,39
12829,8,234,3109,204,4759,30
13078,114,5463,3094,4092,38788,1371
43274,25,289,1116,202,3838,87
24149,0,34,2491,30,2345,4
27847,10,175,2315,162,1749,13
14900,13,804,2955,623,4827,181
937,12,329,3950,267,8607,62
35792,34,635,1918,505,6208,130
40167,1,29,1641,26,5877,3
41276,18,979,1529,701,12676,278
42519,16,331,1309,234,3179,97
18623,6,142,2774,129,11862,13
27483,5,220,2336,159,5695,61
46427,33,314,161,290,3128,24
27745,47,1114,2321,870,13065,244
18205,8,308,2793,249,5052,59
20965,7,241,2655,202,3717,39
6560,7,161,3467,136,12086,25
28173,31,1374,2296,1072,14573,302
40317,14,233,1630,169,8145,64
2891,5,107,3605,63,3645,44
25988,6,435,2408,380,4497,55
26608,0,82,2381,68,6035,14
28333,174,4738,2287,3624,29040,1114
26350,1,159,2392,134,2539,25
42254,1,134,1362,110,9675,24
43115,221,2382,1161,1947,23190,435
46195,164,4874,257,3750,19208,1124
30415,14,519,2177,420,7595,99
11478,487,30103,3180,21902,76377,8201
39962,38,651,1653,505,6799,146
42972,12,116,1206,75,3239,41
32611,17,705,2068,559,16713,146
10941,5,190,3209,123,9517,67
31650,23,424,2114,351,5371,73
16854,51,2736,2858,2154,41183,582
41938,28,349,1424,251,6990,98
4592,24,447,3560,381,15598,66
37747,64,585,1797,442,5221,143
15621,38,2680,2918,2186,7024,494
20771,177,4306,2668,3103,25988,1203
22877,70,4142,2552,2705,34883,1437
5094,4,81,3536,72,3957,9
32705,30,2116,2065,1584,23684,532
3002,4377,222205,3603,136989,569283,85216
17078,3,549,2846,374,11100,175
39507,24,999,1682,785,12424,214
40382,36,1076,1622,864,10004,212
42742,43,1031,1261,759,9898,272
39352,5,191,1690,156,4356,35
11445,16,1075,3182,831,14769,244
46397,30,379,181,357,3854,22
27496,2,216,2335,157,3323,59
40484,60,1266,1613,917,7892,349
26643,461,11895,2379,9499,51396,2396
2081,61,1584,3618,1165,15694,419
2706,515,34048,3608,21791,142446,12257
37374,106,2395,1822,1761,13099,634
3343,44,1525,3597,1239,6297,286
1892,18,1634,3622,1304,15781,330
12132,42,1572,3148,1264,12057,308
6847,12,353,3455,288,4291,65
12467,33,3027,3129,1830,13137,1197
29699,36,856,2214,600,3937,256
44542,492,9240,830,7132,80290,2108
17517,9,1371,2823,1036,19234,335
21240,3,199,2637,156,3459,43
44172,4,76,887,46,4648,30
12755,26,575,3114,448,11428,127
15241,74,4360,2936,3332,32485,1028
14461,10,1482,2984,1106,10353,376
41552,65,644,1491,490,6930,154
7126,1,50,3439,41,3520,9
25567,80,2298,2428,1719,24761,579
29577,2,129,2220,116,3118,13
14931,0,349,2953,234,6766,115
21706,8,210,2612,170,3646,40
1910,57,1305,3622,1077,28557,228
39617,8,439,1675,329,6003,110
7558,3,209,3415,168,5582,41
16236,20,3646,2891,2322,22538,1324
15457,2,114,2927,98,2256,16
44995,5,39,705,36,2513,3
33271,2,68,2042,57,2862,11
4354,290,11100,3569,8015,42590,3085
2554,100,2190,3610,1786,21734,404
15634,12,465,2917,368,6523,97
23794,1,116,2508,93,5806,23
38050,5,187,1777,148,4445,39
13798,57,3750,3033,2291,107517,1459
46480,5,56,136,55,1368,1
7588,3,131,3413,98,4514,33
45342,136,1306,582,1096,13514,210
26445,11,1020,2387,733,11581,287
10477,6,87,3235,69,1711,18
45588,0,884,512,715,5417,169
6521,21,771,3469,445,19989,326
24191,2,76,2489,61,3675,15
17801,18,818,2812,637,5265,181
15488,17,1070,2925,788,7783,282
20393,69,1354,2688,1084,7707,270
2849,40,692,3606,512,19639,180
5140,78,1635,3533,1306,10580,329
9502,7,290,3282,246,4448,44
10830,37,1289,3214,934,18423,355
10331,16,872,3242,698,6779,174
36073,1,43,1897,35,4659,8
20193,13,1159,2698,864,13470,295
5095,152,8420,3536,6424,32264,1996
8129,7,115,3368,92,3556,23
15025,74,4088,2948,3197,14279,891
28461,133,3034,2280,2182,13052,852
20142,4,159,2701,128,3157,31
21054,8,586,2650,451,16975,135
27929,0,490,2310,390,13088,100
44881,10,85,738,65,2796,20
37303,0,30,1826,27,3346,3
8981,4,200,3315,164,9224,36
37155,1,132,1836,104,4649,28
23315,19,1102,2531,848,22986,254
19392,166,4969,2741,3958,28855,1011
21857,6,144,2605,104,2992,40
14828,3,177,2958,153,8741,24
36160,34,1105,1892,851,13573,254
18185,1039,114033,2793,71256,208295,42777
43411,20,292,1073,247,5522,45
44730,44,500,785,419,10383,81
33493,14,281,2033,236,2925,45
12911,10,119,3104,87,8744,32
12492,2,98,3127,71,2827,27
42558,1,115,1303,81,7653,34
13822,2,76,3032,67,9259,9
15336,363,17898,2931,12661,84527,5237
37681,4,111,1803,82,5348,29
20552,28,1739,2680,1409,22764,330
5020,25,634,3541,450,17156,184
30077,3,204,2196,158,10535,46
43505,62,1039,1047,819,12429,220
42180,43,502,1379,378,7062,124
14617,14,360,2973,285,7083,75
3346,98,3913,3597,2812,23848,1101
2844,8,220,3606,133,4234,87
40407,12,473,1621,370,5256,103
23074,6,233,2543,183,5547,50
15198,3,351,2938,275,7150,76
17524,56,2615,2822,1895,12719,720
17368,0,57,2829,29,3662,28
22111,145,8241,2589,6343,60495,1898
3980,5,158,3582,123,3262,35
6349,5,161,3476,134,3071,27
34548,8,192,1994,157,6112,35
18455,14,439,2782,330,4409,109
44174,5,121,886,89,3164,32
3896,17,391,3585,318,7939,73
19077,1,167,2756,133,6100,34
40968,214,5687,1570,4186,41364,1501
4611,439,11510,3559,8487,45242,3023
35083,15,771,1965,574,8020,197
15487,1,263,2925,192,7404,71
24729,64,1697,2464,1338,11296,359
16873,3,175,2858,155,7711,20
26044,4,135,2406,110,4459,25
27592,13,475,2329,361,5550,114
25966,8,1715,2409,1201,24670,514
2060,110,5091,3618,4081,43192,1010
1963,20,397,3620,327,16233,70
35342,50,5215,1951,3949,20001,1266
35494,45,503,1942,395,5424,108
45097,98,1020,661,822,9955,198
33884,1,67,2019,58,2691,9
42353,12,252,1344,190,3888,62
26138,4,386,2403,300,7967,86
29396,25,1604,2229,1237,14129,367
46207,3,45,253,35,1560,10
33341,3,164,2039,138,2937,26
2741,13,341,3608,260,6466,81
11321,3,379,3189,302,9931,77
34082,191,2824,2013,2232,26538,592
12763,162,11703,3113,9430,49244,2273
8730,0,20,3329,17,1381,3
11350,1,55,3188,44,3561,11
5106,15,528,3536,414,15865,114
30875,48,2813,2154,2173,16926,640
12432,18,963,3130,787,9832,176
3362,8,106,3596,79,4777,27
6579,9,543,3467,459,25287,84
9789,56,2126,3268,1612,45543,514
14579,4,143,2975,120,19495,23
3351,1,33,3596,29,3407,4
16313,10,202,2887,158,13510,44
4256,158,4518,3573,3322,27884,1196
4151,248,7134,3576,5565,88035,1569
40322,17,538,1630,343,8434,195
8136,9,233,3368,178,7436,55
15078,16,901,2944,724,12053,177
45613,3,35,505,26,2844,9
38725,1,101,1729,80,4577,21
10115,35,1307,3252,981,26781,326
37474,28,422,1816,351,3682,71
27796,1,195,2317,156,8447,39
6304,28,572,3479,441,5947,131
36313,25,479,1884,356,8550,123
41243,130,4619,1536,3668,42947,951
20405,16,1309,2687,1116,32196,193
24308,17,564,2484,446,6690,118
24539,11,341,2473,274,4599,67
34281,2,48,2006,42,3052,6
42515,116,8437,1310,6397,57901,2040
26472,76,1981,2386,1595,11775,386
28288,599,26214,2290,17181,156429,9033
39191,13,408,1700,296,5915,112
32509,8,411,2073,331,4118,80
44787,6,54,767,46,2163,8
14823,29,527,2958,390,14444,137
43027,10,490,1191,340,9581,150
31009,7,291,2149,230,6639,61
34043,1,82,2014,58,3068,24
4600,274,30375,3560,20323,102027,10052
8786,115,3439,3326,2550,23434,889
31295,8,191,2134,157,3675,34
2524,58,1167,3611,983,15265,184
42993,7,215,1199,167,11704,48
10413,22,545,3238,401,11828,144
46029,118,1028,327,854,13700,174
33959,1,185,2017,166,21978,19
36664,39,1664,1866,1221,15118,443
19621,4,157,2730,130,4653,27
38923,28,1111,1717,798,15625,313
25683,13,651,2422,471,11710,180
46357,1,32,203,21,778,11
17805,4,164,2812,123,3737,41
33702,30,1360,2026,991,19287,369
43339,95,2311,1097,1806,24651,505
14764,22,576,2963,449,8621,127
32287,0,18,2083,16,1881,2
25311,6,474,2440,377,4626,97
41664,1,56,1472,44,4739,12
19842,5,293,2717,235,9705,58
38553,13,575,1740,451,6643,124
39669,11,620,1672,453,9583,167
45391,3,36,568,33,1198,3
38662,189,2167,1733,1675,10289,492
23553,0,35,2519,17,1930,18
39772,11,207,1667,169,5490,38
26856,20,2251,2369,1694,21037,557
44785,36,302,767,272,6389,30
3070,9,327,3602,280,4792,47
15552,5,514,2922,352,14674,162
27622,8,161,2327,131,7037,30
35187,44,1918,1959,1374,21548,544
3815,31,3479,3587,2816,26752,663
12715,61,1871,3116,1437,26346,434
14545,34,537,2978,412,10564,125
6073,49,1779,3487,1242,10904,537
12663,51,4085,3118,2919,42865,1166
34801,0,120,1980,106,6743,14
40954,2,99,1571,80,4274,19
25793,295,19763,2417,14627,90327,5136
9221,7,132,3301,98,2439,34
5085,14,394,3538,319,11492,75
3720,104,2600,3589,1818,39738,782
1877,13,513,3623,379,19847,134
5376,2,23,3521,20,2381,3
41823,8,255,1441,206,5831,49
37435,1,39,1818,31,3787,8
7361,31,622,3426,478,8589,144
45618,23,214,502,193,5816,21
45612,27,454,506,307,6910,147
14943,162,10972,2952,8286,91019,2686
40346,6,127,1627,96,4357,31
21452,3,189,2626,150,3035,39
7249,31,1308,3434,978,25509,330
14476,60,3022,2983,2255,26103,767
11828,2,61,3163,44,2036,17
36389,262,4611,1880,3359,24208,1252
17219,18,1094,2838,937,16473,157
40263,17,394,1634,316,7445,78
8783,4,97,3326,71,2347,26
26432,252,10461,2388,8078,82217,2383
40995,9,146,1568,111,4882,35
8579,26,707,3338,611,8957,96
27380,1,190,2342,149,4729,41
43565,7,70,1026,55,3578,15
29650,6,462,2216,367,7444,95
20714,4,274,2671,223,5386,51
22897,0,75,2551,56,3977,19
14054,36,2279,3012,1648,70097,631
40202,14,155,1638,127,4920,28
9676,19,1436,3273,952,19724,484
40023,18,346,1649,231,6650,115
43619,107,1447,1004,1198,15758,249
5144,46,1263,3533,844,19872,419
4711,3,86,3555,66,2343,20
40214,34,1464,1638,1156,18967,308
19038,343,18170,2757,13044,42145,5126
24787,11,311,2462,241,5773,70
42166,15,477,1381,331,14854,146
11994,64,3365,3155,2484,20530,881
6470,10,307,3471,234,10362,73
3356,3,86,3596,57,3707,29
7022,0,79,3445,65,2141,14
6636,2,83,3464,69,8619,14
9960,3,112,3259,82,4104,30
9661,43,1515,3273,1191,17272,324
34419,68,2268,2000,1723,11429,545
40509,121,3394,1610,2386,35661,1008
20007,14,700,2708,539,7080,161
4875,13,304,3548,264,7456,40
36690,33,675,1865,575,17854,100
16900,941,60318,2857,36778,229210,23540
14879,32,1815,2956,1419,17074,396
13906,63,4907,3023,3261,37500,1646
32800,29,576,2061,467,3138,109
24523,11,731,2474,597,6493,134
33496,6,159,2033,138,3463,21
36683,2,48,1865,41,5293,7
8341,13,155,3354,119,3324,36
37701,43,1545,1801,1259,8159,286
33823,1380,51937,2021,38072,299206,13865
45196,61,857,624,645,8630,212
37817,9,240,1792,200,12017,40
2909,549,20150,3605,15022,109328,5128
7562,23,443,3415,360,3359,83
33698,43,748,2026,531,6845,217
25496,5,283,2432,219,6888,64
31536,15,397,2120,320,4148,77
32624,61,1120,2068,845,5985,275
34607,63,1859,1991,1379,11954,480
8409,3,82,3350,55,4630,27
42826,87,2103,1243,1432,16809,671
26009,8,467,2407,367,10019,100
28277,28,1566,2290,1228,29676,338
30685,373,21639,2162,15943,132082,5696
23250,46,5586,2534,4070,28329,1516
3460,110,8842,3594,6096,62876,2746
39779,11,360,1667,286,5324,74
28077,9,532,2301,445,6874,87
29877,10,282,2205,244,6838,38
45312,2,28,588,18,2743,10
38081,95,2159,1775,1764,13168,395
7529,3,43,3417,39,1450,4
26954,6,201,2364,150,2264,51
41492,21,309,1498,229,5448,80
14893,20,1448,2955,1158,14131,290
31193,3,194,2139,148,4476,46
27500,190,9495,2335,6891,64880,2604
9180,9,472,3302,381,12340,91
15117,3,410,2942,323,9751,87
30059,26,2642,2197,1764,23691,878
29794,102,2321,2210,1702,11994,619
2599,14,258,3610,194,5777,64
20480,3,442,2684,370,6576,72
25748,51,1094,2419,819,8158,275
10552,66,2144,3231,1723,31192,421
19707,6,548,2725,477,8925,71
46178,3,68,262,35,1603,33
16862,24,1409,2858,1075,6129,334
1999,291,10471,3619,8003,65984,2468
35110,1,25,1963,22,4921,3
39208,69,3511,1699,2702,19043,809
42358,80,2921,1343,2062,55539,859
22553,0,1815,2567,1448,17890,367
33871,120,10107,2019,7291,17010,2816
4902,99,2603,3546,1980,43071,623
41618,10,793,1480,576,10666,217
44097,41,1174,892,869,10208,305
5792,7,186,3500,147,4883,39
7048,13,395,3443,315,21951,80
6561,5,104,3467,74,3215,30
26368,9,829,2391,650,16946,179
20638,17,794,2676,621,10054,173
23762,0,347,2510,254,3201,93
36716,5,472,1863,396,8538,76
4748,33,1770,3554,1376,59629,394
1611,23,1183,3678,984,13303,199
15498,12,460,2925,396,10030,64
3855,18,1006,3586,722,8548,284
33661,0,43,2027,34,6589,9
12148,29,782,3147,587,9947,195
16909,36,3393,2856,2626,27884,767
8181,85,2689,3365,2129,21827,560
38626,10,393,1735,321,11211,72
34655,8,184,1988,153,7118,31
10959,19,368,3208,271,9010,97
18543,8,293,2778,231,6059,62
28878,15,342,2256,283,5761,59
8766,354,12363,3327,9566,62178,2797
45012,7,99,700,72,2766,27
6105,6,215,3486,146,4857,69
26438,141,11374,2388,8637,56375,2737
12998,65,1469,3098,1008,31403,461
28536,3,145,2274,120,3757,25
3186,5,348,3599,257,8785,91
5398,25,794,3520,632,17881,162
44059,2,45,907,29,1858,16
28190,65,2022,2295,1607,14039,415
3697,0,27,3589,24,2566,3
34967,12,228,1971,189,3124,39
3072,5,214,3601,174,8784,40
14235,19,428,3001,342,8314,86
29995,13,823,2200,692,11992,131
31428,4,137,2127,121,7082,16
31040,3,62,2147,53,4054,9
42128,5,108,1391,86,3526,22
16626,0,1177,2872,877,17206,300
2965,14,503,3603,379,10020,124
8457,10,113560,3347,39680,14202,73880
13638,42,1606,3046,1249,29528,357
36457,20,550,1878,437,13087,113
33042,14,311,2051,239,5592,72
43723,102,1428,969,1075,11535,353
26168,43,1435,2401,1137,12967,298
42305,25,723,1354,547,8926,176
17586,2,253,2819,163,7381,90
40621,51,1236,1601,966,17492,270
30259,5,201,2187,146,3931,55
7849,51,1349,3395,1114,18324,235
6301,12,568,3479,441,12449,127
31535,29,583,2121,471,7284,112
28371,2,74,2284,57,4824,17
12817,4,537,3110,431,7897,106
10769,13,386,3218,261,9654,125
14983,331,14366,2950,9864,59628,4502
42764,13,147,1258,122,4024,25
41555,1,102,1490,70,4288,32
17256,31,1348,2835,1003,18898,345
33116,11,811,2047,630,8213,181
11520,4,157,3178,126,8386,31
23208,7800,351925,2536,225505,874777,126420
6578,34,1074,3467,728,9401,346
41703,10,151,1466,107,2806,44
11308,272,9812,3190,7792,69586,2020
41503,35,1054,1496,770,21022,284
6993,8,410,3447,311,4750,99
28187,2,308,2295,216,3703,92
24091,184,9044,2494,6393,64516,2651
34484,358,19091,1998,12853,141292,6238
33690,71,2104,2026,1554,11228,550
35615,50,2717,1932,1990,15518,727
45160,1,38,635,20,2941,18
20644,201,4039,2676,3033,25992,1006
3555,147,4336,3593,3448,18645,888
27371,9,558,2343,426,7459,132
37759,659,27038,1796,19599,153744,7439
16367,68,5620,2884,4217,26969,1403
15909,52,2453,2907,1948,22377,505
24249,0,42,2487,35,2002,7
37479,26,1266,1815,987,14027,279
7500,153,8502,3419,6066,46095,2436
21229,7,114,2638,89,2132,25
45007,16,126,701,101,3979,25
29603,17,978,2220,774,23804,204
16252,25,1314,2890,1048,6822,266
12273,1,71,3140,56,1933,15
8942,25,685,3317,527,16142,158
32292,14,409,2083,333,13478,76
30860,158,3736,2154,2913,20820,823
38830,9,474,1723,371,3912,103
34361,11,174,2003,143,2938,31
40554,11,232,1606,178,4122,54
45411,21,170,562,137,5082,33
36164,34,742,1891,566,9433,176
16416,10,635,2881,483,12875,152
45872,21,365,397,258,4883,107
23714,1,333,2511,282,3184,51
38200,179,4777,1767,3455,42413,1322
25127,1,59,2447,48,2622,11
36317,9,274,1884,222,4838,52
21999,425,11116,2595,9094,50949,2022
13664,41,1072,3044,841,10107,231
23069,1339,35712,2543,26825,106878,8887
11642,4,210,3172,186,6318,24
34743,91,2278,1983,1729,24816,549
17134,28,613,2843,474,5488,139
17539,0,279,2821,234,5761,45
24751,15,229,2463,194,4087,35
23259,5,156,2533,128,2145,28
38941,29,562,1716,405,10585,157
33257,82,1754,2043,1357,10444,397
31012,13,433,2149,360,4618,73
8116,9,213,3369,144,4449,69
8726,1,62,3329,50,1538,12
42121,123,3909,1393,3112,53217,797
36358,13,547,1882,430,8850,117
22678,96,3230,2562,2431,39917,799
33867,2,79,2019,62,2175,17
20169,1,93,2699,81,3439,12
29936,5,139,2202,123,7264,16
20402,7,553,2688,440,11612,113
38303,3,135,1759,101,4261,34
5492,25,1182,3516,953,6957,229
7166,257,6575,3437,5184,158018,1391
23832,2,163,2506,128,3934,35
14388,8,426,2989,353,4779,73
37411,34,853,1820,599,5656,254
38465,19,434,1747,354,5691,80
24287,5,264,2485,216,12206,48
41186,0,0,1545,0,4365,0
33869,1,75,2019,50,2464,25
34688,5,155,1986,122,2973,33
26094,7,232,2404,189,1723,43
19368,46,1911,2742,1386,15180,525
39292,29,961,1693,702,11609,259
14767,99,3571,2962,2836,13533,735
37527,8,114,1812,90,1984,24
31440,8,321,2127,251,9376,70
5684,689,29419,3505,20848,108778,8571
38874,3,117,1720,96,3935,21
15157,15,14120,2940,5285,12347,8835
45347,3,43,581,36,1348,7
37766,2,176,1796,132,5582,44
45278,2,33,599,20,1593,13
22174,17,386,2586,309,6185,77
14410,116,14136,2987,10096,65619,4040
3762,8,306,3588,256,7271,50
3961,478,15912,3583,12110,152903,3802
16822,13,1413,2860,1058,21705,355
6849,5,178,3454,128,9993,50
39718,78,2141,1669,1775,29127,366
36558,9,176,1872,134,2264,42
30744,18,692,2159,547,10157,145
42352,22,330,1344,246,6140,84
2913,10,208,3605,178,5239,30
25855,1,39,2415,33,3194,6
42938,8,227,1213,151,7238,76
36903,412,14023,1851,9027,105041,4996
15676,5,340,2916,281,3550,59
16014,102,3229,2902,2368,16499,861
18681,4,105,2772,80,4102,25
32077,1,103,2093,53,2623,50
20358,120,7219,2690,5356,39213,1863
46218,0,13,251,6,694,7
9267,8,208,3298,152,12180,56
19801,51,2441,2720,1863,33895,578
22715,117,3383,2560,2499,27046,884
19448,2,145,2737,91,6646,54
1845,110,11828,3624,8126,37808,3702
42766,7,133,1257,104,6832,29
11158,24,162161,3197,43332,16727,118829
38961,23,269,1714,230,4255,39
6564,5,162,3467,119,2760,43
42533,261,6558,1307,4869,49905,1689
26756,342,11059,2374,7601,51583,3458
2245,80,1431,3616,1128,10012,303
39831,2,146,1663,107,6932,39
25011,5,260,2452,214,6727,46
11787,2,93,3164,77,3291,16
11841,3,145,3163,113,10965,32
2026,101,4633,3619,3290,37172,1343
33121,0,37,2047,29,2049,8
7969,27,624,3382,490,9152,134
33166,25,803,2045,677,13898,126
32806,7,171,2060,146,6204,25
5861,1920,94132,3496,63434,244655,30698
46450,14,229,149,189,4761,40
1777,5,239,3633,186,4702,53
27403,1,47,2341,45,2541,2
36319,84,6800,1884,3908,35806,2892
33242,14,3130,2043,2021,8835,1109
44822,37,513,755,394,6209,119
4683,5,102,3557,84,3903,18
20971,0,26,2655,22,1369,4
27726,2,48,2322,34,1521,14
41016,3,147,1566,107,4760,40
45269,158,6094,602,4145,39470,1949
45387,5,64,569,48,2245,16
35843,103,6374,1915,4444,50259,1930
46105,12,145,296,122,1279,23
36014,3,124,1902,97,2547,27
7410,6,183,3424,151,9024,32
8401,90,4696,3350,3624,35740,1072
30139,1,110,2193,91,2919,19
37129,2,103,1837,86,8603,17
3934,1243,65274,3584,47125,270938,18149
9644,20,1031,3274,803,14685,228
8515,14,547,3343,264,5299,283
31480,17,5883,2124,4377,33896,1506
16134,15,459,2895,353,4840,106
36212,207,14112,1890,11573,45376,2539
9653,65,4904,3273,3479,39784,1425
3339,12,406,3597,314,13033,92
8120,5,158,3369,119,1966,39
11549,3,142,3176,111,2843,31
13714,605,25364,3040,15949,220419,9415
9186,2,47,3302,39,1878,8
1553,3,316,3688,214,7424,102
23796,14,297,2508,224,10508,73
35677,11,431,1926,347,7611,84
42823,4,136,1243,96,7426,40
2861,3,66,3606,59,2521,7
3223,40,1444,3599,1108,19855,336
6930,1,67,3451,52,3099,15
26504,0,114,2385,95,3897,19
2585,86,7516,3610,5521,47521,1995
1791,23,416,3627,342,7758,74
18055,16,439,2799,324,5819,115
20117,25,1476,2703,1124,13076,352
38436,402,23858,1749,17183,105539,6675
27132,2,112,2357,96,1573,16
26538,52,1286,2383,940,11595,346
13999,2,214,3016,145,3897,69
35562,0,63,1937,52,3915,11
46296,5,146,228,126,3475,20
8778,19,752,3326,565,11632,187
3948,27,785,3583,607,10260,178
11179,97,7787,3196,5659,64756,2128
42885,6,137,1228,109,7323,28
44001,155,1300,918,1079,10136,221
45565,5,71,516,32,1148,39
36188,1,134,1890,101,4157,33
35376,23,778,1950,656,12221,122
44714,6,108,789,79,2410,29
44872,35,324,740,277,5715,47
33660,3,226,2027,190,6680,36
9640,4,132,3274,107,3830,25
18469,659,53648,2781,36095,249699,17553
25858,0,80,2415,67,3172,13
34535,2,132,1995,99,3027,33
32790,30,851,2061,678,7912,173
28918,44,2202,2254,1702,33430,500
40679,19,309,1596,240,6045,69
11606,16,325,3174,251,6201,74
16341,6,135,2885,102,3798,33
1293,8,256,3834,208,6726,48
2613,9,651,3609,497,21347,154
26933,17,288,2365,231,4436,57
4623,4,253,3559,193,11113,60
38169,8,164,1768,127,10150,37
29079,44,1729,2245,1291,14635,438
36237,5,182,1889,146,2235,36
41409,48,1502,1510,1086,14439,416
35421,614,30438,1947,22372,149518,8066
7012,2,61,3446,53,2651,8
4640,3,76,3558,65,3577,11
20317,10,707,2692,587,18854,120
24295,3,113,2484,92,5500,21
8151,11,222,3367,187,10629,35
10915,26,1180,3210,785,36037,395
41895,13,482,1430,379,7456,103
4829,12,360,3551,280,12139,80
36541,0,32,1873,23,1986,9
4195,98,3029,3575,2258,23972,771
10026,40,1475,3256,1147,11216,328
38622,40,3330,1735,2774,21586,556
2229,2,87,3616,80,3464,7
41469,27,761,1501,580,7247,181
24293,0,71,2485,63,1685,8
29150,0,33,2242,23,1471,10
26669,2,194,2378,158,8131,36
46377,11,119,191,90,2317,29
21902,4,63,2602,51,3435,12
2398,220,11971,3613,8805,80071,3166
38261,1,113,1762,99,4539,14
20426,569,21850,2686,17908,67223,3942
35280,28,632,1953,514,7211,118
40672,9,228,1597,166,3707,62
30582,21,662,2168,561,8244,101
6317,12,483,3478,389,18081,94
42291,16,363,1356,276,10522,87
19140,647,21238,2754,16000,121256,5238
33110,81,2769,2048,2180,14462,589
29633,31,596,2217,466,4721,130
5404,3,271,3519,221,15175,50
15827,0,221,2909,185,4927,36
40569,9,1340,1605,1010,22311,330
19216,10,682,2750,556,10790,126
31571,6,102,2119,88,3448,14
40224,67,2593,1637,2040,22256,553
8307,5,46,3357,38,2283,8
9168,9,372,3303,293,7248,79
43349,22,352,1094,259,5324,93
22869,318,7940,2552,5635,56063,2305
39106,26,916,1705,617,16945,299
10100,3,191,3252,130,3352,61
17846,8,178,2810,143,3707,35
15482,22,1385,2926,1105,7949,280
16915,45,2767,2856,2076,12306,691
41741,39,557,1460,414,13787,143
14676,335,16543,2970,12048,66791,4495
29475,6,1356,2225,680,11737,676
37680,9,222,1803,174,9782,48
11710,21,568,3168,429,10913,139
40518,4,205,1610,159,6949,46
34597,10,543,1992,409,19141,134
2278,27,754,3615,621,6899,133
28363,0,141,2285,107,3315,34
4565,239,18858,3561,12860,120053,5998
41918,16,663,1427,472,10266,191
3903,1,72,3585,48,3092,24
39172,23,420,1702,321,13150,99
4253,40,854,3573,713,19608,141
25916,5,416,2412,351,7984,65
36023,41,594,1902,500,9106,94
14572,9,209,2976,166,5712,43
12275,45,903,3140,592,7064,311
22326,315,9889,2579,7724,50726,2165
28903,58,3963,2255,3029,14131,934
10841,20,1698,3214,1023,11039,675
16593,75,4879,2874,3619,56286,1260
40923,109,2985,1573,2258,29742,727
27503,1,77,2334,65,1354,12
23042,31,3358,2544,2677,21863,681
7427,11,439,3422,333,9957,106
8208,8,150,3363,97,6786,53
35747,0,110,1922,87,4548,23
5836,17,688,3498,496,26626,192
2217,35,1755,3616,1433,33096,322
31809,251,6223,2107,4829,25347,1394
15910,30,3349,2907,2536,22985,813
8393,94,5003,3351,3768,59011,1235
28016,11,687,2305,534,9698,153
45287,17,382,596,249,6881,133
23829,48,2776,2506,2110,17457,666
18968,25,1150,2760,917,16675,233
46429,11,96,161,81,2083,15
10323,6,156,3242,118,4361,38
6508,5,80,3469,64,3299,16
4550,31,991,3562,792,9857,199
7386,0,56,3425,48,2935,8
18115,0,119,2796,101,4672,18
25484,1,119,2432,92,2675,27
33340,14,587,2039,484,15308,103
20362,3,405,2690,313,10818,92
41004,0,284,1567,214,7236,70
38710,2,130,1730,114,9300,16
37616,2,176,1806,140,10273,36
24405,24,1165,2480,896,7575,269
31432,10,180,2127,151,9558,29
5995,2,70,3490,58,3149,12
5899,17,289,3494,242,9309,47
4382,49,1033,3568,766,7069,267
11839,3,189,3163,159,12555,30
11781,3,135,3164,102,4363,33
19666,8,499,2728,396,3348,103
5133,13,400,3534,288,13795,112
45345,29,269,581,189,2643,80
31228,15,473,2138,403,6656,70
10957,103,125417,3208,40435,36055,84982
9554,4,89,3279,74,4350,15
40656,50,1977,1599,1501,28185,476
7981,11,241,3381,181,6366,60
5706,147,7016,3504,5337,47835,1679
12316,34,959,3138,833,12911,126
29906,29,1961,2204,1621,7125,340
22537,10,956,2568,725,21574,231
7265,3,143,3432,100,8818,43
38849,18,788,1721,631,7087,157
1499,6,79,3710,68,3344,11
17300,304,9156,2833,6863,44865,2293
12357,7,62468,3135,22149,17419,40319
11139,19,1004,3198,796,33883,208
38885,14,384,1719,299,7086,85
36896,22,393,1852,336,5976,57
12645,2,54,3119,47,6622,7
17767,0,108,2813,85,3436,23
36987,90,3406,1846,2390,25318,1016
6426,4,267,3473,152,9088,115
19244,13,440,2748,319,6206,121
19303,124,8266,2745,6453,14453,1813
46104,117,3367,297,2709,20681,658
20929,87,4694,2657,3170,35948,1524
24882,32,81,2458,55,4865,26
13921,10,810,3022,660,6654,150
6593,12,290,3466,214,7839,76
41775,11,180,1453,137,4992,43
30391,7,290,2178,204,12116,86
45276,7,90,600,77,2260,13
22411,7,416,2575,319,7474,97
4705,42,1140,3556,907,15601,233
8973,2,78,3315,59,4427,19
20759,9,579,2669,417,8424,162
30283,12,291,2185,228,5642,63
43751,1,42,963,32,3666,10
28542,1,38,2273,35,2323,3
37353,7,131,1824,102,5046,29
29145,0,18,2242,15,1949,3
19825,0,108,2718,89,8483,19
16083,17,806,2897,631,5237,175
25560,1,44,2429,39,2430,5
6500,6,92,3470,74,2009,18
3212,43,1478,3599,1138,44257,340
40309,51,1602,1631,1080,14208,522
19847,1199,45700,2717,32548,169471,13152
44671,443,6412,806,4758,37167,1654
5219,14,636,3529,506,10724,130
40697,0,0,1595,0,7826,0
31254,36,739,2137,596,10142,143
15511,551,24366,2924,18798,73431,5568
2337,8,184,3614,149,6749,35
19904,4,225,2714,185,3556,40
29883,4,207,2205,174,4613,33
19558,7,430,2733,325,7074,105
9953,2,78,3260,62,1447,16
28812,4,213,2259,175,5157,38
2065,11,317,3618,248,9921,69
33605,96,3378,2029,2582,24625,796
37823,656,14779,1791,10547,91470,4232
6230,32,569,3482,478,5060,91
14020,32,2658,3014,2018,49631,640
33717,6,381,2025,327,6099,54
18619,100,8494,2774,6434,39323,2060
35534,20,576,1938,450,3661,126
17925,61,3472,2806,2448,34132,1024
2701,11,302,3608,251,8823,51
26937,3,263,2365,215,6074,48
4913,17,448,3546,378,7273,70
36260,64,2645,1887,1811,16182,834
45808,6,66,419,45,2346,21
21881,182,5408,2603,4242,23743,1166
10621,92,5007,3227,3752,73498,1255
1800,32,1652,3626,1244,29449,408
31081,11,367,2145,312,16755,55
23614,60,1094,2516,835,12041,259
4295,41,1115,3571,820,20309,295
30664,8,213,2163,168,7283,45
19883,10,407,2715,324,4945,83
44180,42,700,885,580,22728,120
12039,75,1688,3153,1346,9914,342
9006,6,479,3314,379,14871,100
29339,3,298,2231,218,5023,80
33549,4,387,2031,326,5640,61
28910,1,255,2255,211,4840,44
16877,126,6624,2858,4928,47736,1696
1727,1,99,3650,81,4920,18
25124,3,142,2447,101,2342,41
3993,7,164,3581,135,7625,29
14990,12,293,2949,212,6073,81
14520,12,335,2979,250,3826,85
13217,6,195,3077,149,4762,46
20066,3,159,2705,127,7149,32
40456,14,375,1616,300,4708,75
22793,51,1287,2557,922,6100,365
30271,152,5069,2186,4002,21508,1067
15170,62,2396,2939,1890,15896,506
44777,10,109,769,79,2705,30
9206,6,258,3301,205,11862,53
18571,270,10229,2777,7709,46959,2520
18439,19,925,2782,632,14753,293
22167,105,13208,2587,9255,58405,3953
3055,48,2592,3602,2055,50541,537
12043,0,140,3153,115,3810,25
38319,7,135,1758,106,3492,29
28959,29,1010,2252,653,11213,357
21077,80,4798,2649,3265,40380,1533
13909,8,566,3023,439,9676,127
43380,5,184,1082,125,2976,59
19929,64,4288,2713,2860,38689,1428
12205,151,4536,3144,3489,62996,1047
40087,15,592,1645,363,6544,229
4924,15,398,3545,284,5177,114
23021,9,725,2545,515,8912,210
23153,787,239696,2539,165443,318514,74253
19903,9,153,2714,113,4147,40
33955,51,1467,2017,1093,23957,374
44658,5,182,809,140,6886,42
38295,12,632,1759,496,11230,136
6607,13,326,3466,268,6975,58
25618,46,1398,2425,1153,10858,245
7183,5,66,3436,54,2399,12
10855,136,4113,3213,3222,61536,891
42229,104,5482,1368,4610,14278,872
37960,28,514,1782,411,5474,103
25462,249,12300,2433,9144,43116,3156
38927,14,474,1717,391,6807,83
14634,36,1601,2972,1243,16682,358
8092,60,1504,3370,1229,15746,275
15438,90,8230,2928,5987,42112,2243
41451,7,175,1503,135,2257,40
23666,1437,63124,2513,43188,295202,19936
38326,18,369,1757,285,5297,84
27186,12,328,2354,233,11583,95
32264,7,213,2083,183,6413,30
30324,4,282,2182,222,4566,60
24301,1,464,2484,315,13659,149
38718,4,81,1730,69,3584,12
36947,15,325,1849,256,8583,69
20419,31,2541,2686,2086,20225,455
26786,93,7334,2372,5690,54588,1644
27839,10,217,2315,183,2288,34
10748,24,1998,3219,1359,16829,639
13683,5,432,3043,337,7432,95
25606,44,2851,2425,2232,16536,619
7908,4,37,3389,33,2242,4
14068,10,712,3011,489,5649,223
6369,69,3414,3475,2428,31193,986
43698,21,354,977,272,6662,82
31355,4,126,2131,111,3418,15
5454,16,400,3517,300,10220,100
39698,1,69,1670,51,2678,18
25221,16,947,2443,760,16030,187
38539,11,345,1742,253,8469,92
8243,16,373,3361,273,9032,100
46020,48,569,329,497,7578,72
7036,116,2618,3444,2034,22189,584
43361,6,121,1080,99,6382,22
2346,1,58,3614,44,3985,14
13836,20,615,3031,482,7036,133
18579,45,1119,2777,898,9231,221
20211,4,303,2697,233,6074,70
17663,1,79,2816,63,5588,16
38420,6,480,1750,384,9226,96
8768,23,419,3327,342,13436,77
13730,43,1283,3038,1001,12794,282
16231,24,1392,2891,1099,22834,293
42276,2,102,1358,72,3581,30
2422,94,3133,3613,2538,21875,595
12218,244,71519,3144,45619,234338,25900
11002,33,2983,3205,2013,24110,970
27577,0,69,2330,53,2500,16
21594,85,3620,2618,2882,15713,738
6754,90,6615,3459,5017,54185,1598
35666,16,353,1928,282,4556,71
17644,117,10815,2817,7189,41902,3626
9213,1,69,3301,57,1893,12
16845,311,23847,2859,17230,160171,6617
42817,26,563,1244,390,6425,173
34526,73,1715,1995,1354,10332,361
3416,65,2611,3595,2018,21644,593
45374,8,239,573,136,3950,103
9332,0,64,3293,49,5382,15
39040,119,3493,1710,2654,20064,839
1916,11,471,3622,372,6878,99
4833,86,2292,3550,1795,24833,497
22066,154,8165,2592,6023,35538,2142
29564,80,2681,2221,2233,28409,448
36321,147,1825,1884,1488,15384,337
8046,19,281,3372,233,6401,48
10030,432,15866,3256,10882,52560,4984
45191,1,14,626,13,1567,1
11153,3,139,3197,124,8203,15
11784,61,3367,3164,2247,23442,1120
32785,2,88,2062,76,5715,12
7503,45,1146,3419,885,12249,261
8643,13,419,3335,311,5797,108
4523,18,771,3563,571,18308,200
25933,38,2861,2411,2261,20357,600
17852,2,270,2810,182,4301,88
37765,38,442,1796,350,4800,92
11507,68,7563,3179,5577,43776,1986
7909,55,2343,3389,1781,27190,562
18884,1,443,2763,362,6317,81
15130,35,1803,2942,1453,25350,350
45234,32,241,614,181,4507,60
13121,36,1154,3090,885,13997,269
35295,4,176,1953,155,1605,21
8150,16,756,3368,624,11777,132
6606,4,69,3466,54,2350,15
33794,5,226,2022,187,3478,39
23146,542,10141,2539,7751,49573,2390
44892,0,13,735,12,2005,1
32829,17,585,2059,462,6706,123
13139,42,1954,3089,1501,20880,453
3902,12,440,3585,346,16396,94
15443,331,25816,2927,18278,186101,7538
39194,81,775,1700,617,6547,158
22423,1,283,2575,223,3578,60
35442,11,330,1945,291,2272,39
26518,4,131,2384,117,3091,14
35234,98,5897,1956,4314,31076,1583
11183,43,1424,3195,1097,13208,327
15108,4,204,2943,166,6510,38
2442,5,661,3612,565,8956,96
28478,52,2848,2279,2239,20214,609
12373,11,744,3134,550,12940,194
14551,1,35,2978,28,3337,7
40709,24,605,1594,427,9948,178
32478,13,1182,2075,830,9290,352
43595,0,83,1013,57,9883,26
23917,7,570,2503,383,7507,187
21799,24,892,2607,727,15750,165
11239,22,981,3192,735,15240,246
34103,29,780,2012,642,9354,138
32782,117,4099,2062,3123,31592,976
40743,42,986,1591,793,21808,193
6658,6,52,3464,41,5219,11
4271,26,615,3572,503,12056,112
35345,21,395,1951,288,7137,107
15636,306,14775,2917,11192,96006,3583
29112,62,1260,2244,885,25494,375
38612,8,94,1736,79,4186,15
44696,13,107,797,96,1477,11
31179,61,4426,2140,3424,23935,1002
34875,23,807,1975,650,8806,157
29287,19,633,2235,506,18153,127
40022,13,275,1649,231,5059,44
14275,31,1008,2999,830,7241,178
23906,6,264,2503,220,7310,44
2386,49,2388,3613,1933,37471,455
37320,15,318,1825,243,3068,75
4380,17,470,3568,348,11576,122
12125,11,87,3149,72,7382,15
8119,6,268,3369,212,7543,56
5612,30,245,3510,188,7298,57
26070,26,1246,2405,974,8081,272
31823,3,141,2106,104,3394,37
16061,16,706,2899,587,7828,119
38247,10,336,1762,242,7130,94
17920,0,149,2806,114,6532,35
13100,109,5321,3091,3742,66838,1579
32018,1,151,2096,100,5847,51
15775,42,1456,2911,1126,25593,330
17498,43,2057,2824,1590,21814,467
12678,7,400,3118,322,19286,78
43504,128,1972,1047,1559,12534,413
36503,33,891,1875,730,6520,161
3965,6,85,3583,69,4139,16
16330,184,7605,2886,5202,53593,2403
43158,18,533,1149,379,8982,154
9341,35,1299,3292,901,12105,398
10384,24,1277,3240,762,21366,515
12049,113,4936,3153,3760,25161,1176
27931,402,34654,2309,22907,144281,11747
11685,46,2621,3169,1953,38235,668
12057,0,80429,3153,21797,3394,58632
5502,21,433,3515,319,12456,114
40230,266,9522,1636,7064,64128,2458
45910,27,1085,383,546,7444,539
3969,47,1920,3582,1375,21900,545
12656,21,976,3119,752,16065,224
24983,1,101,2453,81,3281,20
36697,0,118,1864,92,7393,26
28758,90,2432,2261,1760,11604,672
38278,59,1119,1761,893,7165,226
10835,56,4122,3214,2933,32124,1189
33643,10,314,2028,275,4564,39
44129,270,4867,895,3197,25662,1670
7338,76,4469,3427,3238,15451,1231
5874,35,168,3496,135,12664,33
17487,29,1736,2824,1349,55227,387
19494,8,281,2735,204,4371,77
30973,393,30893,2150,22711,181912,8182
43467,22,808,1059,558,10527,250
10763,18142,937968,3218,495493,2767700,442475
14728,13,479,2966,399,18219,80
4369,31,1029,3568,781,22228,248
42458,1,36,1322,29,2451,7
17521,13,546,2823,440,7962,106
31533,9,283,2121,249,4068,34
4170,45,1193,3576,955,11507,238
9209,4,332,3301,282,24154,50
42530,48,1131,1308,883,19023,248
24167,0,40,2490,34,2685,6
45555,14,436,520,306,6188,130
28412,1,40,2282,34,1950,6
38667,10,364,1733,199,5339,165
2837,11,174,3606,153,11109,21
6964,133,4685,3448,3533,42039,1152
4498,94,3127,3564,2299,18947,828
6182,6,156,3484,124,4491,32
46356,36,718,203,524,10291,194
32940,22,395,2055,322,4040,73
29498,1,186,2224,164,3819,22
37638,23,375,1805,294,6535,81
27159,0,110,2356,86,2719,24
22920,8,363,2549,276,11601,87
37596,3123,100317,1808,58227,273353,42090
45785,4,42,426,32,1330,10
33542,36,1043,2031,778,7994,265
4714,146,4473,3555,3292,31045,1181
8745,9,352,3329,263,3992,89
37774,17,516,1795,388,7152,128
29966,9,458,2201,386,6323,72
34286,1,75,2006,61,2892,14
29201,5,193,2240,154,6117,39
42069,173,3324,1402,2532,29190,792
31218,246,5104,2139,3597,47062,1507
38230,0,2,1764,1,113,1
14316,106,4671,2994,3543,28554,1128
38383,125,2550,1753,2021,28956,529
25235,26,1205,2442,985,12042,220
947,3,72,3948,62,2748,10
9471,0,148,3284,117,2774,31
43428,92,2289,1068,1536,15286,753
34245,125,5101,2008,3805,92699,1296
43523,448,6761,1042,5222,46440,1539
41252,6,134,1533,112,6634,22
14606,0,65,2974,44,4176,21
35992,26,272,1904,212,6754,60
30185,3,96,2190,78,2572,18
22233,15,2312,2583,1663,32202,649
36128,31,876,1894,698,12757,178
13516,41,1391,3054,1080,13276,311
41523,59,504,1495,385,6214,119
42970,9,212,1206,147,9315,65
21980,452,22158,2596,17128,146087,5030
33164,3,136,2045,111,4229,25
29185,40,1816,2241,1474,25055,342
27596,4,593,2329,457,4675,136
3945,6,200,3583,164,3551,36
10291,87,2546,3244,1979,23965,567
26030,4,385,2406,282,6619,103
33782,1,41,2022,37,2310,4
12797,287,11623,3111,8527,34140,3096
29724,2,105,2213,91,8741,14
43444,57,940,1065,780,19799,160
23138,3,196,2539,159,10439,37
15785,151,9919,2911,7461,67772,2458
28684,4,219,2266,170,3166,49
34405,102,4300,2001,3339,28313,961
20256,5,209,2694,172,4554,37
43601,50,876,1011,707,20895,169
46197,21,556,257,387,6763,169
39647,6,101,1673,68,2357,33
19736,1,112,2724,88,6474,24
36058,29,520,1898,427,5639,93
33627,109,3206,2029,2379,19106,827
26634,1439,38674,2380,29930,184056,8744
6970,48,2794,3448,2092,70688,702
4385,110,2481,3568,1886,14123,595
18442,79,6141,2782,4335,49804,1806
36753,14,538,1861,443,9339,95
31811,23,1241,2107,1003,12727,238
27991,1,67,2306,42,2617,25
41817,13,455,1442,300,4954,155
6912,7,211,3452,173,4259,38
3976,85,4044,3582,2975,57789,1069
35930,2,25,1908,21,3425,4
24290,3,234,2485,170,3932,64
28300,16,1036,2289,825,13414,211
24051,40,1568,2496,1148,15315,420
2726,105,9004,3608,3592,56864,5412
35791,6,224,1918,173,10711,51
9924,21,625,3262,489,9708,136
39355,18,377,1690,303,6127,74
18690,10,957,2771,770,11013,187
9555,21,850,3279,637,13856,213
34991,15,1046,1969,804,13904,242
40491,194,6335,1612,4771,39554,1564
45559,1,18,518,7,1701,11
42037,401,8891,1408,6323,82111,2568
29296,34,786,2234,624,8194,162
31752,27,1757,2109,1377,22579,380
29032,2,176,2248,153,4287,23
18343,7,572,2786,458,4491,114
4355,43,2697,3569,2251,30733,446
40261,45,1094,1634,842,23838,252
21342,2,34,2633,24,3535,10
20325,21,1484,2692,1209,24486,275
21736,19,1011,2611,798,20453,213
29720,2,251,2213,194,5025,57
40794,8,415,1585,287,9169,128
11566,2,66,3176,55,1181,11
33245,3,99,2043,84,3165,15
6839,8,120,3455,94,2855,26
12490,12,205,3128,163,3404,42
22238,23,895,2583,736,7732,159
43219,110,2497,1133,1743,24289,754
4478,19,750,3564,632,30023,118
30571,3,85,2168,68,1694,17
27056,0,139,2362,117,5854,22
23242,57,2338,2534,1893,9985,445
11470,2,66,3181,53,3468,13
39585,54,1473,1677,1097,14605,376
5838,28,623,3497,442,5224,181
42957,1,68,1209,48,2443,20
36679,95,3248,1865,2606,22222,642
45127,77,1471,645,1050,14696,421
37867,557,17460,1788,13691,88187,3769
42115,52,1894,1394,1399,29588,495
15858,15,638,2908,529,8963,109
29375,17,322,2230,239,3458,83
33637,60,1237,2028,975,9204,262
1227,1,72,3859,61,3528,11
36848,6,353,1853,293,9906,60
6082,13,581,3487,402,12879,179
2341,8,378,3614,280,9410,98
43172,8,160,1145,113,3715,47
5127,692,20563,3534,13531,201574,7032
4182,2,155,3575,135,4933,20
25094,6,221,2448,178,2703,43
45350,8,139,580,86,3645,53
42338,16,186,1348,131,3295,55
34798,32,1047,1980,809,17920,238
18199,24,2311,2793,1832,33759,479
41929,7,421,1425,262,7346,159
42103,4,99,1395,82,2595,17
28796,23,1207,2260,831,15335,376
45504,27,342,541,267,5528,75
3229,27,1041,3599,722,33077,319
12855,10,191,3107,155,2015,36
31543,14,258,2120,222,4769,36
8035,177,4362,3372,3493,13621,869
41839,277,9263,1439,6624,70218,2639
25151,24,662,2446,550,4789,112
26418,13,374,2389,294,3563,80
7100,17,412,3441,323,5907,89
13776,4,212,3035,160,4042,52
34261,6,118,2007,91,4661,27
23804,65,2605,2508,2096,13547,509
8130,10,466,3368,363,8896,103
29252,3,199,2237,159,3666,40
36514,4,97,1874,83,4744,14
15178,2,100,2939,83,11937,17
35061,30,736,1966,624,4933,112
46130,7,150,285,102,2066,48
18589,119,3938,2776,2974,20080,964
27028,5,214,2363,175,3989,39
11096,20,435,3200,347,12962,88
34026,52,1380,2014,1118,19859,262
38029,254,5562,1779,4308,45936,1254
8789,1,67,3326,48,1741,19
38094,9,124,1774,103,3049,21
38236,27,531,1763,423,8037,108
32283,1,50,2083,41,2675,9
25184,0,45,2444,35,1539,10
38186,0,21,1767,13,3732,8
10239,173,10014,3246,7682,50138,2332
39242,464,30867,1696,23277,135145,7590
45632,44,367,493,296,7820,71
24794,35,1573,2462,1175,22322,398
31403,13,481,2129,375,5687,106
7092,7,104,3441,95,3932,9
18023,33,4266,2800,2783,27674,1483
20572,735,43117,2679,30224,162390,12893
6471,27,697,3471,574,7211,123
12310,1,52,3139,32,2441,20
18817,8,367,2766,267,15040,100
10106,1,49,3252,38,2687,11
27621,194,16631,2327,12070,48181,4561
7210,82,1794,3435,1456,41626,338
26498,43,9673,2385,7924,14042,1749
31790,10,197,2107,104,1861,93
42881,257,3361,1229,2730,24649,631
36867,4,70,1853,56,2569,14
10051,4,240,3255,196,4401,44
27802,3,208,2316,176,6096,32
24477,99,3203,2476,2633,20985,570
39880,6,290,1659,242,11569,48
3664,382,22469,3590,16126,126081,6343
37393,1,91,1821,69,4763,22
11318,11,636,3190,479,12094,157
38907,2,124,1718,88,11288,36
30648,1,39,2164,36,7921,3
18848,71,1479,2764,1113,11388,366
2779,361,20495,3607,15834,103942,4661
39081,0,58,1707,48,1936,10
38316,0,52,1758,40,2924,12
5108,32,3135,3536,1533,22102,1602
3950,150,7401,3583,5528,60146,1873
32763,17,511,2063,386,8406,125
18146,11,252,2795,224,13060,28
28480,47,839,2279,665,13400,174
38297,10,194,1759,159,4247,35
16794,4,174,2861,139,2964,35
44021,54,864,913,548,5635,316
22028,12,373,2593,323,11267,50
20843,0,1093,2664,828,10287,265
12058,9,572,3153,446,5246,126
19428,14,2345,2739,1862,24354,483
35118,972,48531,1963,30956,197540,17575
28928,9,1124,2254,725,9758,399
8445,114,2770,3348,2244,30582,526
12946,31,1005,3102,776,8997,229
19864,9,402,2716,335,12646,67
35553,0,129,1937,106,4588,23
13687,13,668,3042,493,8653,175
11341,37,633,3189,516,3237,117
36253,7,211,1888,178,4333,33
10808,2,33,3215,27,1953,6
42057,0,43,1404,39,4665,4
36950,6,202,1848,166,9032,36
29539,4,234,2222,180,7063,54
37131,31,571,1837,474,11387,97
30344,63,1540,2181,1119,10183,421
26648,0,8639,2379,6697,66883,1942
8015,15,458,3379,187,5032,271
40894,0,33,1575,27,4686,6
43515,4,73,1044,49,4189,24
19944,5,360,2712,307,13612,53
46285,0,13,233,8,805,5
6243,42,2275,3481,1330,24504,945
18949,1,119,2761,95,2725,24
33804,40,1178,2021,984,11155,194
35674,22,677,1927,548,9821,129
8941,7,202,3317,144,7173,58
36649,134,7031,1866,5239,43409,1792
6139,2,65,3485,47,2717,18
39435,54,1006,1685,776,6586,230
39667,3,112,1672,84,10897,28
40591,10,143,1603,104,1456,39
45036,6,164,690,96,4913,68
1859,48,1386,3623,1117,22484,269
42333,12,182,1349,142,6827,40
43283,15,682,1114,449,14515,233
13830,14,1011,3031,773,18476,238
9024,6,194,3313,152,3502,42
24355,17,608,2482,494,17132,114
27794,18,1215,2317,902,9915,313
7122,38,1351,3439,1071,12317,280
36830,7,138,1855,112,4422,26
23986,20,662,2498,537,3671,125
24533,42,1414,2474,1005,12053,409
40401,37,1870,1621,1407,11839,463
43231,3,88,1129,67,3248,21
1121,5,72,3892,63,3865,9
44657,83,915,809,745,14953,170
15431,4,119,2928,91,6738,28
5941,1,31,3492,26,1993,5
37723,5,235,1799,199,3862,36
13983,7,120,3017,83,8195,37
22125,6,242,2588,186,12294,56
22838,426,23229,2554,15847,126213,7382
44205,39,555,880,385,6593,170
43142,4,108,1154,63,3201,45
5842,41,2025,3497,1499,23529,526
37200,6,58,1832,50,2630,8
43984,119,1092,920,857,11488,235
8590,36,1525,3338,1248,17741,277
15805,0,8025,2910,6264,61431,1761
28566,7,219,2272,167,2008,52
4620,33,943,3559,790,11286,153
29537,5,584,2222,478,13094,106
35040,25,730,1967,598,9825,132
2984,4,69,3603,60,2387,9
14042,0,696,3013,556,4479,140
19501,13,567,2735,439,7960,128
16301,16,1043,2887,815,7789,228
36125,88,5637,1894,4367,34830,1270
8429,56,3658,3349,2720,34221,938
46072,1,53,305,41,2030,12
35923,2,37,1909,33,3395,4
37576,2,248,1808,185,8804,63
3824,4,119,3587,99,3709,20
3718,83,5603,3589,4235,56842,1368
3667,28,960,3590,753,11052,207
36803,33,1406,1857,1069,13681,337
26206,7,171,2398,144,2903,27
27876,0,0,2313,0,1835,0
41842,3,143,1439,101,10585,42
42828,75,4369,1241,3341,45239,1028
6343,17,318,3477,266,10161,52
4852,85,2988,3549,2394,38274,594
26011,30,1007,2407,758,16099,249
31981,336,7682,2098,5473,47963,2209
31150,13,393,2142,322,12015,71
34638,27,851,1989,716,13450,135
34781,142,6315,1981,4706,55990,1609
38484,11,379,1746,273,7664,106
33124,16,715,2047,589,9946,126
16482,30,1178,2879,909,15316,269
36121,4,80,1894,64,4526,16
21663,0,114,2614,92,2333,22
21994,6,224,2595,154,4255,70
24937,12,268,2455,188,17301,80
37268,458,15887,1828,12537,92048,3350
5479,29,777,3516,614,15694,163
46237,4,37,247,35,881,2
16657,213,15510,2870,10098,136971,5412
45522,50,580,534,477,5111,103
15014,44,1098,2948,880,9465,218
13947,45,4837,3020,3713,36521,1124
22415,2,155,2575,129,4737,26
18106,6,289,2797,232,9003,57
30091,3,400,2196,294,4485,106
16281,9,343,2889,280,6792,63
23139,6,170,2539,142,8892,28
5171,9,202,3532,174,5092,28
8526,49,1220,3342,972,23656,248
32088,12,205,2092,135,2708,70
25561,53,895,2429,708,9033,187
9896,17,589,3263,399,4931,190
9093,100,2091,3308,1522,22214,569
16387,223,23200,2882,15598,62477,7602
24980,0,2115,2453,1481,21639,634
38041,22,345,1777,275,9405,70
6873,4,406,3454,363,7849,43
12540,1,26,3126,22,1179,4
17349,9,242,2831,162,6759,80
34792,519,9602,1980,6812,48809,2790
22825,4,67,2555,55,2114,12
16560,70,1722,2875,1334,17700,388
33339,74,3185,2039,2487,38662,698
40726,2,56,1592,44,4755,12
27474,59,1463,2336,1065,9951,398
25376,0,38,2437,35,1634,3
40864,41,1184,1578,888,16384,296
12078,45,1596,3151,1049,21815,547
35247,5,80,1955,66,2555,14
5341,100,4642,3523,3543,77615,1099
26503,5,473,2385,315,4240,158
38703,2,224,1730,183,6062,41
18246,39,554,2790,435,6617,119
23855,12,265,2505,219,4446,46
43353,32,726,1093,536,13166,190
6117,15,666,3486,546,12583,120
24520,2,360,2474,287,8481,73
40360,9,182,1624,149,5943,33
16381,15,1040,2883,831,9212,209
13418,89,7341,3063,5288,98182,2053
41087,40,378,1557,288,3986,90
15560,12,897,2921,690,6431,207
21391,34,2146,2630,1558,20071,588
45963,21,211,355,160,2553,51
34338,1,64,2004,53,4039,11
44587,26,310,822,229,6511,81
9445,105,6173,3286,4839,42622,1334
12069,170,9816,3152,6701,76493,3115
8420,17,510,3350,391,11331,119
19003,4,340,2759,288,3089,52
38936,1,40,1716,33,5907,7
8960,37,1020,3316,825,19165,195
7442,9,496,3422,336,5907,160
16423,4,192,2881,158,7046,34
26499,15,637,2385,491,16290,146
18743,1,151,2769,118,3377,33
33498,193,4565,2033,3333,23478,1232
22452,7,334,2573,288,4710,46
31387,30,441,2130,334,2329,107
29994,100,3192,2200,2450,26251,742
40213,19,748,1638,597,13646,151
32851,3,157,2058,120,4142,37
15291,7,124,2933,109,6278,15
37193,53,1279,1833,1051,9195,228
10543,65,3148,3231,2444,27811,704
17062,8,430,2847,359,7082,71
43900,54,693,933,524,7674,169
36910,16,518,1851,445,11501,73
44760,2,41,775,20,1174,21
12991,43,1982,3098,1656,9272,326
45714,2,68,452,38,1141,30
12857,127,51424,3107,22929,70817,28495
18080,7,474,2798,405,5426,69
14964,4,123,2951,109,5208,14
11018,4,107,3205,84,3338,23
17652,6,184,2816,142,5300,42
18341,15,261,2786,210,3113,51
12276,3,43,3140,32,3125,11
2772,1,188,3607,151,4265,37
17602,1,559,2819,463,17296,96
27428,40,1470,2340,1202,13002,268
20081,5,143,2704,106,2250,37
30057,2,200,2197,167,2614,33
8814,33,1733,3324,1339,25064,394
4091,180,4909,3578,3961,48738,948
17327,51,2428,2832,1852,20023,576
9311,22,1189,3295,1009,9933,180
40075,0,106,1646,78,3383,28
13952,137,5120,3020,3959,36489,1161
44981,39,420,710,370,9084,50
4528,16,203,3563,175,4377,28
21323,2,85,2634,76,2574,9
18814,5,228,2766,178,10165,50
45989,2,15,345,14,879,1
8645,4,65,3335,53,8060,12
20947,32,990,2656,761,9706,229
28276,22,945,2290,787,29556,158
31490,69,3356,2123,2376,29735,980
9890,32,802,3263,603,17365,199
34618,1,86,1991,74,4463,12
13610,36,1986,3048,1622,34176,364
23132,15,809,2540,607,17341,202
10086,77,1300,3253,1015,13491,285
32968,7,446,2054,363,5397,83
36553,21,492,1873,397,8223,95
11824,2055,197881,3163,123820,617193,74061
16546,29,3520,2875,2198,17418,1322
38890,30,748,1719,580,7627,168
29102,42,1916,2245,1466,12298,450
18834,29,1143,2765,887,9196,256
40922,22,1113,1573,840,14061,273
41913,45,1305,1428,1020,22320,285
30620,4,594,2166,449,9665,145
18184,303,22049,2793,15923,138948,6126
14832,15,1056,2958,756,17792,300
26218,152,3883,2398,3172,21096,711
4298,12,216,3571,170,3070,46
27913,26,852,2310,694,14983,158
7571,10,141,3414,108,10858,33
35878,5,123,1912,101,2783,22
8173,6,72,3366,53,4999,19
34490,6,218,1997,180,11741,38
20334,5,337,2691,258,5077,79
35922,2,250,1909,200,8276,50
23002,22,655,2546,512,9560,143
26249,6,206,2397,168,2085,38
45424,6,59,560,45,2561,14
18840,14,1177,2765,815,7101,362
42814,14,173,1244,137,3985,36
41327,26,725,1522,537,13725,188
18353,51,2988,2785,2251,34237,737
39353,15,241,1690,184,4118,57
8149,4,85,3368,70,3979,15
6846,40,1916,3455,1505,16879,411
13235,42,1804,3077,1466,38547,338
30859,158,6436,2154,4591,47526,1845
7231,2,101,3434,80,4544,21
8105,44,1090,3369,869,14014,221
13501,44,2858,3056,2184,33229,674
20793,1,75,2666,53,2432,22
24453,631,28616,2478,20240,139169,8376
31584,8,501,2118,391,5606,110
4975,33,994,3543,810,13259,184
6577,2,18,3467,16,1741,2
36547,4,165,1873,129,3742,36
30117,23,1142,2194,987,25751,155
20449,6,168,2685,128,3101,40
29161,73,2849,2242,2193,17574,656
42651,3,119,1284,78,3310,41
11262,38,1217,3191,890,9053,327
9511,5,172,3282,146,3293,26
1098,4,99,3897,90,5191,9
25499,6,286,2431,244,3960,42
18296,0,47,2788,40,1988,7
5693,94,3076,3504,2328,30550,748
19258,16,520,2747,413,7419,107
6795,232,9031,3457,6331,46329,2700
9442,116,4173,3286,3324,23791,849
36146,2,169,1893,130,7160,39
28481,23,1430,2278,1022,12657,408
11887,25,1254,3161,1022,23541,232
4477,2,40,3564,34,3145,6
16635,3,201,2872,154,7539,47
40963,0,182,1570,131,4538,51
5224,19,430,3529,352,17196,78
19411,10,689,2739,450,13960,239
9231,9,253,3300,218,13077,35
28668,0,3,2267,3,1606,0
44385,6,162,855,108,6367,54
3111,36,4091,3601,3020,29449,1071
33114,153,7626,2047,5505,61709,2121
18670,7,645,2772,411,5811,234
4931,3,32,3545,25,1440,7
16163,3,152,2894,134,6265,18
13576,6,107,3050,82,2317,25
43230,38,1812,1129,1290,20804,522
42277,15,258,1358,195,3091,63
34715,1,62,1985,51,4182,11
13770,6,377,3035,315,4395,62
30933,80,3016,2152,2138,32503,878
26768,5,765,2373,635,11399,130
40939,45,891,1572,641,11477,250
15229,0,35,2936,29,2849,6
7009,433,12201,3446,8230,38847,3971
8030,2,22,3372,17,4433,5
43247,7,157,1124,149,10614,8
16823,56,4072,2860,3256,17916,816
13590,19,2945,3049,1791,13442,1154
45517,216,3629,536,2864,30908,765
36573,2,113,1871,88,4037,25
38025,5,336,1779,265,6630,71
28130,18,840,2299,669,7304,171
5998,5,160,3490,134,5497,26
15333,7,220,2931,168,4359,52
8690,17,652,3331,559,12966,93
28916,98,6880,2255,5170,17090,1710
12230,15,798,3143,643,6046,155
4178,148,7500,3575,5868,34326,1632
16755,31,1107,2864,775,6710,332
32401,27,844,2077,695,16416,149
32718,63,1748,2064,1370,11118,378
40304,168,4454,1632,3188,40881,1266
40171,38,634,1641,486,7353,148
30929,18,266,2152,221,3015,45
38259,9,705,1762,526,12006,179
40413,0,31,1620,25,7315,6
20064,15,760,2705,585,17100,175
26145,25,1120,2402,968,10266,152
20249,53,1367,2694,1065,11272,302
30988,32,1454,2150,1159,16308,295
37906,8,213,1785,172,3660,41
30817,6,81,2156,74,3495,7
41716,39,1380,1464,936,6875,444
30076,48,2555,2196,1991,22079,564
38102,16,581,1773,443,9662,138
12843,8,234,3108,192,12711,42
25853,5,460,2415,346,7516,114
16293,15,1220,2888,963,22000,257
30797,19,647,2157,522,14059,125
24553,1,296,2472,236,5570,60
44164,408,7400,889,5389,51611,2011
14795,23,993,2960,742,15169,251
40681,42,761,1596,598,8757,163
12610,12,468,3122,411,12753,57
22376,14,1742,2577,1361,14571,381
23361,46,806,2529,611,6748,195
22516,1,75,2569,60,3454,15
24375,7,505,2481,384,5735,121
9724,118,6315,3271,4588,49746,1727
3059,34,611,3602,435,6395,176
6355,3,226,3476,183,8856,43
45788,2,27,425,21,1708,6
41181,42,1500,1545,1114,19152,386
32190,0,46,2087,35,2269,11
15565,30,1858,2921,1447,17274,411
14472,37,2832,2983,2238,16507,594
30275,22,585,2186,493,12107,92
4820,384,25575,3551,19161,110215,6414
3087,15,1088,3601,861,24298,227
16058,9,560,2899,415,8070,145
25791,0,23,2417,18,3618,5
34499,11,518,1997,417,6467,101
16815,452,29944,2860,22039,142689,7905
17190,88,3482,2839,2470,28825,1012
42675,70,1523,1279,1219,13477,304
20212,155,19534,2697,14285,63484,5249
21402,87,1558,2629,1209,7812,349
31391,11,374,2129,318,7176,56
16499,197,12795,2878,10009,64696,2786
28186,127,4756,2295,3432,30560,1324
11798,2,73,3164,62,2919,11
7833,7,135,3396,111,5507,24
1911,10,348,3622,270,9328,78
8052,5,265,3371,192,3120,73
32518,3,122,2073,95,2591,27
45898,25,200,388,163,4382,37
31470,13,539,2125,444,9283,95
1708,1,14,3657,12,2634,2
22650,9,779,2563,587,8363,192
4877,30,1013,3548,853,11197,160
6721,2,96,3461,82,1904,14
35692,9,192,1926,152,2762,40
36855,5,275,1853,218,2102,57
8123,8,209,3369,85,6279,124
39681,177,9635,1671,7172,40289,2463
6776,24,2044,3458,1438,22582,606
39183,18,209,1701,174,4052,35
17358,42,1183,2830,878,11802,305
22861,10,608,2553,468,3150,140
24236,57,2191,2488,1727,20622,464
30997,3,51,2149,39,4304,12
2638,5,98,3609,71,9550,27
33055,1,118,2050,75,3985,43
1742,3,205,3645,168,4024,37
9306,8,639,3296,305,4634,334
38324,1,39,1757,34,3157,5
10935,944,47863,3209,33958,411585,13905
34844,34,2070,1977,1739,8696,331
26694,12,606,2376,492,9260,114
26114,41,1872,2403,1504,12209,368
8220,45,656,3363,516,11751,140
21877,36,3897,2603,2841,41076,1056
39771,40,1042,1667,792,10412,250
13720,144,7211,3039,5214,56562,1997
29520,3,291,2223,229,2413,62
18597,3,167,2776,138,11976,29
36380,1,110,1881,77,3413,33
40644,15,248,1599,191,5599,57
23487,366,18174,2522,13892,142860,4282
43852,1185,25915,940,20723,125226,5192
32818,19,557,2060,361,9666,196
34840,7,204,1977,156,6648,48
13518,49,3741,3054,2913,34863,828
25944,2,158,2410,126,4284,32
43199,3,190,1139,110,4748,80
21130,14,1982,2646,1266,16035,716
7211,7,305,3435,248,14919,57
37669,1,138,1803,101,11494,37
2295,2,48,3615,39,3943,9
36291,13,333,1885,258,6892,75
18899,1,212,2762,151,3843,61
20849,67,1221,2663,944,10200,277
8604,2,94,3337,81,6618,13
15998,150,46894,2902,32637,96803,14257
4072,510,15340,3579,11642,147682,3698
39036,164,4728,1710,3267,43469,1461
9717,33,1349,3272,971,11907,378
1207,13,419,3861,354,4382,65
8583,23,1224,3338,985,12769,239
2409,7,185,3613,155,13324,30
28936,7,320,2253,218,3364,102
24350,0,93,2482,70,2454,23
26001,38,4163,2408,2904,40854,1259
40154,21,684,1642,486,7854,198
9889,47,1820,3263,1443,34080,377
7733,68,2867,3404,2235,32432,632
10317,87,1702,3243,1350,37656,352
23308,15,643,2531,486,7757,157
35331,3,151,1951,121,4852,30
10472,10,1388,3235,1049,6131,339
19994,134,3397,2709,2501,20365,896
32439,6,349,2076,258,7124,91
42899,9,608,1225,420,9825,188
41445,5,117,1504,102,2954,15
42487,21,1476,1316,1020,18140,456
4229,70,2557,3574,1994,15258,563
30027,17,1035,2199,780,15096,255
21407,15,705,2629,529,5724,176
14201,7,169,3004,133,3603,36
8723,13,418,3330,347,18070,71
23202,153,11466,2536,7837,29057,3629
34949,133,4002,1971,2901,39452,1101
3530,28,711,3593,589,7595,122
45946,41,506,360,414,14627,92
6832,13,315,3455,271,8028,44
32794,64,4254,2061,3239,27604,1015
19152,1,59,2753,42,3387,17
2897,7,344,3605,254,8318,90
41912,5,382,1428,225,8466,157
33883,1,276,2019,199,3799,77
28512,34,1947,2276,1508,15103,439
43113,15,295,1163,205,4233,90
37740,24,1672,1798,1354,17311,318
34108,54,1312,2012,981,18400,331
26583,2,149,2382,130,3683,19
31530,80,1998,2121,1497,9751,501
4738,2,16,3554,13,1866,3
42760,106,2541,1258,2021,21928,520
22970,7,210,2547,161,4907,49
13846,1,81,3030,64,9277,17
35801,5,165,1917,132,4963,33
18671,0,133,2772,96,3238,37
26861,2,140,2368,122,14698,18
40856,55,1677,1578,1162,15582,515
3804,38,872,3587,673,11988,199
18585,41,1163,2777,942,11239,221
10628,18,282,3226,209,3731,73
40701,545,12086,1594,8595,108654,3491
30756,33,1078,2159,843,7443,235
45321,7,77,587,52,3254,25
4681,6,312,3557,249,14587,63
45401,72,697,565,499,7555,198
30105,22,2480,2195,1795,12660,685
2814,207,8332,3606,6515,91767,1817
6708,36,1589,3461,1152,28010,437
14822,211,5536,2958,4115,30898,1421
30249,3,296,2187,242,5173,54
24943,30,1111,2455,858,19281,253
27879,44,971,2313,783,9839,188
6313,10,101,3478,74,8458,27
35361,26,346,1950,284,4393,62
6729,111,4530,3461,3069,19886,1461
21377,7,418,2631,355,2632,63
30157,21,698,2193,585,12830,113
44659,212,1958,809,1593,13987,365
36790,6,134,1858,87,3697,47
40125,36,2206,1643,1674,18966,532
11963,34,991,3157,853,10177,138
33407,175,6905,2037,5154,46379,1751
42711,1,118,1271,97,8162,21
27728,7,300,2322,227,3397,73
27733,1,54,2321,45,1767,9
2441,16,543,3612,453,8626,90
19794,12,217,2720,108,8465,109
40920,3,315,1573,228,5742,87
17117,32,987,2843,734,7165,253
5930,129,10394,3493,7546,87426,2848
45407,32,275,563,215,4354,60
19108,3,175,2755,116,3776,59
39489,1,25,1682,20,1671,5
38438,335,6912,1749,5548,23897,1364
37207,14,284,1832,236,4767,48
2817,1,137,3606,71,5305,66
2867,30,2804,3605,1884,16898,920
12971,32,1306,3100,986,18289,320
35466,88,2092,1943,1617,19148,475
1412,2,39,3742,33,2818,6
45606,12,386,508,335,9005,51
33052,15,428,2050,342,7014,86
35049,16,605,1966,483,9917,122
37698,3,55,1801,47,3355,8
45348,15,163,580,122,5369,41
22191,0,26729,2586,19221,143979,7508
16470,8,598,2879,488,7847,110
9926,207,10910,3261,7892,71832,3018
9191,7,125,3302,82,5179,43
34879,174,13852,1975,8884,102943,4968
39089,7,131,1706,103,5423,28
19495,5,505,2735,408,19128,97
34703,4,110,1985,84,2471,26
43597,14,201,1013,166,4651,35
11189,701,28353,3195,22280,94696,6073
46264,37,319,241,263,3714,56
17768,0,168,2813,132,3051,36
18108,1,213,2797,176,3591,37
12537,3,56,3126,44,1609,12
27531,24,1194,2332,991,22886,203
4286,24,550,3571,410,5214,140
16048,10,381,2899,288,6255,93
38351,30,1496,1755,1179,11928,317
45377,12,108,573,73,2354,35
17137,47,2742,2842,2003,14289,739
32496,6,106,2074,81,2430,25
16979,1,103,2853,83,3966,20
46305,99,1556,223,1180,10688,376
18456,8,199,2782,163,2974,36
43586,11,210,1018,171,4616,39
9616,2,127,3275,111,4478,16
25786,16,509,2417,409,4045,100
43763,27,615,957,392,5535,223
4801,20,307,3552,213,12590,94
29778,32,735,2210,568,21363,167
15044,0,220,2946,190,6179,30
36083,14,241,1897,193,4226,48
42212,178,2842,1372,2108,35925,734
5220,39,813,3529,653,12830,160
14985,53,3447,2950,2428,17588,1019
23128,5,470,2540,385,5608,85
23733,35,1252,2510,1016,8956,236
41404,1,18,1510,16,3819,2
6955,8,245,3449,199,2303,46
35487,432,10396,1942,7597,61381,2799
7178,8,156,3436,124,5910,32
20538,6,459,2681,341,7931,118
30335,1,160,2182,122,4205,38
19779,10,406,2721,306,4099,100
8760,7,226,3327,183,3645,43
44277,4,104,872,88,6302,16
1046,5,128,3911,113,10392,15
37713,9,265,1800,223,7132,42
5362,4,82,3522,69,5395,13
33089,389,15224,2048,12022,91758,3202
21363,3,261,2631,194,4344,67
36776,4,157,1859,115,6304,42
31967,3,142,2099,119,4635,23
39627,67,1866,1674,1437,10150,429
16110,5,201,2896,164,2961,37
28231,19,740,2292,584,16846,156
16653,150,9821,2870,7285,57287,2536
2860,3,107,3606,88,4782,19
29800,7,324,2210,267,15995,57
29593,7,434,2220,385,10269,49
7683,4,691,3407,336,9321,355
45467,23,442,550,332,6462,110
27125,323,5833,2358,4038,36029,1795
42367,36,378,1341,264,4619,114
29448,46,1138,2226,818,17436,320
37601,1,100,1807,68,4868,32
20069,2,157,2705,120,9737,37
21589,0,153,2619,119,2691,34
36218,10,236,1889,208,8557,28
39980,37,763,1652,455,16153,308
19050,3,101,2757,83,1725,18
38494,2,226,1746,165,10507,61
35017,4,168,1968,124,8317,44
37816,92,4770,1792,3302,45522,1468
8828,12,873,3323,714,17653,159
21964,6,283,2597,199,3987,84
37253,63,712,1829,548,11751,164
13635,23,1949,3047,1504,22135,445
36336,129,8610,1883,6769,32884,1841
32468,2,106,2075,91,3177,15
10147,88,4506,3251,3515,39364,991
43202,5,202,1139,150,4493,52
37940,8,209,1783,169,3916,40
44203,15,222,880,181,4728,41
20314,13,464,2692,375,13191,89
28084,2,128,2301,110,7479,18
39636,77,1768,1674,1309,14102,459
10016,20,842,3257,662,8537,180
26684,59,6927,2377,5180,47245,1747
40019,1,22,1649,19,8141,3
10975,17,483,3207,368,6854,115
24602,36,1176,2469,873,5299,303
35574,38,1004,1936,845,11394,159
43356,113,1774,1092,1379,10742,395
10316,4,45,3243,38,2014,7
3006,2,107,3603,74,4466,33
13939,51,1730,3021,1215,13907,515
22100,20,320,2589,251,3832,69
36692,4,295,1864,227,4224,68
44954,87,1459,717,1301,14570,158
7049,4,105,3443,86,2288,19
29858,7,326,2206,172,2538,154
28237,18,796,2292,657,12810,139
10681,33,1208,3223,969,18426,239
15700,1,554,2914,433,6893,121
44152,3,61,892,42,2940,19
37076,7,146,1840,118,7045,28
27177,0,49,2355,41,961,8
4442,10,370,3566,291,8526,79
39224,34,425,1698,344,9442,81
7403,21,1124,3424,926,18456,198
27799,14,584,2316,478,3858,106
16458,3,111,2880,93,6019,18
11794,1,66,3164,50,3212,16
7395,68,2041,3424,1478,16478,563
32931,4,97,2055,67,2985,30
10870,445,21565,3213,14206,131882,7359
16340,6,412,2886,337,8988,75
45252,3,23,608,14,1358,9
36229,0,49,1889,42,2427,7
16921,4,321,2855,228,3557,93
9198,7,424,3302,321,4319,103
44758,27,445,775,325,6871,120
11162,577,33508,3196,26057,97170,7451
32230,5,201,2085,169,3758,32
9667,26,672,3273,498,5530,174
28104,2,96,2300,77,3708,19
16065,28,1147,2898,897,13534,250
3737,63,1423,3589,1101,6347,322
37735,19,299,1799,227,8566,72
9893,8,574,3263,458,13865,116
14678,0,68,2969,54,2538,14
12836,19,1075,3108,839,35731,236
13998,2,41,3016,35,4637,6
21818,36,1894,2607,1435,19222,459
2981,28,1549,3603,1205,15055,344
27732,27,683,2321,560,10793,123
28223,3011,156571,2293,123008,578499,33563
29799,6,265,2210,205,5733,60
25218,162,7860,2443,6132,39215,1728
27176,14,382,2355,316,2286,66
38525,17,447,1743,310,9360,137
42956,6,426,1209,308,6350,118
36780,10,192,1859,150,9105,42
16787,7,310,2861,250,4071,60
42261,178,4058,1362,2988,30109,1070
7975,4,225,3382,188,9956,37
7378,10,115,3425,71,6163,44
39098,234,11183,1706,8140,73028,3043
21647,4,105,2615,82,5668,23
28582,17,336,2271,273,5941,63
40885,2,59,1576,52,3096,7
8469,10,481,3346,339,4774,142
24105,40,2799,2493,2251,16564,548
42904,52,1621,1224,1091,16700,530
27952,113,1693,2308,1428,16364,265
45489,12,154,544,140,3756,14
36775,20,636,1859,504,7704,132
7552,17,343,3416,269,5567,74
8516,6,170,3343,110,10323,60
25812,8,272,2416,198,3329,74
22135,1167,47424,2588,36580,207361,10844
9587,11,360,3277,255,6563,105
46354,5,37,204,25,691,12
3179,88,3919,3600,2868,35815,1051
30922,44,1956,2152,1618,16184,338
30449,1,45,2175,37,2478,8
9738,6,225,3270,181,4705,44
5365,36,1396,3521,1148,12306,248
19102,27,708,2755,589,9136,119
7846,1,55,3395,46,2410,9
41139,13,431,1550,294,4516,137
12870,131,5032,3106,3455,38188,1577
35602,247,6373,1933,4269,47919,2104
37281,34,1728,1827,1401,6499,327
41539,205,6310,1492,4771,34755,1539
30078,2,168,2196,124,6384,44
7761,9,180,3402,142,2443,38
30899,4,139,2153,114,3805,25
10441,43,735,3237,564,25610,171
32642,12,262,2067,221,4324,41
31609,8,221,2117,175,6067,46
15914,228,8270,2907,5873,36672,2397
10741,3,194,3219,153,3367,41
18172,16,752,2794,593,7228,159
28810,9,230,2259,195,4346,35
39586,24,361,1677,298,6135,63
36694,11,220,1864,181,5088,39
46225,0,49,250,47,1616,2
4587,12,194,3560,149,3260,45
15655,1,64,2917,47,3349,17
14032,98,4209,3014,3269,16143,940
6911,4,138,3452,117,6910,21
5949,6,226,3492,179,4609,47
32500,398,15488,2074,11473,105250,4015
33736,46,1135,2024,896,13837,239
17261,4,74,2835,60,7404,14
29923,6,103,2203,82,2459,21
33292,35,294,2041,246,4727,48
42123,71,576,1392,420,6390,156
14211,3,116,3004,85,2713,31
11979,25,707,3156,561,4040,146
20832,14,426,2664,352,3977,74
15791,3,140,2910,108,2743,32
8225,32,1105,3362,870,10760,235
25785,5,268,2418,211,2530,57
38742,0,49,1728,35,1955,14
9754,92,14386,3270,10464,50263,3922
12561,48,2203,3124,1696,29115,507
23488,109,5331,2522,3950,49283,1381
10640,83,3189,3225,2546,24833,643
40680,28,652,1596,490,18833,162
45754,141,2726,437,2107,30218,619
21002,47,1472,2652,1170,18715,302
25204,156,4294,2443,3424,40276,870
43319,7,117,1104,104,6264,13
10229,11,486,3247,394,6484,92
15619,3019,191171,2918,114701,787126,76470
18995,11,724,2759,608,6781,116
29233,42,2653,2238,2037,14749,616
21017,3,466,2651,353,5793,113
30348,35,1717,2181,1452,8133,265
35569,9,349,1936,279,5613,70
4986,15,614,3543,441,8549,173
11497,43,2171,3179,1722,19420,449
9746,246,5407,3270,4006,20638,1401
17050,114,5156,2847,3406,18897,1750
3446,69,2427,3595,1842,19566,585
17918,4,411,2807,305,3413,106
15749,3,918,2912,624,14104,294
34633,9,263,1989,189,3675,74
6164,11,390,3484,325,9026,65
24089,4,166,2494,146,2247,20
22134,70,7905,2588,4725,65167,3180
35171,12,623,1960,520,10555,103
4629,19,549,3558,434,5821,115
40461,41,1109,1615,847,9444,262
24379,1,99,2481,69,2257,30
3205,17,636,3599,475,6470,161
23580,27,754,2518,574,5915,180
18351,7,306,2786,217,5962,89
30789,1,67,2158,53,3895,14
7838,1,49,3396,36,3522,13
19931,16,656,2713,569,9464,87
5890,71,1270,3495,1024,10350,246
19912,0,57,2714,44,2105,13
41827,9,462,1440,336,14932,126
39271,7,255,1694,196,5788,59
1820,12,306,3625,187,5987,119
39622,59,2028,1675,1576,26697,452
9333,802,27824,3293,20455,95780,7369
29346,1,63,2231,46,2492,17
9975,4,162,3259,138,4928,24
11133,17,1115,3199,817,19550,298
12800,0,165,3111,124,3902,41
3550,20,681,3593,561,14444,120
11468,5,154,3181,118,2670,36
4085,9,169,3578,130,5191,39
22425,19,706,2575,582,17412,124
27450,23,528,2338,413,12339,115
39012,24,849,1712,634,9466,215
15056,56,2021,2945,1461,12688,560
42833,5,574,1240,287,8815,287
18601,14,1284,2776,918,31547,366
10332,25,1165,3242,869,22425,296
27289,8,612,2348,498,7115,114
41496,21,1049,1497,742,17079,307
27278,0,570,2349,410,5640,160
45847,111,1254,405,1080,11224,174
29935,27,987,2202,778,8406,209
8277,423,14628,3359,10480,71024,4148
43662,32,735,990,590,9728,145
28901,3,185,2255,144,3722,41
13927,32,2433,3021,1469,15979,964
39265,22,733,1694,556,9895,177
7829,31,928,3397,752,11588,176
19033,44,4147,2758,2981,39824,1166
15890,10,486,2907,387,6730,99
2102,23,351,3618,289,13224,62
8203,37,868,3363,635,12075,233
23807,51,1144,2508,862,10073,282
32276,5,104,2083,92,2685,12
23926,116,7895,2501,6063,72543,1832
29680,138,3356,2215,2320,20323,1036
23039,11,396,2545,311,4139,85
30894,2,131,2153,101,7445,30
3263,17,419,3598,316,2714,103
6434,52,3512,3473,2868,27185,644
2291,99,3993,3615,3159,28491,834
34164,508,16188,2010,11144,108830,5044
16441,228,8800,2880,5874,36951,2926
6620,64,3959,3465,2546,59297,1413
45307,10,123,591,117,5108,6
46148,29,537,257,419,5972,118
24194,2593,95940,2489,61537,445041,34403
25910,14,626,2412,501,12794,125
27739,215,8771,2321,6847,48491,1924
33138,2,34,2046,29,2322,5
40952,1,172,1571,131,4459,41
3755,18,216,3588,174,5908,42
5198,713,25856,3530,18075,128371,7781
3455,51,3676,3594,2722,50962,954
15448,26,1614,2927,1238,10533,376
39410,4,93,1687,77,4487,16
5437,32,872,3518,713,21923,159
42292,10,440,1356,313,7185,127
15723,34,1635,2913,1238,15604,397
12939,491,29511,3103,20295,113473,9216
1829,92,3930,3624,2933,27389,997
6918,63,2824,3451,2023,26161,801
3147,29,1150,3600,889,14869,261
11742,44,902,3167,717,22077,185
8603,1,60,3337,53,5831,7
25375,0,22444,2437,15985,126773,6459
17538,3,220,2821,178,6982,42
13332,1,207,3069,171,5128,36
7734,131,7005,3404,5362,47511,1643
23053,3,280,2544,234,4810,46
36990,1,108,1846,97,3359,11
32122,50,2233,2090,1298,18117,935
29306,36,465,2234,366,3765,99
12379,13,556,3134,443,9339,113
5649,12,337,3507,283,18037,54
2603,28,768,3610,655,27977,113
40162,6,60,1641,43,4289,17
30170,5,293,2192,228,9873,65
19492,33,1526,2735,1149,6425,377
35163,26,753,1960,626,7475,127
17781,1354,105863,2813,65470,416223,40393
42478,5,128,1317,104,3021,24
14619,42,3807,2973,2789,68234,1018
42119,19,683,1393,489,9046,194
2367,9,125,3614,95,6879,30
18152,2,164,2795,127,2718,37
35278,64,2118,1953,1538,23163,580
13763,21,907,3035,751,10048,156
7732,6,82,3404,49,2449,33
8858,7,407,3322,331,7672,76
8836,89,3512,3323,2581,43861,931
35611,2,81,1932,57,2491,24
8880,85,3750,3321,2599,28585,1151
34771,2,70,1982,54,2769,16
12485,65,3310,3128,2608,30116,702
5417,7,317,3519,227,8271,90
10775,90,2571,3218,1958,31568,613
15779,2,54,2911,49,3998,5
22850,20,749,2553,604,10155,145
27551,1,23,2331,19,1025,4
13708,370,23151,3041,16356,163673,6795
3241,13,411,3598,288,12921,123
11357,49,126412,3187,40194,19510,86218
2758,67,2232,3607,1697,36553,535
16848,32,931,2859,709,5395,222
10910,62,1814,3210,1414,27987,400
15401,11,493,2929,384,9233,109
13006,91,3146,3098,2261,27910,885
25603,2,123,2426,95,6552,28
44794,23,200,764,180,5335,20
40068,7,543,1646,205,6179,338
24012,11,461,2497,368,4735,93
7594,20,652,3413,524,16880,128
40790,13,215,1586,170,2340,45
23104,16,740,2541,541,5200,199
26287,0,180,2395,145,6978,35
39549,8,114,1679,83,2696,31
36981,238,9076,1846,7069,72052,2007
32783,21,294,2062,234,3801,60
19533,225,9063,2734,6395,35036,2668
41347,0,97,1519,74,4069,23
8719,11,526,3330,432,12099,94
22456,120,5278,2573,3720,51935,1558
42812,58,1636,1244,1150,12335,486
2935,29,1531,3604,1195,35363,336
37846,6,78,1789,64,3307,14
20087,21,845,2704,516,12560,329
33090,1,223,2048,181,4023,42
10871,195,6997,3212,5522,117327,1475
46430,3,33,161,29,1441,4
28717,31,1229,2264,933,10786,296
3661,14,387,3590,327,12246,60
15072,2,143,2945,112,3074,31
12002,91,3728,3155,2836,13394,892
3599,16,540,3592,422,16273,118
17535,2,116,2822,77,6817,39
40506,35,982,1611,663,7722,319
41578,5,283,1487,204,6317,79
4009,10,481,3581,392,4961,89
9118,85,2309,3307,1622,17775,687
16945,4,0,2854,0,18079,0
3874,26,646,3585,531,6697,115
15296,11,383,2933,311,7187,72
36074,22,342,1897,270,5597,72
7319,340,16651,3429,11696,49473,4955
37452,27,1254,1817,1032,18570,222
22257,0,41325,2582,30173,154734,11152
8255,17,534,3360,405,24143,129
41107,38,324,1554,262,4404,62
43477,38,434,1056,350,9613,84
17345,1448,51309,2831,39384,132327,11925
34475,2,120,1998,94,4396,26
16760,2,0,2864,0,4218,0
40669,7,204,1597,147,5728,57
4950,12,670,3544,455,7477,215
15167,40,1723,2939,1368,13727,355
41155,2,86,1549,69,11572,17
16664,14,553,2870,448,7993,105
28522,5,192,2275,157,7792,35
43010,41,585,1193,409,8773,176
2528,103,4816,3611,3717,97878,1099
44750,4,84,777,52,2252,32
43320,35,470,1103,338,10283,132
43915,14,223,930,166,4076,57
22094,37,942,2589,739,5759,203
37426,28,446,1818,347,8228,99
2008,663,45370,3619,32840,199733,12530
12859,1325,61749,3107,42881,169536,18868
19266,9,739,2747,576,12542,163
36637,44,1413,1867,1152,12332,261
34124,0,25,2011,21,1392,4
7949,26,1002,3384,799,9335,203
25724,1,70,2420,63,4277,7
6347,16,284,3476,224,5337,60
40227,4,233,1636,181,6509,52
29044,0,145,2248,119,3078,26
21411,8,379,2629,312,9675,67
26343,2,1416,2393,1167,18956,249
2194,98,2322,3616,1395,12532,927
25690,30,1399,2422,1103,18148,296
35326,28,606,1951,513,5837,93
10346,10,170,3241,142,6588,28
4443,22,556,3565,436,4866,120
38196,83,2514,1767,1868,27603,646
26702,0,18794,2376,13619,88243,5175
18051,14,872,2799,710,22670,162
25217,10,478,2443,392,5902,86
3647,104,6835,3591,5222,33531,1613
33783,31,803,2022,556,4457,247
29120,268,6855,2244,5287,47920,1568
27514,1,36,2334,34,2519,2
28197,92,2898,2294,2087,23571,811
3472,4,34,3594,27,2900,7
10735,26,2323,3219,1743,23008,580
44828,265,3395,752,2766,34675,629
28482,31,602,2278,471,5654,131
31411,4,126,2128,104,3162,22
25586,5,235,2427,199,4197,36
8400,253,11114,3350,7141,225117,3973
11616,72,2488,3174,1945,15328,543
38764,8,271,1727,201,6266,70
4331,85,2318,3570,1714,12533,604
10150,490,24871,3250,17659,140552,7212
42693,39,413,1274,320,6718,93
31183,353,46838,2140,32775,129930,14063
29212,0,157,2239,125,3315,32
36193,0,101,1890,74,4098,27
38075,9,168,1775,151,3815,17
29454,11,245,2226,186,4801,59
28166,26,600,2296,474,6107,126
6568,37,3410,3467,2781,114660,629
5835,6,99,3498,85,5025,14
4332,2,220,3570,160,10788,60
39971,44,647,1653,501,13665,146
41051,11,306,1562,228,5869,78
6762,55,1195,3459,953,7380,242
9531,800,32601,3281,25454,124687,7147
30248,99,4192,2187,2604,18959,1588
2200,34,831,3616,629,5598,202
37829,13,391,1791,304,8209,87
33781,28,1149,2022,942,13672,207
45776,0,48,426,31,1291,17
42587,27,987,1297,722,8953,265
3040,8,297,3602,249,8479,48
21695,17,490,2612,364,3279,126
42498,7,385,1314,313,6819,72
15252,10,231,2935,174,4711,57
18679,8,508,2772,412,6040,96
43083,11,348,1172,228,7984,120
1116,5,264,3892,216,6378,48
20109,156,6092,2703,4187,19316,1905
5093,0,17,3536,10,1421,7
40553,3,146,1606,116,4041,30
19351,7,593,2743,468,13613,125
11664,34,1006,3171,852,6668,154
25123,54,1560,2447,1139,7808,421
41461,51,583,1502,444,7239,139
14806,42,1530,2959,1099,21882,431
12626,504,31331,3121,21167,129971,10164
40132,67,655,1643,463,5001,192
16987,11,619,2852,473,8637,146
13393,56,2579,3065,2113,33937,466
39969,21,1178,1653,927,12664,251
22369,14,457,2577,367,5428,90
37620,4,130,1806,106,5483,24
39501,3,80,1682,68,7785,12
29432,101,1585,2227,1165,10198,420
2220,62,3152,3616,2496,30504,656
28809,0,1868,2259,1529,32420,339
21235,33,932,2637,757,16953,175
39558,0,98,1679,53,3894,45
25403,3,285,2436,223,3999,62
9956,3,60,3260,51,4872,9
12652,10,504,3119,417,11273,87
15613,6,352,2918,248,10263,104
32145,25,2452,2089,1950,29759,502
30684,1,93,2162,77,2749,16
3658,31,991,3590,818,19737,173
21393,2,89,2630,77,3216,12
30221,5,205,2188,165,3634,40
31750,31,865,2109,717,12946,148
9810,7,231,3266,191,21881,40
11573,12,282,3176,195,18283,87
8697,42,3143,3331,2332,23018,811
18441,30,2305,2782,1374,23957,931
20481,10,671,2684,515,13158,156
21008,267,6203,2652,4497,29536,1706
34183,58,2751,2010,2053,23212,698
41128,1,40,1551,30,4839,10
29382,4,168,2229,143,8516,25
17640,3,239,2817,169,8755,70
12014,3,78,3154,64,5069,14
26403,4,75,2389,69,2746,6
35508,15,202,1940,167,2956,35
30119,64,1994,2194,1627,14208,367
34601,39,1426,1991,1178,16797,248
46113,7,165,294,134,2111,31
9607,5,355,3275,271,11635,84
46297,13,119,227,91,1976,28
17165,2,0,2840,0,58767,0
13180,25,1591,3079,1205,24167,386
35789,65,1291,1918,990,8406,301
3798,8,316,3588,240,5251,76
6216,45,2011,3483,1515,19952,496
20593,2,87,2678,54,2035,33
3160,77,2301,3600,1814,34864,487
24288,8,272,2485,211,2841,61
7018,43,1990,3445,1589,7147,401
9317,28,684,3295,505,16322,179
7698,378,23120,3406,16113,162289,7007
15019,18,381,2948,296,3230,85
30257,194,3799,2187,2614,23808,1185
6598,27,1509,3466,1105,30979,404
30340,1,53,2181,45,2238,8
36733,9,202,1862,161,5837,41
44071,5,99,905,69,3342,30
5648,24,669,3507,525,15432,144
21745,7,156,2610,136,3279,20
20408,5,147,2687,125,3149,22
22012,58,2662,2595,2066,11224,596
13769,9,566,3035,460,5840,106
16284,22,755,2888,590,33464,165
21788,1,125,2608,102,4816,23
42144,37,1061,1387,848,25904,213
40326,20,965,1629,723,8248,242
35842,1,61,1915,56,3037,5
5422,6,121,3519,102,4469,19
25287,1,71,2441,53,1582,18
45894,2,120,389,86,3789,34
40368,2,61,1623,47,10443,14
15962,9,378,2904,316,5284,62
30917,16,857,2153,639,6034,218
8480,117,3382,3345,2250,25392,1132
41800,26,377,1447,267,8628,110
44751,89,1604,776,1180,19557,424
29159,15,1083,2242,847,12448,236
26682,3,183,2377,131,4648,52
39497,26,308,1682,232,6233,76
17315,12,632,2833,483,14560,149
26042,0,112,2406,92,3180,20
18104,3,265,2797,217,3575,48
11679,1,80,3170,61,6236,19
18365,7,210,2785,166,10533,44
3045,11,461,3602,385,12583,76
32349,3,186,2079,154,4476,32
38898,30,722,1718,570,7796,152
42091,6,151,1398,103,3521,48
35940,4,86,1908,63,5976,23
21313,38,1575,2634,1164,29376,411
10804,8,400,3216,321,5996,79
6837,15,846,3455,633,15737,213
10464,20,727,3235,549,8796,178
37136,32,815,1837,639,6796,176
3105,2,73,3601,69,2657,4
40517,6,306,1610,228,6087,78
26824,16,636,2370,541,8433,95
16132,7,412,2895,340,3210,72
45908,7,107,384,85,1270,22
19165,17,1106,2752,845,10074,261
21259,10,1013,2636,796,8822,217
34755,30,778,1983,638,11555,140
26007,18,811,2407,660,5433,151
33639,12,373,2028,298,5323,75
36749,1,139,1861,108,2632,31
28440,1,212,2281,165,5929,47
25497,92,7938,2432,6208,53068,1730
29663,7,232,2216,188,3754,44
14564,11,320,2976,272,5382,48
2317,9,162,3614,139,8209,23
4954,252,15574,3544,11065,36988,4509
21503,12,320,2623,288,3964,32
3170,33,1602,3600,1161,20997,441
39740,4,122,1669,100,6300,22
43635,22,360,999,259,14513,101
37751,14,699,1797,544,11354,155
44297,14,286,870,219,7381,67
43620,27,475,1004,379,7481,96
17493,10,181,2824,146,8415,35
35887,19,363,1911,298,8368,65
33240,8,540,2043,454,9182,86
28704,106,1629,2265,1217,11715,412
22789,16,1283,2557,1029,12108,254
15806,4,105,2910,79,1617,26
38799,9,269,1725,205,11438,64
43177,6,469,1144,296,9189,173
13604,114,8346,3048,5670,60771,2676
44138,8,130,894,83,3782,47
9379,94,4671,3290,3251,30806,1420
2734,489,32181,3608,22549,150404,9632
23705,30,1551,2512,1098,23897,453
3204,20,804,3599,577,5497,227
8022,3,78,3379,65,2838,13
29817,3,256,2209,214,3780,42
18825,2,160,2765,135,4243,25
9631,3,67,3275,52,3130,15
42788,101,1655,1250,1199,28761,456
9390,8,164,3289,144,7436,20
16849,42,3060,2859,2227,22433,833
45779,4,88,426,80,2848,8
25054,0,8,2450,7,5173,1
12696,5,192,3117,162,4583,30
7798,4,197,3399,136,4343,61
5071,29,566,3538,379,5280,187
41966,28,359,1418,267,9602,92
25239,1,114,2442,93,6914,21
38453,28,1967,1748,1301,20235,666
5003,66,1935,3542,1550,21885,385
39655,2,74,1673,53,3889,21
30758,7,285,2159,230,3354,55
42137,83,1121,1389,835,14307,286
22980,380,24147,2546,17361,116949,6786
42307,15,488,1353,343,8695,145
40189,8,374,1640,256,6100,118
4251,9,328,3573,206,6881,122
40872,38,831,1577,633,20210,198
4561,47,1823,3561,1349,12603,474
2326,23,353,3614,306,6019,47
21533,29,1354,2622,1097,30532,257
43429,40,428,1068,350,10174,78
28030,0,829,2304,673,8069,156
3159,1,27,3600,20,2637,7
30102,0,51,2195,42,4997,9
38573,87,2785,1739,2138,28996,647
22189,8,724,2586,605,9288,119
2148,53,1324,3617,1040,9676,284
37557,1,25,1810,21,2826,4
45302,2,25,593,19,1586,6
24812,33,1870,2461,1562,17852,308
30355,265,19976,2181,13423,67780,6553
28981,19,878,2251,713,11128,165
37132,75,1488,1837,1045,43869,443
10499,63,1883,3234,1345,18377,538
5159,32,1341,3532,987,7761,354
2801,14,174,3606,142,6223,32
3410,66,6954,3595,5067,34851,1887
23602,7,264,2517,228,4030,36
36522,147,2248,1874,1764,15334,484
13286,10,781,3073,642,10436,139
16713,81,4109,2867,3406,13701,703
23701,4,225,2512,203,11240,22
35822,3,291,1916,214,4130,77
2882,75,3765,3605,2716,18077,1049
14637,26,1597,2972,1109,16162,488
10223,1293,59245,3247,42271,224706,16974
3849,228,9550,3586,7109,67396,2441
5018,37,689,3541,511,11930,178
8888,11,779,3320,608,9006,171
5794,18,639,3500,479,4401,160
31405,20,1102,2129,859,6275,243
13818,172,12491,3032,9268,142299,3223
32677,71,3208,2066,2498,17622,710
9536,31,2300,3280,1876,14038,424
20508,16,659,2682,525,9051,134
15004,2,300,2949,236,3512,64
14205,2,85,3004,73,3018,12
15574,5,217,2920,176,5273,41
13310,0,32,3071,27,6268,5
2643,9,97,3609,66,4373,31
18340,95,2908,2786,2390,13689,518
44890,7,92,736,64,3861,28
19350,2,370,2743,168,5374,202
5597,13,297,3510,233,3425,64
27490,16,598,2335,451,4786,147
12782,0,65,3112,34,3853,31
4109,874,38386,3578,24399,252424,13987
32076,15,452,2093,303,4956,149
45353,114,881,579,732,6704,149
13392,4,71,3065,59,3351,12
39499,18,352,1682,269,5831,83
38037,113,1149,1778,769,7687,380
17113,85,1656,2844,1255,18526,401
35897,124,7179,1911,5545,87992,1634
19339,29,1578,2743,1170,13253,408
24250,70,1822,2487,1459,12427,363
40589,4,71,1603,57,1598,14
31598,3,56,2118,44,2377,12
26219,700,28987,2398,22922,126979,6065
29177,0,42,2241,29,1516,13
15532,46,1996,2923,1602,28743,394
19399,42,6178,2740,4548,18396,1630
44128,57,483,895,339,3505,144
36576,26,256,1871,201,3752,55
17501,26,861,2824,631,21058,230
25517,65,1979,2431,1602,10464,377
5547,30,980,3513,746,18724,234
33465,10,584,2034,481,8182,103
35583,10,695,1934,430,7981,265
13370,760,41474,3067,28635,159591,12839
37266,0,6,1828,4,2719,2
41041,0,182,1563,131,3545,51
31577,0,105,2119,80,5289,25
23012,1,57,2545,51,1928,6
1208,4,91,3861,80,5565,11
12092,14,743,3151,604,11210,139
33861,14,379,2020,309,4024,70
34770,106,1057,1982,781,9181,276
40143,39,990,1643,770,12451,220
19817,14,1088,2718,895,30098,193
20396,14,597,2688,503,19301,94
45058,46,606,682,500,10452,106
39377,48,1633,1689,1276,19051,357
22357,22,2563,2578,1903,19637,660
27470,4,186,2337,151,7244,35
32859,12,1807,2058,1526,5458,281
3809,58,3843,3587,3132,55778,711
34808,7,324,1979,248,5107,76
14486,6,130,2982,67,9257,63
10909,3,30,3210,26,3340,4
7004,3,401,3446,337,16124,64
3073,106,10499,3601,7541,84738,2958
9461,11,334,3285,251,10367,83
10235,5,156,3246,119,5290,37
21548,0,66,2621,49,3784,17
38077,9,570,1775,399,9446,171
31834,0,113,2105,75,1700,38
27148,158,2978,2356,2263,16877,715
29433,54,687,2227,542,9244,145
22117,13,526,2588,401,8605,125
5349,16,516,3523,396,14471,120
27368,35,1755,2343,1423,10906,332
44774,3,50,769,42,2098,8
35570,151,10928,1936,8729,64248,2199
4023,1,49,3580,43,2674,6
18482,8,495,2780,393,5831,102
24086,15,687,2494,543,15827,144
46396,5,117,182,72,2542,45
28851,30,1955,2257,1601,10688,354
24396,2,103,2480,89,1543,14
45065,34,316,677,276,4640,40
42767,6,166,1257,126,7669,40
15144,11,391,2941,344,5497,47
30654,0,32,2164,25,3095,7
40283,97,2545,1632,1929,19992,616
5428,7,148,3518,124,4260,24
4908,7,258,3546,189,9518,69
7787,5,502,3400,337,4636,165
9455,35,771,3285,600,5934,171
31190,6,100,2139,84,2791,16
24844,5,276,2460,234,3453,42
21565,87,1211,2620,961,11382,250
17093,4,275,2845,237,4681,38
25299,5,504,2440,405,5446,99
14057,317,67396,3011,41458,117808,25938
11617,179,8097,3173,6173,100489,1924
12176,38,899,3146,683,13885,216
27365,22,1267,2343,964,7830,303
45705,38,402,457,333,4965,69
45481,3,46,546,32,3208,14
10828,20,1764,3215,1373,24197,391
15585,17,960,2919,746,12976,214
13210,18,779,3078,567,9936,212
30907,0,0,2153,0,10828,0
27563,26,608,2331,467,4408,141
36328,50,1526,1883,1185,12578,341
26813,8,219,2371,170,8086,49
8287,14,482,3358,378,7336,104
25347,25,713,2438,557,6658,156
33956,9,181,2017,132,3051,49
39052,59,1434,1709,1068,11411,366
33251,3,85,2043,66,5208,19
25255,19,1385,2442,1046,23297,339
43403,47,668,1076,452,7093,216
26680,27,1842,2377,1338,25683,504
24541,216,12001,2473,7853,55184,4148
45114,125,1478,651,1299,11576,179
41704,3,187,1466,145,5117,42
37275,71,2201,1828,1720,40651,481
11666,103,6496,3171,4544,23635,1952
44148,11,111,892,88,7929,23
40037,614,19365,1648,14544,118238,4821
5250,5,76,3528,62,2699,14
15381,30,1144,2930,838,8205,306
39459,9,347,1684,238,5370,109
6363,5,114,3476,102,2737,12
32107,9,284,2091,213,11717,71
25939,1,148,2411,115,5648,33
26328,86,8021,2394,4816,21155,3205
21242,0,23,2637,19,1314,4
2549,25,951,3610,671,8988,280
46153,11,181,275,158,1814,23
42394,17,567,1337,422,7098,145
45456,6,101,552,72,3118,29
11919,8,609,3159,505,21830,104
33447,187,2264,2035,1766,10269,498
33987,21,628,2016,507,13544,121
36738,25,805,1862,590,21535,215
19059,16,449,2757,313,3282,136
9771,12,561,3269,371,5608,190
10424,402,29719,3238,19558,102288,10161
24548,20,903,2473,653,10765,250
14521,138,5532,2979,4112,40723,1420
37619,10,304,1806,228,7185,76
15125,83,5090,2942,3456,44608,1634
34909,5,143,1973,118,3993,25
11304,133,4796,3190,3663,126246,1133
14809,30,678,2959,535,9951,143
27657,11,362,2325,172,2264,190
11509,0,88,3179,72,2023,16
32092,10,378,2092,297,8399,81
4487,27,676,3564,513,5263,163
33312,4,102,2041,82,2939,20
3167,30,632,3600,485,21894,147
35850,18,427,1914,319,4130,108
45849,5,79,404,55,1479,24
15373,14,1312,2930,1081,3213,231
16462,10,667,2879,493,14012,174
40499,1,42,1611,33,2509,9
21883,1,192,2603,151,3264,41
3822,22,562,3587,415,6504,147
39493,0,194,1682,150,3872,44
27771,20,1343,2319,954,18861,389
18107,8,298,2797,235,3992,63
5715,16,541,3504,457,25569,84
40325,91,3749,1630,2249,94859,1500
33175,32,543,2045,426,4694,117
20641,130,3555,2676,2667,22525,888
35669,306,15184,1927,11311,106004,3873
18316,7,92,2787,74,10676,18
18128,187,8158,2796,6374,60166,1784
15601,25,806,2919,590,4157,216
38283,5,211,1760,137,5880,74
35523,13,611,1939,499,15705,112
30808,3,72,2157,58,2770,14
46270,1,8,238,8,1124,0
37978,4,189,1780,132,3088,57
2415,810,44070,3613,30725,247654,13345
42905,16,308,1224,222,5198,86
29970,5,565,2201,416,9950,149
1472,3,46,3712,39,2388,7
23629,9,405,2515,314,4099,91
7281,2,117,3431,92,1597,25
12536,238,14030,3126,9757,160414,4273
2688,4,58,3608,47,2177,11
23111,50,2378,2540,1736,25007,642
27336,1,150,2345,133,5022,17
34672,0,42,1987,33,2654,9
44046,71,886,909,709,46411,177
21623,4,308,2616,244,4178,64
29271,3,92,2236,73,1979,19
17760,5,221,2813,169,4064,52
41069,12,254,1559,211,4999,43
41224,17,396,1539,313,7908,83
11164,608,23280,3196,18431,73739,4849
41646,128,2566,1475,1996,20139,570
13930,10,267,3021,230,2473,37
37736,39,1525,1798,1202,18228,323
28361,16,270,2285,228,5755,42
31670,7,286,2113,232,8396,54
36159,100,4788,1892,3584,32693,1204
41197,8,142,1544,119,2921,23
2713,2,74,3608,61,8110,13
15706,12,820,2914,622,3512,198
25833,37,1557,2416,1213,25051,344
25272,24,1525,2441,1178,24246,347
10311,10,458,3243,366,7931,92
10077,44,1362,3253,1077,17976,285
42405,28,491,1335,387,8678,104
39091,31,793,1706,628,17739,165
21362,1,89,2631,80,3219,9
14194,1,142,3004,113,5344,29
3872,4,94,3585,68,4432,26
5530,26,215,3514,173,6229,42
6592,37,635,3466,476,15634,159
7271,55,4328,3432,3220,86582,1108
33438,133,3698,2036,2899,30451,799
41422,60,1039,1508,744,13906,295
26409,20,453,2389,346,4115,107
34298,2,98,2006,84,2944,14
25854,2,37,2415,28,2172,9
41158,139,3508,1549,2531,39186,977
38052,13,368,1777,301,14350,67
36580,6,163,1871,139,9028,24
43038,3,46,1186,43,3762,3
4205,243,11061,3574,8798,72751,2263
28257,3,277,2291,237,5458,40
39359,20,396,1689,300,4145,96
19626,36,1060,2730,741,6876,319
17090,40,896,2845,656,6783,240
7943,18,379,3385,321,8358,58
3939,25,1180,3584,798,13994,382
36661,17,779,1866,580,6225,199
6407,12,164,3474,129,2384,35
18354,14,859,2785,694,7657,165
32413,600,27513,2077,19980,151403,7533
10489,14,199,3234,156,2909,43
14835,14,1429,2958,1015,7225,414
10624,2,111,3226,89,3834,22
33990,47,1097,2015,901,10717,196
5021,16,547,3541,386,7920,161
21762,11,914,2609,703,10407,211
40502,42,1163,1611,939,17556,224
27110,237,12878,2359,9206,98773,3672
34158,46,1026,2011,780,17083,246
12221,62,2387,3144,1721,23114,666
19764,32,2712,2722,1862,17896,850
11752,3,108,3166,87,4211,21
14507,15,1104,2981,778,18048,326
4779,13,465,3553,354,4515,111
2521,9,239,3611,198,6029,41
32199,13,338,2086,219,8497,119
3563,14,501,3592,430,12151,71
23814,17,546,2507,465,4216,81
13174,67,1706,3079,1344,18276,362
28158,13,478,2297,387,7663,91
22340,4,745,2578,538,3267,207
16171,31,1273,2894,962,15736,311
11199,11,582,3194,462,10828,120
7236,2,109,3434,94,3754,15
18907,57,4383,2762,3369,24946,1014
44755,13,66,776,60,5559,6
31361,44,3386,2131,2626,25700,760
22499,55,2561,2570,2063,39912,498
9515,81,3188,3281,1726,11755,1462
6815,5,156,3456,117,3453,39
25806,0,878,2417,678,13286,200
12378,1,43,3134,39,2671,4
5546,33,758,3513,585,8957,173
11265,217,6690,3191,5020,81382,1670
12839,50,5184,3108,4062,62826,1122
25078,1882,66021,2449,48436,262889,17585
41871,30,682,1434,585,10245,97
19389,19,696,2741,527,15703,169
27807,28,3657,2316,2860,44328,797
2115,84,1798,3618,1268,10107,530
35749,0,4699,1922,3470,34935,1229
7839,8,74,3396,61,3033,13
14022,10,317,3014,250,19174,67
13443,111,11145,3060,8459,40207,2686
23556,4,0,2519,0,2901,0
29016,25,1194,2249,983,15982,211
7069,30,845,3442,601,10675,244
11945,36,669,3158,546,8744,123
13848,65,4715,3030,3470,37833,1245
45767,38,683,430,547,6975,136
8028,65,1122,3372,782,12071,340
19774,7,354,2721,295,5886,59
35943,50,453,1908,348,4073,105
9897,78,1394,3263,1113,13941,281
33521,24,894,2032,689,5113,205
43669,0,21,988,17,1823,4
23888,8,343,2504,275,5579,68
7021,32,1467,3445,1131,21495,336
34948,10,520,1971,395,10104,125
38105,27,1746,1772,1342,19346,404
30937,3,56,2152,43,1808,13
6924,68,2484,3451,1807,32504,677
25531,44,824,2430,613,8336,211
23366,73,3328,2528,2474,13752,854
2070,42,1639,3618,1363,31468,276
18335,7,380,2786,279,5698,101
5256,121,4391,3527,3448,47728,943
30835,2,62,2155,51,2055,11
13039,16,397,3096,332,8940,65
2943,67,2201,3604,1797,87151,404
4616,31,551,3559,392,13944,159
10383,278,22234,3240,16060,42394,6174
37300,8,215,1826,165,8194,50
20627,5,491,2676,399,5986,92
39694,10,302,1671,228,5320,74
17260,12,798,2835,608,6049,190
20277,36,1205,2693,927,12062,278
38743,51,1749,1728,1271,20347,478
35190,2,133,1959,98,11313,35
17903,159,11802,2808,8928,96101,2874
30742,5,160,2159,142,4089,18
3726,52,1702,3589,1082,11252,620
24726,43,3357,2464,2366,25018,991
28899,23,1719,2255,1377,10234,342
35587,73,797,1934,623,7361,174
27760,7,161,2320,138,3856,23
25689,0,9927,2422,7352,38895,2575
29924,15,260,2203,225,4022,35
33548,5,587,2031,485,23202,102
36432,11,342,1879,268,7271,74
21820,15,285,2606,242,8440,43
22695,79,3793,2561,2649,30550,1144
16135,213,17281,2895,12375,112272,4906
14992,5,186,2949,139,3230,47
30191,22,1175,2190,899,12280,276
6158,4,230,3485,194,7754,36
42154,3,105,1384,78,4866,27
35043,56,1553,1967,1342,13725,211
14209,2,265,3004,209,7719,56
42077,88,2528,1400,1907,36693,621
24705,23,844,2464,676,6609,168
4436,59,1844,3566,1339,16921,505
9805,7,436,3266,339,7230,97
2172,65,1940,3617,1455,29212,485
27195,3,119,2354,105,1840,14
14604,4,79,2974,56,4065,23
28760,1,57,2261,33,3515,24
37071,0,115,1841,91,4144,24
16813,10,312,2860,243,5811,69
45727,20,183,444,165,3888,18
44259,11,226,873,163,4266,63
33934,51,2131,2018,1724,16348,407
15810,11,507,2910,429,8380,78
15441,29,1177,2927,898,8280,279
27171,123,2238,2355,1647,10860,591
25243,30,1057,2442,873,14129,184
39496,6,422,1682,320,8927,102
1986,6,97,3620,87,3081,10
5392,379,11598,3520,9093,50673,2505
3359,58,1891,3596,1392,23761,499
7078,5,517,3442,394,7577,123
12744,0,18,3114,11,1329,7
36838,2,105,1854,90,3798,15
38944,42,1283,1716,1030,24554,253
34141,44,1940,2011,1522,16728,418
31528,59,3435,2121,2775,31137,660
39320,3,70,1691,42,3452,28
7327,967,37395,3428,25210,169938,12185
2951,129,6242,3604,4473,138990,1769
35832,9,432,1915,356,8198,76
9750,3,199,3270,150,2237,49
11856,4,72,3162,50,2359,22
42687,11,190,1274,146,5365,44
33319,49,2025,2040,1724,16118,301
43719,15,93,971,80,2391,13
14373,16,661,2990,541,12274,120
22978,5,418,2546,299,8873,119
24415,123,4323,2479,3273,30256,1050
8033,492,20352,3372,14220,50168,6132
41866,154,3943,1435,2981,48585,962
29882,34,1665,2205,1306,18913,359
38307,2,160,1758,127,4498,33
44901,29,363,732,281,3548,82
11718,3,118,3168,84,11869,34
33718,3,128,2025,109,4300,19
44076,169,3009,905,2163,24100,846
12377,4,246,3134,168,2559,78
11658,16,623,3171,486,13326,137
23306,34,2173,2531,1594,28173,579
31064,37,760,2146,634,9526,126
12493,0,26,3127,22,1553,4
36261,516,31459,1887,23043,148221,8416
15817,5,591,2910,490,13161,101
45664,0,134,478,83,2698,51
6840,3,74,3455,62,4095,12
22196,26,1181,2585,925,15419,256
20810,38,1651,2665,1249,16049,402
13239,12,1149,3076,845,5309,304
20762,192,11877,2669,6540,57317,5337
45457,5,52,552,40,3279,12
26509,1,91,2385,77,6707,14
46436,14,209,159,149,1604,60
40754,111,3228,1589,2296,38443,932
46238,1,9,246,8,549,1
15586,22,1656,2919,1267,21527,389
24338,38,3186,2483,1986,10781,1200
14484,0,126,2982,102,4456,24
17512,1,44,2823,31,2306,13
38756,174,4314,1727,3416,34292,898
25870,82,2809,2414,2351,19282,458
1560,5,150,3687,122,2870,28
18892,1,171,2763,120,7356,51
34586,65,1302,1992,993,28267,309
12146,323,11298,3147,7028,42208,4270
3173,1,159,3600,125,4461,34
37344,20,896,1824,746,11148,150
14929,124,27247,2953,18695,79717,8552
3743,270,9064,3589,6954,160914,2110
37508,8,279,1813,229,7395,50
36795,49,1161,1858,886,13072,275
36688,28,839,1865,684,9267,155
42499,5,161,1314,115,3275,46
13677,55,4402,3043,3311,38294,1091
20391,1,82,2689,64,1990,18
15645,18,743,2917,567,10997,176
18024,1,64,2800,55,4183,9
41369,166,4950,1516,3531,26673,1419
13308,26,515,3071,421,10445,94
26914,9,524,2366,427,9657,97
42815,3,56,1244,47,1975,9
37106,13,438,1839,354,7331,84
37142,55,1303,1837,1044,13452,259
1897,23,462,3622,380,11312,82
13890,21,1012,3025,616,9754,396
2287,49,1539,3615,1225,21216,314
44465,26,406,845,273,8529,133
13045,44,1296,3095,1022,7916,274
15340,100,5555,2931,3918,25086,1637
19036,1,307,2758,254,5231,53
25205,1,33,2443,29,5038,4
42288,8,250,1357,181,6090,69
9347,8,164,3292,138,3528,26
36730,100,3259,1863,2568,19075,691
9288,15,593,3297,446,5869,147
42758,19,407,1258,292,5361,115
3226,21,391,3599,304,8094,87
38246,6,135,1762,106,3702,29
10329,43,649,3242,492,10423,157
13245,3,137,3076,108,3553,29
8408,16,276,3350,220,6700,56
45477,8,140,547,122,3971,18
27930,2,80,2309,66,2205,14
2567,37,3063,3610,2243,19561,820
16831,6,1141,2860,895,49196,246
11036,11,64,3204,48,4803,16
22247,57,2512,2582,2021,24036,491
33517,3,68,2032,59,2502,9
43980,17,333,920,258,9143,75
36559,1,85,1872,57,2675,28
13014,19,901,3097,666,18241,235
21726,147,16702,2611,12087,73673,4615
6983,46,662,3447,485,7133,177
2163,36,1405,3617,1115,11710,290
44768,3,47,772,21,1865,26
9807,89,6001,3266,4681,48741,1320
36473,1,54,1877,37,3096,17
10516,4,58,3233,47,3631,11
35354,4,82,1950,71,2025,11
15628,26,1350,2918,1084,11646,266
15607,75,5038,2918,3944,145730,1094
28492,68,2110,2278,1368,12436,742
21218,4,167,2638,136,8615,31
20046,118,6119,2706,4596,33839,1523
27066,7,211,2361,168,4070,43
19145,16,392,2753,309,6182,83
44979,16,166,710,155,3681,11
15460,24,4468,2927,3130,13906,1338
36902,73,1255,1851,969,9582,286
5460,26,363,3517,288,7005,75
27345,1,165,2344,135,3911,30
28419,1,37,2282,32,3245,5
30782,6,400,2158,285,11538,115
12015,14,751,3154,559,9251,192
14348,21,1298,2992,920,10439,378
19468,317,21092,2737,15032,114249,6060
34831,22,447,1977,356,8398,91
18942,50,1988,2761,1587,8142,401
6112,9,590,3486,459,12453,131
27105,5,173,2360,145,10444,28
16985,39,2428,2852,1879,24551,549
36348,29,397,1882,324,5301,73
36960,9,293,1847,238,3903,55
5787,18,603,3501,425,6012,178
34528,27,2055,1995,1576,19376,479
29840,19,546,2208,459,5375,87
2467,29,594,3612,503,67930,91
32214,1,63,2086,53,5272,10
22044,11,965,2593,712,14169,253
10876,39,1151,3212,904,18361,247
6623,908,35705,3465,25341,216255,10364
30998,4,199,2149,151,7953,48
25026,5,40,2452,32,2058,8
6998,30,892,3447,672,10234,220
6118,10,200,3486,159,4302,41
21009,13,508,2652,397,9196,111
42535,23,627,1307,407,7210,220
26776,2,36,2373,35,3437,1
3251,27,1129,3598,889,6233,240
25723,2,245,2420,190,3335,55
22595,408,25228,2566,16166,161056,9062
44935,4,19,724,15,1446,4
2444,11,372,3612,301,6310,71
5321,49,1411,3524,1088,26194,323
3206,29,1821,3599,1458,9275,363
35493,2,122,1942,103,3609,19
30343,2,132,2181,93,2375,39
3613,2,62,3591,53,4203,9
27293,4,217,2348,176,5867,41
29787,20,1224,2210,977,12914,247
9678,24,977,3273,758,15436,219
4074,37,3055,3579,2311,22275,744
38673,4,362,1733,275,6948,87
23650,5,394,2514,282,6884,112
36932,20,1287,1849,917,12129,370
5246,61,3465,3528,2746,51219,719
15573,7,358,2920,261,9500,97
23152,2,114,2539,81,4295,33
9928,21,426,3261,334,14304,92
12331,688,47212,3137,29549,111019,17663
33602,18,558,2029,451,9475,107
30045,4,173,2198,138,3286,35
30827,119,24156,2156,20022,70063,4134
2397,16,713,3613,563,25377,150
13910,25,1792,3023,1473,16082,319
13853,615,17399,3029,11799,118861,5600
43087,18,322,1169,258,8248,64
27160,96,6458,2356,4317,44955,2141
42420,41,1140,1330,826,10412,314
9816,6,226,3266,166,8062,60
8670,2,103,3333,87,2515,16
8247,10,433,3361,339,10746,94
9016,31,1278,3314,1070,20037,208
42316,40,814,1352,609,13839,205
38858,96,3199,1721,2181,34281,1018
40254,0,79,1634,65,8620,14
5721,14,362,3503,274,5793,88
11928,8,378,3158,308,3942,70
7315,111,4368,3429,2790,13881,1578
27805,62,2923,2316,2069,49409,854
19948,49,1233,2712,995,11127,238
19206,2,169,2750,131,7210,38
43067,20,680,1177,539,11617,141
19264,49,3523,2747,2746,28833,777
37746,29,2373,1797,1706,21799,667
27216,9,263,2353,218,4845,45
34176,16,210,2010,170,2162,40
15781,3759,134685,2911,96394,375176,38291
17603,57,3120,2819,2209,10879,911
27185,25,332,2354,265,4013,67
6288,29,666,3479,521,7525,145
10814,8,358,3215,292,10088,66
3238,21,420,3598,324,6976,96
19755,58,3674,2722,2839,29032,835
32831,7,303,2059,206,5044,97
12549,3,88,3126,57,7725,31
2489,18,320,3611,271,10317,49
43606,0,18,1008,14,2896,4
12935,63,2748,3103,2070,27267,678
25504,0,306,2431,226,3976,80
1454,9,288,3721,234,4112,54
24468,5,266,2477,217,3146,49
11530,16,287,3177,220,2963,67
28832,60,1152,2258,936,7191,216
4867,4,118,3549,102,6544,16
4811,7,68,3551,60,6174,8
6085,23,790,3487,578,7166,212
31434,12,222,2127,178,7684,44
46324,0,4,214,4,848,0
1665,3,142,3663,126,4895,16
36566,112,2331,1872,1856,17862,475
24622,55,1181,2468,882,4676,299
15180,3,124,2939,100,4664,24
44999,3,36,704,24,3119,12
12347,43,3205,3136,2637,22995,568
23369,18,618,2528,512,14063,106
20505,0,84,2683,69,2492,15
28145,0,72,2298,57,4119,15
16128,6,515,2895,417,10292,98
21560,48,1989,2621,1698,23420,291
22689,19,1369,2561,896,19736,473
42178,102,2685,1379,1970,45536,715
36217,12,861,1889,641,8864,220
17914,55,3928,2807,2958,24413,970
32060,142,6120,2094,4880,33863,1240
35617,1,35,1932,27,3826,8
12091,9,757,3151,578,3802,179
46466,0,22,142,22,716,0
10156,22,800,3250,642,9353,158
6886,444,18423,3453,13717,171816,4706
25730,5,130,2420,101,2622,29
26816,38,3790,2370,2769,19320,1021
36770,100,3071,1860,2433,23071,638
11463,17,1422,3181,1111,15662,311
15797,11,806,2910,579,5975,227
17733,0,94,2814,75,4070,19
8061,1,54,3371,46,2152,8
15082,20,569,2944,445,13123,124
5934,11,328,3493,270,4582,58
26478,155,5076,2386,3806,42704,1270
42829,14,331,1240,230,7900,101
26909,2,164,2366,134,2039,30
1658,13,531,3665,442,4342,89
18144,0,95,2795,82,2794,13
25112,9,628,2447,483,12287,145
39168,1,84,1702,67,2744,17
38554,16,417,1740,337,5765,80
40035,33,832,1648,635,14092,197
39173,23,1269,1701,951,12236,318
13980,7,877,3017,673,22271,204
40976,1,54,1569,41,3469,13
41881,33,566,1432,391,16162,175
2120,2,78,3618,63,3269,15
40636,1,35,1600,32,2482,3
33939,1,91,2018,77,5017,14
42182,21,1079,1378,763,16228,316
4161,50,1875,3576,1383,17376,492
33933,58,9916,2018,7232,54143,2684
9687,2,82,3273,72,3779,10
12659,249,84469,3119,29753,120455,54716
20619,8,981,2677,821,12748,160
34378,0,0,2002,0,8347,0
36668,0,49,1865,40,3221,9
19126,5,829,2754,640,11453,189
18067,28,956,2798,716,11412,240
45355,15,233,579,119,3837,114
14021,0,157,3014,112,9407,45
41976,1,69,1417,56,8298,13
36736,67,2327,1862,1883,14309,444
3994,110,2506,3581,1725,17396,781
35803,12,286,1917,219,4388,67
39149,80,3681,1702,2835,26135,846
37372,143,3284,1822,2551,23854,733
42634,34,355,1289,278,7705,77
27277,0,46,2349,34,3951,12
5544,3,26,3513,18,1673,8
7873,4,77,3392,59,4651,18
4277,91,2817,3572,2075,16896,742
45447,8,117,554,90,1779,27
21705,379,16713,2612,12170,46338,4543
42423,136,3379,1330,2404,14234,975
14320,26,809,2994,621,21110,188
40882,447,6316,1576,4925,45690,1391
29293,0,41,2235,29,3757,12
22240,0,743,2583,582,10840,161
26775,46,1170,2373,917,11083,253
25321,7,143,2439,123,4094,20
45063,22,277,677,241,6117,36
30730,44,1463,2160,1025,8066,438
2856,23,926,3606,771,18781,155
35115,51,952,1963,717,7821,235
5839,0,56,3497,46,2178,10
32454,7,408,2076,314,4489,94
37717,26,308,1800,189,3067,119
29082,4,313,2245,251,8963,62
27818,64,1599,2316,1201,14723,398
38928,123,2327,1717,1857,20517,470
33101,21,804,2048,646,9123,158
25901,83,3915,2413,3121,19282,794
16588,6,233,2874,187,2709,46
34984,3,143,1970,117,3331,26
38330,31,6311,1757,4942,8230,1369
36641,1,34,1867,28,5654,6
26198,0,36,2399,29,1756,7
2493,23,744,3611,521,15351,223
12793,2,110,3111,82,8929,28
16662,96,10528,2870,7733,43844,2795
41260,23,715,1532,548,21179,167
43024,2,98,1191,64,5489,34
31446,3,147,2126,117,3603,30
13257,23,76179,3075,21863,25274,54316
21138,14,297,2645,245,7511,52
15713,31,2590,2914,2015,13383,575
25105,0,10,2448,10,5030,0
3409,5604,213274,3595,145715,638212,67559
38724,5,125,1729,99,7396,26
4808,57,1690,3551,1387,27264,303
15796,1,40,2910,35,2704,5
46182,8,110,261,58,2573,52
4372,78,2351,3568,1749,15591,602
32004,11,482,2097,375,6653,107
18522,154,6894,2779,5287,52947,1607
41683,102,867,1470,693,13329,174
25459,0,1059,2433,798,15584,261
45394,15,225,568,159,3843,66
40510,4,58,1610,45,5005,13
22062,63,2065,2592,1571,12286,494
40386,440,21106,1622,14194,130435,6912
28563,70,2164,2272,1324,20991,840
13388,100,4968,3065,3511,43147,1457
29006,3,128,2250,113,15347,15
19545,5,600,2734,487,5333,113
35287,18,491,1953,386,4279,105
11768,3,460,3165,378,17389,82
43705,8,112,975,96,2569,16
24580,69,2049,2471,1561,12952,488
12722,366,23897,3115,17133,160784,6764
18231,18,866,2791,616,9488,250
25773,9,615,2418,499,14095,116
9758,14,488,3270,389,6552,99
12217,3,13,3144,10,1571,3
26026,1,179,2407,149,6011,30
20826,7,831,2664,663,13442,168
31209,7,323,2139,250,6706,73
27459,25,1263,2337,972,14174,291
16181,11,1398,2893,1190,31595,208
5470,24,557,3517,471,12042,86
27731,39,1509,2321,1201,12304,308
14255,97,1911,3000,1370,16280,541
38548,8,314,1741,241,8763,73
31214,49,3582,2139,2533,18907,1049
8976,6,231,3315,179,4805,52
7650,0,23,3409,21,2560,2
16087,71,3386,2897,1860,16187,1526
4252,51,1052,3573,856,13301,196
5606,7,356,3510,229,6588,127
16869,83,2034,2858,1651,10865,383
25583,0,98,2427,85,3368,13
27665,36,1608,2325,1232,10348,376
15436,66,4363,2928,3324,38988,1039
29963,60,1106,2202,866,11974,240
25951,20,467,2410,382,8090,85
17276,0,55,2834,37,2944,18
37369,28,1274,1822,884,13939,390
11531,118,3836,3177,2818,19818,1018
11576,2,151,3175,119,9369,32
33787,48,1376,2022,1051,9661,325
37422,9,287,1819,241,12097,46
33351,4,170,2039,141,4729,29
9996,18,313,3258,228,4983,85
5921,90,3523,3493,2631,13760,892
1869,273,11182,3623,7532,45998,3650
1996,6,126,3620,107,4133,19
21747,3,869,2610,631,17005,238
19048,0,42,2757,39,2136,3
6916,5,637,3452,466,16432,171
39587,8,237,1676,192,4813,45
18406,11,644,2784,522,9826,122
8472,24,506,3346,406,2593,100
40279,442,14454,1633,10626,75160,3828
40400,12,363,1621,292,6193,71
18621,6,264,2774,215,5964,49
22949,657,34675,2548,23923,220043,10752
9208,261,10802,3301,7867,41535,2935
40281,7,166,1633,137,2517,29
17258,8,606,2835,502,12270,104
30780,2,107,2158,84,3174,23
21817,2,78,2607,58,2317,20
38802,1,73,1724,55,2461,18
7584,7,158,3413,126,12837,32
38778,123,1165,1726,960,11416,205
7933,10,567,3386,455,9372,112
28081,2,255,2301,192,5943,63
18544,36,1162,2778,922,21549,240
15872,7,293,2908,208,7302,85
45103,34,683,657,573,7767,110
42688,10,242,1274,168,10588,74
7970,2,117,3382,76,4503,41
45168,3,43,633,20,2692,23
20855,2,150,2663,104,7195,46
21697,12,265,2612,239,6130,26
7730,16,1290,3404,1010,20036,280
32318,12,610,2081,455,7607,155
24964,6,464,2454,372,9300,92
33780,32,1089,2022,847,12014,242
40786,11,440,1586,325,6998,115
45392,1,29,568,26,1417,3
39903,3,261,1657,180,4563,81
31407,0,49,2129,39,6609,10
3821,685,38356,3587,25788,285960,12568
5913,24,432,3494,360,9643,72
20465,3,270,2685,230,5007,40
12920,1,59,3104,44,2235,15
26400,20,515,2389,421,10624,94
34782,0,83,1981,66,4761,17
40775,14,331,1587,239,6509,92
36232,21,551,1889,436,2912,115
11056,749,26764,3203,19324,145550,7440
42300,290,5661,1355,3850,63687,1811
7435,15,521,3422,415,8875,106
46248,5,133,245,101,1568,32
14377,87,7867,2990,5833,56302,2034
9324,186,7769,3294,5652,52281,2117
13012,1650,82293,3098,52881,220664,29412
33646,7,562,2028,433,9472,129
20991,11,907,2653,762,13390,145
41732,92,4952,1461,3661,28132,1291
2085,11,356,3618,255,39467,101
38893,8,192,1719,154,3839,38
32750,81,3394,2063,2533,15007,861
1469,2,45,3713,36,1744,9
2890,10,291,3605,246,14752,45
14307,25,1334,2995,1021,30243,313
32904,3,158,2056,141,6151,17
24009,4,218,2497,184,8103,34
17354,7,458,2831,358,4059,100
4755,19,575,3554,445,14910,130
36327,19,602,1884,472,7606,130
17811,199,22715,2811,14994,71961,7721
37919,2,79,1784,52,6026,27
28997,5,445,2250,339,9597,106
11434,829,43883,3183,32568,145373,11315
4351,70,3068,3569,2323,45353,745
41025,29,498,1566,373,9061,125
14063,5,382,3011,214,8863,168
45521,231,2441,534,1955,16849,486
30382,5,136,2179,110,2288,26
7627,22,953,3411,715,15784,238
27128,27,840,2357,662,6020,178
18761,95,16448,2768,11555,211071,4893
45622,48,605,496,484,9471,121
41891,4,189,1430,155,6633,34
30915,115,6123,2153,4696,45448,1427
39358,1,86,1690,63,6195,23
45902,22,193,386,140,3290,53
3847,8,233,3586,163,6597,70
3527,2,101,3593,88,3517,13
1196,4,117,3864,93,5670,24
2751,53,1493,3607,1187,19985,306
28245,472,53496,2292,39150,181318,14346
43263,83,1369,1119,1137,25327,232
43009,19,372,1194,251,6981,121
33173,13,409,2045,347,5143,62
12463,3,186,3129,141,4005,45
4805,1033,63218,3552,43421,233832,19797
27309,17,532,2347,440,6584,92
24919,69,2209,2456,1658,25632,551
3257,44,268866,3598,90091,8778,178775
17359,11,1373,2830,1026,50802,347
26738,1,55,2374,44,3908,11
39623,27,668,1675,489,5657,179
6019,5,99,3489,86,3045,13
35142,2,45,1961,36,3630,9
25900,25,2203,2413,1429,11723,774
33725,0,75,2025,60,5629,15
11426,3,142,3184,100,4717,42
24643,70,5741,2467,4320,46675,1421
33734,23,999,2024,799,11930,200
2320,71,1929,3614,1624,40322,305
22585,4,296,2566,241,4735,55
6002,145,6894,3490,4867,78205,2027
23979,0,311694,2499,191157,597004,120537
38600,11,681,1737,479,24966,202
19457,669,62365,2737,42981,233632,19384
36909,19,607,1851,494,13351,113
20410,37,668,2687,539,4957,129
3399,68,2098,3595,1585,18474,513
29230,23,366,2238,296,5276,70
31296,26,562,2134,479,17102,83
32378,26,550,2078,427,7082,123
4359,40,901,3568,705,5722,196
11977,28,850,3156,627,20990,223
5327,10,288,3524,230,11807,58
14602,5,313,2974,234,6882,79
11956,21,644,3157,534,8763,110
14509,78,5456,2981,3959,47605,1497
7050,23,587,3443,413,11586,174
27522,19,980,2333,805,15834,175
5584,21,850,3511,640,9823,210
41816,16,343,1442,248,4804,95
22801,21,773,2556,585,6798,188
1814,17,786,3625,620,11278,166
31525,1,108,2121,97,4290,11
22022,6,210,2594,168,4521,42
16003,17,786,2902,666,6728,120
10184,1,71,3249,54,5165,17
2840,8,558,3606,452,17969,106
13450,48,3332,3059,2460,18941,872
32417,24,823,2077,655,17719,168
1191,14,333,3865,257,6981,76
33576,11,130,2030,114,2080,16
25659,13,271,2423,221,4041,50
2839,12,296,3606,210,11706,86
42785,29,202,1251,164,4660,38
30289,11,290,2185,230,4801,60
43408,5,194,1073,138,4364,56
20078,13,290,2704,239,3800,51
13525,9,365,3054,295,7843,70
34227,1,162,2009,116,4428,46
28865,0,42,2256,32,2646,10
40222,6,256,1637,203,7245,53
9973,20,922,3259,714,7787,208
11819,3,106,3163,54,4647,52
5277,230,5061,3526,3850,17429,1211
29137,265,11404,2243,8200,53221,3204
14301,17,743,2996,610,6218,133
28883,76,4590,2256,3410,32072,1180
5654,73,7804,3507,5794,179468,2010
11526,32,1010,3177,780,13923,230
32929,3,169,2055,132,4142,37
3423,8,621,3595,422,19827,199
8353,130,7697,3353,5338,34837,2359
44476,26,403,843,277,6727,126
10642,5,197,3225,131,7368,66
29490,10,324,2224,254,5755,70
16429,52,4921,2881,3795,21812,1126
12785,1252,113128,3112,76141,752907,36987
22675,2,233,2562,204,8865,29
985,46,2405,3936,1874,23648,531
20610,22,253,2677,214,3199,39
20891,336,20744,2660,13999,117715,6745
4619,12,389,3559,298,6987,91
8153,2,180,3367,113,7639,67
31122,4,98,2143,89,4623,9
14580,37,3410,2975,2561,91415,849
32072,42,1032,2093,671,12295,361
19882,7,454,2715,388,3515,66
43222,8,282,1132,175,8047,107
26372,35,1250,2391,1013,20137,237
7548,12,286,3416,226,13190,60
13160,110,2284,3080,1823,24059,461
5206,56,2017,3530,1650,32051,367
26252,65,2973,2397,2503,35368,470
42174,3,49,1379,32,2605,17
14774,44,3426,2962,2498,36278,928
30862,32,2380,2154,1759,13447,621
20021,5,120,2707,79,2962,41
35324,231,4719,1951,3621,17218,1098
32870,18,1271,2057,1013,14721,258
36354,4,332,1882,250,5712,82
16277,3,262,2889,189,9139,73
46161,22,279,269,237,2288,42
5302,111,3232,3525,2465,35017,767
33741,90,2202,2024,1564,12164,638
15763,1,68,2912,58,2831,10
27366,9,276,2343,199,3439,77
3169,12,318,3600,240,7516,78
36846,19,424,1853,327,11474,97
36081,18,642,1897,493,10624,149
9392,37,468,3289,374,4774,94
38408,10,255,1751,221,5610,34
35300,79,1671,1952,1210,17909,461
25350,5,161,2438,115,7794,46
29571,3,102,2221,87,2132,15
38558,19,1872,1740,1545,6094,327
5531,9,275,3514,218,7806,57
5101,2,159,3536,111,12376,48
12187,20,898,3145,670,10939,228
12392,21,985,3133,820,12269,165
40649,82,2273,1599,1694,16131,579
27491,6,199,2335,151,5921,48
13124,10,437,3090,266,7063,171
27633,1,62,2327,54,1927,8
18849,3,251,2764,193,5453,58
38760,29,429,1727,300,5580,129
29472,22,555,2225,422,4088,133
1135,11,596,3890,441,9363,155
28742,202,8306,2263,6315,26902,1991
28172,11,277,2296,235,7080,42
32565,5,167,2070,125,6221,42
44870,2,67,740,56,4658,11
15174,2,34,2939,28,3684,6
36085,36,918,1896,724,10266,194
22732,13,993,2559,652,10684,341
18176,5,186,2794,149,5862,37
32984,4,145,2053,111,3260,34
19804,61,3599,2720,2489,27555,1110
13368,48,2147,3067,1592,32797,555
3233,9,271,3599,209,10631,62
42545,3,97,1304,74,3556,23
26436,16,949,2388,777,7764,172
30279,142,2508,2185,1996,16677,512
40886,35,996,1576,787,10243,209
46169,25,259,266,184,3859,75
46282,7,180,234,117,4455,63
25652,89,2739,2423,2116,38200,623
39494,0,23,1682,18,7793,5
29400,5,61,2229,47,3236,14
34899,107,8192,1974,6033,61596,2159
17046,26,2233,2848,1532,18931,701
16965,12,641,2853,421,15812,220
7470,7,118,3421,95,3298,23
7617,18,266,3411,237,10210,29
43598,13,139,1012,108,2513,31
2203,271,11003,3616,8227,70224,2776
36861,3,70,1853,58,2091,12
21097,12,579,2648,470,9193,109
15807,2,91,2910,65,5556,26
10131,15,588,3251,425,5488,163
23491,12,437,2522,339,8433,98
16050,9,405,2899,342,5769,63
44724,16,131,787,103,3860,28
30110,10,1051,2195,804,16286,247
2410,6,141,3613,116,10637,25
23724,9,422,2511,305,7923,117
29186,15,582,2241,491,6659,91
14192,326,9482,3005,7262,62735,2220
11469,21,1219,3181,850,24353,369
42567,6,109,1301,84,7929,25
46176,23,327,263,281,4651,46
44105,2,24,898,15,1540,9
45995,10,163,343,129,2191,34
45156,151,1609,637,1261,18075,348
22726,200,8372,2560,6149,46804,2223
6628,14,403,3465,292,17882,111
19819,16,927,2718,761,27601,166
45855,84,2033,374,1683,21409,350
19969,43,3872,2710,3088,33791,784
19044,0,36,2757,28,1352,8
3715,16,710,3589,571,35621,139
13342,2,47,3068,37,2992,10
20102,22,810,2703,615,18591,195
31082,170,2859,2145,2178,16146,681
4228,21,933,3574,771,10599,162
37405,6,110,1820,82,2943,28
5524,72,3211,3514,2580,32300,631
40900,2,70,1575,61,10715,9
9792,139,6270,3267,4581,48084,1689
44213,58,793,879,635,17069,158
28998,19,837,2250,585,4882,252
5251,135,4196,3527,3315,34699,881
8296,13,286,3358,181,2701,105
39135,175,3310,1704,2426,15090,884
5779,3,97,3501,71,2152,26
16947,60,2714,2854,2090,16609,624
34737,1,36,1984,28,1408,8
10888,5,116,3211,73,5393,43
5487,571,66910,3516,47758,129620,19152
19850,0,1388,2717,1161,14818,227
16545,2,400,2875,257,2812,143
11539,27,912,3177,702,19655,210
16015,11,365,2901,272,3426,93
39981,35,861,1652,649,9722,212
46175,1,75,264,57,2342,18
5138,823,39791,3533,27966,151619,11825
33125,388,10888,2047,9068,46269,1820
35301,4,216,1952,181,4489,35
24782,2,99,2462,71,5284,28
42473,72,856,1319,632,12022,224
41577,19,479,1488,354,9419,125
15264,14,1101,2935,853,6471,248
5268,5,205,3526,165,19313,40
20553,1,130,2680,93,2634,37
35952,41,513,1907,408,5460,105
13177,14,502,3079,414,5316,88
15868,2,76,2908,55,5258,21
28824,49,4868,2258,4016,28929,852
9104,0,94,3308,78,3052,16
12894,1,236,3105,166,8498,70
35219,49,2909,1957,2314,25634,595
28693,1,141,2265,120,7129,21
17061,9,225,2847,191,8313,34
14339,464,50820,2992,34271,177767,16549
40683,32,870,1596,754,14401,116
22628,4,345,2565,284,5797,61
25740,0,47,2419,37,2093,10
46158,13,166,270,138,2396,28
17845,2,83,2810,61,2530,22
34337,1,96,2004,76,11007,20
41591,30,605,1484,418,10017,187
26051,56,923,2405,672,10621,251
45248,42,441,610,376,7261,65
6474,18,365,3471,292,5912,73
24334,0,2524,2483,2040,29256,484
2557,3,198470,3610,73280,10067,125190
19058,65,3322,2757,2581,20858,741
10623,9,428,3227,361,3485,67
17367,7,258,2830,215,13527,43
26171,1,188,2401,139,3687,49
28982,49,1528,2251,1171,14576,357
40671,5,178,1597,134,4452,44
8570,4,186,3339,135,7912,51
34788,9,399,1980,305,6405,94
30046,58,1847,2198,1459,21801,388
37185,28,1163,1834,860,16581,303
25438,7,120,2434,102,2880,18
6449,7,188,3473,152,10399,36
26536,0,672,2383,521,12412,151
23543,15,851,2520,607,21057,244
17355,79,46607,2830,35009,52592,11598
42737,94,597,1264,449,9515,148
42529,92,1758,1308,1376,36977,382
38149,8,146,1769,115,3324,31
25783,1,274,2418,237,14732,37
35402,10,564,1948,413,4928,151
4446,3,49,3565,37,3909,12
6261,7,324,3481,256,6824,68
36461,10,416,1877,331,6045,85
22700,39,845,2561,626,5499,219
37675,6,285,1803,233,9110,52
32323,7,217,2081,178,6282,39
25275,3,370,2441,261,2347,109
30109,4,272,2195,207,6028,65
42142,9,241,1387,195,5082,46
11969,5,618,3157,466,8844,152
29329,19,511,2232,401,8701,110
24827,5,207,2461,174,2446,33
4069,119,4230,3579,3345,72413,885
12030,1,71,3154,58,2680,13
31346,25,904,2132,731,12208,173
15776,66,6927,2911,5138,25728,1789
13640,137,2668,3046,2104,18448,564
42098,37,461,1396,357,7118,104
10818,13,401,3215,305,6193,96
40150,28,752,1642,594,17541,158
27332,26,682,2346,508,5465,174
5540,7,435,3513,307,4822,128
10979,29,1795,3207,1431,17225,364
12639,3,94,3120,82,2641,12
12258,69,2336,3141,1773,64128,563
17560,13,651,2821,526,8492,125
6883,12,246,3453,180,3477,66
6947,90,2936,3449,2160,14966,776
42490,2370,55946,1316,38142,345144,17804
3811,29,481,3587,351,22083,130
22006,5,251,2595,212,4207,39
16333,0,27,2886,24,1848,3
38735,146,5824,1729,4130,28730,1694
19296,9,252,2746,188,4773,64
31482,24,711,2124,563,7995,148
39567,11,651,1678,490,14517,161
7454,30,2067,3421,1574,29219,493
30657,3,159,2163,136,4920,23
39683,24,450,1671,344,7352,106
45082,13,218,670,162,4242,56
6372,77,2997,3475,2329,23283,668
17242,0,362,2836,295,9846,67
9559,3,91,3279,78,2737,13
33013,5,144,2052,127,4027,17
18630,19,409,2774,349,4210,60
35635,142,11856,1931,8691,62723,3165
35505,12,599,1941,461,11850,138
17624,311,26116,2818,18064,126090,8052
21885,5,252,2602,215,2965,37
34429,6,70,2000,58,4057,12
6733,21,440,3460,328,6630,112
2973,121,4356,3603,3253,114437,1103
14775,0,1417,2962,1054,26458,363
3321,83,1527,3597,1158,33616,369
4715,27,299,3555,239,15977,60
19915,421,15040,2714,10664,106615,4376
44093,48,1474,892,1050,8414,424
46487,5,57,133,57,1143,0
5807,65,1462,3499,1119,14194,343
42717,59,2471,1270,1905,24078,566
6331,26,1006,3477,798,9935,208
45238,40,565,614,464,7956,101
38706,34,1113,1730,811,6234,302
22690,11,1439,2561,1141,18425,298
45485,2,27,545,13,1428,14
21995,2,127,2595,108,5474,19
25577,0,67,2428,61,16398,6
12044,71,2225,3153,1661,28442,564
32538,3,189,2072,138,10107,51
16223,1,65,2891,57,6554,8
11838,2,66,3163,53,2258,13
12934,6,128,3103,104,3875,24
8407,51,2824,3350,2273,37970,551
32165,23,627,2088,449,17700,178
40981,1,61,1569,51,5248,10
36453,8,257,1878,205,6652,52
28946,9,483,2253,413,3936,70
21529,9,304,2622,243,4875,61
21966,159,4925,2597,3886,17621,1039
4110,10,492,3578,321,4778,171
6009,6,240,3489,185,3200,55
33230,171,9151,2044,7133,60412,2018
14037,196,5205,3013,4112,58560,1093
6042,1,38,3488,32,2978,6
18918,8,497,2762,403,9675,94
25852,0,40,2415,36,1222,4
16772,76,5891,2863,4689,43739,1202
4995,28,605,3542,476,5710,129
12301,9,378,3139,320,15226,58
7366,4,520,3426,405,7861,115
12164,6,270,3146,209,4693,61
43735,43,383,966,292,10364,91
7232,60,1574,3434,1175,11551,399
32185,0,21,2087,18,1475,3
8552,11,431,3340,282,3957,149
6165,22,664,3484,410,20487,254
15179,16,708,2939,575,5438,133
23802,4,174,2508,146,3968,28
26609,38,1131,2381,883,18932,248
22156,36,2408,2587,1861,24158,547
39540,6,72,1680,59,3637,13
23764,2,66,2510,54,3660,12
31805,49,2020,2107,1567,17087,453
17068,3,202,2846,177,6449,25
41119,12,287,1552,214,5754,73
2894,3,102,3605,84,9396,18
8474,8,144,3346,125,2724,19
11270,6,197,3191,163,9358,34
6322,33,1303,3478,879,9030,424
19376,0,704,2742,551,12658,153
16632,40,1447,2872,1126,6413,321
43665,48,565,989,463,7233,102
37734,11,427,1799,319,4338,108
44808,2,97,760,61,3182,36
30154,18,416,2193,323,6567,93
41614,17,621,1481,446,12717,175
11575,1,101,3175,82,6890,19
36409,27,847,1880,614,10518,233
28199,7,113,2294,89,2026,24
30315,30,1740,2183,1315,21631,425
19202,2,139,2751,109,3103,30
7977,50,1389,3381,1055,20805,334
8746,6,159,3328,130,4715,29
8921,21,1056,3319,756,9225,300
8274,46,2365,3359,1722,18436,643
25621,22,680,2425,510,5188,170
6290,3,190,3479,142,5556,48
42450,14,614,1324,439,8011,175
15481,4,907,2926,771,14986,136
33482,183,3987,2034,3149,28446,838
7173,9,215,3436,162,4835,53
15294,662,33170,2933,21494,116563,11676
29250,65,2946,2237,2132,26609,814
34267,0,420,2007,335,8687,85
20881,42,1156,2661,856,7531,300
38606,5,177,1736,143,4994,34
44779,47,575,768,426,14087,149
23278,145,3168,2533,2510,16688,658
31390,223,11497,2129,7368,55348,4129
2859,56,1923,3606,1431,34950,492
9265,10,877,3298,685,18571,192
44914,2,26,730,19,2699,7
33266,272,4382,2042,3425,28810,957
31307,43,1050,2133,833,20832,217
20736,78,3147,2671,2467,34991,680
22451,11,1390,2573,1064,21819,326
22654,12,312,2563,251,9523,61
16190,11,313,2893,246,4132,67
16463,13,571,2879,475,8004,96
4642,47,1218,3558,952,14930,266
20086,3,65,2704,53,2363,12
15893,13,585,2907,450,10299,135
28465,11,418,2279,324,11617,94
42403,2,67,1335,52,3710,15
10231,9,350,3247,268,6407,82
12668,17,338,3118,254,5255,84
33178,2,78,2045,63,1982,15
5741,27,494,3503,390,14532,104
45279,288,5600,598,4538,40829,1062
16620,9,676,2872,538,12381,138
16735,9,229,2866,198,4026,31
35874,3,267,1912,212,9073,55
30841,282,11798,2155,8602,72830,3196
13850,7,173,3029,128,6272,45
20082,145,9459,2704,6562,51366,2897
8617,16,932,3336,677,6704,255
15815,2,250,2910,213,4555,37
44044,9,174,909,123,9165,51
10386,1,30,3240,23,1570,7
22914,19,248,2550,219,2324,29
15970,131,7662,2904,6002,24108,1660
35526,21,468,1939,368,6520,100
28143,7,666,2298,494,3910,172
11436,661,34002,3183,27251,75105,6751
32217,43,2512,2085,1878,22166,634
28076,23,1157,2301,936,19632,221
30610,35,1217,2166,923,13533,294
40837,49,1576,1580,1179,17226,397
45528,0,54,533,26,2200,28
44066,103,2010,906,1613,17522,397
7024,66,1470,3445,1089,26987,381
13727,63,5013,3038,3867,40140,1146
3785,85,5009,3588,3887,37874,1122
16391,23,1217,2882,996,13012,221
29071,4,212,2246,179,5195,33
41109,59,1021,1554,753,9991,268
27138,116,2148,2357,1550,10820,598
46468,0,62,142,43,1191,19
17917,43,4283,2807,3072,32249,1211
24889,70,3351,2458,2590,42923,761
15899,15,827,2907,590,15109,237
6281,14,461,3480,368,7718,93
40426,5,282,1619,214,2995,68
20163,250,20804,2700,14097,94130,6707
17171,3,289,2840,222,3704,67
26869,7,172,2368,148,3296,24
43729,19,344,968,302,11175,42
11644,25,3199,3172,2255,25260,944
41420,68,629,1509,482,9062,147
29653,12,453,2216,362,4003,91
35230,1169,43838,1956,37018,212178,6820
1453,16,1369,3722,1062,24640,307
34886,10,1092,1974,860,9331,232
8798,252,12931,3325,8837,76201,4094
9912,20,644,3262,490,19461,154
33394,2,65,2037,52,3457,13
8431,36,1116,3349,797,9117,319
4308,265,10221,3570,7969,47127,2252
20667,16,803,2674,590,13076,213
11147,18,693,3197,570,7536,123
44917,15,153,726,116,2564,37
15948,24,1459,2905,1145,28345,314
1951,266,8271,3621,6425,87969,1846
45461,106,773,551,615,12668,158
14247,12,201,3001,168,3290,33
11371,13,551,3187,406,15712,145
22990,0,56900,2546,36345,269426,20555
43104,257,2812,1166,2244,17660,568
20774,28,620,2668,497,9251,123
31881,3,50,2103,39,2886,11
20013,8,281,2707,207,6604,74
32251,8,267,2084,223,3879,44
34946,10,447,1971,386,8779,61
26559,0,12,2382,11,935,1
29694,13,514,2214,418,6329,96
13244,1,34,3076,26,1661,8
9444,26,1163,3286,950,10614,213
32960,20,1157,2054,905,11581,252
39399,64,784,1687,625,8951,159
41241,90,2779,1536,2264,40093,515
12960,21,708,3101,606,6839,102
28441,5,177,2281,145,4388,32
5637,13,629,3508,466,6873,163
14189,7,437,3005,354,7034,83
27317,35,1323,2346,1081,19025,242
37176,8,264,1834,225,10875,39
12350,25,1263,3136,1000,9638,263
17791,26,2509,2812,1922,51296,587
25282,23,559,2441,458,9753,101
43474,17,553,1058,418,11513,135
3971,15,321,3582,261,5431,60
44834,4,30,749,27,1985,3
34785,7,162,1981,130,2091,32
32019,8,130,2096,110,4839,20
16161,3,250,2894,195,3436,55
12156,4,40,3146,34,3273,6
2046,8,262,3619,227,25129,35
2209,1,79,3616,68,5369,11
46099,154,2302,299,1857,11788,445
5804,3,80,3500,66,2884,14
32617,2,47,2068,37,3357,10
38499,11,182,1745,149,4949,33
39625,5,111,1674,95,9561,16
42066,22,307,1403,242,7844,65
37730,6,251,1799,194,3989,57
31665,9,891,2114,717,12835,174
7213,8,111,3435,88,5160,23
40008,36,828,1650,637,6764,191
36568,129,4232,1872,3107,15372,1125
19528,4,169,2734,136,4469,33
3770,1,79,3588,62,3666,17
37784,3,86,1795,69,3537,17
15765,1,27,2912,22,3369,5
46191,2,60,259,46,975,14
32988,5,115,2053,87,2500,28
39491,0,113,1682,93,2720,20
6853,144,12271,3454,7774,56764,4497
42010,209,8888,1412,6086,49885,2802
15705,3,264,2914,200,3050,64
34650,121,2074,1988,1544,15561,530
41134,27,577,1551,424,6890,153
29793,61,2439,2210,1846,26030,593
14451,1213,87218,2985,61272,228844,25946
6806,9,273,3457,231,9421,42
12747,18,1124,3114,784,13804,340
35227,15,511,1957,407,12766,104
11103,8,231,3200,185,7831,46
4398,30,1658,3567,1275,21343,383
14402,41,1371,2988,1085,9743,286
28975,339,11048,2251,8314,53943,2734
16577,7,212,2874,144,3786,68
21167,17,572,2642,468,5075,104
13865,46,3114,3028,2169,12116,945
15315,20,2241,2932,1764,14055,477
40887,2,336,1576,236,7095,100
41364,19,507,1517,405,16025,102
26724,83,8322,2375,6009,58798,2313
32197,20,514,2086,415,11006,99
12032,98,6799,3154,4884,23387,1915
23854,66,937,2505,700,10917,237
37222,49,1142,1831,938,5186,204
41055,2,52,1561,42,2885,10
9408,36,1949,3288,1519,29524,430
7324,19,595,3428,498,19115,97
40829,98,2020,1581,1478,18951,542
6443,4,121,3473,97,3628,24
12414,1,82,3131,69,2666,13
5603,10,381,3510,243,4417,138
26653,90,2205,2379,1835,19337,370
45486,12,227,544,156,4104,71
40728,64,1562,1592,1169,31646,393
3937,7,433,3584,247,4920,186
43713,28,521,973,442,5975,79
19739,55,1061,2723,800,6274,261
25712,2,465,2421,365,7709,100
39726,5,140,1669,117,3521,23
7113,2,507,3440,397,12849,110
15956,185,6841,2904,5006,23151,1835
10434,4,133,3237,95,5804,38
26215,2,348,2398,273,10999,75
41834,7,257,1440,201,11329,56
40974,1,75,1570,64,3356,11
12791,40,1522,3111,1166,24632,356
1233,3,93,3858,73,3391,20
32392,3,68,2078,56,1837,12
2651,14,233,3609,186,12239,47
10847,11,830,3214,657,12245,173
10892,47,1403,3211,1105,12667,298
16141,99,2655,2895,2125,39594,530
1987,54,2203,3620,1623,16897,580
9509,36,1097,3282,859,22698,238
24590,0,10783,2470,8173,37892,2610
45581,0,120,513,91,2512,29
24027,1,226,2496,174,4255,52
23873,21,529,2504,387,5989,142
6856,64,1303,3454,1044,14410,259
2227,154,17388,3616,12006,50816,5382
24327,247,11840,2483,8567,83655,3273
15561,21,689,2921,565,5908,124
42049,15,511,1406,401,9643,110
42734,36,633,1265,439,8704,194
14570,31,783,2976,601,10360,182
39819,10,352,1664,252,5224,100
4540,22,1391,3562,1081,31244,310
44771,7,177,771,116,3488,61
44898,64,777,734,541,12302,236
39506,0,45,1682,38,2522,7
26230,0,14,2398,11,1257,3
25174,1,80,2445,63,3121,17
15171,145,14039,2939,9841,74399,4198
17617,4,332,2818,222,14369,110
25952,25,1735,2410,1362,24381,373
28424,0,110,2281,99,5042,11
39972,0,202,1653,154,5708,48
2575,1,138,3610,110,4974,28
29092,1,97,2245,78,2499,19
19292,1,106,2746,64,3025,42
25187,8,546,2444,428,8617,118
24135,6,363,2492,299,4842,64
30686,11,546,2162,451,5722,95
27530,334,17335,2332,12991,140585,4344
35963,5,100,1906,85,5255,15
6619,6,131,3465,102,3855,29
9615,5,136,3275,113,8302,23
40235,14,333,1636,276,5288,57
3129,8,255,3601,200,7471,55
27693,9,285,2324,230,5934,55
34549,4,54,1994,47,2612,7
41235,9,214,1537,162,8730,52
40303,0,30,1632,26,3099,4
25052,25,639,2451,438,7386,201
21551,6,253,2621,202,13455,51
32886,57,5785,2057,4537,15476,1248
15892,10,377,2907,288,6088,89
43119,7,169,1160,119,7783,50
5158,64,2045,3532,1434,37960,611
12993,155,3776,3098,2789,13028,987
14513,11,451,2980,338,7433,113
16012,12,1835,2902,1483,21802,352
29365,3,170,2230,132,4516,38
23972,1,65,2499,58,2814,7
36984,7,412,1846,289,8157,123
40857,13,212,1578,169,5183,43
40048,228,4050,1647,2747,37886,1303
6731,30,1197,3460,923,18225,274
28787,0,205,2260,164,6036,41
43187,7,161,1143,119,4056,42
14615,0,158,2973,131,23524,27
5732,153,4355,3503,3173,34453,1182
39413,415,14970,1686,10873,93018,4097
26296,5,347,2395,295,3434,52
3120,2,65,3601,54,3191,11
3497,0,57,3594,49,2026,8
23495,9,436,2522,352,5581,84
6774,9,230,3458,187,11466,43
37564,1,107,1809,86,4101,21
27907,24,1738,2311,1395,12825,343
9825,42,1188,3265,953,13728,235
33481,2,273,2034,212,7944,61
30228,0,44,2188,36,1560,8
33450,38,666,2035,513,8114,153
18573,252,24975,2777,16688,85212,8287
35856,45,582,1914,469,9954,113
46108,10,92,295,61,1828,31
29566,36,1510,2221,1204,12499,306
11169,925,47783,3196,33796,118862,13987
9011,18,1143,3314,697,24386,446
39766,16,319,1668,251,8207,68
36560,37,1867,1872,1520,14298,347
39480,4,284,1683,230,5916,54
20041,29,553,2706,440,5601,113
24317,8,286,2484,212,3979,74
5668,12,163,3506,97,6241,66
13259,238,20512,3075,14911,98971,5601
38737,6,198,1729,168,6224,30
21418,5,431,2629,297,2951,134
38110,196,2568,1772,1851,12011,717
9351,7,882,3291,651,18839,231
39048,38,713,1709,504,5934,209
3293,308,10000,3598,7816,115235,2184
10787,1,66,3217,54,3442,12
12746,5,100,3114,74,9984,26
40609,8,149,1601,110,1391,39
46160,39,355,269,296,3952,59
5670,4,66,3506,52,4966,14
5780,7,106,3501,71,4032,35
11867,2,58,3162,47,10118,11
8923,21,921,3318,720,21386,201
23790,7,245,2508,204,7439,41
2979,104,6524,3603,4784,33675,1740
41545,31,649,1491,502,10715,147
34279,20,441,2007,320,4409,121
30714,22,376,2161,300,4404,76
43472,22,377,1058,291,6284,86
22831,1,126,2554,100,3325,26
9951,14,1253,3260,928,17484,325
6233,17,1069,3482,820,8515,249
4661,2,48,3557,34,2407,14
25821,21,1594,2416,1175,8297,419
9719,2,103,3271,69,2537,34
24712,44,3126,2464,2370,30536,756
1476,2,53,3712,47,3214,6
35834,2,118,1915,105,4325,13
26728,6,124,2375,106,8512,18
4190,11,282,3575,229,5806,53
6318,109,5121,3478,4033,54640,1088
23300,0,15,2531,11,2472,4
39409,14,274,1687,223,5434,51
5258,16,751,3527,294,8084,457
12133,3,88,3148,72,2159,16
31776,1,92,2108,81,4342,11
4014,6,48,3581,41,4141,7
15376,33,675,2930,565,12208,110
40896,17,744,1575,521,17487,223
9764,22,972,3269,797,7015,175
32316,4,572,2081,479,5820,93
4951,106,2990,3544,2213,24473,777
24754,67,2109,2463,1557,12227,552
32308,44,2296,2082,1556,19675,740
16362,69,1914,2884,1468,16929,446
2315,18,360,3615,310,20842,50
42466,6,168,1321,95,5818,73
20853,1,169,2663,144,4863,25
20764,6,356,2669,266,9921,90
4403,55,1505,3567,1167,16452,338
29415,127,3240,2228,2400,17555,840
32414,7,373,2077,304,2208,69
40017,20,371,1650,277,10162,94
6403,294,16529,3474,12123,87080,4406
17409,3,673,2827,526,10345,147
40663,9,385,1597,265,10661,120
20330,3,231,2692,180,8039,51
8528,0,32,3341,29,1941,3
44285,44,404,871,339,9852,65
33564,3,61,2031,48,3010,13
12315,1,105,3138,82,5739,23
19009,535,32536,2759,24301,155965,8235
3030,14,336,3602,265,3476,71
7091,5,193,3441,158,4339,35
46252,18,243,244,184,2806,59
1212,2,38,3861,33,2463,5
45421,25,215,561,169,4233,46
28592,27,1130,2271,841,12775,289
17337,28,1858,2832,1254,15692,604
19593,14,766,2731,634,9496,132
21721,315,15791,2611,11660,66994,4131
12410,0,33,3132,26,2691,7
45344,6,52,581,37,1846,15
6507,347,12669,3470,9324,80557,3345
21795,57,3538,2607,2501,31352,1037
8106,29,426,3369,337,4305,89
11686,6,176,3169,111,2435,65
11176,255,8991,3196,6541,114415,2450
25451,56,1093,2434,803,5735,290
11234,20,917,3193,714,13462,203
4272,8,475,3572,327,11957,148
12764,11,231,3113,200,4386,31
18988,45,825,2760,663,5660,162
30861,6,114,2154,93,7906,21
34415,55,1637,2000,1233,7767,404
28212,24,1732,2293,1482,11835,250
33915,3,547,2018,444,5732,103
14002,13,567,3016,462,10450,105
7155,77,2587,3437,1897,20491,690
13362,0,122,3067,94,3523,28
25846,45,1492,2415,1136,13703,356
11443,37,3783,3183,3001,31628,782
20547,10,286,2680,238,8308,48
19435,55,1054,2738,790,7866,264
44298,10,78,868,60,2512,18
31547,40,835,2120,674,7933,161
4582,491,21035,3560,14122,133653,6913
17796,9,228,2812,190,5211,38
44928,7,114,725,75,2836,39
12661,32,2231,3119,1774,18714,457
36225,6,173,1889,123,2731,50
21472,25,714,2625,540,13533,174
38373,323,12246,1753,9171,55529,3075
8925,75,2130,3318,1661,30856,469
32571,17,789,2070,667,3599,122
11716,6,187,3168,167,5886,20
8509,26,780,3343,597,7670,183
15979,15,536,2903,438,6975,98
21073,3,396,2649,312,4962,84
32367,22,465,2079,297,5694,168
39583,0,52,1677,43,4856,9
45518,67,1197,535,1055,8558,142
46241,27,211,246,186,3863,25
24078,4666,393939,2495,242177,1054570,151762
13863,18,305,3028,251,4320,54
46009,2,48,335,36,2085,12
38363,277,6534,1754,5067,33236,1467
32674,12,388,2066,302,18875,86
32331,3,41,2080,32,3675,9
7637,94,3949,3410,2817,31471,1132
28633,3,103,2268,84,5837,19
34670,32,330,1987,265,4175,65
17402,33,1945,2828,1479,11841,466
30759,15,331,2159,276,7350,55
2978,84,3664,3603,2567,35932,1097
17727,0,213,2815,182,4180,31
21278,7,564,2636,471,13443,93
3782,9,205,3588,170,5177,35
14495,18,964,2981,770,5964,194
12972,0,164,3100,135,3676,29
42075,106,3379,1401,2471,35462,908
46342,4,87,206,71,1584,16
41148,3,162,1549,116,4226,46
33579,1,137,2030,113,3309,24
25629,90,1976,2424,1594,8581,382
25447,9,532,2434,449,7721,83
29110,2,147,2244,121,6609,26
15567,0,318,2920,238,4552,80
12873,45,1048,3106,801,8100,247
36745,13,427,1861,325,8148,102
34215,6,164,2009,139,4403,25
4323,50,1579,3570,1199,32548,380
6175,6,191,3484,160,2730,31
37013,194,15037,1845,11194,94621,3843
32540,8,290,2072,239,3764,51
30269,8,440,2186,361,14934,79
26175,39,719,2401,542,5428,177
14233,36,1157,3002,942,5714,215
16399,86,7852,2882,5369,46350,2483
43438,5,225,1066,191,6611,34
26047,177,6358,2406,4703,36426,1655
2534,3,49,3611,38,5570,11
38475,183,13464,1747,9971,62406,3493
11915,11,399,3159,324,7434,75
24655,57,1936,2467,1489,21043,447
32585,19,1148,2070,896,12154,252
4232,21,934,3574,741,25297,193
21140,77,1564,2645,1256,11021,308
43709,25,479,973,346,6934,133
28973,151,4344,2251,3410,44828,934
32358,1,35,2079,31,1593,4
41354,12,285,1518,226,15245,59
42699,31,710,1273,529,8017,181
46325,4,72,214,57,1397,15
35477,33,851,1943,718,15442,133
18196,0,303,2793,238,7083,65
25530,151,6579,2430,4376,72982,2203
7358,17,622,3426,455,11828,167
43740,9,192,965,148,5642,44
30960,4,195,2151,160,5393,35
30430,1,25,2176,21,1508,4
13813,21,975,3033,560,12143,415
27409,4,434,2341,365,8300,69
13690,12,387,3042,315,9838,72
27231,28,665,2351,536,7437,129
12036,46,2010,3154,1564,8374,446
22998,28,3609,2546,2650,17859,959
33168,28,1211,2045,988,16436,223
35517,12,230,1940,193,4674,37
17505,6,205,2823,156,4322,49
33143,12,583,2046,489,11909,94
44963,17,277,715,174,4122,103
16234,163,14999,2891,7933,57494,7066
42548,4,130,1304,100,2889,30
39151,5,153,1702,115,7041,38
5591,118,5682,3511,4362,41096,1320
31807,0,40,2107,33,3022,7
27192,4,122,2354,114,1667,8
19894,29,2265,2714,1741,22367,524
35799,35,1924,1917,1446,12699,478
36756,17,382,1861,320,4947,62
13015,33,1992,3097,1274,18297,718
16420,8,266,2881,226,3381,40
28293,30,1837,2289,1264,12911,573
14874,3,179,2956,147,3711,32
39488,0,27,1682,23,1585,4
41693,54,1101,1469,790,12920,311
9246,11,216,3299,170,6068,46
4120,73,1559,3577,1231,16038,328
27236,31,1784,2351,1514,16975,270
25469,14,255,2433,217,2355,38
2202,110,3252,3616,2519,29012,733
46025,30,316,329,245,4587,71
42109,7,192,1395,136,4957,56
7990,37,745,3380,522,8679,223
11291,8,338,3190,263,12430,75
12371,6,333,3134,263,5156,70
17762,1,205,2813,148,2474,57
2805,56,1442,3606,1098,17769,344
46461,21,273,143,255,3543,18
24932,0,14,2456,12,4440,2
24509,143,5962,2475,4116,25969,1846
4949,158,8077,3544,6032,67353,2045
32090,6,872,2092,590,11453,282
25747,408,13916,2419,9724,73057,4192
27706,31,834,2323,646,8207,188
17195,90,21260,2839,16026,48314,5234
27730,346,14246,2321,10371,102306,3875
20851,9,487,2663,366,10104,121
42592,63,1652,1296,1250,25913,402
27668,3,58,2325,47,2791,11
35393,309,6022,1949,4435,24945,1587
20381,29,1301,2689,1050,15382,251
36200,7,175,1890,139,4226,36
21191,2,95,2641,79,2624,16
34954,18,879,1971,702,6008,177
7159,2,25,3437,21,1617,4
10432,5,76,3237,65,2594,11
15896,7,379,2907,282,6770,97
41786,15,290,1450,219,6787,71
18012,215,14433,2801,10883,67477,3550
27068,0,276,2361,199,4722,77
4539,4241,169157,3562,113368,643432,55789
21577,27,1557,2619,1168,14940,389
29765,1,228,2211,178,3796,50
8820,2,201,3324,149,7128,52
27608,0,36,2328,32,2406,4
44635,0,12,816,7,1595,5
23117,75,2153,2540,1740,46219,413
4483,4,91,3564,76,3933,15
1630,3,43,3674,40,1684,3
28964,74,5997,2252,4423,48781,1574
33972,3,96,2016,80,7980,16
4888,14,180,3547,138,3192,42
1258,13,415,3846,353,7372,62
6147,102,2515,3485,1798,29626,717
42036,24,332,1408,270,5427,62
34964,15,498,1971,407,6975,91
9649,7,177,3274,149,5708,28
24549,20,1695,2473,1351,12645,344
2601,19,810,3610,607,15319,203
20312,51,4141,2692,3292,21330,849
6684,11,263,3462,236,7256,27
37801,11,198,1793,158,3939,40
15761,2,107,2912,73,2914,34
33274,4,182,2042,157,5244,25
45614,31,658,298,582,4465,76
40742,9,142,1591,115,4204,27
8855,47,2934,3322,2251,61031,683
22925,233,15671,2549,10982,154268,4689
14376,30,855,2990,633,5534,222
6828,9,315,3455,243,11372,72
24218,23,728,2488,577,5954,151
34824,12,332,1978,253,4451,79
23881,1,122,2504,100,4438,22
16992,4,205,2852,157,2245,48
44971,2,68,712,47,2250,21
2064,18,1172,3618,865,13254,307
46090,71,917,302,849,13515,68
2582,162,7387,3610,5768,48282,1619
28594,26,1364,2270,1113,18859,251
40563,150,3437,1605,2571,19084,866
5513,6,526,3515,313,7838,213
45171,4,34,632,21,1812,13
17913,25,1685,2807,1225,19924,460
7874,19,435,3392,328,5264,107
41724,142,3788,1463,2820,28340,968
38317,9,543,1758,415,9054,128
13955,27,2562,3019,2073,32632,489
5048,40,1026,3540,778,14519,248
31510,11,219,2122,179,5779,40
23181,334,14891,2538,11013,44792,3878
12013,10,316,3154,251,4183,65
43164,30,526,1148,356,7080,170
7312,19,785,3429,624,12623,161
36802,30,911,1857,743,12287,168
18248,1,148,2790,124,7283,24
19474,9,879,2736,692,11683,187
41193,38,1095,1544,903,19120,192
17312,6,153,2833,127,4424,26
11297,94,5492,3190,4225,37189,1267
3758,11,348,3588,270,5421,78
17333,101,5447,2832,3903,61475,1544
10561,512,17178,3230,12764,59397,4414
19029,4,210,2758,169,5649,41
3900,9,150,3585,107,3772,43
22881,15,632,2552,499,7405,133
12509,15,369,3126,311,2920,58
43409,22,191,1073,166,5840,25
14783,31,526,2961,404,5618,122
39746,8,275,1668,207,4678,68
31240,1181,63532,2137,41871,242662,21661
39885,2,190,1659,130,3534,60
13695,106,4929,3042,3683,49210,1246
5639,15,342,3508,252,6651,90
37209,74,1251,1832,1003,8863,248
5196,22,601,3530,511,5903,90
2708,34,1269,3608,872,7772,397
16016,58,4186,2901,2893,24287,1293
43040,112,2003,1185,1335,31707,668
45718,0,21,449,14,922,7
41594,37,509,1484,412,19869,97
18373,19,2079,2785,1583,22599,496
10153,52,1284,3250,1057,8729,227
12853,7,955,3107,776,26572,179
45334,13,115,584,97,1529,18
31697,18,548,2112,423,7462,125
44663,234,3505,808,2983,40997,522
36585,34,2283,1870,1736,34357,547
41752,10,544,1457,416,10523,128
5795,1,83,3500,67,4312,16
36394,0,70,1880,60,2805,10
36881,3,143,1852,117,2030,26
7420,312,31629,3423,19979,254846,11650
32267,88,2035,2083,1601,14069,434
35223,30,982,1957,788,6820,194
16401,335,14684,2882,11475,143010,3209
4454,17,383,3565,289,12865,94
37068,21,610,1841,492,6258,118
43907,6,116,933,86,3623,30
3335,18,423,3597,338,15675,85
35828,2,112,1916,82,4230,30
5323,15,375,3524,284,9528,91
37099,6,240,1839,196,3753,44
31684,18,335,2113,275,4663,60
7524,13,985,3417,702,36695,283
45544,0,35,526,32,2115,3
31334,5,202,2132,164,7732,38
12246,87,3278,3142,2525,21054,753
16118,55,2027,2896,1544,14869,483
26766,15,354,2373,285,6314,69
28978,6,482,2251,365,6831,117
8964,576,24605,3315,16968,288038,7637
18268,59,2830,2789,2078,16857,752
23795,4,267,2508,213,4142,54
3750,5,31,3588,26,2070,5
11999,243,7980,3155,5643,68506,2337
5845,147,5448,3497,4136,25713,1312
32167,11,119,2088,85,2574,34
20946,1,68,2656,50,5890,18
27254,49,2031,2350,1614,11974,417
30627,23,1297,2165,1002,6058,295
32959,4,79,2054,65,2746,14
41593,88,1544,1484,1164,11202,380
8830,19,609,3323,410,6360,199
28688,70,2436,2266,1909,26070,527
35759,20,630,1921,513,13762,117
15675,313,23453,2916,16384,264139,7069
14538,2,53,2979,40,2836,13
15419,26,1226,2928,961,15768,265
34951,0,91,1971,81,3332,10
33263,14,363,2042,293,5831,70
15999,59,1563,2902,1184,13228,379
16438,6,248,2880,210,4160,38
15311,139,6337,2932,4502,15607,1835
37401,0,47,1820,37,3331,10
42762,38,598,1258,464,5168,134
16618,4,349,2872,268,6273,81
10271,1,73,3245,61,2224,12
8144,37,1048,3368,788,7326,260
26054,0,0,2405,0,1880,0
28357,45,1950,2285,1626,12157,324
13302,119,5991,3072,4516,30699,1475
16843,542,31018,2859,20798,154106,10220
31016,21,495,2148,407,8873,88
3941,1,224,3584,179,5721,45
20261,22,3276,2694,2151,12426,1125
5848,8,364,3497,271,8769,93
24676,21,446,2466,324,4311,122
15319,38,3256,2932,2571,17085,685
20921,5,187,2657,164,2572,23
27972,333,11585,2307,9276,70763,2309
7932,46,1413,3386,997,17771,416
42184,115,2219,1378,1494,18704,725
5069,24,1093,3538,845,6501,248
5919,33,1080,3493,824,8012,256
19868,4,96,2716,85,3680,11
5267,74,1971,3526,1515,45347,456
2259,1,23,3615,20,2221,3
15156,18,1078,2940,793,12733,285
41365,0,88,1517,68,2355,20
39004,23,676,1712,489,9027,187
18430,286,12241,2782,7698,50817,4543
14197,22,691,3004,537,9043,154
1969,67,3468,3620,2801,34510,667
36001,2,275,1903,216,9566,59
31561,26,509,2119,402,5628,107
14327,1,27,2993,20,4771,7