Mod,likes,downloads,time,unique_dl,views,dl_dif
41839,277,9263,1477,5099,74850,4164
38403,2,120,1790,94,3899,26
18406,11,644,2822,478,10031,166
29176,6,347,2279,294,5801,53
37533,19,423,1849,357,14030,66
12411,93,5309,3170,3540,46204,1769
44197,96,1193,920,1059,15806,134
42250,5,94,1402,67,3677,27
26479,0,3165,2424,1450,21631,1715
43956,215,4524,963,1908,38152,2616
21329,9,557,2671,335,6586,222
25966,8,1715,2447,1190,24943,525
14343,120,3498,3030,2871,19774,627
30275,22,585,2224,502,12377,83
29347,155,5657,2269,3603,45531,2054
46350,25,495,244,287,4855,208
16921,4,321,2893,180,3659,141
44915,86,1454,768,918,18633,536
18832,6,485,2803,311,4943,174
11569,5,347,3214,311,2682,36
32182,14,439,2125,359,5649,80
31337,72,1404,2170,1120,10778,284
14422,8,330,3024,312,5172,18
30338,22,422,2219,296,5915,126
13708,370,23151,3079,20258,165066,2893
26444,26,527,2425,402,7570,125
44976,48,408,749,327,4624,81
14676,335,16543,3008,11462,67984,5081
25415,37,1653,2473,1264,16868,389
15141,152,12543,2979,6815,60847,5728
41951,0,0,1459,0,5567,0
15784,3,65,2949,54,2965,11
32891,1,149,2095,72,3196,77
41937,20,303,1462,219,8588,84
34641,2,90,2026,73,2501,17
32568,24,344,2108,286,3665,58
25532,10,476,2468,403,7801,73
26030,4,385,2444,233,6767,152
37055,10,488,1879,372,7545,116
44929,161,2184,763,1438,18347,746
33221,39,1727,2082,1204,24274,523
12763,162,11703,3151,9373,49761,2330
20340,23,466,2729,397,3827,69
16708,72,6268,2905,3269,38595,2999
39485,26,1214,1721,889,10958,325
31216,19,906,2177,671,6724,235
18142,1,31,2833,28,4372,3
27548,21,867,2369,659,7359,208
11476,3,225,3219,189,8730,36
39580,4,171,1715,135,3865,36
20315,16,603,2730,472,11455,131
40471,302,10570,1652,5628,69128,4942
24130,31,1585,2530,1175,16755,410
30440,3,50,2213,42,2065,8
20322,6,297,2730,236,10094,61
15116,130,3496,2980,2760,15982,736
41888,13,319,1469,259,7940,60
30985,2,89,2188,79,3008,10
41716,39,1380,1502,965,7069,415
18949,1,119,2799,52,2808,67
31435,5,247,2165,203,12267,44
28697,4,131,2303,68,2920,63
41700,112,2392,1504,1813,18261,579
14917,237,7699,2992,5451,42578,2248
37875,69,651,1825,516,6997,135
26866,0,1607,2406,1065,15704,542
42286,4,135,1395,110,5970,25
39204,2,56,1737,44,4388,12
29512,44,1138,2261,888,15625,250
39600,17,586,1713,450,15049,136
41427,5,268,1545,205,4435,63
35978,230,24816,1943,10000,102400,14816
25989,76,2422,2446,1181,14229,1241
22523,9,265,2607,224,4993,41
20347,3,253,2729,205,3971,48
26581,3,150,2420,125,3366,25
36952,14,517,1886,456,13464,61
17147,1013,42496,2880,30159,122920,12337
40752,285,5362,1627,3286,39319,2076
18985,21,1217,2798,955,22668,262
43523,448,6761,1080,5691,50151,1070
15478,126,6375,2964,3653,61603,2722
13306,26,954,3109,873,6242,81
35421,614,30438,1985,15791,152613,14647
23917,7,570,2541,206,7621,364
27558,89,1681,2369,1287,11331,394
24894,123,8773,2495,7110,34580,1663
29276,4,84,2274,68,2497,16
34547,24,1780,2032,1309,28806,471
32750,81,3394,2101,2560,15258,834
37596,3123,100317,1846,56373,290759,43944
30627,23,1297,2203,1013,6187,284
45058,46,606,720,551,11186,55
41084,22,353,1595,214,4325,139
46224,0,14,288,11,1388,3
40856,55,1677,1616,1194,15990,483
35460,0,104,1982,71,9330,33
38693,7,110,1769,92,2139,18
35884,11,572,1950,394,12598,178
20334,5,337,2729,260,5219,77
14236,0,232,3039,224,19715,8
37116,10,170,1876,144,5794,26
13651,24,1334,3083,1211,19231,123
21706,8,210,2650,173,3732,37
38420,6,480,1788,317,9304,163
26014,1,77,2445,63,5302,14
29081,548,20794,2283,10632,131894,10162
28310,51,565,2326,481,5093,84
45199,49,675,662,366,10619,309
34441,0,56,2037,49,1758,7
31195,2,122,2177,107,2285,15
19582,18,849,2770,604,6017,245
28587,12,293,2309,211,5660,82
12585,77,4236,3161,3922,87340,314
19180,60,2486,2790,1493,15538,993
26351,17,840,2430,446,13357,394
20172,243,8890,2737,6052,79753,2838
39579,2,98,1715,86,5546,12
13986,24,2050,3055,1321,16494,729
21139,56,2224,2683,1666,15788,558
15828,0,85,2947,74,2824,11
13288,11,550,3111,462,7564,88
11578,19,1230,3213,1091,16443,139
17946,13,580,2843,442,5244,138
30603,506,33854,2205,20941,205048,12913
15389,56,3973,2967,3152,37591,821
26397,6,254,2427,192,5369,62
22629,4,70,2603,62,3245,8
39030,3,190,1749,118,5035,72
16730,3,146,2904,113,3507,33
6867,86,4030,3492,3518,16480,512
25187,8,546,2482,424,8752,122
17940,48,3592,2843,2628,41195,964
21361,61,2381,2669,1669,12589,712
32060,142,6120,2132,4899,34927,1221
13927,32,2433,3059,1252,16157,1181
23788,14,403,2547,319,8075,84
40023,18,346,1687,220,6758,126
22183,3,110,2624,91,5786,19
37304,18,207,1864,154,9448,53
34083,169,7489,2051,4782,62998,2707
23253,11,1147,2572,846,10895,301
44614,62,2717,855,765,22523,1952
45021,99,1131,735,721,10907,410
35002,0,49,2007,41,2007,8
31183,353,46838,2178,7967,132604,38871
40502,42,1163,1649,681,17897,482
18013,72,4974,2839,2682,45362,2292
11817,20,931,3202,439,7197,492
22486,1,117,2609,102,8193,15
41127,2,16,1589,13,2750,3
10352,79,2400,3279,1989,60913,411
27091,68,3119,2398,2178,34926,941
37075,1787,76518,1878,41428,169891,35090
25521,4,107,2468,83,4133,24
19846,11,824,2755,421,7907,403
38575,9,250,1777,190,5839,60
28103,70,1160,2338,958,9878,202
36682,23,603,1903,421,6542,182
20126,4,295,2740,220,6458,75
43571,51,1067,1062,622,17112,445
26594,0,66,2419,59,2756,7
31960,1,62,2138,51,4963,11
34429,6,70,2038,60,4182,10
28427,531,35304,2319,16781,177648,18523
39704,10,683,1708,501,11455,182
31499,42,886,2160,737,6579,149
15212,12,360,2975,343,15743,17
29147,2,197,2280,174,4719,23
19687,42,970,2765,789,8043,181
27520,448,20430,2371,11001,77995,9429
41376,53,577,1553,465,9587,112
20513,11,379,2720,342,3688,37
44152,3,61,930,43,3115,18
31666,244,10983,2152,7796,74922,3187
22051,7,259,2631,130,5474,129
33475,478,7540,2072,5703,31439,1837
20795,2,0,2704,0,9701,0
18583,26,921,2815,709,16816,212
26790,6,155,2410,136,2687,19
37401,0,47,1858,39,3442,8
17856,10,708,2848,556,12131,152
29052,5,51,2285,42,5249,9
18537,5,708,2817,302,9368,406
30286,1,41,2223,35,1680,6
35931,0,12,1946,11,1962,1
30474,8,250,2212,203,4930,47
28124,30,6713,2337,830,23665,5883
43504,128,1972,1085,1661,13409,311
14167,59,2376,3045,2209,26421,167
45281,152,2988,631,2061,37549,927
21990,18,2440,2634,812,13518,1628
23273,180,10922,2571,8340,85887,2582
17464,206,7012,2863,4802,51015,2210
30185,3,96,2228,81,2666,15
22214,39,874,2622,684,10939,190
16076,1,28,2936,28,3205,0
43733,13,240,1005,154,5216,86
18343,7,572,2824,458,4560,114
43099,6,120,1204,73,7256,47
29539,4,234,2260,186,7399,48
28221,1,89,2331,75,1339,14
11128,4,205,3237,201,3916,4
27345,1,165,2382,140,4077,25
30920,86,1900,2190,1504,24626,396
22823,14,378,2593,294,3002,84
29575,8,644,2258,298,7893,346
23318,7,293,2569,246,10603,47
43342,18,297,1134,211,6161,86
23714,1,333,2549,226,3273,107
19864,9,402,2754,259,12774,143
26098,35,815,2442,690,8567,125
15076,22,1013,2982,877,9500,136
41777,57,925,1491,744,8804,181
26599,11,544,2419,460,10398,84
38116,6,374,1810,247,7721,127
25832,7,1123,2454,804,10788,319
35077,5,107,2003,95,2324,12
19265,78,3403,2785,2136,23042,1267
32688,13,600,2104,436,14511,164
36633,18,226,1905,175,3623,51
33941,3,178,2056,96,6380,82
23547,22,1051,2558,579,18478,472
24213,12,219,2527,197,3534,22
41187,34,992,1583,748,10189,244
33292,35,294,2079,255,4867,39
18484,2,139,2818,121,4943,18
18444,23,1542,2820,992,11259,550
25687,1,152,2460,63,3028,89
18625,200,17636,2812,10612,111957,7024
21902,4,63,2640,52,3522,11
37643,2,45,1843,41,4425,4
28949,26,3255,2291,1485,29767,1770
29998,7,769,2238,584,14538,185
20364,4,236,2728,196,7689,40
30357,67,1632,2219,1240,11332,392
32957,79,4453,2092,3606,51306,847
14117,28,664,3046,587,9470,77
26002,6,248,2446,213,1856,35
33803,0,23,2059,22,1953,1
13232,173,10512,3115,9068,104306,1444
42189,47,1053,1414,801,22824,252
17332,1,89,2870,42,5489,47
17384,16,1270,2867,897,18483,373
33211,11,413,2082,193,7074,220
44893,8,80,773,65,2039,15
15618,8,414,2956,333,8688,81
982,5,148,3976,118,7054,30
44019,11,97,952,76,1494,21
14111,139,4605,3046,3588,34947,1017
41454,168,3675,1541,1821,26112,1854
12612,370,19867,3159,15423,145666,4444
14813,2,330,2997,277,11664,53
12092,14,743,3189,724,11408,19
25779,4,224,2456,177,2846,47
21540,5,489,2659,288,10164,201
37165,50,2141,1873,1618,28941,523
11148,9,432,3235,412,10941,20
36178,7,191,1929,157,4076,34
18494,28,1505,2818,894,11578,611
23862,43,1977,2543,1231,23120,746
45006,3,68,739,55,2382,13
19282,85,3605,2784,2402,20551,1203
28769,6,117,2299,108,5866,9
38755,1,99,1765,81,5557,18
27596,4,593,2367,462,4755,131
15705,3,264,2952,204,3137,60
38085,26,983,1813,641,8605,342
25286,3,165,2479,135,4392,30
19693,21,1076,2765,788,20474,288
28506,0,63,2315,56,2583,7
35928,0,35,1946,31,1840,4
40034,3,144,1686,94,7013,50
11406,17,922,3223,739,17276,183
16061,16,706,2937,591,7972,115
23502,1,81,2560,48,3007,33
14216,142,9243,3041,5987,51915,3256
6928,22,821,3489,782,8088,39
24153,6,168,2529,137,2560,31
16727,15,1076,2904,857,16352,219
25413,3,586,2473,380,13421,206
32199,13,338,2124,204,9028,134
22471,5,208,2610,161,15982,47
22425,19,706,2613,584,17507,122
43434,63,1406,1105,1143,23312,263
45844,6,76,444,59,2906,17
26459,0,29,2425,26,1644,3
32057,0,125,2132,63,3313,62
45376,4,29,611,26,1526,3
39082,0,83,1745,70,2749,13
30858,9,251,2192,210,4387,41
41197,8,142,1582,121,3031,21
20021,5,120,2745,80,3058,40
46117,1,36,330,28,1646,8
42602,51,1677,1332,1330,34863,347
25783,1,274,2456,238,14806,36
22965,847,31543,2585,15713,119072,15830
10979,29,1795,3245,1651,17429,144
43097,134,3672,1205,1739,43156,1933
32365,45,809,2117,577,10817,232
22757,3,84,2596,82,1772,2
27692,3,613,2362,412,11493,201
27259,164,4896,2387,3966,22224,930
22098,86,3239,2627,2349,31755,890
14463,17,583,3022,558,18086,25
11864,17,770,3200,599,12833,171
30399,7,258,2216,181,4941,77
42023,0,44,1449,32,5971,12
23168,29,2089,2576,1506,42350,583
24379,1,99,2519,70,2315,29
34416,11,262,2038,146,7998,116
45723,4,52,484,40,5880,12
40411,4,159,1658,115,5667,44
32937,5,172,2093,141,5400,31
10896,66,3623,3249,3201,21094,422
24445,18,730,2516,598,12566,132
13258,15,1036,3113,998,11297,38
36931,178,8982,1888,4781,49231,4201
24919,69,2209,2494,1693,26621,516
35189,1,64,1997,49,3981,15
25822,111,2734,2454,2106,17726,628
35583,10,695,1972,426,8213,269
17863,301,16649,2847,12467,112536,4182
41411,50,1313,1548,1073,11637,240
41921,3,147,1465,120,19036,27
20442,27,1917,2723,1467,19611,450
9079,13,1015,3347,1008,4265,7
23616,26,570,2554,427,2806,143
43741,143,1764,1003,1614,14179,150
28692,32,2682,2303,1647,24923,1035
11617,179,8097,3211,7719,101992,378
36276,13,1916,1924,708,22888,1208
30725,4,291,2198,231,4545,60
20627,5,491,2714,401,6096,90
7357,8,100255,3464,443,5547,99812
40643,14,418,1637,315,6536,103
9357,764,160530,3329,30087,138120,130443
10870,445,21565,3251,16222,137721,5343
8440,1258,88982,3386,61845,621802,27137
34375,3,452,2040,349,15808,103
36254,4,121,1926,109,4266,12
30601,336,15933,2205,10205,78363,5728
16652,0,174,2908,124,4710,50
22633,8,333,2603,263,5378,70
13683,5,432,3081,397,7523,35
41447,182,2907,1542,2529,21096,378
45257,6,65,645,60,1995,5
15133,19,1214,2980,1087,32701,127
9897,78,1394,3301,1314,14220,80
16573,166,8578,2912,6687,57191,1891
28438,16,596,2319,430,4948,166
26650,3,167,2417,130,5972,37
45573,15,188,553,131,2936,57
974,7,619,3979,501,9162,118
32072,42,1032,2131,683,12591,349
28249,51,3221,2329,2489,37225,732
19244,13,440,2786,319,6346,121
43616,7,201,1042,127,7775,74
16870,10,1060,2896,816,16187,244
33198,70,2736,2082,2120,58604,616
26368,9,829,2429,657,17149,172
40989,5,141,1606,123,3697,18
45154,25,296,676,130,4937,166
44858,44,524,780,518,7586,6
37767,32,1226,1834,942,25583,284
21063,28,1137,2688,916,16815,221
43331,203,2789,1138,2262,16022,527
15001,12,1215,2987,616,11165,599
42815,3,56,1282,49,2049,7
28033,10,1007,2342,601,5802,406
26756,342,11059,2412,7760,52956,3299
20980,790,64934,2692,36025,265197,28909
29863,14,408,2244,331,8376,77
40888,64,1194,1614,919,7294,275
14906,109,3350,2992,2397,16579,953
25692,16,362,2460,299,5888,63
36697,0,118,1902,94,7463,24
10020,132,5502,3295,5211,48643,291
34966,3,139,2009,113,4156,26
15777,141,11221,2949,7927,57468,3294
26054,0,0,2443,0,1938,0
38542,110,2640,1779,2117,28416,523
45506,4,52,579,39,1710,13
32808,41,872,2098,635,11219,237
13536,704,26087,3091,19508,84414,6579
31967,3,142,2137,121,4796,21
32851,3,157,2096,91,4203,66
29273,29,1955,2274,639,12174,1316
38159,82,1920,1807,1324,12813,596
13289,5,417,3111,358,7930,59
27098,4,142,2398,120,4857,22
43037,109,2366,1224,1771,33399,595
18765,17,378,2806,316,8678,62
16636,20,1244,2909,991,11929,253
31308,48,722,2171,592,14414,130
43509,4,54,1084,50,2867,4
12897,36,2482,3143,2129,10813,353
19576,18,1444,2770,487,9653,957
8863,130,11272,3360,9349,89995,1923
21996,33,2360,2633,1796,18668,564
16063,9,899,2936,470,33123,429
45500,6,61,580,43,2336,18
21626,33,1613,2654,1010,11302,603
30151,36,1008,2231,657,16638,351
21306,84,3837,2673,2823,41598,1014
36194,12,272,1928,242,4370,30
43838,5,53,978,43,2717,10
24185,10,748,2528,382,7929,366
18092,25,705,2835,539,6378,166
27447,2,85,2376,73,3039,12
36376,1,73,1919,43,3052,30
25555,32,582,2467,446,5775,136
17769,1,64,2851,50,1679,14
18663,1,63,2810,55,1770,8
23371,183,18115,2566,9330,82981,8785
22537,10,956,2606,729,21739,227
20141,56,2124,2739,1659,28164,465
30304,467,16190,2222,9771,108395,6419
30172,6,180,2229,130,2907,50
22524,4,385,2607,233,6313,152
28194,4,297,2332,172,10127,125
24592,12,610,2508,405,7248,205
14524,12,826,3017,573,10084,253
15136,58,2427,2979,2207,23034,220
28713,8,220,2303,179,5512,41
44081,10,217,930,171,5722,46
42945,7,177,1249,142,4463,35
14513,11,451,3018,435,7564,16
44902,85,800,770,694,11510,106
15708,433,16800,2952,12840,82949,3960
24748,25,668,2501,525,11792,143
34557,2,153,2032,136,4223,17
25252,1,46,2480,39,2300,7
36308,12,311,1922,248,12640,63
43146,7,157,1191,98,4782,59
29737,26,549,2251,456,5757,93
19360,21,1023,2781,630,4678,393
33470,30,875,2072,619,15604,256
15108,4,204,2981,190,6623,14
16941,18,1107,2892,902,12392,205
43402,3,54,1114,42,1496,12
42196,39,574,1413,467,8682,107
42142,9,241,1425,196,5249,45
39929,9,305,1694,236,5586,69
38529,152,3813,1780,2922,38719,891
29877,10,282,2243,225,6965,57
42577,17,1642,1337,573,17874,1069
43348,11,254,1134,164,16427,90
25671,22,431,2460,335,3959,96
25095,28,867,2486,692,13202,175
15749,3,918,2950,286,14190,632
36380,1,110,1919,55,3450,55
15369,40,1738,2968,1174,10423,564
27583,107,2170,2367,1733,17449,437
43308,84,1544,1144,956,17129,588
40697,0,0,1633,0,7944,0
41582,5,103,1524,90,4547,13
29836,6,240,2246,192,3030,48
20019,97,1462,2745,1159,10017,303
29470,2,104,2263,85,2506,19
27613,2,72,2366,62,2046,10
40068,7,543,1684,209,6299,334
31003,63,6599,2187,2971,28272,3628
15946,14,1035,2943,808,27007,227
30823,30,1820,2194,1362,38261,458
24839,9,326,2498,190,8850,136
37563,7,470,1847,364,5303,106
6300,28,1212,3517,1093,29742,119
18024,1,64,2838,60,4353,4
40983,81,1928,1607,1407,19571,521
37968,17,459,1819,357,6489,102
35522,25,667,1977,561,11052,106
15549,80,4275,2960,3152,50857,1123
8469,10,481,3384,424,4893,57
21877,36,3897,2641,2902,42262,995
38539,11,345,1780,263,8666,82
28165,3,45,2334,42,3938,3
18119,5,282,2834,210,15351,72
37935,76,737,1821,575,6825,162
42379,10,440,1377,325,8541,115
31489,14,424,2161,318,5473,106
16019,4,329,2939,259,6687,70
26069,11,471,2443,406,22687,65
45019,21,175,736,105,2464,70
14782,9,299,2999,294,7794,5
29210,45,853,2277,703,3230,150
19617,6,247,2768,168,5021,79
14900,13,804,2993,638,4930,166
38716,0,109,1768,65,4009,44
13385,137,7948,3103,5050,45300,2898
41457,1,86,1541,64,4223,22
17493,10,181,2862,153,8861,28
22907,571,44949,2588,29127,179188,15822
37413,480,20219,1858,9093,97881,11126
28828,3,120,2296,77,1502,43
40033,0,141,1686,87,5004,54
14754,44,2331,3001,2047,25733,284
14074,94,4198,3049,3448,38855,750
23558,305,15285,2557,11463,83342,3822
40756,27,494,1626,384,6305,110
39271,7,255,1732,150,5983,105
40605,26,756,1640,580,16731,176
16645,373,28768,2909,19881,160617,8887
28490,166,6363,2316,4649,65189,1714
17786,1,82,2851,67,4790,15
32530,56,1943,2110,1114,33737,829
27872,42,959,2352,537,10914,422
29082,4,313,2283,214,9040,99
37282,67,677,1865,533,8136,144
22037,2,132,2631,114,4916,18
15476,70,1862,2964,1421,25393,441
40608,8,123,1639,102,2826,21
13747,38,2291,3075,1270,50772,1021
32386,3,202,2116,177,4436,25
30705,12,470,2199,367,10770,103
13093,246,12809,3130,10019,46869,2790
14739,91,2609,3003,2327,12081,282
15821,1,234,2947,203,4447,31
36141,3,220,1931,166,3955,54
24548,20,903,2511,542,10989,361
12275,45,903,3178,695,7316,208
46166,9,87,304,78,1250,9
40518,4,205,1648,167,7195,38
43171,3,149,1183,94,4310,55
29286,131,3325,2273,2523,33119,802
21960,79,5747,2635,4202,21670,1545
34165,56,1341,2048,1126,12966,215
29794,102,2321,2248,1721,12532,600
32622,46,1428,2106,937,13082,491
21651,14,514,2653,383,11193,131
42240,37,1331,1403,852,17260,479
20878,0,867,2699,185,8249,682
40816,55,1605,1620,1041,18140,564
14033,33,2938,3052,1413,10838,1525
17145,15,749,2880,618,23193,131
34592,7,228,2030,145,4424,83
41488,6,142,1536,123,3980,19
41955,31,925,1459,730,19065,195
39094,3,65,1744,51,3287,14
29469,4,179,2263,146,3766,33
45650,52,801,521,444,7965,357
43574,78,817,1062,701,12385,116
31341,886,36831,2170,26247,198551,10584
27249,3,195,2388,176,8794,19
13843,6,340,3068,258,6753,82
35536,1,63,1976,51,3606,12
27914,19,686,2348,539,11791,147
36802,30,911,1895,755,12518,156
22602,78,2289,2603,1629,20915,660
35166,22,457,1998,319,4726,138
32617,2,47,2106,40,3419,7
32390,32,670,2116,574,10871,96
39047,43,1018,1747,861,14171,157
14569,155,5214,3014,4472,27650,742
37221,57,705,1869,557,6537,148
40207,1,43,1676,38,4562,5
46023,145,1752,368,1744,14625,8
20225,1,145,2734,115,3364,30
13677,55,4402,3081,2736,38603,1666
36587,0,94,1908,87,3639,7
29415,127,3240,2266,1958,17916,1282
6481,29,2007,3509,1905,17054,102
19878,5,235,2754,204,9941,31
27228,5,347,2390,269,5304,78
38936,1,40,1754,35,6025,5
13518,49,3741,3092,2923,35325,818
9011,18,1143,3352,1142,24497,1
39544,7,210,1718,134,5111,76
44013,33,524,953,359,6002,165
45998,41,755,380,423,12331,332
44872,35,324,778,288,6197,36
22155,36,2444,2625,1536,15876,908
41390,82,2477,1551,1900,35218,577
40497,11,233,1649,192,5284,41
36726,31,433,1901,324,7167,109
27145,309,5999,2394,4783,37052,1216
6665,1208,59980,3501,46249,201994,13731
23301,13,396,2569,332,6500,64
30283,12,291,2223,238,5763,53
18106,6,289,2835,190,9114,99
36495,18,1185,1913,610,59663,575
36590,4,97,1908,71,5446,26
14933,4,170,2991,154,2706,16
26596,0,33,2419,30,1641,3
17337,28,1858,2870,1263,15958,595
17140,0,67,2880,52,2572,15
18604,20,542,2813,441,9770,101
38380,1,62,1791,53,2775,9
40399,18,412,1659,304,4886,108
42649,477,7450,1323,4408,39046,3042
30316,15,716,2221,540,17423,176
35860,2,74,1952,57,4522,17
21578,26,887,2657,730,11944,157
35065,87,1745,2003,1452,21961,293
19365,0,144,2780,111,2223,33
42359,8,393,1381,236,6790,157
27423,0,75,2378,43,3046,32
9926,207,10910,3299,4404,73481,6506
15694,13,715,2953,458,17372,257
40682,7,245,1634,159,5856,86
23263,6,416,2571,301,4705,115
11919,8,609,3197,587,21982,22
42758,19,407,1296,307,5585,100
44755,13,66,814,62,5770,4
35276,50,1026,1992,861,16867,165
43426,2,93,1107,65,5008,28
39410,4,93,1725,60,4627,33
15878,0,4527,2946,2305,15851,2222
39911,5,137,1695,115,3645,22
11531,118,3836,3215,3105,20296,731
42076,15,582,1438,441,12170,141
22944,2,232,2586,182,10098,50
19166,1,162,2790,130,2391,32
17845,2,83,2848,62,2586,21
36529,1,27,1912,25,1901,2
30280,49,1083,2223,881,7115,202
33241,14,748,2081,557,10471,191
31868,0,20,2142,16,1881,4
22025,23,1714,2631,1169,19611,545
39875,3,115,1698,81,7200,34
25299,5,504,2478,396,5531,108
41094,7,148,1593,119,3180,29
26735,79,2982,2413,2181,30952,801
22897,0,75,2589,57,4058,18
24211,14,487,2527,400,6136,87
43027,10,490,1229,345,9796,145
24905,45,8561,2495,500,6316,8061
45898,25,200,426,189,5552,11
41208,4,87,1581,48,2668,39
36047,5,156,1938,141,14354,15
23794,1,116,2546,95,5907,21
23634,19,533,2553,420,6229,113
21089,152,9518,2686,6193,55293,3325
37566,1,46,1847,40,2333,6
33625,1,19,2067,13,2060,6
15335,56,4790,2969,3194,34208,1596
25273,3,303,2479,247,9102,56
25054,0,8,2488,7,5321,1
30910,65,2277,2191,1402,29644,875
43035,87,2173,1225,1544,14898,629
11494,4,233,3217,214,13181,19
44888,39,324,775,274,4906,50
17205,9,240,2877,185,6888,55
45423,34,443,599,427,11818,16
41007,155,4273,1605,2703,80175,1570
20496,31,1974,2721,1528,14546,446
2799,1015,57863,3644,54431,220504,3432
25727,15,500,2458,419,6093,81
13942,30,1314,3058,1004,18455,310
14548,21,995,3016,881,10773,114
23470,6,336,2561,260,7134,76
34399,357,14318,2039,10165,100536,4153
30960,4,195,2189,134,5462,61
45552,27,686,559,358,11166,328
19091,1,34,2793,28,3417,6
5338,184,17262,3561,10218,86107,7044
29368,23,671,2268,494,10580,177
22535,21,2009,2606,1422,33592,587
12817,4,537,3148,452,7984,85
45046,32,325,725,233,6235,92
39264,5,174,1732,137,5662,37
17590,0,2497,2857,813,28607,1684
13756,33,1466,3074,1463,30961,3
29530,125,2736,2261,1902,10627,834
9568,26,801,3316,761,10711,40
41458,46,2350,1541,1299,25492,1051
39849,27,419,1700,352,13438,67
38753,0,173,1766,140,5953,33
35842,1,61,1953,57,3103,4
34949,133,4002,2009,2858,40516,1144
13601,34,1068,3087,887,9244,181
33097,8,398,2086,229,2787,169
40429,11,237,1656,178,5831,59
35475,9,1007,1981,568,11297,439
43484,109,1302,1093,1091,14301,211
36119,39,554,1932,466,6232,88
1257,22,25977,3884,6032,22130,19945
19335,6,333,2782,232,4771,101
21863,49,4400,2642,1602,22760,2798
32128,131,3492,2128,2493,21917,999
36127,3,80,1932,70,2839,10
9379,94,4671,3328,4454,31150,217
38917,19,188,1756,153,3423,35
20760,3,197,2707,121,7455,76
20377,17,569,2727,454,5132,115
14209,2,265,3042,203,7791,62
45408,94,2072,601,840,13661,1232
20541,1,147,2719,127,4157,20
26910,4,147,2404,120,2180,27
8964,576,24605,3353,20120,289997,4485
32013,1,38,2135,29,3820,9
16608,23,527,2911,425,5592,102
45245,9,70,649,54,2786,16
22429,127,9570,2613,4299,73027,5271
15297,60,3134,2971,2015,24990,1119
14594,6,321,3012,249,6522,72
20724,8,226,2709,181,10341,45
33432,9,470,2074,393,5952,77
10383,278,22234,3278,10587,43987,11647
45823,3,153,451,57,2280,96
18507,399,17337,2817,12726,65132,4611
42307,15,488,1391,317,8965,171
24609,15,961,2507,776,12064,185
20843,0,1093,2702,631,10458,462
15605,18,999,2956,752,7911,247
42157,53,1023,1422,839,10873,184
40066,0,1276,1684,926,22782,350
40706,8,298,1632,219,9120,79
33317,11,571,2079,482,11701,89
24415,123,4323,2517,3283,30543,1040
42782,4,497,1290,266,13762,231
29090,1585,165263,2283,59740,453298,105523
21053,2,75,2688,68,5230,7
41811,68,989,1482,645,13306,344
27502,1,107,2372,90,4970,17
13394,67,1521,3103,1319,26156,202
34286,1,75,2044,64,2939,11
16535,25,2255,2914,1656,38414,599
35269,44,836,1992,707,11465,129
41169,262,5518,1585,4053,49946,1465
19245,228,9898,2786,7159,43712,2739
45863,8,130,439,91,6365,39
20476,31,578,2722,476,6984,102
22319,13,433,2618,347,5528,86
36388,200,8897,1918,6585,62835,2312
36681,0,49,1903,39,2058,10
37199,2,66,1870,49,3043,17
24493,3,124,2514,91,3188,33
41799,0,39,1485,34,8306,5
21778,12,466,2646,368,8430,98
16399,86,7852,2920,5399,46814,2453
14659,79,3975,3009,2453,22317,1522
32915,23,1360,2094,973,16383,387
45207,18,177,660,123,3190,54
22235,22,1157,2621,753,15595,404
28037,927,40478,2342,23671,273994,16807
15843,5,610,2947,460,25448,150
32979,21,562,2091,438,12831,124
11974,36,1601,3194,1219,15476,382
43980,17,333,958,225,9693,108
20473,10,297,2722,228,10868,69
26082,28,733,2442,587,10548,146
17417,220,12976,2865,9924,125329,3052
12041,17,408,3191,367,6137,41
24601,2,369,2507,278,5816,91
31466,0,91,2163,72,3491,19
33861,14,379,2058,315,4092,64
22116,8,106,2626,92,2250,14
12390,2,124,3172,67,3896,57
42994,3,193,1236,137,6427,56
31728,53,1769,2149,1367,39356,402
21077,80,4798,2687,3283,40846,1515
20784,60,2470,2705,2006,10513,464
21009,13,508,2690,401,9397,107
13625,18,441,3085,437,4609,4
46195,164,4874,295,2570,25963,2304
24373,1,114,2519,94,3436,20
23886,3,118,2542,96,3934,22
21543,1,129,2659,67,3525,62
20840,25,937,2702,696,6953,241
34188,1,103,2048,55,3605,48
21680,116,7142,2651,3399,48801,3743
36712,6,221,1901,116,2818,105
42083,24,876,1436,676,21554,200
29283,161,2719,2274,1869,16863,850
27157,1,54,2394,44,2461,10
35724,20,668,1961,507,8714,161
44176,50,796,924,712,18183,84
34667,11,585,2025,299,12739,286
36920,11,1589,1888,771,14157,818
22529,4,360,2607,272,5521,88
14982,619,46321,2988,18704,156141,27617
22658,11,749,2601,501,7895,248
32997,15,689,2091,540,13451,149
18571,270,10229,2815,7460,48332,2769
23901,65,1461,2541,1129,6904,332
32253,5,321,2122,268,6497,53
28651,10,490,2305,373,7110,117
39387,3,89,1726,73,3069,16
23825,0,173,2545,145,5918,28
32514,10,718,2111,585,13306,133
30934,249,7798,2190,6092,71600,1706
11085,2,84,3239,71,4632,13
1268,3,78,3881,62,3101,16
31858,13,1956,2142,416,5837,1540
34308,15,681,2043,571,12672,110
20528,111,4491,2719,2309,34861,2182
20319,10,428,2730,343,9407,85
37403,11,251,1858,172,4443,79
13139,42,1954,3127,1680,21174,274
38453,28,1967,1786,779,20861,1188
45469,2,22,588,22,1369,0
17273,0,60,2873,54,2886,6
40004,30,724,1688,570,9354,154
38087,61,1451,1813,775,11530,676
23130,14,1477,2578,1050,5045,427
9387,7,462,3327,453,5351,9
22806,1,205,2594,160,2347,45
44066,103,2010,944,1476,19144,534
18153,6,305,2833,251,5831,54
40998,87,4134,1606,1431,20361,2703
11002,33,2983,3243,1712,24431,1271
32996,24,837,2091,686,10530,151
43575,24,629,1062,278,8564,351
28844,16,259,2295,217,3816,42
32717,5,176,2102,149,4797,27
28693,1,141,2303,120,7191,21
23992,115,6776,2536,4577,36882,2199
39679,286,9979,1709,6943,49702,3036
22638,32,595,2602,484,17245,111
26036,4,162,2444,137,7345,25
29769,12,335,2249,244,4448,91
34376,28,701,2040,560,4277,141
19093,21,828,2793,666,11972,162
41593,88,1544,1522,1244,12185,300
19269,5,232,2785,146,10527,86
16604,2,66,2911,54,2927,12
29067,670,19582,2285,9790,89028,9792
35241,8,178,1993,137,3168,41
20515,13,1204,2720,834,8779,370
13264,70,4815,3113,3199,42185,1616
43300,94,1489,1146,1151,29947,338
12397,97,2380,3171,2098,15420,282
42898,10,304,1263,186,7122,118
31238,124,3574,2175,3051,13586,523
11426,3,142,3222,98,4810,44
38564,2,442,1778,192,5962,250
37766,2,176,1834,134,5628,42
38223,46,977,1802,729,7721,248
31211,0,179,2177,52,3373,127
41283,20,653,1566,515,13978,138
35596,1,30,1971,28,1976,2
20950,114,10213,2694,5814,54876,4399
10928,220,13166,3247,8616,71780,4550
31172,6,159,2178,132,3487,27
19165,17,1106,2790,514,10341,592
29661,5,297,2254,249,19312,48
28865,0,42,2294,33,2701,9
21414,6,168,2667,123,2026,45
24477,99,3203,2514,2603,21286,600
29186,15,582,2279,405,6814,177
26101,111,6908,2442,5115,47757,1793
25651,5,127,2461,105,2561,22
19448,2,145,2775,92,6728,53
43709,25,479,1011,345,7488,134
14037,196,5205,3051,4531,59958,674
32197,20,514,2124,426,11272,88
29091,1,85,2283,70,2145,15
36193,0,101,1928,78,4151,23
38610,1,45,1774,39,4345,6
42607,0,18,1331,13,1314,5
31280,42,1819,2173,1249,12649,570
35363,62,593,1988,495,4633,98
43102,17,498,1204,314,6275,184
38325,19,463,1795,359,9470,104
37919,2,79,1822,56,6124,23
25379,20,564,2474,356,24262,208
2557,3,198470,3648,327,10358,198143
39713,9,173,1708,143,4336,30
17894,275,10732,2846,7569,79077,3163
36486,67,1499,1914,1082,9671,417
32983,4,247,2091,219,8703,28
13716,3,734,3078,612,15285,122
20487,45,3741,2722,2006,18215,1735
29225,4,320,2276,259,7402,61
3585,229,4720,3630,4352,17619,368
32823,1,224,2098,152,5304,72
19533,225,9063,2772,6166,35933,2897
37953,6,293,1820,240,10910,53
36629,60,660,1905,518,6266,142
38506,7,417,1783,133,3208,284
18390,464,61485,2822,15101,324904,46384
19304,93,5807,2783,3525,55871,2282
26407,4,145,2427,130,2560,15
32780,17,253,2100,195,4435,58
19791,16,628,2758,487,8709,141
44221,124,1088,915,899,16834,189
24982,6,271,2491,206,12022,65
27083,2,76,2399,64,3448,12
37740,24,1672,1836,1339,17616,333
23167,2,109,2576,96,5503,13
41073,26,538,1596,293,5728,245
16091,74,5920,2935,4270,46813,1650
32150,87,5495,2127,3148,31146,2347
13859,5,405,3067,393,12845,12
30102,0,51,2233,28,5062,23
37692,64,466,1840,365,4928,101
28978,6,482,2289,376,7001,106
39576,8,376,1715,312,6759,64
26648,0,8639,2417,6220,67608,2419
43740,9,192,1003,105,5823,87
17410,50,4172,2865,3362,27698,810
13459,26,1357,3096,988,15730,369
41344,17,154,1558,144,3544,10
32175,29,1159,2125,868,18688,291
41887,6,373,1470,214,5456,159
15100,2,30,2981,30,2019,0
14283,42,1980,3036,1902,37937,78
42326,5,127,1388,87,4953,40
34712,18,292,2023,141,3058,151
30350,23,374,2219,252,4914,122
38164,11,154,1807,119,2198,35
21440,24,2264,2665,1809,21889,455
12049,113,4936,3191,3156,25619,1780
20952,57,2139,2694,1311,76243,828
20944,22,1019,2694,854,7377,165
12082,612,35566,3189,26628,234346,8938
25860,8,372,2453,267,12903,105
45528,0,54,571,28,2395,26
26585,72,2684,2419,1627,12793,1057
13742,57,1245,3075,952,11982,293
31062,32,1416,2184,540,10819,876
25665,3,221,2460,180,9483,41
26850,0,1895,2407,1539,27802,356
38056,1,148,1815,101,6323,47
13679,44,1106,3081,1098,27375,8
38972,41,1052,1752,808,7239,244
33171,11,245,2083,202,7218,43
32255,5,131,2122,63,2925,68
23888,8,343,2542,278,5662,65
41475,59,1304,1538,976,28260,328
36334,5,228,1921,194,6695,34
39185,34,667,1738,565,7736,102
34462,9,361,2037,315,5677,46
35745,13,365,1960,140,3411,225
26145,25,1120,2440,972,10392,148
27422,1,61,2378,50,1913,11
29816,0,0,2247,0,2012,0
37279,84,1116,1866,894,9942,222
45675,8,71,509,65,3662,6
40038,1,29,1686,24,2742,5
24684,25,1260,2504,612,9786,648
41540,12,136,1530,115,7529,21
44417,2,55,890,42,2424,13
28985,0,54,2289,43,2868,11
25452,12,997,2472,821,42450,176
17557,316,11842,2859,6742,55315,5100
21859,57,1604,2643,1256,10013,348
43534,18,403,1074,306,8790,97
15952,133,8438,2943,5665,34420,2773
10485,81,13908,3273,3463,26373,10445
21501,16,1528,2662,801,17053,727
28499,19,1201,2315,825,23529,376
16934,12,943,2893,640,15307,303
18181,8,416,2832,250,4021,166
16498,9,464,2916,304,7106,160
34630,8,253,2028,187,7227,66
22129,27,1650,2626,1223,14392,427
19499,19,472,2773,357,6541,115
23441,10,291,2562,239,5191,52
14222,18,689,3041,620,7915,69
40461,41,1109,1653,440,9873,669
35719,2,94,1961,80,3552,14
39952,15,668,1692,438,14755,230
39371,71,2621,1727,1271,20070,1350
36237,5,182,1927,149,2266,33
38923,28,1111,1755,733,16077,378
25978,1,21,2447,20,4559,1
35569,9,349,1974,237,5670,112
22518,63,2931,2607,1533,18279,1398
40757,779,53097,1626,10575,159539,42522
19611,17,669,2768,522,5846,147
26454,15,479,2425,310,8984,169
25232,804,21588,2481,17675,82190,3913
22877,70,4142,2590,2048,35616,2094
32208,15,813,2124,653,14456,160
46191,2,60,297,52,1253,8
14951,139,6396,2990,4948,41022,1448
45082,13,218,708,138,4878,80
20170,16,2402,2737,1392,41334,1010
29778,32,735,2248,576,21784,159
38183,61,2537,1806,2001,31594,536
11620,9,282,3211,275,5646,7
28478,52,2848,2317,2232,20493,616
45182,29,365,667,276,8184,89
41461,51,583,1540,431,7605,152
32354,27,1556,2117,1055,28800,501
33488,22,842,2071,565,9244,277
41863,36,308,1473,237,4516,71
35655,8,221,1967,137,3318,84
45759,14,231,472,157,3949,74
37708,7,234,1839,199,3403,35
17985,3,154,2840,125,5647,29
33589,58,1521,2068,1244,9268,277
19374,3,326,2780,249,5402,77
24762,77,3307,2501,2378,29230,929
32771,25,791,2100,639,7529,152
46360,71,995,240,701,12596,294
42506,30,951,1350,640,11613,311
26902,196,9846,2405,5188,49223,4658
29004,6,136,2288,124,6752,12
30237,48,822,2226,705,10347,117
23970,75,2129,2537,1628,17880,501
43770,25,569,993,518,9393,51
36824,11,364,1893,295,10144,69
28297,101,3523,2327,2572,35479,951
26680,27,1842,2415,1072,26025,770
29725,58,2187,2251,1239,19117,948
13889,46,1558,3063,1328,10707,230
35153,2,115,1998,97,2003,18
42618,6,201,1329,162,5717,39
23299,0,3328,2569,1920,50790,1408
23205,0,1454,2574,1123,15371,331
15163,43,1393,2977,1172,16657,221
21609,6,730,2655,538,12633,192
42442,19,336,1364,223,4687,113
13610,36,1986,3086,1886,34485,100
31990,9,308,2136,151,9950,157
20205,88,23439,2735,10750,59759,12689
45382,53,507,610,501,10126,6
34249,1,106,2046,82,3189,24
38052,13,368,1815,285,14799,83
22472,7,230,2610,189,8164,41
24260,12,520,2525,441,10223,79
35331,3,151,1989,106,4903,45
34003,4,258,2053,210,5039,48
43392,9,106,1116,87,2692,19
23523,105,2194,2559,1692,15050,502
35170,21,254,1998,230,4455,24
16942,70,3789,2892,2915,41480,874
31935,19,513,2139,425,14564,88
14622,79,4442,3011,2968,39683,1474
30089,48,1890,2234,1470,33907,420
27734,27,1296,2359,921,12268,375
21643,98,5354,2654,3295,32009,2059
23184,11,931,2576,670,12916,261
17191,50,5581,2877,3793,22143,1788
25382,3,187,2474,153,3315,34
43390,323,6629,1117,5310,49301,1319
21854,8,430,2643,350,6652,80
42877,11,206,1269,178,6735,28
38686,5,188,1769,147,3692,41
23128,5,470,2578,391,5760,79
34964,15,498,2009,412,7065,86
39648,15,618,1711,439,9821,179
10030,432,15866,3294,11712,54839,4154
23186,6,568,2575,471,15480,97
36636,1,38,1905,36,2835,2
39135,175,3310,1742,2875,17558,435
25281,0,58,2479,53,2643,5
12798,159,11005,3149,9087,85637,1918
26909,2,164,2404,139,2107,25
12556,459,20162,3163,14933,80362,5229
38646,6,207,1772,161,11347,46
33782,1,41,2060,39,2356,2
22176,52,1883,2624,1475,25265,408
33090,1,223,2086,183,4072,40
25655,86,4184,2461,3256,23109,928
41636,8,272,1515,198,7693,74
14765,75,4745,3001,3878,19392,867
18695,39,1364,2809,1049,10242,315
30602,3,95,2205,71,3153,24
12418,27,662,3169,652,16502,10
32538,3,189,2110,128,10185,61
22631,12,707,2603,314,8610,393
33257,82,1754,2081,1406,11341,348
41414,10,222,1547,172,2772,50
32416,5,87,2115,74,4544,13
31591,41,1335,2156,972,19220,363
16562,10,408,2913,348,3728,60
35272,393,49842,1992,10501,157962,39341
36405,2,44,1918,25,3128,19
21140,77,1564,2683,1212,11259,352
36655,2,67,1904,54,3095,13
33134,34,884,2084,734,14317,150
15539,1,65,2961,51,3345,14
45180,75,906,667,436,9843,470
35983,11,595,1943,495,12376,100
10194,218,9659,3286,8434,65630,1225
25560,1,44,2467,39,2474,5
31057,9,534,2184,441,12085,93
10490,43,2120,3272,1091,30080,1029
19967,3,250,2748,219,4093,31
29688,546,29971,2253,12405,135635,17566
29182,5,213,2279,171,3919,42
20540,11,358,2719,264,2121,94
42748,34,2532,1299,912,18739,1620
40450,15,613,1654,454,19326,159
14119,243,24485,3046,14831,129701,9654
28897,4,502,2293,389,11284,113
45280,15,209,636,146,6647,63
23074,6,233,2581,187,5659,46
24432,59,2024,2516,1467,13224,557
44788,60,519,805,319,5951,200
12776,5,879,3150,756,14971,123
25363,9,492,2475,373,9809,119
13674,0,496,3081,374,7932,122
35226,2,28,1995,26,3472,2
25314,465,8507,2477,6829,31150,1678
11487,51,5120,3218,4402,38564,718
38829,10,677,1761,279,12940,398
13798,57,3750,3071,2663,109129,1087
13216,6,493,3115,489,6422,4
36175,12,266,1929,233,10845,33
22247,57,2512,2620,1598,24338,914
34166,2,89,2048,79,3334,10
22761,7,161,2596,126,6485,35
43142,4,108,1192,64,3245,44
16776,4,343,2900,168,3940,175
17621,488,99175,2856,21199,143639,77976
31250,1,105,2175,87,2021,18
36011,10,390,1940,298,9341,92
39832,119,2143,1701,1541,21610,602
26096,9,951,2442,488,8851,463
14736,72,2250,3003,2063,18096,187
35038,6,225,2005,179,7390,46
17068,3,202,2884,178,6521,24
25326,52,1363,2477,1062,17392,301
11778,2053,96368,3202,70465,411988,25903
25777,66,4063,2456,2825,25932,1238
27847,10,175,2353,142,1802,33
24707,56,1833,2502,1415,20546,418
24523,11,731,2512,509,6631,222
10471,25,1450,3273,1258,9663,192
27210,79,1629,2391,1143,10029,486
42275,8,215,1396,175,3973,40
15809,23,1283,2948,960,18402,323
8211,33,1089,3401,845,10196,244
20348,274,11057,2729,8271,61873,2786
34541,4,436,2032,370,25370,66
33793,25,2455,2060,1175,21126,1280
42559,0,0,1341,0,6149,0
27296,8,585,2385,215,8483,370
20689,9,422,2711,343,4189,79
18861,177,8924,2802,6773,82926,2151
34550,14,281,2032,204,4278,77
25050,148,4635,2489,3509,41494,1126
40592,5,88,1641,72,2357,16
29767,13,317,2249,275,9122,42
19415,19,3402,2777,1012,23054,2390
39624,77,2066,1712,1584,19039,482
15783,1,65,2949,58,3304,7
34345,1,41,2042,22,1817,19
36981,238,9076,1884,6536,73605,2540
31196,73,4898,2177,3716,37300,1182
7819,7043,451578,3436,207396,1256808,244182
28537,915,56207,2312,21091,157289,35116
31626,9,395,2154,311,10634,84
9322,246,12175,3332,10214,64852,1961
28369,8,365,2323,300,5560,65
20219,10,255,2734,157,12895,98
27646,18,486,2364,348,5945,138
19284,0,573,2784,463,5393,110
45928,9,119,409,107,4872,12
35682,12,233,1964,197,2596,36
33381,218,11070,2076,5311,60908,5759
36530,4,81,1911,74,3901,7
23701,4,225,2550,206,11483,19
40130,198,4767,1681,3786,37983,981
26033,30,758,2444,626,16475,132
41477,65,857,1538,825,9853,32
41857,4,99,1475,87,2904,12
15259,5,158,2973,157,5868,1
18291,26,1781,2827,1298,27021,483
31694,6,285,2150,221,6164,64
32293,48,1530,2121,1252,16971,278
22010,5,213,2633,130,4526,83
42858,20,550,1274,405,12011,145
16810,4,268,2898,226,5038,42
31650,23,424,2152,319,5484,105
12299,90,7854,3177,5604,70990,2250
18379,3,487,2823,393,7455,94
37276,6,264,1866,229,7145,35
24301,1,464,2522,319,13965,145
42604,19,490,1332,353,7190,137
38255,70,1554,1800,1282,12013,272
36185,10,220,1929,172,11524,48
18696,21,1500,2809,1059,20817,441
35759,20,630,1959,436,14032,194
37739,7,783,1836,242,18275,541
43601,50,876,1049,729,21633,147
19095,14,558,2793,308,10657,250
42262,15,114,1400,89,1853,25
12837,2,517,3146,470,14374,47
35444,172,7184,1983,5078,63870,2106
40859,21,526,1616,410,10409,116
39698,1,69,1708,51,2772,18
21322,0,382,2672,322,2538,60
22521,1,64,2607,56,2555,8
27079,197,19869,2399,8473,102961,11396
31848,32,889,2143,692,9879,197
43730,21,201,1005,186,9820,15
16715,4,230,2905,199,11429,31
25483,5,376,2470,305,7504,71
1107,1,80,3933,68,5617,12
46144,9,135,316,127,3807,8
23706,14,1594,2550,855,27480,739
26692,1,171,2415,132,6024,39
35959,48,621,1944,487,7235,134
40224,67,2593,1675,2130,23084,463
23691,10,229,2550,166,5247,63
9668,3,267,3311,251,3686,16
31179,61,4426,2178,1643,24339,2783
31274,17,1091,2173,552,15748,539
39048,38,713,1747,523,6134,190
35129,0,93,2000,72,5217,21
40137,3,57,1681,45,3025,12
15648,173,15188,2955,3507,37252,11681
13198,10,551,3116,525,6683,26
20046,118,6119,2744,4636,34184,1483
34844,34,2070,2015,1739,8782,331
18165,2,111,2832,89,2916,22
19880,17,868,2754,582,9268,286
15430,4,307,2966,157,5100,150
19489,77,6194,2773,2864,29658,3330
43066,4,64,1215,51,1605,13
15443,331,25816,2965,18362,188144,7454
36169,62,1540,1929,1317,7370,223
17869,110,3046,2847,2261,15479,785
33717,6,381,2063,309,6181,72
7385,135,7381,3463,6838,49368,543
17629,98,5289,2855,3919,45166,1370
35900,16,256,1948,225,7255,31
32363,169,7290,2117,5680,41003,1610
20449,6,168,2723,117,3154,51
22959,141,11949,2585,6623,53296,5326
46284,0,18,271,13,1960,5
39682,3,98,1709,50,2874,48
21731,10,1123,2649,676,19101,447
34737,1,36,2022,23,1451,13
15422,3,262,2966,205,6392,57
29189,6,303,2279,219,7718,84
40593,229,6283,1641,4088,38809,2195
30865,8,368,2192,173,5733,195
29220,13,579,2277,443,21634,136
15691,18,1363,2953,1051,13504,312
24114,51,1931,2531,1547,18418,384
45520,276,3490,573,3386,17927,104
7269,238,10250,3470,9147,56139,1103
19965,22,541,2749,465,19049,76
21693,742,38301,2650,15955,178606,22346
21913,61,1622,2639,1282,4809,340
45609,130,1421,544,1268,12050,153
26551,83,3349,2421,1330,21381,2019
14843,0,86,2996,77,5545,9
31081,11,367,2183,316,16985,51
36216,22,365,1927,239,7911,126
11417,99,5966,3223,5053,82008,913
10419,15,0,3276,0,51951,0
45532,59,996,569,695,9094,301
16151,1,129,2932,101,3985,28
45259,20,752,644,361,9598,391
13067,170,12026,3132,10491,102337,1535
15023,2,232,2986,214,8417,18
24677,77,2838,2504,2095,14938,743
32071,15,510,2131,298,4285,212
17455,34,1545,2864,911,14071,634
9187,436,21244,3340,16988,91583,4256
45197,335,4408,662,2836,36845,1572
21821,32,1718,2644,1272,18925,446
34068,10,291,2051,242,4245,49
43637,18,238,1036,185,7085,53
19198,7,409,2789,305,9918,104
39936,259,7575,1693,3760,33913,3815
19998,23,513,2747,414,7892,99
28057,8,341,2340,218,5006,123
34959,10,436,2009,306,7412,130
26673,21,628,2416,473,5330,155
37912,6,86,1823,72,6064,14
40269,36,1106,1671,427,16123,679
39810,3,100,1702,75,4758,25
39400,26,242,1725,194,3812,48
32315,4,105,2119,94,4359,11
38954,1,81,1753,62,3805,19
15020,24,258,2986,238,5563,20
18014,5,358,2839,277,5518,81
13695,106,4929,3080,4063,49903,866
37127,24,608,1875,495,14874,113
22095,5,264,2627,149,2845,115
24861,38,1324,2497,1041,15598,283
22781,7,228,2595,179,4070,49
17727,0,213,2853,185,4256,28
46074,9,145,342,124,2361,21
39224,34,425,1736,361,9774,64
25334,0,42,2476,34,3065,8
19803,8,263,2758,191,4311,72
22207,0,156,2623,128,3417,28
18354,14,859,2823,696,7760,163
26728,6,124,2413,109,8630,15
19050,3,101,2795,84,1773,17
17697,11,779,2854,352,14476,427
17733,0,94,2852,77,4149,17
21368,88,9537,2669,3893,42798,5644
36571,10,242,1910,187,10135,55
39715,23,403,1707,320,6036,83
40324,78,2914,1668,1539,32728,1375
27301,57,13066,2385,1685,43195,11381
18816,21,1233,2804,943,19155,290
39057,2,34,1747,28,4448,6
15157,15,14120,2978,1059,12522,13061
43704,30,489,1013,331,8541,158
9445,105,6173,3324,6083,43007,90
30444,5,255,2213,184,4040,71
43049,21,232,1221,213,5125,19
41184,17,979,1583,746,22273,233
37903,87,2053,1824,1426,18134,627
14805,850,74783,2997,32558,211418,42225
40184,29,637,1678,497,6257,140
11792,1,85,3202,82,4947,3
19574,5,319,2770,255,3737,64
42591,75,1379,1335,1038,12299,341
20650,27,2127,2713,1018,17072,1109
37377,1313,117087,1860,50189,387930,66898
28050,84,1087,2341,833,7207,254
24980,0,2115,2491,810,21914,1305
20402,7,553,2726,438,11822,115
46282,7,180,272,118,5878,62
33424,68,1541,2075,1220,12447,321
5643,2344,137938,3545,113541,524989,24397
33269,94,3949,2080,2552,34141,1397
12536,238,14030,3164,11990,161710,2040
44879,17,291,776,251,5137,40
22515,0,77,2607,46,3516,31
41051,11,306,1600,237,6007,69
31368,2,64,2169,56,3977,8
15667,7,319,2954,253,5713,66
43765,2,83,995,54,2989,29
26897,9,264,2405,223,2790,41
37417,2,50,1857,47,2234,3
45128,13,123,682,86,4518,37
36592,625,23769,1908,16014,178681,7755
36969,8,784,1885,154,11639,630
38267,2,104,1799,62,3788,42
16012,12,1835,2940,1483,22092,352
29143,5,220,2281,164,4116,56
33627,109,3206,2067,2311,19979,895
9348,27,2065,3330,1604,13531,461
45760,134,1399,471,1276,14460,123
25459,0,1059,2471,806,15706,253
36598,0,102,1907,94,3408,8
18761,95,16448,2806,10278,213212,6170
11039,115,5817,3242,4764,34954,1053
34482,1,108,2036,97,10975,11
40279,442,14454,1671,10331,81351,4123
20335,174,5382,2729,3584,34139,1798
21124,12,706,2684,572,22119,134
37449,53,1171,1855,737,13925,434
36414,89,4429,1917,1943,43236,2486
42413,17,411,1371,290,9494,121
43532,77,898,1076,662,12040,236
10337,15,754,3280,712,10539,42
36960,9,293,1885,188,3975,105
7157,3,253710,3475,108,6184,253602
44723,16,164,825,153,6005,11
32574,7,319,2108,258,4348,61
9973,20,922,3297,823,7925,99
30768,27,673,2196,497,7792,176
46378,4,82,229,80,1476,2
26863,4,479,2406,406,6928,73
21326,1,72,2671,60,8668,12
3157,17,210396,3638,809,7283,209587
14774,44,3426,3000,2150,36521,1276
37170,8,316,1873,187,8343,129
23678,177,5823,2550,4423,69588,1400
4472,64,2935,3602,2802,17778,133
35306,68,2154,1990,1260,20430,894
29697,33,1485,2252,1103,25899,382
36775,20,636,1897,257,7801,379
39768,0,0,1705,0,5138,0
26352,188,6877,2430,4357,30454,2520
31390,223,11497,2167,6070,58001,5427
17585,10,458,2857,365,13011,93
14723,892,50094,3004,30515,254952,19579
39221,19,654,1736,481,17428,173
39417,39,583,1724,461,13635,122
27631,23,953,2365,569,8524,384
46066,1,60,345,44,1291,16
38965,15,619,1752,471,9099,148
15415,29,1307,2967,832,6366,475
43750,15,236,1001,182,4499,54
8830,19,609,3361,566,6691,43
37638,23,375,1843,304,6705,71
36780,10,192,1897,157,9394,35
26747,11,897,2412,648,18036,249
15167,40,1723,2977,1123,13900,600
45394,15,225,606,153,4161,72
25225,11,326,2481,276,5459,50
26561,1,66,2420,55,2393,11
14192,326,9482,3043,7855,65240,1627
17924,72,3482,2844,2683,67577,799
11953,9,390,3196,383,4537,7
29940,5,127,2240,107,2215,20
28304,42,1549,2326,1204,12551,345
42330,5,130,1387,105,8147,25
19175,25,1906,2790,1122,19052,784
19346,55,4524,2781,1664,23809,2860
19972,29,3407,2748,1936,15673,1471
19279,4,136,2784,108,5163,28
38389,5,307,1791,183,3412,124
36155,2,139,1930,87,3796,52
45665,61,684,513,657,17126,27
30346,15,642,2219,532,6227,110
10739,16277,679642,3257,371707,1452097,307935
21650,6,705,2653,227,8344,478
19197,7,262,2789,170,3609,92
41302,7,337,1563,256,8811,81
26088,2,258,2442,213,7957,45
44819,6,87,793,62,2798,25
24712,44,3126,2502,2381,31014,745
15555,48,1628,2960,1114,6968,514
37750,5,161,1835,134,4030,27
20714,4,274,2709,188,5458,86
43109,7,385,1202,253,14642,132
22325,1,58,2617,46,2265,12
45148,2,46,676,30,3047,16
21537,8,632,2660,529,8409,103
36680,1,37,1903,29,2298,8
26443,35,2028,2425,1467,28014,561
25928,3,173,2449,125,4825,48
25572,9,162,2466,136,5045,26
39514,1,75,1719,56,6822,19
17876,17,708,2847,517,35683,191
41328,20,428,1559,339,4851,89
16536,12,912,2914,702,9667,210
16249,2,159,2928,123,6506,36
25881,15,677,2452,426,7887,251
15693,16,943,2953,668,6991,275
16401,335,14684,2920,10320,145049,4364
26196,402,8708,2437,5088,42058,3620
34077,4,132,2051,93,4574,39
25055,49,2488,2488,1750,18875,738
19990,13,469,2747,350,7342,119
42270,2,81,1398,62,3864,19
38673,4,362,1771,280,7076,82
16623,8,749,2910,537,8375,212
40615,22,885,1639,291,12497,594
35902,8,486,1948,321,9594,165
14471,124,4102,3022,3452,21198,650
44070,3,31,944,22,1683,9
21111,100,3604,2685,2823,28054,781
24488,0,227,2514,182,5922,45
7451,97,6210,3459,5080,44544,1130
8033,492,20352,3410,16967,51211,3385
40309,51,1602,1669,1121,14880,481
36564,0,114,1910,105,2735,9
40125,36,2206,1681,954,19461,1252
26252,65,2973,2435,2343,35886,630
30426,7,280,2214,235,7840,45
40203,13,421,1676,332,5003,89
13961,1,98,3057,91,3164,7
45752,10,145,475,126,3264,19
6536,198,8552,3506,8485,52097,67
12268,35,1634,3179,1557,36882,77
26792,34,1812,2410,969,13261,843
33924,2,574,2056,433,13097,141
14779,6,138,3000,124,2929,14
40442,9,222,1655,179,3520,43
37894,420,17539,1824,9104,101370,8435
15849,2,155,2947,104,5912,51
24393,6,205,2518,140,5715,65
23117,75,2153,2578,1777,47051,376
37356,49,2840,1861,1090,22145,1750
40538,7,439,1646,343,12080,96
21745,7,156,2648,138,3344,18
40890,23,340,1614,269,2988,71
31483,13,437,2162,346,8083,91
31915,12,375,2140,314,5961,61
15288,7,321,2971,302,18574,19
12375,29,1677,3172,1346,24016,331
38999,148,5701,1750,2857,41027,2844
26471,1,95,2425,84,5187,11
40683,32,870,1634,512,14904,358
20914,51,1836,2696,1240,19594,596
30431,8,161,2214,126,3349,35
41641,46,1569,1514,1207,28608,362
41148,3,162,1587,118,4315,44
41176,1,20,1584,18,4058,2
34757,4,152,2021,124,13155,28
43867,4,64,977,45,2232,19
40549,883,24679,1645,11433,126317,13246
27820,2,74,2354,50,2585,24
19553,69,9047,2771,3575,48654,5472
23726,39,2286,2549,1825,25334,461
17722,6,184,2853,147,2678,37
34947,20,502,2009,431,10009,71
20250,4,370,2732,289,9661,81
21055,170,7508,2688,4253,29662,3255
40002,33,470,1688,374,8678,96
42781,123,2346,1291,1592,31036,754
29458,111,4322,2264,2895,31618,1427
32203,5,71,2124,61,2435,10
14287,17,649,3035,494,12669,155
16883,57,2091,2895,1646,17646,445
19227,1,39,2788,32,4012,7
30157,21,698,2231,590,13039,108
20202,19,197,2735,157,6819,40
15640,19,841,2955,640,7461,201
20530,80,2526,2719,1726,11580,800
19112,3,54,2793,40,2944,14
17892,11,1154,2846,918,15609,236
29282,8,334,2274,201,4272,133
24957,11,968,2492,317,12984,651
24136,8,321,2530,272,10416,49
17361,17,765,2868,640,14842,125
14250,63,1821,3039,1416,18986,405
23880,7,178,2542,148,3719,30
33690,71,2104,2064,1401,11506,703
35705,1,56,1962,44,3765,12
43723,102,1428,1007,1149,12812,279
17380,1,121,2867,108,4405,13
15677,306,12715,2954,8821,47627,3894
11189,701,28353,3233,24967,96775,3386
30035,50,1728,2236,1299,13186,429
17644,117,10815,2855,3245,42509,7570
45526,0,16,572,14,1642,2
22500,58,757,2608,749,9519,8
31560,15,1980,2157,1122,19525,858
22070,4,316,2629,215,11522,101
45997,54,1208,381,813,12244,395
15813,3,640,2948,383,9983,257
20774,28,620,2706,490,9432,130
33055,1,118,2088,80,4051,38
46073,12,173,343,98,1209,75
34079,188,7238,2051,5025,41418,2213
39764,8,230,1706,153,6336,77
17474,3,130,2863,114,3019,16
44804,8,82,798,65,4475,17
23535,15,1264,2558,915,16772,349
27762,4,331,2358,158,13533,173
19285,70,3136,2784,1432,13723,1704
22274,0,44,2619,38,3280,6
37877,57,740,1825,344,6969,396
15966,22,743,2942,485,12014,258
13066,39,1182,3132,1096,7312,86
32746,10,357,2101,243,5932,114
40900,2,70,1613,63,10839,7
18616,312,13985,2813,9528,87729,4457
35568,0,24,1974,18,4705,6
34413,21,444,2038,386,5143,58
38980,298,11345,1751,4979,39962,6366
41689,36,395,1507,319,6762,76
38217,3,126,1803,104,4193,22
16187,13,274,2931,207,6599,67
33045,6,125,2089,110,3707,15
29339,3,298,2269,222,5121,76
25717,15,625,2458,510,5849,115
15760,5,325,2950,275,5024,50
13453,209,13245,3096,10156,93281,3089
32902,3,77,2094,59,3715,18
16791,8,405,2899,263,3099,142
35557,16,410,1975,340,5428,70
36046,15,196,1938,176,1632,20
37326,1,83,1863,53,4403,30
15094,17,1006,2982,821,13766,185
22801,21,773,2594,569,6944,204
41018,10,230,1604,178,6542,52
18503,7,461,2817,391,8768,70
18523,1,148,2817,142,3063,6
38583,14,331,1777,238,3135,93
36478,20,801,1914,628,5187,173
37761,40,1145,1834,825,16297,320
38311,11,391,1796,314,11676,77
16560,70,1722,2913,1169,18025,553
19292,1,106,2784,65,3091,41
38478,6,326,1785,271,10817,55
10995,4,121,3244,117,2908,4
42268,52,1753,1398,998,29497,755
18585,41,1163,2815,958,11539,205
21062,92,5379,2688,3558,32080,1821
32267,88,2035,2121,1512,14383,523
10466,126,4124,3273,3130,32076,994
22737,54,2754,2597,1991,28991,763
38705,44,1372,1768,819,16590,553
12649,3,559,3157,558,14069,1
44667,28,262,845,239,7282,23
30571,3,85,2206,70,1765,15
24443,1007,111831,2516,43131,321169,68700
32144,31,1209,2127,1001,15461,208
40621,51,1236,1639,743,18302,493
20004,0,1061,2746,683,14953,378
17054,79,8435,2885,5235,43156,3200
37510,64,2022,1851,1131,18942,891
19331,421,31200,2782,17922,100600,13278
16871,175,13683,2896,9950,111517,3733
40820,8,157,1620,132,4670,25
40340,23,954,1666,756,22200,198
39550,758,30407,1717,14954,200327,15453
27729,11,420,2360,302,7064,118
10384,24,1277,3278,999,21734,278
30013,20,636,2237,415,7453,221
24726,43,3357,2502,2274,25518,1083
27382,4,65,2380,54,2865,11
12965,79,1942,3139,1578,46404,364
41430,7,243,1545,177,7311,66
12184,94,7210,3183,5843,76306,1367
45786,0,27,464,18,1994,9
20351,24,488,2729,379,4085,109
17333,101,5447,2870,3392,62200,2055
17814,1,89,2849,72,4943,17
21634,27,894,2654,499,11016,395
26155,3,195,2440,171,4194,24
45968,6,71,391,60,1598,11
13163,13,656,3118,540,8060,116
33994,95,2562,2053,1663,13516,899
14256,2,81,3038,80,6328,1
19378,23,799,2780,640,11323,159
24526,10,322,2512,284,5452,38
23732,18,740,2548,411,7861,329
46024,6,90,367,71,3565,19
35794,0,17,1956,15,1713,2
19126,5,829,2792,307,11619,522
40819,7,116,1620,98,3377,18
15252,10,231,2973,207,4813,24
42749,42,1148,1299,502,11865,646
43095,9,114,1205,67,3871,47
24243,9,243,2525,184,5540,59
25667,1,88,2460,75,3820,13
18278,27,757,2827,584,5275,173
19511,14,919,2773,716,15066,203
20893,0,129,2697,105,8620,24
41126,7,234,1589,183,9190,51
43363,7,110,1127,76,5820,34
16312,52,3216,2925,2404,50106,812
15050,8,339,2984,319,4407,20
36381,1,125,1919,104,6094,21
25291,1,69,2478,59,3547,10
25215,7,632,2481,494,4948,138
34025,75,4796,2052,3097,41702,1699
18979,85,2339,2798,1374,11536,965
25853,5,460,2453,350,7640,110
12319,55,1673,3176,1307,11111,366
30453,14,1272,2213,460,10262,812
45501,6,192,580,111,3478,81
1116,5,264,3930,216,6378,48
17498,43,2057,2862,1192,22118,865
16920,0,4391,2893,3425,40461,966
17713,4,350,2853,272,4116,78
42039,26,1012,1445,611,15944,401
25073,44,2116,2488,1223,9149,893
33583,13,701,2068,507,6925,194
43588,21,320,1056,225,3407,95
23244,0,2646,2572,1934,38261,712
28283,14,591,2328,283,5531,308
45202,40,452,661,346,7864,106
25708,6,130,2459,91,4583,39
6150,204,16808,3523,13021,48264,3787
20687,9,189,2711,147,5650,42
30771,81,2700,2196,1963,14816,737
9671,24,578,3311,545,4517,33
33957,59,1069,2055,842,15567,227
5398,25,794,3558,632,17881,162
26557,1,77,2420,62,2465,15
44486,8,67,879,46,4570,21
37914,6,213,1823,163,5663,50
12992,4,272,3136,262,5413,10
44679,44,443,840,390,5913,53
17581,1,116,2857,101,10316,15
16546,29,3520,2913,1053,17805,2467
39474,152,2431,1721,1734,20546,697
28757,0,44,2300,38,1866,6
32953,11,654,2093,356,10442,298
19895,26,1220,2752,947,21267,273
28329,56,1638,2325,1036,14996,602
26380,6,310,2428,259,6344,51
23404,248,15394,2564,10178,48702,5216
44917,15,153,764,130,2733,23
35342,50,5215,1989,859,21192,4356
40211,146,6023,1676,2688,40455,3335
24321,4,192,2522,159,4225,33
18348,2,91,2824,71,4086,20
41645,86,916,1513,713,11511,203
17143,53,1685,2880,1153,13003,532
14276,87,2287,3037,1906,15901,381
28987,25,1392,2289,905,9825,487
40055,77,1867,1685,1438,17732,429
25343,37,1119,2476,909,7060,210
42523,10,135,1347,102,3200,33
17119,27,989,2881,696,6823,293
15311,139,6337,2970,4574,16039,1763
35620,14,448,1970,285,13159,163
43756,26,192,999,167,3197,25
16554,53,1808,2913,1562,19055,246
36994,111,3131,1884,1815,19148,1316
34798,32,1047,2018,824,18270,223
20995,1,73,2691,63,2640,10
23964,12,1559,2537,1219,18485,340
30084,79,1914,2234,1345,22467,569
43459,77,1312,1099,1009,29071,303
32540,8,290,2110,231,3846,59
25689,0,9927,2460,5461,39713,4466
34743,91,2278,2021,1750,25497,528
42318,4,109,1389,85,5689,24
13204,37,812,3116,687,7047,125
28313,35,731,2326,608,15986,123
16259,113,3794,2927,2790,22025,1004
38098,39,1884,1812,850,10538,1034
39756,1026,37285,1706,21742,271073,15543
30900,29,3269,2191,1533,15740,1736
34130,128,1952,2049,1523,15549,429
45445,38,334,592,302,12399,32
30269,8,440,2224,364,15096,76
40995,9,146,1606,119,5073,27
24541,216,12001,2511,7969,56189,4032
36115,6,469,1932,243,5210,226
38573,87,2785,1777,2159,29613,626
16571,27,1496,2912,1142,13548,354
28616,224,14285,2307,10006,93491,4279
38822,3,55,1761,46,1976,9
41520,9,190,1533,151,4508,39
23495,9,436,2560,353,5663,83
28938,564,22554,2291,16335,153104,6219
23553,0,35,2557,18,1975,17
42922,61,1737,1256,855,10919,882
36887,163,5557,1890,2134,22331,3423
25475,14,334,2471,205,5033,129
41451,7,175,1541,137,2337,38
15650,2,41,2955,37,2359,4
11080,40,756,3240,755,4589,1
45559,1,18,556,9,1859,9
40335,22,849,1667,650,15250,199
18951,16,331,2799,275,6303,56
32198,20,1077,2124,578,14459,499
28907,3,105,2293,90,5896,15
40771,37,681,1625,518,8257,163
19293,31,2745,2784,2003,37016,742
45830,21,181,448,176,5121,5
15380,18,904,2968,771,13037,133
44455,90,1222,884,968,21421,254
22365,122,5855,2615,4066,44143,1789
43645,30,391,1033,352,7663,39
41829,9,664,1478,384,17794,280
29495,416,20811,2262,14181,119159,6630
36078,13,1082,1935,694,11470,388
44422,16,129,889,112,4197,17
44629,1899,89342,854,32996,292697,56346
39961,92,3034,1691,1969,32305,1065
18846,621,36526,2802,22374,166335,14152
41903,42,874,1467,481,9123,393
16849,42,3060,2897,2244,22783,816
19380,68,1816,2780,1285,13177,531
42851,3,140,1275,133,9262,7
28511,21,497,2314,352,5586,145
42179,74,2709,1417,1888,38140,821
34742,4,144,2021,116,5236,28
25634,40,5697,2462,3200,32921,2497
11438,9,768,3221,525,16463,243
36150,35,898,1930,737,26045,161
36664,39,1664,1904,1253,15662,411
13786,286,23952,3072,11847,135841,12105
29243,109,2566,2276,2128,23126,438
22542,3,149,2606,99,2609,50
27961,3,222,2346,189,3935,33
45024,12,125,735,115,7961,10
22647,10,847,2601,385,6864,462
19595,547,30262,2769,21157,182950,9105
39684,4,69,1709,57,4858,12
32285,0,25,2121,20,1898,5
35904,5,137,1948,113,3482,24
18546,95,4640,2816,3054,25184,1586
20520,14,526,2720,421,11316,105
35110,1,25,2001,24,5040,1
32645,0,93,2105,75,6071,18
40835,29,833,1619,601,14343,232
21356,4,236,2670,192,8886,44
20789,22,717,2704,456,5461,261
36106,23,391,1933,328,8017,63
28655,31,1011,2305,620,18551,391
36806,3,126,1895,93,4252,33
14530,3,187,3017,160,3280,27
16756,9,365,2902,258,9316,107
20728,45,1481,2709,1122,12016,359
10210,62,3334,3285,2776,18513,558
33276,320,5923,2080,5236,61175,687
46267,5,80,277,69,2949,11
25151,24,662,2484,563,5005,99
12987,16,746,3137,706,7857,40
28240,1,157,2330,137,2168,20
25188,0,212,2482,102,4061,110
34109,106,4114,2050,3016,15676,1098
11436,661,34002,3221,15441,78122,18561
18724,19,929,2808,533,10923,396
28021,6,293,2343,243,5498,50
41260,23,715,1570,563,21859,152
37293,2,78,1865,66,4451,12
5976,45,1993,3529,1930,6936,63
37519,2,232,1850,190,12533,42
37859,5,70,1827,66,2484,4
40368,2,61,1661,48,10536,13
36028,6,157,1939,126,3536,31
26371,0,47,2429,45,2246,2
39373,21,878,1727,635,17406,243
1013,1,7,3965,5,1808,2
13068,0,113,3132,108,8437,5
14485,28,2684,3020,2062,23860,622
8209,287,16698,3401,11058,39040,5640
42421,17,871,1368,621,10317,250
25352,16,911,2476,724,7717,187
37107,1,57,1877,49,2274,8
8740,2,178,3367,152,5556,26
17826,36,1418,2849,723,9044,695
43849,11,96,978,74,2357,22
20129,20,863,2740,653,13207,210
40227,4,233,1674,184,6634,49
44140,364,5639,932,4438,52065,1201
14014,23,1610,3052,1225,26864,385
18111,77,3036,2834,1199,23547,1837
22167,105,13208,2625,5972,59521,7236
28127,39,1187,2337,791,7373,396
13017,732,27033,3135,18004,185095,9029
7568,140,5413,3452,4981,54552,432
11557,8,84029,3214,374,4881,83655
43244,38,676,1162,558,15508,118
13127,18,695,3128,590,11035,105
36927,9,280,1888,206,13206,74
40182,20,515,1678,368,7021,147
24527,38,1356,2512,1019,5650,337
18612,1,113,2813,90,1961,23
31575,58,1755,2157,1372,18713,383
20350,5,249,2729,206,6412,43
41355,10,244,1556,167,5845,77
42431,14,591,1366,396,9203,195
18430,286,12241,2820,7829,52253,4412
25094,6,221,2486,174,2774,47
21138,14,297,2683,246,7576,51
33019,13,285,2089,189,5410,96
26506,8,186,2423,149,4483,37
14304,315,21439,3034,11038,126029,10401
35062,2,125,2004,112,4424,13
31304,20,1483,2172,1105,16140,378
4757,22,252950,3592,719,6564,252231
31918,80,3523,2140,2090,44993,1433
30398,16,1164,2216,890,12624,274
40386,440,21106,1660,10515,133411,10591
38857,101,1334,1759,1028,19711,306
42688,10,242,1312,174,10727,68
24398,2,62,2518,48,1879,14
11164,608,23280,3234,21063,75243,2217
20436,23,932,2724,454,9350,478
35225,19,784,1995,521,28727,263
36195,103,1231,1928,977,21443,254
45537,2,51,567,33,2803,18
26078,0,129,2443,102,3276,27
39016,6,200,1749,159,3735,41
24590,0,10783,2508,5274,38246,5509
15798,0,0,2948,0,1973,0
9655,1945,170124,3311,90788,848453,79336
36596,16,467,1908,333,15319,134
28482,31,602,2316,466,5760,136
25011,5,260,2490,216,6887,44
36933,4,243,1887,148,7104,95
28684,4,219,2304,171,3208,48
45332,4,86,622,48,3071,38
21597,9,298,2656,228,7898,70
30617,15,302,2204,252,5548,50
14708,2,201,3005,145,11303,56
27966,49,3442,2345,1326,20149,2116
22494,0,3180,2609,2235,25172,945
29020,7,294,2287,162,4067,132
28632,2,112,2306,100,3697,12
44544,5,77,868,75,4734,2
24174,53,2537,2528,1854,48050,683
14724,0,644,3004,515,25786,129
18168,12,365,2832,272,13373,93
41420,68,629,1547,496,9350,133
43610,18,515,1045,332,9245,183
24236,57,2191,2526,1750,21016,441
34330,90,1227,2042,1024,8997,203
41296,83,2826,1564,2120,22116,706
46340,2,35,248,35,2481,0
31776,1,92,2146,84,4390,8
24958,32,922,2492,668,5655,254
34860,12,636,2014,503,11326,133
24129,2,109,2530,76,3064,33
35417,53,512,1985,421,4142,91
11376,182,4553,3224,3784,44591,769
18878,6,681,2801,583,7006,98
36505,0,31,1913,26,2418,5
40343,346,5159,1665,3595,31057,1564
24687,22,1591,2504,1127,9556,464
14370,94,5719,3028,4382,36723,1337
36032,41,1046,1939,874,15431,172
42516,8,352,1348,192,4649,160
26786,93,7334,2410,5710,55203,1624
8815,1,121,3362,78,4154,43
21091,9,625,2686,442,17611,183
28430,278,10370,2319,7765,66572,2605
42026,24,290,1448,218,8494,72
32138,7,117,2128,93,5187,24
33885,0,152,2057,120,4424,32
13007,44,1529,3136,1381,12621,148
40548,72,835,1645,621,7588,214
43590,92,1900,1054,1553,30867,347
46336,50,852,248,673,22712,179
1356,5,109,3837,97,2856,12
27293,4,217,2386,131,6022,86
23980,38,1253,2537,937,10434,316
18823,17,1628,2803,905,18847,723
3954,104,5775,3621,5639,58515,136
34965,44,4696,2009,2368,29107,2328
27950,0,156,2346,121,2907,35
19156,194,9369,2791,6115,51358,3254
42966,22,220,1246,152,9711,68
19307,81,3668,2783,2891,27931,777
5118,1114,50166,3573,28030,107386,22136
25360,19,878,2475,715,15229,163
33737,17,603,2062,496,5777,107
29095,9,296,2283,228,3835,68
20320,21,1046,2730,810,24615,236
34838,50,1161,2015,945,16228,216
35828,2,112,1954,70,4357,42
22384,100,4660,2614,3246,44481,1414
27510,4,132,2372,93,3394,39
21703,10,454,2650,344,6092,110
45686,12,49,505,48,1557,1
42349,260,4553,1384,2974,38518,1579
20321,2,208,2730,165,4972,43
33422,3,120,2075,91,2315,29
11979,25,707,3194,655,4197,52
37033,142,3630,1881,2485,50464,1145
21983,28,792,2634,644,15224,148
39689,18,303,1709,252,10292,51
41625,0,25,1517,22,2039,3
45765,262,4247,464,3214,26092,1033
12666,24,2514,3156,2237,27328,277
22230,584,34566,2621,24334,151433,10232
40048,228,4050,1685,2964,40457,1086
31270,5,175,2173,150,5995,25
19057,12,557,2795,456,18088,101
16268,24,1033,2927,853,12409,180
36262,6,110,1925,90,4560,20
43047,242,8501,1221,4418,76778,4083
12196,48,2287,3183,2118,23295,169
29492,5,112,2262,82,5523,30
4312,160,6403,3608,5055,50518,1348
36335,3,102,1921,73,3956,29
32392,3,68,2116,61,1938,7
16606,5,175,2911,139,4279,36
13457,14,65941,3096,438,7537,65503
26215,2,348,2436,277,11103,71
42938,8,227,1251,147,7495,80
41008,39,1427,1605,1030,24959,397
45278,2,33,637,20,1593,13
35630,15,242,1969,207,4359,35
29906,29,1961,2242,1621,7226,340
39547,3,81,1717,69,3368,12
30517,16,414,2209,343,4788,71
37540,34,598,1849,487,12031,111
12870,131,5032,3144,4105,38788,927
30729,1,113,2198,101,2818,12
26526,4,156,2422,118,2990,38
44729,122,3124,823,1680,40974,1444
23552,32,1249,2558,1019,10909,230
10217,218,13342,3285,12434,88981,908
42869,23,650,1271,416,8158,234
45761,25,297,471,290,4926,7
10908,9,451,3248,433,8926,18
40272,2,46,1671,37,4104,9
44097,41,1174,930,490,10829,684
46042,14,120,354,88,3049,32
14579,4,143,3013,134,19661,9
35525,11,476,1977,332,18043,144
42248,16,948,1402,374,12030,574
25576,21,1254,2466,981,29632,273
44565,72,1197,865,610,19601,587
13782,64,1599,3073,1337,11423,262
25484,1,119,2470,93,2719,26
24866,20,523,2497,429,3216,94
42614,34,378,1329,288,5827,90
19342,43,975,2781,790,7969,185
20844,5,173,2701,144,5316,29
31732,24,1065,2149,708,9828,357
36431,58,1266,1917,861,10031,405
40848,2,208,1617,166,7440,42
25118,9,270,2485,178,8961,92
41209,17,1034,1580,458,8350,576
18889,4,361,2801,171,6152,190
29676,244,5305,2253,3606,24592,1699
19207,49,826,2788,657,14623,169
12942,1,52,3141,40,2883,12
37368,2461,340474,1860,86320,921255,254154
36070,0,87,1935,73,3403,14
40637,12,524,1638,302,4775,222
37498,10,450,1852,364,8861,86
22695,79,3793,2599,2662,31012,1131
39720,234,4976,1707,4163,21736,813
43937,1,47,964,31,1237,16
40150,28,752,1680,610,17899,142
26884,7,294,2405,241,5895,53
10403,628,32999,3277,17391,92512,15608
29909,7,239,2242,192,3228,47
15807,2,91,2948,68,5741,23
12077,97,4430,3190,4398,25954,32
31248,5,147,2175,123,4947,24
21344,11,453,2671,353,11200,100
33034,2,70,2089,55,3270,15
42678,27,410,1315,283,4883,127
35273,74,2072,1992,1708,28090,364
38897,14,441,1756,361,12949,80
37886,12,412,1825,294,5808,118
31494,117,7804,2161,4116,42870,3688
37581,11,317,1846,238,15000,79
35956,55,2610,1945,1757,33667,853
36501,28,866,1913,697,17560,169
8958,743,35013,3354,22663,157019,12350
43566,39,534,1064,447,4212,87
23320,55,5443,2569,3388,29582,2055
26103,1221,79548,2442,44823,234081,34725
20071,20,807,2743,652,8847,155
6982,185,13557,3485,7473,33281,6084
28710,4,223,2303,186,10322,37
17299,4,279,2871,216,6796,63
13422,60,1949,3101,1945,14348,4
44475,42,336,882,248,4395,88
45121,33,314,685,274,6691,40
22063,44,1886,2630,1325,9280,561
22171,11,1412,2625,1159,10482,253
36217,12,861,1927,653,9104,208
42902,218,4308,1262,3384,40459,924
28650,494,18140,2305,11315,95089,6825
23250,46,5586,2572,2738,28626,2848
31751,22,1900,2147,996,16595,904
19234,10,532,2787,388,6367,144
16755,31,1107,2902,779,6827,328
42929,218,2798,1254,2293,24399,505
26629,10,403,2418,325,5996,78
45990,81,756,382,700,6732,56
16620,9,676,2910,534,12707,142
35296,60,1274,1991,1073,8136,201
15706,12,820,2952,535,3611,285
39470,0,39,1721,34,3848,5
13331,54,2160,3107,1819,25742,341
5057,22,206979,3577,742,19109,206237
38153,0,43,1807,36,3779,7
32885,7,358,2095,167,3801,191
27077,8,1169,2399,949,11762,220
26143,149,2182,2440,1583,20423,599
43277,38,361,1153,266,6695,95
22177,85,3774,2624,2535,48846,1239
30911,1,116,2191,103,9306,13
19169,0,47,2790,41,4774,6
32580,3,192,2108,164,4083,28
38814,25,678,1762,540,14313,138
16900,941,60318,2895,36461,233601,23857
38958,25,695,1752,347,5244,348
42010,209,8888,1450,3698,51950,5190
28582,17,336,2309,280,6083,56
21302,9,389,2673,301,5150,88
37187,68,2395,1872,1535,15785,860
17811,199,22715,2849,15245,73812,7470
15904,42,2500,2945,1920,28976,580
36266,1,38,1924,30,8190,8
32305,5,74,2120,63,1920,11
8490,229,23545,3382,12323,58234,11222
13900,1,124,3062,124,5241,0
9842,37,2862,3303,2732,31625,130
27195,3,119,2392,110,1896,9
32573,21,303,2108,265,4626,38
32922,14,566,2093,434,5493,132
44382,15,210,893,167,6909,43
41628,92,3153,1517,2380,25292,773
999,2,50,3970,40,3450,10
29559,774,28631,2259,20559,151267,8072
36988,19,601,1884,386,8024,215
46397,30,379,219,304,5602,75
30638,9,438,2203,365,7009,73
16859,3,239,2896,198,3967,41
29500,6,290,2261,241,8290,49
15375,34,4009,2968,1324,7421,2685
45330,30,318,622,264,7717,54
12886,185,8473,3144,7948,62397,525
19288,68,4106,2784,3086,34052,1020
18630,19,409,2812,296,4312,113
27533,12,476,2370,370,7064,106
42937,2,17,1251,14,2053,3
25984,8,214,2447,179,4147,35
25703,27,756,2459,640,6618,116
18218,5,100,2830,86,4003,14
5288,1088,57837,3563,54007,322117,3830
35913,94,1692,1947,1291,15586,401
29712,7,137,2252,114,6487,23
15625,22,1245,2956,891,18025,354
13019,10,647,3135,560,6482,87
23853,33,865,2543,649,9226,216
44670,9,151,844,81,6030,70
23924,63,3137,2540,2290,36538,847
45271,235,2454,639,2183,25705,271
43087,18,322,1207,192,8580,130
25582,4,292,2465,99,5629,193
45144,4,43,677,35,1824,8
34958,31,807,2009,663,23193,144
35629,5,219,1969,135,4371,84
20684,45,1678,2711,1071,18657,607
44939,10,170,760,123,5318,47
28032,7,306,2342,271,12184,35
41041,0,182,1601,135,3629,47
5999,95,3707,3528,3572,25223,135
17264,1,176,2873,124,3390,52
6729,111,4530,3499,4109,20125,421
12537,3,56,3164,56,1678,0
14509,78,5456,3019,4233,47965,1223
45616,27,456,540,281,6950,175
27111,33,1986,2397,936,12993,1050
26089,16,508,2442,416,5636,92
36241,1,40,1927,34,2062,6
40487,17,388,1650,315,7466,73
13238,10,483,3114,287,6516,196
45612,27,454,544,346,7814,108
15271,8,517,2972,469,8997,48
17078,3,549,2884,376,11195,173
40303,0,30,1670,26,3200,4
29821,0,23,2247,23,2870,0
12089,0,0,3189,0,2674,0
45661,19,265,518,159,3682,106
32761,0,24,2101,20,2077,4
31484,2,55,2162,47,4217,8
24204,1,50,2527,40,1872,10
28469,100,4849,2317,3533,30065,1316
37687,2,120,1840,67,4165,53
43183,37,570,1182,421,10798,149
26777,28,747,2411,612,14345,135
34534,53,1697,2033,1266,26546,431
39642,386,7164,1712,4219,39294,2945
44572,2,67,863,51,3147,16
41813,75,1898,1481,1493,41332,405
10126,194,6798,3290,6211,41903,587
44815,2,19,795,15,1451,4
25124,3,142,2485,101,2412,41
35709,1,50,1962,45,4506,5
41023,150,6124,1604,2463,45206,3661
31438,0,47,2165,41,1927,6
24147,289,31663,2529,14441,120660,17222
36557,3,85,1910,75,3198,10
34581,2,483,2031,401,8228,82
42655,132,2786,1321,1822,39912,964
37777,8,269,1833,218,13789,51
21004,21,1015,2690,857,6634,158
11158,24,162161,3235,928,17046,161233
43615,11,125,1043,105,6145,20
20467,8,299,2723,231,5346,68
32436,8,333,2114,260,9210,73
30721,10,720,2198,573,8918,147
27386,15,862,2380,677,12068,185
32544,8,659,2110,447,11638,212
41507,61,1932,1534,1524,19015,408
45632,44,367,531,323,8519,44
32052,4,175,2132,79,4822,96
15511,551,24366,2962,16893,74799,7473
15164,78,3555,2977,3183,26002,372
39168,1,84,1740,72,2871,12
25780,0,18,2456,14,3190,4
27414,58,9135,2378,1129,44976,8006
18776,17,434,2805,348,6774,86
35604,3,22,1971,22,3911,0
23774,84,3730,2547,3007,37601,723
19294,25,1360,2784,1074,16308,286
15607,75,5038,2956,3968,146276,1070
42444,3,138,1363,85,6102,53
32196,6,193,2124,157,3036,36
29615,5,63,2257,53,2162,10
19641,272,29665,2767,8709,133029,20956
10308,66,2516,3281,1921,26653,595
39885,2,190,1697,48,3605,142
37644,36,382,1843,307,4612,75
21905,20,933,2640,737,10382,196
14377,87,7867,3028,4916,57195,2951
16721,63,5958,2905,4561,40079,1397
45825,4,53,450,48,2137,5
40110,73,2749,1682,1624,27601,1125
42910,13,292,1260,200,3362,92
19589,2034,161793,2769,66150,486333,95643
33431,28,761,2074,495,7541,266
15523,122,5761,2961,4403,19614,1358
23570,93,12987,2556,5111,47041,7876
45440,434,7919,595,5577,48011,2342
35549,2,207,1975,101,5731,106
16431,27,1715,2919,1346,26891,369
41720,2,37,1502,35,2613,2
13845,28,1548,3068,1390,17779,158
37824,25,359,1829,279,8191,80
43059,29,464,1217,336,8274,128
15381,30,1144,2968,680,8368,464
17383,6,445,2867,361,10230,84
20967,3,77,2693,65,1907,12
27727,25,1042,2360,724,9096,318
18601,14,1284,2814,631,31717,653
23055,42,1143,2581,936,14612,207
40558,107,1620,1643,1293,11077,327
36036,0,28,1939,26,2155,2
36090,3,217,1934,131,5529,86
45810,15,122,456,98,3391,24
25833,37,1557,2454,1224,25397,333
11518,11,516,3216,497,12576,19
9724,118,6315,3309,5305,50042,1010
27616,16,1933,2366,1558,45182,375
37595,30,747,1846,541,6860,206
40749,113,4292,1627,2930,35293,1362
30830,7,135,2194,98,2011,37
2957,5,239694,3642,414,7530,239280
31384,32,1312,2168,1123,31395,189
19618,1,125,2768,100,2672,25
33759,2,100,2061,84,5681,16
27196,4,324,2392,221,2595,103
26369,35,900,2429,735,6928,165
36672,17,508,1903,421,5206,87
18545,22,1036,2816,689,17786,347
2581,95,3403,3648,3376,17602,27
37062,1,84,1879,62,3053,22
30732,67,1371,2198,1065,14693,306
40785,25,826,1624,540,13967,286
25704,184,6327,2459,4818,43876,1509
36045,81,2256,1938,1778,43347,478
18854,3,311,2802,203,2067,108
28178,7,1200,2334,704,17875,496
1857,39,424863,3661,2146,28018,422717
27931,402,34654,2347,11459,147271,23195
37818,5,185,1830,145,5738,40
13817,23,421,3070,292,5568,129
34741,14,606,2022,448,7026,158
17706,408,17527,2853,11572,56557,5955
31433,12,725,2165,543,11794,182
26056,4,128,2443,99,2992,29
39473,41,1285,1721,996,20125,289
25997,7,191,2446,150,1995,41
17258,8,606,2873,507,12353,99
10991,165,6313,3244,5383,30812,930
43852,1185,25915,978,20057,140045,5858
25198,1,59,2482,51,2182,8
24889,70,3351,2496,2535,43283,816
41687,20,778,1507,508,14248,270
43442,131,1515,1104,1480,9701,35
19662,28,880,2766,661,21661,219
34872,15,467,2013,333,7975,134
30948,48,966,2190,808,19056,158
41299,9,132,1563,111,2610,21
40420,4,230,1658,149,2528,81
45240,10,178,651,113,5282,65
43350,10,377,1132,184,8104,193
42292,10,440,1394,263,7370,177
27119,1,147,2396,130,5189,17
19273,12,671,2785,493,12213,178
3394,231,9797,3634,8739,37466,1058
29942,1271,91004,2240,45766,334227,45238
18146,11,252,2833,227,13377,25
27493,1,86,2373,61,2603,25
40568,1,31,1643,24,1933,7
18752,365,20104,2807,13483,112144,6621
37471,13,346,1854,255,6313,91
45244,2,32,651,21,2779,11
40254,0,79,1672,58,8774,21
18486,26,2120,2818,1546,20138,574
25470,17,453,2471,373,5004,80
45393,54,706,606,579,10465,127
39191,13,408,1738,287,6069,121
19652,3,114,2766,95,3109,19
26559,0,12,2420,10,970,2
29598,59,2370,2258,1792,24690,578
30416,3,132,2215,110,3265,22
38768,6,227,1764,188,4391,39
16677,553,25154,2907,18256,70983,6898
34179,1266,80559,2048,33669,405358,46890
11262,38,1217,3229,1134,9221,83
18191,3,94,2831,79,3777,15
10738,118,8862,3257,7852,36499,1010
36464,0,31,1915,25,3518,6
39254,11,207,1733,149,4890,58
20039,7,619,2744,320,9462,299
28718,229,13946,2302,9920,103627,4026
13113,29,2761,3129,1672,31107,1089
14787,101,3033,2999,2178,13377,855
26160,4,158,2439,135,5699,23
14421,6,308,3025,254,4644,54
24655,57,1936,2505,1507,21350,429
27759,12,428,2358,352,6641,76
26753,0,23,2412,22,1283,1
26689,144,3547,2415,2407,14287,1140
19202,2,139,2789,94,3194,45
18581,67,2261,2815,1712,16138,549
40573,70,1709,1642,1212,12921,497
18161,1,90,2833,68,5277,22
23667,157,6508,2551,4761,44768,1747
12443,276,16979,3168,14479,80041,2500
41998,14,480,1452,343,16283,137
35167,80,1626,1998,886,15447,740
32275,1,127,2121,102,8302,25
23869,6,305,2543,259,7184,46
13941,342,26024,3059,19867,151318,6157
21157,3,115,2681,106,3290,9
29754,3,380,2250,208,10074,172
45777,26,390,464,310,3169,80
11444,37,4862,3221,3982,24588,880
14808,173,18610,2997,15180,148265,3430
8036,35,2361,3410,2251,25197,110
32586,3,92,2108,80,4211,12
37747,64,585,1835,457,5446,128
32798,2,54,2099,47,3278,7
16470,8,598,2917,463,7981,135
12873,45,1048,3144,1030,8212,18
32444,20,952,2114,535,9445,417
39422,228,2879,1724,2284,22868,595
15672,29,1134,2954,790,12533,344
9208,261,10802,3339,8093,42594,2709
27392,16,363,2379,218,6548,145
22825,4,67,2593,52,2209,15
37843,27,749,1828,602,9605,147
7633,348,18658,3448,14840,114359,3818
36101,142,3465,1933,2817,28413,648
44794,23,200,802,197,5669,3
25375,0,22444,2475,14570,127932,7874
45297,210,2211,632,2210,19004,1
20734,0,35029,2709,6525,361882,28504
42538,1,143,1344,86,5837,57
21362,1,89,2669,81,3312,8
22607,17,853,2603,516,9305,337
24367,42,812,2520,646,5598,166
30789,1,67,2196,47,3960,20
39761,66,2299,1706,1234,16840,1065
13652,114,9758,3083,7823,78336,1935
42495,238,5608,1353,4030,40347,1578
30931,24,663,2190,390,8152,273
24783,3,593,2500,360,8243,233
38163,246,11002,1807,2912,40851,8090
22150,10,578,2625,450,8225,128
18362,7,303,2823,247,5348,56
12432,18,963,3168,936,10026,27
9132,258,12019,3344,10238,46241,1781
38798,21,322,1763,273,2709,49
15548,14,668,2960,461,18505,207
25688,3,304,2460,257,12538,47
39091,31,793,1744,636,18012,157
20310,0,86,2730,47,3262,39
5703,132,3065,3542,2790,21946,275
38701,15,356,1768,292,5267,64
13864,17,979,3066,912,9283,67
44087,125,9084,930,1766,29718,7318
18505,8,611,2817,435,8456,176
27278,0,570,2387,385,5740,185
25628,2,120,2462,109,2528,11
23566,102,3539,2556,2604,25807,935
33406,97,4662,2075,3293,34832,1369
29363,3,257,2269,131,4059,126
37705,3,98,1839,84,7989,14
42720,6,58,1307,43,4450,15
40395,14,457,1659,272,8419,185
16287,4,365,2926,259,8088,106
18539,639,63762,2816,37888,340903,25874
28468,17,443,2317,359,2988,84
18461,98,1856,2819,1457,9478,399
32671,3,120,2104,100,2830,20
38662,189,2167,1771,1776,10883,391
24246,34,1831,2525,1355,21666,476
16603,6,141,2911,106,4096,35
35255,53,2157,1992,1177,20784,980
12823,36,851,3147,681,6912,170
15834,23,1318,2947,1013,7987,305
18712,222,13343,2808,10303,80489,3040
36065,14,676,1936,569,15415,107
40684,4,112,1634,89,6370,23
17731,10,476,2852,310,11712,166
28227,4,101,2331,58,4414,43
18822,36,2827,2803,2329,22451,498
22244,10,517,2620,422,11480,95
37088,1602,37091,1877,21801,235351,15290
45475,9,211,586,142,4644,69
42490,2370,55946,1354,27526,367351,28420
15490,39,1819,2963,1368,19626,451
43651,56,1216,1032,706,11056,510
43013,64,1399,1230,1139,37180,260
19825,0,108,2756,77,8598,31
15678,8,341,2954,292,2995,49
18870,3,271,2801,135,6532,136
21714,14,190,2649,154,2389,36
20736,78,3147,2709,2073,36082,1074
34851,5,310,2014,128,4940,182
31581,12,274,2156,237,3677,37
31928,3,104,2139,85,8707,19
35309,1,160,1990,138,4712,22
24650,4,188,2505,171,8854,17
29738,13,441,2251,367,9335,74
44699,28,267,834,180,6728,87
1825,664,60466,3663,44909,330716,15557
37387,154,2861,1859,2028,22272,833
42876,127,6185,1269,2646,49977,3539
44745,16,267,817,223,4428,44
27719,21,1217,2360,1024,9561,193
35773,10,415,1958,337,11315,78
32630,1,79,2106,69,2788,10
29785,9,149,2248,119,4459,30
45734,5,69,480,53,3626,16
13537,14,784,3090,700,19097,84
15475,7,222,2964,139,6290,83
17117,32,987,2881,755,7352,232
39888,9,558,1696,445,8738,113
21696,28,1834,2650,1102,10675,732
11702,14,848,3207,813,32515,35
15324,61,3960,2970,3199,17213,761
35061,30,736,2004,634,5045,102
29452,9,324,2264,249,3962,75
30697,4,314,2199,257,5619,57
10115,35,1307,3290,1255,27001,52
27231,28,665,2389,535,7845,130
21869,12,622,2642,438,11490,184
38667,10,364,1771,177,5445,187
20510,20,946,2720,767,12266,179
28303,40,1700,2327,1238,17709,462
24535,6,297,2512,212,4247,85
40252,14,206,1673,176,8562,30
27682,9,424,2362,235,5600,189
30903,4,207,2191,152,3466,55
33071,4,91,2087,81,3178,10
25539,0,73,2468,63,2299,10
16495,158,25661,2916,5535,54293,20126
25164,12,1556,2483,1160,41533,396
4954,252,15574,3582,15465,37256,109
40464,14,245,1653,172,4736,73
41165,55,1394,1586,1011,16897,383
15561,21,689,2959,451,6017,238
21533,29,1354,2660,1108,30846,246
24313,28,657,2522,543,10309,114
44089,289,14050,930,4395,73167,9655
38734,107,1817,1767,1263,33158,554
27480,14,483,2374,319,5716,164
17930,13,505,2844,430,8199,75
42272,7,228,1397,200,11344,28
42545,3,97,1342,79,3719,18
39747,21,1065,1706,790,13794,275
25479,0,98,2470,82,4004,16
21785,84,2541,2646,1936,18540,605
21134,7,318,2683,203,12719,115
12772,34,832,3150,804,13311,28
21202,36,894,2678,691,8685,203
41140,20,460,1588,339,11878,121
38263,22,885,1800,607,14503,278
37891,6,90,1825,69,3028,21
19393,14,587,2779,451,13574,136
38304,15,593,1797,488,4646,105
29086,62,1124,2283,836,10979,288
36088,3,130,1934,113,5376,17
43135,5,257,1194,92,10528,165
37410,8,214,1858,176,5886,38
29613,4,120,2257,102,3576,18
46039,1,60,358,29,2397,31
21883,1,192,2641,152,3313,40
23655,3,47,2552,38,19255,9
31529,13,431,2159,347,7047,84
36436,23,749,1917,581,20660,168
29111,5,333,2282,260,6260,73
43464,151,2422,1098,1470,26221,952
12531,1,86,3164,62,1447,24
12187,20,898,3183,681,11161,217
32718,63,1748,2102,1222,11547,526
30811,4,213,2194,167,6648,46
17759,6,266,2851,206,3714,60
42820,2,185,1281,136,5380,49
35646,2,80,1968,63,4338,17
41925,96,2055,1464,1590,31180,465
22120,30,2808,2626,2208,21436,600
17694,7,3273,2854,2565,54754,708
8802,481,23243,3363,19242,90948,4001
29138,23,2200,2281,1202,14222,998
45063,22,277,715,264,6587,13
43595,0,83,1051,61,10135,22
41371,4,254,1554,141,3211,113
39212,2,358,1737,293,7166,65
34538,2,76,2032,54,2927,22
33193,53,1251,2083,952,9284,299
31084,1166,57845,2183,37929,227332,19916
40481,218,6149,1651,3865,27914,2284
30069,13,227,2235,196,2237,31
16005,1670,95878,2940,49512,238128,46366
44980,13,168,748,141,3582,27
30010,1,43,2237,41,1933,2
42352,22,330,1382,256,6405,74
25596,5,182,2464,118,4509,64
46043,18,229,354,179,4636,50
26509,1,91,2423,78,6833,13
13257,23,76179,3113,1376,25478,74803
32755,6,416,2101,338,9358,78
10712,48,1394,3259,1082,22395,312
42166,15,477,1419,336,15170,141
42079,31,1107,1437,867,19358,240
21807,2,162,2645,94,4392,68
12909,89,2114,3142,1764,7897,350
26854,63,2705,2407,1876,30270,829
29513,3,124,2261,80,3657,44
42429,8,140,1366,111,4915,29
25274,20,692,2479,583,4880,109
33587,10,428,2068,337,8073,91
13895,1,151,3063,119,2860,32
23084,1,42,2580,38,3362,4
37721,50,1078,1837,814,14356,264
45129,274,2839,682,2607,16604,232
23366,73,3328,2566,2425,14118,903
18492,6,294,2818,190,10554,104
34953,33,1615,2009,1184,17254,431
30233,0,189,2226,101,4216,88
39281,10,996,1731,646,15390,350
28443,50,1790,2319,1331,11594,459
29307,50,1072,2272,862,7023,210
45845,31,342,444,196,4274,146
33398,0,0,2075,0,2443,0
40868,12,689,1615,440,9832,249
40407,12,473,1659,372,5369,101
28872,11,385,2294,284,5361,101
12878,37,2498,3144,1780,14525,718
35901,5,274,1948,223,7790,51
35870,2,99,1951,88,3139,11
7232,60,1574,3472,1230,11839,344
13316,8,316,3108,306,10854,10
7706,241,15338,3444,13305,97662,2033
13687,13,668,3080,480,8737,188
42215,7,374,1409,225,5766,149
17853,1,144,2848,116,3890,28
38363,277,6534,1792,4590,35252,1944
29750,30,1602,2250,1334,8906,268
40623,1,81,1638,58,1355,23
14781,19,682,2999,538,12495,144
33011,11,586,2090,433,15019,153
38585,780,31331,1776,14193,126158,17138
12757,20,78770,3151,1137,14001,77633
37736,39,1525,1836,1149,18712,376
20694,40,3933,2711,2838,28080,1095
45396,49,387,604,286,7374,101
43729,19,344,1006,320,11730,24
40238,51,809,1674,634,5445,175
31132,16,614,2180,500,12705,114
19089,618,72431,2793,31628,226932,40803
35610,154,3846,1970,2749,31600,1097
20766,16,1665,2707,1175,10560,490
20929,87,4694,2695,3193,36428,1501
15125,83,5090,2980,3654,45306,1436
25462,249,12300,2471,9359,44604,2941
18686,18,1016,2809,809,9619,207
33932,5,214,2056,167,10259,47
30093,341,17321,2233,10372,57341,6949
25517,65,1979,2469,1671,10837,308
40858,4,138,1616,115,6352,23
37590,2,51,1846,46,1664,5
19542,1,183,2772,128,4513,55
26624,17,344,2418,293,4612,51
28881,464,19646,2294,10564,70115,9082
5022,1240,54400,3579,46193,279976,8207
39686,23,525,1709,351,11062,174
42222,293,8798,1407,5582,62468,3216
7637,94,3949,3448,3929,32024,20
35999,13,260,1941,226,10180,34
14322,3,107,3032,74,1639,33
33639,12,373,2066,298,5323,75
15419,26,1226,2966,989,16277,237
19477,0,38,2774,33,2101,5
20523,4,30,2719,22,1853,8
40526,172,4055,1647,3042,24313,1013
17907,98,4690,2845,3608,58897,1082
38728,16,235,1767,196,3778,39
15536,7,723,2961,559,12925,164
12532,1,49,3164,45,1647,4
42541,4,246,1343,168,5684,78
15871,24,1239,2946,898,8001,341
26023,7,287,2445,245,4342,42
26562,8,590,2420,458,6980,132
14467,1,74,3022,72,3708,2
14985,53,3447,2988,1482,18180,1965
43325,22,640,1140,363,14380,277
41412,4,70,1548,52,4802,18
37406,5,211,1858,170,6216,41
30381,58,1929,2217,1552,7832,377
29159,15,1083,2280,848,12526,235
34690,19,500,2024,429,2960,71
41862,16,209,1473,170,3351,39
24325,14,756,2521,554,7578,202
19490,36,1115,2773,852,8506,263
44079,90,3378,930,1259,11472,2119
24439,6,397,2516,331,8677,66
7657,5,186502,3447,420,6062,186082
19388,1178,111481,2779,56401,564375,55080
38050,5,187,1815,113,4517,74
24070,28,1360,2533,999,14938,361
14560,286,23235,3015,8578,94767,14657
45165,3,34,671,26,3361,8
16633,216,11119,2910,7478,84518,3641
40640,1,63,1637,51,3934,12
14871,6,268,2994,258,8453,10
38045,44,452,1815,360,4494,92
27309,17,532,2385,442,6659,90
41855,519,10539,1475,6966,92311,3573
36641,1,34,1905,29,5711,5
41680,12,361,1508,294,6656,67
46209,0,12,291,11,2607,1
21006,102,3054,2690,2343,24882,711
24336,3,76,2521,60,5964,16
27194,1,90,2392,81,1879,9
20483,113,3177,2722,2163,24756,1014
37883,80,1289,1825,993,8908,296
38544,10,287,1779,227,8089,60
24217,0,87,2526,62,3715,25
28010,37,1865,2343,650,12291,1215
10454,7,279,3274,268,6921,11
39294,14,397,1731,336,10594,61
26513,7,370,2422,310,6719,60
46033,2,74,361,45,4042,29
31924,2,65,2140,54,3815,11
42574,119,1611,1338,1047,19198,564
38847,3,370,1760,255,14582,115
26269,18,641,2434,528,3784,113
41501,16,293,1534,199,7933,94
13362,0,122,3105,117,3636,5
16965,12,641,2891,422,15906,219
27887,572,12440,2351,10496,74860,1944
30978,9,466,2188,389,7198,77
32118,92,3419,2128,2516,27270,903
29669,34,1940,2254,1471,15546,469
23125,2,84,2578,63,3371,21
43781,120,2340,989,1501,24391,839
38896,44,1253,1757,1014,8228,239
41856,7,204,1475,161,8187,43
2227,154,17388,3654,14795,52414,2593
27115,8,311,2397,274,3618,37
31028,36,1293,2185,954,25123,339
1211,5,144,3899,115,5998,29
4727,501,12621,3593,12502,54566,119
40026,1,58,1687,44,3007,14
19464,27,5097,2775,1511,22551,3586
26055,453,23192,2443,10061,72114,13131
20502,1,109,2721,85,4860,24
12767,28,1656,3150,957,13378,699
28115,3,316,2338,197,7581,119
46436,14,209,197,147,2178,62
16370,24,975,2922,764,4501,211
26095,20,1235,2442,885,13961,350
35701,1,59,1963,44,3111,15
29749,11,475,2250,357,6218,118
43470,52,1023,1097,864,23326,159
24885,5,111,2496,60,5684,51
44869,5,43,778,36,2039,7
41506,3,73,1534,68,8715,5
19426,15,738,2777,549,14466,189
25870,82,2809,2452,2405,19831,404
39496,6,422,1720,327,9198,95
12028,33,1326,3192,1276,10447,50
27929,0,490,2348,398,13269,92
34212,4,136,2047,105,8220,31
22140,25,1512,2626,983,12254,529
28316,0,450,2326,355,5966,95
10859,30,200855,3251,997,31116,199858
35434,456,12189,1984,8399,94847,3790
42759,17,902,1296,507,10269,395
31334,5,202,2170,169,7858,33
41961,77,682,1457,495,10108,187
40307,5,154,1669,91,5438,63
37480,32,591,1853,466,9182,125
32989,2,80,2091,71,3696,9
34587,23,552,2030,419,7472,133
34035,2,66,2052,58,2908,8
20877,79,3215,2699,2043,38113,1172
45428,8,157,597,128,4912,29
44886,21,173,775,164,3675,9
16787,7,310,2899,253,4139,57
39740,4,122,1707,105,6472,17
37722,8,163,1837,124,8789,39
16877,126,6624,2896,4908,48128,1716
21557,22,2186,2659,1705,11691,481
41889,30,364,1469,280,9048,84
28330,10,167,2325,148,3804,19
15131,39,565,2980,499,22300,66
16293,15,1220,2926,968,22162,252
25057,0,12,2488,9,3861,3
35176,3,77,1997,53,2909,24
36203,21,416,1928,344,5356,72
39044,11,327,1748,243,10641,84
37433,4,207,1856,167,5872,40
42225,7,254,1407,167,4445,87
36446,11,209,1916,175,4020,34
43766,101,1524,995,1139,25018,385
26696,2,151,2414,86,5670,65
44846,57,485,784,341,9028,144
10650,106,15363,3263,10792,77291,4571
41191,0,7,1582,6,1064,1
32509,8,411,2111,331,4198,80
33404,72,2812,2075,1905,14592,907
18138,83,4230,2834,2805,23773,1425
27486,15,643,2373,469,9654,174
45901,8,89,424,70,1355,19
8711,1322,79866,3368,42246,195667,37620
45542,2,21,565,19,1374,2
13776,4,212,3073,192,4232,20
34061,1,85,2051,65,2813,20
14615,0,158,3011,130,23638,28
40145,65,1584,1681,1205,20791,379
41088,28,621,1595,483,6565,138
39501,3,80,1720,71,7919,9
14624,20,908,3011,833,10741,75
20798,12,430,2704,300,7471,130
28009,31,437,2343,363,5122,74
19385,6,327,2779,247,10088,80
16354,89,4503,2922,3044,32188,1459
17582,69,4682,2857,1429,19950,3253
12179,11,1583,3183,1492,17923,91
35223,30,982,1995,836,7269,146
29577,2,129,2258,117,3187,12
38515,47,1994,1782,1482,29459,512
28458,16,402,2318,331,5616,71
40247,10,195,1673,116,2822,79
24496,10,350,2513,245,4012,105
25718,36,2360,2458,1524,18626,836
29165,1,86,2280,79,4062,7
43423,3,245,1107,113,3265,132
28957,2,191,2290,138,7534,53
14563,39,1291,3015,1101,14639,190
18704,40,2539,2809,1739,15958,800
29255,17,681,2275,303,5422,378
15078,16,901,2982,835,12241,66
34505,22,921,2035,629,11576,292
38323,5,215,1795,176,4877,39
21803,6,223,2645,182,3209,41
9151,285,7876,3342,7634,28574,242
28244,29,1336,2330,753,19096,583
37619,10,304,1844,219,7409,85
39922,1,136,1694,108,3276,28
45576,294,6816,552,6501,38447,315
20362,3,405,2728,267,10966,138
42717,59,2471,1308,1032,24961,1439
24119,68,2344,2531,1871,31089,473
11459,125,3755,3219,3229,18154,526
20352,3,613,2729,409,9058,204
35635,142,11856,1969,5812,63699,6044
31408,41,1045,2167,736,14007,309
19690,3,123,2765,73,6146,50
23548,54,2743,2558,1963,9675,780
42878,12,105,1269,94,3506,11
22978,5,418,2584,279,9012,139
37493,4,159,1852,136,6492,23
33135,0,92,2084,81,5277,11
17914,55,3928,2845,2971,24861,957
37588,3,225,1846,186,3042,39
15893,13,585,2945,451,10465,134
43542,5,103,1072,54,5735,49
9442,116,4173,3324,3811,24200,362
31779,0,79,2146,62,2194,17
22948,2,198,2586,137,2914,61
22105,18,932,2627,674,6444,258
41171,101,3222,1585,2481,20352,741
17045,3,122,2886,106,11808,16
1815,5782,299788,3663,202405,679719,97383
37975,0,24,1819,13,2973,11
10833,37,2280,3252,2271,13342,9
42339,207,5018,1385,3599,83298,1419
46470,3,92,179,79,3257,13
45010,1,22,739,12,2258,10
31668,350,20252,2151,4585,82790,15667
41664,1,56,1510,45,4849,11
13037,167,11743,3134,5889,70393,5854
11748,10,492,3204,459,7785,33
15082,20,569,2982,520,13271,49
15915,20,847,2945,683,11644,164
26474,14,996,2424,844,22156,152
45442,11,157,593,119,3608,38
18905,50,1272,2800,770,11962,502
39705,24,806,1708,644,9071,162
26627,4,90,2418,85,2395,5
15896,7,379,2945,283,6852,96
16193,5,73,2931,56,2552,17
31289,1,118,2172,95,3437,23
42799,25,887,1283,642,11871,245
10144,269,13402,3289,10945,77534,2457
19593,14,766,2769,534,9609,232
37206,1,114,1870,88,2849,26
14688,17,882,3007,658,12538,224
14916,43,3420,2992,2802,28764,618
15907,27,843,2945,636,8530,207
21180,18,833,2679,728,4482,105
16915,45,2767,2894,1724,12513,1043
40378,83,2014,1661,1078,20362,936
34337,1,96,2042,80,11157,16
18076,16,634,2836,366,9246,268
36108,1,92,1933,82,4669,10
34932,6,246,2010,165,3833,81
39506,0,45,1720,37,2582,8
35206,9,348,1996,284,7517,64
14345,50,3429,3030,2678,22040,751
17322,23,534,2871,440,4244,94
30827,119,24156,2194,3696,73020,20460
33149,1,30,2084,22,4118,8
31879,3,309,2141,144,6765,165
30289,11,290,2223,236,4948,54
22644,6,383,2601,298,6413,85
35895,124,6044,1949,4654,44958,1390
42172,11,278,1418,196,31091,82
24122,0,131,2530,109,5195,22
21163,11,444,2680,347,11052,97
35011,21,381,2006,297,10273,84
19042,0,105,2795,85,2498,20
33425,33,818,2075,668,8879,150
30882,347,9389,2192,7299,57797,2090
21967,17,1179,2635,642,13482,537
10760,39,712,3256,712,3797,0
37441,13,347,1856,285,14714,62
17458,16,1117,2864,823,8567,294
36080,47,1671,1935,1199,19453,472
37852,7,225,1827,188,11243,37
13516,41,1391,3092,1267,13522,124
42082,6,259,1436,177,4168,82
45268,5,58,640,40,3190,18
1252,2,25,3888,23,2236,2
42674,37,878,1317,729,14251,149
18542,7,909,2816,436,10318,473
28360,8,542,2323,465,2766,77
16424,138,9065,2919,5920,44735,3145
45355,15,233,617,146,4773,87
18419,19,452,2821,347,5775,105
37715,13,252,1838,219,5253,33
29854,5,603,2245,411,7759,192
21289,26,1266,2674,884,13791,382
33308,23,350,2079,256,6760,94
15081,50,1125,2982,1045,10306,80
36734,47,1315,1900,1051,25246,264
26705,1,31,2414,27,1892,4
36868,9,92,1891,67,2562,25
43039,70,1206,1223,1029,30080,177
40166,55,1512,1679,1151,19772,361
30348,35,1717,2219,541,8488,1176
35998,6,268,1941,201,4903,67
45914,11,104,418,89,2764,15
22112,17,1135,2627,588,11490,547
29533,6,319,2261,238,4431,81
13633,108,5952,3085,4893,78279,1059
33057,9,196,2088,168,5930,28
37783,4,147,1833,115,3677,32
12167,33,1472,3184,1323,36397,149
14019,24,1432,3052,1291,29953,141
30615,13,625,2204,411,9576,214
45956,22,165,395,104,2070,61
37983,7,248,1818,168,6568,80
31822,197,7683,2144,5424,63043,2259
28414,1,111,2320,94,3885,17
9807,89,6001,3304,4828,49198,1173
18339,7,887,2824,531,14728,356
35694,1,88,1963,56,3948,32
38186,0,21,1805,14,3782,7
20383,79,3802,2727,2673,21776,1129
35553,0,129,1975,108,4680,21
44053,8,133,945,103,3842,30
45564,372,4991,555,4541,40105,450
19755,58,3674,2760,2892,29742,782
42199,0,128,1413,71,11221,57
18235,2,174,2829,122,3450,52
38203,19,606,1804,424,6119,182
39487,370,7034,1721,5846,34521,1188
35442,11,330,1983,133,2297,197
21454,26,1013,2664,823,15205,190
17368,0,57,2867,23,3780,34
998,37,3048,3970,2286,28373,762
45798,5,41,460,39,2708,2
36545,215,6072,1911,4869,42446,1203
33075,209,11122,2087,6425,63326,4697
13692,207,14721,3080,7980,67200,6741
35046,2,137,2004,108,3646,29
23564,9,387,2557,264,7745,123
11698,727,27447,3207,23136,164482,4311
24089,4,166,2532,148,2315,18
33680,5,162,2065,142,7964,20
42038,554,11673,1445,6268,102077,5405
14029,38,1904,3052,1642,23743,262
20355,1,130,2728,81,10677,49
31212,26,595,2177,458,6638,137
38609,19,742,1774,305,5232,437
16494,30,1475,2916,1112,15384,363
20330,3,231,2730,183,8143,48
22909,14,564,2588,439,8510,125
37893,9,297,1825,238,5276,59
36842,50,2753,1892,1251,24483,1502
15377,9,375,2968,335,4585,40
33213,0,136,2082,107,4445,29
22001,17,876,2633,461,11492,415
40929,24,941,1611,485,9511,456
39291,10,269,1731,224,8910,45
17360,194,4293,2868,2839,16783,1454
24618,1,63,2506,58,4713,5
11249,166,7429,3230,6706,36591,723
43903,20,275,971,207,4828,68
40694,17,599,1633,432,14069,167
26358,42,1409,2429,1163,13026,246
31558,7,898,2157,422,10690,476
46091,130,3287,339,2484,28151,803
16640,857,28129,2909,19489,70875,8640
30331,17,368,2220,223,9177,145
18124,2,88,2834,77,2271,11
37648,7,339,1842,172,4790,167
41459,9,251,1540,183,6681,68
46291,2,38,267,29,1789,9
17532,577,42222,2860,29031,300746,13191
46052,3,44,350,38,1937,6
21735,4,584,2649,451,13009,133
39090,4,128,1744,111,3490,17
14670,1,101,3008,89,3128,12
26208,19,558,2436,480,13061,78
27994,0,138,2344,120,3898,18
15492,54,1061,2963,844,6388,217
41389,3,75,1551,58,2341,17
25775,1,190,2456,168,5242,22
35043,56,1553,2005,1323,14253,230
5127,692,20563,3572,14514,205348,6049
28354,39,1562,2324,1232,10868,330
13951,9,414,3058,397,8675,17
45769,83,1321,467,863,22027,458
41767,7,187,1492,111,4628,76
13189,21,1114,3117,863,26392,251
18254,1,105,2828,90,2272,15
12630,307,29516,3158,14878,146668,14638
24589,459,18425,2508,13598,61399,4827
36087,55,1767,1934,1234,15498,533
17883,188,16123,2846,7773,87281,8350
22634,20,823,2603,595,21552,228
26719,283,18969,2413,13679,145245,5290
31598,3,56,2156,46,2430,10
14611,17,671,3011,648,14499,23
38803,81,3318,1762,1460,14048,1858
27284,0,60,2386,54,7378,6
22581,10,584,2604,456,8791,128
18693,111,15214,2809,5514,89859,9700
14386,546,62610,3027,26687,311249,35923
33950,24,497,2055,401,11691,96
41827,9,462,1478,347,15336,115
15806,4,105,2948,81,1677,24
15770,30,1150,2949,886,18584,264
41272,24,1012,1568,726,26267,286
41177,31,597,1584,436,8314,161
45714,2,68,490,32,1376,36
23741,12,535,2548,384,5586,151
16087,71,3386,2935,2017,18778,1369
14820,9,349,2997,298,4784,51
15398,6,215,2967,156,3542,59
21620,1,108,2655,70,2177,38
30271,152,5069,2224,2085,22397,2984
37658,7,160,1842,121,6290,39
32621,5,364,2106,280,5057,84
12557,27,61641,3163,1360,15863,60281
19328,23,722,2782,556,15994,166
21311,13,461,2673,273,10748,188
12631,4,192,3158,184,3038,8
23543,15,851,2558,569,21291,282
20432,432,45415,2724,18653,121177,26762
32626,10,486,2106,349,12220,137
14552,5,242,3016,213,12218,29
41022,2,120,1604,93,3997,27
24669,7,543,2504,410,18706,133
36520,1,70,1912,59,2024,11
32974,1,51,2092,30,2495,21
41268,48,1539,1569,1233,15194,306
21730,31,2894,2649,1082,16116,1812
40163,83,3155,1679,1743,18842,1412
32606,0,29,2107,21,1362,8
23129,7,649,2578,509,5383,140
26383,14,1115,2428,852,15176,263
25868,2,86,2452,71,2265,15
41822,44,970,1480,844,19490,126
26763,70,2902,2411,1930,36362,972
17560,13,651,2859,531,8630,120
31795,79,2297,2145,1841,22323,456
45877,2,31,433,27,1267,4
33044,1366,103014,2089,34881,289347,68133
40505,9,371,1649,314,7444,57
27738,117,10216,2359,5671,63681,4545
26220,1512,60028,2436,36401,238401,23627
31730,0,187,2149,152,5707,35
38257,106,4933,1800,3163,47395,1770
20588,15,1783,2716,645,7120,1138
46102,19,261,336,177,8789,84
14886,45,2351,2993,1851,31777,500
25001,55,1031,2491,667,8018,364
33151,35,441,2084,361,6952,80
27055,3,233,2400,135,4247,98
44144,24,267,931,245,8084,22
26955,15,392,2402,336,5031,56
17353,5,327,2869,207,3992,120
42434,31,601,1365,434,8066,167
34530,0,73,2033,58,2137,15
13171,125,9535,3117,7410,66475,2125
30249,3,296,2225,192,5270,104
17932,12,442,2844,365,8033,77
23177,57,1416,2576,1050,18214,366
36954,535,32176,1886,14943,181098,17233
23004,8,283,2583,206,7870,77
17625,32,1962,2856,1412,11991,550
13057,31,48712,3133,1486,17827,47226
35084,16,299,2003,255,5028,44
27559,14,1161,2369,906,20704,255
36576,26,256,1909,207,3853,49
5887,27,1210,3533,968,16791,242
33319,49,2025,2078,1389,16666,636
36666,23,883,1903,571,10034,312
31592,3,143,2156,114,9363,29
32279,1,19,2121,16,2143,3
46353,0,103,243,63,3147,40
25636,5,778,2462,599,20185,179
32730,60,1317,2102,1028,22227,289
32973,4,146,2092,125,5324,21
21041,35,1438,2688,1197,6193,241
15642,32,2517,2955,1888,11434,629
34269,3,29,2045,25,1341,4
25725,34,1128,2458,782,7822,346
16062,1,174,2937,126,3693,48
12960,21,708,3139,681,6918,27
36902,73,1255,1889,774,9719,481
41380,3,127,1553,95,5680,32
40754,111,3228,1627,2368,39812,860
26202,41,1523,2437,1201,11324,322
16618,4,349,2910,270,6381,79
29723,0,57,2251,55,4455,2
33702,30,1360,2064,746,19720,614
41213,289,10063,1580,5895,66259,4168
41917,14,510,1465,386,13161,124
37707,29,471,1839,389,8814,82
36745,13,427,1899,339,8407,88
45477,8,140,585,95,4410,45
12223,13,924,3182,797,10518,127
19389,19,696,2779,547,16229,149
34298,2,98,2044,89,3045,9
28264,43,1968,2329,1524,10559,444
32527,30,683,2111,451,6980,232
35943,50,453,1946,355,4231,98
19084,5,67,2794,57,2334,10
18209,40,1864,2830,1449,22183,415
31037,17,689,2185,549,6347,140
36427,8,425,1917,333,6001,92
12230,15,798,3181,594,6172,204
33364,24,926,2076,702,12488,224
28027,117,5229,2342,3539,50001,1690
33250,8,119,2081,104,3845,15
13180,25,1591,3117,1450,24386,141
1051,3,64,3948,56,3166,8
20606,37,1976,2715,1043,13050,933
35511,106,5893,1978,3026,22412,2867
44681,52,754,840,547,8203,207
36223,8,236,1927,187,5925,49
16520,102,4291,2915,3280,22759,1011
39806,7,227,1703,186,4041,41
42776,8,133,1293,84,2759,49
26852,29,1757,2407,1336,25418,421
18295,9,425,2826,374,4876,51
43836,0,298,979,253,5155,45
17980,155,5759,2841,4566,47542,1193
38184,5,237,1806,192,9183,45
12074,129,4666,3190,3072,24779,1594
24141,21,1057,2529,843,11931,214
18909,33,1173,2800,898,6400,275
15968,21,2021,2942,1111,32164,910
38853,45,2775,1759,2034,25627,741
39802,4,282,1703,191,7059,91
33054,430,35763,2088,15000,146756,20763
38901,2,124,1756,102,2380,22
29089,1,41,2283,38,1664,3
26702,0,18794,2414,11417,89312,7377
17529,3,107,2860,93,3577,14
27062,0,229,2400,73,2370,156
22289,2,74,2619,58,2078,16
38364,7,150,1792,123,3535,27
18532,28,1517,2817,1151,20252,366
19271,5,287,2785,216,6870,71
41037,38,808,1603,653,20781,155
39338,54,800,1729,696,8955,104
12480,8,403,3166,339,4461,64
42638,9,158,1326,130,5838,28
26442,13,204,2426,134,5515,70
20403,1,226,2725,171,2961,55
22525,19,1357,2607,1046,14715,311
28855,2,149,2295,128,4876,21
44148,11,111,930,94,8344,17
27858,2,59,2352,48,2635,11
14935,20,692,2991,678,15023,14
31038,11,629,2185,295,6988,334
28636,45,1325,2306,963,11266,362
15209,2,122,2975,115,3558,7
34106,15,214,2050,188,3975,26
33338,45,1802,2077,1345,13965,457
33654,3,176,2066,111,5302,65
42301,19,1077,1393,441,12278,636
35275,6,165,1992,123,3717,42
45641,18,336,527,293,6406,43
2268,209,24153,3653,21332,128201,2821
33248,733,12351,2081,9254,48696,3097
37444,23,513,1856,412,12945,101
44792,35,470,804,280,9840,190
19446,1,150,2775,103,4073,47
39097,7,134,1744,107,6911,27
34817,8,213,2016,175,5457,38
31077,1,138,2183,123,5443,15
31016,21,495,2186,405,9152,90
18197,148,6013,2831,4466,31018,1547
44947,12,169,757,145,2844,24
34702,42,1071,2023,894,8303,177
42946,12,124,1249,100,3599,24
20922,20,452,2695,311,3117,141
23602,7,264,2555,232,4175,32
37753,55,1359,1835,778,13113,581
41375,3,83,1553,60,3258,23
33379,5,107,2076,76,2465,31
9676,19,1436,3311,1222,19860,214
8057,3,46010,3409,151,3453,45859
36987,90,3406,1884,2451,26315,955
9159,286,25584,3342,15199,127343,10385
15779,2,54,2949,50,4081,4
35420,104,1216,1985,948,14023,268
16857,71,3147,2896,2030,21447,1117
26933,17,288,2403,234,4550,54
34732,1,138,2022,58,3764,80
29280,10,644,2274,547,16858,97
28114,9,697,2338,504,21130,193
38995,16,875,1751,630,7659,245
24275,3,68,2524,56,2286,12
24859,54,1107,2497,885,13311,222
36207,21,516,1928,389,7131,127
35079,0,239,2003,189,16794,50
33361,12,310,2077,225,5048,85
34781,142,6315,2019,3760,56746,2555
11986,48,1463,3193,1292,26676,171
18049,6,421,2837,287,8510,134
31400,46,2138,2167,1744,18276,394
33026,137,21766,2089,4440,75325,17326
36580,6,163,1909,140,9144,23
20140,6,480,2739,290,7299,190
14874,3,179,2994,171,3800,8
44946,86,880,757,845,13238,35
22362,5,280,2616,240,12770,40
19272,28,640,2785,494,4671,146
24179,14,1034,2528,732,8756,302
40669,7,204,1635,125,5828,79
45551,0,8,560,7,1440,1
14918,567,24437,2992,17632,76508,6805
18922,8,445,2800,248,10250,197
41826,18,549,1479,393,17925,156
39927,40,1719,1694,996,17942,723
26075,189,4487,2443,3578,24390,909
15636,306,14775,2955,11254,98065,3521
25003,0,2307,2491,1825,28007,482
27798,0,174,2355,117,6094,57
14605,0,421,3012,392,6018,29
32787,120,8968,2099,5124,42137,3844
22193,15,418,2624,280,5159,138
33262,22,1028,2080,789,13543,239
19054,33,1787,2795,1442,7660,345
23013,16,1433,2583,1068,12368,365
42008,1,61,1450,41,2288,20
29910,3,162,2241,60,3308,102
9758,14,488,3308,419,6657,69
42923,85,1225,1256,956,22251,269
33433,2,45,2074,44,5327,1
33838,14,567,2058,439,9729,128
25212,12,518,2481,405,8532,113
35729,14,555,1961,382,6062,173
26631,13,1178,2418,873,23180,305
28243,38,910,2330,693,6287,217
27516,8,314,2372,237,2773,77
18288,2,179,2827,155,2590,24
30863,4,106,2192,65,3414,41
26764,27,1640,2411,777,25320,863
24118,124,10799,2531,4504,40828,6295
15552,5,514,2960,227,14865,287
12534,2,59,3164,54,1386,5
16588,6,233,2912,182,2799,51
35710,4,57,1962,51,2767,6
19395,18,560,2778,357,4149,203
30635,96,3287,2203,2549,22512,738
23231,11,1001,2573,437,7874,564
13094,24,1903,3130,1499,12897,404
27761,10,241,2358,145,5926,96
25732,11,600,2458,506,5029,94
40506,35,982,1649,702,8041,280
27165,16,637,2394,487,19205,150
27878,3,109,2351,84,3431,25
32373,2,379,2116,223,4883,156
24021,20,1353,2535,955,16174,398
34560,5,102,2032,89,3290,13
46062,6,45,348,41,1484,4
44697,222,3019,834,1909,26608,1110
22254,636,104790,2620,33596,294252,71194
46120,1,17,330,17,749,0
29247,38,2414,2275,1124,10818,1290
43962,171,3289,963,2530,38888,759
44924,8,385,764,194,4471,191
15397,12,417,2967,344,10481,73
30273,1,61,2224,43,4127,18
29745,0,126,2251,101,2879,25
34631,63,2806,2028,2140,38184,666
22066,154,8165,2630,3267,36251,4898
34240,3,77,2046,60,2384,17
31876,5,116,2142,98,10163,18
15576,5,221,2958,157,6639,64
21002,47,1472,2690,814,19033,658
23005,10,532,2583,418,4172,114
14957,64,20005,2989,1280,16936,18725
34385,254,9720,2040,7313,58722,2407
27511,2,204,2372,162,4737,42
24209,1,19,2527,16,1068,3
26230,0,14,2436,12,1299,2
32884,15,411,2095,314,6611,97
26022,12,259,2445,207,2790,52
43757,27,359,999,237,9875,122
33756,55,1454,2061,1099,13386,355
28099,1,43,2339,25,2742,18
31525,1,108,2159,98,4393,10
33605,96,3378,2067,2328,25409,1050
18016,10,537,2838,463,6056,74
38494,2,226,1784,123,10655,103
37314,0,83,1863,54,4679,29
19869,5,247,2754,194,5992,53
11075,19,993,3240,968,14976,25
35800,48,758,1955,576,8461,182
18140,0,45,2833,35,5268,10
36432,11,342,1917,277,7460,65
15181,3,186,2977,159,4084,27
29155,11,481,2280,330,11913,151
9912,20,644,3300,617,19811,27
20696,3,206,2710,173,2939,33
18131,352,19023,2834,14163,138944,4860
27241,1,116,2389,81,4410,35
33299,213,17822,2079,7376,101513,10446
26885,4,156,2405,121,4774,35
26888,8,611,2405,506,9735,105
41422,60,1039,1546,772,14309,267
32820,0,30,2098,29,1869,1
24059,28,944,2534,674,8679,270
32232,15,171,2123,144,3136,27
27075,82,4935,2399,3572,41500,1363
38833,7,206,1760,169,2701,37
17367,7,258,2868,216,13634,42
35696,229,15145,1963,3818,46848,11327
18623,6,142,2812,129,11971,13
40909,136,3445,1612,2677,29271,768
15985,10,500,2941,390,14727,110
31036,115,1611,2185,1282,11307,329
31112,20,583,2181,489,6919,94
31686,14,283,2150,191,4492,92
29163,280,7755,2280,5952,76072,1803
20900,24,859,2696,527,4211,332
40746,49,1764,1628,1201,28958,563
29391,170,5918,2267,4329,46152,1589
17705,15,760,2853,615,12701,145
11685,46,2621,3207,1789,38886,832
31588,23,1581,2156,841,17551,740
41571,100,2365,1527,1738,25217,627
27057,1,42,2400,37,1978,5
41741,39,557,1498,429,14152,128
40920,3,315,1611,235,5947,80
41358,14,215,1556,154,5009,61
1122,7,146,3929,121,6387,25
30213,28,1467,2227,1152,22637,315
33298,141,7021,2079,4525,43399,2496
31797,25,566,2145,447,8771,119
23941,6,414,2538,281,7360,133
46038,2,12,358,12,2003,0
28730,410,19443,2301,13477,108116,5966
44001,155,1300,956,1200,11025,100
17666,34,3905,2854,2802,48462,1103
33438,133,3698,2074,2520,30844,1178
29109,2,174,2282,135,7212,39
23295,75,3203,2570,2178,26747,1025
37152,274,37905,1874,5253,137054,32652
15448,26,1614,2965,1247,10770,367
43057,8,188,1218,101,3870,87
37273,16,297,1866,246,5047,51
22820,49,1555,2593,980,5722,575
35251,3,77,1993,69,5442,8
31146,11,237,2180,200,10856,37
42278,9,204,1396,171,5738,33
34341,11,466,2042,391,12139,75
25460,0,155,2471,119,3049,36
23723,7,145,2549,130,4381,15
43749,9,229,1001,155,9002,74
41907,0,53,1467,40,3404,13
10798,65,4502,3254,4092,23515,410
8714,173,5092,3368,4639,33745,453
37904,536,13867,1824,5997,92014,7870
24171,0,17636,2528,6427,69284,11209
45371,5,83,612,63,3969,20
18344,3,326,2824,161,7493,165
17647,13,418,2855,317,12385,101
41159,3,281,1587,222,8034,59
19817,14,1088,2756,720,30291,368
12580,104,16056,3162,11058,109978,4998
22667,0,8105,2600,6073,47359,2032
17349,9,242,2869,163,6863,79
20778,207,10906,2706,6847,39278,4059
25488,7,570,2470,465,12595,105
39359,20,396,1727,308,4234,88
32475,0,23,2113,22,2172,1
23940,2,105,2538,91,2724,14
7196,85,5966,3473,4684,26918,1282
35274,10,124,1992,113,4375,11
19308,5,162,2783,139,2980,23
23042,31,3358,2582,2003,22165,1355
28952,31,1129,2290,939,19422,190
35953,4,301,1945,148,3942,153
18931,137,7906,2800,5574,36786,2332
43656,36,389,1026,363,7127,26
17594,14,1433,2857,343,12268,1090
45780,5,44,464,41,2383,3
21305,151,11070,2673,6308,57597,4762
32297,6,183,2120,154,4168,29
15322,11,1483,2970,739,15750,744
28728,1,14,2302,13,912,1
25397,9,351,2474,283,4073,68
32328,1,371,2119,298,10753,73
27807,28,3657,2354,2504,44734,1153
20906,5,262,2696,202,6158,60
43432,19,527,1106,369,7322,158
25979,1,59,2447,56,2543,3
23322,66,2255,2568,1698,29698,557
18751,19,724,2807,608,6669,116
40387,20,577,1660,390,5082,187
33521,24,894,2070,411,5214,483
39020,142,5399,1749,4205,31848,1194
34112,23,535,2049,444,6081,91
14932,37,1826,2991,1460,28609,366
15817,5,591,2948,441,13323,150
15644,1,123,2955,101,10088,22
1054,1,85,3948,75,3966,10
22356,102,2928,2616,2315,29297,613
23274,1,165,2571,142,5338,23
21747,3,869,2648,527,17122,342
42295,5,249,1393,195,3063,54
30162,37,1611,2231,1189,8719,422
43890,10,199,973,163,6247,36
15046,25,704,2984,617,8090,87
39419,69,792,1724,649,9575,143
37957,3,137,1820,109,7153,28
12272,23,951,3178,787,24249,164
44933,28,275,762,275,7264,0
26715,0,3705,2414,2632,18488,1073
32256,1,37,2122,22,2240,15
5396,39,517,3558,444,10593,73
27967,20,522,2345,461,3644,61
43113,15,295,1201,211,4365,84
37070,13,345,1879,275,9301,70
18665,4,337,2810,278,11745,59
40985,5,259,1607,137,4936,122
18030,0,62,2838,49,2982,13
34157,74,1780,2049,1131,11364,649
19703,7,573,2764,459,9375,114
40061,2,117,1685,69,5218,48
41711,73,2132,1503,1203,21387,929
43354,29,710,1131,389,7709,321
39728,6,129,1707,122,3548,7
39772,11,207,1705,176,5629,31
46313,21,346,255,291,6463,55
45486,12,227,582,192,4735,35
42040,6,409,1445,258,7518,151
40277,1,16,1671,14,1706,2
35037,17,614,2005,388,9351,226
12857,127,51424,3145,9702,71810,41722
25353,45,1418,2476,1124,21128,294
14239,63,3886,3039,2465,31977,1421
15007,12,441,2987,401,4828,40
19631,30,886,2768,648,10937,238
34299,8,270,2044,208,5445,62
31469,38,1599,2163,1135,18876,464
19646,5,414,2767,307,10959,107
43235,148,3625,1165,2123,21209,1502
21227,218,12227,2676,6926,57177,5301
22054,4,237,2631,172,9033,65
35575,1,52,1974,45,4017,7
18498,4954,1427480,2818,130361,1634486,1297119
15373,14,1312,2968,604,3313,708
25501,0,317,2469,187,8730,130
38496,29,1637,1783,615,20161,1022
38895,2,153,1757,137,5550,16
34539,16,406,2032,344,8002,62
45796,10,81,462,78,4402,3
32673,19,779,2104,585,12158,194
42170,26,317,1418,242,6457,75
16044,7,559,2937,360,6732,199
10183,248,11640,3287,7089,76637,4551
40468,265,6200,1652,4646,38171,1554
36074,22,342,1935,277,5749,65
36205,71,2469,1928,1342,17103,1127
11278,153,11793,3229,9357,60106,2436
36595,65,1723,1908,1199,25022,524
29504,4,82,2261,67,4154,15
27908,10,1377,2349,1011,19099,366
39288,328,15257,1731,11464,81886,3793
34394,3,178,2039,154,7846,24
42362,2,77,1380,56,6158,21
28762,55,2831,2299,2131,41782,700
38621,18,386,1773,290,9959,96
15885,271,17538,2945,10155,91732,7383
40901,127,3348,1613,2353,31628,995
25321,7,143,2477,125,4156,18
37973,14,137,1819,115,5160,22
15566,94,8010,2958,5616,42372,2394
17852,2,270,2848,184,4384,86
29057,4,234,2285,158,4283,76
34869,7,322,2013,250,5487,72
37680,9,222,1841,181,10023,41
14220,36,1146,3041,1023,12050,123
18904,12,466,2800,265,6078,201
40880,88,3275,1614,2123,34353,1152
23530,387,22889,2558,16224,163939,6665
34051,21,391,2051,317,6079,74
17505,6,205,2861,155,4435,50
39032,43,636,1749,494,7823,142
42313,8,121,1390,77,3415,44
13309,176,12847,3109,6812,83922,6035
29620,0,76,2256,60,3628,16
16306,51,1814,2925,1399,16601,415
28424,0,110,2319,100,5091,10
10299,197,15266,3282,10033,147434,5233
28216,3,131,2331,105,2353,26
32657,45,1612,2105,1088,24965,524
35027,58,3731,2006,1713,28307,2018
27148,158,2978,2394,2256,17680,722
30076,48,2555,2234,2020,22728,535
22159,64,4801,2625,2360,31076,2441
43024,2,98,1229,67,5542,31
17137,47,2742,2880,1849,14716,893
40120,3,91,1682,69,3176,22
20853,1,169,2701,145,4940,24
16794,4,174,2899,125,3022,49
19413,34,5005,2777,2402,30698,2603
31159,24,1026,2179,756,10719,270
7612,51,3396,3450,3278,29695,118
43914,7,98,968,83,2029,15
29731,1,208,2251,113,9384,95
15265,24,1248,2973,1119,25969,129
22966,1,133,2585,109,4881,24
14901,51,1374,2992,1061,16512,313
20410,37,668,2725,545,5087,123
23834,135,59410,2544,2664,97069,56746
24880,2,440,2496,318,10263,122
29528,4,102,2261,79,2709,23
40456,14,375,1654,321,4917,54
16720,20,739,2905,550,8049,189
17639,5,184,2855,154,1978,30
21465,5,273,2664,229,3647,44
11993,3,136,3193,117,4268,19
11124,127,7669,3237,6488,44986,1181
42047,12,305,1444,176,4692,129
27371,9,558,2381,442,7771,116
34883,69,2359,2013,1370,23055,989
15225,66,6140,2974,3726,28364,2414
38290,6,293,1798,254,7763,39
20679,64,2155,2711,1546,21507,609
17534,14,1062,2860,515,13973,547
13513,49,3247,3093,2585,18673,662
23069,1339,35712,2581,22932,113507,12780
39725,5,105,1707,95,3023,10
15433,3,351,2966,246,4633,105
41868,37,647,1473,514,9746,133
11362,309,17233,3225,11658,55351,5575
32342,113,2576,2118,1949,10874,627
32283,1,50,2121,44,2738,6
8049,221,20684,3409,11652,102544,9032
13486,23,1032,3095,897,9018,135
12379,13,556,3172,441,9517,115
23135,3,132,2578,112,3029,20
20506,23,625,2721,482,5722,143
25898,74,3547,2451,2236,18705,1311
9972,17,507,3297,461,5103,46
24811,28,978,2499,778,13247,200
42066,22,307,1441,249,8120,58
41774,257,10716,1491,3257,65811,7459
15699,2,151,2953,114,4210,37
26593,0,78,2419,71,3814,7
23778,8,290,2547,218,5335,72
35771,48,1309,1958,1082,9621,227
16089,3,259,2935,205,4973,54
31649,51,776,2152,621,7167,155
23843,16,891,2544,715,4966,176
45553,130,1383,559,1157,12018,226
35346,88,837,1988,631,6782,206
9952,777,31653,3298,27970,119200,3683
45870,29,263,438,220,2697,43
16818,583,58418,2898,18888,92029,39530
7487,497,17583,3458,16373,102697,1210
23114,69,2556,2578,1788,18248,768
38712,34,613,1768,396,5523,217
38144,35,664,1808,533,9336,131
39851,25,812,1700,609,5824,203
18996,29,3728,2797,1529,27605,2199
34037,3,105,2052,93,3396,12
29961,6,235,2240,182,3574,53
11027,131,6216,3242,5288,40536,928
28558,70,3591,2310,2786,21948,805
19004,41,1922,2797,1508,21065,414
21864,21,1519,2642,1018,13780,501
17577,26,1219,2858,746,6891,473
17229,202,13952,2875,5845,89908,8107
25836,14,1715,2454,1066,38593,649
31290,14,656,2172,459,6842,197
6611,625,30543,3503,25007,126974,5536
23144,44,3602,2577,2750,26580,852
11371,13,551,3225,414,15835,137
40326,20,965,1667,686,8646,279
25558,318,10598,2467,6953,86845,3645
13758,19,38486,3073,869,10994,37617
29827,270,12463,2246,9603,62916,2860
24317,8,286,2522,213,4156,73
16196,50,6127,2931,4506,36193,1621
39880,6,290,1697,247,11852,43
15061,28,1209,2983,1133,14065,76
17099,1,537,2883,383,11777,154
30629,6,105,2203,90,2619,15
44741,90,1070,819,712,11773,358
38540,111,2638,1779,1741,16741,897
1099,5,208,3935,159,4716,49
38351,30,1496,1793,472,12511,1024
46119,10,165,330,139,3235,26
14983,331,14366,2988,10165,60653,4201
31186,11,200,2177,169,4229,31
36257,8,251,1926,219,5587,32
35671,285,7164,1965,4696,57010,2468
43041,14,533,1223,361,11790,172
43669,0,21,1026,17,1933,4
21546,720,67030,2659,35071,271423,31959
45057,6,107,721,78,4283,29
27358,1,48,2382,45,2159,3
43187,7,161,1181,108,4223,53
29633,31,596,2255,493,5043,103
34808,7,324,2017,173,5198,151
11810,2,123,3202,118,5663,5
39163,53,873,1740,676,8461,197
26438,141,11374,2426,6722,57338,4652
18681,4,105,2810,83,4224,22
37305,13,308,1864,271,3074,37
45606,12,386,546,245,9851,141
18794,6,225,2805,154,5595,71
39041,16,407,1748,293,6614,114
34794,0,145,2018,117,5273,28
1136,3,158,3927,130,7658,28
6359,842,47148,3514,41263,219914,5885
30716,0,66,2199,60,4723,6
1218,5,44,3899,36,3329,8
42986,19,613,1239,423,8995,190
43864,12,143,977,113,4213,30
26487,4,117,2424,101,2696,16
14793,9,206,2999,204,3889,2
2817,1,137,3644,126,5371,11
41763,12,376,1493,298,10716,78
42600,23,609,1333,502,16212,107
32061,4,251,2132,171,7316,80
21649,3,64,2653,50,4515,14
31444,5,287,2164,145,14047,142
25621,22,680,2463,527,5374,153
45995,10,163,381,123,2509,40
41945,258,9548,1460,4485,61543,5063
36026,71,893,1939,683,7263,210
37880,19,459,1825,402,7395,57
35178,3,312,1997,239,6677,73
35636,18,1034,1969,708,14029,326
42254,1,134,1400,111,9745,23
40316,1,177,1668,52,4887,125
18170,6,439,2832,274,7797,165
44943,13,189,758,107,2817,82
25523,8,320,2468,237,8366,83
32141,1,71,2127,61,2945,10
45775,7,187,465,154,2939,33
12508,59,3471,3164,2730,30644,741
30253,1,51,2225,34,1904,17
19591,227,14919,2769,9200,77764,5719
26099,12,1483,2442,339,5891,1144
27257,2,66,2388,49,3004,17
21992,16,1668,2634,1256,10933,412
36083,14,241,1935,199,4386,42
17781,1354,105863,2851,34291,422260,71572
26751,9,571,2412,482,7549,89
22277,34,4403,2619,2548,33902,1855
38360,3,121,1792,96,7387,25
26621,94,4821,2418,3846,54307,975
29995,13,823,2238,462,12175,361
19507,10,624,2773,486,4866,138
24125,18,896,2530,752,6764,144
35257,47,847,1992,688,8834,159
25661,0,138,2461,112,3562,26
18723,203,27738,2808,9362,167058,18376
14549,17,561,3016,493,13584,68
43161,1,57,1187,44,4084,13
45635,0,1128,530,915,15143,213
32859,12,1807,2096,135,5684,1672
41974,26,484,1456,396,9975,88
42449,160,4261,1362,2299,57815,1962
46008,3,54,373,42,1741,12
15916,3,292,2945,223,7984,69
29087,561,31482,2283,14322,166382,17160
43186,17,337,1181,256,4360,81
42176,0,0,1417,0,1709,0
30046,58,1847,2236,1494,22376,353
24593,21,314,2508,213,12816,101
42875,29,479,1269,330,5265,149
40743,42,986,1629,811,22222,175
40406,49,547,1659,425,6438,122
11721,246,8052,3205,6626,44311,1426
39555,1,74,1717,62,3889,12
30835,2,62,2193,51,2152,11
28087,5,387,2339,224,7016,163
35668,3,352,1965,277,11850,75
41995,165,4903,1453,2562,41755,2341
29864,4,74,2244,59,2007,15
14261,11,328,3037,315,4198,13
42415,56,2016,1369,1373,11477,643
28486,18,1063,2316,615,9047,448
38908,23,924,1756,694,12850,230
22527,3,84,2607,65,2296,19
11038,16,490,3242,391,4366,99
40362,4,539,1662,357,8516,182
38472,5,360,1785,294,2808,66
35242,3,102,1993,87,5789,15
31158,0,0,2179,0,1290,0
19059,16,449,2795,320,3450,129
36518,18,704,1912,547,11868,157
41648,0,26,1513,21,2464,5
17958,150,10453,2842,7766,54186,2687
32298,74,3923,2120,1638,27178,2285
27419,5,339,2378,227,4833,112
31986,2,81,2136,74,3309,7
30361,2,80,2218,66,2679,14
45988,4,52,383,32,1381,20
22865,7,172,2591,111,2393,61
42809,0,76,1282,54,2336,22
25855,1,39,2453,23,3245,16
42441,39,503,1364,371,8320,132
25653,5,226,2461,182,5548,44
28348,0,53,2324,48,2843,5
42796,20,230,1285,153,6254,77
42590,9,355,1335,232,9247,123
45177,50,1047,668,549,9128,498
18246,39,554,2828,440,6761,114
17127,44,4672,2881,2137,13302,2535
33000,7,217,2091,182,3675,35
14597,0,405,3012,306,8109,99
36312,2,67,1922,48,2299,19
25399,51,2249,2474,1329,25786,920
37093,0,72,1877,58,2626,14
29652,157,4878,2254,1968,28557,2910
46160,39,355,307,313,4758,42
45592,17,182,549,96,3639,86
44587,26,310,860,254,6899,56
16839,14,681,2897,530,11637,151
15329,83,3100,2969,2355,26067,745
31931,0,97,2139,88,5325,9
12342,4,315,3175,281,13562,34
11463,17,1422,3219,1169,15788,253
27128,27,840,2395,599,6122,241
29780,9,259,2248,151,4603,108
36121,4,80,1932,67,4630,13
32901,19,319,2094,275,4922,44
15923,7,194,2944,154,6021,40
32366,9,405,2117,339,6979,66
31107,8,161,2182,126,5427,35
31911,3,120,2140,92,2503,28
30945,7,74,2190,56,2874,18
39724,5,105,1707,92,2382,13
28639,7,337,2306,254,10206,83
15743,16,678,2950,547,8667,131
36425,15,237,1917,196,4611,41
17182,14,848,2878,544,9603,304
13826,9,697,3070,612,16044,85
29742,193,8351,2251,3675,100463,4676
10713,286,9302,3259,7863,45622,1439
39231,17,236,1735,187,6053,49
42335,4,109,1386,82,3235,27
25659,13,271,2461,225,4126,46
43149,4,193,1190,129,5481,64
29401,12,387,2267,324,9896,63
25385,9,289,2474,233,4827,56
10162,132,5489,3288,4691,42018,798
12707,5,286,3154,284,4976,2
14365,8,114,3029,99,6858,15
14642,109,5004,3009,4001,40152,1003
33853,1,131,2058,100,5033,31
23140,124,5120,2577,2739,27875,2381
41939,297,8139,1462,5825,83843,2314
14648,16,485,3009,428,13084,57
41553,117,2222,1529,1423,28825,799
44664,4,83,845,64,2697,19
31874,0,138,2142,105,3003,33
30720,1,104,2198,90,5455,14
39983,16,625,1690,409,25940,216
14041,45,2616,3051,1802,12239,814
42363,96,5040,1380,2595,46140,2445
27514,1,36,2372,35,2552,1
25949,29,1543,2448,1045,7983,498
17496,8,609,2862,352,13491,257
25235,26,1205,2480,838,12250,367
35876,4,77,1950,70,2183,7
28566,7,219,2310,172,2104,47
24144,6,415,2529,341,8291,74
27553,37,1426,2369,1046,13967,380
43165,65,695,1186,476,14133,219
41466,4,121,1539,98,3427,23
42470,3,81,1358,65,4002,16
18969,27,843,2798,623,12482,220
19943,5,118,2750,93,3565,25
42498,7,385,1352,133,7354,252
28512,34,1947,2314,776,15518,1171
23369,18,618,2566,521,14274,97
41659,3,182,1512,136,5591,46
41718,110,1046,1502,710,11085,336
45028,69,615,733,572,5756,43
22400,16,1597,2614,512,5665,1085
36589,1,63,1908,35,6154,28
20584,51,1352,2716,1021,12147,331
26895,2,133,2405,98,8580,35
27042,13,315,2400,259,5999,56
38873,8,199,1758,164,3673,35
30281,30,552,2223,424,2913,128
28416,2,178,2320,150,3708,28
31920,0,36,2140,26,1672,10
45766,9,155,468,143,4073,12
42035,76,1064,1446,853,17653,211
987,4,87,3974,74,3377,13
15836,30,1552,2947,1186,15880,366
43296,60,1046,1148,699,32797,347
27443,0,96,2376,73,2907,23
8939,95,4528,3355,4418,33500,110
38890,30,748,1757,612,7950,136
45925,66,1042,412,764,7636,278
19816,5,211,2756,178,7206,33
35731,22,548,1961,411,17278,137
25349,39,762,2476,620,6320,142
14245,15,2050,3039,1689,79338,361
21247,0,19,2675,17,2335,2
34309,3,150,2043,131,5844,19
18479,38,1102,2818,901,8280,201
24710,49,1962,2502,1502,23268,460
22318,30,2803,2618,1662,27064,1141
22991,6,296,2584,212,3839,84
19313,81,2696,2782,2071,34844,625
42872,1,65,1270,41,2780,24
40318,5,269,1668,184,10805,85
35235,22,1123,1994,346,8395,777
28501,24,859,2315,529,12762,330
21820,15,285,2644,216,8553,69
41588,6,116,1523,84,5934,32
29381,43,3648,2268,2132,32721,1516
30583,13,438,2206,327,5734,111
28242,19,376,2330,285,8592,91
39775,2,113,1705,71,2931,42
42785,29,202,1289,170,4805,32
40581,65,2176,1642,1472,23654,704
15488,17,1070,2963,538,7909,532
16474,14,531,2917,375,10322,156
28649,523,17560,2305,11688,156764,5872
17189,959,137770,2877,41660,281051,96110
35345,21,395,1989,305,7385,90
15765,1,27,2950,23,3448,4
28457,3,169,2318,145,12482,24
16844,1,138,2897,98,4079,40
30324,4,282,2220,229,4708,53
44085,23,1427,930,506,11855,921
30534,32,504,2208,321,4073,183
21419,4,256,2667,195,6023,61
33995,207,5768,2053,4550,40441,1218
20455,21,780,2723,443,6668,337
11457,74,77128,3220,5108,57082,72020
23384,130,5095,2565,1774,34846,3321
11470,2,66,3219,53,3523,13
15728,21,3315,2951,1923,10506,1392
15872,7,293,2946,210,7518,83
3943,9,459,3621,367,25526,92
6189,314,7517,3522,6524,59308,993
41557,6,223,1528,179,10017,44
35066,6,179,2003,138,3403,41
37079,4,95,1878,82,4834,13
13133,463,33551,3127,23311,256822,10240
36610,9,106,1906,90,4116,16
25071,9,2672,2488,602,10114,2070
36950,6,202,1886,170,9159,32
11904,16,968,3198,881,15124,87
25760,13,346,2457,291,9625,55
21149,19,2346,2681,1718,17602,628
20526,149,3699,2719,2788,21101,911
22925,233,15671,2587,11152,156810,4519
23173,49,1819,2576,1371,7232,448
16164,23,3731,2932,1900,16921,1831
22238,23,895,2621,741,7849,154
12010,28,407,3192,393,9763,14
23419,129,5216,2563,3418,29095,1798
34116,1,19,2049,16,1157,3
39327,82,1331,1729,1048,15788,283
30091,3,400,2234,102,4565,298
27446,43,1915,2376,1555,41784,360
18352,83,3841,2823,2838,77454,1003
30643,0,11,2203,11,1439,0
42640,232,3645,1325,2652,32057,993
37727,20,561,1837,473,10318,88
45444,3,27,593,20,1290,7
22197,171,7628,2623,3445,37130,4183
34234,11,542,2047,261,5911,281
34465,266,9169,2037,4742,46674,4427
30460,51,2427,2212,2070,21999,357
9851,39,1974,3303,1756,18849,218
11165,550,23556,3234,20706,80634,2850
10059,12,1728,3292,1602,36720,126
45668,0,29,512,23,3985,6
32724,24,305,2102,250,2959,55
27693,9,285,2362,225,6050,60
31355,4,126,2169,111,3452,15
39669,11,620,1710,314,9990,306
32865,83,4670,2096,3518,44177,1152
13174,67,1706,3117,1489,18899,217
17030,13,747,2887,609,15031,138
14931,0,349,2991,271,6921,78
34010,194,4828,2053,2097,24199,2731
3629,325,10625,3629,9096,130241,1529
38402,21,808,1790,675,11686,133
7428,11,1135,3460,1021,18208,114
45273,19,250,638,159,6966,91
29763,9,253,2249,213,8562,40
34271,49,1459,2045,777,14155,682
24580,69,2049,2509,1220,13191,829
26313,41,1090,2432,809,11386,281
45383,51,1347,609,633,7701,714
3418,27,1079,3633,1008,5639,71
27068,0,276,2399,201,4770,75
42373,1,45,1379,31,4785,14
15680,2,72,2953,60,3521,12
24374,31,2256,2519,1308,17503,948
27089,19,766,2399,460,9763,306
35788,14,215,1956,179,4575,36
39186,0,26,1738,19,2008,7
35774,37,2023,1957,967,20482,1056
13602,119,5228,3087,4118,22876,1110
14336,237,15874,3031,9247,78428,6627
28838,2,84,2296,76,2011,8
19637,69,2304,2767,1839,12027,465
23958,6,103,2538,90,2470,13
40027,11,439,1687,338,10833,101
28746,1,61,2300,53,2736,8
36015,135,4153,1940,2562,40422,1591
31292,7,574,2172,297,5529,277
14857,88,31143,2995,3474,45964,27669
19302,15,874,2783,653,7754,221
1062,4,76,3947,67,3444,9
32340,0,58,2118,50,3154,8
35271,248,11755,1992,5892,70722,5863
20544,26,922,2718,763,10917,159
43428,92,2289,1106,1336,16147,953
21551,6,253,2659,204,13577,49
27973,52,1948,2345,1445,19339,503
35717,8,178,1961,144,3158,34
15287,20,2172,2971,1366,17677,806
26492,6,319,2424,255,5105,64
40867,143,7518,1615,2869,80953,4649
45002,4,45,742,28,2162,17
39999,212,4844,1689,3599,39818,1245
19492,33,1526,2773,1165,6636,361
32019,8,130,2134,114,4958,16
15709,0,3662,2952,2839,17689,823
43088,16,265,1207,210,4351,55
39247,7,315,1733,234,6424,81
25362,29,1326,2475,973,11671,353
30936,17,406,2190,315,4448,91
41994,7,283,1453,236,10104,47
16341,6,135,2923,79,3849,56
20118,2,196,2741,155,4135,41
45479,62,950,585,792,12658,158
16254,24,1334,2928,1086,19159,248
38877,29,695,1758,546,7870,149
43541,13,328,1072,185,6955,143
42526,9,293,1346,214,5755,79
41155,2,86,1587,70,11705,16
29038,141,3974,2286,3351,31775,623
8862,145,5722,3360,5377,46518,345
36662,0,28,1904,25,3645,3
40142,13,344,1681,238,6991,106
43082,11,159,1210,81,3152,78
27208,50,1691,2391,1229,16520,462
35589,93,1005,1972,795,9730,210
14465,1,102,3022,102,3669,0
13192,24,1649,3117,1458,21223,191
33048,2,32,2088,28,3434,4
14630,21,1196,3010,1078,9055,118
19692,9,308,2765,237,6155,71
34122,23,1704,2049,811,16858,893
21925,156,7084,2638,5062,59745,2022
17896,28,1580,2846,1200,24601,380
29851,17,550,2245,271,8261,279
35923,2,37,1947,33,3483,4
24634,98,7996,2506,3480,46761,4516
41259,89,3170,1570,2111,20801,1059
32500,398,15488,2112,9754,107192,5734
13451,1,404,3097,167,7441,237
32769,2,73,2100,68,6099,5
44392,114,2066,892,1736,13044,330
23461,14,252,2561,172,5482,80
39075,4,98,1745,80,3054,18
39797,0,26,1703,23,2680,3
32603,8,139,2107,101,2796,38
33692,4,159,2064,128,4056,31
29968,5,195,2239,144,3982,51
41719,94,852,1502,608,23095,244
21422,7,918,2667,678,16178,240
19718,23,819,2763,429,7571,390
19882,7,454,2753,331,3597,123
41460,13,245,1540,203,5485,42
37564,1,107,1847,89,4174,18
7416,56,3264,3461,3017,35861,247
21313,38,1575,2672,902,29615,673
38884,32,932,1757,744,10216,188
37095,27,914,1877,715,16768,199
14920,243,6846,2991,5397,37813,1449
36834,14,280,1893,227,5484,53
43421,85,1705,1107,1161,25736,544
15333,7,220,2969,170,4435,50
40988,28,1331,1606,819,13106,512
30207,2,97,2227,77,8457,20
25489,10,234,2470,191,5729,43
43319,7,117,1142,107,6563,10
19600,12,802,2769,366,3439,436
22337,8,374,2617,307,15775,67
44661,5,76,847,39,1512,37
17911,70,2773,2845,2143,25888,630
17289,2,169,2872,153,4517,16
17085,5,387,2884,308,3510,79
41651,62,763,1512,618,10300,145
17203,7,774,2877,558,25388,216
29980,6,192,2239,115,3249,77
43064,20,209,1216,171,3619,38
17977,12,335,2841,283,5766,52
15063,221,11917,2983,7246,59366,4671
32419,6,233,2115,174,9879,59
42667,9,282,1318,206,10590,76
33226,7,242,2082,206,8151,36
22785,16,449,2595,368,2125,81
28070,57,1350,2339,1174,8693,176
37182,60,1044,1872,850,8740,194
38905,5,128,1756,96,3970,32
24628,6,212,2506,189,9676,23
21409,16,863,2667,728,12272,135
13050,153,37839,3133,6044,73767,31795
31047,289,24107,2185,8216,101646,15891
25056,0,87,2488,62,7406,25
16373,55,1668,2921,1241,15283,427
18531,7,350,2817,265,7497,85
40959,88,2247,1608,1547,19874,700
32339,2,142,2118,63,3966,79
42581,41,2008,1336,1083,30059,925
15939,98,2218,2943,1714,10348,504
34028,21,643,2052,494,15341,149
22021,20,2502,2632,838,13718,1664
42113,1,64,1433,49,4793,15
28487,35,563,2316,428,7174,135
41991,13,349,1453,279,13788,70
38256,54,1170,1800,738,10525,432
32818,19,557,2098,349,9896,208
18172,16,752,2832,534,7341,218
35708,0,65,1962,53,4866,12
39920,14,266,1694,230,13086,36
26835,0,47,2408,39,2937,8
38385,13,181,1791,119,3839,62
20056,33,715,2744,553,6793,162
40738,5,74,1629,60,2366,14
10379,31,2056,3278,1590,22023,466
23238,6,241,2573,147,3070,94
35942,31,496,1946,304,5621,192
45136,1,28,679,19,1905,9
29627,6,182,2256,128,4259,54
19010,6,433,2797,371,11645,62
43551,26,827,1068,639,10409,188
30140,60,1991,2231,1497,21963,494
36983,2,43,1884,41,5644,2
24751,15,229,2501,182,4248,47
45690,54,837,504,643,13841,194
39716,25,1353,1707,774,26446,579
21784,25,672,2646,489,5467,183
9653,65,4904,3311,4305,39936,599
40508,5,161,1648,129,7467,32
27315,6,130,2384,109,2324,21
28200,17,1324,2332,816,8072,508
19653,14,2048,2766,583,30053,1465
12465,0,35,3167,35,2120,0
9432,46,1681,3325,1579,20272,102
40249,0,38,1673,28,1930,10
16456,35,2343,2918,1695,14757,648
18943,0,6673,2799,2688,41411,3985
31684,18,335,2151,255,4828,80
38700,9,330,1769,265,5890,65
42520,1,129,1347,67,2518,62
21129,6,258,2684,200,10953,58
16873,3,175,2896,157,7808,18
22134,70,7905,2626,4008,66056,3897
34199,3884,146587,2047,95499,706006,51088
42802,4,105,1283,84,3262,21
40807,17,798,1621,579,10607,219
45881,258,4578,431,4073,21187,505
40982,21,791,1607,609,9505,182
15683,9,199,2953,169,3929,30
31584,8,501,2156,397,5715,104
31482,24,711,2162,570,8244,141
40917,15,425,1612,342,18172,83
36709,26,1194,1901,824,12718,370
14213,3,250,3041,184,7896,66
10305,62,3143,3282,3006,23323,137
19648,22,915,2766,701,10214,214
28136,1,107,2337,91,3330,16
40357,19,569,1662,436,8396,133
32038,0,0,2134,0,9770,0
27726,2,48,2360,35,1556,13
24277,50,984,2523,739,10545,245
20799,1150,81265,2704,41836,322964,39429
38361,15,530,1792,353,8136,177
16821,26,1821,2898,784,9766,1037
20716,66,2457,2709,1506,20461,951
39261,2,136,1732,115,4635,21
23536,0,32,2558,29,8142,3
12599,83,3322,3161,2966,27507,356
15414,191,9954,2967,7187,26092,2767
8500,2105,104516,3382,79704,302594,24812
17163,14,740,2879,466,10920,274
31888,10,780,2141,676,9797,104
42992,7,161,1237,122,5878,39
15240,56,3646,2974,2733,38020,913
41276,18,979,1567,516,12939,463
40202,14,155,1676,133,5086,22
9503,38,1672,3320,1620,21121,52
26906,34,737,2404,604,6775,133
9284,47,1679,3335,1522,16009,157
14266,89,2206,3037,1684,13907,522
16033,10,168,2939,135,2463,33
30327,99,1676,2220,1274,10467,402
14472,37,2832,3021,2237,16663,595
38154,14,233,1807,204,5140,29
14333,37,887,3031,879,6710,8
44937,13,89,762,71,3777,18
10634,44,2233,3264,1983,21027,250
25499,6,286,2469,251,4058,35
26536,0,672,2421,526,12598,146
15096,143,5848,2982,4268,28375,1580
40705,49,1062,1632,813,14440,249
9500,329,26497,3320,12313,49692,14184
35618,10,206,1970,187,15353,19
28755,3,239,2300,187,4444,52
8991,250,11154,3352,10316,105786,838
25654,0,392,2461,300,4358,92
27408,9,249,2379,215,6948,34
43988,6,165,958,96,4103,69
13337,174,10343,3107,7258,34696,3085
28149,1,74,2336,65,4807,9
30491,22,926,2211,571,11165,355
45339,39,740,621,356,12688,384
35494,45,503,1980,408,5640,95
35048,32,931,2004,757,10253,174
31240,1181,63532,2175,41396,251498,22136
41526,174,4059,1532,3264,30830,795
29281,3,142,2274,125,5589,17
16050,9,405,2937,346,5874,59
29395,9,310,2267,264,5240,46
17018,222,22385,2888,7991,79960,14394
33463,31,501,2072,415,6527,86
16111,9,303,2934,216,5790,87
17603,57,3120,2857,1271,11107,1849
20385,3,147,2727,134,3061,13
21607,21,897,2655,645,9581,252
20097,34,1224,2742,926,10079,298
21274,68,7122,2674,3074,41704,4048
44700,36,589,834,455,14379,134
20232,352,16091,2733,11773,106324,4318
12032,98,6799,3192,4822,23845,1977
26353,68,4249,2429,2972,33489,1277
30022,0,65,2237,49,2597,16
20358,120,7219,2728,5312,39755,1907
26664,2,70,2416,64,3727,6
44754,26,129,814,127,4598,2
31969,2,136,2137,125,3462,11
11469,21,1219,3219,1090,24598,129
12911,10,119,3142,108,8839,11
10256,391,25136,3283,17822,106538,7314
27381,25,989,2380,787,14570,202
19253,6,738,2786,592,9307,146
33812,9,172,2059,121,3011,51
15858,15,638,2946,532,9078,106
4532,12,1218,3601,900,5668,318
20053,2692,257865,2744,79481,587450,178384
41334,19,823,1559,575,9792,248
22894,167,5552,2589,4638,29506,914
10345,279,25000,3279,19733,85547,5267
41162,3,269,1586,199,5921,70
28989,179,5492,2289,4159,56238,1333
31890,3,78,2141,65,1921,13
10985,156,3237,3244,2810,22215,427
43570,4,138,1063,60,7316,78
1196,4,117,3902,93,5670,24
19626,36,1060,2768,765,7343,295
43444,57,940,1103,763,20465,177
6369,69,3414,3513,3100,31502,314
7581,32,1416,3451,1416,17118,0
11181,83,5371,3234,4222,62540,1149
46377,11,119,229,105,3248,14
41048,215,5619,1600,4185,52582,1434
24718,0,39,2502,37,3255,2
17909,616,90787,2845,38081,228749,52706
22662,8,416,2601,230,4134,186
19136,0,1315,2792,814,5834,501
19311,27,1508,2783,1216,10814,292
25952,25,1735,2448,1392,24950,343
3311,959,36482,3635,28017,160971,8465
15231,3,106,2974,93,2112,13
30664,8,213,2201,171,7361,42
16223,1,65,2929,58,6638,7
40773,17,761,1625,395,11859,366
20957,14,1886,2694,772,39284,1114
16649,3,87,2909,68,2276,19
24430,174,15055,2517,6562,73556,8493
25145,33,3114,2484,1200,22854,1914
34986,19,363,2008,314,6779,49
45357,82,1617,616,1141,18087,476
24694,38,1819,2503,1388,18349,431
14601,1017,67043,3012,27112,308395,39931
39263,17,567,1732,419,29849,148
19215,7,339,2788,272,3431,67
24294,3,346,2522,290,3613,56
25313,30,518,2477,452,10999,66
32854,12,486,2096,290,5974,196
25348,14,1155,2476,360,11598,795
23792,9,324,2546,241,3671,83
29710,68,3203,2252,2352,18632,851
43467,22,808,1097,461,10865,347
19206,2,169,2788,133,7330,36
34734,87,878,2022,693,8860,185
45209,278,2639,660,2368,24075,271
44977,7,85,749,66,2133,19
17999,8,324,2839,243,3949,81
24390,0,1346,2518,978,12931,368
38379,58,981,1791,544,7693,437
15243,83,5265,2974,3436,36265,1829
45480,32,423,585,411,5493,12
28007,19,509,2343,403,6277,106
39233,4,105,1735,73,4584,32
13296,33,1281,3110,1206,12595,75
24326,30,1830,2521,1418,22233,412
27915,24,379,2348,292,3921,87
46476,12,276,176,217,3578,59
40775,14,331,1625,246,6722,85
41476,8,146,1538,113,5428,33
39235,5,164,1735,137,8354,27
18382,4,547,2823,371,8700,176
18184,303,22049,2831,10483,141496,11566
15165,49,4366,2977,1725,24691,2641
34175,503,14656,2048,11925,57518,2731
27868,37,750,2352,540,10477,210
46044,16,196,354,145,6240,51
45055,14,180,721,144,8362,36
16890,21,1793,2895,1395,17507,398
24569,10,465,2509,340,5507,125
34474,161,2574,2036,2190,18710,384
26510,616,12208,2423,8615,43017,3593
18110,9,533,2834,424,6410,109
25355,13,326,2476,262,8406,64
23864,0,60,2543,52,5008,8
36631,62,3075,1905,1992,32973,1083
21834,66,1904,2644,1225,18477,679
23180,3,196,2576,180,3449,16
10148,12,917,3288,875,12312,42
26870,11,560,2406,387,6787,173
13987,1676,66221,3055,48261,155940,17960
29971,23,513,2239,413,4063,100
40370,21,878,1661,656,11520,222
38801,120,2096,1762,1479,21366,617
21955,11,459,2636,334,7793,125
15410,5,700,2967,610,9444,90
41050,362,5893,1600,3781,40147,2112
42634,34,355,1327,290,7959,65
25400,28,1895,2474,1242,19456,653
25037,29,800,2489,598,8224,202
9070,50,2108,3348,2092,27922,16
10835,56,4122,3252,3796,32582,326
38246,6,135,1800,106,3800,29
39784,187,3830,1705,2908,24357,922
11699,2,35,3207,35,3182,0
42188,148,3780,1414,2692,41585,1088
25500,21,2940,2469,733,21883,2207
45351,11,90,618,81,2373,9
41055,2,52,1599,41,2928,11
27861,6,88,2352,79,3798,9
34324,1128,33764,2043,22122,228231,11642
16509,8,185,2915,135,5533,50
27097,12,352,2398,277,3926,75
35762,208,9148,1959,6897,61787,2251
15987,11,193,2941,165,2315,28
7988,59,4367,3418,3904,32272,463
41076,250,5303,1596,2586,39121,2717
12785,1252,113128,3150,69953,757250,43175
19982,15,345,2747,296,4857,49
37126,7,170,1875,138,6286,32
15286,16,866,2971,716,22823,150
19009,535,32536,2797,14614,158992,17922
43054,17,150,1219,131,3261,19
33331,7,188,2078,135,6249,53
27557,5,239,2369,206,4100,33
44749,3,40,815,36,2275,4
13006,91,3146,3136,2223,28329,923
19025,6,300,2796,237,4879,63
36519,52,1164,1912,766,13133,398
21736,19,1011,2649,808,20815,203
14214,255,14341,3041,8805,46397,5536
36609,90,1611,1906,1170,8440,441
20196,2,130,2736,95,2946,35
31314,48,1942,2171,577,7607,1365
18330,90,6871,2825,3537,52272,3334
10530,19,926,3270,713,4062,213
37099,6,240,1877,194,3836,46
32904,3,158,2094,102,6250,56
33713,95,2014,2063,1385,11906,629
25916,5,416,2450,351,8077,65
30299,2,31,2222,28,1676,3
19387,726,77972,2779,24500,183995,53472
22047,0,86,2631,69,2618,17
33732,20,1835,2063,1401,50568,434
16404,4,542,2919,462,5282,80
7679,45,1702,3446,1576,7705,126
39638,14,577,1712,458,9834,119
10911,13,1524,3248,1255,22612,269
43926,4,72,965,53,3271,19
41617,24,555,1518,427,10952,128
13124,10,437,3128,367,7140,70
10376,71,2562,3278,2150,27932,412
32652,93,2527,2105,2086,21852,441
35834,2,118,1953,108,4412,10
34026,52,1380,2052,982,20456,398
40899,17,261,1613,200,8152,61
26899,127,4863,2405,3706,28010,1157
38316,0,52,1796,42,2998,10
23111,50,2378,2578,1695,25332,683
20369,102,4392,2728,3273,24885,1119
26841,13,831,2407,406,8191,425
25911,8,579,2450,467,6954,112
39446,0,25,1723,23,2542,2
22392,147,6827,2614,4488,34569,2339
27754,23,737,2358,578,13964,159
22438,6,777,2612,426,7240,351
37948,22,575,1821,390,9490,185
18279,2,79,2827,70,3643,9
39815,30,2206,1702,495,12761,1711
10400,3914,360234,3277,146195,871376,214039
14057,317,67396,3049,14734,126726,52662
35810,16,570,1955,332,7685,238
33215,0,29,2082,27,6627,2
22338,53,2479,2617,1481,17262,998
31493,12,442,2161,310,5701,132
23640,16,711,2553,529,13474,182
13773,4,171,3073,158,2886,13
24078,4666,393939,2533,127503,1103613,266436
18899,1,212,2800,148,3929,64
27319,0,13828,2384,10045,90648,3783
39169,5,141,1740,105,4046,36
11445,16,1075,3220,953,14853,122
34075,9,166,2051,137,6024,29
16843,542,31018,2897,20919,156394,10099
44365,18,543,895,382,16355,161
5297,246,20108,3563,19325,70748,783
28291,1,113,2327,95,5045,18
18621,6,264,2812,219,6035,45
42324,6,127,1388,97,6357,30
34303,5,99,2044,83,2087,16
46110,0,8,333,7,1061,1
45762,46,799,471,542,8233,257
10200,46,1693,3286,1478,21405,215
21174,13,1761,2680,1152,19173,609
28434,3,107,2319,92,6365,15
16735,9,229,2904,199,4152,30
32301,31,796,2120,610,5984,186
46252,18,243,282,192,3439,51
11730,11,606,3205,527,11527,79
45303,12,165,631,136,5824,29
17072,43,3480,2884,2416,27968,1064
25042,0,36,2489,30,1507,6
41368,19,541,1554,424,15425,117
46009,2,48,373,34,2332,14
35524,2,93,1977,83,5307,10
15844,3,231,2947,176,3851,55
38369,34,4076,1792,3247,14016,829
30147,25,349,2231,281,3212,68
22132,21,1680,2626,1274,37690,406
15458,10,674,2965,433,9653,241
24132,165,8078,2530,5994,63613,2084
27353,23,375,2382,316,4909,59
39787,13,155,1704,138,4383,17
17311,3,126,2871,98,7529,28
28101,0,23,2338,21,4195,2
32046,5,363,2133,193,4203,170
19185,1,200,2789,171,3741,29
38491,8,218,1784,187,5149,31
39342,3,183,1728,119,4873,64
19409,103,2436,2777,2046,22522,390
24438,11,423,2516,172,5223,251
40418,9,208,1658,120,5595,88
16928,15,1552,2893,1191,25122,361
39718,78,2141,1707,1528,29856,613
20218,1210,68778,2734,22582,178182,46196
44892,0,13,773,13,2203,0
35295,4,176,1991,133,1678,43
45816,1,23,453,13,1110,10
33189,29,567,2083,453,4704,114
39335,16,184,1729,140,3299,44
41003,83,3128,1605,1550,30871,1578
30841,282,11798,2193,8282,73789,3516
15775,42,1456,2949,1134,25836,322
12038,221,14422,3192,7492,101102,6930
13259,238,20512,3113,11174,100423,9338
22732,13,993,2597,600,10817,393
46228,14,181,287,137,3646,44
25515,8,449,2469,375,4075,74
20964,14,663,2693,352,11145,311
32541,110,4520,2110,1843,18588,2677
34407,120,3877,2039,3183,32052,694
12914,50,2483,3142,2431,31980,52
30755,5,116,2197,94,4364,22
40070,0,71,1684,61,3076,10
15616,5,118,2956,92,4000,26
46134,27,300,322,250,3239,50
38340,7,314,1794,226,8743,88
19642,25,514,2767,409,7096,105
24187,4,521,2528,175,7232,346
5663,55,1743,3544,1670,9220,73
33547,2,629,2069,484,24048,145
21110,4,111,2685,92,3754,19
32596,9,442,2107,330,8572,112
33580,22,2028,2068,1563,25152,465
17602,1,559,2857,465,17414,94
2357,58,448457,3652,2135,17336,446322
5902,1205,60758,3532,52150,328307,8608
19184,2,131,2789,110,15565,21
28592,27,1130,2309,734,13095,396
41373,106,2200,1553,1334,15128,866
37261,39,834,1867,693,29549,141
43312,29,454,1143,321,6201,133
23452,2,81,2562,68,4959,13
39599,7,359,1714,278,8232,81
22280,198,5795,2619,4267,58615,1528
42652,5,210,1322,133,6686,77
46020,48,569,367,460,9061,109
39411,116,3651,1724,2578,43675,1073
16407,43,1511,2919,1156,12097,355
37450,13,351,1855,277,6119,74
39901,1,45,1695,39,4177,6
15171,145,14039,2977,6020,75076,8019
33395,24,717,2075,552,7511,165
17562,557,22652,2859,16204,62363,6448
13905,27,2811,3061,1342,20568,1469
46232,34,697,287,283,9315,414
20711,14,422,2709,259,6933,163
18340,95,2908,2824,2266,14234,642
33446,2,123,2073,98,8023,25
24295,3,113,2522,93,5592,20
26411,2,132,2427,87,3737,45
31699,17,1710,2150,347,10268,1363
28898,36,1515,2293,1181,7936,334
42175,7,300,1417,253,13348,47
30057,2,200,2235,100,2683,100
30009,27,1149,2237,982,15669,167
33486,34,449,2071,356,4524,93
12718,517,36605,3153,17835,296973,18770
14822,211,5536,2996,4098,31930,1438
24623,200,9295,2506,7200,74496,2095
41558,122,1411,1528,987,15921,424
20415,6,116,2725,98,2803,18
36226,10,823,1927,574,8146,249
43670,21,454,1026,374,9283,80
34420,3,74,2038,55,5082,19
43403,47,668,1114,504,7587,164
13217,6,195,3115,182,4884,13
40504,16,218,1649,143,3217,75
26110,6,325,2441,137,3535,188
5175,3128,307350,3570,177255,1069991,130095
6678,198,15120,3501,13747,80761,1373
37166,21,651,1873,408,13618,243
30686,11,546,2200,410,5841,136
28151,324,14318,2336,7112,68060,7206
11734,31,1883,3205,1749,32895,134
28998,19,837,2288,633,5179,204
40654,15,387,1637,296,3533,91
10479,79,7150,3273,6383,58186,767
39280,77,1963,1731,1650,14373,313
33414,167,3450,2075,2404,18192,1046
44978,228,2391,748,2002,34282,389
31815,5,152,2144,124,7400,28
36494,16,220,1913,160,5798,60
43522,12,258,1080,222,6366,36
18207,315,15014,2830,9870,115462,5144
35576,81,2269,1973,1680,17903,589
31007,5,158,2187,129,3116,29
45156,151,1609,675,1064,20160,545
28179,30,1140,2334,715,12448,425
18143,2,61,2833,58,3498,3
19976,40,2351,2747,1783,21045,568
39867,4,209,1698,97,4733,112
38096,6,207,1812,181,6326,26
30921,16,516,2190,376,11872,140
28666,45,1040,2305,803,9169,237
18324,51,3277,2825,2266,14193,1011
26058,1,108,2443,99,3770,9
40174,23,598,1678,424,9304,174
44914,2,26,768,17,2812,9
27069,12,530,2399,441,8970,89
11657,2,102205,3209,197,7847,102008
44953,230,2512,755,2249,22981,263
38418,4,151,1789,133,6437,18
9059,14,502,3349,433,9372,69
29751,898,58621,2250,32782,176866,25839
18488,8,329,2818,237,4325,92
31567,211,7027,2157,5136,54160,1891
11223,100,9270,3231,7465,61463,1805
28497,18,427,2315,289,5325,138
21125,287,22626,2684,9585,105496,13041
29649,155,4508,2254,3546,23877,962
33718,3,128,2063,111,4372,17
39845,5,187,1700,138,5391,49
27332,26,682,2384,524,5758,158
45140,3,49,678,25,3002,24
45949,84,662,398,639,10653,23
33043,0,61,2089,50,4587,11
18988,45,825,2798,676,5835,149
37940,8,209,1821,173,3998,36
15890,10,486,2945,392,6829,94
25660,73,2930,2461,1160,16006,1770
18792,16,806,2805,664,10779,142
20124,1,84,2740,70,2854,14
20152,5,159,2738,131,4472,28
23242,57,2338,2572,1913,10273,425
37829,13,391,1829,307,8314,84
13781,14,657,3073,567,6777,90
18160,166,12656,2833,8124,34578,4532
27635,12,1073,2365,865,17675,208
45203,14,167,661,117,4773,50
6914,2821,117680,3490,97847,417923,19833
41058,14,169,1598,133,3848,36
28561,45,1011,2310,799,14050,212
34162,63,2107,2049,1042,12320,1065
37651,9,254,1842,173,7757,81
46031,0,9,364,7,1025,2
19401,16,370,2778,260,8046,110
23577,1,130,2556,116,3420,14
32874,1,60,2095,47,6575,13
23451,1,31,2562,28,2352,3
10947,415,17236,3246,14612,57173,2624
43056,9,149,1219,115,3932,34
19046,3,234,2795,91,1964,143
25472,35,1738,2471,1329,17082,409
42239,3,383,1403,150,11643,233
42224,39,1211,1407,609,13495,602
44218,72,1150,916,831,27980,319
27531,24,1194,2370,996,23123,198
18007,53,1918,2839,1370,34725,548
41623,8,349,1517,251,9384,98
42085,128,2612,1436,1855,41613,757
46358,35,383,241,375,7942,8
21817,2,78,2645,61,2391,17
41500,3,146,1534,114,6551,32
32333,3,257,2118,139,4241,118
41708,38,1094,1503,834,23702,260
31714,1,55,2149,49,2771,6
38131,1,82,1808,52,3207,30
41431,26,618,1544,506,16937,112
21235,33,932,2675,769,17297,163
13473,6,567,3095,454,7589,113
43576,12,121,1061,93,4931,28
35614,15,220,1970,174,3523,46
20920,14,857,2695,418,10733,439
33846,17,782,2058,426,10747,356
23711,3,82,2549,65,8571,17
22509,52,2316,2608,1774,23920,542
18068,20,1259,2836,949,15052,310
24201,8,155,2527,91,5320,64
14714,1457,54982,3004,36256,266423,18726
25767,4,172,2456,120,2100,52
23040,10,111,2583,89,1826,22
27593,8,162,2367,133,7980,29
17941,5,255,2843,161,3900,94
21339,56,4468,2671,3001,37659,1467
36001,2,275,1941,221,9829,54
28678,5,336,2304,130,4919,206
22340,4,745,2616,322,3321,423
34257,67,2410,2045,1808,31025,602
18128,187,8158,2834,6443,61092,1715
27912,4,116,2348,87,2960,29
11590,88,6944,3213,5778,87870,1166
30988,32,1454,2188,751,16574,703
37959,446,11859,1820,8287,86406,3572
4189,641,26867,3613,24869,64332,1998
17365,31,801,2868,552,6283,249
11549,3,142,3214,139,2985,3
15725,2,307,2951,216,8095,91
15573,7,358,2958,263,9626,95
41348,166,3405,1557,1448,21474,1957
20859,1,92,2700,72,2597,20
33939,1,91,2056,79,5099,12
24453,631,28616,2516,14768,145584,13848
13856,15,1304,3067,903,16261,401
18351,7,306,2824,219,6068,87
21424,423,16684,2666,11581,89636,5103
27883,9,281,2351,254,6036,27
37817,9,240,1830,204,12240,36
38245,0,28,1800,21,2784,7
39132,8,137,1742,118,5547,19
21572,240,11886,2658,8983,35142,2903
33903,3,135,2056,111,4577,24
37290,31,846,1865,613,9208,233
16638,1,153,2909,121,2411,32
18722,118,7615,2808,5899,80033,1716
34771,2,70,2020,56,2802,14
30965,1,27,2189,22,3629,5
42416,30,823,1369,557,14253,266
33771,46,2001,2061,1367,27916,634
26778,14,373,2411,292,6455,81
24387,19,901,2518,740,8342,161
13479,31,1498,3095,1399,9989,99
42015,128,3362,1450,2471,32345,891
12314,20,1426,3176,1272,21074,154
43268,180,3600,1156,2965,23771,635
45894,2,120,427,67,4620,53
43511,8,176,1084,151,12189,25
36991,0,78,1884,66,5133,12
30909,4,142,2191,117,4194,25
14831,11,648,2996,550,9404,98
17803,3,92,2850,69,4399,23
40268,10,441,1671,288,10392,153
23331,25,1525,2568,991,7939,534
39734,8,451,1707,309,15748,142
30512,12,198,2209,162,3904,36
30633,1,29,2203,26,2034,3
45911,22,180,420,159,4083,21
20195,13,628,2736,452,3159,176
34954,18,879,2009,707,6076,172
14364,8,528,3029,501,15385,27
34448,4,138,2037,109,2279,29
30340,1,53,2219,46,2276,7
37961,4,126,1820,103,3309,23
22578,39,2817,2604,2050,22536,767
14599,42,2849,3012,2135,22437,714
45399,16,367,603,198,13160,169
39935,4,200,1693,136,6886,64
17960,135,5852,2842,4526,38758,1326
36925,13,344,1888,265,7118,79
39278,37,963,1732,756,13159,207
24286,18,1955,2523,470,6219,1485
37716,0,472,1838,354,13047,118
36553,21,492,1911,413,8561,79
45858,113,2776,412,1361,20189,1415
20210,3,194,2735,144,4009,50
21266,0,32,2674,25,1162,7
45906,1,27,423,24,1960,3
17003,106,4977,2889,3740,29996,1237
45270,8,395,639,213,8354,182
28626,42,2282,2307,1544,17052,738
35333,1688,65679,1989,31207,304011,34472
26388,5,323,2428,249,6719,74
17336,150,20649,2870,9904,83519,10745
27733,1,54,2359,47,1809,7
11095,6,246,3238,234,7610,12
44999,3,36,742,26,3355,10
28404,5,269,2320,224,4425,45
32894,11,362,2095,306,14875,56
39428,1,112,1724,83,5285,29
39710,6,256,1708,198,6086,58
38266,18,607,1799,490,7826,117
21989,890,29985,2634,20795,167870,9190
43636,16,189,1037,153,5174,36
20610,22,253,2715,215,3263,38
33579,1,137,2068,88,3389,49
39964,78,2587,1691,1528,37541,1059
34531,24,788,2033,619,11632,169
38796,35,501,1763,449,15169,52
37936,39,2167,1821,1319,28136,848
32763,17,511,2101,392,8619,119
25606,44,2851,2463,1111,16779,1740
33314,24,1389,2079,866,15844,523
33212,105,4453,2082,3517,39405,936
8884,42,665,3359,631,7817,34
34854,9,784,2014,579,22012,205
27025,19,378,2401,302,7158,76
24293,0,71,2523,41,1731,30
13360,312,12430,3105,10755,64206,1675
37710,58,1424,1839,1183,18517,241
25723,2,245,2458,194,3407,51
43726,81,1227,1006,1002,21673,225
34824,12,332,2016,216,4558,116
22684,10,1028,2600,326,4935,702
45401,72,697,603,448,8189,249
36863,3,196,1891,174,3542,22
28472,22,2264,2317,634,11814,1630
24484,23,718,2514,594,5380,124
16518,91,2999,2915,2055,29059,944
19579,29,2090,2770,1512,21141,578
19797,4,118,2758,91,2246,27
14998,2,105,2987,98,3454,7
13085,248,28265,3131,8107,96194,20158
43771,151,2777,993,1967,57244,810
32211,14,298,2124,195,6125,103
25707,107,1587,2459,1240,13328,347
24411,11,591,2517,414,14799,177
38348,2,173,1793,133,3929,40
41953,14,213,1459,180,4557,33
24108,0,2568,2531,1153,19196,1415
39314,8,304,1730,255,10054,49
30110,10,1051,2233,795,16578,256
43540,71,1575,1073,1068,31438,507
30390,14,571,2216,274,1937,297
40945,107,3400,1609,2529,46896,871
28778,11,221,2299,174,7262,47
25266,126,7083,2480,2771,22783,4312
41686,109,3386,1507,1599,28921,1787
33428,0,61,2075,51,5134,10
41093,28,801,1594,671,17163,130
39834,29,538,1701,463,13867,75
12466,2726,168529,3167,88746,635505,79783
38745,4,151,1766,120,8798,31
22261,9,272,2620,216,7499,56
30202,7,263,2228,224,5688,39
37910,493,18880,1823,12195,114693,6685
34126,3,90,2049,78,2296,12
37513,148,4379,1851,3202,43829,1177
45836,3,79,447,74,3048,5
19997,42,1632,2747,1187,24447,445
37161,71,1289,1873,1019,21014,270
37124,15,734,1876,577,27292,157
12091,9,757,3189,366,3887,391
31327,45,2072,2170,577,9192,1495
34392,7,170,2039,150,4812,20
28951,17,1379,2290,956,7663,423
40922,22,1113,1611,884,14767,229
1826,1298,43791,3663,41837,128970,1954
29267,6,381,2274,283,4390,98
24307,50,4427,2522,3369,48267,1058
25086,5,148,2487,125,4179,23
10622,121,6124,3265,5230,51826,894
40384,11,291,1660,209,11152,82
38619,36,1817,1774,1044,12184,773
12993,155,3776,3136,3093,13289,683
30533,5,130,2208,104,2411,26
30138,14,548,2231,284,4115,264
28396,2,84,2321,70,1720,14
27657,11,362,2363,155,2320,207
23150,896,29376,2577,20755,149091,8621
45239,2,48,652,37,1750,11
38317,9,543,1796,419,9172,124
10543,65,3148,3269,2721,28258,427
42099,0,83,1434,57,5837,26
34409,0,17,2038,16,1999,1
23142,2,66,2577,50,6300,16
43844,7,156,978,113,4673,43
44950,10,132,756,127,2999,5
18732,6,375,2808,144,4336,231
4657,26,150356,3596,574,5084,149782
15132,12,649,2980,627,13850,22
24160,21,480,2529,398,2612,82
25297,30,916,2478,764,11170,152
20084,73,1496,2742,1138,13836,358
41530,80,1307,1532,934,15421,373
27609,0,118,2366,90,2167,28
19067,66,2523,2794,1651,14534,872
37548,58,1340,1848,747,9353,593
28760,1,57,2299,34,3548,23
45496,83,855,580,685,12483,170
28953,16,500,2290,288,7277,212
29080,27,2162,2283,1199,15239,963
39860,16,829,1699,499,11749,330
43075,6,376,1211,242,7650,134
37569,12,367,1847,276,4094,91
9012,3,264,3352,264,6570,0
17089,62,1751,2883,1101,21714,650
14777,5,706,3000,640,18934,66
10418,92,2841,3276,2559,22948,282
11819,3,106,3201,68,4723,38
37474,28,422,1854,357,3777,65
16672,99,6857,2907,4916,62471,1941
24517,0,32,2512,30,4891,2
44875,4,116,778,50,5753,66
16035,13,920,2938,678,16015,242
22380,11,1151,2615,718,8064,433
40427,24,262,1656,213,7381,49
19081,32,1701,2794,1255,11559,446
22794,2300,118800,2595,83891,633791,34909
20905,27,1758,2696,1252,17095,506
42068,69,2217,1440,1640,22019,577
29640,85,5754,2255,1940,30855,3814
18432,3,324,2820,235,6713,89
19222,29,1190,2788,949,17191,241
30555,112,4892,2207,2810,26833,2082
21862,644,13232,2642,9457,54569,3775
25227,3,130,2481,74,10599,56
32165,23,627,2126,446,18334,181
27636,55,2757,2365,2014,18777,743
42888,34,1111,1265,853,31210,258
27156,44,1283,2394,1026,11942,257
25249,9,522,2480,327,13195,195
25574,1248,97165,2466,35848,295255,61317
21548,0,66,2659,51,3865,15
15551,22,672,2960,515,5486,157
43607,11,178,1046,156,7802,22
23572,9,311,2556,260,5704,51
17879,34,3474,2847,1825,26038,1649
24745,27,1886,2501,1436,34297,450
29817,3,256,2247,183,3826,73
15717,2,273,2952,201,10708,72
45851,60,774,441,716,14264,58
38658,183,4439,1771,1798,27176,2641
15530,12,659,2961,572,8494,87
43303,1,25,1100,23,2701,2
27799,14,584,2354,484,3973,100
28072,0,34,2339,27,6128,7
42184,115,2219,1416,1517,19262,702
12496,75,7188,3165,4615,53583,2573
26700,40,1453,2414,1184,9590,269
33523,56,3811,2070,2260,39890,1551
24948,11,329,2492,264,4219,65
40389,180,2986,1660,2515,20064,471
29722,1,81,2251,68,2010,13
16083,17,806,2935,626,5327,180
21189,4,180,2679,127,11795,53
36859,4,308,1891,246,8765,62
21573,2,203,2657,165,2705,38
27683,48,1431,2362,1158,14691,273
43986,18,260,958,153,6230,107
43573,12,435,1062,307,7539,128
27251,10,487,2388,407,6677,80
22694,36,2484,2599,934,27532,1550
8429,56,3658,3387,2720,34221,938
27158,2,68,2394,61,2453,7
14407,7,573,3025,489,17952,84
11170,0,89,3234,89,4074,0
22949,657,34675,2586,18885,223161,15790
28198,26,951,2332,706,13457,245
32912,3,62,2094,55,1953,7
38719,1,52,1767,37,5754,15
25586,5,235,2465,203,4297,32
10092,74,3072,3291,2842,22605,230
32446,9,341,2114,299,5205,42
35697,3,89,1963,78,10731,11
19162,0,142,2791,64,3479,78
42427,17,398,1366,299,4765,99
16322,46,1655,2924,1258,18455,397
20037,66,1243,2744,990,7428,253
38797,1,44,1763,33,2036,11
40342,10,288,1665,241,12186,47
31151,56,1083,2180,935,20860,148
37683,29,670,1840,479,5874,191
37552,0,53,1848,40,2381,13
45725,4,124,483,117,3553,7
26611,50,2631,2418,1803,25355,828
3930,14,585,3622,460,6461,125
21187,7,234,2679,202,5613,32
16680,8,560,2907,394,6806,166
12573,17,584,3162,516,5899,68
27109,100,3065,2397,2461,17381,604
31478,9,208,2162,163,4592,45
35547,21,799,1975,585,13265,214
38694,26,1365,1769,774,15540,591
29548,4,252,2260,189,3794,63
35477,33,851,1981,730,15719,121
14971,5,205,2989,194,3428,11
18796,6,452,2805,324,9184,128
30648,1,39,2202,37,7982,2
13762,2,174,3073,144,3389,30
31120,8,264,2181,224,6292,40
23489,95,9022,2560,4462,42443,4560
34432,9,721,2038,461,12604,260
30430,1,25,2214,22,1556,3
22341,1,93,2616,69,1568,24
40046,85,5300,1685,2804,37355,2496
22442,3,97,2612,78,2223,19
24743,5,215,2501,172,4581,43
41104,2,30,1592,21,4262,9
13957,120,68156,3057,3182,33362,64974
35040,25,730,2005,618,9998,112
25553,3,84,2467,70,3995,14
29120,268,6855,2282,5200,50221,1655
14574,757,62737,3014,28352,281750,34385
39635,553,8718,1712,6912,44157,1806
27199,18,644,2391,400,7155,244
23574,12,722,2556,423,9724,299
23747,34,1294,2548,1025,16339,269
41775,11,180,1491,142,5146,38
41840,6,702,1477,441,18220,261
6008,25,1667,3527,1660,12647,7
20379,21,650,2727,502,5084,148
16482,30,1178,2917,909,15468,269
23171,1,275,2576,196,5306,79
40485,20,788,1651,535,14089,253
28910,1,255,2293,183,4987,72
18075,12,460,2836,385,3636,75
28548,140,3631,2311,2683,29398,948
31693,7,171,2150,136,10334,35
19474,9,879,2774,555,11904,324
15067,5,271,2983,245,5971,26
22011,3,193,2633,161,11553,32
20007,14,700,2746,545,7230,155
17166,3,136,2878,112,3146,24
28143,7,666,2336,504,4019,162
23800,2,195,2546,123,5629,72
24044,81,7743,2534,2695,51291,5048
41359,34,477,1555,373,6194,104
40676,5,221,1634,161,7882,60
29366,0,90,2268,82,2923,8
9730,62,2515,3309,2391,11526,124
5984,30,2358,3528,2115,24142,243
36827,61,1097,1893,952,6649,145
43970,2,22,962,16,1812,6
17371,12,542,2867,421,4995,121
30495,2,138,2210,109,4007,29
28583,331,17253,2309,12730,118239,4523
12982,56,2637,3137,1336,20729,1301
45325,15,231,623,197,7755,34
33781,28,1149,2060,964,14137,185
20175,1,142,2737,64,7504,78
29472,22,555,2263,434,4207,121
22079,2,329,2629,231,7879,98
35182,223,8373,1997,5358,67803,3015
26374,2,95,2429,84,2047,11
21857,6,144,2643,106,3062,38
41385,2,34,1552,27,3497,7
25772,15,719,2456,522,15057,197
29653,12,453,2254,370,4145,83
19546,48,1298,2772,630,7493,668
18259,1,55,2828,43,2096,12
41109,59,1021,1592,770,10250,251
39189,42,910,1738,633,10285,277
28509,8,295,2314,241,4674,54
34480,3,80,2036,67,3066,13
45015,14,154,737,132,3549,22
38308,2,128,1796,97,4605,31
17552,6,210,2859,165,6657,45
41963,19,329,1457,256,4560,73
39019,37,1388,1749,1024,8522,364
41695,65,2274,1506,1346,23855,928
34697,41,3476,2024,598,19324,2878
28166,26,600,2334,481,6251,119
31582,14,430,2156,355,4842,75
33560,198,4102,2069,3154,23820,948
14680,2,277,3007,236,4660,41
29361,127,4632,2269,3517,49424,1115
34103,29,780,2050,660,9629,120
25864,5,265,2453,189,3017,76
42960,47,815,1247,630,13266,185
11255,36,1203,3230,1052,23271,151
41976,1,69,1455,62,8423,7
36761,0,31,1898,27,3813,4
42737,94,597,1302,438,9746,159
28742,202,8306,2301,3837,28153,4469
18593,17,281,2814,217,3436,64
26009,8,467,2445,337,10417,130
31688,36,1088,2150,745,10144,343
24030,4,111,2534,94,2133,17
22303,2,33,2618,29,1900,4
27349,12,4474,2382,298,4276,4176
28894,7,786,2293,599,9180,187
34120,18,462,2049,388,6543,74
38497,5,79,1783,62,2813,17
37275,71,2201,1866,1748,41306,453
14953,0,288,2989,205,2528,83
22121,7,193,2626,124,5315,69
21623,4,308,2654,162,4283,146
33533,89,1777,2069,1133,11917,644
16421,4,556,2919,284,4579,272
38068,54,1286,1813,998,15424,288
3806,278,28937,3625,22258,68837,6679
26730,0,41,2413,37,2623,4
19543,3,224,2772,186,9011,38
37926,16,290,1822,243,5991,47
45353,114,881,617,837,7523,44
21818,36,1894,2645,1456,19603,438
23360,10,449,2567,361,14163,88
25806,0,878,2455,688,13536,190
13283,125,8512,3111,7382,98076,1130
2041,245,10206,3657,7085,50319,3121
27411,9,430,2378,265,5101,165
27376,80,2260,2380,1634,23818,626
19949,87,5820,2750,2915,42648,2905
17162,42,3402,2879,2569,47575,833
46070,45,711,343,478,11390,233
43458,8,147,1100,137,6361,10
41101,9,433,1593,341,5866,92
45915,19,174,418,173,6818,1
34671,66,2803,2025,1915,29573,888
18338,24,2374,2824,1557,17661,817
39070,5,118,1745,96,2899,22
21013,49,1588,2689,1179,26973,409
42829,14,331,1278,242,8205,89
14796,31,1175,2998,780,15637,395
42293,4,44,1394,37,2928,7
41139,13,431,1588,268,4590,163
10924,1,90,3248,50,3741,40
32571,17,789,2108,678,3709,111
45801,41,299,459,264,4880,35
43916,31,289,967,221,5617,68
42340,9,847,1385,569,15983,278
17352,6,166,2869,134,10947,32
17806,5,248,2850,171,3517,77
13421,17,855,3101,796,23123,59
40657,204,6634,1636,4861,55084,1773
31630,21,552,2154,440,9143,112
27177,0,49,2393,42,1014,7
36959,20,531,1886,454,13290,77
32103,12,334,2129,270,6216,64
30039,4,108,2236,87,2997,21
4600,274,30375,3598,25778,103388,4597
35554,13,214,1975,175,3873,39
34319,4,159,2043,119,4605,40
7902,504,58118,3428,21990,237698,36128
14381,45,2490,3027,1909,20085,581
42942,6,313,1249,191,6253,122
17763,6,499,2851,417,16971,82
33721,1,65,2063,50,4433,15
19092,66,3875,2793,2861,31519,1014
23918,4,164,2541,109,3262,55
18683,58,2672,2809,2006,14407,666
25615,173,10677,2463,6045,53664,4632
16894,6,315,2895,264,7191,51
32681,19,611,2104,497,7362,114
37751,14,699,1835,464,11521,235
43517,79,1242,1081,1023,22064,219
43231,3,88,1167,48,3405,40
32180,12,176,2125,146,2302,30
34484,358,19091,2036,9382,145695,9709
36822,22,1441,1893,1117,13414,324
17001,9,499,2889,367,8185,132
17245,4,210,2874,163,8367,47
16121,161,7484,2933,5410,62250,2074
24875,57,2380,2496,1739,22691,641
26279,5,222,2434,172,3361,50
7619,214,8403,3449,7517,73413,886
33174,7,327,2083,282,4095,45
9092,137,6500,3346,5532,48549,968
19362,170,12732,2780,8913,60710,3819
21215,1,56,2677,46,4362,10
20592,2,59,2716,37,2270,22
45196,61,857,662,614,9650,243
38942,7,450,1754,286,15404,164
18442,79,6141,2820,1826,50886,4315
36202,3,123,1928,106,3760,17
40306,20,440,1670,324,10154,116
37613,450,20685,1844,15242,119342,5443
43760,0,55,998,41,4734,14
36243,48,1798,1926,1438,15484,360
45565,5,71,554,34,1273,37
25581,0,79,2465,73,2301,6
17965,142,10219,2842,7537,98255,2682
2332,16,1162,3652,1100,18780,62
35721,0,75,1961,33,3260,42
43474,17,553,1096,433,11903,120
37631,10,417,1843,332,17979,85
26478,155,5076,2424,3312,43750,1764
20144,42,1305,2739,1016,14044,289
32083,10,620,2130,424,9006,196
26085,29,2106,2442,820,15153,1286
11965,20,376,3195,373,3821,3
35484,21,876,1980,634,22181,242
31173,23,1712,2178,1397,10978,315
35485,154,2284,1980,1848,20118,436
41025,29,498,1604,377,9264,121
31763,1,40,2147,38,2605,2
19129,4,103,2792,83,1379,20
20836,5,245,2702,217,6595,28
22143,36,1412,2626,998,13140,414
40891,15,1036,1614,656,13770,380
25972,0,655,2447,509,8358,146
38299,30,2058,1797,1134,24230,924
40764,21,597,1626,404,7284,193
37694,0,175,1840,138,2997,37
18000,111,2817,2839,2177,10846,640
23812,5,218,2546,172,3763,46
8252,28,801,3399,764,7410,37
43081,14,297,1210,243,11975,54
30665,10,522,2201,419,24621,103
31123,146,4979,2181,3864,24539,1115
28714,129,4399,2303,3234,35800,1165
24598,6,288,2507,260,6012,28
28863,369,14824,2294,9757,103083,5067
28047,9,425,2341,361,13664,64
42769,55,675,1295,503,10550,172
40823,225,9067,1620,4325,55435,4742
21672,3,285,2652,199,5261,86
28854,37,2276,2295,875,12695,1401
12394,32,2401,3171,1427,21701,974
14675,2,74,3008,68,4287,6
34499,11,518,2035,342,6550,176
44845,2,71,784,55,2343,16
25346,100,2164,2476,1667,10586,497
42995,31,1034,1236,717,15313,317
15795,164,24505,2948,8386,57472,16119
25150,396,19838,2484,13222,101764,6616
27417,146,14005,2378,7863,48915,6142
18120,41,2704,2834,2091,18675,613
27361,19,2209,2381,1423,49472,786
38821,11,317,1761,259,5566,58
32806,7,171,2098,148,6290,23
27706,31,834,2361,585,8518,249
21810,3,75,2645,63,2189,12
32498,6,296,2112,217,5959,79
43239,343,6353,1164,4981,44434,1372
30819,0,24,2194,23,1715,1
37360,13,1147,1861,906,5781,241
46001,13,132,379,119,1905,13
9859,30,1786,3302,1745,19314,41
45118,0,36,686,18,1560,18
41529,19,240,1532,204,3488,36
20965,7,241,2693,169,3821,72
20121,29,1181,2740,904,16144,277
29704,77,1783,2252,1302,30677,481
41316,156,3539,1561,2487,24282,1052
33548,5,587,2069,487,23258,100
39012,24,849,1750,642,9695,207
28206,4,352,2332,196,6655,156
19171,10,743,2790,442,8291,301
13939,51,1730,3059,1381,14155,349
45756,0,20,474,16,1506,4
35075,5,175,2003,143,5593,32
34535,2,132,2033,82,3086,50
35312,47,470,1990,392,4320,78
38671,3,129,1771,85,5904,44
38170,44,3336,1806,2698,12782,638
20802,220,7871,2704,5188,70955,2683
25694,1,56,2459,52,2042,4
45106,59,902,693,643,8087,259
41883,2,230,1470,166,7286,64
26853,23,1249,2407,886,8291,363
23149,56,749,2577,586,6022,163
40689,5,179,1633,130,9458,49
32951,3,191,2093,137,7495,54
15951,176,8606,2943,6279,65712,2327
27023,123,3039,2401,1679,16016,1360
34606,2,71,2029,65,3830,6
43732,13,100,1005,85,2608,15
9271,33,1028,3336,911,10020,117
34935,49,676,2010,545,8186,131
21269,1,66,2674,61,1532,5
25508,0,1291,2469,766,14499,525
30618,113,6872,2204,3778,45768,3094
21108,188,5416,2685,4067,39283,1349
25309,853,52721,2478,19354,136215,33367
31611,50,2922,2155,2162,24680,760
20776,18,846,2706,676,10374,170
15891,105,4349,2945,3515,45903,834
36177,96,4439,1929,1885,42597,2554
45186,9,124,665,108,4509,16
29815,48,1785,2247,1385,22732,400
1194,18,852,3902,698,16524,154
12257,17,59507,3179,864,13972,58643
33417,11,306,2075,260,7150,46
18272,34,1326,2827,1109,11963,217
45747,9,229,478,152,5577,77
30117,23,1142,2232,780,26128,362
41195,11,234,1582,174,6332,60
44405,8,53,890,37,1955,16
34943,1,301,2010,229,15299,72
29526,66,3332,2261,2607,26582,725
29271,3,92,2274,77,2045,15
40317,14,233,1668,174,8286,59
40444,16,386,1654,293,10626,93
15932,100,3107,2944,2328,13930,779
26024,15,796,2445,547,7186,249
12956,23,1519,3139,1303,11705,216
20706,11,1184,2710,919,10048,265
30400,12,1139,2216,903,25570,236
17549,23,828,2859,549,7882,279
12330,313,25762,3175,16652,155066,9110
41523,59,504,1533,402,6480,102
19030,300,5985,2796,4701,26257,1284
30610,35,1217,2204,937,13831,280
43134,72,2257,1195,1217,19339,1040
37411,34,853,1858,619,5846,234
18522,154,6894,2817,4426,54178,2468
30326,8,174,2220,123,2465,51
40154,21,684,1680,292,8098,392
38365,136,7778,1792,3694,50389,4084
39173,23,1269,1739,676,12759,593
23713,2,211,2549,142,6015,69
20054,478,21518,2744,14099,149742,7419
40425,16,428,1657,314,8465,114
34562,4,70,2031,64,6871,6
20354,84,4297,2728,1783,39294,2514
36972,3,80,1885,62,3032,18
18635,22,566,2812,449,6787,117
29663,7,232,2254,172,3863,60
28366,7,1148,2323,255,8178,893
16671,35,1754,2907,1331,47824,423
33741,90,2202,2062,1595,12558,607
26595,21,511,2419,413,6238,98
23491,12,437,2560,330,8558,107
7914,153,7205,3426,6170,30451,1035
19922,6,614,2751,372,6485,242
41975,42,2000,1455,1114,27287,886
39666,44,546,1710,426,10729,120
41495,6,147,1535,118,6162,29
39113,125,2460,1743,1465,21639,995
19188,74,4769,2789,3698,50407,1071
40596,438,10942,1641,7604,81424,3338
27625,10,1003,2365,766,4088,237
13962,125,4819,3056,4231,32498,588
8805,28,1027,3362,882,8843,145
43012,1,22,1231,22,2192,0
18297,346,27352,2826,18310,120465,9042
38135,208,7035,1808,5158,61294,1877
41492,21,309,1536,244,5739,65
33260,48,3167,2080,2293,22494,874
14747,268,16798,3002,8398,124525,8400
44146,2397,68957,930,43753,438452,25204
25102,21,603,2486,467,13965,136
16365,89,3524,2922,2701,37833,823
29631,1,156,2255,109,2250,47
18141,2,108,2833,84,4988,24
11107,666,24983,3238,21318,121844,3665
29487,3,240,2262,187,8227,53
42006,5,317,1451,231,16005,86
32261,92,1342,2122,1226,12431,116
43463,56,1140,1097,775,25079,365
37224,0,94,1869,76,5721,18
24884,17,311,2496,235,4268,76
37032,33,652,1881,448,9416,204
40794,8,415,1623,295,9458,120
17962,11,524,2842,321,4913,203
14784,309,19514,2999,14550,90734,4964
16192,48,2941,2931,2194,29120,747
22810,1594,67775,2593,35618,295950,32157
26515,28,1540,2422,974,11512,566
20055,1,138,2744,115,2890,23
37013,194,15037,1883,3107,96257,11930
43282,34,883,1152,615,16019,268
45986,15,221,385,160,5741,61
45504,27,342,579,309,6243,33
11683,5,350,3208,323,24473,27
43565,7,70,1064,56,3679,14
35181,20,596,1997,350,9301,246
45379,25,505,611,331,9832,174
24002,0,216,2535,174,3337,42
12416,11,1702,3169,1117,15657,585
42835,15,167,1278,137,7114,30
12569,10,1055,3162,598,11761,457
37587,300,9817,1846,6141,81152,3676
24135,6,363,2530,220,4927,143
34230,149,6210,2047,4319,45524,1891
21471,338,24650,2664,10647,98970,14003
44608,172,2402,856,2049,26594,353
40405,23,1255,1659,527,10676,728
38048,9,623,1815,367,9851,256
11167,321,20051,3234,18287,96143,1764
45566,50,729,554,374,6684,355
32960,20,1157,2092,776,11800,381
19275,15,259,2784,197,4133,62
22639,19,802,2602,626,6569,176
32642,12,262,2105,225,4410,37
35498,4,160,1979,132,3665,28
37432,57,1218,1856,957,7729,261
30967,5,68,2189,53,2472,15
20813,9,513,2703,441,9217,72
40237,50,1089,1674,733,22210,356
42954,14,219,1248,160,4247,59
20090,1,106,2742,87,3922,19
31531,9,151,2159,123,2216,28
39779,11,360,1705,283,5402,77
28569,4,244,2310,165,15063,79
18467,7,152,2819,106,6669,46
29671,10,265,2254,218,3358,47
20303,495,28561,2730,20330,76055,8231
24068,26,755,2533,540,10742,215
30122,5,149,2232,125,2347,24
36222,5,474,1927,387,8909,87
24010,14,403,2535,303,6366,100
27645,6,453,2364,287,8670,166
24417,136,7686,2517,5014,36250,2672
19919,2,65,2751,62,1600,3
42075,106,3379,1439,2040,36365,1339
30134,29,1757,2232,1209,23504,548
28559,11,305,2310,249,4696,56
17456,67,2312,2864,1761,18411,551
37402,8,152,1858,117,6184,35
32942,1,42,2093,31,2682,11
35443,4,222,1983,182,8874,40
36858,7,210,1891,176,3047,34
17833,21,1336,2848,1047,17385,289
18436,14,586,2820,448,8717,138
37233,1,219,1868,175,6421,44
34729,16,405,2022,311,9064,94
24602,36,1176,2507,859,5376,317
26975,14,261,2402,215,6666,46
23795,4,267,2546,211,4205,56
37529,167,3650,1850,2850,34110,800
28412,1,40,2320,35,1988,5
31102,12,397,2182,309,5463,88
28505,7,462,2315,355,5301,107
18384,84,5380,2823,3072,36814,2308
19077,1,167,2794,136,6216,31
38278,59,1119,1799,909,7396,210
32006,84,4916,2135,2336,23256,2580
35025,148,5113,2006,3349,43630,1764
15464,12,1185,2965,646,7598,539
42701,13,177,1311,91,2686,86
46158,13,166,308,152,3142,14
32705,30,2116,2103,1586,23826,530
40660,131,2278,1636,1684,33277,594
43385,16,362,1118,254,9284,108
38739,3,95,1766,75,3637,20
44945,187,8268,758,4296,78894,3972
12962,3,112,3139,95,2426,17
17284,308,9314,2872,6904,37377,2410
34740,5,490,2022,351,10664,139
42158,1,119,1422,92,5154,27
24324,0,68,2521,56,2615,12
24834,138,6157,2498,4304,51761,1853
25433,15,479,2472,402,11062,77
38612,8,94,1774,83,4275,11
5480,1367,123222,3554,100254,511180,22968
25608,0,69,2463,48,1568,21
43579,275,4675,1059,3899,39503,776
8813,5,118,3362,95,8371,23
27072,18,511,2399,383,8511,128
37512,7,363,1851,292,4452,71
36818,37,1177,1894,892,9843,285
42951,0,50,1248,29,2640,21
10527,227,8143,3270,6326,47706,1817
13573,354,20588,3088,15588,155291,5000
24663,10,609,2505,465,8340,144
9941,3,327,3299,298,8593,29
28171,11,245,2334,209,4845,36
26575,7,121,2420,102,3413,19
17720,13,1079,2853,540,9923,539
20317,10,707,2730,577,18952,130
39803,1,40,1703,35,2672,5
30646,15,401,2202,299,13757,102
35472,42,1256,1981,766,11251,490
40192,8,133,1677,104,3487,29
32970,51,1436,2092,1194,36174,242
30521,211,5203,2208,3531,49401,1672
36235,83,1943,1927,1448,23908,495
38509,1,72,1782,44,4971,28
17622,4,207,2856,154,5373,53
11700,47,1497,3207,1496,14100,1
27287,4,498,2386,372,15968,126
25722,6,300,2458,220,6344,80
34080,7,115,2051,95,6891,20
35397,220,5709,1986,3662,55902,2047
31430,16,427,2165,362,3822,65
35041,6,182,2005,149,8231,33
17628,7,558,2855,408,3178,150
24309,0,4624,2522,2591,25261,2033
23605,191,10725,2555,7658,70002,3067
28135,38,1544,2337,1275,22873,269
41341,0,46,1558,33,3439,13
39065,1,90,1746,54,2797,36
19615,2,37,2768,33,3411,4
29967,19,562,2239,440,11386,122
41262,3,208,1570,157,10624,51
26165,10,215,2439,181,3900,34
36497,25,461,1913,356,6519,105
17754,14,1499,2851,1153,15328,346
45097,98,1020,699,943,11419,77
36408,27,632,1918,373,6910,259
28164,88,3172,2335,2311,21148,861
39251,28,1036,1733,710,11651,326
27731,39,1509,2359,1224,12547,285
36159,100,4788,1930,3703,33978,1085
12146,323,11298,3185,6669,44720,4629
32873,2,107,2095,57,2945,50
35974,19,290,1943,225,3866,65
27812,45,2638,2354,1449,44625,1189
26077,0,63,2443,52,2087,11
42073,254,4881,1439,3867,29712,1014
45178,7,118,667,87,2869,31
16195,2,128,2931,107,2998,21
9167,14,610,3341,572,27008,38
11455,85,6695,3220,5476,42164,1219
33002,2,135,2090,67,4289,68
29221,97,3118,2277,2296,35834,822
28795,10,511,2298,391,6883,120
34917,5,498,2011,342,7042,156
35672,3,162,1965,121,2728,41
25939,1,148,2449,118,5799,30
13393,56,2579,3103,1471,34535,1108
38261,1,113,1800,100,4633,13
41759,5,133,1493,109,4784,24
14218,8,626,3041,464,28453,162
5399,5,219,3557,219,4929,0
39655,2,74,1711,54,3997,20
37194,26,987,1870,745,21068,242
24003,78,7007,2535,1918,49973,5089
36774,2,27,1897,27,2005,0
29106,320,18033,2282,12752,124649,5281
20000,90,2924,2746,2022,25810,902
41332,3,100,1559,80,2510,20
4955,651,34409,3582,29028,93784,5381
1233,3,93,3896,73,3391,20
42337,335,7058,1386,5354,53230,1704
14557,15,42664,3015,373,6612,42291
45269,158,6094,640,2785,45647,3309
38747,19,2503,1766,836,16705,1667
21969,8,311,2635,279,6475,32
21434,20,849,2666,674,5620,175
17126,11,335,2881,289,4049,46
15345,42,2453,2969,1980,26535,473
30087,19,447,2234,356,5115,91
43480,13,723,1094,575,15378,148
30834,6,231,2193,196,4590,35
39502,33,828,1720,563,13206,265
44713,822,19552,827,11686,85567,7866
20051,66,1265,2744,939,8585,326
34923,8,557,2010,424,9380,133
21486,12,490,2663,369,9176,121
44059,2,45,945,29,1963,16
20958,4,601,2694,424,8745,177
28394,1,64,2321,60,4952,4
27182,37,1293,2392,985,16595,308
25964,2,256,2447,124,3342,132
26190,0,156,2439,114,7700,42
14799,210,15740,2997,8445,34434,7295
25233,47,1688,2480,1360,19283,328
33005,28,524,2090,422,9995,102
39038,3,89,1748,72,8088,17
43175,25,509,1183,312,9602,197
26038,343,24300,2444,9368,96249,14932
16284,22,755,2926,596,33847,159
42690,21,487,1312,401,10280,86
10768,623,26150,3256,23487,100204,2663
18628,5,176,2812,128,1875,48
30888,8,169,2192,147,5536,22
24444,87,4696,2516,3430,64204,1266
36164,34,742,1929,561,9917,181
26158,0,286,2439,227,4141,59
17291,4,204,2872,175,6841,29
35808,28,1189,1955,818,15821,371
7674,7,121,3446,103,6773,18
23141,40,1082,2577,853,5231,229
38044,16,1315,1815,853,19484,462
35285,8,327,1991,237,10324,90
36355,2,36,1920,30,1934,6
26412,0,46,2427,35,1447,11
28576,6,427,2310,318,8248,109
22815,59,2694,2593,1857,26912,837
19535,14,1137,2772,910,17781,227
42056,8,308,1443,227,6437,81
44673,70,1064,842,834,10027,230
34644,77,1356,2026,1128,9755,228
10292,144,7901,3282,6497,29000,1404
7155,77,2587,3475,2150,21091,437
5236,39,2452,3566,2272,14467,180
43083,11,348,1210,225,8145,123
45960,145,2356,393,1595,31252,761
29741,7,227,2251,181,7444,46
20589,3,371,2716,259,6636,112
18071,164,10585,2836,6569,52827,4016
39404,124,2138,1725,1781,13560,357
13447,13,687,3097,471,9470,216
39227,22,500,1735,431,9704,69
36322,13,348,1922,263,6714,85
14755,9,741,3001,576,7705,165
42662,8,70,1319,65,2975,5
30962,28,809,2189,653,5550,156
13260,0,1956,3113,1408,13575,548
27675,218,4460,2362,3215,42549,1245
15754,0,48,2950,43,3725,5
38878,29,779,1758,610,11827,169
31359,52,2314,2169,1746,23050,568
45089,7,109,704,72,3118,37
27064,157,12821,2399,5438,49216,7383
22899,10,480,2588,363,6454,117
30406,14,367,2215,315,13790,52
40527,70,2153,1647,1619,19295,534
15060,36,1383,2983,1108,10775,275
35591,2,35,1972,33,4234,2
35171,12,623,1998,522,10651,101
36964,1,78,1885,45,7119,33
19333,28,1966,2782,1057,25150,909
37514,30,946,1851,689,15891,257
14372,24,709,3028,636,15566,73
18519,4,215,2817,192,1903,23
17640,3,239,2855,170,8833,69
12941,22,728,3141,690,4592,38
44360,143,2639,895,2160,21225,479
22980,380,24147,2584,13074,120168,11073
43690,60,1251,1017,967,29171,284
19411,10,689,2777,437,14273,252
11179,97,7787,3234,6293,65375,1494
34055,13,265,2051,211,5608,54
14288,5,313,3035,249,8982,64
25255,19,1385,2480,885,23674,500
26129,25,790,2441,489,7276,301
15387,5,476,2967,336,12372,140
23053,3,280,2582,196,4868,84
18385,646,34706,2822,24498,164566,10208
10902,29,1315,3249,1105,6243,210
40963,0,182,1608,84,4733,98
31981,336,7682,2136,5270,50398,2412
23885,4,104,2542,88,3080,16
43316,10,184,1143,163,14206,21
30107,39,1774,2233,821,16328,953
29006,3,128,2288,114,15548,14
30312,32,645,2221,439,7988,206
20866,0,26,2700,24,2307,2
36791,2,68,1896,46,2741,22
26461,35,2030,2425,1178,10036,852
45210,36,272,660,202,3670,70
44998,63,823,742,619,13903,204
19470,164,8325,2774,5975,46010,2350
29071,4,212,2284,181,5312,31
10472,10,1388,3273,818,6191,570
37103,59,633,1877,509,6254,124
38492,6,213,1784,121,8254,92
41621,44,2002,1517,1219,15407,783
41497,50,901,1535,662,8658,239
41357,11,191,1556,159,4054,32
17838,58,2370,2848,1796,19605,574
31220,3,87,2176,79,3358,8
1557,5,24923,3725,105,2017,24818
38347,18,605,1793,457,10753,148
40197,1,14,1677,12,1204,2
38947,3,108,1753,92,4228,16
24051,40,1568,2534,808,15727,760
34476,17,614,2036,524,14755,90
38642,75,4660,1772,3146,33835,1514
12350,25,1263,3174,1183,9844,80
19916,6,420,2752,181,12163,239
24087,145,8679,2532,6531,67032,2148
28824,49,4868,2296,1404,29383,3464
43450,94,1916,1102,1233,28891,683
25737,6,740,2457,466,19047,274
36600,12,171,1907,144,4083,27
40653,26,428,1637,289,7044,139
14975,33,1620,2988,1160,18257,460
26839,33,848,2408,658,7440,190
19856,0,137,2755,48,2507,89
45358,29,257,616,205,5971,52
37399,9,312,1858,267,6160,45
18607,25,1070,2813,842,12814,228
3857,65,215518,3624,2469,17914,213049
42709,83,1545,1310,1131,15414,414
31012,13,433,2187,360,4756,73
41032,3,93,1603,72,4953,21
32431,5,103,2114,85,3189,18
12777,9,548,3150,538,11405,10
24047,0,42,2534,33,1718,9
36493,19,1036,1913,769,13357,267
27662,58,2155,2363,1532,16995,623
45554,118,2589,558,1263,26540,1326
27223,3,200,2390,163,4669,37
27889,4,198,2350,158,1814,40
24668,25,501,2504,336,6954,165
15026,6,417,2985,322,6834,95
14278,17,817,3037,814,19499,3
26408,0,0,2427,0,2938,0
18458,1,98,2820,71,2529,27
24470,0,347,2515,288,7250,59
35765,3,164,1958,115,6667,49
42731,74,2033,1304,1146,22715,887
37813,38,2229,1830,1245,22544,984
16895,54,1787,2895,1276,17828,511
9644,20,1031,3312,1029,14829,2
30966,7,177,2189,126,3661,51
44997,22,223,743,212,6318,11
43513,9,214,1083,116,4243,98
34438,3,144,2038,101,4101,43
38669,22,337,1771,277,15034,60
43968,11,151,962,103,2092,48
37479,26,1266,1853,1000,14200,266
45908,7,107,422,80,1556,27
33245,3,99,2081,90,3261,9
30145,12,250,2231,198,5934,52
45347,3,43,619,39,1545,4
15304,12,986,2970,807,11551,179
43626,0,22,1040,18,2205,4
45122,84,494,684,352,8967,142
3647,104,6835,3629,6022,35016,813
30902,18,393,2191,306,8422,87
32427,73,6502,2115,4949,18708,1553
4957,35,305354,3582,2012,14940,303342
41590,30,1642,1522,1186,32575,456
11238,118,8345,3230,6942,59162,1403
44890,7,92,774,76,4431,16
31963,0,155,2137,59,3413,96
14469,73,6059,3022,4210,44962,1849
21335,110,5118,2671,3265,38137,1853
33955,51,1467,2055,1101,24220,366
22957,21,978,2585,776,9625,202
40735,8,429,1629,271,5238,158
19823,17,422,2756,332,7943,90
43327,2,62,1139,48,2205,14
17818,125,4446,2849,3048,44188,1398
36092,314,18439,1934,7315,106719,11124
26148,8,493,2440,417,5481,76
26217,68,2672,2436,2105,15740,567
46223,33,710,289,599,9180,111
38825,0,37,1761,32,2602,5
45037,63,510,728,425,12700,85
19602,35,1865,2769,1386,11400,479
29209,1,90,2277,75,4718,15
36128,31,876,1932,713,13134,163
45628,70,592,532,520,6962,72
33576,11,130,2068,118,2141,12
17889,10,757,2846,575,12357,182
16973,34,6227,2891,2521,20333,3706
45878,28,755,412,506,8537,249
42570,13,269,1339,184,9992,85
26672,60,3215,2416,2123,25828,1092
42548,4,130,1342,105,2966,25
15066,13,1012,2983,946,17921,66
23237,77,6504,2573,2488,37160,4016
33419,125,5550,2075,3706,49811,1844
40236,18,377,1674,275,8518,102
9558,49,184881,3317,1734,27595,183147
19124,287,16467,2792,12591,103548,3876
14306,11,935,3033,819,23289,116
39921,2,134,1694,87,3471,47
14834,745,55232,2996,29484,226444,25748
10397,10,538,3277,514,12015,24
13604,114,8346,3086,6226,61841,2120
21737,7,517,2648,337,5952,180
23058,12,685,2581,577,9871,108
39298,10,431,1730,340,7715,91
21794,155,10748,2646,4430,54202,6318
16260,13,357,2927,289,4180,68
15423,8,276,2966,229,12216,47
34158,46,1026,2049,691,17633,335
20640,40,4325,2714,2401,33676,1924
34275,33,986,2045,659,15719,327
15822,7,308,2947,198,16703,110
35892,98,5142,1949,2439,43421,2703
18389,5,503,2822,408,3036,95
36415,20,299,1917,217,6319,82
39276,30,843,1732,692,11000,151
33323,170,7713,2078,3912,49343,3801
36132,8,379,1931,288,9355,91
39133,97,7384,1742,3451,32610,3933
27317,35,1323,2384,960,19290,363
19647,6,201,2766,172,4093,29
45631,2,38,531,27,1474,11
43498,22,579,1087,427,14547,152
41524,24,999,1533,766,17371,233
24413,1,110,2517,92,4246,18
13333,29,754,3107,675,9281,79
20615,5,115,2715,102,6625,13
31599,19,732,2156,589,10265,143
25617,22,664,2463,570,10962,94
30363,1,55,2218,36,2565,19
14253,31,1584,3038,1308,31012,276
36407,142,3325,1918,2402,32756,923
42843,82,1982,1276,1440,43158,542
17743,338,25005,2852,5938,129389,19067
9579,25,1155,3316,997,13373,158
31912,23,1400,2140,1001,9892,399
8128,5,576,3406,541,5982,35
24705,23,844,2502,476,6759,368
22636,1,82,2602,76,2494,6
31594,2,56,2156,46,2714,10
6631,447,27214,3503,23594,147209,3620
27599,17,513,2367,418,4463,95
36563,676,31272,1910,17728,148808,13544
6420,71,2301,3511,2105,15184,196
28398,6,385,2321,250,9040,135
43271,13,126,1155,92,3594,34
39903,3,261,1695,134,4629,127
23664,4,190,2551,163,4534,27
45276,7,90,638,41,2606,49
40921,13,525,1611,411,9274,114
14337,15,632,3031,467,6113,165
9310,158,9823,3333,7125,54115,2698
39960,14,202,1691,172,3698,30
32504,24,537,2111,297,7366,240
28018,0,41,2343,34,2922,7
9571,118,10489,3316,8147,87676,2342
38412,6,139,1789,115,3740,24
42542,4,79,1343,61,2912,18
39144,36,651,1741,458,7493,193
27739,215,8771,2359,4686,49229,4085
34804,38,2118,2018,1006,22423,1112
12750,10,366,3152,354,7913,12
21452,3,189,2664,151,3097,38
27676,143,4579,2362,3519,29343,1060
23484,1049,31438,2560,26494,112384,4944
30742,5,160,2197,144,4163,16
29943,21,662,2240,380,11212,282
40304,168,4454,1670,2713,42830,1741
34815,13,671,2016,479,13639,192
39830,122,4278,1701,2465,22998,1813
18661,3,429,2810,191,3492,238
43717,38,243,1010,210,3171,33
42290,8,213,1394,168,4541,45
35101,40,605,2002,520,8494,85
43272,6,175,1155,113,3171,62
18403,13,812,2822,698,8496,114
10085,379,16267,3291,14088,48717,2179
24283,14,342,2523,245,4905,97
9574,36,1727,3316,1574,9041,153
36188,1,134,1928,103,4212,31
28170,38,563,2334,434,7204,129
32104,1,105,2129,70,4000,35
26698,0,43,2414,34,2227,9
17125,201,11511,2881,8045,88396,3466
28272,7,269,2328,131,4044,138
22379,22,1843,2615,1384,13095,459
7257,468,237706,3471,37919,132115,199787
15206,19,1289,2976,1074,17474,215
23041,8,147,2583,120,2299,27
43078,25,637,1211,449,8163,188
25536,40,998,2468,671,13184,327
28041,1,148,2341,69,6838,79
16519,1,61,2915,54,2899,7
43451,84,1171,1102,913,8378,258
24872,23,957,2497,759,8286,198
18433,14,494,2820,387,6687,107
19303,124,8266,2783,1875,14784,6391
26414,35,1184,2427,392,6505,792
15554,18,880,2960,637,12948,243
39538,64,4643,1718,1266,17686,3377
30191,22,1175,2228,776,12556,399
28767,65,2334,2299,1839,10795,495
37313,3,103,1863,75,4613,28
40329,283,9063,1667,6278,73200,2785
45402,10,163,603,124,3239,39
43101,100,1331,1204,1202,13300,129
33493,14,281,2071,208,2988,73
45958,3,33,394,33,1433,0
23672,36,4741,2551,2228,62160,2513
20387,56,2157,2727,928,13942,1229
39928,79,1483,1694,1184,16868,299
39339,3,94,1728,77,4527,17
18357,8,555,2823,415,6889,140
34669,104,1021,2025,792,9583,229
11519,10,356,3216,346,16380,10
36567,129,5216,1910,2926,47272,2290
16296,58,9127,2926,5365,105632,3762
38307,2,160,1796,88,4630,72
41146,0,87,1588,53,4212,34
33312,4,102,2079,85,3006,17
37228,1,49,1869,40,5801,9
31689,18,600,2150,509,9848,91
27749,7,356,2358,284,11477,72
10941,5,190,3247,184,9673,6
16103,16,1693,2934,1257,15472,436
22645,12,1197,2601,946,22897,251
33121,0,37,2085,30,2084,7
25631,20,884,2462,656,9578,228
39258,41,1333,1733,1054,14548,279
45392,1,29,606,29,1535,0
29935,27,987,2240,796,8656,191
41425,22,1036,1545,759,7948,277
38404,10,247,1790,209,5590,38
14200,693,41842,3042,15661,131428,26181
39906,71,1508,1695,1162,24837,346
46030,49,309,365,243,5559,66
24787,11,311,2500,245,5905,66
25493,16,904,2470,692,8935,212
21876,6,619,2641,491,9849,128
46301,40,363,263,256,5634,107
39056,62,3180,1747,2014,17661,1166
15763,1,68,2950,59,2898,9
41896,0,101,1468,57,2862,44
40020,7,234,1687,154,6604,80
38125,40,987,1809,627,8704,360
26469,7,596,2425,498,8245,98
12824,0,205,3147,179,6804,26
35799,35,1924,1955,776,12981,1148
15018,9,292,2986,284,6640,8
38062,22,401,1814,343,6517,58
29250,65,2946,2275,2162,27090,784
19098,7,392,2793,311,9742,81
40569,9,1340,1643,493,22646,847
42057,0,43,1442,41,4774,2
24832,64,2984,2498,2180,26774,804
13603,26,1755,3086,1155,12860,600
13105,258,16664,3129,14642,175049,2022
4804,2226,133935,3590,101433,732617,32502
21175,836,49480,2679,29323,271143,20157
11172,63,6115,3234,3615,93404,2500
26493,22,442,2424,356,3277,86
20428,9,638,2724,455,9372,183
32483,5,321,2112,190,4813,131
35094,12,648,2002,498,10565,150
43393,2,31,1116,27,4633,4
18356,5,82,2823,71,3681,11
16037,61,4393,2938,1912,31979,2481
31150,13,393,2180,324,12215,69
31840,2,92,2143,59,2263,33
27873,16,274,2352,224,9044,50
33933,58,9916,2056,2258,55826,7658
38189,11,262,1805,177,6829,85
40393,34,2557,1659,1107,51202,1450
24302,19,524,2522,414,6118,110
28903,58,3963,2293,3049,14451,914
38624,336,21161,1773,12260,113001,8901
28008,9,217,2343,195,3015,22
12367,608,46138,3173,17473,120389,28665
20762,192,11877,2707,3296,58361,8581
24218,23,728,2526,595,6246,133
15418,22,1143,2966,876,10628,267
21017,3,466,2689,354,5890,112
37000,1,85,1883,73,3449,12
12782,0,65,3150,63,3909,2
35957,21,786,1945,602,16096,184
45535,0,14,568,10,1061,4
42598,32,1037,1334,688,15521,349
45764,27,243,470,168,4060,75
15974,10,497,2942,372,5356,125
14166,0,145,3045,102,4222,43
24235,2,78,2526,62,4232,16
13487,2,237,3095,157,5746,80
37409,10,113,1858,98,3919,15
33481,2,273,2072,164,8027,109
12486,78,2156,3166,1677,15754,479
15565,30,1858,2959,1467,17533,391
11059,66,4398,3241,4327,60097,71
40864,41,1184,1616,889,16989,295
22008,8,487,2633,352,12233,135
31228,15,473,2176,336,6775,137
31424,157,3849,2166,2883,41535,966
42031,4,198,1447,131,6583,67
42554,32,1051,1341,676,19745,375
39085,36,716,1745,564,8900,152
24303,6,212,2522,152,7959,60
16207,30,2643,2930,1752,54770,891
19674,12,722,2766,580,10696,142
44211,26,337,916,286,8599,51
13795,26,1718,3072,1536,12952,182
45743,5,97,475,77,4103,20
35318,69,556,1990,449,6496,107
22828,861,33170,2592,16940,162229,16230
17046,26,2233,2886,1545,19172,688
36473,1,54,1915,39,3126,15
45899,15,232,426,201,4007,31
15911,40,2117,2945,1614,17716,503
44581,13,212,860,158,3631,54
16704,902,21241,2906,14467,95652,6774
24247,4,485,2525,395,9516,90
23021,9,725,2583,429,8994,296
42464,1,57,1359,37,4516,20
40871,32,644,1615,490,7845,154
36031,81,1712,1939,1372,9601,340
16352,24,1079,2922,860,18442,219
27216,9,263,2391,221,4984,42
39308,1,80,1730,60,3310,20
30335,1,160,2220,87,4304,73
19268,91,11040,2785,5555,42061,5485
19771,5,407,2759,343,5107,64
29342,7,193,2269,158,3090,35
46035,16,78,359,67,8732,11
19640,12,268,2767,223,4948,45
17213,10,302,2876,238,5611,64
42333,12,182,1387,145,6994,37
34636,14,594,2027,500,8208,94
27482,2,348,2374,254,4843,94
26904,61,4135,2404,1967,40462,2168
26221,31,1480,2436,1126,17502,354
43694,21,194,1016,134,5792,60
20201,4,433,2735,269,3528,164
12369,22,1592,3172,1333,15400,259
37920,5,72,1822,58,2923,14
11958,23,1182,3195,1001,15744,181
13746,8,242,3075,220,2850,22
34460,11,278,2037,139,3170,139
40459,6,221,1653,179,14859,42
13865,46,3114,3066,2299,12348,815
19262,268,19990,2785,14479,102861,5511
20013,8,281,2745,211,6798,70
35804,10,193,1955,127,3859,66
42103,4,99,1433,84,2655,15
30885,7,364,2192,322,6315,42
23121,85,2414,2578,1800,28797,614
34673,560,123794,2025,10878,251208,112916
22317,4,278,2618,222,6417,56
27782,19,1236,2356,1033,22966,203
14766,42,2255,3001,1658,21237,597
958,6,272,3983,231,9925,41
38346,5,105,1793,93,4287,12
13500,80,4761,3094,4400,39938,361
43222,8,282,1170,179,8254,103
41120,14,515,1590,254,11604,261
25815,0,150,2454,130,8295,20
34613,113,2455,2029,1972,26857,483
33301,7,623,2079,521,5140,102
28139,8,293,2337,238,7438,55
11954,368,11520,3195,9907,114509,1613
45859,179,2735,412,2684,36780,51
32212,3,66,2124,59,2864,7
23847,20,527,2544,385,4856,142
39507,24,999,1720,634,12741,365
29448,46,1138,2264,856,18153,282
37381,35,701,1860,527,11402,174
22344,40,1102,2616,861,7472,241
26234,112,3705,2435,2326,16673,1379
33315,41,1203,2079,698,12950,505
44185,3,40,921,25,1857,15
41199,0,0,1582,0,3610,0
33706,9,117,2064,84,2760,33
18274,10,666,2827,526,9760,140
45020,60,673,736,524,11386,149
10257,430,184213,3283,14124,72593,170089
43058,43,1134,1218,615,11658,519
14460,98,3503,3022,2925,25970,578
10158,12,287629,3288,266,5770,287363
10717,169,7568,3259,4053,35953,3515
29629,10,419,2256,337,11032,82
10353,24,1689,3279,1246,18358,443
21064,18,793,2688,639,5154,154
38162,12,321,1807,241,7492,80
41486,73,1214,1537,821,20085,393
27603,10,552,2367,329,9202,223
30204,10,344,2228,315,15820,29
39362,88,3458,1727,2241,21296,1217
23188,39,2395,2575,806,17624,1589
25584,6,446,2465,360,8785,86
27945,7996,382629,2346,196733,1080412,185896
18067,28,956,2836,584,11605,372
35492,33,871,1980,539,8708,332
18599,235,10802,2814,7584,93315,3218
34082,191,2824,2051,2060,27414,764
24234,19,775,2526,632,8215,143
28711,135,2861,2303,1324,16028,1537
28896,6,327,2293,263,6915,64
31586,2,77,2156,61,6764,16
20417,19,630,2725,498,10010,132
12055,26,842,3191,815,9109,27
12340,29,1375,3175,1137,19161,238
5695,118,3169,3542,2358,9840,811
19231,3,351,2787,265,11384,86
35727,192,5424,1961,4622,31603,802
15305,16,512,2970,412,6095,100
5132,83,8958,3572,8837,127017,121
27990,96,3420,2344,2376,22268,1044
25105,0,10,2486,10,5114,0
42430,68,714,1366,611,6399,103
17219,18,1094,2876,943,16695,151
14320,26,809,3032,713,21378,96
37361,15,508,1861,386,5998,122
16231,24,1392,2929,1101,22980,291
38964,14,270,1752,190,3145,80
28595,3,128,2308,111,2830,17
19270,14,1180,2785,646,6057,534
15856,3,193,2946,153,6425,40
37522,16,428,1850,374,8901,54
31328,19,932,2170,795,5212,137
21332,22,1137,2671,926,7295,211
29046,16,477,2286,353,14363,124
14941,59,2535,2990,2190,25130,345
40842,2,62,1618,53,2485,9
45130,13,149,682,143,2596,6
17502,0,2275,2862,1650,45043,625
18575,12,321,2815,252,4801,69
13267,160,8770,3112,5875,57450,2895
41292,7,326,1564,257,6543,69
29132,6,535,2281,381,6720,154
25817,37,1715,2454,824,11837,891
23278,145,3168,2571,2333,17457,835
42948,358,5272,1249,3449,47749,1823
25268,17,527,2480,460,5239,67
31820,52,1490,2144,1269,7544,221
21837,5,325,2644,223,2696,102
13995,49,3079,3054,2404,28998,675
22191,0,26729,2624,16789,145781,9940
19735,6,278,2762,234,8099,44
43454,4,169,1101,99,4733,70
40186,17,595,1678,442,7252,153
30707,2754,250791,2199,81807,779267,168984
22697,56,3750,2599,2493,35068,1257
12558,24,1579,3163,1519,13847,60
32241,0,71,2122,60,2042,11
42285,57,1814,1395,1336,22675,478
14229,63,2933,3040,2547,29400,386
22653,86,3487,2601,2297,33658,1190
31246,51,1952,2175,974,18217,978
31348,39,1450,2170,766,12091,684
16847,77,4899,2897,3236,41996,1663
31291,35,3407,2172,2447,31429,960
40774,1768,49372,1625,34237,254667,15135
40839,66,1447,1618,1033,16104,414
42593,37,766,1334,572,17454,194
32477,10,1327,2113,811,14794,516
35104,3,396,2002,333,6048,63
35362,30,370,1988,320,4064,50
29875,8,433,2243,345,11762,88
27197,29,2959,2391,2208,25802,751
16152,27,979,2932,776,15384,203
8043,801,70687,3410,44079,421044,26608
28078,7,252,2339,184,3842,68
35608,112,2791,1971,1914,13348,877
29531,11,212,2261,182,4820,30
40037,614,19365,1686,10222,121610,9143
20474,147,8540,2722,5531,43654,3009
18658,6,270,2810,222,5690,48
14870,83,6264,2994,4942,65211,1322
35675,154,2592,1965,1746,16816,846
35471,51,857,1981,718,12172,139
28232,8,175,2330,134,11711,41
34388,5,167,2040,120,4446,47
22388,74,2573,2614,1923,25016,650
45974,49,883,389,419,13014,464
40351,1,38,1663,35,1874,3
40241,20,598,1673,353,13496,245
44200,9,126,920,93,3936,33
42331,21,666,1387,556,6430,110
25900,25,2203,2451,1453,11991,750
20244,2,81,2732,63,3345,18
22933,3,266,2586,219,5291,47
26496,52,3125,2423,2242,18720,883
36365,803,27724,1919,14512,159598,13212
38156,19,706,1807,400,13688,306
21229,7,114,2676,93,2203,21
42524,14,188,1347,151,4017,37
27667,139,9426,2363,3469,77352,5957
21655,12,759,2652,634,14349,125
22889,8,227,2589,182,6585,45
19476,192,5340,2774,3468,39636,1872
20161,69,2569,2738,1962,25118,607
21941,0,6691,2637,5032,44281,1659
14221,210,18612,3041,10003,89379,8609
27794,18,1215,2355,650,10134,565
35070,59,1435,2003,1170,9940,265
29332,7,214,2270,179,10916,35
17260,12,798,2873,610,6145,188
21945,144,6462,2637,4221,36708,2241
22861,10,608,2591,485,3342,123
36024,79,1238,1940,888,8612,350
24403,50,2359,2518,1861,29267,498
37382,1116,24239,1860,16401,159660,7838
28371,2,74,2322,61,4898,13
39066,7,170,1746,133,5358,37
45797,47,552,460,486,5213,66
28879,21,1034,2294,821,10368,213
24603,5,102,2507,85,4052,17
21711,26,3623,2649,2369,18973,1254
34886,10,1092,2012,645,9457,447
24084,30,972,2532,764,8867,208
31364,7,122,2169,111,3871,11
35004,62,3101,2007,1422,22621,1679
39367,1,80,1727,47,2780,33
18206,86,5604,2831,3480,31649,2124
22062,63,2065,2630,1162,12551,903
18879,10,395,2801,295,3017,100
15655,1,64,2955,49,3410,15
29431,26,1151,2265,892,13912,259
40283,97,2545,1670,1866,21453,679
13710,45,2207,3078,1739,35616,468
12255,42,2696,3179,2290,32136,406
27518,56,4325,2372,2657,21186,1668
30344,63,1540,2219,1138,10438,402
36269,48,1471,1924,873,13114,598
18848,71,1479,2802,1122,11609,357
17521,13,546,2861,448,8186,98
29449,38,620,2264,528,7986,92
39444,41,593,1723,432,8844,161
23642,0,62,2552,45,4886,17
35970,0,18,1944,17,3881,1
44213,58,793,917,640,17953,153
39282,81,1297,1731,828,9430,469
34999,7,321,2007,242,5372,79
23529,7,549,2559,432,8354,117
12384,4,279,3172,252,7342,27
28228,9,194,2331,152,5111,42
40564,15,241,1643,179,2929,62
21498,33,1221,2662,800,12018,421
39565,2,191,1716,144,9169,47
38029,254,5562,1817,3914,47530,1648
41223,80,3094,1577,1532,33713,1562
26915,120,2468,2404,2014,14395,454
19545,5,600,2772,424,5438,176
24273,3,406,2524,313,9926,93
9510,141,15401,3320,10949,41805,4452
27344,134,5809,2383,4210,49212,1599
24475,216,10596,2514,5845,70956,4751
17525,281,15285,2860,7604,58539,7681
28719,14,1023,2302,797,14898,226
37394,124,4245,1859,2257,24899,1988
35207,42,1430,1996,1055,14756,375
32785,2,88,2100,77,5779,11
45920,12,181,415,147,6444,34
31791,20,459,2145,273,5357,186
38498,2,78,1783,66,4062,12
46222,2,41,289,38,2103,3
23671,9,502,2551,307,7538,195
25626,2,92,2463,58,3029,34
40123,0,0,1682,0,2479,0
15740,16,797,2951,588,12382,209
11892,436,13054,3198,10665,78282,2389
44063,6,68,944,50,3206,18
35526,21,468,1977,360,6682,108
33643,10,314,2066,239,4690,75
46200,33,205,294,151,3164,54
22690,11,1439,2599,672,18530,767
42387,4,333,1377,199,7802,134
14806,42,1530,2997,1208,22263,322
42594,40,940,1334,708,10666,232
16058,9,560,2937,409,8239,151
34545,8,386,2032,296,8381,90
16150,269,13292,2932,7334,48737,5958
16090,3,523,2935,401,6541,122
10957,103,125417,3246,3411,37048,122006
17943,294,26411,2843,12368,100968,14043
37064,31,1438,1879,1102,13237,336
33247,3,127,2081,103,3080,24
5097,1195,43322,3574,37860,161658,5462
26436,16,949,2426,662,7858,287
32722,21,555,2102,420,11789,135
30135,5,320,2232,254,4589,66
43309,82,1906,1144,1244,22781,662
11733,29,4007,3205,2333,27713,1674
43472,22,377,1096,235,6471,142
19443,93,4230,2776,3020,18683,1210
19790,0,0,2758,0,1530,0
11905,12,615,3198,576,9250,39
16417,324,19748,2919,11516,162181,8232
42149,205,4537,1424,3730,26268,807
46190,9,87,297,53,3170,34
20632,0,2643,2714,2039,46301,604
44753,2,60,814,33,2541,27
27277,0,46,2387,35,4004,11
40936,9,481,1610,335,7199,146
36725,3,91,1901,75,3986,16
42218,168,4389,1407,3384,98716,1005
45503,16,261,579,131,6480,130
40751,43,1372,1627,1089,26460,283
31105,0,70,2182,56,1237,14
38248,2,94,1800,73,7039,21
24194,2593,95940,2527,61635,471428,34305
39504,764,44160,1720,21770,178945,22390
12859,1325,61749,3145,39906,175928,21843
34984,3,143,2008,121,3400,22
993,5,227,3971,181,9227,46
31810,7,139,2145,122,4058,17
32045,20,886,2133,661,12073,225
43008,14,494,1232,227,15691,267
44332,5,80,900,52,4672,28
39811,9,247,1702,212,6460,35
24805,40,2250,2500,1092,17220,1158
28638,37,1161,2306,999,19755,162
16545,2,400,2913,258,2877,142
1073,6,116,3944,102,4427,14
25342,0,12789,2476,9539,78526,3250
16567,79,1972,2912,1569,24493,403
32173,6,260,2126,207,11329,53
24853,35,2090,2497,1411,31602,679
14940,34,578,2990,467,6828,111
39654,1,79,1711,62,4666,17
43117,347,12964,1199,6832,89403,6132
14986,9,515,2988,488,10703,27
26875,16,617,2406,546,9017,71
8771,314,17767,3365,15911,110603,1856
45334,13,115,622,108,1737,7
29204,8,169,2278,143,6636,26
41168,3,205,1585,163,4358,42
19809,136,8858,2757,4619,58618,4239
20757,6,189,2707,148,10471,41
36617,44,2301,1906,1256,24980,1045
20150,34,720,2738,589,2873,131
45208,109,1261,660,768,10701,493
39571,29,648,1716,507,19379,141
29327,23,708,2270,552,5929,156
31205,6,135,2177,115,12144,20
42370,17,581,1379,457,11751,124
26569,0,74,2420,66,1869,8
24015,25,2866,2535,1761,32802,1105
20331,4,412,2730,267,12287,145
23448,6,366,2562,254,4838,112
24828,4,109,2499,98,6030,11
45299,176,2369,631,2132,26106,237
44474,97,2192,879,869,29495,1323
18150,5,244,2833,188,7480,56
45952,2,49,396,39,1510,10
24250,70,1822,2525,1271,12792,551
34176,16,210,2048,174,2223,36
13462,8,506,3096,477,9076,29
37678,14,690,1841,464,16971,226
20316,4,150,2730,120,4666,30
6657,12,236936,3502,333,5278,236603
25183,29,1227,2482,1006,5260,221
21535,0,60,2660,48,4648,12
27698,3,116,2361,60,4084,56
12544,1,102,3164,57,1840,45
18397,7,512,2822,208,8003,304
15364,4,214,2968,172,4677,42
42928,263,3740,1254,2847,23554,893
44023,4,57,951,49,2682,8
41399,141,3299,1549,2234,18672,1065
12991,43,1982,3136,1737,9482,245
24533,42,1414,2512,1059,12592,355
25243,30,1057,2480,876,14343,181
38181,0,106,1806,79,8964,27
27638,813,16471,2365,12963,60412,3508
16945,4,0,2892,0,18172,0
36299,18,499,1923,385,9740,114
39817,11,584,1702,436,8433,148
41478,128,3819,1538,2440,27352,1379
16749,28,1908,2903,1035,18182,873
41872,21,451,1472,384,21442,67
36891,2,89,1890,70,2125,19
18223,8,266,2830,202,4694,64
17975,4,486,2841,262,9294,224
25883,211,7842,2452,5423,58757,2419
15189,1,174,2976,163,7298,11
14325,54,1335,3032,1144,15799,191
37699,6,225,1839,167,5962,58
23064,494,22027,2581,16419,80510,5608
45326,22,228,623,193,4664,35
36489,9,629,1914,193,6559,436
33882,2,161,2057,136,10260,25
26682,3,183,2415,134,4728,49
20555,147,4515,2718,3446,31262,1069
44233,16,214,915,110,5710,104
33819,25,1563,2059,998,20926,565
15095,24,1066,2982,825,13586,241
39636,77,1768,1712,961,14671,807
27147,103,2085,2394,1600,14902,485
41456,29,588,1541,443,10034,145
30045,4,173,2236,139,3350,34
25880,14,442,2452,347,10319,95
29852,11,350,2245,292,12257,58
34925,16,457,2010,362,7168,95
14297,3,148,3034,137,3457,11
16953,8,279,2892,216,14811,63
19522,32,1135,2772,984,14960,151
35927,11,418,1947,220,10200,198
7616,5,231,3449,198,6575,33
39692,22,455,1709,299,10436,156
34410,176,3141,2038,2183,15558,958
29716,4,137,2252,105,7481,32
34259,4,278,2045,170,8663,108
20837,25,1372,2702,1050,9754,322
43034,10,249,1225,222,6747,27
28461,133,3034,2318,2250,13634,784
28214,64,2096,2331,1528,15311,568
31970,12,434,2137,355,6203,79
16643,11,229,2909,191,6682,38
40187,26,1281,1678,778,19093,503
19344,11,3357,2781,423,12232,2934
23687,127,4031,2550,2464,30069,1567
29601,29,1633,2258,928,18874,705
43188,14,299,1181,198,9492,101
23289,76,3303,2570,2518,20180,785
45853,128,1401,440,1236,8617,165
2037,2845,142082,3657,112509,422492,29573
23170,65,3455,2576,2749,22440,706
36851,14,634,1891,517,14824,117
38238,17,449,1801,362,8184,87
23682,0,93,2550,61,3077,32
32669,0,22,2104,19,5042,3
35607,3,95,1971,53,2817,42
14910,3,103,2992,81,2935,22
45678,6,83,508,62,4782,21
24226,5,492,2526,426,14637,66
37252,6,373,1867,295,10973,78
24001,15,411,2536,323,6938,88
39089,7,131,1744,105,5628,26
39457,78,1575,1722,1223,22373,352
25738,9,892,2457,729,9606,163
20217,21,488,2734,364,14667,124
42357,43,850,1381,598,12758,252
20305,13,329,2730,219,7114,110
11897,25,592,3198,574,3912,18
17252,12,606,2874,397,13288,209
44172,4,76,925,47,4886,29
14020,32,2658,3052,2287,50078,371
26051,56,923,2443,685,11071,238
15905,15,1415,2945,752,14403,663
42551,17,182,1342,138,3709,44
32868,0,154,2096,130,7930,24
34589,23,1015,2030,735,10430,280
34696,3,99,2024,69,2310,30
22528,27,1736,2607,1380,19345,356
20032,7,484,2745,173,7598,311
31476,24,830,2162,688,15760,142
39134,6,166,1742,125,2981,41
44003,2,41,956,26,2341,15
30060,91,3431,2235,1660,35704,1771
39773,8,140,1705,120,5258,20
40517,6,306,1648,235,6239,71
21075,11,1530,2687,1220,18383,310
28807,13,629,2297,510,4457,119
40100,5,373,1683,299,11214,74
17739,2,58,2852,47,1943,11
32135,60,1246,2128,896,12516,350
31471,10,252,2162,218,7520,34
25138,0,4305,2484,2081,31970,2224
36618,321,4987,1906,3633,27475,1354
10510,2917,211603,3271,131889,571067,79714
43225,53,1414,1170,1015,16624,399
15313,24,1313,2970,1083,7422,230
37610,3,127,1844,105,4247,22
33609,1,23,2067,22,2411,1
39916,13,727,1694,514,11474,213
17135,47,1560,2881,877,10871,683
26952,2,67,2402,57,2147,10
10387,15,763,3278,746,19324,17
18950,3,107,2799,79,7598,28
24633,4,156,2506,138,2012,18
33506,1,34,2071,30,2437,4
20332,432,16467,2730,12298,54972,4169
38315,15,521,1796,393,7591,128
11357,49,126412,3225,1560,20185,124852
15895,2,131,2945,105,2987,26
17431,113,5627,2865,4384,36734,1243
31391,11,374,2167,261,7291,113
14732,1,123,3003,120,4548,3
15330,6,252,2969,209,7846,43
21608,706,98930,2655,24183,212271,74747
16994,81,4087,2890,2957,30752,1130
31660,1,81,2152,65,2645,16
27549,0,82,2369,69,2081,13
24120,0,140,2531,112,5212,28
44296,1,75,908,45,2371,30
23998,101,7649,2536,3792,37652,3857
30654,0,32,2202,21,3130,11
45380,172,4713,611,3852,35109,861
45173,2,24,670,17,2916,7
39950,19,618,1692,393,20525,225
34894,50,1128,2012,897,6737,231
37209,74,1251,1870,709,9626,542
37026,3,205,1882,100,7211,105
38645,11,368,1772,316,9763,52
21839,21,720,2644,461,8961,259
34739,3,179,2022,139,3157,40
43412,42,263,1110,225,7077,38
18334,0,441,2825,66,2616,375
33988,2,75,2054,67,3291,8
13894,93,6516,3063,4342,44762,2174
41766,15,301,1492,200,11724,101
32968,7,446,2092,366,5461,80
39520,4,279,1719,213,4917,66
27879,44,971,2351,655,10140,316
41525,3,96,1532,87,8432,9
24881,46,3735,2496,1723,31571,2012
11757,0,160364,3204,47,2514,160317
1219,6,279,3899,225,9450,54
17192,79,2151,2877,1567,35462,584
32157,20,902,2126,717,11382,185
35141,3,101,1999,83,4698,18
13868,35,2589,3066,1736,17919,853
14760,44,2083,3001,1767,23879,316
42302,146,3015,1393,2078,44331,937
46133,3,72,320,45,1920,27
16761,14,747,2902,625,10203,122
29683,5,74,2253,67,4660,7
19730,21,2811,2762,2225,26467,586
29054,1,24,2285,22,2439,2
41092,3,68,1594,43,9732,25
20499,12,640,2721,549,5759,91
42803,9,157,1283,121,4202,36
12071,12,985,3190,649,19935,336
19994,134,3397,2747,2262,21131,1135
42167,33,994,1419,772,9509,222
18055,16,439,2837,329,5967,110
41632,22,807,1516,330,19258,477
8849,12,359,3360,296,14562,63
12703,252,10311,3154,9090,69981,1221
23500,1,12,2560,12,1379,0
10812,248,15233,3253,11739,58015,3494
20503,51,1279,2721,781,11559,498
3973,878,40880,3620,27745,173604,13135
15508,402,29279,2962,17733,162250,11546
42424,94,4622,1367,1610,63805,3012
46421,7,90,204,83,1873,7
17344,16,409,2869,340,4721,69
11113,358,28073,3237,26811,168785,1262
18534,3,162,2817,132,3818,30
27460,8,627,2375,202,4163,425
23207,18,851,2574,684,12124,167
20085,118,3747,2742,2831,41550,916
25544,18,1316,2467,942,18726,374
22910,18,733,2588,409,5399,324
32737,756,26656,2102,16992,159519,9664
40916,10,179,1612,137,2297,42
20773,12,443,2706,360,5182,83
8654,67,1811,3372,1771,20094,40
34655,8,184,2026,156,7193,28
34874,3,380,2013,339,8519,41
32329,6,200,2119,137,5494,63
22363,32,1837,2616,1336,22267,501
21248,555,35614,2675,26462,206274,9152
39750,4,223,1706,152,4074,71
35786,6,524,1956,328,9040,196
15124,514,27327,2980,19817,138579,7510
35867,0,129,1951,101,6918,28
44048,23,203,946,152,4256,51
36283,15,715,1923,624,12999,91
4040,156,8839,3618,8542,45655,297
31735,11,234,2148,176,5293,58
42084,13,573,1436,416,11548,157
40941,32,906,1610,689,16116,217
12732,590,14684,3152,11430,70448,3254
17059,22,1464,2885,441,17849,1023
41915,90,4012,1465,2154,35436,1858
41012,468,9818,1605,5475,49554,4343
31983,5,314,2136,253,5335,61
30712,39,880,2199,719,9453,161
1126,4,244,3929,209,5798,35
12057,0,80429,3191,59,3477,80370
18753,0,103,2807,86,5807,17
41243,130,4619,1574,2261,44684,2358
18509,26,941,2817,701,6962,240
25740,0,47,2457,37,2152,10
27666,17,673,2363,443,6996,230
24915,481,14185,2494,9030,70002,5155
38736,63,1029,1767,785,7308,244
22928,0,51,2586,44,2672,7
26445,11,1020,2425,467,11882,553
14726,15,820,3004,758,23855,62
21727,11,344,2649,266,6116,78
42644,963,23551,1324,16785,113756,6766
32995,4,135,2091,109,4374,26
41010,66,2272,1605,1373,29476,899
31510,11,219,2160,181,5947,38
29445,4,73,2264,62,4614,11
26026,1,179,2445,151,6125,28
16622,8538,364406,2910,197562,799333,166844
13357,60,87683,3106,3137,59225,84546
35054,8,323,2004,261,6872,62
29795,75,4847,2248,3602,44591,1245
32154,2,82,2127,71,5292,11
15897,16,541,2945,410,9985,131
41528,93,1656,1532,1060,12269,596
15541,13,692,2961,550,6360,142
40844,5,107,1618,91,4249,16
20817,6,110,2703,104,5203,6
10753,478,20009,3256,13962,97525,6047
5519,21,1226,3552,1115,10876,111
29651,13,322,2254,259,9072,63
41273,35,1254,1568,744,29005,510
24471,0,476,2515,235,5878,241
29152,19,1202,2280,789,18403,413
35384,54,1371,1987,1166,12599,205
20547,10,286,2718,241,8533,45
19036,1,307,2796,255,5284,52
18819,9,357,2804,298,7902,59
14753,23,796,3001,772,12453,24
18248,1,148,2828,96,7352,52
20079,31,2055,2742,1120,31912,935
22217,9,540,2622,408,4741,132
27204,31,1710,2391,1310,23285,400
39148,7,186,1741,154,5021,32
15003,12,1326,2987,974,13440,352
27827,2,62,2353,51,3833,11
13910,25,1792,3061,1746,16254,46
40829,98,2020,1619,1623,20089,397
27852,76,2632,2352,2102,15206,530
14817,24,1572,2997,1173,19988,399
33928,5,552,2056,139,7512,413
26498,43,9673,2423,7924,14042,1749
37081,16,324,1878,247,7761,77
23895,111,7857,2542,5754,38776,2103
27438,8,416,2377,277,3687,139
26788,176,6105,2410,4346,50455,1759
38815,1,148,1761,54,3197,94
22330,483,30474,2617,18644,155709,11830
18957,126,4174,2799,3206,30002,968
38141,182,4674,1808,3493,35420,1181
15995,37,1120,2940,889,16086,231
25734,2189,87060,2458,61948,489124,25112
32929,3,169,2093,136,4243,33
32984,4,145,2091,115,3388,30
45767,38,683,468,275,8201,408
13172,4,276,3117,248,13454,28
32855,469,14468,2096,9650,102614,4818
13320,16,582,3108,568,8623,14
23765,4,122,2547,94,6146,28
18812,65,8641,2804,5942,41329,2699
45084,106,976,707,814,9708,162
15724,5,477,2951,314,12924,163
29145,0,18,2280,17,1982,1
37847,54,1707,1827,1406,20844,301
39248,8,173,1733,149,14192,24
36173,26,568,1929,438,7897,130
38136,29,778,1808,489,13367,289
45978,5,110,386,67,2489,43
43490,160,4419,1090,1540,28426,2879
3172,1596,74759,3638,71236,281618,3523
45234,32,241,652,195,4806,46
23949,41,4390,2538,1506,20719,2884
39766,16,319,1706,227,8432,92
12591,86,6362,3161,2745,42084,3617
14180,5,263,3043,232,8039,31
27409,4,434,2379,369,8435,65
36852,308,13238,1891,10120,94822,3118
15764,2,109,2950,64,3486,45
19728,5,110,2762,52,7245,58
42925,7,231,1255,159,7246,72
21490,13,857,2663,702,10174,155
21123,1,228,2684,191,5839,37
25059,2,91,2488,86,8941,5
2455,201,16535,3650,15248,55816,1287
36798,19,679,1896,535,5977,144
31005,16,451,2187,339,6709,112
30212,5,114,2227,99,2260,15
11824,2055,197881,3201,103188,632377,94693
37200,6,58,1870,48,2684,10
17609,59,1766,2856,1153,19852,613
21323,2,85,2672,77,2646,8
42104,0,53,1433,47,3115,6
19695,165,6804,2764,5211,71155,1593
33340,14,587,2077,480,15475,107
34970,1,63,2008,57,3205,6
15781,3759,134685,2949,85190,398041,49495
42684,201,5430,1313,3259,37877,2171
36703,41,1778,1902,1050,26064,728
24064,13,506,2534,415,21364,91
19764,32,2712,2760,1255,18283,1457
45961,30,386,393,379,12676,7
39100,11,369,1744,284,6165,85
43524,15,256,1080,188,8707,68
33701,0,0,2064,0,9306,0
44114,92,1992,935,1360,17569,632
34512,20,697,2034,436,9412,261
22272,84,4754,2619,2591,39122,2163
27132,2,112,2395,96,1614,16
43092,51,1856,1206,1306,25422,550
36073,1,43,1935,38,4818,5
20326,2,197,2730,159,3818,38
40132,67,655,1681,461,5582,194
32481,15,547,2112,445,9064,102
32494,28,616,2112,501,8317,115
45362,3,129,615,65,4291,64
24308,17,564,2522,457,6948,107
38484,11,379,1784,275,7927,104
46018,2,23,369,17,956,6
44385,6,162,893,119,6968,43
33390,21,484,2075,381,3807,103
42998,68,1543,1235,1105,36364,438
23073,75,1709,2581,1232,11189,477
42645,83,1547,1324,1131,16996,416
16769,50,2548,2901,1850,19276,698
39526,3,186,1719,88,5616,98
3057,5,294447,3640,358,4434,294089
26973,15,831,2402,491,7506,340
31762,14,308,2147,241,4204,67
26573,0,68,2420,60,1946,8
44277,4,104,910,51,6615,53
34473,10,342,2036,273,7006,69
19071,3,48,2794,42,4235,6
20618,2,732,2715,413,9198,319
37009,3,200,1883,169,6275,31
38250,1,99,1800,87,4286,12
46333,11,159,250,144,2928,15
10969,17,703,3245,694,5939,9
45395,5,28,606,28,2414,0
40946,0,21,1609,9,2298,12
23255,8,188,2572,149,3203,39
29525,3,209,2261,154,6399,55
20886,2,95,2698,61,2404,34
39195,14,349,1738,275,6427,74
25177,11,599,2483,328,8954,271
16815,452,29944,2898,11694,145541,18250
8676,96,1768,3370,1749,17769,19
21318,12,1041,2672,823,25735,218
38229,26,882,1802,539,9400,343
31925,2,141,2140,106,5046,35
37463,178,3591,1855,2381,22852,1210
38381,0,71,1791,56,4792,15
29925,5,487,2241,319,6535,168
32565,5,167,2108,123,6351,44
41564,31,373,1528,277,5983,96
40346,6,127,1665,99,4439,28
29685,0,153,2253,117,2691,36
39625,5,111,1712,96,9700,15
22168,6,440,2625,310,3763,130
19146,13,302,2791,228,3953,74
21542,59,1465,2659,1056,16202,409
37759,659,27038,1834,19670,157133,7368
34354,8,279,2041,234,3255,45
37423,22,379,1857,343,9185,36
26067,411,38964,2443,17498,156493,21466
33164,3,136,2083,113,4312,23
21761,7,352,2647,275,7087,77
13963,50,1375,3056,1320,7461,55
10757,72,137388,3256,3206,47049,134182
21079,2,73,2687,63,7041,10
42687,11,190,1312,152,5610,38
34335,3,170,2042,146,8507,24
25335,20,1205,2476,292,8141,913
12315,1,105,3176,103,5790,2
42419,3,146,1368,84,7523,62
17831,5,107,2849,85,3631,22
43410,16,162,1111,136,6207,26
35177,3,186,1997,137,14079,49
17801,18,818,2850,650,5404,168
5861,1920,94132,3534,77685,262044,16447
29185,40,1816,2279,1397,25620,419
13167,13,1530,3118,1100,22880,430
45345,29,269,619,199,2861,70
39202,122,4597,1737,1753,57326,2844
39997,22,688,1689,533,12973,155
38709,305,9151,1768,6004,44816,3147
28902,254,17393,2293,7530,101818,9863
29488,10,361,2262,320,9981,41
28278,23,417,2328,350,10429,67
24822,0,32742,2499,4924,51432,27818
14720,591,24783,3004,17912,86205,6871
36023,41,594,1940,436,9457,158
31177,4,145,2178,109,4169,36
37628,5,80,1843,61,3308,19
25894,7,193,2451,164,2898,29
25908,105,8311,2450,3999,54845,4312
44756,4,87,814,60,3532,27
37676,46,1719,1841,1327,12643,392
27048,7,523,2400,397,5021,126
31892,236,7726,2141,5192,83755,2534
19513,26,872,2773,710,14380,162
20633,77,1441,2714,1083,12548,358
34292,14,131,2044,112,4159,19
41880,47,1046,1470,795,30531,251
36776,4,157,1897,116,6354,41
40598,2,72,1641,54,3024,18
24338,38,3186,2521,1996,10983,1190
37412,10,213,1858,194,3302,19
37303,0,30,1864,30,3384,0
45591,87,650,550,515,8716,135
40950,91,2263,1609,1579,19739,684
20486,6,102,2722,88,1824,14
37794,1126,34461,1832,25020,158444,9441
1135,11,596,3928,441,9363,155
40433,34,3806,1656,1399,22292,2407
38775,47,1029,1764,840,11259,189
14059,21,423,3049,412,4103,11
16869,83,2034,2896,1676,11138,358
3225,39,1410,3637,1274,8985,136
35933,36,819,1946,609,8587,210
24124,27,1686,2530,870,24257,816
34502,3,243,2035,195,3993,48
40222,6,256,1675,207,7361,49
13638,42,1606,3084,1482,29835,124
26272,0,957,2434,740,15311,217
32254,1,40,2122,33,3646,7
20698,331,15170,2710,10016,36190,5154
43739,9,103,1003,87,4638,16
28220,1,141,2331,95,3699,46
21150,24,1952,2681,1213,28579,739
10505,2183,170640,3272,94943,862291,75697
29149,20,467,2280,370,5455,97
29218,6,833,2277,474,7480,359
9360,334,11033,3329,7745,59304,3288
11207,28,1271,3232,978,17073,293
17540,6,1020,2859,806,8361,214
13501,44,2858,3094,2311,33503,547
38234,34,1228,1802,960,14586,268
37811,43,1835,1831,1335,22273,500
14357,1,46219,3029,58,6632,46161
41249,6,310,1572,239,14952,71
21720,50,2101,2649,1690,23674,411
13699,303,20438,3079,9788,78153,10650
15435,9,168,2966,135,9253,33
23959,6,811,2538,671,15054,140
19205,0,60,2788,50,4656,10
18232,1,53,2829,44,3857,9
7757,148,158457,3441,4383,30775,154074
36573,2,113,1909,91,4082,22
41089,8,143,1595,108,4740,35
34830,251,16338,2015,6970,36992,9368
27864,12,264,2352,200,2953,64
23545,62,2405,2558,1848,11783,557
35941,329,6493,1946,6272,37122,221
16786,3,109,2900,88,17633,21
11561,8,386,3214,348,3873,38
27621,194,16631,2365,7002,49019,9629
42850,45,528,1276,385,10474,143
45568,64,1158,554,772,7373,386
36317,9,274,1922,228,5050,46
16506,14,1264,2915,789,14253,475
33140,0,43,2084,40,3615,3
35194,49,896,1997,724,11745,172
1059,6,222,3947,182,10645,40
35813,77,7397,1955,1497,17294,5900
18224,13,1186,2830,882,19981,304
28800,0,33,2298,29,1875,4
17305,2,58,2871,24,5956,34
33726,8,555,2063,254,7117,301
38820,1,65,1761,50,2097,15
26775,46,1170,2411,962,11846,208
45487,15,204,582,168,4006,36
38104,85,2173,1811,1397,15291,776
40153,19,443,1680,355,7461,88
42129,286,6718,1429,4925,57802,1793
41005,552,11556,1605,7849,54778,3707
19154,112,10417,2791,5896,82895,4521
26225,448,25373,2436,10792,149313,14581
12189,53,2242,3183,1807,20976,435
32337,4,260,2118,229,5402,31
15596,13,408,2957,363,3730,45
31553,4,148,2158,111,4349,37
37725,6,135,1837,77,2443,58
29017,15,414,2287,319,8286,95
30584,14,1081,2206,548,8317,533
8668,11,1246,3371,910,18834,336
25735,31,6263,2457,2991,29476,3272
22759,36,2086,2596,1568,32700,518
37191,1,155,1871,124,6854,31
33270,1,62,2080,53,3396,9
33033,73,1094,2089,829,12438,265
29637,21,777,2255,606,10556,171
38864,34,879,1759,665,11299,214
38375,1515,66801,1791,32569,228056,34232
29137,265,11404,2281,5033,55327,6371
37797,58,663,1832,519,5954,144
29333,77,4287,2270,1579,25669,2708
40424,22,374,1657,300,6073,74
22023,20,638,2632,511,14990,127
35359,32,360,1988,286,3977,74
31930,15,417,2139,315,6848,102
13641,4,116,3084,111,4515,5
30028,497,22216,2237,14794,128666,7422
23828,11,848,2544,575,4892,273
27171,123,2238,2393,1281,11266,957
39226,74,1336,1736,885,15381,451
27528,32,1212,2370,872,14761,340
42899,9,608,1263,276,10189,332
41042,194,4520,1601,3107,28263,1413
28176,39,1495,2334,1171,13735,324
21331,11,512,2671,390,9068,122
34548,8,192,2032,154,6267,38
39873,15,643,1698,508,13140,135
41426,2,128,1545,112,4879,16
42903,4,63,1262,57,7408,6
25910,14,626,2450,341,13111,285
36650,156,4794,1904,3127,56891,1667
34519,1,54,2034,44,3168,10
40629,13,318,1638,253,15463,65
41400,4,207,1549,98,11153,109
13281,28,615,3111,535,8542,80
30738,28,970,2198,775,20258,195
45726,2,33,483,28,1019,5
45411,21,170,600,156,5683,14
45213,3,46,657,30,2164,16
43386,240,3839,1101,2979,50731,860
18528,12,641,2817,516,10150,125
12528,10,361,3164,340,5485,21
41113,0,49,1591,41,3793,8
37487,153,3049,1852,2265,25521,784
34862,24,638,2014,553,31255,85
30438,6,332,2214,265,5989,67
34226,2,64,2047,51,1381,13
25272,24,1525,2479,1189,24751,336
23599,77,4960,2555,3284,44477,1676
38937,7,161,1754,132,5180,29
18234,55,1745,2829,1387,8467,358
42147,52,937,1424,695,20344,242
25962,12,472,2448,370,7071,102
17132,3,430,2881,301,19131,129
14510,32,2616,3018,1926,21766,690
39736,128,1907,1707,1441,14386,466
16745,285,20264,2903,13559,125890,6705
15462,5,297,2965,229,5415,68
28262,29,1150,2329,898,16754,252
9948,123,4852,3298,4314,32581,538
12430,39,2395,3168,2361,22629,34
14113,2,172,3046,140,4539,32
36315,4,116,1922,89,1968,27
29313,42,1439,2271,1073,13762,366
19375,9,295,2780,236,5657,59
37494,4,102,1852,81,3199,21
42385,176,4917,1377,3391,26418,1526
40042,3,132,1686,106,2909,26
28520,232,17323,2313,8517,74254,8806
37730,6,251,1837,194,4091,57
21051,1,58,2688,49,4069,9
41029,29,583,1603,396,4623,187
3460,110,8842,3632,8263,63577,579
24843,1,133,2498,111,3795,22
15744,16,502,2950,389,10378,113
29721,10,412,2251,329,17335,83
19147,5,143,2791,124,3234,19
12851,56,2741,3145,1943,18627,798
15491,5,259,2963,199,8546,60
45646,186,10362,524,5569,96105,4793
7694,964,42871,3444,31153,149038,11718
25804,306,10200,2455,6947,50564,3253
24776,8,591,2501,446,6544,145
30674,7,196,2201,161,6307,35
34676,32,344,2025,297,6368,47
22391,46,1512,2614,936,16062,576
24191,2,76,2527,62,3735,14
33668,0,17,2065,17,2215,0
34511,14,503,2034,434,8386,69
44527,23,324,873,243,5203,81
24635,8,446,2506,342,5384,104
43990,33,289,958,217,5073,72
42399,65,2600,1375,1352,28198,1248
27569,12,2195,2368,1689,24635,506
20693,267,12906,2711,9420,103843,3486
19500,9,490,2773,363,12369,127
5568,227,11353,3550,8261,64207,3092
30501,26,898,2210,720,19938,178
29782,2,55,2248,49,5273,6
947,3,72,3986,62,2748,10
14645,39,2267,3009,1595,19416,672
23497,11,319,2560,257,5396,62
44882,17,120,776,109,2481,11
26193,11,2671,2437,1232,21638,1439
34611,310,10235,2029,7040,91352,3195
7500,153,8502,3457,7319,47033,1183
40056,9,256,1685,210,4985,46
16459,2947,395049,2917,127248,1063185,267801
28796,23,1207,2298,840,15573,367
40712,132,3203,1631,2588,13563,615
35500,11,155,1979,130,4842,25
31600,142,11290,2156,7495,88423,3795
6199,21,710,3521,688,4212,22
39912,51,1302,1695,959,12601,343
19495,5,505,2773,409,19317,96
18418,64,5258,2821,3093,34687,2165
27839,10,217,2353,127,2361,90
41841,3,97,1477,81,4150,16
3991,60,4044,3619,2559,16049,1485
46149,30,414,314,206,10471,208
19851,18,905,2755,577,10519,328
25278,4,682,2479,480,5506,202
43583,2,23,1057,21,1694,2
45700,1,31,499,31,2814,0
9219,229,16579,3339,15734,103570,845
34684,4,197,2024,156,4494,41
29045,11,550,2286,463,8510,87
43202,5,202,1177,141,4602,61
42742,43,1031,1299,603,10263,428
14757,0,29661,3001,99,4345,29562
9114,100,3535,3345,2992,11771,543
13906,63,4907,3061,3658,38042,1249
11676,69,2846,3208,2452,24630,394
16416,10,635,2919,492,13093,143
27125,323,5833,2396,4366,38549,1467
34710,2,28,2023,24,2003,4
40911,0,53,1612,38,3964,15
43720,22,497,1009,258,9024,239
28257,3,277,2329,190,5561,87
19224,51,1583,2788,1093,7648,490
32287,0,18,2121,17,1917,1
45099,7,179,697,89,7115,90
22443,4,242,2612,177,9121,65
18417,1596,141027,2821,46593,414629,94434
38584,46,1466,1777,793,10370,673
15547,18,398,2960,326,6476,72
38849,18,788,1759,374,7244,414
17204,235,17527,2877,8316,113180,9211
41200,0,0,1582,0,2666,0
42169,8,98,1418,80,3350,18
6625,34,2091,3503,1895,15634,196
40088,1,57,1683,32,2664,25
26693,8,595,2415,502,6217,93
15984,2,538,2941,432,9003,106
14498,145,5066,3019,4248,39518,818
39622,59,2028,1713,1322,27455,706
14853,129,3576,2995,2947,23730,629
42518,10,394,1347,296,12585,98
34805,4,253,2017,104,7668,149
38742,0,49,1766,38,2013,11
15684,4,171,2953,151,3748,20
11907,32,1720,3198,1523,15472,197
36653,2,79,1904,75,3440,4
44922,13,128,764,94,3550,34
31448,41,1697,2164,1364,8728,333
14415,11,649,3025,644,25633,5
32952,35,1073,2093,846,9170,227
27611,0,0,2366,0,3018,0
41244,36,854,1573,555,11555,299
27893,7,219,2350,193,5519,26
40783,133,3054,1625,2313,27010,741
26361,8,791,2429,277,8313,514
18129,148,5447,2834,4265,44478,1182
11398,13,858,3223,765,7242,93
17539,0,279,2859,235,5829,44
26293,13,226,2433,186,4346,40
38538,6,372,1780,212,6257,160
25557,36,1120,2467,864,11667,256
20587,11,924,2716,693,23461,231
27829,2,124,2353,98,2684,26
27498,10,258,2373,197,8748,61
19238,15,495,2787,396,24096,99
25632,0,23,2462,21,1878,2
4703,1082,42551,3594,40563,215076,1988
25068,7,227,2488,185,4754,42
37754,5,210,1835,184,5111,26
34601,39,1426,2029,975,17302,451
38547,9,165,1779,138,13311,27
41174,63,1859,1585,1265,35963,594
41694,51,1043,1506,606,9323,437
32499,50,2380,2112,1102,20532,1278
14580,37,3410,3013,2687,91916,723
12408,2,170,3170,153,3397,17
33753,2,84,2062,66,3363,18
22170,290,17016,2625,5916,59415,11100
26418,13,374,2427,268,3661,106
38574,1,50,1777,39,3642,11
32412,2,64,2115,39,2180,25
18685,28,3498,2809,1569,39565,1929
28614,41,796,2307,602,8816,194
36014,3,124,1940,94,2600,30
28633,3,103,2306,86,5907,17
22199,1,79,2623,59,2697,20
18798,3,69,2805,61,4844,8
30713,13,510,2199,419,3220,91
21629,34,1190,2654,902,12304,288
30365,0,47,2218,40,2236,7
28924,104,10056,2292,2595,30654,7461
44790,15,128,804,105,2201,23
36665,88,1851,1903,1440,12366,411
26766,15,354,2411,294,6615,60
33842,0,29,2058,27,2004,2
45902,22,193,424,156,3682,37
23160,3,114,2576,94,2632,20
32334,5,118,2118,104,3657,14
37524,0,75,1850,49,5218,26
14545,34,537,3016,525,10774,12
35987,7,192,1942,158,8591,34
15621,38,2680,2956,2196,7172,484
20481,10,671,2722,518,13266,153
24186,0,45,2528,16,3669,29
14559,0,158,3015,136,4937,22
41505,32,380,1534,302,3408,78
32276,5,104,2121,93,2728,11
39583,0,52,1715,44,4907,8
44705,11,222,831,148,4117,74
35737,0,145,1960,108,4494,37
13903,34,1331,3061,1048,9981,283
28527,3,575,2313,464,17028,111
25619,0,67,2463,65,5470,2
14809,30,678,2997,663,10087,15
29032,2,176,2286,152,4340,24
20309,2,107,2730,84,4801,23
24837,20,371,2498,307,5714,64
30180,14,697,2229,557,6567,140
18530,87,4356,2817,3204,28695,1152
44071,5,99,943,52,3579,47
16214,22,1969,2930,1269,12124,700
34752,15,670,2021,534,18582,136
31836,1,116,2143,76,3699,40
39286,26,573,1731,407,9206,166
21246,15,418,2675,373,5434,45
14354,27,1273,3030,1153,11272,120
16118,55,2027,2934,1507,15242,520
23392,8,360,2565,285,5925,75
20665,13,599,2712,479,7793,120
38858,96,3199,1759,1755,35972,1444
35074,14,350,2003,281,13539,69
37867,557,17460,1826,8427,92125,9033
35868,123,4564,1951,3137,29602,1427
31655,6,111,2152,95,1438,16
38436,402,23858,1787,14077,107886,9781
21679,6,672,2651,374,6982,298
37136,32,815,1875,660,7025,155
33370,7,334,2076,274,3075,60
35196,5,349,1997,293,7400,56
30111,9,863,2233,623,10573,240
30011,6,224,2237,173,5312,51
39080,0,46,1745,32,5085,14
33068,23,1683,2087,1327,27840,356
45316,11,326,626,198,4418,128
12132,42,1572,3186,1382,12195,190
10807,69,3966,3253,3327,33255,639
29377,24,1105,2268,801,27853,304
45343,208,3665,620,3417,31826,248
28119,1,97,2338,87,2352,10
38816,164,2716,1761,1960,26143,756
33246,32,290,2081,248,3681,42
42153,24,813,1422,571,9587,242
15045,8,857,2984,673,8540,184
33179,50,1770,2083,1445,24373,325
30741,12,510,2197,401,3539,109
21018,7,282,2689,235,2630,47
39804,3086,123054,1703,62771,318101,60283
15788,1,96,2948,68,6957,28
14363,24,788,3029,785,24052,3
45027,33,302,733,237,5451,65
45571,17,346,553,210,6150,136
20887,21,2034,2698,1105,30474,929
34703,4,110,2023,88,2559,22
19531,1039,60239,2772,42027,291252,18212
39977,4,143,1690,69,6478,74
26534,63,3068,2421,1837,22621,1231
28147,21,1185,2336,908,14256,277
39665,30,1389,1710,1094,10930,295
35750,0,68,1960,38,3357,30
2551,19,464,3648,439,4262,25
45815,16,134,454,117,2910,17
42617,2,23,1329,20,2516,3
36620,2,138,1906,115,3666,23
20622,38,4010,2715,2828,33987,1182
15092,2,82,2982,80,4002,2
17492,189,9709,2862,4806,59716,4903
43116,0,17,1199,15,3447,2
19140,647,21238,2792,12161,124161,9077
32732,55,2947,2102,1679,29201,1268
18574,195,14090,2815,10955,98289,3135
10671,110,5811,3261,5146,31815,665
34497,1,179,2035,147,3784,32
39631,17,552,1712,461,8924,91
33127,131,3258,2085,1843,27091,1415
40610,10,133,1639,105,2532,28
18947,22,853,2799,667,10807,186
16310,26,683,2925,545,6055,138
18656,1,200,2810,160,3054,40
38800,607,27449,1762,17357,128756,10092
14181,30,2651,3043,1952,31467,699
23054,2,176,2581,127,3333,49
38175,2,165,1806,124,6197,41
36484,31,1172,1914,938,16942,234
24416,7,291,2517,199,3342,92
38143,4,110,1808,84,2729,26
28480,47,839,2317,677,13575,162
33700,37,1114,2064,872,15532,242
32563,4,273,2108,193,10454,80
27054,1,131,2400,108,3741,23
15634,12,465,2955,375,6681,90
33630,15,605,2067,440,6078,165
37393,1,91,1859,72,4945,19
42351,1,35,1383,30,3160,5
31068,0,50,2184,41,2241,9
30981,0,93,2188,84,3339,9
42001,22,543,1451,400,16085,143
42264,63,1274,1399,882,27609,392
12931,206,11170,3141,8068,71292,3102
32566,0,155,2108,84,6348,71
29429,87,4258,2265,3186,22251,1072
41966,28,359,1456,268,9933,91
24085,488,15160,2532,11148,58081,4012
25835,100,4580,2454,2419,42531,2161
13954,16,1952,3057,1423,7249,529
34901,10,422,2012,358,9897,64
43689,36,243,1017,215,3917,28
21726,147,16702,2649,5388,74757,11314
32321,29,672,2119,528,9327,144
39071,251,14704,1745,7594,93615,7110
39587,8,237,1714,196,4918,41
32764,0,66,2101,47,3162,19
45052,16,247,722,139,4973,108
21560,48,1989,2659,1713,23940,276
31801,271,8868,2145,6703,55634,2165
43822,8,58,981,55,1335,3
43388,4,189,1117,140,5062,49
25624,5,331,2463,228,6159,103
31193,3,194,2177,136,4524,58
16795,99,25720,2899,4636,94268,21084
32869,0,16,2095,13,2137,3
17268,15,377,2873,299,5023,78
22032,39,3851,2631,944,18274,2907
21200,20,1649,2678,1178,24065,471
23829,48,2776,2544,2136,17890,640
16630,58,3553,2910,2819,35558,734
39757,4,64,1706,58,1830,6
24577,8,268,2509,227,8089,41
40178,0,28,1678,19,2982,9
20518,2,67,2720,56,5806,11
22451,11,1390,2611,881,22011,509
37531,17,318,1849,225,9945,93
22864,0,49,2591,37,2351,12
9942,11,433,3299,426,4173,7
17601,2,194,2857,138,4877,56
41842,3,143,1477,107,10823,36
14795,23,993,2998,853,15399,140
43848,2,52,978,40,7595,12
9969,13476,493648,3297,289223,1267341,204425
27752,91,3907,2358,2979,13221,928
41688,189,2990,1507,2132,40221,858
36385,0,64,1919,45,2414,19
38225,2,318,1802,122,11321,196
41704,3,187,1504,149,5357,38
41308,87,872,1563,657,9939,215
37970,7,241,1819,194,5296,47
33460,4,138,2073,107,2819,31
29703,0,376,2252,103,6004,273
28737,2,20,2301,16,1824,4
32424,322,7196,2115,3902,34958,3294
30279,142,2508,2223,1883,17736,625
38566,46,1398,1778,1047,17280,351
20452,19,1529,2723,762,16586,767
43405,2,30,1112,18,1713,12
45348,15,163,618,134,5845,29
34247,18,290,2046,225,4766,65
36628,7,263,1905,219,9261,44
40248,3,81,1673,64,7094,17
28277,28,1566,2328,1246,30617,320
46148,29,537,295,256,7039,281
38017,28,648,1817,440,8484,208
40499,1,42,1649,34,2558,8
37690,27,256,1840,217,4093,39
43213,3,146,1174,114,7472,32
26287,0,180,2433,147,7118,33
40469,91,2263,1652,1707,41259,556
39352,5,191,1728,117,4459,74
45776,0,48,464,26,1452,22
22916,92,6401,2588,4589,37414,1812
41649,1,47,1512,38,2869,9
12365,827,29152,3173,22715,146512,6437
34001,2,162,2053,127,3109,35
36002,130,3303,1941,2793,28178,510
38102,16,581,1811,412,9907,169
24942,4,155,2493,126,3507,29
16426,86,6130,2919,2763,34350,3367
20112,260,16901,2741,10178,98749,6723
45785,4,42,464,38,1552,4
34043,1,82,2052,55,3210,27
31339,10,889,2170,186,5990,703
42734,36,633,1303,463,8991,170
34215,6,164,2047,143,4502,21
42685,0,0,1313,0,4250,0
38406,36,958,1790,768,10371,190
12373,11,744,3172,701,13034,43
29108,7,334,2282,198,4040,136
39275,6,199,1732,148,9587,51
40077,0,101,1684,82,3734,19
13921,10,810,3060,731,6730,79
26570,4,308,2420,244,9280,64
27021,59,2855,2401,1974,25622,881
15790,11,410,2948,331,7796,79
14911,82,2988,2992,2600,20606,388
26317,1,26,2432,26,2404,0
34360,10,169,2041,135,3376,34
35265,444,17391,1992,8101,133512,9290
41904,104,1016,1467,813,12663,203
14022,10,317,3052,315,19580,2
32171,0,0,2126,0,5138,0
21456,28,1366,2664,1081,7943,285
8809,5,533,3362,456,24540,77
28172,11,277,2334,238,7197,39
42378,0,64,1378,40,4578,24
30073,18,823,2235,691,14526,132
29292,28,1200,2273,670,7455,530
42228,3,101,1406,81,4211,20
44750,4,84,815,53,2457,31
13542,102,2257,3090,2038,20284,219
33343,0,57,2077,49,2681,8
20295,2,151,2730,130,4390,21
45744,193,2452,478,2407,22581,45
15236,40,2852,2974,1563,42378,1289
40927,4,225,1611,166,6437,59
36803,33,1406,1895,916,13903,490
21528,34,1385,2660,1004,8985,381
20796,7,425,2704,366,5123,59
14989,14,294,2987,274,3552,20
1207,13,419,3899,354,4382,65
26829,3,74,2408,63,2839,11
14786,26,2893,2999,1559,19467,1334
23146,542,10141,2577,6272,51243,3869
45176,2,22,669,17,2684,5
33368,19,425,2076,307,5212,118
24848,123,8974,2497,5943,52829,3031
21054,8,586,2688,458,17275,128
18679,8,508,2810,417,6133,91
36261,516,31459,1925,14313,153279,17146
13358,52,3087,3105,2089,63225,998
21355,15,547,2670,421,15999,126
22094,37,942,2627,752,6009,190
25285,3,176,2479,139,7076,37
26837,5,286,2408,226,3079,60
27481,3,500,2374,379,13351,121
32577,2,46,2108,43,5198,3
35361,26,346,1988,294,4512,52
13290,46,1974,3111,1808,20528,166
36831,51,816,1893,678,16331,138
40962,19,286,1608,219,4733,67
12739,187,14644,3152,8548,79976,6096
19768,0,624,2759,462,12984,162
40964,329,12814,1608,4973,98450,7841
44811,11,133,797,86,3593,47
19883,10,407,2753,325,5023,82
13818,172,12491,3070,8625,142935,3866
32733,0,48,2102,36,2091,12
19078,12,689,2794,600,4339,89
26813,8,219,2409,174,8331,45
29206,11,532,2277,453,4246,79
18690,10,957,2809,409,11200,548
17314,5,220,2871,203,6028,17
22692,0,179,2599,147,4443,32
12404,44,1931,3170,1388,22749,543
18629,5,350,2812,278,4887,72
25533,10,569,2468,386,6969,183
41407,6,183,1548,150,4585,33
41870,21,1040,1472,723,24905,317
17862,6,678,2847,518,8412,160
22646,0,19,2601,18,1701,1
20857,0,372,2701,145,16341,227
11057,5,96821,3241,139,2408,96682
27544,120,4778,2370,3361,35445,1417
28900,11,456,2293,347,6690,109
20275,262,14707,2731,9000,90075,5707
18261,0,185,2828,108,3371,77
37160,7,216,1873,184,5787,32
27911,4,414,2348,218,3798,196
28252,3,134,2329,113,4497,21
26781,27,716,2410,556,8467,160
3487,145,9501,3632,8784,50804,717
42728,50,1635,1305,795,11938,840
23209,0,16,2574,10,3357,6
30048,47,1483,2236,1059,15091,424
15105,8,756,2981,632,16076,124
33466,17,285,2072,162,4321,123
40970,7,185,1608,158,4700,27
15702,10,294,2952,242,10471,52
14023,16,926,3052,878,18885,48
31155,4,257,2179,201,6015,56
17146,3,283,2880,238,4147,45
17113,85,1656,2882,1169,18795,487
20552,28,1739,2718,1243,23084,496
15881,3,229,2946,164,11955,65
40961,30,1023,1608,843,12705,180
32478,13,1182,2113,714,9586,468
28895,6,437,2293,363,9332,74
43406,52,598,1112,438,7845,160
18190,4,77,2831,65,4060,12
27926,41,970,2348,752,9123,218
40875,0,49,1615,33,3640,16
33542,36,1043,2069,696,8216,347
46423,0,20,204,19,1521,1
22831,1,126,2592,101,3368,25
30355,265,19976,2219,8115,69748,11861
38172,29,369,1806,294,5117,75
36366,37,395,1919,331,6091,64
35099,480,10538,2002,7223,52827,3315
39413,415,14970,1724,11017,94672,3953
35464,377,12102,1982,8829,85430,3273
19942,17,688,2750,446,4615,242
10715,240,10516,3259,8973,41718,1543
13262,0,1228,3113,865,15985,363
25645,9,823,2461,671,15281,152
12957,19,86109,3139,793,8627,85316
19801,51,2441,2758,1815,34672,626
37598,5,201,1845,130,4709,71
27470,4,186,2375,160,7425,26
19402,16,952,2778,806,14698,146
35375,18,592,1988,484,11686,108
19133,574,55231,2792,25729,281725,29502
43773,101,1558,992,983,24959,575
30449,1,45,2213,38,2503,7
14828,3,177,2996,170,8811,7
45989,2,15,383,12,1006,3
33472,27,1389,2072,1053,21557,336
41918,16,663,1465,480,10536,183
33604,17,968,2067,765,12907,203
36668,0,49,1903,24,3275,25
27505,3,191,2372,147,4601,44
24427,9,227,2517,168,12336,59
29420,16,827,2266,335,5934,492
29916,287,18145,2241,9267,68066,8878
16340,6,412,2924,340,9097,72
14725,117,3259,3004,2820,25495,439
42065,35,526,1441,408,13273,118
17596,62,5137,2857,3358,46077,1779
10255,16,962,3284,667,14257,295
38543,62,3376,1779,1496,21887,1880
16389,23,807,2920,606,9837,201
25672,3,126,2460,103,3940,23
28763,392,12569,2299,9329,46955,3240
35364,35,383,1988,320,4983,63
15805,0,8025,2948,6240,62145,1785
17351,0,65,2869,45,4184,20
29776,37,894,2248,527,9125,367
9306,8,639,3334,465,4737,174
41312,4,98,1562,71,2226,27
20926,6,277,2695,174,5095,103
41009,15,357,1605,249,5110,108
43032,51,561,1226,424,5669,137
36099,5,88,1934,71,2924,17
20213,49,9913,2735,2381,21098,7532
6018,6,248,3527,164,2675,84
7941,11,528,3423,460,9013,68
19905,60,1962,2752,1609,8916,353
6680,669,78852,3500,54478,204546,24374
19350,2,370,2781,168,5448,202
38350,124,5983,1793,2090,25547,3893
46208,1,47,291,46,912,1
34386,10,733,2040,581,10965,152
8561,27,1267,3378,1260,13361,7
16281,9,343,2927,284,6947,59
27930,2,80,2347,68,2245,12
24441,51,1250,2516,998,13744,252
39637,71,2478,1712,1731,29437,747
43430,18,316,1106,211,8356,105
43044,16,241,1222,186,4781,55
19355,42,6314,2781,4701,73549,1613
37942,6,129,1821,127,5108,2
27329,1126,36608,2384,23394,266010,13214
18074,32,2676,2836,1885,31748,791
16747,196,4974,2903,3626,19755,1348
42695,5,166,1311,127,5021,39
29265,38,795,2275,589,8492,206
17237,427,23261,2874,16477,128328,6784
27745,47,1114,2359,885,13326,229
20344,7,398,2729,317,4852,81
32535,21,589,2110,437,14139,152
32837,20,1468,2097,479,19551,989
36184,4,170,1929,145,9728,25
24838,0,2086,2498,1584,24569,502
43284,26,1261,1151,742,21937,519
36055,118,2876,1937,2125,43101,751
25709,99,3403,2459,2726,38012,677
31972,6,202,2137,154,5394,48
38608,22,749,1774,576,13267,173
20421,0,190,2724,61,2769,129
16458,3,111,2918,94,6095,17
44150,26,341,930,317,9089,24
35163,26,753,1998,630,7615,123
45466,1,21,588,16,1187,5
16584,0,96,2912,77,6589,19
35401,16,932,1986,697,12630,235
41532,10,142,1532,92,5817,50
30260,319,14554,2225,7360,50128,7194
30572,3,132,2206,98,3896,34
17650,12,714,2855,555,7051,159
29136,16,549,2281,411,7716,138
35334,14,347,1989,270,6284,77
23643,24,1037,2552,813,9586,224
43648,122,2666,1032,1556,22020,1110
7344,147,4662,3465,4344,43081,318
31082,170,2859,2183,2200,16576,659
27185,25,332,2392,270,4128,62
43774,0,14,992,10,1672,4
18737,149,8526,2807,6229,70916,2297
19904,4,225,2752,177,3653,48
12246,87,3278,3180,3043,21382,235
46213,1,7,290,7,1201,0
43021,21,323,1229,250,16363,73
11870,8,505,3199,482,15908,23
24467,9,331,2515,271,7577,60
35535,2,90,1976,84,2937,6
19314,18,678,2782,580,25940,98
16725,10,625,2904,445,8288,180
31563,5,390,2157,211,3198,179
17266,4,148,2873,125,2504,23
20132,1,283,2740,218,6447,65
39963,5,201,1691,159,4521,42
23967,1,30,2537,27,2937,3
18148,77,3778,2833,2500,28826,1278
39154,15,434,1740,303,7219,131
16265,8,1483,2927,811,23176,672
29667,3,91,2254,66,3841,25
21833,68,5505,2644,3823,38538,1682
17767,0,108,2851,86,3522,22
37576,2,248,1846,185,9087,63
9252,342,34092,3337,23225,147642,10867
10544,2603,183129,3269,142307,1093825,40822
31834,0,113,2143,77,1740,36
25648,23,687,2461,507,10779,180
44304,7,114,906,110,3922,4
33979,221,3111,2054,2586,18353,525
18694,6,485,2809,383,5046,102
14371,19,638,3028,596,10326,42
44038,9,284,948,175,5013,109
18054,1125,28747,2837,16045,140561,12702
23641,18,484,2553,384,7839,100
24310,65,3843,2522,2493,20397,1350
32693,5,228,2103,182,5046,46
12998,65,1469,3136,1318,31858,151
19779,10,406,2759,309,4216,97
44600,14,122,858,114,7254,8
15384,9,260,2968,203,5393,57
12665,28,615,3156,551,5246,64
28014,7,343,2343,265,6120,78
17501,26,861,2862,636,21455,225
35210,12,324,1996,296,5878,28
35030,71,1578,2006,1127,14434,451
1212,2,38,3899,33,2463,5
26093,11,232,2442,201,4328,31
21575,11,655,2657,507,7460,148
41320,6,122,1561,92,3452,30
42573,133,3193,1338,2005,41575,1188
16779,8,278,2900,211,12078,67
30969,52,5121,2189,3076,38544,2045
43640,1,18,1035,17,1203,1
19469,142,11401,2774,7903,61112,3498
20731,22,1809,2709,752,13388,1057
45375,4,70,611,45,3781,25
36568,129,4232,1910,3268,16160,964
18296,0,47,2826,41,2061,6
44807,77,1086,798,965,14319,121
16955,1,117,2892,90,13604,27
17339,59,1358,2870,989,7509,369
27503,1,77,2372,65,1417,12
18743,1,151,2807,119,3440,32
11875,34,1773,3199,1701,14170,72
32725,103,2146,2102,1799,16461,347
24065,26,1689,2533,890,9206,799
38371,8,186,1792,155,4360,31
32206,2,148,2124,120,4494,28
44714,6,108,827,86,2664,22
36909,19,607,1889,503,13605,104
21416,574,24781,2667,16606,169467,8175
19225,1,49,2788,37,5592,12
40213,19,748,1676,509,13910,239
19792,89,5549,2758,3038,33385,2511
23575,68,1560,2556,1285,9436,275
13672,110,3948,3082,2958,15090,990
13062,24,3913,3133,3208,64344,705
18619,100,8494,2812,5751,39901,2743
29692,69,1718,2253,1252,15882,466
24902,35,1478,2495,1232,20681,246
34171,2,61,2048,45,2340,16
41677,19,1946,1508,1142,18431,804
44123,3,71,934,35,2155,36
33206,6,138,2082,119,3016,19
32284,0,96,2121,86,4695,10
17218,90,3465,2876,2555,40199,910
13526,123,5650,3092,5473,74158,177
13327,56,4447,3108,3887,33310,560
31202,15,404,2177,322,3296,82
17312,6,153,2871,128,4495,25
43527,4,55,1078,40,3801,15
28581,44,1854,2309,1467,34281,387
35826,2,76,1954,65,4398,11
45243,11,121,651,86,1865,35
28280,16,447,2328,340,8301,107
32234,1,23,2122,21,2687,2
37147,130,4793,1874,3790,37550,1003
46338,6,199,248,141,2021,58
16112,6,452,2934,338,5808,114
39052,59,1434,1747,1069,12086,365
31252,8,258,2175,137,3180,121
35263,143,3291,1992,2053,17891,1238
40769,201,6538,1625,3960,41573,2578
36815,5,207,1894,154,4898,53
21763,48,1631,2647,1324,13094,307
12119,6,449,3187,357,4954,92
18926,2,81,2800,64,2515,17
41356,97,2389,1556,1701,25217,688
24371,0,55,2519,49,3130,6
10759,43,820,3256,796,7710,24
41133,2,82,1589,60,4892,22
45194,80,1007,664,904,8463,103
23821,60,2535,2545,1907,30469,628
31603,16,2002,2156,756,20220,1246
12248,696,50370,3180,18351,201543,32019
14384,32,1220,3027,1128,17027,92
34164,508,16188,2048,11353,113815,4835
24346,7,321,2520,228,8973,93
15635,59,4553,2955,2215,27147,2338
9345,13,764,3330,735,12224,29
15998,150,46894,2940,7923,97682,38971
22251,1,74,2620,71,2326,3
35337,1,34,1989,23,2433,11
15438,90,8230,2966,4209,42691,4021
40633,18,316,1638,249,15072,67
13884,460,32316,3064,21325,163828,10991
17959,75,4358,2842,2179,29799,2179
41284,63,2129,1566,1496,22425,633
45102,282,2593,695,2366,25982,227
42097,23,232,1434,179,5392,53
26476,3,305,2424,263,12175,42
18578,3,122,2815,100,6646,22
43031,21,465,1227,377,21091,88
32654,39,508,2105,336,5023,172
43887,44,295,974,257,4959,38
14584,51,2212,3013,2047,13809,165
34355,222,7263,2041,4054,39039,3209
29641,80,3567,2255,2814,36718,753
26389,2830,92897,2428,52835,350027,40062
14318,40,2995,3032,2432,23823,563
30837,47,1440,2193,1144,8471,296
8357,379,200608,3391,12006,128272,188602
43408,5,194,1111,132,4518,62
45594,16,233,548,190,5151,43
25693,13,813,2459,662,6203,151
23797,23,600,2546,467,6341,133
19696,69,2742,2764,1935,18914,807
34017,10,443,2052,362,8461,81
29658,0,10,2254,9,1840,1
44064,17,187,944,158,3689,29
20068,48,1095,2743,806,13574,289
17517,9,1371,2861,606,19514,765
18253,11,293,2828,227,2556,66
4357,31,418634,3607,1162,9243,417472
44069,342,3497,944,2690,20660,807
32025,0,69,2134,48,2438,21
35234,98,5897,1994,3552,31888,2345
37902,11,519,1824,422,4335,97
15180,3,124,2977,123,4756,1
22795,201,5099,2594,3017,29218,2082
1315,7,420,3860,317,16333,103
42716,7,229,1308,178,6230,51
27416,4,108,2378,93,2720,15
33228,208,8033,2082,5553,56667,2480
4025,88,12219,3618,10115,63935,2104
22787,708,41565,2595,26126,251010,15439
36252,28,857,1926,671,7708,186
45424,6,59,598,47,2767,12
13647,3,236,3083,218,4718,18
22945,11,390,2586,323,9453,67
44615,10,171,856,112,7957,59
41383,4,149,1552,114,3964,35
39782,88,1952,1705,1560,21141,392
41574,80,822,1527,595,10357,227
39789,1,18,1704,17,2634,1
20681,15,491,2711,377,4290,114
45224,13,276,655,185,6957,91
14104,11,466,3047,431,7646,35
23709,30,1024,2549,582,9988,442
36638,25,2024,1905,945,12086,1079
42826,87,2103,1281,1494,17706,609
22711,1,85,2598,70,2784,15
25339,24,716,2476,559,4642,157
34233,11,640,2047,387,9860,253
18039,3,215,2837,151,10585,64
23030,21,653,2583,472,6168,181
30779,1,78,2196,53,7788,25
15336,363,17898,2969,12721,85288,5177
5921,90,3523,3531,3514,14178,9
23359,26,2420,2567,1847,14507,573
19087,12,824,2793,526,13197,298
21232,2,114,2675,70,3099,44
33743,22,616,2062,499,5186,117
26382,0,347,2428,280,4612,67
36901,26,781,1889,643,18694,138
22817,10,1106,2593,596,8561,510
36966,266,3875,1885,2729,24336,1146
22248,1,67,2620,42,1773,25
28768,0,36,2299,33,1779,3
44830,98,960,790,912,19615,48
35172,12,715,1998,569,12084,146
42460,5,198,1359,147,8111,51
19011,29,1292,2797,942,16550,350
18855,15,1289,2802,596,9460,693
40563,150,3437,1643,2636,19655,801
6249,313,22204,3519,20753,102063,1451
45417,15,111,599,105,4579,6
45736,17,101,479,96,3144,5
42686,4,269,1313,201,8594,68
10291,87,2546,3282,2352,24517,194
35473,3,83,1981,70,4090,13
20238,6,237,2733,199,11534,38
24167,0,40,2528,36,2734,4
18817,8,367,2804,270,15156,97
44795,33,590,802,505,3904,85
33558,2,45,2069,31,3112,14
35411,3,89,1986,77,7370,12
24105,40,2799,2531,1936,16925,863
8962,311,16365,3354,14251,99091,2114
32676,78,1605,2104,1039,14740,566
5521,304,25059,3552,12025,104247,13034
28118,8,395,2338,307,5550,88
46179,20,130,300,129,2487,1
46293,14,223,267,196,6025,27
29477,2,90,2263,81,3024,9
34421,0,118,2038,93,6047,25
18811,8,334,2804,157,2254,177
32233,11,531,2122,411,6106,120
39617,8,439,1713,281,6211,158
12697,2,259,3155,235,4674,24
18065,210,11104,2836,6982,38099,4122
8098,41,2483,3407,2226,9588,257
16805,11,370,2899,225,6259,145
32077,1,103,2131,55,2680,48
46169,25,259,304,209,4475,50
12773,2,126,3150,121,2403,5
28751,9,447,2300,121,4437,326
41154,46,5240,1587,902,25024,4338
17151,1,259,2879,206,9603,53
30446,37,1754,2213,1234,19166,520
14272,11,261,3037,224,5063,37
40051,26,914,1685,681,9266,233
13766,13,617,3073,595,4859,22
12339,100,17411,3175,3921,44142,13490
29578,117,7276,2258,5014,46368,2262
45895,235,3469,426,3370,19270,99
37667,5,104,1842,97,6924,7
32240,26,518,2122,423,9168,95
28211,1,26,2331,22,4453,4
40473,138,4328,1652,2213,23201,2115
31595,119,2475,2156,1879,14607,596
39951,8,151,1692,119,6075,32
19201,164,12122,2789,9315,76877,2807
41215,30,535,1579,422,10008,113
8523,111,3392,3380,2726,10850,666
42672,0,174,1317,130,8089,44
26452,7,393,2425,295,9901,98
29523,213,5954,2261,3230,25312,2724
16107,12,998,2934,740,8306,258
30992,5,267,2188,197,3666,70
38462,18,700,1785,546,7298,154
37606,4,106,1845,85,6123,21
33239,3,365,2081,307,9041,58
17187,0,75,2878,50,2433,25
39137,11,375,1742,237,4029,138
22187,72,3995,2624,2732,24391,1263
36789,1,42,1896,36,2120,6
18882,3,214,2801,158,2854,56
15033,0,916,2985,737,4339,179
44986,81,1317,746,871,12844,446
45489,12,154,582,137,4128,17
32042,44,1867,2133,1190,21269,677
19473,206,7996,2774,5208,28193,2788
38117,20,272,1809,225,5102,47
10679,14,506,3261,505,8736,1
43007,11,433,1232,296,10566,137
14629,15,1930,3010,757,13627,1173
11780,115,4800,3202,4266,28782,534
15981,56,1975,2941,1575,12281,400
14173,24,671,3044,626,6131,45
30005,30,1316,2238,870,13858,446
12069,170,9816,3190,8753,77404,1063
33691,15,541,2064,433,19160,108
43136,71,1432,1194,569,21832,863
27939,2,81,2347,74,7817,7
45473,1,26,587,21,1532,5
21026,95,6473,2689,4668,43784,1805
19167,12,596,2790,455,6689,141
44717,9,180,826,145,2561,35
16190,11,313,2931,247,4235,66
29589,546,11848,2258,9598,61316,2250
27491,6,199,2373,155,6188,44
39292,29,961,1731,711,11884,250
35887,19,363,1949,261,8587,102
8910,33,1029,3357,1012,7294,17
18108,1,213,2835,122,3680,91
45711,78,817,491,789,15753,28
17228,13,409,2875,357,11532,52
15661,0,44,2954,41,1873,3
40624,6,81,1638,70,1238,11
35487,432,10396,1980,7135,63944,3261
42238,14,232,1403,176,8589,56
35681,1,92,1964,62,5660,30
16146,45,1690,2932,1242,19037,448
28455,3,59,2318,53,3044,6
40086,0,621,1683,426,11252,195
41652,165,5514,1512,3873,45950,1641
39358,1,86,1728,65,6359,21
33959,1,185,2055,172,22329,13
22549,46,528,2605,408,5558,120
33637,60,1237,2066,1036,9627,201
20426,569,21850,2724,15342,68490,6508
18047,6,342,2837,292,7184,50
31251,4,566,2175,319,9081,247
14768,20,854,3000,608,7916,246
24934,40,1862,2493,967,20603,895
33376,54,3582,2076,2683,40824,899
24184,5,87,2528,70,3522,17
13225,6,94,3115,79,2273,15
46364,2,73,237,64,2150,9
45698,52,422,501,404,6384,18
26159,0,47,2439,40,2161,7
26074,4,281,2443,238,6383,43
44314,74,1250,903,894,12682,356
33210,38,3653,2082,1182,14829,2471
42454,28,1033,1361,687,16669,346
36182,3,126,1929,110,4456,16
38366,66,3930,1792,1596,20089,2334
3385,59,3424,3634,3207,13663,217
24607,5,532,2507,391,5750,141
41326,72,3013,1560,2240,39743,773
17717,18,1233,2853,919,8272,314
36030,6,294,1939,233,10106,61
24334,0,2524,2521,2054,29554,470
1114,14,572,3932,460,7951,112
34059,2,88,2051,62,2699,26
23783,1393,86432,2547,40095,201263,46337
41982,8,325,1455,246,11293,79
27804,10,360,2354,252,3093,108
25135,44,1003,2484,733,14330,270
22563,10,404,2605,259,8007,145
10170,91,7483,3288,7111,75466,372
32331,3,41,2118,33,3725,8
20454,66,4017,2723,1973,29870,2044
46014,9,349,369,274,3083,75
8298,993,87443,3395,42015,164394,45428
36508,4,137,1912,97,6799,40
38663,3,76,1771,72,5013,4
45193,22,124,664,112,3708,12
16360,1322,144057,2922,56294,331410,87763
14643,175,9177,3009,4856,50140,4321
17799,5,272,2850,206,5435,66
28318,71,5089,2326,3786,28245,1303
27428,40,1470,2378,908,13256,562
35505,12,599,1979,294,12098,305
33184,11,179,2083,146,6254,33
29285,3,319,2273,196,6641,123
25312,66,2188,2477,1685,17838,503
39299,58,1662,1730,1197,18838,465
39879,6,89,1697,73,2668,16
17479,385,30802,2863,17152,142799,13650
29845,10,862,2246,608,9747,254
17476,7,446,2863,377,6247,69
42633,25,434,1327,324,11929,110
12090,173,11401,3189,9615,92573,1786
38121,44,2759,1809,1841,38158,918
14457,5,31995,3022,272,8614,31723
45108,11,238,693,100,5477,138
42773,40,508,1293,426,5973,82
42121,123,3909,1431,915,56706,2994
21966,159,4925,2635,3669,17927,1256
33674,169,7957,2065,5993,65016,1964
31853,14,247,2142,196,3717,51
35718,0,53,1961,50,5400,3
28734,28,1662,2301,1250,29487,412
28134,78,3906,2337,1828,22896,2078
40666,44,1932,1635,865,16825,1067
24465,58,1410,2515,1105,13158,305
34812,33,736,2016,340,5577,396
42535,23,627,1345,415,7406,212
29398,32,1940,2267,1117,14541,823
17055,1,178,2885,141,33012,37
32214,1,63,2124,54,5300,9
41123,10,163,1590,132,4526,31
42739,24,324,1300,253,5823,71
44659,212,1958,847,1569,15078,389
26901,1,80,2405,71,2650,9
21183,18,479,2679,405,9877,74
25318,50,2047,2477,1524,29066,523
20062,0,728,2744,577,8662,151
14899,30,1355,2993,810,16913,545
14172,23,1561,3044,1322,18714,239
27485,600,23018,2374,16841,147670,6177
16342,1,77,2923,63,5899,14
13642,20,2669,3084,2247,15384,422
31295,8,191,2172,162,3772,29
31464,644,13556,2163,10219,50766,3337
41609,241,5430,1519,3837,60117,1593
8499,230,15577,3382,14333,160654,1244
30302,43,1303,2222,899,7422,404
8944,32,1197,3355,1196,8812,1
14937,12,541,2990,420,5909,121
21585,7,256,2657,212,4503,44
33881,31,999,2057,782,9437,217
42793,81,1109,1286,651,15979,458
45219,12,112,656,93,2941,19
25999,5,368,2446,316,14134,52
45230,200,2125,654,1873,32988,252
20831,47,4224,2702,2562,40046,1662
37930,75,2724,1822,2071,19804,653
14120,6,1153,3046,548,20655,605
32760,89,5253,2101,3209,29188,2044
28521,145,2016,2313,1478,11129,538
29720,2,251,2251,197,5093,54
13730,43,1283,3076,1163,12998,120
18672,0,28,2810,23,2134,5
16464,0,134,2917,104,5563,30
37461,3,129,1855,110,6573,19
21475,462,44771,2663,22645,193069,22126
32450,220,5746,2114,3809,39467,1937
5108,32,3135,3574,3120,22249,15
45218,39,781,656,473,7923,308
33110,81,2769,2086,1590,15146,1179
33445,0,94,2073,61,2327,33
26363,12,558,2429,449,7039,109
35822,3,291,1954,216,4188,75
32801,1,115,2099,98,5309,17
20595,10,363,2716,296,14261,67
18839,55,7255,2803,5491,28350,1764
39443,40,867,1723,686,12760,181
24721,25,1871,2502,1518,25623,353
26545,6,314,2421,236,5830,78
44971,2,68,750,37,2371,31
35747,0,110,1960,89,4651,21
23629,9,405,2553,310,4205,95
43045,27,346,1221,291,11483,55
33707,9,182,2064,151,3346,31
36435,109,4414,1917,2330,44718,2084
34227,1,162,2047,119,4569,43
21500,28,2092,2662,1011,19158,1081
31343,6,153,2170,129,7802,24
19179,24,1820,2790,1429,21546,391
19773,9,686,2759,565,9305,121
33980,41,998,2054,845,12590,153
27723,9,247,2360,200,2770,47
24986,5,236,2491,183,6787,53
20078,13,290,2742,244,3929,46
30078,2,168,2234,92,6442,76
26480,7,829,2424,588,11068,241
25424,11,553,2473,442,8730,111
37057,20,534,1879,373,10298,161
41919,1,91,1465,70,4745,21
32767,1,46,2100,36,1915,10
38973,3,69,1752,53,2681,16
14273,23,1349,3037,1195,15957,154
26749,5,264,2412,222,7611,42
38514,41,662,1782,538,7299,124
16718,63,2621,2905,2022,19118,599
34753,206,3433,2021,2598,19092,835
28770,1,71,2299,60,4507,11
29690,42,4440,2253,1914,30557,2526
26070,26,1246,2443,657,8312,589
46444,16,345,191,199,7685,146
8766,354,12363,3365,8105,64002,4258
14546,51,857,3016,721,19253,136
38622,40,3330,1773,1458,21865,1872
37798,107,12183,1832,3095,54134,9088
28253,5,520,2329,406,9354,114
32710,200,3866,2103,2605,36498,1261
33020,4,135,2089,109,2894,26
26011,30,1007,2445,780,16460,227
4768,372,29780,3591,27236,160141,2544
24292,10,240,2523,188,2793,52
36331,38,1341,1921,1055,13541,286
31771,21,396,2147,328,26252,68
20538,6,459,2719,342,8070,117
43219,110,2497,1171,1274,25071,1223
39795,91,1807,1703,1319,19839,488
37153,119,2988,1874,2448,24710,540
41503,35,1054,1534,784,21590,270
30311,14,473,2221,403,4008,70
16773,49,1932,2901,1442,16103,490
35118,972,48531,2001,15034,205971,33497
42186,8,572,1415,372,11530,200
20758,9,361,2707,291,5911,70
2194,98,2322,3654,2053,13129,269
16409,34,585,2919,474,3290,111
16959,0,885,2891,687,6230,198
41271,123,1450,1568,1020,14186,430
11043,41,1158,3242,1098,16743,60
29833,10,297,2246,148,8197,149
32277,1001,48956,2121,21836,160713,27120
4517,19,732,3601,588,25362,144
31760,77,1250,2147,912,8076,338
42327,2,152,1388,65,4813,87
43549,276,7172,1069,5339,75207,1833
30599,146,7248,2205,3363,49579,3885
18435,8,663,2820,406,5030,257
13016,34,1641,3135,1577,11234,64
45426,22,294,597,185,7509,109
15030,111,12931,2985,4457,64392,8474
22361,8,166,2616,128,2566,38
37681,4,111,1841,67,5460,44
43531,63,1107,1076,911,23006,196
22253,21,719,2620,564,14438,155
26218,152,3883,2436,2885,21705,998
40530,257,9286,1647,4891,58368,4395
40008,36,828,1688,667,7060,161
2578,128,9863,3648,8877,37329,986
32458,22,607,2113,483,10010,124
23208,7800,351925,2574,171518,940207,180407
32020,8,403,2134,311,12041,92
23405,8,173,2564,149,2451,24
37675,6,285,1841,237,9285,48
33946,37,559,2055,425,6694,134
43192,14,142,1180,109,2566,33
28675,17,1077,2304,804,11917,273
35986,18,574,1942,484,11244,90
42694,43,680,1312,528,16875,152
21783,2,368,2646,279,6639,89
25290,19,587,2478,450,5328,137
41252,6,134,1571,113,6715,21
23391,1,98,2565,87,3641,11
28935,6,145,2291,123,2508,22
12552,26,941,3163,923,13075,18
10236,98,4983,3284,4820,51993,163
5696,5,480,3542,442,3435,38
40761,209,4644,1626,2915,54229,1729
2987,95,7232,3641,6755,27598,477
40885,2,59,1614,42,3254,17
29228,4,144,2276,117,3450,27
37144,141,4724,1874,3482,37524,1242
33400,6,141,2075,126,4942,15
39776,55,1067,1705,916,21879,151
46433,11,250,197,217,7898,33
17553,264,31731,2859,17862,122394,13869
45654,24,355,519,225,9574,130
14174,46,4482,3044,3252,22504,1230
19060,189,6844,2795,5108,33303,1736
23417,1,256,2563,200,7377,56
26472,76,1981,2424,1587,12185,394
32221,11,1009,2123,589,11682,420
15474,88,3679,2964,2626,24664,1053
33660,3,226,2065,193,6772,33
31383,27,835,2168,612,7698,223
41832,179,2936,1478,2088,19392,848
27039,63,1485,2400,932,10688,553
35677,11,431,1964,261,8015,170
36358,13,547,1920,438,9131,109
27144,74,1772,2395,1324,18265,448
25785,5,268,2456,201,2599,67
13841,2020,72929,3068,48031,248337,24898
22545,2,167,2606,133,6043,34
25310,1,151,2478,76,2683,75
13208,685,34942,3116,30491,353787,4451
14862,26,803,2995,802,8717,1
30132,300,30653,2232,8873,85109,21780
30336,63,2059,2220,1532,21981,527
15751,8,342,2950,278,5141,64
20395,18,923,2726,732,9419,191
37989,37,2440,1818,1138,14743,1302
34453,1,44,2037,36,4047,8
19971,0,94,2748,79,3645,15
27380,1,190,2380,151,4791,39
16243,6,221,2928,196,11888,25
11239,22,981,3230,957,15504,24
33143,12,583,2084,242,12181,341
45872,21,365,435,189,5728,176
42939,15,543,1251,397,8089,146
21583,11,454,2657,349,5316,105
29201,5,193,2278,160,6242,33
41432,4,165,1544,113,4839,52
10943,20,1319,3247,1201,16809,118
45918,143,1744,416,1622,10308,122
36228,3,141,1927,108,2733,33
26029,28,1326,2444,485,7735,841
35320,40,625,1990,480,9110,145
36710,1,55,1901,49,2709,6
27687,38,1229,2362,983,7916,246
30072,7,1234,2235,616,9129,618
31710,18,309,2149,257,4263,52
18837,4,336,2803,258,5252,78
31079,12,236,2183,200,5431,36
20373,77,3939,2727,3025,19178,914
36569,1,29,1910,24,4496,5
22135,1167,47424,2626,28373,215161,19051
18994,7,271,2797,156,2630,115
31219,3,209,2176,118,3429,91
46045,38,532,354,404,8372,128
38990,12,349,1751,236,8463,113
35952,41,513,1945,422,5641,91
30037,38,764,2236,609,6287,155
41039,246,6351,1602,4678,56878,1673
13237,422,15041,3114,10436,93458,4605
31743,1,63,2148,30,2472,33
25859,23,505,2453,318,4643,187
29365,3,170,2268,135,4618,35
12251,53,1504,3179,1491,9607,13
25568,60,1874,2466,1363,14516,511
30127,6,99,2232,96,1800,3
13121,36,1154,3128,1011,14218,143
28191,0,182,2333,103,1960,79
30258,61,1540,2225,1301,32215,239
20636,117,4323,2714,2761,19425,1562
41807,139,3262,1484,2278,38008,984
36746,5,140,1899,113,4452,27
46058,3,20,348,13,1217,7
15374,21,2584,2968,1972,12755,612
31388,1,124,2167,96,5093,28
20457,49,3356,2723,2382,23223,974
13952,137,5120,3058,3905,37447,1215
14521,138,5532,3017,4035,41883,1497
16624,0,134,2910,93,6614,41
43883,54,421,975,368,7464,53
35307,5,93,1990,83,2303,10
34983,4,63,2008,55,2457,8
43048,72,777,1221,674,15371,103
45286,20,154,634,150,8434,4
4135,393,18312,3615,18067,84189,245
25389,189,7612,2474,5940,81179,1672
42530,48,1131,1346,812,19350,319
23314,68,1706,2569,1044,14545,662
18294,214,20427,2826,9753,89477,10674
26891,6,557,2405,489,6822,68
39475,0,24,1721,18,4551,6
20208,13,745,2735,412,9576,333
39129,14,592,1742,454,9711,138
4191,891,44187,3613,36830,129815,7357
21681,13,362,2651,308,2177,54
29835,130,6067,2246,4892,47932,1175
18647,63,1638,2811,1158,13520,480
19398,8,388,2778,196,17647,192
41781,31,695,1490,366,12545,329
29417,1,95,2266,75,2108,20
40571,3,112,1642,74,1415,38
41443,72,986,1543,799,10196,187
38439,24,501,1787,314,3929,187
37472,28,1342,1854,880,25831,462
34619,41,829,2028,666,5850,163
18916,1,130,2800,110,2476,20
28083,74,2589,2339,1948,36313,641
31583,25,472,2156,404,3930,68
30801,1,209,2195,74,4923,135
43154,6,232,1189,159,2756,73
29015,17,535,2287,481,11365,54
21118,0,58,2685,53,3506,5
44739,8,121,820,96,2308,25
33723,1,207,2063,129,3491,78
34727,1,76,2023,64,2610,12
43287,288,5222,1150,4223,42345,999
30391,7,290,2216,209,12402,81
36735,2,41,1900,33,2825,8
18687,21,2254,2809,915,22918,1339
2466,138,5588,3650,4180,35788,1408
11217,11,663,3232,493,10263,170
36700,5,106,1902,93,2610,13
40209,78,1259,1676,890,17827,369
24009,4,218,2535,187,8195,31
43487,147,2396,1092,1578,48228,818
23722,1,69,2549,66,2503,3
27725,1,126,2360,109,4408,17
22152,59,4154,2625,2857,49128,1297
14063,5,382,3049,285,8960,97
23388,81,3758,2565,2960,24044,798
11544,116,13423,3214,7858,64312,5565
39002,22,580,1750,512,10788,68
13533,27,1140,3091,938,23571,202
31948,1,101,2138,87,3542,14
19912,0,57,2752,46,2185,11
21185,5,262,2679,200,6877,62
35753,103,4111,1960,1636,38691,2475
17641,10,3014,2855,1970,35514,1044
38631,4,165,1772,114,6034,51
29537,5,584,2260,338,13477,246
34928,78,3918,2010,1745,62880,2173
29610,3,58,2257,52,6140,6
22262,82,3622,2620,2687,43478,935
14685,0,0,3007,0,6244,0
42920,4,28,1257,25,3995,3
38960,13,335,1752,248,6850,87
42453,118,2527,1361,1578,33556,949
6855,1394,72452,3492,53345,424750,19107
36637,44,1413,1905,1166,12611,247
30059,26,2642,2235,1504,24104,1138
36708,13,196,1902,127,2872,69
30708,25,949,2199,743,15589,206
32031,10,563,2134,458,7868,105
25323,9,203,2477,142,4156,61
16381,15,1040,2921,832,9372,208
42533,261,6558,1345,4854,51241,1704
36963,319,9571,1885,6874,87382,2697
46264,37,319,279,302,4190,17
28429,8,2439,2319,738,13654,1701
45458,0,15,590,14,1768,1
21191,2,95,2679,77,2704,18
33232,3,148,2082,95,3177,53
36839,3,230,1892,73,6109,157
8062,11,1555,3409,1430,11394,125
19931,16,656,2751,385,9587,271
23860,15,1272,2543,788,12174,484
19708,8,467,2763,269,12729,198
39546,0,42,1717,36,3153,6
29170,6,198,2279,152,4854,46
9858,633,47860,3302,21850,168166,26010
30075,0,175,2234,140,4022,35
31130,67,2070,2181,1598,18104,472
31421,9,573,2166,436,8139,137
22342,72,3013,2616,2253,34730,760
41684,0,39,1507,28,2393,11
44635,0,12,854,8,1669,4
25662,5,556,2461,412,11170,144
26116,88,6286,2441,4489,36485,1797
43486,2,65,1092,51,2244,14
43224,430,8984,1170,6968,52209,2016
20313,9,913,2730,526,8100,387
31773,1511,57849,2146,31711,237190,26138
17649,3,129,2855,108,3850,21
20860,5,202,2700,158,3295,44
37842,1160,31112,1828,14996,160099,16116
16950,316,19721,2892,7846,46404,11875
9288,15,593,3335,590,6216,3
25705,20,2570,2459,459,9611,2111
30375,4,257,2217,197,6778,60
27843,13,675,2353,538,5659,137
20123,26,1525,2740,1270,28434,255
22136,229,5268,2626,3406,25691,1862
15975,4,225,2942,186,5700,39
12467,33,3027,3167,1945,13549,1082
44878,45,561,776,494,7863,67
29346,1,63,2269,38,2606,25
41559,63,1470,1528,1022,23541,448
39447,0,0,1723,0,3802,0
45699,33,373,501,261,6586,112
18285,96,4912,2827,3609,20454,1303
26582,11,663,2420,527,7675,136
34607,63,1859,2029,1082,12326,777
32636,34,1601,2106,951,17701,650
20381,29,1301,2727,1004,15634,297
21754,12,1825,2648,913,16159,912
15579,343,19945,2958,12980,85604,6965
37129,2,103,1875,88,8783,15
12015,14,751,3192,665,9356,86
46255,3,74,281,55,1528,19
43279,46,637,1153,468,17504,169
16462,10,667,2917,348,14159,319
41545,31,649,1529,530,11161,119
35562,0,63,1975,52,3989,11
17397,12,1073,2866,791,7192,282
23181,334,14891,2576,9653,46713,5238
39991,2,96,1689,72,3963,24
15563,39,2735,2959,1983,8167,752
21340,11,633,2671,508,7015,125
29562,22,1223,2259,466,7750,757
36384,69,2339,1919,986,12699,1353
31161,0,37,2179,33,2176,4
3127,48,1761,3639,1597,13344,164
35112,13,120,2001,108,2810,12
3396,14,998,3633,937,10892,61
43447,9,287,1102,223,9701,64
23636,21,1682,2553,1097,27532,585
44733,13,343,822,177,6390,166
29946,2,138,2240,114,1666,24
33014,0,31,2090,26,1816,5
16220,105,8562,2930,3395,50080,5167
34680,24,427,2025,328,4072,99
31804,139,3226,2145,2296,22475,930
39218,96,3902,1736,3118,23225,784
32112,21,506,2129,341,12637,165
39978,15,619,1690,476,12162,143
27450,23,528,2376,432,12738,96
38479,6,224,1785,180,8579,44
41036,7,250,1603,205,6025,45
35520,4,158,1978,128,7147,30
46192,90,1797,296,876,17326,921
27275,130,6495,2387,3658,69080,2837
26535,111,3780,2421,3093,20204,687
41340,23,548,1558,366,7660,182
31622,12,368,2154,233,4906,135
13664,41,1072,3082,825,10302,247
16418,54,3236,2919,2338,21185,898
46121,5,48,328,29,1373,19
15215,6,214,2975,181,5292,33
27426,2,57,2378,51,2205,6
38559,7,390,1778,245,14080,145
41965,53,1559,1457,1083,40197,476
37800,1,42,1831,36,3524,6
21369,0,58,2669,40,2118,18
33305,13,1286,2079,643,7869,643
14582,62,4586,3013,2040,25562,2546
41364,19,507,1555,399,16262,108
45350,8,139,618,80,4036,59
10701,85,2745,3260,2070,13465,675
34942,1,219,2010,163,3721,56
39671,23,203,1710,149,3378,54
19747,8,363,2761,296,15295,67
36174,9,344,1929,280,5233,64
44862,201,2428,779,1925,17271,503
37774,17,516,1833,398,7424,118
25668,11,488,2460,396,5829,92
36457,20,550,1916,383,13495,167
30684,1,93,2200,80,2803,13
20959,0,113,2694,108,2756,5
29902,18,939,2242,541,7317,398
25380,28,811,2474,650,7052,161
13002,131,4734,3136,4466,42292,268
35190,2,133,1997,100,11510,33
36732,0,32,1901,28,2705,4
21800,20,918,2645,322,2329,596
30158,4,133,2231,125,8635,8
34342,1,24,2042,20,4620,4
41440,12,716,1543,491,14055,225
6077,73,8866,3525,8622,34079,244
34939,99,1459,2010,1146,9737,313
38727,12,483,1767,233,10340,250
15337,1,200,2969,147,10933,53
16487,4,73,2916,60,7096,13
12516,3,114,3164,106,1529,8
38155,23,287,1807,239,3809,48
16875,50,3234,2896,2454,21662,780
45261,19,116,581,104,2469,12
19633,10,631,2768,484,10163,147
19597,1,262,2769,200,6591,62
26328,86,8021,2432,2560,21548,5461
19683,30,1573,2765,1092,13136,481
35402,10,564,1986,425,5026,139
29288,25,603,2273,348,4722,255
37841,2,191,1828,100,4595,91
38620,3,166,1773,140,6679,26
36107,31,637,1933,509,6262,128
20500,9,427,2721,328,4385,99
13694,106,9726,3080,5680,77041,4046
37022,7,240,1882,204,10171,36
45409,8,61,601,53,2290,8
15436,66,4363,2966,3358,39572,1005
16132,7,412,2933,336,3305,76
19073,1,262,2794,205,6648,57
32651,104,3587,2105,1591,17516,1996
27370,8,282,2381,236,4695,46
20433,16,660,2724,439,7685,221
14810,103,2988,2997,2487,14521,501
13935,185,7392,3059,5772,31107,1620
39238,81,2037,1734,1307,19398,730
32567,13,649,2108,415,11577,234
41521,2,37,1533,31,1494,6
38284,171,8833,1798,4364,72595,4469
21886,5,166,2640,130,4977,36
32587,6,158,2108,133,3822,25
42723,254,11022,1306,4989,65718,6033
25926,58,3229,2449,1401,33205,1828
27365,22,1267,2381,668,7941,599
21097,12,579,2686,467,9308,112
33628,29,504,2067,410,3306,94
24605,67,2432,2507,1516,21675,916
37931,8,533,1822,267,7037,266
41182,32,1282,1583,709,7194,573
42298,7,165,1393,122,3756,43
37565,14,311,1847,205,4311,106
28950,22,1143,2291,596,6080,547
26265,1,111,2434,93,9155,18
17345,1448,51309,2869,39466,140923,11843
42837,23,1457,1277,626,11749,831
45562,5,72,556,41,2769,31
45866,14,111,439,76,3878,35
16991,3,346,2890,265,6757,81
36503,33,891,1913,775,6763,116
20717,47,1704,2709,1137,10735,567
9258,137,8750,3337,8389,40757,361
20165,43,2897,2738,2262,21957,635
23304,35,1757,2569,1335,22241,422
19541,3,178,2772,148,4785,30
35019,17,1285,2006,953,15544,332
17199,13,908,2877,736,11814,172
43036,11,203,1224,173,2304,30
28296,7,394,2327,289,5186,105
16323,898,74923,2924,41537,249368,33386
35521,15,847,1978,661,13688,186
36796,19,391,1896,318,5124,73
21512,44,7347,2661,2636,24659,4711
24514,2,199,2513,160,4775,39
21073,3,396,2687,276,5044,120
45483,308,7257,584,5531,69343,1726
43556,31,1058,1066,623,21904,435
14382,53,3652,3027,2174,41114,1478
13791,15,336,3072,276,5848,60
40731,328,5442,1630,4159,40805,1283
36268,19,833,1924,574,13681,259
40632,0,125,1638,85,2312,40
6448,146,7820,3511,7699,21009,121
21388,195,10076,2668,4713,52391,5363
34996,62,4905,2007,2599,34705,2306
38802,1,73,1762,56,2516,17
16975,418,24262,2891,17338,154855,6924
39465,0,66,1722,34,3804,32
31965,5,236,2137,198,11447,38
17257,15,1211,2873,608,13397,603
25762,7,413,2457,284,7328,129
12691,14,1473,3155,773,13311,700
39919,36,1320,1694,824,20343,496
30296,2,287,2223,223,5526,64
20868,18,712,2700,544,8665,168
14904,33,864,2992,614,7907,250
38527,19,1344,1781,1028,12718,316
34791,27,482,2018,368,3790,114
13964,17,2371,3056,1103,15097,1268
12520,2,278,3164,254,3654,24
21217,39,1831,2676,1438,12936,393
25364,77,5352,2475,2374,34803,2978
12715,61,1871,3154,1361,26963,510
23710,21,640,2549,518,9821,122
25061,6,171,2488,140,2624,31
18842,10,357,2803,274,5390,83
13985,129,8855,3055,5584,160616,3271
34193,29,998,2048,783,8306,215
32439,6,349,2114,262,7299,87
25765,12,224,2456,146,3228,78
37226,37,1932,1869,1344,27965,588
36291,13,333,1923,262,7003,71
20224,84,3351,2734,2716,24492,635
23993,5,428,2536,261,8230,167
10129,29,1393,3289,1188,12170,205
29912,41,4122,2241,3291,25176,831
16316,687,29241,2925,10203,131425,19038
45712,28,350,490,278,9240,72
18222,7,292,2830,231,6221,61
19866,16,298,2754,243,3178,55
24806,51,1476,2500,1162,13086,314
33101,21,804,2086,629,9286,175
43429,40,428,1106,373,10647,55
45611,18,577,544,168,4895,409
31869,0,0,2142,0,10014,0
36509,12,139,1912,123,6320,16
36096,3,81,1934,76,3966,5
39944,1,75,1692,61,2730,14
30658,12,430,2201,281,9081,149
42971,10,217,1244,173,2803,44
24448,895,41245,2516,24044,114394,17201
21345,18,726,2671,600,4148,126
28995,1,54,2288,49,3576,5
20291,13,358,2730,279,8907,79
20558,13,609,2718,491,14372,118
42134,29,376,1428,262,7254,114
27885,22,1308,2351,634,16545,674
39106,26,916,1743,638,17390,278
39017,42,5409,1749,1338,25737,4071
39245,15,1017,1733,645,19664,372
42481,4,197,1355,140,9012,57
32512,304,11904,2111,7039,83722,4865
11423,6,537,3222,525,8884,12
18541,17,601,2816,466,13220,135
17902,30,1686,2846,1453,19535,233
29694,13,514,2252,407,6548,107
33028,4,166,2089,143,5121,23
26718,0,103,2413,72,3304,31
45222,0,12,655,11,1005,1
23690,55,1067,2550,826,8380,241
16481,6,420,2917,306,4246,114
16189,3,127,2931,87,3359,40
28901,3,185,2293,145,3777,40
37359,0,0,1861,0,5650,0
12138,65,1477,3185,1203,10308,274
29605,2,137,2257,120,3308,17
24454,3,82,2516,69,2174,13
19172,1281,119335,2790,50647,433494,68688
32768,16,1229,2100,871,13283,358
40265,10,253,1671,193,5927,60
17784,1734,170777,2851,77526,540583,93251
27090,2,46,2398,40,1891,6
40814,52,1529,1621,1218,20037,311
38408,10,255,1789,181,5712,74
20040,22,915,2744,612,5073,303
13885,41,3624,3064,2352,29657,1272
26793,11,307,2410,259,11226,48
42504,93,2057,1350,1480,19218,577
42698,7,206,1311,128,8841,78
18948,5,169,2799,132,2711,37
29083,20,532,2283,240,5449,292
24646,929,54912,2505,35425,165284,19487
28669,4,204,2305,188,7130,16
43427,12,124,1107,77,2391,47
38334,19,563,1795,451,7282,112
43086,1,38,1208,30,2265,8
39755,8,290,1706,132,5023,158
36731,10,643,1901,401,6946,242
26166,0,40,2439,37,2385,3
19340,24,1310,2781,1025,18335,285
42130,14,689,1429,502,18273,187
15494,108,7659,2963,4327,39141,3332
38504,36,965,1783,740,26600,225
33170,117,4328,2083,3326,42838,1002
19337,21,712,2782,447,5806,265
45831,78,464,448,427,9385,37
21008,267,6203,2690,4585,30657,1618
12327,4,117,3176,97,6016,20
38291,96,3391,1798,2468,38698,923
30682,24,823,2200,694,9329,129
40579,525,15746,1642,9357,93120,6389
26200,794,39905,2437,25170,131483,14735
25040,219,6236,2489,4348,24583,1888
28002,4,58,2343,53,2358,5
43018,192,3367,1230,2615,46632,752
32931,4,97,2093,69,3089,28
17704,18,529,2853,368,5778,161
30783,28,521,2196,424,6134,97
19977,3,96,2747,85,5506,11
35587,73,797,1972,638,7586,159
40239,6,172,1674,143,7716,29
8757,80,86917,3365,31554,16998,55363
37132,75,1488,1875,1084,45406,404
34715,1,62,2023,36,4247,26
13256,3,503,3113,469,5834,34
4893,79,2868,3585,2812,12512,56
43934,9,106,965,100,3405,6
21526,156,7674,2660,5526,41915,2148
42374,39,646,1379,510,10103,136
16051,11,359,2937,265,5942,94
35851,36,511,1952,348,8098,163
44229,47,381,915,348,6071,33
19364,9,376,2780,300,13385,76
18888,2,125,2801,83,1546,42
41361,10,275,1555,206,5348,69
43526,6,146,1078,88,3856,58
16285,54,3432,2926,2638,26787,794
37330,3,197,1863,160,3747,37
40212,4,155,1676,100,3821,55
46210,1,38,291,27,1415,11
36198,22,921,1928,700,10854,221
28973,151,4344,2289,3284,45682,1060
39363,2,208,1727,170,7291,38
38665,6,256,1771,212,3325,44
32074,1,110,2131,69,2751,41
20307,1,31,2730,21,5002,10
35262,25,380,1992,313,7068,67
34700,10,355,2023,290,9025,65
36344,0,5,1920,4,3382,1
26339,35,693,2431,542,12877,151
38390,10,488,1790,329,8084,159
22179,3,177,2624,144,7245,33
20411,3,194,2725,95,5651,99
17832,1,71,2848,47,3355,24
39110,0,25,1743,21,2601,4
40540,7,157,1646,114,6966,43
30208,38,742,2227,636,6859,106
32348,0,41,2117,33,2477,8
40700,1,52,1632,41,3249,11
18158,57,2534,2833,1304,19757,1230
37693,8,269,1840,177,10713,92
19017,33,1544,2796,1255,18227,289
22072,12,459,2629,317,12194,142
14825,6,109,2996,103,3232,6
40602,2,174,1640,79,9127,95
35151,2,202,1999,44,3802,158
39685,5,114,1709,93,6257,21
30025,1,242,2237,68,10059,174
16679,534,58286,2907,33943,251769,24343
36004,121,4797,1941,1724,22988,3073
41428,94,1973,1545,1553,29854,420
41024,2,143,1604,115,5505,28
46154,5,190,313,172,3206,18
40786,11,440,1624,297,7219,143
27732,27,683,2359,538,10995,145
45032,74,878,730,830,14440,48
37580,33,974,1846,533,8213,441
21715,9,232,2649,188,5594,44
19459,8,319,2775,257,5434,62
21788,1,125,2646,104,4870,21
20514,61,1917,2720,1420,7985,497
30248,99,4192,2225,2652,19837,1540
27856,78,1089,2352,816,6718,273
41090,615,15928,1594,9272,141235,6656
29322,48,2265,2270,1639,19062,626
17537,11,508,2860,416,5145,92
35341,0,321,1989,264,7718,57
38725,1,101,1767,82,4643,19
25223,760,50442,2481,24589,236472,25853
44440,59,863,886,542,9795,321
23468,23,612,2561,506,13603,106
43115,221,2382,1199,1936,25607,446
22089,22,611,2628,428,4963,183
11496,14,439,3217,392,6337,47
35284,2,112,1991,88,4143,24
27577,0,69,2368,39,2549,30
22939,49,2999,2586,2268,17930,731
22845,11,651,2591,396,4440,255
27159,0,110,2394,87,2770,23
16412,6,210,2919,170,4767,40
39385,70,1703,1726,1394,14442,309
36097,19,423,1934,262,4943,161
21061,19,555,2688,389,5834,166
13866,6,360,3066,360,11001,0
32459,14,242,2113,196,4610,46
40195,11,383,1677,287,4759,96
17837,48,2722,2848,1650,12656,1072
17193,10,504,2877,387,8405,117
29037,63,1431,2286,1191,24558,240
45595,4,115,548,65,2029,50
31812,1,156,2144,114,4168,42
36114,8,333,1933,273,4611,60
23266,34,966,2571,832,6718,134
41098,25,1912,1593,962,19451,950
35491,7,167,1980,146,5941,21
41201,40,1192,1582,889,17162,303
36781,15,261,1897,223,4107,38
35221,71,2324,1995,1810,53041,514
20465,3,270,2723,232,5105,38
30634,2,138,2203,118,8126,20
43177,6,469,1182,247,10015,222
33972,3,96,2054,81,8059,15
15950,2,249,2943,189,3860,60
35617,1,35,1970,28,3862,7
43924,66,1296,966,613,37136,683
45087,103,1120,707,986,9773,134
19435,55,1054,2776,798,8059,256
43612,7009,175236,1044,108331,948109,66905
43320,35,470,1141,307,10604,163
39050,59,957,1747,775,59775,182
8261,499,19839,3398,17538,134623,2301
41266,12,255,1569,192,7548,63
37881,3,33,1825,28,2003,5
23614,60,1094,2554,850,12302,244
44744,114,1618,818,860,12542,758
33834,50,1092,2058,912,14988,180
24375,7,505,2519,230,5815,275
26635,39,1018,2418,796,18854,222
33175,32,543,2083,387,5004,156
26127,3,67,2441,58,2239,9
41583,17,684,1523,463,10512,221
44841,45,458,785,355,5139,103
9384,32,567,3327,537,3607,30
41587,39,1023,1523,636,13011,387
19241,16,700,2787,544,16890,156
45491,40,419,581,278,5539,141
33086,165,6140,2087,2818,45510,3322
29994,100,3192,2238,2093,26778,1099
45792,35,256,462,230,5432,26
39729,7,98,1707,95,3627,3
40984,3,94,1607,66,3305,28
13353,54,1213,3106,985,37258,228
35832,9,432,1953,361,8397,71
27821,5,329,2353,255,3231,74
37773,43,933,1834,799,14418,134
32289,6,130,2121,111,5077,19
8639,112,2627,3373,2583,24140,44
43381,22,355,1120,259,4729,96
22866,12,390,2591,306,6382,84
42699,31,710,1311,375,8210,335
20049,106,15885,2744,4629,55357,11256
41167,71,2788,1585,2012,35261,776
16868,120,9818,2896,6284,95189,3534
11801,2,116,3202,115,10255,1
15431,4,119,2966,93,6848,26
19893,15,550,2752,447,15074,103
11178,218,4006,3234,3358,20081,648
42160,29,676,1421,453,15942,223
27592,13,475,2367,366,5680,109
20984,40,661,2692,485,7381,176
12551,278,14622,3163,14269,117946,353
40680,28,652,1634,499,19157,153
23044,70,3440,2582,2109,31965,1331
43127,12,231,1197,194,7032,37
31143,293,12823,2180,7205,63781,5618
36176,4,118,1929,76,3247,42
8927,546,23267,3356,17687,75423,5580
28608,122,4282,2307,3101,27850,1181
16423,4,192,2919,161,7192,31
32685,122,2317,2104,1839,21840,478
11471,32,2334,3219,1722,20165,612
46002,32,434,379,354,6525,80
29590,35,1028,2258,893,13986,135
43400,14,339,1115,282,10232,57
5487,571,66910,3554,39832,131165,27078
41294,59,1333,1564,1022,13584,311
40358,4,182,1662,127,4573,55
34751,18,592,2021,510,8128,82
45941,20,94,399,94,1646,0
40976,1,54,1607,42,3507,12
43879,3854,89086,976,72950,393305,16136
25186,0,12,2482,11,1326,1
7343,1124,73623,3465,62541,464064,11082
18883,8,287,2801,228,2818,59
39577,8,263,1715,207,13845,56
42661,6,74,1319,68,2937,6
30975,0,36,2188,36,2642,0
19644,6,141,2767,108,8571,33
40576,41,781,1642,585,5244,196
17306,1,45,2871,39,3822,6
40831,3,64,1619,59,5546,5
15676,5,340,2954,262,3618,78
12004,10,483,3192,388,8163,95
23916,0,66,2541,41,7284,25
34561,11,166,2032,142,15226,24
39423,0,33,1724,22,2515,11
31671,82,2877,2151,1783,18591,1094
26120,1,219,2441,187,11848,32
24498,109,2369,2513,1817,22447,552
18276,9,432,2827,326,4863,106
44168,6,109,926,96,3267,13
16272,1,120,2927,94,3172,26
30451,0,60,2213,44,3413,16
24525,12,427,2512,358,20326,69
26216,59,1681,2436,947,17713,734
32547,0,24,2109,20,3633,4
21472,25,714,2663,553,13768,161
25230,0,1174,2481,626,11067,548
38089,11,261,1812,230,11851,31
41535,4,367,1531,275,10378,92
40107,9,456,1682,334,5878,122
32947,76,930,2093,677,8716,253
41291,62,2686,1564,2113,26324,573
41892,3,102,1468,81,5450,21
44990,13,147,743,112,3408,35
9746,246,5407,3308,4445,21703,962
26878,2,321,2406,266,4366,55
12822,82,8810,3147,3311,57530,5499
28317,49,873,2326,730,16153,143
25406,13,345,2474,273,3911,72
19348,10,233,2781,199,3816,34
13936,12,684,3059,609,12447,75
25914,22,2008,2450,1569,22088,439
37833,73,1560,1828,1276,24134,284
41347,0,97,1557,75,4100,22
16617,304,15627,2910,10654,75242,4973
9593,65,2909,3314,2746,27016,163
27721,23,1967,2360,1574,10356,393
28689,54,1409,2304,1158,8218,251
23562,16,487,2557,398,12744,89
17112,4,447,2882,290,12516,157
45550,3,54,560,33,4995,21
21366,8,555,2669,434,4457,121
35279,41,1198,1991,984,6624,214
16983,53,2203,2890,1425,16460,778
28832,60,1152,2296,947,7432,205
8724,48,1339,3367,1307,12925,32
42274,4,62,1396,60,2798,2
43033,13,323,1225,236,4922,87
16893,4,152,2895,125,2650,27
37300,8,215,1864,172,8328,43
45410,16,427,600,259,6919,168
29437,0,0,2265,0,9337,0
1045,8,173,3949,146,5178,27
40589,4,71,1641,57,1681,14
29890,3,420,2242,340,13157,80
43641,4,107,1034,81,3912,26
42879,80,824,1269,432,8977,392
25347,25,713,2476,424,6808,289
25282,23,559,2479,465,10091,94
18829,17,1967,2803,432,9558,1535
10447,73,2408,3275,2139,31164,269
28334,2,251,2325,194,7216,57
30167,9,340,2230,210,14346,130
42210,21,525,1410,363,11601,162
7731,72,1932,3442,1293,6967,639
28276,22,945,2328,697,29812,248
35326,28,606,1989,513,6008,93
45204,5,39,661,28,2955,11
43317,13,413,1142,277,6471,136
35313,41,478,1990,390,4364,88
34313,16,261,2043,199,3334,62
38546,199,3926,1779,2101,14899,1825
46299,5,76,264,76,1900,0
26144,5,361,2440,207,10879,154
30226,0,33,2226,18,2469,15
19324,25,925,2782,749,10824,176
21065,12,374,2688,284,7743,90
45740,112,2300,479,1416,23578,884
30554,0,27,2207,23,7454,4
38148,1,29,1807,24,4296,5
26104,12,293,2442,246,4585,47
31171,29,337,2178,276,4800,61
18544,36,1162,2816,930,21845,232
19157,169,12062,2791,9292,82510,2770
15334,57,2066,2969,1392,10406,674
34564,20,362,2031,255,4331,107
27192,4,122,2392,87,1726,35
21782,3,200,2646,143,6873,57
20193,13,1159,2736,698,13570,461
23000,27,1048,2584,698,16747,350
43409,22,191,1111,173,6155,18
26776,2,36,2411,35,3510,1
32721,7,244,2102,194,9819,50
31221,2,446,2176,274,7212,172
38771,11,656,1764,532,15235,124
33410,23,874,2075,505,11669,369
44108,179,2391,935,1555,23295,836
24896,300,20739,2495,14948,97835,5791
24724,31,789,2502,651,8911,138
29392,14,2375,2267,778,34706,1597
16858,42,1727,2896,1269,28848,458
35230,1169,43838,1994,17817,222153,26021
30604,163,5396,2205,3399,29670,1997
40656,50,1977,1637,1234,28970,743
35455,44,459,1983,375,4630,84
24073,25,808,2533,651,8705,157
16255,105,5127,2928,3845,46492,1282
6430,284,19886,3511,19095,69146,791
17050,114,5156,2885,2801,19397,2355
39302,57,1507,1730,936,10255,571
27550,0,30,2369,27,1049,3
37653,7,198,1842,168,5384,30
39527,0,0,1718,0,3976,0
22434,14,628,2612,433,9854,195
30012,60,2266,2237,1695,16123,571
24521,4,167,2512,127,3686,40
33839,22,228,2058,197,2977,31
10172,89,6087,3288,4795,40078,1292
16836,101,7225,2897,5283,49217,1942
41818,25,847,1480,624,14894,223
22963,4,165,2585,137,4826,28
25852,0,40,2453,39,1272,1
20086,3,65,2742,54,2411,11
12832,31,1477,3146,1428,30562,49
36611,0,196,1906,161,4246,35
32102,40,2912,2129,2225,37570,687
42098,37,461,1434,342,7422,119
35816,3,137,1954,113,3806,24
25610,17,1503,2463,606,9524,897
21971,33,5383,2635,1720,11921,3663
40642,39,2013,1637,1337,18201,676
12529,1,109,3164,58,1413,51
14473,14,555,3021,456,7130,99
29781,4,107,2248,83,7179,24
25590,19,1089,2465,831,8322,258
40366,18,693,1661,489,13141,204
29823,78,3029,2247,2430,20065,599
13763,21,907,3073,566,10148,341
32319,0,39,2119,38,2119,1
37025,4,322,1882,169,5411,153
35734,6,525,1961,416,28173,109
42857,5,96,1275,69,4958,27
20811,11,528,2703,425,6788,103
14351,210,8825,3030,5570,68069,3255
26106,1,60,2442,47,2268,13
36022,17,352,1940,304,8888,48
45772,33,254,466,245,5837,9
4539,4241,169157,3600,151228,671129,17929
21529,9,304,2660,245,4958,59
9351,7,882,3329,871,18921,11
40152,3,197,1680,147,3656,50
33181,3,110,2083,95,2845,15
14939,277,16255,2990,11946,97753,4309
18404,142,6734,2822,4952,54174,1782
38446,1,37,1786,34,3024,3
36189,22,500,1928,327,12246,173
45748,10,172,477,111,6755,61
20342,66,4067,2729,2818,18646,1249
37815,3,78,1830,67,7777,11
16952,0,86,2892,75,5873,11
21378,6,115,2669,91,3877,24
27784,3,133,2356,78,3274,55
21582,28,1978,2657,1190,16052,788
33154,11,321,2084,214,7575,107
29207,38,2797,2277,2179,28451,618
19468,317,21092,2775,12543,115427,8549
29793,61,2439,2248,1906,27245,533
38518,539,33461,1782,11011,128230,22450
26100,17,859,2442,712,11001,147
45713,12,269,490,153,9060,116
40050,21,733,1685,560,12324,173
39959,240,7845,1691,4751,58647,3094
29924,15,260,2241,232,4102,28
23103,28,3119,2579,983,13800,2136
38105,27,1746,1810,530,19905,1216
34400,14,783,2039,605,7668,178
22290,12,972,2618,759,18909,213
36894,1,18,1890,14,3060,4
20771,177,4306,2706,3125,26943,1181
44948,40,572,757,459,5212,113
26892,669,58487,2405,23462,149435,35025
31096,211,7756,2183,4346,51655,3410
35749,0,4699,1960,3514,35655,1185
44017,4,90,952,60,2969,30
15682,10,516,2953,418,7556,98
13994,58,1992,3054,1065,13152,927
23087,6,500,2580,372,8185,128
27649,15,647,2364,400,11306,247
35200,4,155,1997,118,11300,37
23383,0,157,2565,135,5431,22
19111,33,681,2793,490,5527,191
35693,3,102,1964,88,3516,14
2536,13887,705205,3649,495088,2374234,210117
43077,30,1067,1211,721,16020,346
17242,0,362,2874,297,9951,65
32152,12,666,2127,525,5687,141
4857,8,257320,3587,515,4558,256805
10724,3408,167306,3258,86573,372680,80733
35840,3,99,1953,75,3391,24
44245,0,19,913,16,3838,3
30989,4,445,2188,392,14490,53
25895,9,354,2451,252,4549,102
43260,7,190,1158,120,2875,70
25677,31,1343,2460,1055,19810,288
43196,2,251,1178,120,4880,131
33557,11,325,2069,258,7562,67
33013,5,144,2090,131,4138,13
34543,167,4773,2032,3752,33102,1021
23303,24,1186,2569,953,16572,233
27236,31,1784,2389,1282,17293,502
16221,0,66,2929,40,3734,26
44215,14,208,908,167,3541,41
13702,74,3752,3079,2513,37723,1239
42388,20,778,1377,530,5083,248
38836,2,103,1760,88,2378,15
13335,2,138,3107,114,3340,24
20548,4,247,2718,184,5418,63
25696,6,356,2459,310,3644,46
42400,1716,58864,1374,40834,228072,18030
40296,152,5806,1670,3165,44306,2641
7452,207,5013,3459,4434,30131,579
31884,5,384,2141,225,7455,159
15069,4,92,2983,79,9227,13
25116,8,230,2485,195,4123,35
27551,1,23,2369,19,1073,4
38569,0,37,1777,29,4135,8
8560,52,2568,3378,2518,23561,50
27656,12,350,2363,297,3706,53
34125,71,3482,2049,2558,22049,924
19520,463,19198,2772,12540,46587,6658
17074,38,1867,2884,1321,15772,546
30919,75,1686,2191,1304,24720,382
17184,73,1668,2878,1211,14130,457
36898,7,150,1890,106,2669,44
34785,7,162,2019,132,2152,30
22548,5,289,2606,228,11460,61
19761,6,314,2760,264,11232,50
26105,29,1679,2442,1417,19739,262
17520,4,216,2861,180,4576,36
34924,226,11063,2010,4372,52738,6691
24528,12,520,2512,442,4976,78
13176,26,954,3117,488,4381,466
16654,21,1481,2908,1208,22497,273
43372,21,434,1123,198,8241,236
44683,18,463,839,222,8285,241
23644,7,319,2552,269,13148,50
25485,132,5965,2470,4164,47541,1801
32778,4,168,2100,121,4092,47
34468,18,661,2037,558,8402,103
28071,8,562,2339,319,7497,243
16980,14,447,2890,344,5622,103
29524,1,258,2261,171,7219,87
24361,11,315,2520,247,3281,68
28190,65,2022,2333,1603,14534,419
22700,39,845,2599,628,5587,217
24382,274,18108,2519,9722,77422,8386
29856,0,107,2244,75,4630,32
18471,33,1405,2819,551,13085,854
38332,73,2834,1795,2375,18885,459
42771,84,966,1294,767,7535,199
20519,1,109,2720,94,3512,15
39274,64,819,1732,616,7815,203
20851,9,487,2701,369,10319,118
20904,5,217,2696,180,4959,37
8798,252,12931,3363,11230,77623,1701
19984,36,1707,2747,1303,13091,404
29507,18,264,2261,169,2041,95
29433,54,687,2265,569,9721,118
19875,16,1151,2754,874,10277,277
34178,6,164,2048,126,3981,38
35856,45,582,1952,450,10291,132
35593,459,11582,1972,9067,52474,2515
30462,2,51,2212,31,1974,20
42669,8,133,1318,105,3325,28
37636,39,353,1843,296,3514,57
37087,456,14902,1878,9095,108832,5807
41929,7,421,1463,265,7483,156
12158,15,90451,3184,484,11943,89967
45305,62,573,630,484,5022,89
28819,16,569,2296,324,8422,245
21641,100,8183,2654,4996,84607,3187
10239,173,10014,3284,7516,50935,2498
21120,154,8845,2684,3910,49164,4935
44625,8,170,854,79,5817,91
6707,112,2587,3500,2383,29633,204
35680,3,139,1964,111,3928,28
27703,19,472,2361,398,11499,74
17153,16,1377,2879,1163,15653,214
23696,31,1390,2550,1107,22445,283
22749,0,57,2597,43,2960,14
16403,17,1538,2919,1219,12221,319
22703,3,0,2599,0,13549,0
34580,15,531,2031,349,7614,182
13955,27,2562,3057,1718,32917,844
36522,147,2248,1912,1688,16137,560
43831,17,263,979,224,7541,39
26636,8,156,2418,143,4365,13
11025,312,32084,3242,18968,210002,13116
21503,12,320,2661,275,4092,45
38911,23,395,1756,288,4467,107
14589,107,8339,3013,6569,64004,1770
11485,24,1482,3218,1328,10496,154
16678,8,282,2907,242,4466,40
12457,48,45416,3167,1313,16011,44103
14602,5,313,3012,288,6989,25
22031,18,1098,2631,756,8204,342
11794,1,66,3202,63,3245,3
45146,276,2668,677,2316,17354,352
35578,38,1891,1973,733,17599,1158
39727,7,128,1707,122,2909,6
41078,2,246,1596,201,12926,45
42177,74,1519,1417,1131,25347,388
35391,51,454,1987,375,6004,79
38661,212,8470,1771,4057,35015,4413
30478,38,1140,2212,920,12585,220
39416,18,246,1724,205,5696,41
15533,0,5706,2961,4377,49436,1329
28723,1252,106497,2302,40877,410802,65620
16142,54,1466,2933,1202,12801,264
43198,3,70,1178,58,2585,12
28959,29,1010,2290,617,11619,393
46086,2,25,340,19,1895,6
18749,42,1916,2807,1495,26216,421
21488,4,305,2663,247,5168,58
28826,7,257,2296,213,7129,44
13160,110,2284,3118,1946,24974,338
45110,8,127,692,88,4158,39
38548,8,314,1779,243,8856,71
42540,68,2158,1343,1315,41078,843
45051,4,100,722,89,4286,11
38244,8,244,1801,208,5235,36
20818,57,2887,2703,2326,19807,561
30497,15,227,2210,192,5360,35
46040,5,103,356,64,2664,39
24651,0,33,2505,31,3566,2
9632,5,388,3312,310,19412,78
17503,58,3389,2862,2251,37420,1138
43112,21,480,1201,358,10527,122
12213,15,603,3182,499,7021,104
14495,18,964,3019,834,6106,130
29643,2,162,2255,131,7704,31
21662,17,414,2652,302,2963,112
42342,3,102,1385,86,6902,16
31354,11,295,2169,247,2388,48
38679,6,148,1770,114,9510,34
11056,749,26764,3241,22837,149234,3927
42596,12,400,1334,304,7832,96
34138,3,120,2049,90,2653,30
42261,178,4058,1400,2229,31915,1829
41693,54,1101,1507,601,13781,500
38703,2,224,1768,186,6119,38
21226,113,9445,2676,5619,43334,3826
14478,8,237,3021,227,4512,10
39459,9,347,1722,248,5662,99
22416,2,47,2613,27,2625,20
12917,6,1152,3142,929,10014,223
32503,1,244,2111,151,11546,93
42469,2,241,1358,186,6840,55
22672,6,215,2600,193,5252,22
29903,2,57,2242,39,1607,18
45840,10,124,446,109,3275,15
11933,25,637,3196,559,17197,78
12819,5,254,3148,240,4601,14
4520,662,42682,3601,30920,178098,11762
32739,83,1295,2102,1005,11501,290
15084,13,799,2982,561,11569,238
14865,10,412,2995,392,8595,20
30884,15,418,2192,319,3888,99
21259,10,1013,2674,582,8998,431
35886,1,89,1950,76,8796,13
41354,12,285,1556,235,15678,50
43114,99,1809,1200,1019,16119,790
28790,0,14,2298,6,1974,8
23131,6,211,2578,159,2242,52
18317,51,2205,2825,1550,14936,655
33291,49,1478,2079,1223,24267,255
24127,0,3385,2530,1430,41372,1955
12659,249,84469,3157,9808,121244,74661
29447,55,2692,2264,1764,26418,928
15615,31,1282,2956,1003,12570,279
28281,74,2470,2328,1618,18820,852
22147,0,0,2626,0,29064,0
41914,65,2238,1466,1441,19855,797
23803,65,1780,2546,1142,15373,638
45236,13,273,652,185,4784,88
37784,3,86,1833,71,3626,15
40278,128,3336,1671,2514,46840,822
42972,12,116,1244,79,3337,37
45847,111,1254,443,1121,12611,133
43650,2,15,1032,12,1619,3
30137,4,244,2232,182,5677,62
26406,61,3981,2427,1788,20131,2193
24263,54,3053,2525,2066,29781,987
27963,32,841,2345,669,8884,172
42404,26,231,1373,196,6442,35
45253,94,1227,646,654,10220,573
21300,4,207,2673,154,3993,53
30143,1,67,2231,62,4976,5
28913,0,56,2293,48,4953,8
32121,12,303,2128,229,4706,74
9545,46,1251,3318,1210,6780,41
18907,57,4383,2800,2892,25344,1491
16882,115,7791,2895,5523,48719,2268
16801,5,208,2899,174,3410,34
40818,60,1496,1620,872,20528,624
37858,10,375,1827,198,3781,177
41786,15,290,1488,225,6949,65
42395,32,666,1375,438,13207,228
12948,14,442,3140,427,9626,15
13110,15,1606,3129,1080,10601,526
26007,18,811,2445,667,5592,144
23622,30,1330,2554,1079,22456,251
17624,311,26116,2856,18245,128172,7871
21090,7,317,2686,235,9433,82
20993,209,7182,2691,5361,51913,1821
31792,5,245,2145,194,3769,51
37350,16,478,1862,370,5075,108
18735,219,17515,2807,8198,119273,9317
35973,25,1245,1943,763,13201,482
39707,10,255,1708,200,8824,55
21997,100,3001,2633,2318,20936,683
30136,41,1478,2232,1229,9335,249
18666,26,5625,2810,2956,56340,2669
46262,21,283,279,277,6656,6
41905,19,369,1467,329,8687,40
38292,23,1128,1798,792,12914,336
42422,10,329,1368,210,9063,119
21653,94,4932,2653,2201,27943,2731
36652,35,605,1904,500,7977,105
16178,25,1727,2932,936,34848,791
6623,908,35705,3503,35125,220144,580
18972,11,421,2798,312,4456,109
1293,8,256,3872,208,6726,48
35707,5,321,1962,219,10724,102
27712,0,3553,2360,2834,45239,719
42537,62,1081,1344,836,22956,245
20427,26,1801,2724,1466,9387,335
21566,12,870,2658,692,9038,178
14417,125,4757,3025,3624,50151,1133
34628,13,738,2028,563,12544,175
32137,22,1193,2128,805,8318,388
18244,161,14950,2828,11153,72409,3797
19860,38,725,2754,590,5896,135
39979,130,7386,1690,4396,54271,2990
35042,16,501,2005,367,8072,134
34065,3,166,2051,130,3497,36
15815,2,250,2948,216,4642,34
25730,5,130,2458,96,2686,34
18903,25,685,2800,541,4685,144
29883,4,207,2243,153,4685,54
38824,1,36,1761,30,1664,6
29356,31,652,2269,506,10472,146
33412,64,1918,2075,1496,23214,422
32508,229,3533,2111,3297,19393,236
22726,200,8372,2598,5715,48603,2657
21625,2,0,2654,0,2236,0
24855,0,1919,2497,1198,14715,721
35609,5,865,1971,391,8462,474
37851,50,728,1827,488,8852,240
11290,149,6845,3228,6543,55370,302
25625,22,1367,2463,1098,30599,269
45637,26,278,528,242,6525,36
42445,9,193,1363,161,5369,32
29104,12,449,2283,380,2297,69
46175,1,75,302,72,2943,3
33821,55,1792,2059,1068,32376,724
19666,8,499,2766,404,3491,95
33450,38,666,2073,529,8300,137
31980,38,2786,2136,684,5880,2102
39120,35,902,1742,416,8444,486
30409,34,682,2215,528,6128,154
37562,5,173,1848,123,10005,50
19946,0,1650,2750,1331,21506,319
15166,49,1779,2977,1466,11034,313
36125,88,5637,1932,2710,35735,2927
19557,42,4876,2771,2651,22863,2225
9767,43,1539,3307,1460,12195,79
43255,6,229,1159,121,6543,108
46126,27,342,326,286,6222,56
39548,1,45,1717,31,2880,14
41157,14,209,1587,169,3311,40
21303,3,146,2673,103,2580,43
28942,4,205,2291,171,12867,34
14237,48,2094,3039,1825,14110,269
42702,185,2969,1311,2239,35989,730
26400,20,515,2427,426,10819,89
32149,1,49,2127,37,2775,12
21228,2,140,2676,67,3423,73
33407,175,6905,2075,4894,47284,2011
19796,670,32109,2758,20274,239514,11835
6014,14,2289,3527,2070,24144,219
16277,3,262,2927,192,9254,70
43515,4,73,1082,51,4323,22
16147,0,74,2932,51,3139,23
18051,14,872,2837,713,22844,159
30730,44,1463,2198,648,8375,815
42639,6,69,1326,57,5401,12
39232,76,780,1735,629,13045,151
14819,32,1736,2997,1307,37356,429
42881,257,3361,1267,3169,27172,192
31703,2,44,2150,38,2300,6
39266,0,218,1732,174,5902,44
45386,11,132,608,132,2845,0
17165,2,0,2878,0,59075,0
17760,5,221,2851,171,4167,50
30983,16,618,2188,409,8207,209
29454,11,245,2264,194,5019,51
32928,2,440,2093,309,7778,131
43758,132,1526,999,1042,14993,484
15940,42,1755,2943,951,10182,804
19627,155,6535,2768,4614,55527,1921
12939,491,29511,3141,18974,115240,10537
38676,7,171,1770,140,4132,31
42338,16,186,1386,150,3602,36
45940,0,14,400,13,1373,1
31811,23,1241,2145,988,13425,253
41441,34,672,1543,513,5458,159
19043,1,40,2795,32,1396,8
44852,38,422,783,271,5490,151
25798,3,104,2455,89,2819,15
32163,9,633,2126,529,13620,104
37146,4,106,1874,82,4732,24
26518,4,131,2422,111,3183,20
30950,1,184,2189,158,5231,26
27892,3,205,2350,157,5814,48
35316,33,466,1990,371,4449,95
21147,14,1037,2682,841,32245,196
25446,0,298,2472,239,9602,59
43679,3,50,1022,45,2544,5
45403,32,813,600,293,15906,520
27322,6,305,2384,245,6721,60
30343,2,132,2219,96,2440,36
15628,26,1350,2956,1087,11731,263
24627,4,265,2506,210,8684,55
28873,5,343,2294,266,8405,77
26205,7,525,2436,409,5395,116
39193,98,3392,1738,2433,15922,959
42045,20,553,1444,421,7625,132
35034,10,282,2005,165,5362,117
27825,381,10995,2353,6047,28855,4948
8532,73,2223,3379,1794,13738,429
22635,29,1591,2602,1151,27872,440
27628,14,463,2365,241,9521,222
30567,23,702,2206,567,8848,135
42870,260,5318,1271,3121,36830,2197
28210,11,210,2332,158,2041,52
37366,293,5868,1861,4294,38348,1574
21264,8,435,2674,337,4412,98
29714,1,57,2252,50,4084,7
45324,3,101,623,63,3740,38
19833,11,509,2756,416,13863,93
13996,6,218,3054,207,4452,11
27771,20,1343,2357,708,19334,635
9623,53,2399,3313,2317,21655,82
46469,0,21,179,9,1140,12
32564,1,133,2108,110,3775,23
35649,5,371,1967,194,7136,177
43119,7,169,1198,102,7975,67
27720,124,3988,2360,3053,23027,935
35017,4,168,2006,128,8443,40
22511,4,249,2608,171,8817,78
18664,68,3238,2810,2315,32839,923
11449,1316,114554,3220,80969,422732,33585
38684,19,559,1769,437,20127,122
24304,20,437,2522,311,2939,126
33767,298,11201,2061,5656,85151,5545
17315,12,632,2871,487,14732,145
23478,7,137,2560,109,2966,28
39559,61,1134,1717,916,12779,218
15310,137,5913,2970,4413,33466,1500
33191,236,6297,2083,3615,41760,2682
46231,2,23,287,21,1851,2
11414,42,1037,3223,961,10965,76
30115,22,316,2232,257,3215,59
24997,14,603,2491,219,10453,384
37572,73,2530,1847,1776,24790,754
15477,13,765,2964,564,16685,201
15948,24,1459,2943,1148,28759,311
19609,44,2134,2769,1606,22529,528
18250,12,499,2828,371,4180,128
45216,23,522,657,352,8199,170
24508,33,2008,2513,1470,15935,538
43935,18,124,964,108,2571,16
16898,2,99,2895,86,4399,13
11598,1615,66098,3213,43264,414355,22834
23849,30,1628,2544,794,11449,834
26608,0,82,2419,70,6182,12
37408,17,353,1858,296,5281,57
33807,0,136,2059,74,2604,62
11226,9,619,3231,611,7523,8
16723,10,283,2904,231,4871,52
14199,208,10115,3042,6766,89979,3349
23319,14,351,2569,295,2855,56
18117,9,309,2834,251,8365,58
955,1,101,3984,80,5667,21
43440,21,236,1104,189,4912,47
16141,99,2655,2933,1983,39917,672
43172,8,160,1183,117,3797,43
15232,41,2743,2974,2524,32253,219
31612,154,5543,2155,4125,45571,1418
30762,1,108,2197,81,2085,27
31331,115,4080,2170,2085,33053,1995
22240,0,743,2621,587,11013,156
40232,9,215,1674,122,3775,93
35954,29,1237,1945,1031,11146,206
24932,0,14,2494,12,4493,2
40846,5,106,1617,79,3841,27
39127,11,243,1742,190,6171,53
25308,23,315,2478,264,6253,51
28076,23,1157,2339,662,19831,495
45484,22,278,583,174,5654,104
15357,106,2160,2968,1595,15022,565
16171,31,1273,2932,971,16024,302
18266,24,892,2827,714,22951,178
4988,103,4162,3581,4089,14278,73
26311,12,503,2432,387,5155,116
37068,21,610,1879,334,6384,276
22832,0,115,2592,90,4272,25
12926,1,165,3142,142,2770,23
20400,11,463,2726,383,5974,80
27323,0,75,2384,65,2448,10
16469,1,52,2917,43,6882,9
40869,3,222,1615,166,8112,56
21724,272,19459,2649,13139,145096,6320
34241,43,697,2046,585,6775,112
40349,0,41,1664,37,3259,4
16743,18,922,2903,563,7005,359
28772,3,155,2299,132,3753,23
45875,11,171,435,140,2162,31
29892,5,180,2242,117,5355,63
41351,4,98,1556,86,3177,12
18501,72,2618,2818,1627,18607,991
42819,38,557,1281,473,9196,84
26630,0,45,2418,9,3631,36
39499,18,352,1720,283,6001,69
22984,126,2801,2584,2264,13381,537
32092,10,378,2130,218,8591,160
43305,125,2175,1145,1869,37370,306
43833,85,1049,964,899,16648,150
2992,175,10919,3641,10551,84729,368
19934,2,77,2751,67,2171,10
18328,157,8700,2825,6292,74503,2408
40968,214,5687,1608,4015,42619,1672
31646,17,702,2153,545,16842,157
10930,4,173,3247,168,7877,5
29044,0,145,2286,120,3133,25
21725,11,481,2649,385,3387,96
23356,167,6066,2567,4237,56891,1829
42455,2,111,1360,64,5627,47
15519,59,3374,2961,1745,15738,1629
22364,50,3179,2616,2241,30152,938
39558,0,98,1717,56,3977,42
29736,5,458,2251,280,5586,178
42051,128,2729,1444,2206,17033,523
4537,7,115,3600,100,2001,15
23507,24,749,2559,546,11788,203
45857,22,605,412,159,5781,446
43438,5,225,1104,197,6853,28
20237,158,7769,2733,5290,71561,2479
39651,3,127,1711,94,4281,33
40155,3,75,1680,37,1695,38
23106,11,698,2579,544,8421,154
12422,76,2833,3169,2763,25925,70
33159,0,60,2083,44,2056,16
42194,37,1308,1413,907,17081,401
40928,34,760,1611,469,14148,291
35222,254,10922,1995,4526,46818,6396
37872,16,815,1825,496,12294,319
18399,9,879,2822,740,5029,139
41626,3,389,1517,314,6898,75
27796,1,195,2355,159,8534,36
18590,582,54076,2814,35012,334202,19064
18003,60,3564,2839,2386,30310,1178
38036,42,413,1816,330,4052,83
35154,2,178,1998,129,3567,49
34744,263,4801,2021,3702,23857,1099
41830,2,77,1478,65,3389,12
26768,5,765,2411,639,11518,126
1216,3,79,3899,73,1978,6
12461,11,718,3167,612,6190,106
28600,5,406,2308,329,20913,77
13972,216,16083,3055,10274,50186,5809
42648,187,3295,1323,2383,15260,912
36517,3,374,1912,296,3307,78
36669,2,111,1903,68,2999,43
36382,7,492,1919,272,17364,220
39250,30,971,1733,811,9399,160
32620,2,66,2106,56,2939,10
39971,44,647,1691,521,14124,126
37909,224,3837,1823,3225,26466,612
30181,19,275,2229,222,4011,53
33614,31,1365,2067,865,14836,500
16447,58,2575,2918,2108,22075,467
33440,9,234,2074,187,4470,47
18275,173,6642,2827,4795,35083,1847
24214,1,89,2526,81,5480,8
37192,42,553,1871,426,6036,127
27136,34,1506,2395,1182,14247,324
24350,0,93,2520,73,2548,20
25679,37,2488,2460,1862,16836,626
25876,320,5822,2452,4159,61793,1663
32743,121,1910,2102,1538,11122,372
33052,15,428,2088,330,7260,98
45467,23,442,588,304,7468,138
41803,4,68,1485,50,7950,18
33569,16,439,2069,293,7025,146
38885,14,384,1757,304,7277,80
8397,291,8354,3388,8091,45353,263
42280,23,607,1396,324,7384,283
44261,3,117,901,80,4607,37
33409,5,141,2075,118,2699,23
40102,140,6263,1683,2779,64086,3484
37046,9,102,1880,87,4404,15
17308,3,61,2871,41,4546,20
40763,57,1525,1626,1219,27582,306
38226,5,113,1802,94,3531,19
43982,13,199,958,164,5606,35
14503,13,682,3019,615,14441,67
23541,41,3646,2558,1360,20516,2286
29064,7,137,2285,112,7051,25
27240,4,100,2389,84,2675,16
39850,10,148,1700,118,6104,30
29518,0,0,2261,0,12169,0
43452,9,193,1101,148,4940,45
43360,127,2324,1129,1563,28772,761
9400,112,6596,3327,6347,54333,249
28044,78,1102,2341,847,8611,255
29584,104,3611,2258,2958,26337,653
40284,14,2030,1670,354,19530,1676
44033,66,659,948,570,8944,89
46411,17,147,212,144,3865,3
43938,50,414,964,339,6147,75
7110,491,22609,3478,22569,150656,40
37207,14,284,1870,196,4830,88
21470,19,708,2664,560,6607,148
7810,84,1702,3436,1536,30125,166
19957,5,149,2749,129,4612,20
31802,2,94,2145,72,3663,22
22751,417,17463,2597,9534,66405,7929
8011,4329,181515,3417,138716,535057,42799
12678,7,400,3156,303,19553,97
18360,86,2791,2823,2036,16356,755
45481,3,46,584,36,3474,10
45539,44,420,567,322,6175,98
42629,18,870,1327,553,11229,317
14660,476,25155,3008,17781,91979,7374
30590,6,144,2205,112,4557,32
37502,9,338,1851,187,2940,151
42111,4,103,1433,82,3369,21
39198,2,143,1737,109,4517,34
29115,1,79,2282,65,2961,14
20943,0,124,2694,51,4213,73
8564,272,18165,3377,15792,121734,2373
23402,9,950,2564,720,12878,230
27087,33,574,2399,467,7417,107
32335,8,1083,2118,305,18817,778
30548,2,95,2207,70,7149,25
12588,1452,136868,3161,41634,419647,95234
21532,17,1009,2660,474,5684,535
5041,35,753,3578,599,14439,154
42539,1,41,1343,29,4900,12
31273,136,5788,2173,2327,29006,3461
41936,0,35,1462,32,6227,3
27295,10,755,2385,613,9365,142
24249,0,42,2525,26,2053,16
27387,1,42,2379,28,8173,14
27030,4,50,2401,43,2299,7
39808,263,6374,1702,4788,51808,1586
35815,0,61,1954,31,3539,30
32707,23,713,2103,580,10398,133
17608,6,458,2856,344,6668,114
45880,90,1078,430,540,22333,538
17044,8,359,2886,226,5725,133
16391,23,1217,2920,1001,13166,216
16024,21,562,2939,446,11037,116
25238,2,145,2480,113,6550,32
46349,4,40,244,36,1546,4
23991,4,120,2536,89,3189,31
42775,39,1191,1293,687,32391,504
8876,51,1826,3359,1795,16020,31
27951,0,0,2346,0,16465,0
19777,213,15953,2759,7890,89693,8063
22791,21,537,2595,441,2755,96
45951,29,356,397,295,6052,61
19266,9,739,2785,579,12833,160
29358,88,1706,2269,988,9522,718
16219,53,3723,2930,2710,19478,1013
28876,33,2877,2294,2200,31346,677
40281,7,166,1671,103,2569,63
11652,112,7129,3209,6518,69498,611
3578,1244,70599,3630,47049,207452,23550
13926,5,335,3060,320,8638,15
33774,19,495,2061,381,9997,114
10674,114,5071,3261,2394,23841,2677
29929,0,47,2241,37,2765,10
43139,50,835,1193,646,10520,189
12469,76,6697,3166,4475,53490,2222
41613,39,870,1519,649,7852,221
12866,112,5257,3144,4411,44124,846
33963,142,7674,2055,4676,47176,2998
38778,123,1165,1764,907,12184,258
26770,21,647,2411,507,7904,140
7546,25,2980,3454,2917,62157,63
31636,153,4580,2153,2293,25687,2287
17690,32,1113,2854,789,8836,324
41753,16,213,1495,154,3636,59
29124,47,1264,2281,958,7615,306
30828,7,290,2194,206,5888,84
21926,30,725,2638,602,4685,123
32972,3,171,2092,149,5153,22
23784,0,113,2547,98,11011,15
17247,98,4218,2874,3129,40732,1089
37483,12,599,1853,489,20451,110
45693,13,70,502,64,1985,6
28786,1,242,2298,179,3287,63
22729,8,1345,2598,447,14050,898
27947,73,1597,2346,1271,14009,326
17253,58,2200,2873,1480,21545,720
36053,7,210,1937,145,7908,65
44643,22,398,854,265,6806,133
13890,21,1012,3063,695,9882,317
43256,6,161,1159,114,5724,47
14477,179,9595,3021,6944,54109,2651
8954,344,25940,3354,12937,54196,13003
11493,53,3256,3217,2762,29403,494
9256,48,1989,3337,1778,14657,211
15868,2,76,2946,57,5433,19
12426,10,1577,3169,1065,15749,512
30922,44,1956,2190,939,16476,1017
40874,111,3848,1615,1744,42671,2104
35439,63,1387,1983,1145,18911,242
20279,9,345,2731,303,6065,42
17452,7,450,2864,377,10585,73
3075,118,4281,3639,4132,13525,149
32925,579,65408,2093,11739,103964,53669
38120,6,245,1809,205,4701,40
36683,2,48,1903,42,5404,6
9242,51,2462,3338,2302,24892,160
22278,137,5966,2619,4609,49973,1357
13045,44,1296,3133,1177,8056,119
46242,3,19,284,14,1099,5
23855,12,265,2543,223,4539,42
37365,52,958,1861,767,6454,191
37476,48,756,1854,562,15750,194
16441,228,8800,2918,5916,38095,2884
21565,87,1211,2658,959,11867,252
39131,5,147,1742,112,4425,35
43417,15,303,1109,229,5685,74
19425,1,312,2777,170,7322,142
26295,7,423,2433,317,6854,106
32317,15,686,2119,523,8225,163
26304,5,466,2432,353,12995,113
28810,9,230,2297,201,4472,29
32327,0,37,2119,32,3058,5
43719,15,93,1009,88,2500,5
20517,90,7075,2720,4145,34181,2930
25180,2,36,2482,34,2377,2
32067,15,1055,2131,349,8859,706
33825,4,72,2059,63,3080,9
35741,21,336,1960,261,4759,75
28442,5,350,2319,292,5010,58
35993,5,172,1942,132,2775,40
15396,37,2469,2967,1792,24475,677
38869,1016,31391,1758,22402,218219,8989
4457,80,224660,3603,1944,48872,222716
11364,9411,388841,3225,222143,863227,166698
42148,25,492,1424,365,14879,127
46183,0,33,299,18,1414,15
38461,24,383,1785,317,6756,66
21593,28,649,2656,506,6157,143
27888,3,149,2350,112,4590,37
24097,1,36,2531,32,1080,4
46289,58,2223,269,970,17916,1253
44429,54,672,887,598,6397,74
38770,0,32,1764,31,2971,1
28518,135,8284,2313,6045,65637,2239
9605,50,2482,3314,2362,37736,120
41226,11,692,1577,450,11930,242
33734,23,999,2062,611,12127,388
11956,21,644,3195,634,8895,10
18195,12,578,2831,417,7854,161
30188,40,788,2228,613,6980,175
10121,63,2053,3290,1690,11178,363
26807,50,2035,2409,1616,39163,419
28771,1,89,2299,75,3210,14
44844,17,152,784,112,3353,40
15892,10,377,2945,289,6164,88
20108,0,503,2741,200,6539,303
14452,10,798,3023,417,29408,381
32178,2,116,2125,94,5471,22
28077,9,532,2339,387,7059,145
1279,3,53,3878,43,7045,10
16015,11,365,2939,277,3552,88
17900,3,172,2846,98,1909,74
18154,7,427,2833,338,14640,89
31387,30,441,2168,342,2401,99
38997,6,195,1750,116,9410,79
35493,2,122,1980,104,3696,18
8495,25,1169,3382,1141,11241,28
17224,83,3846,2875,2985,42054,861
31977,1,53,2137,42,4324,11
23407,30,3400,2564,2006,19037,1394
39236,78,3145,1735,1688,38962,1457
35994,46,532,1941,423,6079,109
22715,117,3383,2598,2531,27723,852
36975,364,10564,1885,6183,94773,4381
26171,1,188,2439,140,3745,48
25714,386,8022,2459,6419,26626,1603
46187,33,453,298,226,5351,227
27016,2,167,2402,106,4251,61
13929,50,3454,3059,2604,33505,850
11094,2,137,3238,106,5381,31
22493,55,3427,2609,2505,28547,922
25813,27,686,2454,502,11805,184
45289,4,65,633,53,2825,12
22263,4,235,2620,201,4092,34
35408,32,857,1986,728,14284,129
24690,5,294,2504,225,11133,69
29768,7,622,2249,498,7841,124
12517,3,124,3164,115,1205,9
46355,5,63,241,59,1719,4
42885,6,137,1266,113,7422,24
34038,1,134,2052,88,3257,46
25547,0,35,2467,28,4259,7
18312,10,271,2826,228,6294,43
20328,354,14690,2730,8189,65848,6501
26335,1,35,2431,31,1948,4
34150,12,375,2049,284,6632,91
9633,4,66,3312,59,5598,7
34091,26,420,2050,370,9268,50
12946,31,1005,3140,957,9147,48
12719,19,840,3153,821,6759,19
15516,11,566,2962,410,8519,156
34652,12,224,2026,179,3325,45
35921,90,1864,1947,1464,13717,400
16252,25,1314,2928,1061,7015,253
25429,185,3034,2472,2597,13382,437
23762,0,347,2548,257,3281,90
18787,53,1556,2805,1195,24539,361
29644,15,755,2255,605,18520,150
26490,545,20969,2424,14432,172165,6537
22599,5,243,2603,133,3788,110
40521,1,51,1648,43,2744,8
26423,0,15963,2426,9533,87177,6430
29430,8,136,2265,116,5778,20
24483,81,3242,2514,2201,18620,1041
38586,6,238,1776,182,4498,56
24210,1,429,2527,369,13900,60
23422,4,550,2563,284,8628,266
44044,9,174,947,120,9668,54
31532,7,144,2159,112,3542,32
39268,12,158,1732,127,3033,31
15270,78,3502,2972,2663,70605,839
38356,0,41,1792,30,3861,11
9792,139,6270,3305,5457,49147,813
32921,22,1586,2093,1281,18567,305
45685,85,842,508,708,7863,134
30578,33,1214,2206,944,6305,270
43783,23,418,989,306,14318,112
22372,145,4201,2615,2594,38887,1607
31893,27,1569,2141,838,14505,731
23139,6,170,2577,137,9067,33
10763,18142,937968,3256,443471,2968452,494497
22117,13,526,2626,402,8666,124
39140,26,835,1742,656,7889,179
38906,20,555,1756,438,9565,117
28564,4,325,2310,225,4123,100
20645,1,45,2714,40,1696,5
31638,89,7238,2153,3324,53649,3914
11616,72,2488,3212,2398,15612,90
33349,3,109,2077,93,9401,16
43782,48,626,990,357,6051,269
21570,12,426,2658,356,4396,70
20211,4,303,2735,235,6169,68
30972,42,947,2188,789,24823,158
20361,5,80,2728,62,2228,18
9827,22,1133,3303,983,10833,150
10718,66,3625,3259,2941,29161,684
19963,3,166,2749,116,7948,50
37128,2,114,1875,82,4475,32
37027,21,647,1882,538,12437,109
38280,1,81,1799,68,4616,13
969,15,480,3980,397,6691,83
22628,4,345,2603,289,5896,56
20991,11,907,2691,710,13485,197
35452,5,306,1983,144,5835,162
42059,6,123,1442,103,5983,20
21547,4,172,2659,135,3669,37
45309,0,52,628,30,1641,22
36763,43,593,1898,459,7708,134
41394,65,1661,1551,1294,25584,367
37645,87,933,1843,707,8718,226
13550,21,827,3090,757,5914,70
39210,10,507,1737,423,11511,84
14673,125,4833,3008,4014,27937,819
25866,29,582,2452,450,8403,132
13670,60,2190,3082,1782,17702,408
22313,8,305,2618,259,4281,46
20946,1,68,2694,51,6047,17
24016,128,13094,2535,5970,50364,7124
26291,810,71654,2433,28804,250492,42850
45283,3,113,636,56,2346,57
40944,22,438,1610,298,5742,140
37846,6,78,1827,67,3402,11
29739,6,78,2251,54,4323,24
27836,0,0,2353,0,7722,0
18122,7,277,2834,215,4710,62
24013,22,2092,2535,1443,5449,649
19125,39,1266,2792,786,13501,480
38600,11,681,1775,498,25631,183
17186,175,18833,2878,9708,86046,9125
23423,1,83,2563,66,4619,17
40094,80,2777,1683,1487,26995,1290
37470,10,261,1854,201,4606,60
32629,2,84,2106,65,2138,19
22067,4,549,2630,430,7698,119
14260,19,706,3037,544,17879,162
21243,12,573,2675,379,7458,194
45338,2,27,621,20,2425,7
35044,32,841,2004,630,10248,211
17515,94,2448,2861,2054,16989,394
27522,19,980,2371,602,16159,378
20386,27,402,2727,341,6037,61
43625,20,193,1041,137,10478,56
18121,8,431,2834,320,3978,111
20105,86,2049,2741,1540,13800,509
35347,5,52,1988,46,1965,6
32140,3,92,2127,76,3596,16
11658,16,623,3209,589,13495,34
42034,5,80,1446,68,3737,12
11474,653,27013,3219,15416,98357,11597
33681,26,634,2065,536,7857,98
44935,4,19,762,16,1585,3
16361,5,236,2922,164,4372,72
38448,6,276,1786,135,5329,141
30632,1,54,2203,28,3518,26
18477,101,6802,2819,4854,59955,1948
3346,98,3913,3635,3592,24219,321
31224,24,632,2176,483,4271,149
28928,9,1124,2292,608,9871,516
17626,71,1522,2856,1195,26055,327
38101,83,3124,1811,1510,18471,1614
21218,4,167,2676,137,8689,30
15597,25,808,2957,604,7902,204
14527,131,9751,3017,8750,77673,1001
16862,24,1409,2896,1112,6412,297
41446,9,158,1542,134,6733,24
8595,44,4701,3376,3328,29507,1373
30473,13,520,2212,423,9715,97
16345,5,151,2923,139,9944,12
21056,3,149,2688,102,5610,47
16251,800,46502,2928,15820,165308,30682
20623,105,2782,2715,2148,38562,634
30092,8,310,2234,258,8835,52
30489,171,4694,2211,3893,28914,801
24929,43,2291,2494,1134,35396,1157
13233,184,6419,3115,5334,39009,1085
15301,8,429,2970,388,10750,41
40400,12,363,1659,306,6364,57
34770,106,1057,2020,807,9584,250
9754,92,14386,3308,6745,50474,7641
13768,7,448,3073,445,9916,3
14255,97,1911,3038,1482,16582,429
9983,348,6658,3296,4813,27954,1845
20525,130,3494,2719,2715,15260,779
17141,4,386,2880,187,6008,199
39051,217,9821,1747,6665,68982,3156
27035,10,777,2401,470,8833,307
43435,20,314,1105,208,6018,106
42760,106,2541,1296,1749,22888,792
19715,34,3944,2763,1924,32027,2020
37007,2,181,1883,154,4388,27
40381,16,1424,1660,963,18771,461
30955,4,200,2189,153,5328,47
44529,239,2505,870,2271,38908,234
36565,18,507,1910,386,22271,121
37443,26,585,1856,474,9757,111
36258,0,56,1925,40,6513,16
34679,6,160,2025,132,7069,28
18017,4,374,2838,302,6081,72
40810,16,711,1621,492,13384,219
43040,112,2003,1223,1414,33115,589
27526,15,830,2371,631,11038,199
41324,153,1875,1560,1314,16803,561
30822,25,1554,2194,1085,16693,469
17418,11,387,2865,299,3940,88
11054,153,24490,3241,17487,186440,7003
13821,10,250,3070,232,16413,18
36081,18,642,1935,505,10926,137
20080,128,6882,2742,5228,63828,1654
3834,174,17448,3624,16890,61960,558
35465,8,319,1982,258,6840,61
14127,160,4207,3045,3262,34700,945
9349,124,6324,3330,5976,76494,348
17160,69,2270,2879,1546,40666,724
14069,6,135,3049,117,3890,18
32259,53,3809,2122,2162,28411,1647
17234,19,742,2874,641,12653,101
27348,8,239,2382,133,4342,106
45929,92,767,407,516,7289,251
39313,32,548,1730,402,7677,146
25288,7,289,2479,239,2689,50
23007,12,462,2583,350,6144,112
38735,146,5824,1767,4513,31547,1311
35725,0,54,1961,46,4729,8
6446,181,8692,3511,8671,40933,21
39566,6,164,1716,140,11187,24
17762,1,205,2851,147,2580,58
45822,54,862,451,491,16774,371
37779,8,214,1833,175,3667,39
24163,1,107,2529,91,5206,16
36943,69,1317,1887,1011,17864,306
40791,76,1447,1624,1126,14885,321
35374,15,608,1988,478,11636,130
33125,388,10888,2085,7755,47659,3133
18933,11,359,2800,210,5347,149
33242,14,3130,2081,553,9033,2577
17330,542,21536,2870,15824,58033,5712
34717,7,277,2023,206,6110,71
32529,34,2197,2110,1074,33797,1123
26249,6,206,2435,169,2140,37
45669,49,669,511,531,10988,138
26309,3,409,2432,310,9034,99
30560,14,328,2207,249,5609,79
43138,6,215,1193,147,2792,68
17687,53,1434,2854,1147,21259,287
31543,14,258,2158,182,4897,76
35533,22,1068,1976,731,38232,337
8415,5,163,3388,148,5728,15
32775,184,19441,2100,5665,89173,13776
24835,65,5895,2498,4597,76752,1298
20363,30,1206,2728,872,10534,334
43653,83,1361,1031,1156,17579,205
28003,4,102,2343,89,1500,13
32926,136,4372,2093,2583,23752,1789
19432,31,1409,2776,1140,17340,269
20301,7,666,2730,546,17013,120
31608,7,215,2155,166,2935,49
34948,10,520,2009,397,10317,123
20448,12,421,2723,284,6460,137
18597,3,167,2814,139,12076,28
30435,11,353,2214,295,3996,58
41404,1,18,1548,18,3860,0
13632,125,10728,3085,6483,44337,4245
22057,274,20330,2630,14625,137781,5705
35355,160,4463,1988,3822,21124,641
19013,17,2860,2796,1950,33744,910
35926,4,190,1947,149,4462,41
13968,44,2914,3056,1774,32976,1140
19818,14,615,2756,484,17235,131
15264,14,1101,2973,906,6572,195
16209,0,175,2930,136,2587,39
34905,3504,124572,2012,74428,420248,50144
38677,4,76,1770,65,5115,11
43745,368,12449,1001,7782,98773,4667
18934,1,254,2800,211,7355,43
23261,65,1580,2571,1199,12745,381
23604,82,2000,2555,1462,23725,538
22811,7,278,2593,149,3947,129
21043,13,328,2688,228,3922,100
24546,57,3030,2511,2052,18533,978
26787,87,3504,2410,2416,14916,1088
29908,57,1621,2242,1343,12143,278
25641,2,90,2462,78,3075,12
35951,93,1332,1945,1051,14720,281
26782,1,93,2410,65,4205,28
42146,63,1946,1425,1542,36206,404
8163,106,3866,3404,3185,27507,681
45728,1,24,482,24,1858,0
41435,47,486,1543,387,8720,99
45267,4,70,640,44,2016,26
28599,3,149,2308,124,3192,25
39126,21,316,1742,265,6194,51
39058,10,266,1747,204,11925,62
19705,6,256,2764,221,10536,35
28217,5,225,2331,171,2839,54
32170,6,373,2126,197,11492,176
22233,15,2312,2621,1666,32342,646
18579,45,1119,2815,893,9506,226
13933,3,297,3059,254,10857,43
23802,4,174,2546,147,4016,27
38952,8,299,1753,236,8650,63
20557,6,1888,2718,474,11385,1414
39147,12,268,1741,220,6310,48
46145,4,113,310,88,2415,25
35853,12,298,1952,255,10559,43
29112,62,1260,2282,907,26184,353
15049,7,533,2984,463,13228,70
14996,82,10456,2987,4905,66867,5551
36449,0,29,1916,22,4723,7
30916,66,1173,2191,909,19066,264
39730,46,813,1707,545,9718,268
44663,234,3505,846,2930,44254,575
30957,12,913,2189,729,7560,184
22455,1,0,2611,0,5840,0
29654,11,217,2254,170,5742,47
17652,6,184,2854,143,5405,41
45183,245,1651,667,1428,18838,223
19885,58,3196,2753,2367,54830,829
39809,3,109,1702,70,7779,39
26625,44,1697,2418,779,13529,918
16958,32,2036,2892,1610,25758,426
16074,0,87,2936,50,2593,37
17109,3,73,2882,64,6992,9
40849,14,436,1617,369,16315,67
1121,5,72,3930,63,3865,9
27027,5,399,2401,298,9592,101
36795,49,1161,1896,743,13493,418
42288,8,250,1395,182,6182,68
13718,57,1715,3077,1686,22403,29
33511,21,701,2070,430,7375,271
46115,62,1076,331,815,8084,261
42817,26,563,1282,319,6593,244
14987,3,232,2988,204,9104,28
7832,46,2722,3434,2582,21782,140
10990,10,1402,3244,964,15544,438
13527,10,350,3092,305,23352,45
34268,2,98,2045,64,6704,34
26114,41,1872,2441,1177,12573,695
45175,10,154,669,122,3644,32
21767,42,2710,2647,1890,16220,820
41819,1,68,1480,57,3272,11
43145,0,37,1191,32,5300,5
36038,2,169,1938,120,4758,49
12130,35,1483,3186,1400,16482,83
40258,7,203,1672,156,2876,47
36285,9,127,1923,108,4916,19
39780,14,351,1705,282,8652,69
36671,35,421,1903,320,7950,101
35228,3,87,1995,76,1857,11
27393,7,229,2379,187,3949,42
31692,308,19618,2150,7287,149727,12331
43164,30,526,1186,379,7552,147
42768,7,167,1295,131,10517,36
35378,9,717,1987,594,10436,123
40854,0,74,1616,53,4900,21
34124,0,25,2049,22,1424,3
25331,128,5961,2476,4652,47219,1309
45191,1,14,664,14,1657,0
10451,121,5129,3275,3576,27278,1553
43465,21,601,1098,339,10980,262
45436,9,117,596,85,2080,32
43070,38,1404,1214,832,24508,572
26610,78,3804,2418,3032,33940,772
25224,408,14886,2481,10484,88503,4402
21489,17,634,2663,400,6959,234
24752,6,469,2501,351,10842,118
17579,1,65,2858,57,2652,8
27907,24,1738,2349,824,13079,914
24661,18,690,2505,530,8503,160
43703,51,866,1013,728,10781,138
44249,133,1791,911,1433,25278,358
37670,6,181,1841,159,4350,22
26659,1,221,2417,178,2203,43
5706,147,7016,3542,6820,48569,196
14116,115,2617,3046,1965,13202,652
9434,121,5870,3325,4658,51169,1212
38286,0,108,1798,93,2433,15
13907,208,13302,3061,10409,80525,2893
20930,11,265,2695,228,2463,37
39828,0,19,1701,18,2727,1
3500,749,31083,3632,27352,100518,3731
13012,1650,82293,3136,55454,229865,26839
25275,3,370,2479,261,2398,109
19939,165,20829,2751,11529,83920,9300
12044,71,2225,3191,2082,29261,143
10762,190,10107,3256,7684,75843,2423
38303,3,135,1797,104,4357,31
27770,48,3002,2357,1947,14676,1055
17925,61,3472,2844,2459,34422,1013
31713,0,57,2149,40,4084,17
35252,110,1420,1993,1025,15827,395
30499,8,127,2210,102,2848,25
16590,9,503,2912,422,6412,81
41657,15,929,1512,570,14338,359
26708,16,861,2414,704,12414,157
2882,75,3765,3643,3372,18360,393
45040,51,526,727,484,13081,42
17313,5,242,2871,197,4965,45
32408,4,82,2115,77,1872,5
36756,17,382,1899,331,5055,51
38435,16,375,1787,300,4600,75
42112,5,93,1433,74,5681,19
44776,13,307,807,89,6458,218
27962,7,257,2346,191,8420,66
18210,56,2653,2830,1914,19509,739
43301,350,6644,1146,5167,73483,1477
17278,1,135,2872,98,3210,37
37592,14,356,1846,286,6562,70
14876,6,743,2994,597,15538,146
15870,4,208,2946,142,10536,66
40590,4,78,1641,62,1678,16
37737,2,113,1836,94,3929,19
26327,24,617,2432,363,7398,254
25127,1,59,2485,50,2657,9
45976,1,43,387,41,2851,2
9312,12,426,3333,334,9451,92
32634,38,1843,2106,1251,23475,592
36197,2,126,1928,94,3684,32
11785,37,3798,3202,2641,34740,1157
44606,22,266,856,168,8226,98
45684,4,92,508,61,3590,31
38383,125,2550,1791,1755,29661,795
32008,3,71,2135,64,3375,7
44259,11,226,911,150,4682,76
17915,31,1882,2845,1485,23767,397
16301,16,1043,2925,798,7905,245
37043,10,234,1880,130,6310,104
42501,46,1342,1351,867,28635,475
32896,11,360,2095,304,5916,56
15201,8,258,2976,207,4651,51
45677,24,236,509,176,6354,60
20662,40,1832,2713,1228,41690,604
43675,15,176,1024,129,4323,47
19392,166,4969,2779,3803,29481,1166
42350,10,134,1383,106,3915,28
20263,1,88,2731,77,2810,11
25988,6,435,2446,267,4589,168
34766,367,19412,2020,9636,92111,9776
19023,6,233,2796,200,3523,33
21979,12,622,2634,487,4194,135
22043,17,771,2631,563,16206,208
11517,16,494,3216,490,20878,4
20971,0,26,2693,23,1431,3
26543,252,16455,2421,7444,77306,9011
35648,4,130,1967,113,4806,17
32949,2,110,2093,84,2755,26
38512,41,1938,1782,1224,13074,714
27853,10,409,2352,328,9131,81
39001,12,696,1750,508,15206,188
36390,3,92,1918,67,5816,25
36747,10,460,1899,362,9923,98
35073,10,458,2003,293,5277,165
27566,0,152,2368,59,1504,93
42927,143,6265,1255,4093,30700,2172
21380,3,197,2669,163,4309,34
19948,49,1233,2750,1018,11598,215
41667,28,661,1510,438,19037,223
38777,117,3422,1764,2060,14487,1362
35480,16,447,1981,354,10865,93
32088,12,205,2130,123,2773,82
37415,2,103,1857,85,7374,18
29735,182,4910,2251,3787,24282,1123
23414,6,247,2564,195,8959,52
44652,5,186,851,166,4628,20
9870,1066,114739,3302,36892,404924,77847
37349,4,59,1862,49,3051,10
15353,429,21716,2969,14522,123012,7194
31578,16,271,2157,215,3813,56
31346,25,904,2170,740,12437,164
42028,135,2611,1448,1861,30432,750
38881,0,36,1757,29,4937,7
17600,93,2933,2857,2288,23484,645
14066,11,629,3049,525,10708,104
25871,532,61856,2452,27883,210187,33973
12494,25,738,3165,651,4558,87
21806,29,778,2645,559,4205,219
15909,52,2453,2945,1890,22758,563
25242,48,1717,2480,1377,20295,340
31624,46,1005,2154,614,9480,391
21728,94,4439,2649,3229,38360,1210
37744,18,341,1835,235,7675,106
31017,58,1446,2186,1058,21017,388
18320,23,1137,2825,890,31244,247
27178,27,595,2393,474,6944,121
30870,77,3155,2192,2314,16875,841
37623,2,79,1843,72,3158,7
14046,59,3332,3051,2473,44871,859
13597,111,7000,3087,4425,44054,2575
38298,15,436,1797,357,13204,79
27187,6,172,2392,133,2858,39
44501,1145,17745,877,14848,90535,2897
11784,61,3367,3202,2659,23738,708
22374,5,393,2615,204,6876,189
39942,11,77,1692,60,4272,17
29173,7,138,2279,94,5015,44
38582,100,2362,1777,1693,13956,669
23650,5,394,2552,284,7005,110
16599,26,1558,2912,1156,35919,402
26064,3,249,2443,206,7951,43
28245,472,53496,2330,12840,186051,40656
27857,5,169,2352,140,5039,29
33698,43,748,2064,548,7087,200
16163,3,152,2932,136,6348,16
15997,29,807,2940,592,21028,215
35298,5,178,1991,141,1906,37
27320,8,2051,2384,1555,24073,496
43697,4,95,1015,55,3156,40
35857,0,23,1952,23,2327,0
37892,5,151,1825,121,3975,30
11744,129,7629,3205,6981,69219,648
17211,11,359,2876,263,4348,96
25087,7,312,2487,254,8069,58
39656,561,17733,1711,12596,121389,5137
26175,39,719,2439,552,5614,167
36152,116,2130,1930,1471,13671,659
37575,3,81,1846,71,2202,10
15486,16,1091,2963,876,53595,215
42812,58,1636,1282,850,12906,786
44225,62,598,915,466,9824,132
45117,134,989,686,783,12015,206
43630,22,329,1039,303,15415,26
29296,34,786,2272,510,8367,276
15266,3,285,2973,166,6288,119
11464,167,4330,3219,4219,54990,111
41765,90,1747,1492,1387,28092,360
38913,11,228,1756,181,3465,47
40189,8,374,1678,260,6262,114
28941,12,495,2291,413,5963,82
32600,22,497,2107,375,4715,122
37309,21,874,1864,702,10816,172
16134,15,459,2933,361,4995,98
42747,78,555,1299,440,7940,115
45588,0,884,550,771,6991,113
42957,1,68,1247,50,2476,18
28459,17,790,2318,545,8522,245
9529,294,14456,3319,13297,116011,1159
39036,164,4728,1748,3308,44228,1420
36713,10,178,1901,139,7097,39
37452,27,1254,1855,851,18923,403
40828,2,80,1619,66,6155,14
26157,98,7200,2440,4815,64871,2385
30784,0,40,2196,34,2850,6
18185,1039,114033,2831,44990,211719,69043
42154,3,105,1422,81,4999,24
44942,15,318,759,171,7392,147
42358,80,2921,1381,2099,56788,822
16998,38,2819,2890,1440,49540,1379
34451,5,171,2037,138,4825,33
43383,25,474,1119,322,6279,152
27494,443,13352,2373,10146,49294,3206
28043,0,42,2341,37,2215,5
39948,74,2303,1692,1459,23699,844
17185,0,74,2878,59,3479,15
33067,57,2462,2087,1981,15099,481
29199,122,4703,2278,3578,36664,1125
14715,89,7901,3004,6130,57102,1771
44956,16,461,755,305,7701,156
29973,17,1115,2239,884,17860,231
28175,2,215,2334,182,3182,33
41729,40,1464,1500,1027,31265,437
33890,3,96,2057,82,1883,14
37269,44,2205,1866,1152,38874,1053
19784,2,106,2758,91,3514,15
5429,117,3038,3556,2671,12182,367
6239,1440,84719,3520,77090,433682,7629
18729,0,37,2808,36,3896,1
14075,7,606,3048,552,15774,54
18089,15,444,2835,356,5043,88
15585,17,960,2957,747,13066,213
20125,1061,65192,2740,43020,341872,22172
29148,10,253,2280,208,4547,45
38094,9,124,1812,104,3101,20
18027,8,598,2838,504,7984,94
1118,1,59,3930,54,5685,5
29169,2,125,2280,103,2339,22
39497,26,308,1720,240,6443,68
21237,88,6654,2675,4817,46473,1837
35564,0,62,1975,52,5915,10
36012,11,482,1940,315,8980,167
15993,3,274,2940,246,7841,28
37239,14,483,1868,342,8581,141
45211,17,180,658,124,2943,56
30899,4,139,2191,117,3900,22
17060,28,1630,2885,1240,24959,390
32876,26,586,2095,484,5333,102
7703,859,32454,3444,27754,110761,4700
32658,68,2891,2105,1507,23916,1384
25209,25,1177,2481,877,15092,300
11696,71,2244,3207,1777,7872,467
13368,48,2147,3105,1988,33150,159
15917,3,540,2945,462,33499,78
34685,30,1018,2024,696,10845,322
23985,5,318,2536,202,11493,116
12744,0,18,3152,18,1397,0
34962,1,64,2009,53,2981,11
1950,2941,143011,3659,137227,565392,5784
36477,2,132,1915,101,9964,31
22367,7,374,2615,301,6629,73
19161,3,174,2791,131,3548,43
22627,6,14,2603,11,6242,3
18445,6,378,2820,259,11403,119
38433,9,211,1787,176,5750,35
13842,38,1005,3068,729,6629,276
21746,45,4459,2648,2833,23676,1626
35155,50,725,1998,547,5295,178
34755,30,778,2021,365,11709,413
14329,19,845,3031,829,4487,16
39588,8,210,1714,168,12753,42
7808,1457,99605,3437,64171,315748,35434
4411,37,876,3605,849,9392,27
15460,24,4468,2965,801,14070,3667
20286,5,409,2730,328,13383,81
18606,16,563,2813,381,15049,182
12670,38,645,3156,626,11747,19
23681,28,1478,2550,1205,18050,273
36292,7,171,1923,147,4008,24
39739,4,67,1707,50,11533,17
30442,33,1751,2213,1151,15683,600
33954,0,31,2055,28,1508,3
37375,25,924,1860,356,16182,568
40993,104,4171,1606,2932,44585,1239
10582,141,6348,3267,5480,55287,868
29635,6,180,2255,137,3423,43
36336,129,8610,1921,983,33923,7627
42692,44,1173,1312,923,22425,250
9457,9,109797,3323,635,16849,109162
22369,14,457,2615,372,5553,85
29724,2,105,2251,94,8891,11
9218,193,10899,3339,8048,32178,2851
18490,4,71,2818,64,6117,7
43686,90,1837,1019,1020,25548,817
43103,83,1508,1204,954,25725,554
23490,51,1931,2560,1562,12539,369
39946,63,2621,1692,1406,21557,1215
36350,116,2938,1920,2260,19182,678
32770,5,690,2100,556,10945,134
39304,6,84,1730,72,2720,12
37537,5,168,1849,141,4282,27
33719,61,1684,2063,1329,19579,355
17232,5,330,2875,249,6214,81
17206,258,11712,2877,8470,51329,3242
37422,9,287,1857,249,12430,38
19829,4,240,2756,86,2683,154
12295,57,1649,3178,1578,21155,71
33452,6,223,2073,171,6851,52
27869,2,70,2352,58,3064,12
21168,35,4043,2680,1479,35325,2564
14769,8,1002,3000,824,36104,178
29230,23,366,2276,305,5412,61
27789,4,206,2355,132,4401,74
38441,24,597,1787,370,4612,227
31009,7,291,2187,232,6762,59
26457,76,882,2425,707,6063,175
18955,8,937,2799,314,6483,623
35409,46,529,1986,396,6982,133
11924,26,2607,3196,2293,25532,314
37897,62,2883,1824,2223,43702,660
25700,4,445,2459,379,7968,66
24864,75,3141,2497,2437,26123,704
40711,285,11308,1631,5567,68227,5741
18757,28,3120,2806,1563,20216,1557
15363,5,205,2968,166,4639,39
19016,27,2732,2796,1336,10087,1396
43705,8,112,1013,103,2780,9
30938,45,1143,2190,932,15563,211
12728,181,18143,3153,13067,92659,5076
15113,30,3116,2981,1434,22650,1682
40421,1,96,1657,80,3835,16
17855,9,558,2848,442,8276,116
42586,206,5483,1335,4396,28999,1087
21469,9,273,2664,214,3525,59
34332,3,60,2042,49,2162,11
16811,17,1059,2898,881,8831,178
34831,22,447,2015,371,8615,76
24281,13,524,2523,405,6866,119
45447,8,117,592,113,2123,4
34934,13,498,2010,398,10864,100
8104,239,10474,3407,8372,61925,2102
33907,16,466,2056,358,9408,108
26298,0,143,2433,122,3337,21
30907,0,0,2191,0,11289,0
4569,18,2725,3599,2588,20214,137
35010,5,322,2007,224,4265,98
40824,267,10381,1619,6555,72174,3826
18187,7,374,2831,287,13515,87
34660,13,326,2026,261,7199,65
38790,2,105,1763,96,3256,9
35476,45,1261,1981,1041,22998,220
19063,11,865,2795,355,10624,510
14811,35,2017,2997,1668,28346,349
38617,135,4118,1774,3073,43522,1045
42931,49,904,1253,503,14490,401
41825,13,384,1479,165,3899,219
45137,8,93,679,86,2496,7
38664,15,323,1771,267,4135,56
20168,6,294,2737,237,9643,57
25834,0,39,2454,36,1853,3
36585,34,2283,1908,1193,34879,1090
15450,9,375,2965,314,6093,61
19217,2,164,2788,126,3584,38
42623,7,143,1328,128,5493,15
9423,189,8562,3325,5972,70100,2590
33512,13,482,2070,394,11081,88
985,46,2405,3974,1874,23648,531
12114,254,6231,3187,5235,22057,996
34163,0,0,2048,0,2526,0
38224,1,88,1802,68,3520,20
22142,19,622,2626,481,14215,141
10640,83,3189,3263,3061,25359,128
15485,0,135,2964,107,5306,28
18018,12,410,2838,285,9413,125
22401,628,30773,2614,15427,141268,15346
31956,6,191,2138,148,3313,43
36399,57,903,1918,489,13814,414
9667,26,672,3311,614,5628,58
38561,57,1828,1778,1440,9289,388
5814,54,5624,3537,4004,40028,1620
27193,2,73,2392,58,1589,15
43525,40,299,1078,271,6760,28
20069,2,157,2743,87,9883,70
36951,10,271,1886,243,10520,28
32908,1,119,2094,84,8765,35
29834,41,1000,2246,732,8730,268
22908,0,42,2588,35,3460,7
16201,26,656,2931,541,11355,115
18857,9,380,2802,168,4408,212
42061,83,1521,1441,1169,18739,352
31405,20,1102,2167,450,6406,652
19352,0,141,2781,121,4512,20
23471,14,938,2561,586,13767,352
32230,5,201,2123,172,3825,29
12078,45,1596,3189,1112,22038,484
46240,1,34,284,27,1522,7
20532,8,480,2719,419,8984,61
31675,4,134,2151,103,2833,31
7327,967,37395,3466,28958,174342,8437
38475,183,13464,1785,6184,64397,7280
21493,19,1653,2663,1369,12815,284
14981,2,138,2988,136,2602,2
29244,26,484,2276,396,3798,88
36608,59,2963,1906,2163,39020,800
30374,16,426,2217,338,4135,88
41869,113,2273,1472,1710,19698,563
31470,13,539,2163,345,9427,194
39438,7,105,1723,88,5155,17
35018,8,279,2006,149,6539,130
20031,6,67,2745,60,2711,7
43495,114,1235,1089,915,13601,320
10607,43,1430,3265,1363,15433,67
17154,18,551,2879,396,5485,155
41957,19,251,1458,184,9095,67
34263,10,263,2045,206,4996,57
41850,21,1213,1476,938,29895,275
29582,6,128,2258,102,3721,26
24342,42,2119,2521,1344,15466,775
43628,23,660,1040,465,11994,195
29954,7,253,2240,208,11621,45
22395,1,303,2614,251,4518,52
15340,100,5555,2969,3935,25390,1620
7857,157,109728,3432,8423,47949,101305
36492,249,3126,1913,2371,22031,755
14280,1123,115587,3037,41697,259202,73890
18780,111,13345,2805,4963,55706,8382
16371,3,225,2921,187,4057,38
27337,26,1346,2383,1084,23391,262
25471,0,76,2471,63,1880,13
44966,6,103,751,75,3529,28
19445,165,10479,2775,5665,34443,4814
44951,403,4935,756,4448,29094,487
20591,4,167,2716,137,6528,30
21911,7,429,2639,342,4890,87
43052,418,12088,1220,6973,93040,5115
26362,63,3453,2429,2396,26911,1057
10448,64,4644,3275,4340,29603,304
39381,20,607,1726,380,6152,227
16367,68,5620,2922,4242,27461,1378
33402,0,14,2075,12,1415,2
45692,11,158,504,96,3462,62
42371,22,254,1379,176,4244,78
28026,3,237,2342,184,5896,53
33027,6,167,2089,135,3193,32
18130,124,5717,2834,4437,48248,1280
38899,22,1764,1756,433,12557,1331
13021,42,1453,3135,1282,20460,171
31281,10,234,2173,164,5692,70
27351,62,1248,2382,998,11267,250
7189,20,2251,3474,1909,47054,342
43131,26,396,1196,340,13160,56
20801,21,1070,2704,877,10700,193
32371,7,286,2116,211,6965,75
18595,1091,73449,2814,53945,162762,19504
45824,88,872,450,827,10958,45
16829,4,152,2898,133,2331,19
34967,12,228,2009,193,3250,35
25417,3,230,2473,190,6065,40
21350,7,566,2670,464,13926,102
27964,24,801,2345,627,7364,174
17424,10,310,2865,212,3169,98
44545,164,2253,867,1338,23698,915
46099,154,2302,337,2160,14129,142
35227,15,511,1995,382,13078,129
37069,14,332,1879,260,4562,72
42756,11,355,1297,220,7245,135
35796,0,18,1956,16,1596,2
35888,1,90,1949,80,4327,10
29021,7,676,2287,462,13340,214
16841,30,1709,2897,1251,13470,458
42226,8,246,1406,132,5103,114
45980,52,855,386,756,7009,99
25891,1,49,2451,48,2086,1
26886,1,101,2405,75,2725,26
15217,4,200,2975,175,4896,25
35396,81,2788,1986,1935,38157,853
21888,7,301,2640,237,3593,64
13169,193,6482,3117,5139,55984,1343
30410,0,39,2215,16,4890,23
32694,3,82,2103,60,2431,22
23259,5,156,2571,129,2210,27
12250,40,2487,3180,1123,45615,1364
21780,12,298,2646,258,5672,40
39356,3,208,1728,157,3860,51
30849,3,103,2193,87,1578,16
44476,26,403,881,220,7032,183
39040,119,3493,1748,2648,21220,845
13265,16,461,3113,430,10362,31
8893,27,1536,3358,1259,29462,277
25923,10,299,2449,249,6827,50
24347,5,409,2520,311,5977,98
35203,10,207,1997,181,11116,26
31311,8,428,2171,363,8712,65
34569,35,1707,2031,1447,34452,260
13240,7,249,3114,213,5974,36
14015,18,1408,3052,1272,21327,136
36826,44,736,1893,552,10281,184
43387,33,1162,1118,796,20819,366
35376,23,778,1988,663,12453,115
39490,2,83,1720,72,3402,11
2114,320,8647,3656,7889,50367,758
13675,8,523,3081,448,6716,75
39760,2,137,1706,93,3453,44
19280,23,1653,2784,865,16714,788
15411,341,27025,2967,18360,99150,8665
22929,14,373,2586,305,4843,68
32853,3,216,2096,186,5847,30
42871,6,107,1270,96,2683,11
6944,230,12099,3488,9458,73864,2641
23796,14,297,2546,229,10701,68
29405,2,80,2267,72,3044,8
40722,109,2451,1631,1548,24014,903
11367,2422,90987,3225,55124,227061,35863
15456,6,721,2965,529,8762,192
23236,28,1132,2573,883,13062,249
23292,6,187,2570,160,2751,27
36280,3,82,1924,64,6436,18
37248,31,485,1868,418,14568,67
13735,43,1243,3076,1155,13499,88
26725,60,2330,2413,1164,19056,1166
31485,4,119,2162,71,3543,48
16008,139,11857,2940,8112,63266,3745
27203,9,244,2391,203,6851,41
20661,7,267,2713,223,8278,44
23786,32,903,2547,643,6048,260
42824,88,1396,1281,1145,16589,251
13009,125,6377,3136,6108,22500,269
12491,30,1051,3166,983,10151,68
44994,1,26,743,19,3689,7
23782,4,287,2547,223,5230,64
40709,24,605,1632,453,10440,152
20169,1,93,2737,83,3531,10
13780,19,853,3073,613,9947,240
20560,2,570,2717,438,7698,132
22305,60,2596,2618,1943,16410,653
31556,60,2195,2158,1791,23780,404
23857,0,57,2543,41,2127,16
41779,56,2020,1490,1182,22688,838
21999,425,11116,2633,6908,53795,4208
40409,171,6391,1659,3447,28178,2944
23138,3,196,2577,161,10537,35
30250,2,36,2225,33,3071,3
43950,43,341,963,286,3300,55
29461,44,4573,2263,3628,11928,945
17413,148,3778,2865,2807,20839,971
10147,88,4506,3289,3671,39749,835
39116,15,390,1743,319,6450,71
13429,278,22560,3100,13073,132640,9487
11430,19,3361,3222,2279,22006,1082
40276,4,70,1671,64,3790,6
42106,3,90,1433,81,6261,9
24827,5,207,2499,156,2514,51
23919,3,70,2541,67,3907,3
14056,9,272,3050,263,4079,9
15168,199,8368,2977,5729,34465,2639
15925,9,470,2944,374,7482,96
39838,20,283,1701,223,7619,60
23027,17,655,2583,511,4097,144
30690,3,84,2200,78,2195,6
33322,19,577,2078,324,14167,253
41958,38,1183,1458,893,20285,290
39840,45,2526,1701,991,22800,1535
40736,13,337,1629,262,8932,75
11392,21,528,3224,449,3254,79
17744,9,731,2852,343,3058,388
43617,19,290,1042,212,8387,78
28815,1,102,2297,54,2591,48
17791,26,2509,2850,1924,51532,585
41894,79,1617,1468,1267,34951,350
41893,0,29,1468,24,3221,5
42044,2,114,1445,79,5368,35
17785,47,2134,2851,1660,28626,474
30558,9,297,2207,239,5211,58
18708,1,236,2809,190,9673,46
36179,1,81,1929,73,1832,8
24074,4,124,2533,85,2255,39
31716,1,59,2149,42,2017,17
38219,17,371,1803,267,4935,104
39678,4,141,1709,96,6871,45
16550,17,835,2913,640,6789,195
43355,22,624,1131,427,8745,197
31971,3,128,2137,115,5255,13
9654,29,879,3311,780,5870,99
29338,15,525,2270,426,4508,99
32700,39,850,2103,685,8878,165
28040,6,248,2341,208,3463,40
32435,29,1521,2114,1065,10724,456
15395,66,3785,2967,2743,23410,1042
16960,152,5148,2891,3826,20932,1322
8366,166,9443,3391,8688,55004,755
18262,11,352,2828,273,6664,79
43073,62,1150,1212,821,9785,329
4940,84,5150,3583,3858,34096,1292
25384,0,24,2474,14,2227,10
36830,7,138,1893,103,4499,35
27746,213,9329,2359,7152,64254,2177
36612,1,63,1906,55,3937,8
26638,35,1016,2417,658,8542,358
41757,58,2451,1494,1838,19797,613
32977,14,417,2091,345,9079,72
7484,359,20032,3458,13746,79275,6286
25944,2,158,2448,117,4351,41
21771,7,273,2647,186,6123,87
45909,165,1665,421,1408,21921,257
37019,5,283,1882,212,10597,71
15746,16,805,2950,536,8620,269
13339,63,2985,3107,2393,33456,592
23148,4,180,2577,150,2512,30
44289,7,107,909,98,3624,9
19628,4093,264094,2768,105429,779885,158665
7457,24,109445,3459,1238,15893,108207
38874,3,117,1758,99,4021,18
35540,1,74,1975,56,2842,18
17328,6,413,2870,276,3379,137
12752,18,742,3152,674,9926,68
7683,4,691,3445,576,9424,115
14097,12,613,3047,568,10176,45
30918,51,1044,2191,832,14261,212
25176,15,1247,2483,570,12067,677
20333,8,570,2729,489,21989,81
37253,63,712,1867,565,12133,147
26583,2,149,2420,104,3760,45
42754,11,204,1298,190,3986,14
24230,2,152,2526,119,4912,33
42620,4,274,1329,176,4654,98
44894,69,675,772,569,12715,106
41676,13,159,1508,113,3136,46
22930,19,584,2586,513,5114,71
36027,9,326,1939,271,7692,55
31726,3,67,2149,57,3385,10
35652,19,287,1967,231,4600,56
24962,10,409,2492,268,4108,141
39004,23,676,1750,498,9239,178
24300,10,179,2522,145,2478,34
4387,1515,109314,3606,63480,338645,45834
27763,27,1273,2357,1075,11122,198
31459,8,324,2163,229,7216,95
30677,51,2118,2200,1653,50316,465
17437,188,10588,2864,6170,54977,4418
37241,13,432,1868,353,10168,79
16382,4,257,2921,207,3928,50
41293,0,24,1564,21,7168,3
21116,1,26,2685,24,1564,2
40413,0,31,1658,22,7457,9
41057,40,2077,1598,993,20017,1084
25437,2,164,2472,151,2909,13
38076,11,96,1813,79,2151,17
15825,2,183,2947,158,3417,25
18553,66,2076,2816,1774,23425,302
26528,2,183,2422,145,10252,38
20832,14,426,2702,355,4094,71
43790,40,321,986,265,6944,56
17040,64,3844,2886,2856,36035,988
28100,23,1611,2339,1004,33252,607
24022,18,2134,2535,816,20777,1318
22990,0,56900,2584,32852,272621,24048
29275,19,401,2274,311,6719,90
14077,23,1537,3048,1380,20747,157
32985,10,600,2091,500,10934,100
27449,26,1298,2376,1094,11672,204
12484,26,1405,3166,1237,14131,168
27067,1,159,2399,130,2308,29
12920,1,59,3142,58,2303,1
17034,548,31573,2887,22539,111835,9034
23466,4,69,2561,60,3138,9
42102,1,101,1433,90,4623,11
41114,45,612,1591,478,6802,134
29141,5,194,2281,148,7677,46
15679,7,319,2953,208,4587,111
42764,13,147,1296,133,4351,14
6683,7,656,3500,656,15990,0
16592,0,73,2912,62,4863,11
11477,43,2838,3218,2549,13459,289
45490,350,4814,582,3998,40638,816
25300,14,698,2478,584,5147,114
29680,138,3356,2253,2366,21015,990
18316,7,92,2825,76,10777,16
18043,7,590,2837,448,14192,142
15956,185,6841,2942,5196,24310,1645
39647,6,101,1711,70,2416,31
38465,19,434,1785,357,5871,77
13999,2,214,3054,90,3957,124
20953,137,6274,2694,4701,55366,1573
28812,4,213,2297,172,5253,41
6853,144,12271,3492,9012,57520,3259
14592,43,2144,3013,1886,33606,258
34811,6,143,2016,120,6004,23
27308,40,3145,2385,2571,18424,574
18443,1,178,2820,133,7611,45
39930,16,443,1693,373,8187,70
1210,12,592,3899,480,12202,112
37704,25,246,1839,191,3408,55
34909,5,143,2011,111,4095,32
38407,12,347,1790,278,7859,69
39393,32,2086,1726,846,22616,1240
3357,8,269345,3634,720,8602,268625
42660,17,645,1319,371,7816,274
29580,67,1545,2258,1271,15688,274
22809,169,8310,2593,5770,95960,2540
29937,9,600,2240,457,18060,143
41908,9,230,1466,196,8543,34
19281,9,576,2784,269,6080,307
25218,162,7860,2481,5574,39665,2286
46234,8,61,286,55,1336,6
8277,423,14628,3397,12948,72848,1680
20576,35,1788,2717,1387,26260,401
21324,2,129,2672,99,2063,30
35327,7,128,1989,83,4252,45
42651,3,119,1322,80,3407,39
20190,17,527,2736,425,8181,102
29595,35,1417,2258,1117,29590,300
27854,1,203,2352,157,5163,46
38893,8,192,1757,163,3974,29
24652,2,49,2505,38,2294,11
34537,20,1465,2033,710,9596,755
41017,37,842,1604,574,11678,268
45372,38,520,612,286,6529,234
37083,34,576,1878,508,5450,68
13220,216,12939,3115,10257,104112,2682
33779,49,1325,2060,931,11675,394
40692,58,1393,1633,1105,14315,288
14814,2,185,2997,139,3380,46
15826,0,76,2947,61,2494,15
28051,9,1985,2341,1055,15349,930
16402,9,731,2920,453,12236,278
38230,0,2,1802,2,174,0
29494,3,54,2262,49,2909,5
11108,398,24062,3238,21646,228844,2416
33456,20,1098,2073,868,14430,230
36124,38,669,1932,521,6665,148
22846,742,29920,2591,15323,158803,14597
17243,41,865,2874,690,13911,175
44992,1,107,743,85,3367,22
1272,2,26,3880,21,3028,5
37034,79,4400,1881,3184,42578,1216
35869,8,401,1951,336,5952,65
16014,102,3229,2940,2436,17333,793
40109,262,7505,1682,5460,45253,2045
15762,0,76,2950,64,2877,12
44696,13,107,835,104,1606,3
39972,0,202,1691,160,5929,42
11680,14,719,3208,590,7265,129
25573,28,835,2466,597,9330,238
41533,122,3079,1531,2488,35340,591
43858,36,258,977,236,4672,22
32129,9,570,2128,287,5318,283
34265,28,737,2045,423,15240,314
5704,487,24495,3542,21076,116588,3419
38920,18,682,1755,520,12601,162
45731,4,52,481,33,2125,19
8334,76,4180,3393,4173,35961,7
27063,2,283,2399,217,3172,66
35685,7,103,1964,92,3862,11
40707,29,1210,1632,824,19301,386
24676,21,446,2504,328,4409,118
28274,114,3556,2328,2262,26803,1294
33359,4,213,2077,192,11785,21
22884,153,6304,2590,3326,34074,2978
28484,2,76,2316,67,3223,9
25439,0,0,2472,0,2372,0
43811,13,249,985,198,7396,51
21030,12,213,2689,170,3981,43
35140,8,317,1999,260,10057,57
20203,112,8507,2735,3779,61632,4728
43178,15,357,1182,231,4497,126
30743,3,283,2197,233,6056,50
17096,35,3047,2883,1356,12992,1691
22887,14,1809,2589,1361,53154,448
30546,195,4655,2208,3328,17277,1327
41365,0,88,1555,70,2459,18
34239,2,52,2046,44,3426,8
16845,311,23847,2897,16452,162249,7395
28237,18,796,2330,575,12974,221
17570,11,207,2858,184,3216,23
44559,22,241,866,167,5273,74
17516,320,11624,2861,7492,49443,4132
25024,5,303,2490,188,2381,115
27936,10,624,2347,472,11947,152
22387,3,134,2614,107,1962,27
7952,52,1560,3422,1465,18386,95
25130,22,1969,2485,449,12820,1520
23503,38,3491,2560,2545,30430,946
38140,2,47,1808,37,3434,10
34608,0,72,2029,21,4856,51
15416,16,809,2967,414,9252,395
9967,54,6020,3297,2958,14894,3062
13740,6,272,3075,241,10420,31
19776,1,31,2759,25,3381,6
38279,112,2185,1799,1781,17702,404
31564,2,425,2157,270,5635,155
16974,15,966,2891,770,9421,196
32560,12,218,2108,186,3883,32
37213,7,100,1870,85,3711,15
28073,1,40,2339,30,4950,10
28974,9,175,2289,141,2784,34
37120,578,21663,1876,7945,113090,13718
26634,1439,38674,2418,25699,203828,12975
43807,11,142,985,110,2672,32
15560,12,897,2959,695,6515,202
37390,25,711,1859,486,6919,225
21106,257,10646,2685,7320,42802,3326
15156,18,1078,2978,786,12818,292
27418,89,1650,2378,1292,10849,358
21100,23,2353,2686,1701,15129,652
31154,0,73,2180,64,3192,9
30427,59,2305,2214,1486,26339,819
34108,54,1312,2050,893,18969,419
33128,22,463,2085,373,6206,90
32945,191,7509,2093,5817,60367,1692
21407,15,705,2667,529,5813,176
25600,16,707,2464,541,5162,166
28717,31,1229,2302,937,10969,292
23082,7,461,2580,365,8528,96
17386,8,257,2866,193,4682,64
20691,109,3514,2711,2587,16375,927
14423,2,79,3024,74,7649,5
45921,9,192,414,124,4083,68
37711,11,267,1838,220,9841,47
19267,38,2300,2785,1399,20297,901
41479,204,5028,1538,3673,39277,1355
44856,3,61,781,28,1832,33
14118,585,27088,3046,19561,106933,7527
25405,1,18,2474,16,922,2
43194,2,69,1179,52,2108,17
16831,6,1141,2898,897,49295,244
34735,1450,45899,2022,25793,214573,20106
40796,33,1178,1623,895,14766,283
25936,6,458,2449,373,9571,85
32880,2,254,2095,136,4590,118
23050,111,4111,2582,3183,45165,928
43218,26,158,1171,135,6079,23
27957,420,10056,2346,7789,48957,2267
9781,76,7219,3306,7142,34490,77
37649,10,357,1842,314,6115,43
45304,23,184,630,174,4879,10
37492,7,238,1852,209,8257,29
24679,0,1050,2504,850,9286,200
13872,8,924,3066,466,8968,458
14729,4,354,3004,329,9919,25
42200,4,161,1412,125,3950,36
2691,1242,56751,3646,48319,211095,8432
12981,44,1170,3137,1098,8030,72
12317,28,1679,3176,1116,19227,563
27383,6,451,2380,386,9560,65
22687,4,274,2599,204,2843,70
40534,1,85,1647,66,2902,19
39451,11,355,1723,234,6349,121
41738,3,196,1498,150,8143,46
36480,23,1010,1914,811,13701,199
13165,23,412,3118,355,7497,57
37561,10,467,1848,369,7584,98
27541,16,656,2370,540,20950,116
42096,39,821,1434,519,13854,302
22039,0,1544,2631,1115,34011,429
15977,14,958,2941,752,30986,206
40470,57,1567,1652,1111,19146,456
24700,10,231,2503,180,7274,51
39196,25,757,1738,595,15831,162
12675,176,7369,3156,5848,21260,1521
19419,104,5059,2777,3047,36279,2012
32360,9,735,2117,530,8038,205
22982,174,9795,2584,7427,80448,2368
44434,5,87,887,50,6331,37
15451,1,235,2965,204,3887,31
46404,2,61,215,41,1358,20
12596,27,1053,3161,1003,8094,50
42509,15,239,1350,203,8105,36
35301,4,216,1990,188,4695,28
41769,3,114,1492,83,6664,31
19003,4,340,2797,289,3161,51
13828,32,987,3069,940,5907,47
16922,18,935,2893,750,12345,185
29127,43,1040,2281,759,11103,281
32552,56,3812,2109,2597,31438,1215
12331,688,47212,3175,25974,113958,21238
20198,4,103,2736,68,8485,35
44907,5,144,769,81,2813,63
23444,8,382,2562,280,4387,102
42915,18,408,1258,266,9520,142
40799,90,3045,1623,2158,35893,887
36908,15,316,1889,256,6175,60
35197,44,768,1997,643,5662,125
27753,14,440,2358,355,6225,85
37397,3,113,1859,90,5563,23
20575,348,13866,2717,7906,53069,5960
16977,60,2316,2891,1872,21539,444
20324,20,1590,2730,1247,26126,343
27173,23,466,2393,389,3380,77
20312,51,4141,2730,2854,21725,1287
17583,99,8092,2857,5145,44469,2947
12029,231,8506,3192,6845,53074,1661
29400,5,61,2267,49,3301,12
11331,19,577,3227,568,3095,9
5138,823,39791,3571,34217,154337,5574
4498,94,3127,3602,2816,19397,311
19053,14,393,2795,287,5385,106
29650,6,462,2254,372,7632,90
29353,6,200,2269,139,2738,61
20293,41,1782,2730,1498,18932,284
21376,91,5156,2669,3823,38020,1333
32266,416,8683,2121,5820,46059,2863
45171,4,34,670,24,2008,10
19599,0,47,2769,46,1997,1
32130,30,956,2128,711,8407,245
30194,9,370,2228,284,11611,86
33078,4,315,2087,247,7542,68
11351,571,43753,3226,31070,175181,12683
45627,52,417,533,318,6097,99
29546,10,316,2260,196,5197,120
42981,149,3628,1240,2456,56097,1172
29018,8,138,2287,121,3391,17
16943,278,25813,2892,13199,131175,12614
25601,19,1058,2464,890,15860,168
20554,21,998,2718,539,8474,459
23098,2,113,2579,82,3335,31
45893,15,160,427,147,3194,13
29375,17,322,2268,244,3602,78
40240,2,181,1673,109,6296,72
37230,55,2138,1869,860,19714,1278
35419,20,377,1985,336,7137,41
39695,51,1746,1708,1363,17979,383
22022,6,210,2632,146,4604,64
39219,14,523,1736,395,16087,128
21027,17,461,2689,365,9755,96
26868,27,673,2406,575,7260,98
35187,44,1918,1997,1243,21970,675
42677,82,2625,1315,1538,25927,1087
15317,609,30417,2970,19327,95662,11090
18469,659,53648,2819,35373,253050,18275
27515,8,581,2372,242,5350,339
20254,1,152,2732,107,2104,45
34584,54,889,2030,725,10032,164
45794,34,345,462,287,4857,58
1222,4,90,3898,81,4012,9
3932,54,5997,3622,5293,26662,704
15562,959,43317,2959,22112,204065,21205
17887,7,380,2846,313,6397,67
19150,142,7070,2791,4959,92267,2111
42462,32,735,1359,359,14544,376
42029,1,100,1448,71,6837,29
9165,74,2310,3341,2079,14889,231
19996,1,79,2747,66,3245,13
41465,4,274,1539,199,4133,75
46005,6,77,376,64,1116,13
42132,66,859,1429,659,13466,200
38343,12,421,1793,298,9511,123
37391,27,396,1859,319,9205,77
46089,3,48,340,43,1230,5
30970,112,5837,2189,3425,42164,2412
6492,272,14814,3508,12810,145303,2004
6447,144,8129,3511,7969,24256,160
23353,228,17219,2567,9394,94285,7825
27200,294,12753,2391,9575,107270,3178
38034,1,58,1816,50,4550,8
29874,0,49,2243,38,2604,11
42435,49,986,1365,765,6681,221
17238,10,687,2874,558,5105,129
41186,0,0,1583,0,4524,0
20204,5,261,2735,227,5437,34
37329,111,2035,1863,1459,60295,576
21072,136,4690,2687,3655,16688,1035
36577,2,51,1909,31,3127,20
33367,6,228,2076,120,6258,108
37335,10,545,1862,384,19029,161
40627,296,4749,1638,3654,41581,1095
11368,134,4523,3225,4058,24077,465
26639,2,67,2417,35,1781,32
29886,3,222,2243,98,5284,124
42256,113,1834,1400,1317,25401,517
22886,8,707,2589,281,7182,426
41536,6,240,1531,188,6315,52
17796,9,228,2850,155,5320,73
25567,80,2298,2466,1775,25435,523
18149,11,511,2833,373,8657,138
43290,20,307,1150,266,12689,41
12689,18,894,3155,706,25069,188
41815,7,238,1481,165,6041,73
10064,55,1405,3292,1333,14452,72
14179,91,7623,3043,6368,62290,1255
17956,14,417,2842,352,8199,65
37274,6,238,1866,151,4503,87
25884,2,163,2452,131,2724,32
43210,63,1525,1175,989,14111,536
25965,1,158,2447,135,6317,23
36349,49,900,1920,639,10275,261
38200,179,4777,1805,2932,43541,1845
15085,27,999,2982,862,11815,137
29140,10,301,2281,215,6455,86
24587,140,4722,2508,3594,42466,1128
17090,40,896,2883,665,6942,231
15567,0,318,2958,155,4634,163
22269,85,2327,2619,1883,12660,444
21005,0,81,2690,69,2103,12
23362,12,173,2567,137,5715,36
34314,123,4040,2043,2555,44653,1485
42905,16,308,1262,202,5257,106
25418,9,585,2473,477,7803,108
25394,41,2672,2474,2079,25796,593
36561,287,8182,1910,6164,39777,2018
33869,1,75,2057,53,2545,22
36844,654,15536,1892,10347,70395,5189
13370,760,41474,3105,21387,164887,20087
16288,609,27279,2926,16384,62295,10895
23039,11,396,2583,212,4280,184
22593,5,166,2604,142,5335,24
34428,34,969,2038,790,12480,179
20060,43,1853,2744,978,10145,875
41185,45,1688,1583,969,28418,719
41360,1,24,1555,19,1649,5
19822,592,26905,2756,19379,168295,7526
8113,434,15091,3407,14591,66832,500
41835,202,4715,1478,3479,43019,1236
24728,44,2594,2502,944,8882,1650
24792,25,1243,2500,905,15773,338
19159,0,91,2791,77,5255,14
17631,45,4295,2855,2595,30815,1700
42283,17,461,1396,301,8359,160
12036,46,2010,3192,1685,8557,325
22970,7,210,2585,161,4979,49
14671,41,4191,3008,1404,27381,2787
18441,30,2305,2820,1385,24162,920
26769,2,95,2411,73,2790,22
34073,6,127,2051,85,3626,42
45705,38,402,495,298,5549,104
39980,37,763,1690,465,16697,298
18299,5,361,2826,311,6133,50
43915,14,223,968,170,4206,53
23450,8,417,2562,287,3525,130
38804,0,36,1762,24,4927,12
42612,16,607,1330,386,10329,221
6836,321,17725,3493,15388,88833,2337
37082,13,244,1878,192,7673,52
44923,12,201,764,168,3865,33
33582,28,725,2068,612,7774,113
32930,1,78,2093,66,3186,12
42979,5,173,1241,129,7727,44
38842,94,7688,1760,3223,58555,4465
21085,7,436,2686,366,8421,70
17939,4,180,2843,157,2695,23
19051,0,41,2795,34,6982,7
38149,8,146,1807,118,3446,28
26437,4,170,2426,124,7566,46
16378,92,4278,2921,3241,60136,1037
14314,97,4709,3033,4614,69973,95
30061,11,240,2235,199,5883,41
41776,6,143,1491,109,10698,34
15083,91,4291,2982,3273,39636,1018
13034,43,3132,3134,1629,45593,1503
10350,7,318,3279,275,17852,43
18392,5,479,2822,402,6648,77
40892,30,888,1613,434,11110,454
36809,2,95,1895,68,2683,27
24339,12,1077,2521,897,13098,180
39217,3,81,1736,54,8639,27
38111,14,241,1810,197,5246,44
34526,73,1715,2033,1207,10772,508
15509,367,24563,2962,18023,131982,6540
34046,2,94,2052,68,2682,26
42884,2,35,1267,26,2865,9
23824,33,699,2545,501,7328,198
42897,7,185,1263,134,5008,51
30894,2,131,2191,106,7583,25
21169,408,18386,2680,12732,159031,5654
28141,5,220,2337,186,8314,34
7557,263,121358,3453,12796,47935,108562
15103,67,3138,2981,1991,26546,1147
45361,23,419,615,338,5045,81
35988,13,283,1942,241,11705,42
38277,136,2394,1799,2113,35262,281
45849,5,79,442,63,1698,16
35883,18,2009,1950,1101,20827,908
40336,1265,42165,1667,30353,129724,11812
15372,34,2048,2968,916,4790,1132
23420,19,634,2563,436,6510,198
31008,10,144,2187,119,2632,25
41987,69,2802,1453,907,15539,1895
12045,24,979,3191,758,17481,221
45201,5,140,661,124,5279,16
10956,84,1906,3246,1760,13198,146
42798,6,114,1285,93,5594,21
16156,12,575,2932,440,6045,135
16276,16,527,2927,427,5246,100
29428,28,905,2265,708,9908,197
25329,12,511,2476,421,13102,90
41731,47,1522,1500,1175,19318,347
45066,14,181,715,150,3665,31
19407,64,2694,2778,1861,22839,833
24279,337,164749,2523,10466,108628,154283
8441,368,15777,3386,12634,71446,3143
43724,279,3171,1007,2843,28986,328
45696,5,30,501,20,1516,10
43582,3,34,1057,32,2720,2
19027,297,27556,2796,12735,166315,14821
23982,0,22,2537,14,2632,8
39449,86,1499,1723,1252,18604,247
43665,48,565,1027,482,7590,83
37012,0,29,1883,25,1973,4
34768,1,307,2020,244,9874,63
13450,48,3332,3097,2703,19304,629
36816,3,242,1894,210,6137,32
16309,15,573,2925,392,8163,181
18398,76,7946,2822,6124,34052,1822
15401,11,493,2967,387,9345,106
15733,1,142,2951,117,5245,25
28668,0,3,2305,3,1636,0
45013,58,601,738,558,9186,43
39059,12,277,1746,238,5610,39
18034,19,1448,2837,1220,7122,228
19090,0,216,2793,84,4669,132
6926,76,2719,3489,2444,22485,275
22920,8,363,2587,279,11775,84
43339,95,2311,1135,1705,25906,606
18860,10,314,2802,240,2330,74
13944,70,5562,3058,4685,35845,877
45406,0,17,602,16,1349,1
14405,23,1275,3025,956,10749,319
16516,12,573,2915,367,6180,206
39073,0,0,1745,0,4425,0
44740,42,654,819,498,7095,156
26762,2,70,2411,65,2085,5
28588,1,50,2309,38,2627,12
44737,329,3450,821,2804,16318,646
25120,2,26,2485,25,1563,1
20416,21,943,2725,754,12724,189
41450,156,3119,1542,1538,13086,1581
8235,2729,142581,3400,83694,714370,58887
45975,1,40,388,33,941,7
28435,5,116,2319,105,8320,11
18560,33,2243,2816,892,17592,1351
18361,1,81,2823,66,2870,15
16806,149,5758,2899,3483,49885,2275
15487,1,263,2963,194,7499,69
43063,25,526,1216,374,6838,152
36828,4,124,1893,77,5197,47
23626,62,2573,2553,2021,18582,552
27877,5,314,2351,275,7621,39
24816,43,2561,2499,1950,28235,611
34588,14,5527,2030,517,12064,5010
17851,26,1041,2848,870,19703,171
11144,1,0,3236,0,2645,0
20127,16,592,2740,517,7972,75
22838,426,23229,2592,11881,128275,11348
35802,7,321,1955,237,10963,84
37822,24,776,1829,481,12428,295
14156,2,151,3045,118,5538,33
34931,219,5739,2010,4235,29016,1504
14946,3,174,2990,142,5411,32
42317,26,725,1389,548,5852,177
27330,3,282,2384,151,4536,131
31769,10,363,2147,294,6976,69
17877,3,318,2847,252,6159,66
42119,19,683,1431,463,9169,220
37712,1,139,1838,83,5855,56
27424,14,357,2378,279,5453,78
12624,49,3377,3159,2843,29035,534
16935,239,17452,2893,12843,109370,4609
38337,8,170,1794,125,5192,45
25267,154,5326,2480,4018,29795,1308
35720,49,2396,1961,1003,20753,1393
44963,17,277,753,179,4942,98
10053,91,4031,3293,3921,37106,110
40986,3,94,1607,76,9349,18
32361,10,323,2117,270,6737,53
30098,2,264,2233,172,5519,92
17509,77,2631,2861,2022,18804,609
45561,13,249,556,204,3560,45
28703,4,181,2303,162,3776,19
16359,7,165,2922,130,3748,35
45969,7,90,391,68,2471,22
20102,22,810,2741,622,18796,188
26149,6,376,2440,262,5028,114
28362,28,790,2323,521,8571,269
29672,32,4491,2254,898,22613,3593
38737,6,198,1767,177,6395,21
39992,7,130,1689,93,3065,37
11273,110,8185,3229,7293,127724,892
45793,1,29,462,23,1939,6
39661,4,147,1711,128,9407,19
40144,37,795,1681,643,8602,152
11553,4,328,3214,303,7173,25
21483,222,10621,2663,6380,81626,4241
33439,2,102,2074,67,4322,35
10281,27,1130,3283,1038,6893,92
17691,20,6563,2854,1115,32724,5448
32841,4,231,2097,177,5805,54
30551,0,86,2207,66,4126,20
14647,30,2928,3009,1659,27948,1269
32136,25,651,2128,510,17229,141
20829,12,746,2702,635,13150,111
38010,4,280,1818,227,9368,53
13275,701,30814,3112,21163,144412,9651
41834,7,257,1478,200,11488,57
40029,52,655,1686,479,10830,176
23501,1,145,2560,120,9546,25
45926,45,1480,2560,1207,8968,273
44568,123,1798,864,1608,14686,190
39389,30,1261,1726,1000,17248,261
9455,35,771,3323,729,6131,42
16863,11,667,2896,573,5627,94
15943,160,5429,2943,3672,87956,1757
33772,5,156,2061,137,2455,19
40233,10,923,1674,425,14657,498
19049,6,380,2795,300,3462,80
33770,2,136,2061,104,4915,32
32097,6,260,2129,190,3519,70
17566,30,3467,2858,2805,35504,662
16499,197,12795,2916,6341,65409,6454
15403,7,132,2967,109,4404,23
35199,0,317,1997,255,3870,62
39309,12,456,1730,389,8443,67
37850,425,12345,1827,8589,94722,3756
27785,13,424,2355,340,11500,84
33629,3,113,2067,89,3303,24
41069,12,254,1597,221,5225,33
9956,3,60,3298,51,4872,9
42055,0,44,1443,29,5479,15
15251,461,19449,2973,11746,114287,7703
40943,76,2310,1610,1659,17478,651
18580,8,462,2815,379,15146,83
36548,25,813,1911,548,8919,265
36225,6,173,1927,126,2806,47
28909,2,178,2293,148,3358,30
10621,92,5007,3265,4508,74328,499
5701,2129,90063,3542,75962,344821,14101
20036,6,355,2745,275,6528,80
13765,14,505,3073,400,5682,105
44576,22,582,862,235,13357,347
20183,1,138,2737,64,6419,74
41746,317,6370,1495,4092,62497,2278
40708,2,37,1632,28,3408,9
18998,82,5011,2797,2243,32184,2768
31103,5,100,2182,87,2860,13
45753,2,103,475,68,3099,35
21467,16,443,2664,332,5857,111
26066,2,97,2443,84,3359,13
40772,0,63,1625,53,5675,10
28288,599,26214,2328,14975,161165,11239
37054,1,61,1879,53,2811,8
16351,1,93,2922,81,2136,12
43769,30,273,993,215,6281,58
28481,23,1430,2316,575,12799,855
40177,0,0,1678,0,6930,0
13770,6,377,3073,235,4579,142
15557,20,362,2960,290,6717,72
13325,4,214,3108,199,8803,15
26847,11,343,2407,133,3840,210
31178,7,283,2178,243,8334,40
26670,289,21196,2416,9245,105081,11951
32110,21,735,2129,485,5268,250
28964,74,5997,2290,4467,49770,1530
39645,20,360,1711,273,6165,87
34825,2,162,2016,136,4240,26
45033,558,5994,729,4116,40630,1878
14893,20,1448,2993,886,14289,562
29409,20,1481,2267,668,29641,813
39891,131,4051,1696,2962,32267,1089
42091,6,151,1436,107,3580,44
28436,33,746,2319,641,17832,105
16245,1,94,2928,76,10483,18
39767,5,153,1705,108,5732,45
41378,15,347,1553,244,6305,103
19622,11,559,2768,412,7725,147
40514,6,277,1648,146,6056,131
25152,48,1587,2484,913,9430,674
27618,4,319,2366,243,9100,76
15524,47,3099,2961,2385,30743,714
25496,5,283,2470,228,7125,55
22947,10,393,2586,295,5882,98
23499,36,2346,2560,1756,21415,590
21204,2,228,2678,182,7666,46
32248,85,1691,2122,1186,12797,505
25867,43,1458,2452,771,14371,687
13779,1,91,3073,90,3097,1
25093,27,618,2487,456,4266,162
23315,19,1102,2569,855,23287,247
34789,5,190,2018,157,5094,33
41121,25,936,1590,692,16098,244
45092,6,150,702,92,5949,58
18622,3,184,2812,139,7724,45
21950,86,2954,2637,2302,25098,652
21446,20,641,2665,529,7070,112
27786,55,2539,2355,1994,14870,545
17906,6,610,2845,280,19835,330
11279,42,2822,3228,2635,47233,187
40162,6,60,1679,44,4342,16
10238,275,17198,3284,12133,75191,5065
24667,35,536,2505,358,5089,178
43713,28,521,1011,280,6334,241
17618,15,1263,2856,865,21267,398
12841,52,5436,3146,4266,47063,1170
23413,19,572,2564,348,4313,224
34417,2,89,2038,74,5414,15
46199,314,15910,295,11343,89063,4567
43283,15,682,1152,458,14689,224
35113,9,134,2001,118,3202,16
21530,27,1288,2660,970,12572,318
37084,4,171,1878,137,6171,34
37372,143,3284,1860,2379,25031,905
16463,13,571,2917,476,8102,95
15520,1,84,2961,70,2470,14
25810,0,37,2454,35,1512,2
37005,9,199,1883,167,5205,32
31147,8,403,2180,313,5708,90
40064,1,83,1684,64,1795,19
39415,316,3902,1724,2936,27163,966
16457,284,15528,2918,10214,80236,5314
2657,12,273104,3647,571,15389,272533
44847,45,631,783,418,15441,213
40463,647,22774,1653,13816,140031,8958
29498,1,186,2262,118,3900,68
20142,4,159,2739,130,3215,29
13852,9,417,3067,347,7065,70
18238,33,2197,2829,1139,11674,1058
33883,1,276,2057,172,3868,104
25221,16,947,2481,778,16498,169
14125,7,227,3046,215,7991,12
42555,4,77,1341,60,4568,17
12117,4,274,3187,235,4329,39
39353,15,241,1728,184,4287,57
36538,3,50,1911,43,1399,7
26370,3,113,2429,87,3283,26
21665,3,46,2652,41,2299,5
39136,8,265,1742,205,8146,60
42393,6,523,1375,345,11111,178
21719,26,912,2649,675,8023,237
37184,38,2302,1872,755,21125,1547
31913,39,904,2140,729,8777,175
31317,49,1289,2171,865,8993,424
25101,274,12168,2486,8946,94266,3222
43716,55,643,1010,517,12556,126
15558,0,129,2959,105,4442,24
22611,35,1323,2603,938,5816,385
23873,21,529,2542,393,6157,136
5570,3276,142670,3550,105972,510332,36698
35393,309,6022,1987,4352,26677,1670
44178,48,550,924,394,11896,156
45715,4,161,490,119,3235,42
28250,5,155,2329,131,2923,24
35688,98,3697,1964,1602,17052,2095
36490,3,156,1914,109,3056,47
43340,142,1699,1135,1220,17834,479
25614,4,48,2463,42,2504,6
24384,19,907,2519,556,5642,351
25811,14,309,2454,282,10030,27
40311,5,83,1669,60,4051,23
7099,98,6080,3479,5884,20593,196
37247,4,182,1868,107,4066,75
45701,13,169,499,138,3649,31
33498,193,4565,2071,2424,24629,2141
27441,37,814,2377,574,5481,240
31393,11,171,2167,128,2675,43
46053,5,54,350,43,1044,11
36673,871,37023,1903,25758,193198,11265
15884,5,338,2946,281,5176,57
31539,22,525,2158,446,17867,79
36979,7,202,1884,128,4120,74
36941,5,431,1887,98,4804,333
16442,618,34086,2918,18049,239647,16037
14367,22,625,3028,591,9624,34
32415,0,22,2115,14,1478,8
26617,0,123,2418,106,5767,17
33453,20,390,2073,274,6519,116
31717,0,44,2149,31,4075,13
9181,120,4038,3340,3558,30202,480
45718,0,21,487,17,1020,4
34687,2,96,2024,85,2957,11
22211,9,456,2622,281,4968,175
39420,112,1500,1724,1217,16953,283
28727,0,155,2302,119,6751,36
28420,1,149,2320,90,4298,59
37465,33,806,1854,583,12165,223
40436,172,2176,1655,1707,14057,469
15048,3,119,2984,116,4535,3
21377,7,418,2669,355,2696,63
37746,29,2373,1835,1043,22746,1330
22501,156,8284,2608,4808,66853,3476
25408,6,635,2474,303,11462,332
40582,64,1830,1642,1426,22030,404
32828,0,0,2097,0,6368,0
13813,21,975,3071,735,12251,240
22185,588,30223,2624,21589,160813,8634
23550,23,1494,2558,1133,13919,361
35008,22,956,2007,341,14632,615
21092,0,69,2686,61,2998,8
30472,13,580,2212,456,5936,124
14966,14,620,2989,523,11856,97
27037,7,240,2400,200,3174,40
16517,97,4486,2915,3180,36354,1306
6486,742,73495,3509,35592,391667,37903
41967,6,189,1456,144,5017,45
39726,5,140,1707,123,3619,17
36246,94,2848,1926,1778,16901,1070
36541,0,32,1911,25,2054,7
37780,10,222,1833,177,5586,45
27791,160,4998,2355,3157,38470,1841
23035,7,268,2583,226,7808,42
43751,1,42,1001,33,3772,9
40825,77,1548,1619,773,13011,775
27610,71,1323,2366,601,15127,722
16020,493,20531,2939,12882,57639,7649
32376,284,15144,2116,10606,102393,4538
36860,5,193,1891,158,2229,35
30007,29,3585,2238,1545,28169,2040
36316,29,1606,1922,936,22580,670
28780,8,234,2299,208,3842,26
16820,9,515,2898,434,6684,81
34015,11,369,2053,308,8865,61
16165,0,311,2932,153,10546,158
38602,7,195,1775,149,4034,46
29597,17,590,2258,495,11966,95
29450,3,190,2264,152,3623,38
45702,25,240,498,161,5547,79
25710,7,136,2459,118,4613,18
28456,6,153,2318,139,5271,14
44944,91,1290,758,892,17489,398
24782,2,99,2500,74,5496,25
45461,106,773,589,649,13369,124
20607,2,176,2715,150,5738,26
46139,31,376,319,274,7919,102
21832,0,481,2644,124,3354,357
15641,27,930,2955,758,10686,172
15469,463,49195,2964,11617,192936,37578
27530,334,17335,2370,11387,142431,5948
43662,32,735,1028,488,10097,247
34536,71,1591,2033,1080,9630,511
18015,12,453,2838,384,6272,69
18252,8,472,2828,397,3142,75
5434,2694,188736,3556,108779,480772,79957
43150,35,825,1190,677,27463,148
19736,1,112,2762,90,6576,22
43674,33,304,1025,285,4842,19
36482,10,188,1914,129,5591,59
1947,347,21825,3659,17701,75355,4124
29552,3,119,2259,97,2888,22
34141,44,1940,2049,1550,17189,390
17920,0,149,2844,94,6633,55
22803,2,90,2594,80,2150,10
37901,65,592,1824,490,8039,102
26305,14,2971,2432,2000,40103,971
17810,55,3881,2849,2706,30060,1175
38655,123,1444,1771,1090,11011,354
46363,0,29,237,23,1434,6
11964,15,460,3195,440,15221,20
30090,2,74,2234,66,2191,8
36544,0,50,1911,32,2353,18
27394,163,6003,2379,4628,41113,1375
39361,21,380,1727,290,5778,90
33510,15,434,2070,315,7254,119
20546,43,3151,2718,2670,18314,481
45867,10,285,438,151,7110,134
20599,7,249,2716,191,3624,58
39825,10,288,1702,225,8549,63
38764,8,271,1765,138,6457,133
40078,2,132,1684,94,3022,38
1103,6,251,3934,211,7152,40
13277,179,10685,3112,9404,73986,1281
29907,5,222,2242,192,3564,30
22855,5,252,2591,189,6265,63
17181,583,26864,2878,19440,113483,7424
23415,12,279,2564,219,10115,60
17849,4,116,2848,94,6015,22
19116,39,1599,2793,1270,8952,329
12524,1,69,3164,57,1390,12
43336,76,2160,1136,1265,15807,895
33169,0,77,2083,70,2637,7
26842,55,2240,2407,1728,27731,512
34758,29,1022,2021,725,11869,297
28184,4,661,2333,556,9285,105
26347,7,389,2430,332,2298,57
40595,12,282,1641,240,6352,42
31991,93,2164,2136,1140,14259,1024
29849,2,117,2245,94,4173,23
10877,5,435,3250,327,12287,108
10647,39,1896,3263,1750,40368,146
25809,1,81,2454,65,1802,16
41901,4,247,1467,192,5658,55
16364,4,619,2922,494,10730,125
28798,90,4059,2298,1785,31118,2274
21717,19,474,2649,385,4253,89
45083,92,1019,707,577,15050,442
40158,45,834,1680,562,10383,272
17448,463,38551,2864,16268,121416,22283
14540,3,123,3016,86,9204,37
17859,9,949,2847,610,16211,339
29541,5,164,2260,128,3913,36
38344,3,97,1793,82,3484,15
23126,8,189,2578,141,4017,48
33106,6,174,2086,138,4537,36
7009,433,12201,3484,10340,41393,1861
29718,16,584,2251,364,7251,220
19889,14,597,2753,432,8169,165
45141,71,1186,678,373,7075,813
32081,24,568,2130,406,8937,162
38297,10,194,1797,167,4359,27
25764,5,151,2457,121,8423,30
22346,6,384,2616,301,7258,83
39464,2,184,1722,160,7571,24
29055,5,151,2285,118,3144,33
24977,5,241,2491,203,8368,38
35057,7,243,2004,155,6266,88
11591,13,973,3213,956,12208,17
8399,39,1584,3388,1455,23947,129
38554,16,417,1778,273,6042,144
32021,21,780,2134,534,11085,246
29289,16,375,2273,280,5669,95
32516,53,930,2111,733,11911,197
36219,106,2323,1927,1859,24228,464
32123,6,153,2128,125,6800,28
18293,6,190,2826,134,3592,56
14461,10,1482,3022,630,10428,852
10132,14,1120,3289,1075,30121,45
13418,89,7341,3101,5726,98985,1615
19555,0,86,2771,62,3434,24
37106,13,438,1877,369,7509,69
31040,3,62,2185,54,4183,8
37096,344,13547,1877,7444,79408,6103
21963,1,150,2635,96,5216,54
16996,10,287,2890,228,10003,59
41946,21,314,1460,209,7355,105
14201,7,169,3042,168,3683,1
18721,32,1326,2808,908,18316,418
24981,3,153,2491,121,4202,32
21068,16,926,2687,719,10936,207
20826,7,831,2702,667,13583,164
39974,21,610,1690,490,12107,120
25005,7,908,2491,764,12564,144
15796,1,40,2948,36,2791,4
28839,4,70,2296,59,2294,11
18702,9,301,2809,178,3502,123
15463,1,59,2965,50,7842,9
17829,3,154,2849,125,8345,29
45152,36,329,676,242,5120,87
44666,19,187,845,153,3871,34
35732,2,73,1961,70,3970,3
39722,58,2695,1707,1822,14465,873
27009,153,14235,2402,9894,36843,4341
6337,21,1712,3515,1681,12752,31
24774,5,531,2501,431,10653,100
20849,67,1221,2701,871,10465,350
25618,46,1398,2463,802,11256,596
22774,48,1404,2595,1063,10871,341
37431,1,43,1856,35,2962,8
26637,0,445,2418,238,6288,207
45109,34,345,693,282,4921,63
6342,16,1396,3515,1384,6968,12
18053,14,524,2837,419,11011,105
14523,54,3093,3017,2661,33506,432
30758,7,285,2197,155,3401,130
32585,19,1148,2108,794,12453,354
23775,21,1196,2547,786,15047,410
27483,5,220,2374,162,5823,58
6947,90,2936,3487,2929,15381,7
21994,6,224,2633,155,4314,69
42592,63,1652,1334,1286,26650,366
12983,208,20821,3137,14311,127901,6510
45088,80,811,705,644,12047,167
40441,82,2650,1655,1902,22598,748
9951,14,1253,3298,798,17818,455
29208,18,620,2277,499,10587,121
19903,9,153,2752,113,4208,40
31018,123,3816,2186,2788,19595,1028
45782,21,321,464,162,5199,159
16095,3,216,2934,145,2963,71
14021,0,157,3052,152,9479,5
38081,95,2159,1813,1780,14045,379
14712,39,1345,3004,1116,9712,229
20073,12,269,2743,205,7150,64
31234,35,2199,2175,1088,18158,1111
16140,9,467,2933,375,6720,92
42601,1,101,1333,49,7769,52
19933,6,281,2751,170,3689,111
17854,0,188,2848,153,4380,35
34627,14,304,2028,242,7470,62
17955,4,307,2842,188,7188,119
19255,11,510,2786,428,8739,82
43278,11,176,1153,136,5166,40
32822,0,81,2098,54,2684,27
29350,4,117,2269,98,3418,19
32003,8,257,2135,155,4307,102
16901,29,1731,2895,1162,9705,569
24844,5,276,2498,220,3510,56
39890,3,174,1696,122,7323,52
20655,34,1720,2713,1179,15839,541
30873,21,416,2192,313,4721,103
31950,14,617,2138,479,7964,138
15564,60,3463,2959,2028,29749,1435
13911,15,769,3061,609,18703,160
34248,18,880,2046,660,7013,220
19966,4,338,2749,245,7675,93
39843,569,33958,1700,14943,141632,19015
36515,36,1012,1912,773,7562,239
39987,2,92,1689,71,3406,21
39585,54,1473,1715,1055,15000,418
36085,36,918,1934,681,10586,237
30886,10,266,2192,215,7218,51
26761,18,564,2411,455,13093,109
29474,3,149,2263,122,3168,27
32962,27,785,2092,680,7049,105
24701,459,29470,2503,13269,76057,16201
19968,12,833,2748,650,15334,183
42583,7,325,1336,184,6916,141
45455,8,102,591,82,4841,20
15498,12,460,2963,401,10173,59
30387,1,228,2217,184,4255,44
26470,3,105,2425,95,3339,10
42467,66,1269,1358,877,23847,392
8515,14,547,3381,396,5423,151
18698,83,1686,2809,1173,12163,513
25812,8,272,2454,202,3432,70
32698,52,2084,2103,1518,18096,566
18227,174,13387,2829,9695,81626,3692
26034,0,25,2444,25,2578,0
20329,7,389,2730,310,8984,79
36953,54,915,1886,729,10209,186
33492,11,177,2071,150,5258,27
39206,22,856,1737,613,14159,243
26948,5,288,2403,207,11977,81
21939,5,148,2638,113,3454,35
15244,1,432,2974,409,7386,23
19879,391,23696,2754,14256,105412,9440
39721,0,77,1707,61,5450,16
45932,10,230,406,163,5794,67
19848,43,2255,2755,1758,52930,497
18838,2,247,2803,198,3703,49
35360,265,20046,1988,7268,99071,12778
41021,0,23,1604,23,1635,0
25280,0,3170,2479,2386,29363,784
21268,2,74,2674,67,3489,7
16823,56,4072,2898,2213,18208,1859
15921,24,1003,2944,783,16674,220
13444,143,5947,3097,3929,56386,2018
27949,33,2835,2346,1105,19658,1730
35936,20,1008,1946,775,9816,233
29566,36,1510,2259,764,12789,746
24305,120,7362,2522,4861,31518,2501
45652,8,117,521,110,5115,7
30826,7,225,2194,128,4247,97
23881,1,122,2542,101,4496,21
40484,60,1266,1651,1068,8761,198
18995,11,724,2797,457,6899,267
33146,0,21,2084,17,2370,4
41234,30,885,1575,671,17289,214
26943,21,765,2403,604,31321,161
35934,2,56,1946,45,2829,11
16217,216,7307,2930,5495,27087,1812
30961,1,102,2189,79,2869,23
39512,6,297,1720,228,8182,69
30816,267,6688,2194,4863,41578,1825
15446,313,20327,2965,13712,97024,6615
22961,365,26904,2585,15882,107628,11022
34713,61,1876,2023,1382,49899,494
13164,7,581,3118,536,10044,45
28536,3,145,2312,122,3832,23
17886,14,616,2846,382,9304,234
17918,4,411,2845,306,3497,105
35659,30,1120,1966,801,15190,319
23580,27,754,2556,539,6033,215
44780,171,1987,806,1748,28340,239
34136,22,416,2049,340,7288,76
28573,7,320,2310,277,11924,43
12269,45,1331,3179,1135,13996,196
16812,28,1080,2898,801,11305,279
30631,223,7581,2203,4948,38599,2633
24355,17,608,2520,501,17378,107
37385,519,16845,1859,6464,110812,10381
28065,82,2360,2340,1718,32515,642
25773,9,615,2456,399,14256,216
23814,17,546,2545,389,4298,157
32383,145,3278,2116,2843,18819,435
28061,66,7912,2340,5712,20016,2200
42608,0,0,1331,0,2150,0
44921,15,330,764,197,5983,133
19529,891,88627,2772,42156,377746,46471
35219,49,2909,1995,2270,26087,639
35944,65,2411,1946,1907,31783,504
31276,52,1389,2173,1117,19940,272
35544,27,1075,1975,748,10558,327
15013,33,3152,2986,1205,17074,1947
40057,24,394,1685,312,7711,82
26198,0,36,2437,20,1798,16
39908,1,52,1695,40,4522,12
42647,12,287,1323,207,7641,80
32924,3,77,2093,67,3210,10
42077,88,2528,1438,1960,37762,568
15086,26,3224,2982,2350,21792,874
38614,64,1895,1774,1469,27019,426
32840,59,4532,2097,3415,45459,1117
18422,1,129,2821,102,3685,27
26350,1,159,2430,136,2608,23
39319,27,605,1729,426,8305,179
14619,42,3807,3011,3155,68430,652
36214,4,84,1928,72,2707,12
39554,6,192,1717,134,3296,58
11261,747,52132,3229,32952,153333,19180
19020,3,95,2796,84,3709,11
26940,15,607,2403,420,7038,187
45061,35,322,718,264,5728,58
44724,16,131,825,108,4095,23
28255,28,1209,2329,841,8835,368
41881,33,566,1470,380,16566,186
26043,2,352,2444,96,2719,256
41594,37,509,1522,411,20605,98
12296,6,449,3177,435,7424,14
35324,231,4719,1989,3714,17819,1005
15996,0,36,2940,30,3001,6
13643,3,166,3084,133,4130,33
40996,3,207,1606,127,7219,80
41068,52,1540,1597,976,17009,564
37719,54,4160,1838,3185,27045,975
38146,16,666,1808,541,10348,125
45534,117,1742,568,1375,26251,367
16321,44,2221,2924,1601,25934,620
36896,22,393,1890,296,6166,97
15207,2,113,2975,112,5116,1
40770,4,124,1625,101,8997,23
13851,3,120,3067,95,3372,25
40251,2,97,1673,80,7642,17
37768,17,983,1834,704,9483,279
31315,8,183,2171,147,10154,36
21851,24,1160,2643,973,25938,187
38313,325,6174,1796,4437,27763,1737
28563,70,2164,2310,1351,21903,813
32120,17,888,2128,678,11034,210
29378,59,2067,2268,1661,16342,406
9513,20,1043,3319,1020,23062,23
37966,3,127,1819,87,3875,40
16988,355,35740,2890,15584,150024,20156
31522,2,219,2159,166,7141,53
14036,46,2555,3051,1621,17251,934
36715,182,7892,1901,5330,50360,2562
32075,5,150,2131,110,3822,40
44362,30,572,895,401,12782,171
41489,91,1981,1536,1552,25111,429
32699,292,12299,2103,8775,99684,3524
20253,4,119,2732,107,2865,12
46151,0,5,314,5,861,0
13134,15,754,3127,541,7456,213
35573,0,37,1974,36,2637,1
16949,5,197,2892,174,5466,23
17905,41,5790,2845,2196,39989,3594
38233,251,6574,1802,3902,56574,2672
29510,2,82,2261,65,4735,17
14486,6,130,3020,112,9316,18
41250,41,1389,1572,1041,13883,348
26044,4,135,2444,114,4555,21
39681,177,9635,1709,5113,41383,4522
19945,8,764,2750,587,10811,177
26978,0,0,2402,0,36134,0
41854,51,465,1476,372,6965,93
13098,73,2988,3130,2522,32900,466
25265,20,563,2480,408,7736,155
32656,9,279,2105,236,5135,43
16937,352,35300,2892,10337,193600,24963
30000,494,11227,2238,6530,48807,4697
30790,65,4585,2195,926,49876,3659
34576,99,4154,2031,1847,25657,2307
19345,25,929,2781,764,9763,165
19844,1,131,2755,113,9972,18
38994,22,735,1751,613,9037,122
24106,15,362,2531,280,5558,82
40567,5,121,1643,90,3447,31
15696,2,233,2953,185,6221,48
45515,43,458,574,354,10323,104
14082,1,150,3048,70,3592,80
15976,16,708,2942,450,4795,258
28965,22,1205,2290,981,19676,224
15525,18,1670,2961,825,14958,845
30901,492,12125,2191,7891,70893,4234
35565,21,1469,1975,506,8337,963
40635,19,344,1638,279,5973,65
28948,10,553,2291,302,7797,251
16161,3,250,2932,167,3542,83
40862,48,889,1616,652,18302,237
11633,8,508,3211,448,11815,60
43737,27,432,1004,347,7574,85
8877,65,2023,3359,1872,11846,151
15623,6,711,2956,544,30770,167
28916,98,6880,2293,5170,17090,1710
35192,36,820,1997,616,3901,204
46019,4,127,369,83,2583,44
32465,8,438,2113,349,6017,89
25934,12,957,2449,760,5285,197
9058,92,5391,3349,4656,27714,735
32863,6,326,2096,265,5085,61
26951,6,127,2402,122,4046,5
16992,4,205,2890,136,2299,69
45111,239,2976,692,1934,16559,1042
11323,71,2862,3227,2401,20425,461
25178,59,2074,2482,1610,10241,464
17354,7,458,2869,292,4148,166
29301,56,1583,2272,841,5562,742
23861,17,462,2543,298,3679,164
23851,11,240,2543,184,5002,56
18249,68,1805,2828,1249,21260,556
17904,27,876,2845,640,7040,236
35456,6,377,1983,281,10210,96
32927,15,301,2093,239,2766,62
43094,6,298,1205,200,7583,98
16746,591,38389,2903,24588,177758,13801
25733,17,1102,2458,914,20234,188
33802,58,836,2059,701,8884,135
31530,80,1998,2159,1606,10374,392
44730,44,500,823,447,11504,53
12856,7,574,3145,472,6165,102
16851,71,4117,2897,3185,22921,932
32147,5,137,2127,96,3562,41
36259,2,60,1925,42,3662,18
33119,20,278,2085,229,3896,49
33618,146,2905,2067,1973,22940,932
27356,14,573,2382,433,8303,140
14595,29,1486,3012,1411,11524,75
21071,3,210,2687,169,5800,41
14159,173,9991,3045,7345,74206,2646
29666,9,472,2254,299,11794,173
22189,8,724,2624,594,9409,130
16129,26,1076,2933,741,7944,335
26731,8,348,2413,255,4803,93
26266,0,3303,2434,2467,36415,836
33199,109,5968,2082,3842,56764,2126
44134,23,173,933,153,11850,20
27897,4,155,2350,121,4211,34
23633,105,1929,2553,1430,20105,499
16657,213,15510,2908,8977,139454,6533
3117,2036,210633,3639,101746,1070919,108887
43168,2,84,1184,57,2593,27
8852,16,1305,3360,1014,24506,291
30024,0,54,2237,47,8349,7
35508,15,202,1978,174,3119,28
23390,13,345,2565,285,3773,60
36695,3,284,1902,203,7528,81
13720,144,7211,3077,5119,57249,2092
27622,8,161,2365,117,7155,44
19749,89,3729,2761,2910,29999,819
19656,3,345,2766,261,6602,84
36755,10,250,1899,166,3073,84
41605,19,809,1519,513,23180,296
18189,0,167,2831,129,5014,38
17194,55,1276,2877,988,9977,288
1191,14,333,3903,257,6981,76
22763,28,1581,2596,1139,14806,442
12332,15,554,3175,458,4063,96
34072,80,2162,2051,1527,15669,635
33104,12,516,2086,400,4640,116
32505,47,1183,2111,942,13281,241
46077,84,1852,338,911,13829,941
45583,10,136,551,68,2194,68
23569,3,155,2556,125,5107,30
35089,0,40,2002,32,2339,8
39675,12,174,1710,153,4276,21
25509,57,2803,2469,1999,30896,804
12783,3,116,3150,106,2221,10
25951,20,467,2448,364,8301,103
8394,102,7166,3389,3901,28904,3265
40974,1,75,1608,51,3392,24
38918,28,255,1756,200,3517,55
12853,7,955,3145,942,26657,13
22321,6,131,2618,92,5754,39
16533,1160,61020,2914,38760,145261,22260
13162,80,3596,3118,2939,34412,657
20616,87,6352,2715,4410,32471,1942
41852,57,2162,1476,1491,23980,671
23608,8,465,2554,344,10768,121
17270,16,801,2873,631,10059,170
44201,0,33,919,24,4429,9
14043,221,36083,3051,15265,156667,20818
17217,9,1209,2876,444,15206,765
31547,40,835,2158,640,8066,195
25367,78,1245,2475,962,15642,283
22610,1,49,2603,36,1736,13
46113,7,165,332,75,2421,90
27660,0,1296,2363,1014,15340,282
40431,16,431,1656,321,8978,110
30058,73,6655,2235,3316,31726,3339
33040,4,77,2089,61,2590,16
32265,115,2831,2121,2148,18055,683
17531,159,7475,2860,5425,41350,2050
24156,14,542,2529,377,4776,165
20285,8,441,2730,288,5962,153
24740,3,109,2501,77,3596,32
8702,50,1913,3369,1884,22732,29
23907,21,599,2541,444,4466,155
39006,51,1437,1750,1062,17091,375
13329,503,127568,3107,95748,163000,31820
22226,442,20548,2621,10651,127881,9897
45966,32,257,392,252,5369,5
28039,5,200,2341,101,13617,99
4805,1033,63218,3590,58086,238746,5132
42115,52,1894,1432,1449,30457,445
19758,8,243,2760,204,5706,39
31139,11,303,2180,244,8476,59
24287,5,264,2523,205,12313,59
37388,0,52,1859,40,3718,12
35907,89,2503,1948,1860,22175,643
23615,59,1862,2554,1117,14064,745
31272,96,4530,2173,2012,36898,2518
21577,27,1557,2657,1173,15203,384
40907,30,1303,1612,954,14686,349
17944,9,265,2843,220,10024,45
33350,0,28,2077,25,1499,3
15698,9,556,2953,443,9945,113
26195,4,185,2437,169,5501,16
28529,32,1467,2312,1170,10449,297
37478,8,231,1853,149,4326,82
23628,314,5928,2553,5127,25351,801
17805,4,164,2850,124,3797,40
24539,11,341,2511,190,4684,151
18649,0,0,2811,0,1320,0
24947,0,10,2492,7,3280,3
31332,23,611,2170,497,13071,114
19145,16,392,2791,280,6250,112
16034,8,363,2938,295,6772,68
21700,11,640,2650,498,8957,142
43093,9,153,1205,82,2607,71
15147,62,4182,2978,3466,41891,716
36694,11,220,1902,182,5267,38
27163,14,427,2394,345,22047,82
28927,3,104,2292,90,4032,14
37045,1,90,1880,73,2867,17
23921,10,527,2540,414,8853,113
44239,5,55,914,41,3653,14
44920,1,30,764,25,2347,5
2857,393,240097,3644,17004,84152,223093
43046,20,277,1221,226,3049,51
44138,8,130,932,86,3963,44
30492,29,1070,2211,836,9449,234
28842,5,1093,2295,598,21306,495
38043,47,1417,1815,995,24014,422
33867,2,79,2057,64,2261,15
26192,42,681,2437,559,8473,122
18566,95,2482,2815,1735,25365,747
24405,24,1165,2518,919,7855,246
44093,48,1474,930,588,9363,886
45290,26,322,633,307,7191,15
26913,5,228,2404,200,2523,28
18183,4,132,2831,99,3744,33
41823,8,255,1479,209,5942,46
12997,1346,67131,3136,32570,548683,34561
38016,50,1568,1817,1202,18876,366
31010,12,517,2187,364,6914,153
21439,10,233,2665,188,4319,45
28594,26,1364,2308,1110,19233,254
42767,6,166,1295,111,8020,55
25797,8,538,2455,451,4161,87
1036,8,153,3954,124,5698,29
37102,16,653,1877,498,14963,155
45320,232,2426,625,2240,26794,186
38710,2,130,1768,119,9530,11
1209,8,345,3899,304,11562,41
39208,69,3511,1737,2780,19717,731
43649,21,349,1032,239,4564,110
36537,55,723,1911,553,6222,170
29983,0,1160,2239,932,25995,228
22276,17,1083,2619,802,12343,281
32782,117,4099,2100,3189,32556,910
33623,10,738,2067,409,10116,329
38236,27,531,1801,432,8242,99
41331,38,1200,1559,926,20016,274
4363,88,9870,3606,3893,17298,5977
39215,434,8336,1736,5396,45924,2940
39403,128,3614,1725,2842,41358,772
16932,414,39266,2893,20239,272927,19027
29110,2,147,2282,105,6702,42
22503,177,15069,2608,8602,80497,6467
30511,50,1172,2209,956,22287,216
26320,1,89,2432,68,4352,21
20737,0,101,2709,70,2801,31
28363,0,141,2323,107,3350,34
28670,0,85,2305,72,3144,13
43471,41,944,1096,616,13710,328
27608,0,36,2366,34,2443,2
24370,2,105,2520,90,10674,15
2867,30,2804,3643,2615,17142,189
19086,548,46506,2793,22277,243348,24229
24107,11,518,2531,432,8541,86
11473,193,11210,3219,8636,63577,2574
42814,14,173,1282,115,4089,58
39641,41,1230,1712,980,21521,250
30214,40,1493,2227,1079,20175,414
30384,4,107,2217,76,2512,31
31533,9,283,2159,169,4159,114
17179,55,1397,2878,1071,12957,326
34790,8,1546,2018,507,10851,1039
31803,7,169,2145,157,3015,12
37418,31,426,1857,268,4490,158
16632,40,1447,2910,1137,6537,310
37731,20,2006,1837,485,11071,1521
22249,38,844,2620,556,6856,288
42721,4,448,1307,296,16924,152
10737,35,2102,3257,1917,21531,185
25793,295,19763,2455,14787,91719,4976
40263,17,394,1672,326,7653,68
45003,30,340,741,275,7057,65
14992,5,186,2987,161,3311,25
17574,3,218,2858,125,4522,93
23659,1,66,2551,48,3678,18
27766,9,551,2357,450,10572,101
11891,3232,238833,3198,107605,420086,131228
23813,29,1657,2546,1182,15490,475
14054,36,2279,3050,1949,70618,330
41405,6,149,1548,115,7971,34
34612,48,1439,2029,871,11560,568
31222,18,421,2176,199,5539,222
23908,29,1414,2541,551,9298,863
29726,6,274,2251,127,11269,147
31777,4,198,2146,146,7946,52
16813,10,312,2898,222,5879,90
31134,3,326,2180,197,5059,129
12149,387,18098,3185,11607,79176,6491
29792,6,370,2248,257,6206,113
19859,0,142,2754,110,3263,32
17872,0,122,2847,65,3747,57
15723,34,1635,2951,1246,15735,389
21166,43,2386,2680,1740,30334,646
7317,243,13094,3467,12741,66502,353
20251,45,2914,2732,1940,9214,974
17227,4,226,2875,164,2994,62
32966,9,888,2092,430,9097,458
43129,156,4343,1196,2301,22888,2042
39800,5,94,1703,65,8007,29
36170,2,382,1929,287,6656,95
39545,4,142,1717,113,7862,29
43508,10,253,1084,125,6930,128
21849,8,309,2643,240,17026,69
16055,207,6877,2937,5431,35132,1446
41311,52,506,1562,306,7007,200
24516,214,4852,2512,3417,21089,1435
37085,5,197,1878,165,4039,32
40833,43,1542,1619,1114,15777,428
36008,8,1455,1940,258,7483,1197
32958,38,710,2092,611,11865,99
15726,14,1511,2951,866,16885,645
14346,315,7014,3030,5146,39252,1868
40302,32,576,1670,401,13601,175
11750,163,7324,3204,6516,58282,808
45155,0,120,675,75,3410,45
45078,7,93,711,85,3066,8
17764,2,391,2851,270,3378,121
15153,9,235,2978,187,5309,48
11422,31,1636,3222,1520,13093,116
25983,3,501,2447,399,28096,102
18199,24,2311,2831,1826,33872,485
27496,2,216,2373,156,3384,60
45262,11,249,642,231,7171,18
46182,8,110,299,93,3605,17
11246,7,3300,3230,1847,18258,1453
29293,0,41,2273,31,3813,10
12803,44,4999,3149,2887,47212,2112
34336,4,141,2042,118,2016,23
19372,0,42,2780,32,1639,10
14163,67,3004,3045,2707,12663,297
40566,95,2025,1643,1583,12151,442
17998,12,703,2839,566,5972,137
40157,118,5939,1680,4134,53261,1805
33235,8,221,2081,155,6340,66
25748,51,1094,2457,827,8370,267
9376,164,12741,3328,6723,63486,6018
33384,44,1278,2076,928,10515,350
38955,408,14155,1753,9295,98823,4860
16963,49,1813,2891,1199,18156,614
24553,1,296,2510,181,5672,115
24688,15,662,2504,491,6967,171
41824,20,825,1479,552,18238,273
29041,15,661,2286,546,8711,115
25605,2,178,2464,123,7344,55
22127,2,47,2626,42,2004,5
25438,7,120,2472,106,2969,14
27972,333,11585,2345,8939,73637,2646
15936,9,929,2944,412,7718,517
40597,5,429,1641,341,10932,88
39442,1,45,1723,40,4270,5
35776,0,14,1957,14,2710,0
15581,332,28122,2958,16616,168806,11506
26796,32,675,2409,530,5616,145
14248,67,3158,3039,2808,34230,350
42823,4,136,1281,98,7669,38
41984,2,147,1454,110,5331,37
32757,2,120,2101,68,2918,52
8811,40,2783,3362,2679,24669,104
29242,19,495,2276,326,5119,169
17295,13,434,2872,366,3046,68
28226,9,149,2331,116,4229,33
38302,1,64,1797,56,4632,8
36922,2,33,1888,27,2533,6
46027,30,414,366,332,7788,82
20956,45,1724,2694,1394,12871,330
32167,11,119,2126,91,2639,28
9962,146,8474,3297,8225,45554,249
23257,44,2241,2572,1649,21593,592
27040,31,646,2400,496,7274,150
36348,29,397,1920,328,5515,69
38883,3,203,1757,152,6274,51
39796,15,605,1703,461,5190,144
30228,0,44,2226,37,1594,7
15920,7,259,2944,211,5580,48
39096,196,10564,1744,6939,48573,3625
38525,17,447,1781,322,9678,125
28419,1,37,2320,34,3283,3
28186,127,4756,2333,2426,31314,2330
20184,200,11633,2736,4914,60546,6719
18700,70,2552,2809,1886,17614,666
40554,11,232,1644,182,4263,50
38114,17,685,1810,515,10752,170
44009,37,258,953,211,4679,47
4721,135,5716,3593,5641,123943,75
16694,1,108,2906,63,4503,45
15850,2,46,2947,42,2590,4
29351,3,106,2269,89,2182,17
17093,4,275,2883,239,4738,36
5296,27545,1528486,3563,695771,4565312,832715
16439,18,403,2918,316,10874,87
40673,27,648,1635,382,9791,266
11198,0,248,3232,241,4093,7
20628,75,2309,2714,1642,9781,667
15613,6,352,2956,249,10354,103
46428,6,96,200,71,3390,25
36089,17,709,1934,553,16258,156
11434,829,43883,3221,39534,151343,4349
9424,1063,52342,3325,38788,167990,13554
13707,326,17970,3079,9221,68477,8749
26694,12,606,2414,496,9365,110
40603,5,99,1640,78,1661,21
32179,4,33,2125,33,3877,0
18114,0,95,2834,76,2437,19
32166,10,705,2126,541,11776,164
45955,20,441,395,339,7240,102
25504,0,306,2469,229,4032,77
34344,3,354,2042,258,6114,96
18083,10,512,2835,439,5640,73
31021,2,96,2186,79,5017,17
11086,135,5465,3239,4333,32494,1132
35097,416,24425,2002,12399,98752,12026
42459,38,710,1360,555,16892,155
4431,9862,652270,3604,402860,2366235,249410
23680,32,957,2550,541,9331,416
45482,69,1119,584,1005,9344,114
42741,3,146,1300,126,9557,20
41656,27,959,1512,706,20449,253
23059,19,432,2581,338,4413,94
44119,10,183,935,169,5329,14
42567,6,109,1339,86,8253,23
20119,390,33141,2740,12222,139375,20919
36678,6,171,1903,139,7657,32
28390,10,561,2321,312,9852,249
27101,57,4311,2398,1608,30558,2703
19452,144,8890,2775,5635,53940,3255
41858,2,144,1474,110,2630,34
37185,28,1163,1872,911,17190,252
41496,21,1049,1535,593,17596,456
38359,6,84,1792,55,7696,29
9336,29,1153,3331,992,6281,161
13840,2,141,3068,129,4899,12
28092,16,3255,2339,598,15441,2657
28361,16,270,2323,232,5851,38
46017,6,74,369,49,3126,25
26247,70,3706,2435,2842,47938,864
28418,1,249,2320,202,4321,47
40958,2,153,1609,117,5431,36
45931,139,3651,406,2624,21037,1027
24717,8,1306,2502,885,6436,421
25646,41,1833,2461,1486,15836,347
36716,5,472,1901,141,8722,331
39872,163,3319,1698,2848,37521,471
28882,17,399,2294,346,3541,53
16453,2,63,2918,55,3495,8
16760,2,0,2902,0,4305,0
26928,136,7801,2404,6346,55250,1455
29799,6,265,2248,208,5861,57
33845,30,691,2058,594,14823,97
14092,68,4127,3047,3567,48973,560
10366,3,164376,3279,161,4873,164215
6344,16,1087,3515,1080,6340,7
30997,3,51,2187,40,4373,11
38934,0,59,1754,53,3705,6
9286,5,220,3335,220,6679,0
28874,154,27386,2294,3444,62406,23942
15860,14,440,2946,347,7098,93
22789,16,1283,2595,1034,12247,249
43714,32,187,1011,179,2990,8
17868,18,512,2847,447,8621,65
18942,50,1988,2799,1608,8378,380
11084,327,20815,3239,10087,60089,10728
24468,5,266,2515,225,3226,41
18388,4,87,2822,71,4870,16
33977,30,1318,2054,359,5770,959
33517,3,68,2070,61,2534,7
31185,17,453,2177,219,5031,234
42993,7,215,1237,169,12069,46
21795,57,3538,2645,1819,31900,1719
16954,3,81,2892,67,3614,14
28090,11,1006,2339,642,24526,364
35280,28,632,1991,522,7354,110
20867,202,10338,2700,3762,123871,6576
36389,262,4611,1918,2778,25960,1833
41261,62,806,1570,583,9853,223
39053,3,51,1747,39,3440,12
36192,14,399,1928,304,9541,95
21480,633,34717,2663,25637,155941,9080
44936,42,333,762,278,6315,55
45374,8,239,611,116,4385,123
13669,41,841,3082,805,8401,36
24510,29,1435,2513,1065,13771,370
25257,23,707,2480,510,5718,197
34110,96,1280,2050,1096,11550,184
21155,0,120,2681,100,2324,20
12124,1,205,3187,204,4345,1
38476,2,189,1785,155,7048,34
28946,9,483,2291,162,4053,321
14667,40,2215,3008,1128,23543,1087
15218,14,255,2975,246,3866,9
42845,15,791,1276,414,11057,377
30452,10,511,2213,419,14452,92
21099,0,432,2686,372,10884,60
12170,15,1534,3184,1359,20208,175
44687,12,222,838,160,4142,62
23102,32,7068,2579,2530,82777,4538
43621,38,1114,1042,982,20476,132
28432,266,8301,2319,6276,41681,2025
17695,14,456,2854,364,3252,92
40678,2,56,1634,35,8243,21
28273,43,1220,2328,937,16499,283
29466,4,266,2263,194,4475,72
31088,13,219,2183,147,3633,72
19278,23,825,2784,663,31627,162
22921,6,545,2587,442,6834,103
26568,12,470,2420,384,7350,86
30389,2,67,2216,59,2336,8
31835,223,5009,2143,3042,32977,1967
35090,85,4388,2002,3005,42442,1383
33855,5,159,2058,133,9777,26
29214,419,83956,2277,13324,310152,70632
39158,132,3962,1740,2866,34569,1096
23647,0,0,2552,0,6296,0
25079,114,3521,2487,2383,27405,1138
16744,81,3348,2903,2119,48057,1229
41744,11,160,1497,129,6002,31
45298,15,118,632,114,1887,4
37434,42,626,1856,461,12265,165
26481,4,361,2424,316,4529,45
20151,7,326,2738,275,7821,51
21383,9,528,2669,422,6403,106
31520,21,1081,2159,889,8397,192
24967,0,68,2492,48,5035,20
21375,13,499,2669,414,3081,85
27469,26,610,2375,375,5816,235
46330,2,47,250,44,2912,3
41401,20,382,1549,280,8032,102
44881,10,85,776,73,2975,12
15011,114,9961,2986,6222,51324,3739
43090,45,1209,1207,644,18932,565
30261,57,1523,2225,1165,13511,358
46006,6,129,374,109,3593,20
29514,3,922,2261,732,25216,190
16824,318,24457,2898,16947,183868,7510
30156,8,195,2231,181,6990,14
21738,88,6301,2648,4284,55580,2017
23960,36,1566,2538,911,11323,655
26937,3,263,2403,217,6156,46
43614,1,67,1044,54,7188,13
35985,67,521,1942,436,5221,85
39569,5,281,1716,134,6525,147
32941,20,571,2093,343,9306,228
45342,136,1306,620,1162,14596,144
33888,369,10168,2057,7855,85099,2313
27110,237,12878,2397,9342,100880,3536
21186,93,8926,2679,6778,39040,2148
45341,81,1055,620,678,11399,377
13948,227,6824,3058,4473,23665,2351
23416,0,103,2563,82,9572,21
20990,10,996,2691,786,4927,210
17512,1,44,2861,33,2357,11
35534,20,576,1976,330,3757,246
16289,45,1335,2926,1055,10409,280
13157,6,81037,3118,176,5077,80861
15053,11,288,2983,270,4358,18
37515,58,2487,1851,1741,43922,746
33442,5,442,2073,252,9583,190
17340,10,501,2869,393,15282,108
33372,3,70,2076,67,5486,3
28991,5,326,2288,261,14415,65
19301,36,959,2783,766,9354,193
2726,105,9004,3646,3910,59021,5094
44516,11,123,875,83,3987,40
1234,10,677,3895,551,12449,126
25537,0,60,2468,47,2401,13
40730,198,7629,1630,5275,66403,2354
40918,20,626,1612,421,12228,205
20468,23,661,2723,423,13887,238
39122,3,265,1742,190,6546,75
39926,75,841,1694,626,7469,215
29765,1,228,2249,99,3838,129
31415,10,857,2166,545,16105,312
16064,9,510,2936,297,3783,213
34291,28,542,2044,392,4483,150
28132,42,1465,2337,524,8664,941
25846,45,1492,2453,1154,14053,338
22588,3,173,2604,143,3238,30
41602,11,325,1520,231,7968,94
20066,3,159,2743,129,7273,30
19069,4,123,2794,103,1852,20
24262,3,443,2525,360,15582,83
32324,9,463,2119,350,7261,113
24197,241,16743,2527,8807,137833,7936
41697,40,1661,1506,1127,20316,534
7617,18,266,3449,237,10210,29
23002,22,655,2584,515,9684,140
22083,108,9358,2629,4195,36665,5163
43499,5,127,1086,114,4080,13
17168,21,1934,2878,1564,18335,370
24847,181,5957,2497,4178,32489,1779
45465,13,156,588,90,4367,66
35308,82,745,1990,590,5858,155
36821,5,86,1894,72,3107,14
29585,29,2206,2258,1681,24110,525
28851,30,1955,2295,490,11010,1465
39633,25,295,1712,267,4993,28
22568,1,88,2604,76,2083,12
26107,6,354,2442,183,5098,171
31706,5,325,2150,227,8640,98
33369,14,1727,2076,1310,18183,417
27866,159,5220,2352,3814,29675,1406
31265,102,2308,2174,1907,21544,401
44076,169,3009,943,2316,26254,693
44853,12,207,782,152,9276,55
24396,2,103,2518,90,1596,13
7989,143,8722,3418,8499,117506,223
24638,16,789,2505,599,11349,190
29427,23,692,2266,574,8638,118
29858,7,326,2244,135,2590,191
22570,11,1008,2604,665,19903,343
45258,77,815,645,635,19813,180
29622,15,546,2256,298,8064,248
45618,23,214,540,185,6566,29
39179,11,264,1739,224,5073,40
18205,8,308,2831,253,5142,55
44883,16,158,776,123,3363,35
30103,2,99,2233,85,6652,14
41038,2,49,1602,37,5557,12
33549,4,387,2069,310,5748,77
23568,30,1615,2556,1234,19617,381
31907,3,167,2140,126,8803,41
41534,76,987,1531,756,11382,231
39150,0,36,1740,26,1836,10
42744,46,434,1299,327,7161,107
20437,9,495,2724,383,5135,112
43084,36,741,1208,515,15138,226
21048,8,239,2688,187,8869,52
23505,36,1281,2559,735,18156,546
41847,16,670,1476,489,11739,181
33912,7,177,2056,146,4689,31
33237,8,260,2081,188,5743,72
7319,340,16651,3467,15134,50065,1517
41691,0,0,1507,0,2305,0
38331,7,169,1795,135,5284,34
11581,359,15071,3213,12452,47016,2619
38074,13,317,1813,230,6413,87
45434,3,65,596,47,2306,18
36050,15,386,1937,335,13326,51
31241,8,98,2175,91,5247,7
42452,1,54,1362,41,7263,13
42405,28,491,1373,308,8941,183
23975,26,996,2537,684,17324,312
46177,1,27,301,25,1401,2
43071,4,117,1214,83,2976,34
12414,1,82,3169,80,2741,2
37210,2,87,1870,46,5607,41
41228,81,1726,1576,1255,23470,471
23947,326,30375,2538,14464,127871,15911
36843,36,950,1892,775,12891,175
21270,13,577,2674,440,5055,137
44809,8,65,798,58,2136,7
44203,15,222,918,181,4973,41
28415,2,80,2320,72,4374,8
24795,76,5303,2500,2647,32343,2656
41315,150,3325,1561,2127,47352,1198
30923,2,142,2190,121,7565,21
20308,2,41,2730,27,4345,14
38025,5,336,1817,269,6744,67
35679,86,1688,1964,1286,19578,402
9333,802,27824,3331,23997,98363,3827
46437,41,1237,197,779,12028,458
34600,65,2315,2030,1317,27882,998
27388,2,129,2379,107,3936,22
33280,43,1511,2080,871,9127,640
32243,14,448,2122,282,5388,166
14902,19,815,2992,649,13860,166
25110,2,103,2485,80,4420,23
20827,42,2149,2702,1644,23607,505
37700,55,1195,1839,945,12998,250
29122,4,259,2281,226,4956,33
21713,64,3197,2649,2719,20027,478
32358,1,35,2117,32,1618,3
34528,27,2055,2033,1603,19781,452
17573,179,10968,2858,7461,72729,3507
13853,615,17399,3067,12818,122624,4581
30852,2,124,2193,99,5549,25
43548,117,2690,1070,1784,32716,906
21721,315,15791,2649,7084,69474,8707
30797,19,647,2195,533,14328,114
19612,0,556,2768,414,8611,142
31577,0,105,2157,82,5436,23
44111,0,40,935,29,2082,11
32850,2,117,2096,92,4932,25
45096,505,13072,700,4855,43195,8217
21640,92,1989,2654,1619,8456,370
19219,7,1080,2788,460,7945,620
38090,137,7508,1812,2709,39914,4799
3570,274,11746,3630,10153,58200,1593
11109,19,482,3238,442,11122,40
20937,29,4732,2695,2516,24061,2216
17285,38,2312,2872,1177,25631,1135
38865,109,2119,1759,1570,23258,549
37702,13,341,1839,207,4156,134
34296,0,43,2044,35,2366,8
34944,5,383,2010,305,7698,78
27176,14,382,2393,320,2350,62
42822,23,462,1281,390,22710,72
15275,51,1795,2972,1414,16126,381
20569,7,174,2717,145,2900,29
37217,91,1744,1869,1046,23595,698
26537,0,67,2421,58,1922,9
22148,5,308,2625,170,3380,138
26020,213,7927,2445,6139,81291,1788
22050,2,66,2631,56,3297,10
44771,7,177,809,124,3831,53
20825,41,1988,2702,1601,38550,387
28174,75,739,2334,582,6056,157
36833,26,667,1893,531,10955,136
42534,2,91,1345,67,5180,24
12363,66,1780,3173,1461,13064,319
30294,13,446,2223,342,10224,104
44897,14,250,772,243,5603,7
35746,59,1275,1960,994,14449,281
42780,1433,28420,1291,15719,356209,12701
19496,101,4766,2773,3692,32167,1074
26495,4,190,2423,171,4775,19
45093,68,825,701,701,9573,124
23286,0,141,2570,102,2873,39
16003,17,786,2940,598,6806,188
13524,28,883,3092,758,5417,125
40948,83,1497,1609,1173,18042,324
44207,25,126,918,120,3579,6
28899,23,1719,2293,1071,10490,648
34668,30,349,2025,289,5011,60
24643,70,5741,2505,3578,47399,2163
42544,5,93,1342,73,7689,20
26257,8,286,2434,206,5440,80
42907,3,86,1261,62,6229,24
32026,5,120,2134,88,3132,32
40691,10,190,1633,141,4143,49
45886,24,125,429,113,2741,12
36034,2,55,1939,46,3820,9
36327,19,602,1922,448,7837,154
44849,6,67,783,59,2348,8
40488,4,71,1650,53,2899,18
20265,69,2400,2731,1963,10460,437
18802,14,859,2804,552,7356,307
43118,6,204,1199,127,2484,77
16982,3,174,2890,81,3150,93
40001,66,763,1688,611,5741,152
28446,33,1391,2318,874,10603,517
17318,15,769,2871,492,18861,277
20030,25,684,2745,537,3454,147
25012,134,4167,2490,3038,19771,1129
27046,30,819,2400,504,7008,315
42765,71,1022,1295,903,23542,119
17408,1,81,2865,69,2732,12
33784,1,69,2060,57,4386,12
43664,6,102,1026,65,4210,37
45498,7,71,580,41,2219,30
35572,59,536,1974,429,5464,107
20917,8,539,2696,346,5739,193
22799,2,123,2594,104,3165,19
40972,140,4739,1608,3005,57617,1734
27941,0,105,2346,90,5807,15
45521,231,2441,572,1797,18755,644
18474,40,3178,2819,1215,49660,1963
19865,31,1402,2754,1090,13174,312
38057,10,350,1814,189,5230,161
29310,3,71,2271,55,2179,16
16240,19,889,2929,628,7872,261
26783,111,1646,2410,1182,12693,464
40981,1,61,1607,56,5317,5
23189,41,1027,2575,803,14481,224
38055,39,555,1815,446,6897,109
36146,2,169,1931,133,7334,36
45957,16,111,395,99,2271,12
34582,46,1382,2030,943,11639,439
39969,21,1178,1691,567,13101,611
14001,20,597,3054,532,8910,65
16208,40,1393,2930,1141,16897,252
43586,11,210,1056,176,4758,34
22824,6,237,2593,187,3334,50
32251,8,267,2122,228,3955,39
29496,1,57,2262,36,2326,21
12343,6,243,3174,186,4692,57
34563,1,67,2031,55,2927,12
40924,1,29,1611,25,2339,4
27917,265,11626,2348,8680,87229,2946
28327,0,98,2325,50,3666,48
45802,90,985,458,683,11119,302
28986,19,560,2289,470,7577,90
16764,32,792,2902,641,8656,151
37294,3,248,1864,217,14063,31
41410,30,782,1548,559,12625,223
42813,97,2037,1282,1657,38061,380
39618,8,406,1713,332,11323,74
17052,10,375,2885,320,4810,55
43369,94,2151,1121,1590,31477,561
22160,2,121,2625,94,2605,27
43158,18,533,1187,373,9203,160
15314,24,792,2970,611,14394,181
38440,3,81,1787,74,2733,7
35143,1,72,1999,64,3144,8
20006,28,1608,2746,1253,9371,355
21384,59,2630,2668,1893,40610,737
42852,106,2239,1275,1388,10356,851
43166,448,9849,1186,5521,68963,4328
32592,2,186,2107,139,4197,47
39746,8,275,1706,212,4761,63
18454,2,173,2820,122,5103,51
18770,50,2707,2806,2080,15095,627
16082,0,76,2935,60,5291,16
13299,49,1108,3110,862,5818,246
40364,64,3171,1662,1988,33133,1183
30757,91,1936,2197,1612,19405,324
42934,0,24,1252,13,2478,11
16170,17,1361,2932,1013,33471,348
21016,2,76,2689,49,4156,27
28474,2,82,2317,38,3240,44
32375,26,1115,2116,819,14781,296
24758,5,243,2501,183,4953,60
37812,10,702,1831,591,13380,111
33153,0,108,2084,87,3564,21
38718,4,81,1768,70,3641,11
33797,60,2279,2060,1724,29758,555
12051,13,1007,3191,727,5401,280
36836,0,0,1892,0,46990,0
21847,58,1943,2644,1534,19809,409
38260,8,266,1800,226,4982,40
42713,28,456,1309,287,7996,169
10568,607,43389,3268,24831,244323,18558
18408,268,17479,2821,13038,122600,4441
22880,26,951,2590,572,4467,379
35922,2,250,1947,205,8389,45
30351,23,368,2219,264,3499,104
19596,12,1658,2769,1093,24823,565
20670,388,28073,2712,18929,177146,9144
36690,33,675,1903,589,18333,86
15785,151,9919,2949,5606,68821,4313
30479,5,69,2212,56,2970,13
46248,5,133,283,56,1977,77
39598,25,1016,1714,763,16743,253
34978,32,1402,2008,1050,8430,352
15914,228,8270,2945,5904,37512,2366
37317,10,269,1863,238,6502,31
38886,73,1974,1757,1400,20856,574
43700,25,363,1015,336,6073,27
29556,6,126,2259,107,3073,19
45112,40,629,692,345,4515,284
42485,9,229,1354,142,5055,87
42381,258,6904,1377,3826,50626,3078
27521,316,6292,2371,4701,21601,1591
45891,3,40,427,35,1747,5
41107,38,324,1592,273,4634,51
38726,4,83,1767,67,2950,16
35005,27,919,2007,750,18835,169
34918,59,1680,2011,1025,11762,655
25781,4,252,2456,197,4711,55
43262,15,244,1157,187,7851,57
40857,13,212,1616,172,5302,40
44732,71,1115,822,803,11340,312
14692,96,6535,3006,4320,46719,2215
19384,95,3023,2779,1693,17176,1330
22311,7,500,2618,422,11170,78
35379,23,1663,1987,1171,10265,492
43106,121,2076,1203,1304,24681,772
31733,2,227,2149,195,11894,32
8861,351,25926,3360,16524,113630,9402
15421,6,240,2966,191,5176,49
44877,16,95,777,94,2104,1
28145,0,72,2336,59,4177,13
33266,272,4382,2080,3449,31344,933
39998,0,63,1689,51,4862,12
38606,5,177,1774,141,5037,36
45850,7,97,442,66,3424,31
6696,570,26484,3500,22238,141404,4246
1844,505,30061,3662,26247,83794,3814
24532,2,446,2512,216,6015,230
38092,27,1493,1812,1157,24519,336
22119,276,18991,2626,10073,61204,8918
41145,24,620,1588,451,12454,169
14193,19,814,3042,676,9920,138
33522,3,219,2070,169,6339,50
36917,34,456,1888,359,8206,97
44941,24,154,759,153,6810,1
35530,66,1764,1976,1430,9750,334
31697,18,548,2150,376,7632,172
23772,7,324,2547,286,3533,38
29459,0,14,2264,12,1412,2
34659,71,1750,2026,1123,19889,627
43367,2,104,1125,67,4492,37
28647,56,1547,2306,1379,17316,168
39183,18,209,1739,181,4186,28
23443,3,194,2562,162,11484,32
34841,287,5874,2015,4126,36733,1748
35299,6,154,1991,112,1702,42
22196,26,1181,2623,937,15743,244
33124,16,715,2085,534,10093,181
11182,558,78189,3233,29245,229698,48944
21687,357,11311,2651,8216,63025,3095
37591,4,91,1846,75,2792,16
9878,35,2285,3302,2098,46124,187
1228,29,863,3897,708,8600,155
12943,47,1858,3140,1703,18187,155
42597,71,1749,1334,1167,19207,582
14316,106,4671,3032,3674,28957,997
27818,64,1599,2354,1237,15459,362
31847,9,621,2143,294,7392,327
3979,1308,70201,3620,50445,212018,19756
29547,0,0,2260,0,1440,0
18852,46,2168,2802,1662,21348,506
41257,35,789,1570,600,15274,189
35769,45,2186,1958,1085,21766,1101
11852,14,593,3200,482,8915,111
13848,65,4715,3068,3960,38202,755
25887,2,216,2451,186,4739,30
27207,43,1445,2391,1147,14859,298
35949,15,139,1945,123,3835,16
40225,2,141,1675,69,2474,72
30782,6,400,2196,292,11831,108
37061,66,1861,1879,1453,29642,408
30878,6,540,2192,377,5782,163
30494,6,215,2210,177,4185,38
28123,9,335,2337,280,5673,55
11666,103,6496,3209,4017,24158,2479
16319,5,281,2925,217,5078,64
42206,16,266,1411,213,10860,53
34047,10,428,2052,187,5405,241
42944,6,76,1249,72,2161,4
27354,7,89,2382,65,3799,24
36359,242,7435,1920,5522,81373,1913
12667,10,505,3156,412,14461,93
32900,0,85,2094,58,4148,27
37405,6,110,1858,84,3026,26
12959,838,48527,3139,43423,465933,5104
20388,37,1248,2727,877,18117,371
28356,106,3007,2323,2338,22796,669
45938,5,52,401,40,2569,12
13300,22,605,3110,500,7387,105
13831,37,1859,3069,1786,14817,73
18035,12,554,2837,445,6993,109
30463,4,248,2212,192,8674,56
32624,61,1120,2106,831,6134,289
11169,925,47783,3234,38604,121976,9179
26499,15,637,2423,511,16946,126
10542,14,794,3269,780,11576,14
33670,68,1279,2065,1020,16427,259
22654,12,312,2601,254,9619,58
43599,52,745,1050,630,23113,115
17642,14,962,2855,628,5123,334
14840,37,907,2996,815,11010,92
26223,67,8440,2436,3286,30784,5154
32601,115,3501,2107,2809,29149,692
17597,197,10443,2857,7616,66080,2827
33785,2,80,2060,46,3231,34
22766,26,3063,2596,2091,31247,972
11465,9,417,3219,297,5628,120
33878,3,84,2057,71,2268,13
37907,4,150,1823,122,4338,28
40190,1366,59549,1678,27529,210470,32020
34219,187,7082,2047,2958,34836,4124
22556,48,3598,2605,2331,16162,1267
19033,44,4147,2796,2919,40161,1228
16576,11,371,2912,278,4821,93
37131,31,571,1875,489,11632,82
22326,315,9889,2617,7232,52543,2657
17984,190,5997,2840,3461,23610,2536
36813,56,2394,1895,1835,33033,559
44728,189,2171,824,1647,36352,524
29039,7,378,2286,222,6373,156
45429,1,8,597,7,1290,1
28307,58,3165,2326,1497,18960,1668
36892,49,817,1890,695,10974,122
25512,28,569,2469,413,4616,156
22386,10,464,2614,324,10645,140
15280,4,1289,2972,817,16088,472
7284,54,2511,3469,1971,11406,540
28156,11,398,2335,306,8973,92
17817,12,638,2849,507,10583,131
22595,408,25228,2604,10224,164932,15004
31190,6,100,2177,87,2878,13
33335,327,10809,2077,7925,36651,2884
34006,5,161,2053,102,8152,59
17327,51,2428,2870,1460,20382,968
29139,19,589,2281,374,6161,215
1246,14,637,3889,470,5460,167
39493,0,194,1720,151,3997,43
43775,31,385,991,329,5442,56
21801,2,82,2645,76,4101,6
6875,343,15570,3492,13544,125005,2026
29963,60,1106,2240,676,12428,430
18405,248,11587,2822,8619,69341,2968
32701,6,421,2103,320,4046,101
38975,5,111,1752,70,5785,41
43185,11,380,1182,216,6509,164
29421,0,75,2266,60,3068,15
16477,2,248,2917,170,4406,78
37374,106,2395,1860,1712,13701,683
27830,2,86,2353,71,3309,15
25882,23,1496,2452,650,10465,846
24143,117,3620,2529,2760,20943,860
37455,0,52,1855,47,4280,5
14896,48,1838,2993,1240,25679,598
19527,0,35,2772,27,4855,8
43398,44,583,1114,498,17096,85
45745,14,263,478,206,4100,57
41175,1,38,1584,30,1517,8
33635,41,911,2066,691,14064,220
45181,3,24,667,13,2232,11
11162,577,33508,3234,22584,98670,10924
23764,2,66,2548,58,3812,8
29952,6,288,2240,234,6302,54
34731,13,147,2022,109,3481,38
38124,9,236,1809,201,6274,35
32191,117,5143,2125,3582,48188,1561
31465,62,3716,2163,1740,47272,1976
12805,14,1909,3148,1414,33903,495
40528,7,158,1647,111,6883,47
12173,51,1194,3184,921,5937,273
16236,20,3646,2929,1517,22819,2129
18413,128,8442,2821,5856,48241,2586
21695,17,490,2650,375,3492,115
32753,296,13888,2101,8777,100729,5111
31443,8,381,2164,327,7373,54
16478,19,758,2917,613,12961,145
8853,10,416,3360,344,12679,72
19584,3,184,2770,156,5486,28
19729,2,238,2762,202,4908,36
40919,20,526,1611,398,8286,128
30994,14,338,2188,292,4066,46
14290,15,280,3035,252,6589,28
16675,6,438,2907,314,10051,124
42212,178,2842,1410,2045,37932,797
19410,3,253,2777,211,13433,42
25078,1882,66021,2487,36980,276407,29041
26896,38,604,2405,487,7303,117
15427,246,15309,2966,9585,78772,5724
27375,0,32,2380,30,1195,2
20082,145,9459,2742,4272,52260,5187
6488,168,9187,3509,8360,49482,827
17497,639,20582,2862,13546,69819,7036
34665,3,153,2025,134,8997,19
36253,7,211,1926,188,4416,23
17891,3,136,2846,113,2937,23
29899,21,1152,2242,590,10229,562
25613,139,3740,2463,2705,17575,1035
43488,4,45,1091,25,6681,20
34937,18,700,2010,568,17325,132
22734,38,2299,2597,1336,23671,963
38218,6,508,1803,87,4528,421
40165,5,94,1679,84,2140,10
18447,0,44,2820,38,3301,6
26421,48,1356,2427,937,8840,419
39469,10,1164,1722,656,13451,508
44311,12,113,905,94,2743,19
32831,7,303,2097,211,5130,92
28104,2,96,2338,63,3849,33
16967,41,1663,2891,1355,12318,308
34902,44,1914,2012,1540,17052,374
15587,566,21068,2957,13632,126375,7436
38373,323,12246,1791,6847,57328,5399
31486,6,364,2161,256,6612,108
21956,20,940,2636,714,16701,226
43568,3,149,1064,98,5194,51
22822,46,3197,2593,2317,26508,880
22914,19,248,2588,221,2402,27
12880,15,776,3144,745,7858,31
16635,3,201,2910,157,7694,44
19368,46,1911,2780,1403,15482,508
42448,66,718,1362,487,5209,231
29807,49,3866,2247,1841,35749,2025
36877,15,639,1890,453,6177,186
31964,9,747,2137,584,11015,163
30579,7,202,2206,148,8351,54
44981,39,420,748,403,9773,17
13783,883,33791,3073,17696,89162,16095
36677,0,83,1903,50,6114,33
16507,3,130,2915,104,5643,26
14999,1596,109334,2987,77823,688524,31511
11613,34,1219,3212,1091,10040,128
33704,7,270,2064,152,11585,118
15819,37,2471,2948,1850,19933,621
21765,11,336,2647,278,3273,58
39877,299,8635,1697,5692,52297,2943
28597,74,2336,2308,1806,15098,530
32378,26,550,2116,430,7358,120
37943,16,466,1821,286,5676,180
14929,124,27247,2991,8814,80265,18433
11337,53,4891,3227,4540,35283,351
42828,75,4369,1279,1684,47147,2685
23355,42,2033,2567,1226,9222,807
34774,7,310,2020,241,8561,69
19518,48,2239,2772,1279,24146,960
33047,10,299,2088,190,5656,109
39667,3,112,1710,89,11034,23
42911,21,176,1259,172,5737,4
27805,62,2923,2354,2100,50068,823
41301,10,548,1563,340,16425,208
11254,5,258,3230,215,7252,43
44095,61,2735,930,704,12615,2031
34745,6,1312,2021,978,25875,334
27053,2,160,2400,126,7040,34
8187,111,3479,3402,2773,13982,706
31723,0,40,2149,35,3068,5
43108,22,650,1202,296,16444,354
31446,3,147,2164,119,3700,28
40308,79,2728,1669,791,16510,1937
21425,28,713,2666,550,5577,163
39025,38,1045,1749,710,12883,335
32845,28,2771,2096,2055,67428,716
29047,0,547,2286,449,6795,98
38130,5,212,1808,168,5460,44
3257,44,268866,3636,1598,9624,267268
25113,120,6680,2485,2675,45658,4005
34311,10,375,2043,274,8247,101
9290,55,1930,3335,1852,26129,78
1043,3,97,3952,85,7673,12
10142,91,2034,3289,1613,23953,421
33661,0,43,2065,35,6694,8
42109,7,192,1433,147,5141,45
20446,157,8036,2723,5160,49796,2876
22553,0,1815,2605,1239,18112,576
44669,27,506,844,360,18014,146
19012,138,8370,2797,6195,26558,2175
43870,133,5742,977,1926,33431,3816
37698,3,55,1839,49,3452,6
38227,1,98,1802,65,3421,33
41189,39,685,1583,515,8304,170
12100,90,3630,3188,3369,24098,261
28496,25,964,2316,577,19818,387
33293,0,34,2079,32,9166,2
41031,4,106,1603,94,6659,12
21301,4,344,2673,275,3616,69
26633,10,899,2418,463,7320,436
43663,8,161,1027,116,7038,45
19404,14,615,2778,395,6670,220
31673,26,875,2151,692,18266,183
36649,134,7031,1904,5286,44129,1745
30740,6,138,2197,124,5252,14
15867,3,77,2946,63,3194,14
35863,20,1682,1952,1043,16719,639
14826,1,78,2996,78,8189,0
31982,7,397,2136,320,9468,77
27224,40,1326,2390,1049,21349,277
40372,19,465,1661,319,8378,146
4157,72,205243,3614,2452,12456,202791
11420,1,80,3222,78,2072,2
30154,18,416,2231,257,6741,159
37281,34,1728,1865,587,6616,1141
30119,64,1994,2232,1654,14552,340
37155,1,132,1874,83,4796,49
25383,18,1116,2474,949,8991,167
41419,36,476,1547,369,5820,107
40510,4,58,1648,46,5153,12
27366,9,276,2381,202,3511,74
9334,4,285,3331,262,4389,23
17082,13,449,2884,334,2809,115
25731,0,99,2458,86,2778,13
32095,0,119,2130,54,4591,65
45808,6,66,457,53,2607,13
21033,13,673,2688,537,11238,136
30189,80,4164,2228,1937,23777,2227
41561,536,10342,1528,7436,87439,2906
40007,75,1385,1688,1203,6613,182
22084,115,3144,2628,2407,14681,737
29063,7,247,2285,202,6828,45
45580,0,83,551,78,2218,5
25455,2,192,2472,170,4459,22
39452,7,212,1722,167,5045,45
25844,82,2887,2453,2040,38560,847
38499,11,182,1783,156,5048,26
41481,43,1285,1538,986,33020,299
22175,20,1496,2624,1146,10664,350
22765,7,559,2596,445,16677,114
19216,10,682,2788,556,10910,126
36993,10,201,1884,168,2761,33
14342,175,5175,3030,4109,30620,1066
38766,8,851,1765,525,11037,326
23730,1,86,2549,77,2234,9
26924,0,15,2404,14,1131,1
32861,10,648,2096,368,11787,280
27372,83,3030,2381,1735,33298,1295
29490,10,324,2262,238,5890,86
30266,26,761,2224,578,8409,183
40172,1291,38381,1679,26762,202772,11619
36502,11,160,1913,135,3365,25
37541,17,289,1849,238,6044,51
37212,7,194,1870,145,4349,49
43017,9,149,1230,94,5530,55
26209,2,431,2436,303,5789,128
23377,24,796,2565,578,4226,218
40159,11,323,1679,256,6793,67
25796,29,1622,2455,1315,25706,307
41274,5,347,1567,239,6953,108
43460,185,1700,1099,1302,10661,398
43201,15,409,1177,291,6623,118
38198,31,2225,1805,1529,26330,696
45229,155,1568,654,1435,7945,133
37181,1,33,1872,30,1096,3
46022,3,76,368,59,2289,17
41655,39,932,1512,621,11268,311
43530,5,70,1076,55,2808,15
42818,3,200,1282,136,3420,64
33665,0,115,2065,96,3251,19
19164,41,1659,2790,1312,28392,347
43376,8,248,1121,158,3652,90
17042,345,23026,2886,13454,92346,9572
7614,187,4441,3450,4423,42189,18
21418,5,431,2667,297,3016,134
19914,2,89,2752,77,2157,12
37685,8,94,1840,78,1799,16
20461,54,3790,2723,2838,17526,952
23288,3,80,2570,42,1885,38
14315,262,21352,3033,12249,116568,9103
36314,9,186,1922,132,4552,54
23162,126,2028,2576,1428,15992,600
25609,0,881,2463,671,11219,210
19508,2,509,2773,393,7795,116
38568,1,111,1777,90,3848,21
32988,5,115,2091,88,2538,27
45172,19,128,670,120,2259,8
40416,269,6287,1658,4855,35737,1432
40015,1,77,1688,53,3706,24
27652,2,260,2364,182,5302,78
13557,9,37211,3089,13490,10412,23721
19915,421,15040,2752,10765,107788,4275
28515,26,475,2314,353,6178,122
31460,13,333,2163,299,8506,34
40472,11,947,1652,538,12527,409
22209,0,38,2622,32,2301,6
28513,1,34,2314,30,2924,4
26607,9,779,2419,275,5132,504
43922,7,98,966,80,4027,18
20719,52,6008,2709,3027,29649,2981
33938,1,108,2056,92,9849,16
16987,11,619,2890,411,8870,208
27219,37,1295,2390,854,15257,441
12463,3,186,3167,140,4136,46
30159,43,1177,2231,990,13327,187
25726,0,56,2458,52,3263,4
7447,50,2186,3460,2038,17270,148
43038,3,46,1224,45,3834,1
42975,102,1505,1243,1400,9878,105
18887,20,2767,2801,1139,14985,1628
29885,3,99,2243,81,2104,18
20397,18,703,2726,278,10931,425
28403,10,408,2320,333,7148,75
13506,157,11652,3093,8281,83192,3371
19442,3,225,2776,142,3868,83
26738,1,55,2412,45,3955,10
41618,10,793,1518,579,10821,214
16069,9,478,2936,356,6566,122
20855,2,150,2701,105,7264,45
33987,21,628,2054,532,14019,96
40721,23,423,1631,228,14121,195
33647,3,93,2066,82,3180,11
36823,14,635,1893,502,17252,133
22488,1,70,2609,46,1926,24
11318,11,636,3228,619,12190,17
15866,128,5926,2946,4040,43837,1886
43678,116,1437,1023,1203,12141,234
23302,3,277,2569,222,3441,55
41895,13,482,1468,214,7608,268
36016,37,1018,1940,890,14074,128
19581,17,1074,2770,758,13206,316
39481,193,6967,1721,5143,65699,1824
18975,5,211,2798,174,10673,37
23733,35,1252,2548,835,9290,417
34670,32,330,2025,272,4302,58
9498,1865,90618,3320,56497,192415,34121
23612,51,1611,2554,879,11831,732
37630,6,214,1843,169,10015,45
15482,22,1385,2964,829,8068,556
20882,5,208,2698,151,2767,57
34714,38,1195,2023,985,13041,210
16338,15,1589,2924,1077,13589,512
35803,12,286,1955,212,4489,74
36370,1255,29281,1919,13629,142323,15652
937,12,329,3988,267,8607,62
29662,4,198,2254,154,7466,44
33166,25,803,2083,688,14334,115
33935,2,146,2056,92,7647,54
24597,1,56,2507,45,2314,11
32982,5,227,2091,180,5991,47
41423,63,821,1546,591,8211,230
15534,2,177,2961,145,6298,32
16656,408,36605,2908,17003,168421,19602
40465,2,79,1653,58,3868,21
42323,27,1286,1388,728,15152,558
13395,202,19128,3103,12035,125377,7093
46049,5,84,352,63,2175,21
28328,13,790,2325,490,11272,300
40445,171,4086,1654,3142,23464,944
34616,42,3720,2029,1062,13154,2658
17929,120,5612,2844,4484,57851,1128
45805,5,98,457,61,1557,37
11868,21,823,3200,721,16199,102
45817,47,1068,453,732,11291,336
4394,353,16372,3605,15631,181377,741
15012,6,259,2986,164,10472,95
44746,23,229,817,190,4688,39
39354,36,1942,1728,1517,35656,425
26057,7,304,2443,267,5195,37
26667,81,3150,2416,2016,23061,1134
29130,2,217,2281,177,4690,40
9916,121,4376,3300,4301,27381,75
43894,3,35,972,35,1750,0
30956,18,670,2189,460,8121,210
38058,35,430,1814,342,5167,88
44899,43,489,771,322,6171,167
20630,121,9479,2714,3368,39154,6111
13880,149,7575,3064,6110,67296,1465
31356,68,2005,2169,1354,18174,651
42883,27,866,1267,484,10940,382
28306,16,493,2326,302,5149,191
46218,0,13,289,7,855,6
28187,2,308,2333,175,3823,133
36865,3,169,1891,125,3445,44
39592,15,424,1714,345,5378,79
31932,12,357,2139,230,8392,127
37270,68,1425,1866,1112,13305,313
42636,0,15,1326,10,1849,5
29499,41,1736,2261,1336,15131,400
44091,15,992,930,249,7463,743
14008,51,2404,3053,2245,31723,159
17564,9,560,2858,456,9015,104
16043,7,264,2938,223,4409,41
25963,37,3179,2448,2537,21743,642
44312,11,101,904,80,7152,21
40672,9,228,1635,134,3776,94
31452,27,728,2164,570,9549,158
27519,269,14237,2371,8325,57969,5912
25516,0,21,2469,17,2326,4
10487,1807,122119,3273,61822,221655,60297
46080,0,34,341,21,2971,13
17589,22,532,2857,410,3969,122
24964,6,464,2492,311,9447,153
41846,16,532,1476,418,11130,114
37015,22,635,1882,531,15648,104
24711,118,4725,2502,3645,49329,1080
37097,5,275,1877,228,8271,47
18179,5,124,2832,92,5399,32
36996,35,684,1883,528,10819,156
42312,14,198,1390,122,4463,76
19707,6,548,2763,484,9079,64
42182,21,1079,1416,717,16516,362
29647,7,478,2255,368,5792,110
38754,2,179,1765,46,4181,133
22906,187,6731,2588,5022,38441,1709
42180,43,502,1417,498,9656,4
18914,102,6503,2800,5034,27084,1469
21391,34,2146,2668,1546,20396,600
19853,4,146,2755,126,4236,20
22975,7,316,2585,245,5724,71
26861,2,140,2406,123,14816,17
16155,14,797,2932,666,8923,131
25535,16,283,2468,241,4437,42
25435,18,1052,2472,849,11434,203
33042,14,311,2089,196,5761,115
34115,6,339,2049,259,4369,80
14506,298,25799,3019,17644,115784,8155
19108,3,175,2793,118,3879,57
28284,0,70,2328,63,1956,7
23716,68,3862,2549,2930,31178,932
38272,6,298,1799,245,2835,53
11441,256,25873,3221,12375,77788,13498
44676,12029,338741,833,173751,1541819,164990
24543,31,1154,2511,903,19855,251
44702,81,1165,833,1005,9618,160
38073,6,246,1813,202,3417,44
36976,16,601,1885,484,17054,117
44995,5,39,743,38,2681,1
42706,3,145,1310,105,5082,40
19685,6,212,2765,180,3349,32
5258,16,751,3565,626,8191,125
36790,6,134,1896,91,3815,43
28660,2,190,2305,151,4048,39
14308,99,7181,3033,5611,48483,1570
42722,120,2361,1306,1655,35520,706
27034,17,374,2401,327,5650,47
13701,32,1864,3079,1504,26713,360
15170,62,2396,2977,2064,16255,332
24897,262,23880,2495,7461,83005,16419
37010,4,212,1883,176,4826,36
24625,11,1744,2506,1346,14956,398
36760,12,402,1898,308,15811,94
34890,142,2532,2012,2078,18629,454
19101,72,2879,2793,2041,46282,838
42267,5,358,1398,226,12265,132
35216,88,2493,1996,1987,30014,506
37225,26,911,1869,628,13095,283
45138,136,979,679,825,12957,154
32423,13,860,2115,644,20902,216
45524,61,549,572,515,9148,34
32789,27,1028,2099,768,18218,260
20809,3,416,2703,344,9925,72
11366,214,16254,3225,11544,57343,4710
15177,22,926,2977,782,5002,144
34542,1,52,2032,46,2213,6
17878,60,2454,2847,1875,32499,579
45242,161,1616,651,1369,15446,247
21881,182,5408,2641,3717,24495,1691
44704,39,388,832,327,6871,61
45499,0,93,580,80,1629,13
21938,30,725,2638,573,3825,152
31233,3,269,2175,124,4904,145
31768,15,371,2147,189,4521,182
33263,14,363,2080,256,6046,107
20405,16,1309,2725,1125,32516,184
24614,286,5634,2507,4095,31173,1539
16780,12,334,2900,295,5714,39
15302,5,287,2970,233,19594,54
38099,32,2589,1812,1163,19996,1426
35825,5,108,1954,91,3810,17
43931,26,348,965,296,3550,52
42408,4,363,1372,265,6764,98
45883,2,17,430,8,1273,9
41954,222,6868,1459,4271,64001,2597
40533,17,560,1647,429,16638,131
11827,3,66,3201,63,4675,3
44725,8,80,824,53,2974,27
16144,12,1279,2933,1032,14500,247
41082,4,236,1595,173,4556,63
41752,10,544,1495,420,10822,124
26403,4,75,2427,70,2813,5
30109,4,272,2233,209,6076,63
25932,3,92,2449,65,6726,27
21885,5,252,2640,215,3062,37
9809,187,13034,3304,9413,96366,3621
39975,24,501,1690,367,10745,134
19444,11,218,2776,183,8378,35
31397,15,443,2167,362,15752,81
28450,1,56,2318,45,4751,11
43900,54,693,971,541,8268,152
32986,16,776,2091,624,20350,152
33739,143,3507,2062,2319,25552,1188
18212,46,3146,2830,1331,17446,1815
35801,5,165,1955,133,5060,32
44658,5,182,847,157,7350,25
22878,10,367,2590,301,5171,66
23239,4,91,2573,78,2349,13
27342,5,140,2383,118,5851,22
18008,23,1473,2839,976,34084,497
19118,3,262,2793,212,5094,50
16427,23,1251,2919,1009,17010,242
15845,55,1823,2947,1372,20872,451
11443,37,3783,3221,3652,31903,131
30404,98,1673,2216,1301,11360,372
35611,2,81,1970,59,2593,22
40170,8,426,1679,276,7866,150
23025,19,1139,2583,870,4230,269
31439,2,375,2165,241,7148,134
12177,0,37,3184,24,1683,13
40478,6,102,1651,86,3872,16
45946,41,506,398,402,16346,104
14055,72,6580,3050,3690,45928,2890
18466,15,1808,2819,1153,16664,655
37602,1,52,1845,46,2510,6
44834,4,30,787,28,2134,2
41115,14,257,1591,198,4550,59
27991,1,67,2344,43,2679,24
10233,142,3512,3285,3307,40523,205
27209,78,3094,2391,1453,9909,1641
45664,0,134,516,88,3085,46
25026,5,40,2490,33,2124,7
45614,31,658,336,422,6214,236
34552,16,314,2032,192,5204,122
35891,9,246,1949,205,5897,41
16233,111,8653,2929,6365,71230,2288
38916,87,1087,1756,938,11278,149
17188,12,1467,2878,670,12159,797
37828,14,432,1829,336,6817,96
3868,340,20460,3623,20162,96986,298
45814,5,62,454,43,2070,19
46047,4,78,352,69,2340,9
45671,2,25,511,17,3100,8
27681,1,37,2362,33,1096,4
36643,20,641,1904,546,7947,95
18425,14,1004,2820,823,8907,181
35871,16,429,1951,329,6689,100
28120,6,774,2337,294,7831,480
29708,23,1053,2252,587,14628,466
19590,5,209,2769,161,7969,48
28753,73,2156,2300,1630,31027,526
34347,2,111,2042,95,2034,16
41611,32,1414,1519,996,12214,418
13432,86,2759,3100,1974,36167,785
23455,12,512,2562,351,10461,161
9727,132,5557,3309,4986,40116,571
26128,4,227,2441,170,2749,57
22496,77,7717,2608,4499,92567,3218
29992,4,114,2238,93,3325,21
14572,9,209,3014,184,5842,25
34281,2,48,2044,28,3132,20
36120,3,181,1932,159,3825,22
28589,17,399,2309,258,4248,141
34772,4,159,2020,119,4476,40
43378,1,63,1120,43,3545,20
25403,3,285,2474,211,4120,74
12153,1,239,3185,229,6660,10
26604,1,51,2419,27,1538,24
23790,7,245,2546,206,7536,39
25022,57,3685,2490,3081,37374,604
15602,41,1621,2957,1132,6538,489
33490,19,511,2071,415,4652,96
40658,7,229,1636,159,6624,70
39435,54,1006,1723,770,6892,236
41740,53,2342,1498,864,17385,1478
29802,2,766,2248,528,9586,238
23026,67,1644,2583,1217,8988,427
17903,159,11802,2846,8188,97701,3614
32242,5,97,2122,82,3884,15
29493,1,109,2262,54,2692,55
39970,14,432,1691,317,8910,115
45385,65,1154,608,1040,16595,114
16957,77,2562,2892,1877,17219,685
29898,8,271,2242,177,4481,94
45065,34,316,715,304,5096,12
19381,7,227,2780,142,9821,85
25724,1,70,2458,64,4331,6
11237,125,6178,3230,4179,25273,1999
45771,51,501,466,462,8642,39
45977,2,97,387,83,2026,14
25591,130,4598,2465,3154,23849,1444
27684,100,9073,2362,7112,77073,1961
45416,0,22,600,16,2411,6
14705,44,2376,3005,2121,24537,255
22114,21,1313,2626,1055,14678,258
38037,113,1149,1816,793,8065,356
38743,51,1749,1766,1297,21019,452
20101,85,15257,2741,3858,51170,11399
37072,21,911,1879,717,9959,194
42595,15,827,1334,395,9794,432
24936,1700,100601,2493,70096,1013816,30505
34481,0,735,2036,572,14219,163
43265,8,229,1157,178,5871,51
22232,733,35442,2621,24866,195138,10576
15792,0,389,2948,306,5194,83
45973,3,46,389,39,2160,7
39284,17,1067,1731,844,13371,223
18345,4,542,2824,405,9414,137
25154,10,538,2484,424,13418,114
22580,23,1057,2604,863,7030,194
39933,62,2137,1693,1421,28300,716
13378,28,3244,3104,2552,52173,692
24604,56,1939,2507,1074,16393,865
32943,5,645,2093,288,13817,357
46016,7,137,369,73,3630,64
23161,0,57,2576,51,3367,6
28046,9,436,2341,364,8489,72
19739,55,1061,2761,810,6448,251
37495,2,225,1852,55,4067,170
38282,1,84,1798,70,3763,14
45420,121,1729,599,1404,19653,325
35793,0,20,1956,16,1538,4
45755,7,73,474,64,3095,9
35570,151,10928,1974,3688,66106,7240
43240,28,637,1164,395,10460,242
34105,2,232,2050,166,5115,66
31744,42,1136,2148,843,14292,293
41393,6,269,1551,191,6888,78
40059,8,131,1685,100,2010,31
38326,18,369,1795,290,5398,79
36319,84,6800,1922,2192,36882,4608
29329,19,511,2270,407,8829,104
30223,69,1588,2226,1056,16931,532
25231,265,12596,2481,7927,76757,4669
32398,5,166,2116,131,4825,35
42165,58,1416,1419,1001,24223,415
23202,153,11466,2574,4997,29420,6469
39945,10,439,1692,340,8107,99
29563,1,63,2259,50,3921,13
36656,3,79,1904,72,4074,7
16420,8,266,2919,202,3473,64
42458,1,36,1360,31,2486,5
36728,2,22,1901,19,3180,3
16767,47,2650,2901,2131,12253,519
37527,8,114,1850,95,2068,19
14868,116,3853,2994,2824,12754,1029
13691,260,30552,3080,14959,90813,15593
18155,0,11,2833,9,1522,2
40546,208,4422,1645,3428,29671,994
19554,1,143,2771,111,6191,32
43619,107,1447,1042,925,16760,522
33392,29,745,2075,568,5236,177
39549,8,114,1717,78,2745,36
7315,111,4368,3467,3958,14439,410
11624,3,154,3211,106,7287,48
33399,10,260,2075,233,7904,27
20109,156,6092,2741,4516,20473,1576
32306,2,219,2120,188,2564,31
34261,6,118,2045,97,4805,21
31074,41,755,2184,616,9567,139
12839,50,5184,3146,5074,63160,110
40755,0,79,1627,36,10403,43
42696,22,198,1311,155,3797,43
37660,3,91,1842,74,2179,17
45602,5,59,547,38,2452,21
7190,314,15400,3474,15057,55782,343
23539,2,47,2558,39,6405,8
4695,266,14929,3594,13170,51403,1759
30187,2,74,2228,70,8966,4
24332,4,135,2521,106,4354,29
12002,91,3728,3193,1936,13851,1792
16016,58,4186,2939,2221,24584,1965
17065,0,103,2884,87,6330,16
7969,27,624,3420,611,9360,13
40446,203,7951,1654,5954,51397,1997
15057,153,26379,2983,5527,27485,20852
45252,3,23,646,15,1518,8
22678,96,3230,2600,2462,40922,768
40619,8,172,1639,143,4251,29
36524,23,296,1912,245,3430,51
16500,1417,185899,2916,75880,431170,110019
11923,6,276,3196,252,7112,24
11673,9,225,3208,216,5525,9
43157,57,550,1188,427,9085,123
27800,2,238,2354,157,7359,81
7130,64,4162,3477,3693,44222,469
29264,5,235,2275,169,7026,66
18667,1,82,2810,66,2549,16
40759,13,274,1626,172,5354,102
27260,298,6001,2387,4582,31317,1419
32727,25,721,2102,624,15602,97
26123,4,246,2441,219,4023,27
34878,75,2220,2013,1501,22297,719
18127,10,660,2834,508,10221,152
35758,4,201,1959,134,3697,67
29920,0,72,2241,59,4726,13
28345,0,55,2324,48,2478,7
29569,630,16982,2259,12377,90682,4605
16864,11,229,2896,172,5079,57
40075,0,106,1684,74,3452,32
25451,56,1093,2472,803,5887,290
17483,135,7118,2863,5387,47119,1731
37352,68,934,1862,811,7149,123
44928,7,114,763,88,3078,26
44787,6,54,805,51,2377,3
29766,57,4354,2249,1774,26085,2580
25052,25,639,2489,427,7698,212
35574,38,1004,1974,728,12369,276
17007,5,653,2889,318,4665,335
24538,0,53,2511,35,2118,18
41345,2,136,1557,92,2650,44
40836,1,49,1618,37,4040,12
20458,8,964,2723,747,20833,217
14267,85,1943,3037,1689,14920,254
42522,2,47,1347,36,1825,11
42900,10,229,1263,189,8522,40
11427,94,4191,3222,3660,22337,531
42743,127,4890,1299,2557,35226,2333
30973,393,30893,2188,11693,184169,19200
39164,9,521,1740,257,4283,264
29779,14,742,2248,616,6222,126
27225,1,68,2390,55,3210,13
18521,1,148,2817,117,3625,31
28408,0,177,2320,152,5984,25
17049,1,162,2885,132,10551,30
21130,14,1982,2684,1046,16194,936
4167,650,51254,3614,39769,189239,11485
44460,54,797,884,581,10657,216
29069,12,412,2284,270,7346,142
17329,20,799,2870,581,7640,218
38618,25,769,1774,591,19132,178
34674,10,271,2025,215,6456,56
35247,5,80,1993,68,2608,12
21663,0,114,2652,94,2407,20
28086,2,35,2339,31,3498,4
40360,9,182,1662,154,6102,28
12791,40,1522,3149,1400,24968,122
45869,24,297,434,221,9740,76
45545,191,3038,563,2371,11132,667
16169,12,615,2932,487,11502,128
25562,17,619,2466,281,4795,338
45174,13,218,669,189,4725,29
46051,11,147,350,115,6307,32
45813,57,465,454,440,7478,25
34677,0,20,2025,17,4399,3
28205,18,409,2332,337,3767,72
38714,2,82,1768,65,5226,17
43010,41,585,1231,395,9048,190
39027,33,807,1749,624,9047,183
41866,154,3943,1473,2665,49615,1278
2103,881,25682,3656,23381,85623,2301
34449,143,7357,2037,3681,60026,3676
29205,35,444,2277,351,6482,93
44042,64,1175,947,932,31000,243
31440,8,321,2165,255,9526,66
36627,0,329,1905,268,7991,61
27289,8,612,2386,338,7230,274
44180,42,700,923,504,24131,196
33204,0,63,2082,54,6909,9
40701,545,12086,1632,8784,111534,3302
17572,0,219,2858,161,4787,58
34816,64,1807,2016,1379,28788,428
34452,0,0,2037,0,7043,0
43635,22,360,1037,283,15370,77
30781,9,474,2196,415,7647,59
36832,4,110,1893,85,5048,25
24018,0,5848,2535,3300,39139,2548
17304,24,1308,2871,1021,27253,287
19040,26,1055,2795,685,3999,370
18080,7,474,2836,409,5544,65
37553,43,1196,1848,984,14631,212
36468,16,455,1915,351,12647,104
25854,2,37,2453,29,2222,8
21181,6,686,2679,379,4637,307
39871,60,1039,1698,755,8203,284
9964,5,507,3297,235,6186,272
31034,264,6613,2185,4566,70349,2047
40019,1,22,1687,20,8223,2
24945,13,1399,2492,601,9297,798
39028,20,1890,1749,1443,15228,447
27298,18,910,2385,713,19286,197
15786,1,42,2949,38,2988,4
18305,6014,358432,2826,158816,1134475,199616
33249,78,3009,2081,1986,26631,1023
16865,23,1330,2896,963,9075,367
38432,5,83,1787,77,6905,6
26646,0,30,2417,26,2217,4
32520,4,130,2111,100,4685,30
32215,2,156,2124,133,5508,23
29396,25,1604,2267,774,14530,830
24381,36,1497,2519,837,16881,660
26042,0,112,2444,96,3263,16
40729,19,404,1630,311,7934,93
42484,72,897,1355,655,42348,242
32633,7,235,2106,171,6646,64
24299,0,2616,2522,1713,22243,903
21359,19,609,2669,459,7942,150
16434,99,9338,2919,6306,49868,3032
42783,294,7013,1290,5429,63531,1584
31297,6,142,2172,113,3580,29
38678,3,174,1770,88,4046,86
33462,369,6368,2072,4421,30115,1947
42473,72,856,1357,640,12665,216
28158,13,478,2335,396,7842,82
3027,1864,101673,3640,50384,509932,51289
41119,12,287,1590,227,6003,60
19897,9,336,2752,264,7835,72
26914,9,524,2404,377,10141,147
19759,374,25563,2760,19117,137396,6446
32107,9,284,2129,218,11850,66
37601,1,100,1845,69,4937,31
22006,5,251,2633,214,4290,37
41541,58,1905,1530,1397,26194,508
31721,3,57,2149,53,2995,4
40369,3,126,1661,111,3585,15
32379,1,27,2116,21,1728,6
31175,1,44,2178,38,3249,6
44979,16,166,748,130,3858,36
39513,3,52,1719,41,3945,11
20261,22,3276,2732,1689,12735,1587
33593,3,80,2068,60,7057,20
36870,3,235,1891,179,5271,56
33833,8,483,2058,384,9894,99
30221,5,205,2226,171,3687,34
39062,57,1420,1746,1166,10253,254
14702,18,755,3006,689,12199,66
17485,44,1340,2862,1074,24388,266
27680,18,473,2362,406,10869,67
22065,81,2858,2630,2111,18350,747
26665,54,2793,2416,1664,24524,1129
18159,3,242,2833,189,3002,53
37669,1,138,1841,93,11756,45
36018,92,4444,1940,3121,43477,1323
46297,13,119,265,112,2386,7
37451,68,1885,1855,1030,18529,855
26392,7,209,2428,176,5257,33
16830,6,162,2898,131,2759,31
37827,0,119,1829,68,2601,51
40841,2,59,1618,52,3556,7
20524,33,1795,2719,684,5600,1111
24113,4,126,2531,103,3923,23
10226,8,326,3285,309,4552,17
17338,122,5492,2870,3496,38853,1996
17604,11,623,2857,516,8557,107
37535,1,69,1849,41,4674,28
45069,9,102,715,98,4146,4
26877,10,400,2406,348,5971,52
13166,4,183,3118,177,3523,6
37354,1,73,1862,50,4199,23
23174,7,432,2576,325,8785,107
21550,3,121,2659,90,2095,31
19045,0,28,2795,23,1162,5
26808,13,492,2409,368,5627,124
35545,12,261,1975,229,5446,32
19376,0,704,2780,556,12799,148
34069,5,55,2051,48,6438,7
39343,1,124,1728,77,3177,47
21835,4,217,2644,170,13776,47
32794,64,4254,2099,2360,28072,1894
41812,58,587,1481,412,9650,175
45123,187,2630,684,1873,15455,757
46221,2,30,289,29,1916,1
21396,21,1608,2668,1277,13356,331
21159,94,4984,2681,3185,51684,1799
14434,69,8613,3024,6111,80198,2502
26477,35,1061,2424,861,19561,200
28593,72,2444,2309,1686,24332,758
32374,45,883,2116,684,5572,199
31805,49,2020,2145,1127,17648,893
37260,6,162,1867,126,2897,36
26497,1,43,2423,15,2674,28
12523,1,73,3164,49,1355,24
43469,34,621,1094,492,14807,129
32205,6,80,2124,72,3221,8
42217,5,104,1408,84,2921,20
25208,61,2121,2481,1602,25610,519
45359,173,2656,616,1925,11504,731
38450,5,230,1786,135,11999,95
23284,1,122,2571,86,3771,36
28803,8,145,2297,120,2224,25
43445,6,72,1103,48,2520,24
45626,1,14,533,10,1148,4
23399,2,92,2564,78,2111,14
21764,0,100,2647,71,4299,29
17411,428,12287,2865,9218,37636,3069
20390,8,226,2727,148,7376,78
27946,1,33,2346,30,3358,3
13613,16,1426,3086,1118,11665,308
46072,1,53,343,38,2242,15
33483,4,153,2072,103,3471,50
43356,113,1774,1130,1595,11746,179
35930,2,25,1946,21,3505,4
43110,8,194,1202,141,7271,53
36424,1,143,1917,123,3476,20
28677,72,5479,2304,3760,22015,1719
38077,9,570,1813,407,9623,163
43712,121,1786,1011,1605,12632,181
21314,15,727,2672,523,7331,204
38783,12,126,1763,107,4079,19
29796,22,770,2248,660,14114,110
14439,12,1220,3024,566,16097,654
42521,0,17,1347,15,1882,2
38452,21,859,1786,667,12342,192
42174,3,49,1417,36,2728,13
24518,43,983,2512,797,7626,186
20058,112,12713,2744,4318,39900,8395
41131,2,89,1589,57,2603,32
11211,205,11695,3232,6039,61288,5656
29706,0,135,2252,111,6814,24
41817,13,455,1480,319,5314,136
16430,139,4966,2919,3773,31921,1193
12348,15,766,3174,739,12672,27
42489,47,1144,1354,857,20049,287
17746,1,72,2851,42,1473,30
21589,0,153,2657,119,2758,34
46425,17,466,201,417,11012,49
14440,2,245,3023,165,8667,80
43785,58,764,988,543,12392,221
20659,7,366,2713,207,7332,159
32194,4,80,2124,60,4526,20
16411,44,1456,2919,1132,12233,324
39557,1,42,1717,35,2246,7
42423,136,3379,1368,2710,15525,669
15979,15,536,2941,436,7099,100
29625,10,328,2256,291,3583,37
45950,1,27,397,14,2196,13
42450,14,614,1362,392,8226,222
19141,12,1085,2792,888,9567,197
27728,7,300,2360,166,3514,134
15179,16,708,2977,644,5542,64
42036,24,332,1446,268,5547,64
45214,423,6101,644,4603,39545,1498
38434,13,373,1787,299,6277,74
34071,5,47,2051,42,4754,5
44774,3,50,807,46,2233,4
34445,48,1918,2037,1418,18767,500
13117,19,1782,3128,1198,29460,584
16300,4,138,2926,114,3972,24
27102,5,125,2398,106,8105,19
26288,37,883,2433,579,7845,304
29520,3,291,2261,215,2486,76
23145,6,287,2577,231,11170,56
43062,24,193,1216,171,3141,22
45666,792,19467,513,16792,109471,2675
36485,31,704,1914,527,15319,177
44209,6,87,917,78,3480,9
44592,1,9,859,7,1652,2
32442,5,422,2114,310,4352,112
28748,283,6452,2300,4229,46427,2223
39064,15,441,1746,355,5740,86
5400,32,572,3557,500,7038,72
14217,53,2533,3041,1340,16963,1193
17105,4,414,2882,225,6168,189
33447,187,2264,2073,1841,10797,423
23254,317,14644,2572,10805,72302,3839
13318,6,627,3108,476,20097,151
44896,245,2807,772,2178,22731,629
18617,505,49715,2813,24294,209891,25421
8374,56,1402,3390,1264,6949,138
5522,76,4905,3552,4742,45568,163
44651,65,581,851,480,8180,101
37810,576,17782,1831,11552,114819,6230
40914,37,1344,1612,1032,9866,312
37709,18,479,1839,394,14398,85
38553,13,575,1778,455,6730,120
37597,1,133,1846,77,4015,56
18233,11,1177,2829,453,8598,724
45935,9,110,404,84,4097,26
37594,206,6704,1846,4171,56573,2533
45365,11,95,614,88,2298,7
14265,648,23187,3037,16471,87753,6716
32001,25,952,2135,716,15247,236
39925,0,18,1694,17,1131,1
1965,5557,397490,3658,266062,1486582,131428
33884,1,67,2057,30,2725,37
31043,3,80,2185,60,4789,20
45670,104,1927,511,1346,11280,581
39399,64,784,1725,536,9426,248
39477,48,2162,1721,834,23681,1328
38724,5,125,1767,102,7585,23
26025,3,156,2445,113,3787,43
39267,47,1430,1732,977,20158,453
30772,30,1907,2196,1529,26591,378
11154,41,1656,3235,1524,14516,132
22786,33,800,2595,633,3758,167
32213,4,388,2124,227,5667,161
43629,18,263,1040,208,4862,55
5977,2918,159305,3528,99355,520839,59950
9287,167,6430,3335,4591,20519,1839
35047,10,263,2004,216,7825,47
14420,32,1054,3025,964,13184,90
38983,1,45,1751,39,3387,6
34720,8,153,2023,119,2886,34
26780,62,8929,2411,4149,48764,4780
21647,4,105,2653,51,5767,54
46036,8,134,358,105,3271,29
33619,9,763,2067,608,13334,155
27186,12,328,2392,235,11813,93
945,8,400,3986,317,5095,83
25132,21,598,2485,501,8314,97
33273,526,31666,2080,21952,175750,9714
28997,5,445,2288,241,9718,204
11468,5,154,3219,140,2741,14
33041,0,130,2089,114,5173,16
19460,3,180,2775,141,3902,39
19339,29,1578,2781,1174,13456,404
31793,4,73,2145,57,6057,16
12012,9,391,3192,343,8814,48
41585,328,4400,1523,3315,30479,1085
37599,7,566,1845,421,14473,145
13279,20,1071,3112,911,10512,160
19892,73,3272,2753,1320,13793,1952
38526,5,132,1781,112,4383,20
31754,101,3103,2147,2058,33050,1045
31957,33,956,2138,574,13579,382
42394,17,567,1375,331,7290,236
12236,18,1226,3181,716,17153,510
39560,40,955,1717,684,12458,271
44711,2,132,828,43,4216,89
44511,65,860,876,730,11168,130
42151,34,560,1423,460,6297,100
45168,3,43,671,22,2840,21
26462,0,36,2425,31,1896,5
3367,204,9723,3634,9529,66235,194
36463,74,1440,1915,711,10258,729
23656,0,30,2552,25,2333,5
46021,47,462,368,425,7274,37
26460,6,125,2425,102,7361,23
16415,36,1372,2919,886,11187,486
42246,28,499,1402,379,14821,120
22512,1,53,2607,32,3888,21
18203,342,16172,2831,12077,110052,4095
28091,14,675,2339,405,9455,270
27975,6,160,2345,142,2882,18
19039,119,2900,2795,1927,15554,973
10095,12,322,3291,310,26776,12
36139,361,9219,1931,6685,46839,2534
23997,84,2549,2536,1872,12188,677
37878,77,677,1825,526,6198,151
16460,65,1922,2917,1523,14037,399
41217,12,197,1579,176,5573,21
38061,1096,33269,1814,21690,105118,11579
33358,7,399,2077,258,6222,141
37105,31,493,1877,376,4437,117
16772,76,5891,2901,4717,44219,1174
19382,34,2221,2779,1472,40317,749
25478,34,1337,2471,1098,18084,239
34320,260,11542,2043,6539,73136,5003
34930,12,240,2010,165,5171,75
37682,4,167,1841,61,3496,106
20955,4,204,2694,160,6759,44
31898,9,303,2141,262,8431,41
30161,1,55,2231,48,2788,7
38397,68,1528,1790,1085,21047,443
11461,31,1120,3219,1089,18405,31
42958,5,129,1247,99,4767,30
36201,11,366,1928,291,6340,75
27792,6,500,2355,399,6645,101
24662,3,102,2505,59,7496,43
24555,10,328,2510,196,7738,132
39377,48,1633,1727,1295,19690,338
27141,72,4510,2395,2846,23040,1664
28016,11,687,2343,503,9835,184
39896,51,1891,1696,1133,23238,758
22421,20,811,2613,638,15808,173
9829,204,36274,3303,6406,73929,29868
43718,354,3924,1010,3512,42289,412
14031,16,388,3052,347,7037,41
46369,31,563,234,480,6143,83
14124,0,129,3046,105,3376,24
35777,1,26,1957,26,2338,0
31687,25,463,2150,379,10177,84
20173,47,3593,2737,2823,13369,770
25436,98,2040,2472,1469,11129,571
20781,0,63,2705,53,2174,10
15242,21,1049,2974,703,5975,346
35188,1,63,1997,44,3282,19
10558,54,1044,3269,954,10101,90
46314,0,28,254,23,1433,5
22998,28,3609,2584,1528,18004,2081
31191,0,124,2177,93,2676,31
22158,17,650,2625,419,6738,231
16492,1,70,2916,54,2307,16
17989,13,2819,2840,2106,60515,713
24530,18,610,2512,496,5490,114
43067,20,680,1215,218,11908,462
20256,5,209,2732,175,4693,34
19911,97,9826,2752,2774,31011,7052
23469,2,0,2561,0,2672,0
21403,25,2319,2667,1388,17151,931
10847,11,830,3252,770,12300,60
37971,7,217,1819,170,10095,47
32709,279,8617,2103,5815,37028,2802
41471,29,817,1539,640,10238,177
35670,11,153,1965,125,5075,28
13727,63,5013,3076,3294,40617,1719
37227,20,588,1869,375,11750,213
36984,7,412,1884,292,8348,120
23950,20,407,2538,339,7068,68
15461,48,3110,2965,2461,28923,649
15376,33,675,2968,577,12409,98
40853,193,6720,1617,3252,88943,3468
2076,64,4397,3656,3694,21825,703
15255,23,516,2973,424,4934,92
41493,6,114,1536,98,4654,16
20498,92,3919,2721,3070,30296,849
42499,5,161,1352,102,3353,59
45254,19,254,646,202,4009,52
45427,71,945,597,851,22625,94
31428,4,137,2165,76,7192,61
45638,22,370,471,263,3826,107
24462,52,1591,2515,1152,11590,439
29509,25,1184,2261,978,30441,206
39461,161,3603,1722,2440,19664,1163
16683,2,47,2906,43,4639,4
36068,7,278,1936,186,4979,92
29287,19,633,2273,518,18341,115
46373,12,161,232,148,4011,13
28510,29,638,2314,543,11930,95
42889,80,1993,1265,1414,19325,579
42436,2,121,1364,99,2552,22
28477,0,74,2317,47,2277,27
14570,31,783,3014,727,10734,56
38483,17,622,1784,388,12751,234
24088,73,7832,2532,5834,88849,1998
44128,57,483,933,368,3806,115
39887,50,1044,1696,823,16920,221
20864,11,618,2700,511,8158,107
28142,2,85,2337,74,4154,11
18335,7,380,2824,274,5783,106
39424,90,2975,1724,2071,16670,904
35874,3,267,1950,214,9131,53
18527,5,182,2817,163,2485,19
38635,2,86,1772,65,4163,21
15580,131,5771,2958,4393,60574,1378
41555,1,102,1528,71,4339,31
20249,53,1367,2732,1088,11578,279
38424,14,656,1788,490,15473,166
22074,259,11933,2629,8113,79378,3820
17995,6,419,2840,333,22748,86
13089,130,3657,3131,3419,39310,238
32200,6409,247943,2124,139475,564718,108468
24180,25,696,2528,553,9179,143
41445,5,117,1542,108,3039,9
44162,323,10360,926,4178,47463,6182
31610,391,39333,2155,11707,178478,27626
36985,7,273,1884,212,8038,61
27600,17,276,2367,213,3229,63
35915,0,15,1947,13,2002,2
45495,17,258,580,178,6698,80
20447,0,56,2723,48,2449,8
42766,7,133,1295,81,6931,52
32218,2,123,2123,106,6612,17
15445,0,92,2965,76,1732,16
17812,17,747,2849,604,11211,143
42141,51,971,1425,697,20186,274
45572,23,306,497,196,5283,110
24666,4,544,2505,411,14190,133
15382,3,120,2968,98,2588,22
42930,16,565,1253,431,10271,134
14240,7,780,3039,533,6640,247
15278,1681,138904,2972,64169,326852,74735
19431,32,2918,2776,1768,25478,1150
21358,5,101,2669,91,2367,10
25909,182,13599,2450,9568,70183,4031
9896,17,589,3301,545,5192,44
24608,3,197,2507,145,5474,52
16825,3,503,2898,404,8687,99
19052,9,208,2795,157,5864,51
35602,247,6373,1971,4174,49633,2199
26381,12,854,2428,649,18300,205
35131,23,470,2000,385,7210,85
24111,2,194,2531,160,5665,34
37324,10,509,1863,381,6851,128
31535,29,583,2159,476,7482,107
45169,27,257,671,194,8179,63
42110,3,177,1433,143,8292,34
15294,662,33170,2971,13011,121079,20159
25786,16,509,2455,412,4141,97
25481,0,514,2470,402,8941,112
40975,221,5865,1607,3549,47882,2316
39107,244,11700,1743,7246,86894,4454
37538,3,172,1849,147,3535,25
42557,6,145,1341,112,3561,33
42094,11,402,1435,332,9127,70
23482,1,34,2560,31,4355,3
40325,91,3749,1668,1803,103274,1946
19821,6,367,2756,293,12720,74
31772,18,400,2147,293,7425,107
37906,8,213,1823,178,3750,35
15711,0,1363,2952,999,10466,364
34195,34,1183,2048,802,13878,381
41891,4,189,1468,158,6817,31
21627,15,0,2654,0,42681,0
15546,6,589,2960,449,11293,140
28793,6,274,2298,137,9020,137
22413,23,900,2613,654,9735,246
16073,3,248,2936,140,9555,108
25080,5,378,2487,89,3223,289
42536,10,155,1344,112,5669,43
36810,4,211,1895,152,3109,59
21047,5,246,2688,200,7978,46
38182,4,46,1806,40,2139,6
28947,3,93,2291,73,2622,20
44964,190,1862,753,1692,20036,170
41290,4,90,1564,66,2863,24
29042,25,2643,2286,1034,15256,1609
27302,667,36414,2385,11118,124135,25296
41028,2,56,1603,40,2010,16
27340,0,10,2383,10,1791,0
18151,7,469,2833,367,8984,102
17593,9,287,2857,213,7094,74
44873,11,143,778,98,4585,45
43382,3,40,1120,34,2187,6
8773,551,39562,3365,28953,156924,10609
27404,1,52,2379,47,2574,5
40872,38,831,1615,654,20586,177
38160,19,664,1807,376,11478,288
18176,5,186,2832,103,6112,83
16660,5,369,2908,310,6444,59
8670,2,103,3371,87,2515,16
8857,0,73204,3360,51,2219,73153
35665,66,1752,1966,1277,17290,475
18152,2,164,2833,132,2809,32
24076,1,154,2533,131,8374,23
37086,6,198,1878,165,8488,33
25327,10,234,2477,180,7435,54
28059,9,156,2340,124,4542,32
15088,79,5156,2982,3012,47044,2144
30747,10,235,2197,200,4990,35
36968,24,542,1885,433,6289,109
45589,187,3377,550,2226,20496,1151
25205,1,33,2481,19,5114,14
18332,12,798,2825,475,6503,323
28788,0,123,2298,90,4685,33
36306,1,66,1923,49,3639,17
32870,18,1271,2095,712,15024,559
13446,62,2773,3097,2272,14520,501
12877,25,1387,3144,1313,31187,74
36309,55,1295,1922,962,15187,333
21716,18,478,2649,392,9371,86
21069,21,867,2687,693,9795,174
16860,16,582,2896,467,4622,115
42827,7,105,1280,86,9675,19
41816,16,343,1480,267,5042,76
38949,7,243,1753,186,11562,57
16049,12,326,2937,254,9273,72
45518,67,1197,573,1002,9941,195
30341,28,2241,2219,494,7220,1747
34020,5,237,2052,156,5277,81
9857,162,161115,3302,10452,107006,150663
19862,34,995,2754,739,10120,256
29611,6,130,2257,99,3700,31
29376,6,397,2268,242,5161,155
41723,152,3878,1501,2954,49442,924
36625,2,141,1905,95,5850,46
25676,39,2785,2460,2104,13850,681
20375,4,713,2727,496,12885,217
23899,13,853,2541,718,15959,135
27497,6,270,2373,218,5848,52
15326,20,686,2969,578,14762,108
40902,10,700,1613,528,23864,172
26228,24,1182,2436,740,14263,442
28963,101,4094,2290,2926,39768,1168
31260,27,591,2174,472,6476,119
45356,49,480,616,473,6390,7
11194,9,517,3233,498,4591,19
41758,11,187,1494,104,9085,83
19528,4,169,2772,138,4551,31
18968,25,1150,2798,922,16907,228
18973,1,182,2798,142,4409,40
40101,1,46,1683,37,3049,9
20881,42,1156,2699,800,7705,356
17751,3,377,2851,284,5229,93
36000,314,6050,1941,4690,78553,1360
43123,11,162,1197,101,7668,61
26285,11,405,2433,305,2874,100
23556,4,0,2557,0,2973,0
19309,15,771,2783,616,9709,155
17409,3,673,2865,530,10470,143
29811,4,125,2247,95,4477,30
24509,143,5962,2513,3127,26520,2835
29213,7,145,2277,142,2376,3
21944,119,4046,2637,3088,16616,958
14347,139,5171,3030,3658,23640,1513
25604,285,9370,2464,6904,47987,2466
36394,0,70,1918,62,2855,8
24256,17,498,2525,421,5048,77
1008,5,124,3968,103,5541,21
38006,29,648,1818,503,11528,145
11297,94,5492,3228,4203,37488,1289
31065,13,296,2184,236,4176,60
13530,382,39610,3091,26823,240333,12787
36320,335,6597,1922,3270,34494,3327
23183,4,483,2576,307,12487,176
39015,2,269,1749,143,4700,126
13560,1,49,3089,48,3308,1
33577,0,21,2068,21,1711,0
38683,81,2378,1769,1846,15116,532
44835,29,177,786,153,3252,24
14198,29,640,3042,545,4417,95
17729,24,3220,2853,2161,16468,1059
28741,37,1167,2301,926,9939,241
46098,23,330,338,284,6969,46
28580,46,2386,2309,1305,23976,1081
26701,1,69,2414,51,1555,18
45855,84,2033,412,1078,28910,955
25585,18,878,2465,607,12053,271
24686,168,8064,2504,6486,47873,1578
20489,17,4137,2722,2548,56863,1589
36363,3,50,1919,41,2388,9
35768,31,679,1958,542,7313,137
22373,7,496,2615,380,3822,116
42021,7,135,1449,109,5420,26
41235,9,214,1575,166,8960,48
37633,42,414,1843,326,4292,88
43351,171,4246,1132,2298,44299,1948
20391,1,82,2727,66,2035,16
35903,2,33,1948,30,4417,3
38477,24,364,1785,318,3456,46
17256,31,1348,2873,1001,19209,347
32793,19,1152,2099,452,18907,700
43907,6,116,971,91,3762,25
42587,27,987,1335,557,9226,430
36476,4,151,1915,126,4386,25
23380,13,449,2565,364,9774,85
39175,0,42,1739,38,2665,4
28766,44,2992,2299,2193,18886,799
44706,26,460,831,265,17116,195
29125,12,121,2281,101,3836,20
20641,130,3555,2714,2371,22936,1184
25027,9,367,2490,320,9486,47
23104,16,740,2579,551,5349,189
41735,52,466,1499,345,12560,121
32473,74,1802,2113,1161,10864,641
15014,44,1098,2986,995,9637,103
9131,30,1897,3344,1714,28932,183
38500,13,538,1783,313,9601,225
45212,6,45,658,45,2285,0
19594,87,6180,2769,4487,16312,1693
22329,50,1677,2617,1189,10634,488
33094,0,13,2086,11,2582,2
32201,1,91,2124,84,5501,7
12804,57,6288,3148,5336,66299,952
39552,7,84,1717,74,3445,10
43304,412,9679,1145,4391,70843,5288
28814,51,5827,2297,3815,81272,2012
22704,0,82,2599,66,1625,16
30288,301,14107,2223,9133,112130,4974
27397,19,661,2379,556,18102,105
38438,335,6912,1787,6216,27124,696
11928,8,378,3196,354,4056,24
41639,123,1271,1514,971,14669,300
40392,2116,73200,1659,39689,253427,33511
27201,9,778,2391,567,10045,211
32963,1,24,2092,19,3691,5
22231,391,23315,2621,17345,121093,5970
46280,0,14,272,11,697,3
42831,3,263,1278,207,8262,56
29922,6,110,2241,90,2706,20
36550,86,1978,1911,1174,18751,804
29119,2,28,2282,24,2337,4
26872,7,629,2406,483,11049,146
27150,67,2218,2394,1663,14747,555
19754,48,1901,2760,1422,21888,479
40889,13,442,1614,348,4419,94
38596,20,606,1775,454,5920,152
30100,16,290,2233,238,7751,52
43439,6,146,1101,86,2954,60
46372,8,149,230,128,4078,21
23062,119,3399,2581,2387,19759,1012
46100,4,58,337,45,1956,13
40617,176,4126,1639,3200,32601,926
29077,8,391,2283,227,3860,164
25014,483,21625,2490,14978,153161,6647
41158,139,3508,1587,2639,40361,869
38322,7,203,1795,166,12032,37
19377,22,1241,2780,681,7644,560
22004,43,1804,2633,1477,19766,327
14837,47,3982,2996,3611,20484,371
35669,306,15184,1965,11430,107603,3754
14759,19,1139,3001,952,47726,187
16688,66,3046,2906,1693,19252,1353
37634,60,724,1843,587,10772,137
37312,0,33,1863,22,4598,11
38898,30,722,1756,417,8010,305
14512,8,938,3018,879,13372,59
39114,1,70,1743,48,3849,22
42386,2,109,1377,84,7322,25
44742,14,152,819,143,5053,9
43995,2,61,957,56,3439,5
25534,13,727,2468,556,11593,171
33003,1086,35051,2090,24079,192347,10972
10141,134,5038,3289,4455,41542,583
26558,0,63,2420,50,2152,13
11206,346,15074,3232,10123,94820,4951
10288,19,975,3282,825,9104,150
23896,4,287,2541,210,5192,77
29212,0,157,2277,93,3361,64
13489,21,1413,3094,1133,17825,280
39054,3,68,1747,63,2981,5
12936,12,714,3141,617,16096,97
24240,12,383,2526,262,5905,121
42411,302,5036,1371,3947,52278,1089
25542,1,40,2467,33,3233,7
37547,8,156,1848,135,5140,21
35392,2,103,1987,98,3167,5
29190,2,155,2279,134,6908,21
37236,11,360,1868,266,8615,94
39355,18,377,1728,330,6420,47
21596,257,18582,2656,12740,114982,5842
39118,4,105,1743,91,3027,14
33738,248,16230,2062,11146,85850,5084
34470,1,39,2036,26,3152,13
36321,147,1825,1922,1171,16082,654
35615,50,2717,1970,1231,16057,1486
24182,13,291,2528,181,7218,110
37734,11,427,1837,230,4521,197
44142,18,306,931,243,12443,63
37459,4,250,1855,200,5946,50
42615,11,360,1329,275,10458,85
30775,2,31,2196,28,2576,3
36730,100,3259,1901,2576,19672,683
20561,0,1698,2717,677,8165,1021
15663,27,690,2954,552,4829,138
26141,118,9241,2440,5081,36346,4160
42584,0,0,1336,0,3015,0
42746,38,758,1299,509,18362,249
9949,339,21345,3298,20035,106215,1310
24207,73,2488,2527,1952,30653,536
26922,217,11383,2404,5177,64645,6206
13078,114,5463,3132,4466,40106,997
11142,121,5734,3236,5257,43797,477
45192,5,80,664,46,3211,34
13236,87,4351,3114,2984,43774,1367
24096,3,291,2532,251,4933,40
10499,63,1883,3272,1740,18939,143
24298,4,217,2522,153,4027,64
36910,16,518,1889,451,11752,67
30080,4,107,2234,69,6313,38
36110,7,264,1933,212,3471,52
23083,2,153,2580,121,2305,32
15619,3019,191171,2956,93727,814975,97444
31434,12,222,2165,182,7812,40
34217,27,1246,2047,660,12034,586
43477,38,434,1094,358,9932,76
28379,371,18193,2322,10951,97892,7242
20701,1,43,2710,42,1521,1
33622,2,111,2067,102,12461,9
28648,2,130,2306,108,3908,22
38035,10,263,1816,205,4900,58
44677,296,4055,842,3207,22381,848
45025,6,192,734,98,5782,94
37507,21,707,1851,601,11744,106
35410,9,425,1986,371,13071,54
24512,15,421,2513,333,6852,88
40851,43,1490,1617,942,25419,548
24503,7,162,2513,131,6858,31
42531,4,118,1346,90,3671,28
13855,7,531,3067,361,4274,170
40452,3,202,1654,153,5802,49
45758,8,100,472,73,1762,27
37735,19,299,1837,229,8810,70
45657,5,140,518,89,5456,51
31780,6,394,2146,170,3764,224
40383,4,68,1660,61,2142,7
25945,12,1018,2448,672,13628,346
31232,7,344,2175,284,10867,60
28607,272,11239,2307,7067,60709,4172
32558,1,124,2109,96,5530,28
38510,1,90,1782,59,6735,31
7930,306,10300,3424,8773,74499,1527
28312,24,1273,2326,972,17665,301
27220,18,323,2390,259,3900,64
27797,120,2689,2355,1265,18559,1424
14286,24,1101,3035,839,18815,262
27476,102,3573,2374,2454,28766,1119
10450,362,26671,3275,25945,258538,726
22220,3,431,2622,83,6494,348
26289,2,61,2433,55,4781,6
31360,14,994,2169,190,6154,804
12056,2,134,3191,111,3311,23
27874,0,115,2351,102,3845,13
6598,27,1509,3504,1380,31078,129
39482,6,142,1721,98,8553,44
41122,78,549,1590,443,5717,106
42308,0,125,1391,74,4156,51
18677,407,71454,2810,10194,130717,61260
17983,23,2509,2840,1829,30769,680
30670,22,854,2201,446,7355,408
29674,1,177,2254,128,3972,49
30993,19,514,2188,462,7733,52
21682,4,378,2651,219,6299,159
17177,1,62,2878,54,2934,8
6472,262,9435,3509,8603,46610,832
14794,143,10216,2998,6582,39918,3634
31882,192,6132,2141,4033,23313,2099
16108,17,2650,2934,1790,37958,860
45263,1,19,642,13,1333,6
12663,51,4085,3156,3132,43128,953
37369,28,1274,1860,907,14395,367
24619,11,376,2506,290,4990,86
45321,7,77,625,64,3659,13
26504,0,114,2423,75,4046,39
14728,13,479,3004,451,18435,28
16136,23,929,2933,620,9585,309
46393,3,30,222,30,896,0
21433,2,104,2666,85,4731,19
41387,1,29,1552,21,2658,8
38868,34,895,1758,352,8407,543
38555,5,148,1778,102,4632,46
21549,8,306,2659,234,2615,72
39630,13,495,1712,386,11382,109
17159,11,646,2879,463,6307,183
28653,247,7524,2305,4730,43163,2794
27313,0,48,2385,40,1806,8
23465,5,378,2561,250,5245,128
30861,6,114,2192,95,8001,19
36265,0,44,1924,38,1907,6
32239,15,233,2122,180,3213,53
12409,89,3417,3170,3347,31674,70
43079,157,4211,1210,3349,38806,862
3066,2004,134060,3640,85523,523180,48537
44868,9,102,778,76,2049,26
17948,4,140,2842,112,4402,28
24175,0,94,2528,74,3242,20
19974,1155,70308,2748,45455,330143,24853
42064,0,0,1441,0,1439,0
42990,11,312,1238,213,5400,99
35024,1,80,2006,66,2710,14
31242,12,824,2175,645,11248,179
27954,301,15580,2346,10681,102260,4899
7673,6,169,3446,139,8361,30
46105,12,145,334,122,1279,23
44931,14,139,763,122,4870,17
8665,1234,57646,3371,33653,180719,23993
41343,10,303,1558,261,9094,42
10670,235,9859,3261,6644,48058,3215
43584,45,634,1057,530,11395,104
34380,28,554,2040,477,4784,77
8671,41,2072,3371,1816,38245,256
33588,27,762,2068,605,4417,157
28975,339,11048,2289,7211,55898,3837
12214,38,1180,3182,1079,13824,101
21402,87,1558,2667,1241,8193,317
9080,284,9417,3347,7873,38997,1544
31254,36,739,2175,474,10366,265
29013,11,350,2288,278,7641,72
20779,53,830,2705,623,6280,207
36929,1,357,1888,236,7143,121
38259,9,705,1800,406,12356,299
44710,62,468,828,383,7101,85
45621,6,62,535,37,2873,25
20932,0,45,2695,42,2168,3
38888,16,334,1757,252,3582,82
15073,18,881,2983,717,30547,164
20289,3,362,2730,278,6484,84
20409,31,1053,2725,703,9907,350
14238,4,267,3039,242,4306,25
29263,88,1642,2275,1225,11472,417
21796,6,308,2645,201,5570,107
26602,10,791,2419,495,10763,296
21813,34,1500,2645,1201,16595,299
15051,53,2596,2984,1781,16099,815
44791,66,534,804,414,16090,120
21924,285,25520,2638,15455,102395,10065
38157,58,2207,1807,1223,18787,984
26464,2,75,2425,66,2483,9
8574,300,8767,3377,8704,45584,63
14409,98,2528,3025,2093,22594,435
24778,71,3148,2500,2286,24143,862
44763,8,65,813,65,3708,0
18225,8,359,2830,233,10938,126
16572,20,1182,2912,873,14873,309
22771,67,4484,2595,1484,24851,3000
22689,19,1369,2599,905,20054,464
30065,12,379,2235,217,7095,162
31865,1,28,2142,24,2483,4
26348,57,10359,2430,2891,53438,7468
22520,141,3648,2607,2657,25574,991
18437,385,28742,2820,16490,125313,12252
40305,1,34,1670,31,4171,3
5038,110,3456,3578,2983,17952,473
16137,151,5471,2933,3510,23895,1961
36021,3,42,1940,32,3228,10
12351,33,1384,3174,730,8214,654
15379,44,3038,2968,2295,26931,743
35683,20,262,1964,216,3899,46
45788,2,27,463,24,2000,3
12568,29,807,3162,651,6508,156
32783,21,294,2100,239,3870,55
36602,3,72,1907,68,4707,4
23984,26,283,2536,236,4221,47
45800,21,300,459,211,3938,89
34146,20,520,2049,405,4131,115
43735,43,383,1004,312,11002,71
14002,13,567,3054,557,10567,10
20505,0,84,2721,69,2598,15
22850,20,749,2591,616,10407,133
38928,123,2327,1755,1923,21310,404
31854,35,2622,2142,900,39125,1722
41633,4,279,1516,202,8053,77
30337,10,177,2219,156,5602,21
15413,35,1175,2967,785,5871,390
36337,26,695,1921,584,6735,111
30088,93,2792,2234,2236,15535,556
13838,519,23080,3068,19154,118071,3926
19233,11,360,2787,298,3589,62
15254,14,1053,2973,603,9504,450
37036,8,488,1881,295,8892,193
27982,3,81,2345,72,2272,9
19608,7,441,2769,193,19012,248
36160,34,1105,1930,659,14045,446
36971,1,51,1885,38,2896,13
11749,123,20452,3204,6569,100308,13883
28293,30,1837,2327,852,13047,985
33064,130,3015,2088,2149,17670,866
25947,2,140,2448,123,7093,17
20951,14,450,2694,348,10645,102
37584,0,136,1846,117,4944,19
45421,25,215,599,184,4511,31
41742,2,120,1498,99,6831,21
34567,2,72,2031,63,6148,9
31782,7,551,2146,350,9678,201
30504,64,3313,2209,2405,28007,908
28880,4,105,2294,90,3438,15
44842,46,412,785,341,5792,71
12867,6,426,3144,419,3077,7
16832,29,982,2898,826,9696,156
35651,1,31,1967,30,3001,1
31029,164,5560,2185,4971,45096,589
10481,55,2174,3273,2157,11968,17
19570,7,461,2770,375,10213,86
15715,9,381,2952,285,5928,96
35963,5,100,1944,84,5405,16
34705,6,90,2023,83,2619,7
7825,173,8550,3435,5698,55613,2852
15937,8,514,2944,346,6857,168
31258,23,920,2174,760,15697,160
34708,12,290,2023,165,6614,125
46351,0,36,244,35,1553,1
45778,43,502,464,482,11082,20
35992,26,272,1942,222,7004,50
42864,26,193,1272,145,4849,48
40649,82,2273,1637,1733,16699,540
1109,7,150,3932,114,5099,36
27665,36,1608,2363,945,10890,663
24012,11,461,2535,375,4844,86
38933,0,19,1754,18,6150,1
11547,9,919,3214,559,10157,360
29326,33,1026,2270,780,10164,246
12869,221,23418,3144,14484,104471,8934
34464,19,455,2037,334,12883,121
45533,108,1849,569,1049,28481,800
8950,94,6428,3354,3071,30664,3357
34153,198,7814,2049,5517,70890,2297
31824,49,1861,2144,1283,22628,578
12244,89,5578,3180,4375,27745,1203
38741,65,2327,1766,1615,26429,712
18115,0,119,2834,103,4758,16
14259,298,7052,3038,5148,43192,1904
38919,6,184,1756,135,5150,49
43375,11,185,1121,151,7809,34
16602,62,1992,2911,1530,21772,462
24537,7,524,2511,399,4772,125
17400,88,4189,2866,2995,38523,1194
37944,35,776,1821,614,9955,162
43877,18,281,976,175,7774,106
23372,248,16026,2566,11375,67913,4651
33394,2,65,2075,55,3507,10
21995,2,127,2633,108,5584,19
31329,84,3599,2170,2572,27491,1027
29312,38,1078,2271,822,12959,256
27751,45,1497,2358,1113,22923,384
12011,61,4170,3192,3256,64152,914
34312,22,251,2043,200,2821,51
35961,65,1114,1944,760,10375,354
44843,16,288,784,138,8567,150
16644,4,98,2909,57,6481,41
38595,2,101,1776,73,7399,28
44766,150,1709,812,1376,21570,333
29944,17,424,2240,352,7783,72
45116,310,6095,688,3719,77097,2376
38627,4,151,1773,132,6615,19
27288,5,932,2386,208,12366,724
37315,29,732,1863,534,6591,198
30959,11,344,2189,237,4041,107
39347,6,381,1728,298,7998,83
41241,90,2779,1574,1734,41744,1045
34333,4,105,2042,88,8203,17
40147,264,7852,1680,5433,47937,2419
18448,16,828,2820,668,12238,160
40728,64,1562,1630,1204,32542,358
18123,7,197,2834,167,2840,30
36172,27,997,1929,881,16732,116
17968,7,158,2841,127,3426,31
21601,16,2397,2656,468,14966,1929
21705,379,16713,2650,12387,47488,4326
20812,6,245,2703,183,3405,62
20134,4,106,2740,71,1595,35
33787,48,1376,2060,879,9924,497
26564,0,157,2420,140,3406,17
16334,2,322,2924,177,5022,145
16502,1,128,2916,113,12093,15
30760,53,1871,2197,1220,24458,651
41218,6,373,1578,222,9925,151
17788,9,339,2851,244,12449,95
16989,57,1974,2890,1579,10654,395
41844,15,288,1477,247,10406,41
41231,0,0,1575,0,10742,0
28473,17,395,2317,330,2355,65
9769,2486,131524,3307,60990,688107,70534
20755,11,707,2708,368,5172,339
41552,65,644,1529,492,7250,152
9959,2,315,3297,157,3104,158
40675,1,94,1634,80,3368,14
29362,10,303,2269,223,4075,80
36200,7,175,1928,143,4314,32
15675,313,23453,2954,16511,265758,6942
30946,8,338,2190,250,6982,88
14627,1,51,3011,46,2747,5
34058,12,383,2051,322,15921,61
39495,81,1264,1720,1022,13233,242
18109,6,245,2835,203,3667,42
17982,1,100,2840,79,5256,21
33240,8,540,2081,461,9368,79
31303,127,4498,2172,3471,39998,1027
36426,6,215,1917,129,2967,86
23750,14,395,2548,293,5994,102
33259,1,155,2080,95,7816,60
41295,63,1273,1564,948,15406,325
27707,14,235,2360,187,8270,48
43364,5,131,1126,68,3516,63
34597,10,543,2030,412,19420,131
35713,31,1591,1962,888,15749,703
41472,20,342,1539,253,4891,89
40937,11,912,1610,429,19560,483
42989,26,601,1239,309,12076,292
39099,15,494,1744,379,6078,115
15190,7,171,2976,155,2542,16
42589,6,60,1335,49,4612,11
25770,32,2347,2456,1675,14075,672
41612,14,366,1519,267,12599,99
29527,204,9816,2261,6449,78782,3367
27440,18,1370,2377,763,22946,607
35322,72,853,1990,664,7085,189
30877,58,4082,2192,1142,26474,2940
18298,38,1201,2826,965,22400,236
42375,36,809,1378,625,18857,184
44106,4,54,936,52,5226,2
14990,12,293,2987,274,6163,19
41679,7,159,1508,122,4297,37
27490,16,598,2373,431,4910,167
43485,42,1076,1092,781,11066,295
15517,95,7590,2962,4618,76747,2972
45890,49,404,427,395,6073,9
32661,172,6758,2105,5011,27918,1747
39934,6,179,1693,154,5429,25
37250,3,259,1867,197,6852,62
12061,97,3775,3190,3081,23535,694
44671,443,6412,844,5146,41253,1266
18006,10,607,2839,421,6239,186
23029,8,189,2583,166,4083,23
13319,8,153,3108,152,3705,1
15122,8,668,2980,491,13226,177
34516,45,1586,2034,1019,10151,567
31809,251,6223,2145,5119,27019,1104
44535,8,146,868,99,6170,47
40843,8,88,1618,69,3345,19
28097,1,32,2339,28,6711,4
21973,4,160,2635,140,9419,20
5065,176,5592,3577,5162,24781,430
46239,34,496,284,480,7830,16
30853,2,111,2193,89,12436,22
10901,110,5347,3249,4544,24929,803
12684,131,13194,3155,7443,83921,5751
23518,33,4868,2559,2271,36627,2597
45838,6,71,447,71,3363,0
32774,25,444,2100,326,4997,118
11981,55,2473,3194,2387,58765,86
10996,86,5125,3244,4432,36709,693
30321,4,141,2220,98,9495,43
15852,495,14398,2947,10666,44857,3732
25376,0,38,2475,35,1671,3
43353,32,726,1131,384,13615,342
36418,5,155,1917,130,5198,25
26546,0,528,2421,434,5067,94
16802,11,541,2899,419,9168,122
30917,16,857,2191,639,6101,218
15282,41,2964,2972,1711,36159,1253
23808,0,9161,2546,3984,58076,5177
12168,12,950,3184,802,8745,148
14610,15,802,3011,716,12169,86
36488,33,850,1914,669,11799,181
30144,18,269,2231,235,5306,34
19109,62,4103,2793,2409,29814,1694
38019,188,3932,1817,2844,26509,1088
15532,46,1996,2961,1611,28973,385
30371,28,1743,2218,1185,29240,558
29860,9,1193,2244,228,7276,965
31665,9,891,2152,719,12944,172
30306,29,938,2222,739,12190,199
23307,0,59,2569,49,2539,10
38799,9,269,1763,207,11691,62
25497,92,7938,2470,5010,53701,2928
19406,36,2521,2778,2032,12428,489
13881,35,3369,3064,2273,14531,1096
40931,9,122,1611,103,3946,19
35343,201,5269,1989,3540,39369,1729
15097,142,6141,2982,4500,38247,1641
25112,9,628,2485,487,12473,141
32599,188,7503,2107,5556,60355,1947
22108,108,6446,2627,5244,71966,1202
44389,139,2230,892,1525,29072,705
32222,86,2190,2123,1641,16267,549
37848,68,2453,1827,2045,17410,408
3384,1116,68173,3634,46788,468396,21385
24054,0,62,2534,54,2230,8
45649,9,124,522,95,4761,29
38370,15,578,1792,305,5548,273
22430,0,11,2613,11,2026,0
25577,0,67,2466,62,16580,5
37223,14,452,1869,385,12270,67
15249,44,1597,2973,1340,9202,257
17524,56,2615,2860,1903,12870,712
11183,43,1424,3233,1376,13441,48
37952,12568,301255,1820,217549,994552,83706
27686,1,185,2362,159,11449,26
36903,412,14023,1889,8182,106898,5841
23332,12,941,2568,682,6308,259
28970,2,167,2289,136,5911,31
44083,97,5070,930,1207,28206,3863
28672,0,18,2305,16,1491,2
45094,25,233,700,164,5072,69
33683,184,6496,2065,4248,32568,2248
13505,25,1117,3093,999,13820,118
16258,9,417,2927,358,3552,59
24362,2,207,2520,174,9110,33
39562,2,51,1716,41,2388,10
30549,15,637,2207,307,8589,330
10301,11,589,3282,501,11212,88
38830,9,474,1761,370,4007,104
24812,33,1870,2499,1044,18061,826
38903,10,484,1756,350,6285,134
34879,174,13852,2013,7368,106025,6484
46305,99,1556,261,1338,13999,218
32507,2,240,2111,102,4317,138
24048,3,84,2534,74,2291,10
12284,107,6887,3178,4896,57023,1991
10905,24,866,3248,693,6913,173
27579,17,381,2368,299,4897,82
1267,4,135,3881,115,5164,20
19935,79,5077,2751,2533,32719,2544
36916,28,383,1888,294,4504,89
39087,17,277,1744,204,9675,73
38837,35,536,1760,464,6919,72
40609,8,149,1639,110,1445,39
34683,31,492,2024,381,9677,111
25423,51,1558,2473,1052,8828,506
13825,24,1920,3070,1223,20553,697
15112,61,3888,2981,2831,27688,1057
14233,36,1157,3040,1001,5844,156
21136,2,90,2683,85,1802,5
6960,1485,79191,3486,59471,503594,19720
23378,1,130,2565,101,5962,29
43779,27,330,990,206,5777,124
13870,19,719,3066,581,7206,138
15586,22,1656,2957,1274,21741,382
38940,4,83,1754,66,3295,17
44373,18,295,895,231,4572,64
20497,23,835,2721,633,7385,202
44761,4,43,813,29,2496,14
43323,3,67,1141,49,2408,18
43806,24,317,986,282,6327,35
36402,12,321,1918,178,3512,143
38075,9,168,1813,157,3952,11
35590,39,843,1972,568,9630,275
23903,28,868,2541,711,9026,157
16337,4,333,2924,273,11908,60
38927,14,474,1755,327,6900,147
30155,12,479,2231,405,9805,74
43223,8,197,1170,135,3158,62
38387,6,137,1791,93,5410,44
44783,5,136,805,88,3296,48
19002,28,610,2797,445,5897,165
44297,14,286,908,159,7715,127
38925,1,34,1755,26,3358,8
35144,25,648,1999,489,6449,159
24924,95,3270,2494,2433,30755,837
14881,42,2378,2993,2059,30043,319
33603,3,80,2067,50,2168,30
26723,245,9938,2413,5536,53848,4402
32889,2,107,2095,91,4216,16
29966,9,458,2239,390,6379,68
23166,19,1173,2576,937,11501,236
45809,4,56,456,41,2682,15
20842,1,199,2702,163,3277,36
44701,29,349,834,264,5349,85
31453,16,536,2164,442,5375,94
38414,41,953,1789,691,6409,262
37868,123,1092,1826,794,8909,298
16438,6,248,2918,212,4242,36
36967,48,4041,1885,1777,26928,2264
19075,4,728,2794,357,13602,371
32578,6,302,2108,180,5023,122
29114,17,525,2282,400,3570,125
24969,0,22,2492,20,16853,2
25199,17,1180,2482,563,11632,617
46101,7,76,336,58,1708,18
37526,6,467,1850,77,3333,390
42289,8,217,1394,165,4548,52
22408,41,2154,2613,1740,10735,414
31757,312,11386,2147,7970,36330,3416
39035,26,645,1748,522,12919,123
37586,59,2159,1846,926,13380,1233
45517,216,3629,574,2626,35044,1003
33984,21,1269,2054,651,10441,618
13919,2,109,3060,106,3958,3
30798,19,424,2195,312,3708,112
41110,1,52,1591,37,5781,15
11773,12,816,3203,758,11185,58
37435,1,39,1856,31,3861,8
17819,3,124,2849,94,2997,30
22522,7,170,2607,143,7489,27
18892,1,171,2801,121,7434,50
46261,5,60,279,43,2434,17
34692,28,905,2024,755,10319,150
16181,11,1398,2931,1196,31761,202
38776,26,557,1764,485,12906,72
36324,163,5533,1922,3220,61556,2313
42865,107,5278,1272,2462,54792,2816
41398,38,1581,1550,851,14670,730
40262,4,194,1672,122,8372,72
40965,3,65,1608,56,8815,9
17646,4,59,2855,51,5637,8
17499,24,612,2862,378,9657,234
32362,6,295,2117,214,5760,81
16065,28,1147,2936,904,13643,243
33015,3,151,2089,128,8049,23
23305,19,342,2569,261,9632,81
45579,0,67,551,55,2264,12
16263,18,1066,2927,824,22574,242
39379,6,121,1726,111,4166,10
41848,0,0,1476,0,3857,0
36462,66,2348,1915,1727,28340,621
12218,244,71519,3182,9853,236745,61666
6244,806,45893,3519,45404,148445,489
30259,5,201,2225,150,4066,51
8489,346,9522,3382,6528,38365,2994
19428,14,2345,2777,1869,24523,476
20954,35,1340,2694,1059,14958,281
14969,35,1230,2989,1013,19731,217
31632,1,64,2154,59,5726,5
14437,38,2010,3024,1829,25385,181
10890,23,2175,3249,1381,52361,794
8658,14,1388,3371,1103,6715,285
42382,19,551,1377,388,19933,163
30714,22,376,2199,305,4552,71
27529,1,206,2370,151,5043,55
27378,4,118,2380,89,3004,29
41267,54,1184,1569,864,19113,320
20318,5,329,2730,260,9162,69
5684,689,29419,3543,26823,111604,2596
18692,12,974,2809,693,4225,281
28524,3,58,2313,50,5141,8
41760,112,2754,1493,1994,48819,760
38107,2,64,1810,42,8215,22
45287,17,382,634,215,8003,167
33705,24,1506,2064,913,27334,593
20064,15,760,2743,586,17187,174
38142,30,424,1808,332,5160,92
41015,3,246,1604,194,3930,52
43763,27,615,995,358,5824,257
28377,4,433,2322,348,11798,85
15309,5,394,2970,334,8894,60
21146,15,691,2682,537,9166,154
41577,19,479,1526,375,10054,104
19200,19,1163,2789,663,9983,500
10289,102,4782,3282,4084,28397,698
43738,32,381,1004,350,13187,31
18268,59,2830,2827,2086,17050,744
25062,200,12291,2488,8698,88029,3593
18772,43,1334,2806,1082,12876,252
41409,48,1502,1548,1149,15407,353
16317,22,1149,2925,862,11006,287
15637,302,15909,2955,11298,125273,4611
33870,60,584,2057,445,6232,139
42964,20,532,1246,369,18794,163
12687,32,1411,3155,837,12829,574
29740,7,107,2251,89,3552,18
22102,4,89,2627,70,3898,19
25122,18,224,2485,174,3194,50
36989,8,260,1884,218,5866,42
40905,11,347,1613,290,18274,57
36546,368,24667,1911,6299,147232,18368
9704,0,164,3310,62,1631,102
32803,15,241,2099,199,4211,42
38187,75,2013,1805,1593,34895,420
27117,1,64,2397,60,2868,4
34840,7,204,2015,149,6760,55
43091,10,90,1206,88,5030,2
25759,432,30095,2457,10403,122255,19692
25117,271,12067,2485,8665,109379,3402
45942,4,111,399,64,3195,47
36224,154,2297,1927,1727,21824,570
20099,21,823,2741,618,7149,205
38301,226,5357,1797,4292,37045,1065
13924,14,689,3060,580,10886,109
24868,26,595,2497,458,5561,137
33823,1380,51937,2059,32870,306305,19067
36634,5,98,1905,84,3130,14
24560,14,246,2510,190,4664,56
30364,49,2083,2218,1213,16623,870
29923,6,103,2241,83,2504,20
26133,85,4859,2441,3444,51976,1415
28238,1,62,2330,49,2972,13
43600,6,105,1050,93,4036,12
18598,3,319,2814,262,8753,57
25750,1,140,2457,30,2840,110
39081,0,58,1745,50,1985,8
31447,0,259,2164,155,8259,104
28031,230,21856,2342,8814,81290,13042
13587,44,2091,3087,1421,15720,670
32468,2,106,2113,92,3227,14
18245,8,318,2828,212,5048,106
46156,89,2271,310,1739,31617,532
28977,5763,351942,2289,77556,1282359,274386
19341,3,260,2781,219,4406,41
13588,59,4500,3087,3692,18425,808
30951,23,438,2189,356,10907,82
15592,6,257,2957,175,6923,82
32969,330,14804,2092,7877,91673,6927
16097,0,35,2934,29,2998,6
8287,14,482,3396,480,7524,2
24786,4,66,2500,56,3377,10
43419,1,58,1108,52,3584,6
33513,16,405,2070,325,11754,80
42711,1,118,1309,105,8428,13
45624,39,438,534,347,5276,91
37677,210,6852,1841,4964,50230,1888
27400,11,664,2379,416,14282,248
13190,27,2259,3117,1830,21359,429
31000,51,2713,2187,2018,33567,695
19995,0,30,2747,27,1609,3
15704,17,940,2952,578,10834,362
30628,7,237,2203,200,7945,37
25469,14,255,2471,221,2443,34
42131,153,1921,1429,1447,17480,474
38330,31,6311,1795,499,8489,5812
35692,9,192,1964,158,2868,34
35546,182,7279,1975,4235,55399,3044
37306,6,226,1864,206,6639,20
21637,553,35565,2654,25181,187997,10384
26410,74,2729,2427,2168,12955,561
18717,5,221,2808,178,11819,43
21010,0,2984,2690,2431,59999,553
37640,5,217,1843,181,5005,36
22370,71,4423,2615,3362,36000,1061
42456,283,6847,1360,5046,44640,1801
15041,90,6448,2985,4666,46343,1782
28413,5,87,2320,71,3066,16
10295,55,2208,3282,2013,14198,195
38941,29,562,1754,385,11516,177
25787,26,512,2455,434,7518,78
45807,2,54,457,48,1390,6
21751,3,152,2648,125,3714,27
19127,0,1080,2792,376,15324,704
19472,17,1016,2774,829,10789,187
16544,1183,114593,2913,47773,245268,66820
43258,1,145,1158,107,2830,38
42626,17,688,1328,461,7907,227
19605,121,6277,2769,3768,59274,2509
38306,15,740,1797,394,9245,346
45310,72,1045,627,852,8926,193
41578,5,283,1525,210,6420,73
46130,7,150,323,122,2429,28
15886,0,451,2945,355,8531,96
22490,19,2019,2609,1615,15739,404
16757,86,1881,2902,1470,13668,411
19896,3,202,2752,148,6921,54
38605,36,912,1774,743,10236,169
45103,34,683,695,369,8388,314
10842,119,28460,3252,7230,122538,21230
16027,2,152,2939,108,3914,44
39649,13,444,1711,357,8446,87
32640,11,231,2105,195,4558,36
14376,30,855,3028,686,5765,169
29317,40,3694,2271,1630,25451,2064
32029,15,437,2134,331,4000,106
35335,41,2163,1989,1790,20081,373
40545,104,1111,1645,927,70806,184
26843,24,922,2407,444,9114,478
16286,4,178,2926,136,6001,42
45738,13,203,479,170,3083,33
38088,22,492,1812,407,15027,85
22773,1,210,2595,185,7526,25
45053,2,46,722,39,1911,7
44684,12,102,839,98,2647,4
31093,3,171,2183,147,3768,24
27711,119,5505,2360,3424,57679,2081
27434,38,3264,2377,1916,29599,1348
21176,1362,130301,2679,24821,395057,105480
1011,8,156,3967,141,4982,15
23996,29,1419,2536,1107,24697,312
21908,100,2359,2639,1771,16782,588
25603,2,123,2464,68,6632,55
32122,50,2233,2128,1333,18776,900
34404,5,235,2039,204,5646,31
14704,57,3973,3005,2328,23388,1645
42137,83,1121,1427,880,14882,241
32304,161,14719,2120,7667,57190,7052
28992,352,13779,2288,8399,76656,5380
33105,1,110,2086,100,5567,10
13556,17,1434,3089,1124,34038,310
40703,28,761,1632,598,14746,163
29440,19,771,2265,518,8304,253
37551,2,215,1848,190,4357,25
28586,108,6650,2309,1398,28159,5252
35946,4,111,1945,90,5665,21
15700,1,554,2952,247,6985,307
11483,384,27780,3218,18468,145535,9312
24025,0,577,2535,460,7083,117
13239,12,1149,3114,915,5377,234
40696,2,83,1633,66,2460,17
33380,0,171,2076,57,4912,114
31941,1,28,2139,24,1672,4
14556,131,3707,3015,3043,31711,664
28199,7,113,2332,90,2085,23
21534,33,1153,2660,928,7914,225
25901,83,3915,2451,2448,19690,1467
31032,1,32,2185,28,3186,4
6967,278,32177,3486,29726,242212,2451
34801,0,120,2018,108,6874,12
34256,15,1300,2045,521,14633,779
46065,13,146,345,102,4296,44
43855,5,124,977,104,3727,20
39536,107,3835,1718,1918,31178,1917
1869,273,11182,3661,10772,47069,410
28207,19,1345,2332,472,8984,873
26290,2,30,2433,26,1333,4
14228,31,1773,3040,1238,20886,535
15959,39,7270,2942,1674,35077,5596
29436,3,134,2265,106,5042,28
24081,0,1951,2532,913,16839,1038
14635,28,1245,3010,1066,11879,179
45676,26,269,509,246,4126,23
39467,5,200,1722,121,3485,79
14958,52,4686,2989,3776,53330,910
15058,9,251,2983,241,8692,10
29364,16,1501,2269,597,12852,904
40740,3,378,1629,273,6322,105
39255,2166,60890,1733,39548,285660,21342
27590,287,13816,2367,9994,82947,3822
16230,25,1720,2929,1383,24242,337
35351,9,480,1988,356,6091,124
18731,31,1759,2808,1307,15472,452
39522,4,312,1719,217,7479,95
31538,30,520,2158,439,6227,81
31669,140,2903,2151,2166,22289,737
17724,8,490,2853,387,3553,103
34041,81,4279,2052,2751,40369,1528
16556,17,565,2913,417,2981,148
32674,12,388,2104,306,18975,82
21633,7,391,2654,325,15443,66
25201,49,3537,2481,2635,32739,902
30077,3,204,2234,133,10754,71
20100,9,424,2741,337,5304,87
42353,12,252,1382,200,4022,52
37764,5,117,1834,93,2622,24
26804,3,118,2409,89,1606,29
38902,95,1507,1756,1257,14166,250
15919,51,2801,2944,2174,30097,627
16292,14,575,2926,450,8064,125
44465,26,406,883,236,8931,170
35821,6,181,1954,157,3293,24
8392,68,4913,3389,4668,87070,245
31296,26,562,2172,387,17275,175
11333,103,4587,3227,3557,36406,1030
43516,3,41,1082,27,4167,14
11097,33,605,3238,504,12611,101
30657,3,159,2201,141,5032,18
22989,33,3200,2584,2001,35659,1199
11552,2,155,3214,153,2742,2
14980,17,956,2988,876,12372,80
13015,33,1992,3135,1538,18644,454
1137,4,329,3927,263,10030,66
29561,80,5025,2259,1726,20623,3299
24212,27,781,2527,659,5240,122
34255,4,130,2045,110,5585,20
31676,10,764,2151,635,9134,129
26310,32,804,2432,646,9199,158
26825,4,218,2408,187,3368,31
46354,5,37,242,34,1075,3
43431,26,549,1106,347,13599,202
22012,58,2662,2633,1998,11462,664
44299,14,116,906,93,3611,23
19399,42,6178,2778,1613,18678,4565
43273,92,2945,1154,1119,27978,1826
19044,0,36,2795,29,1383,7
29404,5,484,2267,128,6554,356
21429,59,6726,2666,2349,36852,4377
29936,5,139,2240,125,7413,14
18211,45,1385,2830,1055,14591,330
35879,6,93,1950,83,3166,10
46257,0,51,280,36,1219,15
23793,22,668,2546,437,12204,231
45856,4,92,440,45,4054,47
18164,14,250,2833,200,5952,50
31561,26,509,2157,414,5825,95
45596,19,346,548,309,6797,37
31580,6,193,2156,158,3425,35
15404,33,3528,2967,2786,28716,742
10266,315,39086,3283,23351,176211,15735
45029,129,1258,733,879,14999,379
19235,22,728,2787,560,6361,168
46303,33,706,262,395,8000,311
38706,34,1113,1768,825,6374,288
34793,186,12739,2018,3062,51301,9677
30484,2,129,2211,99,4507,30
26709,128,6561,2414,4315,40679,2246
32496,6,106,2112,83,2490,23
30004,71,1057,2238,827,8159,230
37657,30,690,1842,384,5047,306
7420,312,31629,3461,28807,256563,2822
19583,7,425,2770,203,10001,222
32691,24,1008,2103,824,13815,184
27149,208,5966,2394,4618,34736,1348
33096,1,136,2086,106,6775,30
30051,57,3150,2235,2339,23822,811
10735,26,2323,3257,2099,23193,224
16626,0,1177,2910,502,17435,675
26062,120,5113,2443,2534,32650,2579
45643,43,556,524,366,7878,190
23597,46,3227,2555,1764,26366,1463
19772,432,25109,2759,14574,69339,10535
15470,24,2290,2964,1515,26278,775
40198,132,3662,1677,2595,30776,1067
13186,92,4356,3117,3702,51362,654
19688,2,315,2765,260,6225,55
30968,12,273,2189,235,2820,38
23979,0,311694,2537,128376,615934,183318
18806,878,81642,2804,37453,300221,44189
30359,38,1093,2218,837,13971,256
19774,7,354,2759,301,6002,53
40670,16,562,1635,441,16797,121
38169,8,164,1806,133,10509,31
36840,4,129,1892,98,5549,31
34887,9,300,2012,258,10433,42
13285,134,7350,3111,3964,43316,3386
19094,0,764,2793,268,15152,496
28341,38,1916,2324,1364,27705,552
29154,82,2152,2280,1699,11941,453
33482,183,3987,2072,3187,29224,800
18640,9,230,2811,186,2592,44
35523,13,611,1977,366,15868,245
14246,35,1408,3039,1249,25460,159
17558,94,3026,2859,2379,44115,647
36075,562,12962,1935,10075,54508,2887
33024,3,228,2089,179,6407,49
43677,15,307,1023,256,10007,51
20642,110,3051,2714,1430,11076,1621
39201,20,715,1737,539,14565,176
31313,3,148,2171,123,3732,25
45302,2,25,631,25,1802,0
32323,7,217,2119,181,6408,36
27179,3,415,2393,291,9421,124
41598,13,189,1520,131,4881,58
2097,27361,1742557,3656,787038,4548979,955519
29905,51,1265,2242,546,15026,719
29564,80,2681,2259,2124,29256,557
13581,149,11068,3088,9058,73756,2010
27433,11,357,2378,283,2898,74
17578,8,657,2858,538,10958,119
23522,7,108,2559,95,2612,13
35428,2,70,1984,59,3012,11
25270,4,90,2479,75,1073,15
30530,17,609,2208,472,11971,137
31456,7,168,2163,137,4132,31
33167,6,153,2083,97,4440,56
25551,68,3088,2467,1675,31683,1413
31335,0,35,2170,29,3131,6
32238,55,2292,2122,1524,13187,768
36009,2,85,1940,56,2963,29
26519,5,83,2422,68,5068,15
39432,16,432,1724,321,6838,111
31100,5,197,2182,166,6288,31
44838,71,1470,786,929,15450,541
11571,3,179,3214,171,1713,8
40025,2,77,1687,64,3104,13
37888,12,198,1825,166,5879,32
32309,0,48,2120,44,6850,4
36229,0,49,1927,44,2511,5
1379,1,37,3810,34,7608,3
43147,9,243,1191,178,8236,65
45963,21,211,393,192,2996,19
45018,260,2430,737,2231,15839,199
21698,99,15984,2650,5299,52888,10685
11280,5149,338989,3228,165645,977657,173344
29948,411,11504,2240,8730,43101,2774
6322,33,1303,3516,1220,9239,83
16697,4,270,2906,229,9525,41
19138,42,1733,2792,1336,28303,397
20434,11,473,2724,385,9834,88
21756,4,340,2648,286,7925,54
32980,1,44,2091,33,3451,11
13252,5,427,3113,303,6833,124
33177,3,137,2083,85,3831,52
29756,8,412,2250,277,7065,135
25799,456,15102,2455,10764,52743,4338
44011,185,1994,953,1785,21842,209
39421,0,10,1724,9,2125,1
23915,1,104,2541,95,2917,9
32176,1,99,2125,75,4505,24
42260,14,417,1400,353,12377,64
28197,92,2898,2332,2127,24232,771
33077,3,76,2087,71,3020,5
25336,52,1149,2476,881,7342,268
31700,14,712,2150,531,16924,181
41097,52,589,1593,433,5993,156
42718,81,1417,1308,583,12555,834
32023,42,3105,2134,2413,35116,692
22614,17,950,2603,778,20915,172
43313,29,350,1143,247,5552,103
32971,2,81,2092,62,4096,19
18773,8,367,2806,297,5679,70
32752,0,0,2101,0,19823,0
15962,9,378,2942,319,5374,59
29930,7,891,2241,226,8013,665
16733,7,671,2904,452,9757,219
45804,10,129,457,97,2263,32
20715,58,5014,2709,3828,33221,1186
24544,30,4788,2511,1075,21863,3713
17115,0,25,2882,20,2120,5
14520,12,335,3017,282,3927,53
42887,8,113,1265,79,3339,34
30450,9,203,2213,173,4492,30
18167,124,5093,2832,2894,25527,2199
15481,4,907,2964,776,15138,131
11727,21,1216,3205,1104,17044,112
18145,8,244,2833,197,11707,47
21292,4068,270768,2673,136888,535997,133880
18884,1,443,2801,365,6429,78
10791,237,12174,3255,12035,131243,139
27976,3,380,2345,307,7484,73
36619,100,1765,1906,1401,15366,364
39511,58,2317,1720,1711,14534,606
22589,27,1535,2604,922,12425,613
40625,5,98,1638,85,2700,13
9958,3,62271,3297,222,2645,62049
39325,21,330,1729,190,3832,140
29485,23,448,2262,317,6039,131
24708,26,1343,2502,984,11616,359
8957,13,106488,3354,475,4911,106013
40726,2,56,1630,45,4815,11
45056,231,1994,721,1728,12636,266
40408,26,473,1659,348,8697,125
20787,24,903,2705,690,9551,213
32145,25,2452,2127,1957,29897,495
27431,21,2267,2378,553,14669,1714
16114,3,75,2934,64,1476,11
36206,5,201,1928,174,3371,27
18231,18,866,2829,529,9651,337
34378,0,0,2040,0,8478,0
38680,9,379,1770,324,13991,55
9744,131,4370,3308,3607,19014,763
34881,14,906,2013,477,8449,429
40896,17,744,1613,522,17784,222
26214,126,7360,2436,5354,22817,2006
35185,8,633,1997,273,8241,360
23660,76,1515,2551,1159,16051,356
17477,115,13426,2863,9420,56314,4006
14456,4,485,3022,378,5589,107
34490,6,218,2035,186,11891,32
12371,6,333,3172,303,5290,30
18990,2,148,2797,125,2684,23
20382,392,19565,2727,14594,111321,4971
23946,120,5185,2538,3182,23502,2003
39570,1,170,1716,141,3771,29
20772,25,2898,2706,2309,30899,589
35267,0,626,1992,512,18387,114
27314,26,728,2385,615,13287,113
42755,212,2309,1298,1611,18976,698
16013,2,156,2940,122,4711,34
42825,11,270,1281,193,6804,77
29931,505,14554,2241,10338,72433,4216
41910,5,389,1466,298,11174,91
42018,58,1760,1449,1377,15390,383
27474,59,1463,2374,991,10127,472
38840,203,6788,1760,4894,47609,1894
32819,26,892,2098,566,18659,326
39717,7,165,1707,144,4487,21
14821,35,1557,2997,1450,16965,107
32055,21,996,2132,505,18163,491
33913,14,196,2056,174,7284,22
15980,60,1304,2941,1053,8155,251
35958,21,1149,1944,498,8792,651
30502,12,327,2210,257,9558,70
29177,0,42,2279,31,1573,11
36880,1,48,1890,43,1602,5
40022,13,275,1687,182,5190,93
27555,5,129,2369,99,6641,30
37978,4,189,1818,133,3176,56
36277,47,1536,1924,1239,15525,297
18918,8,497,2800,409,9833,88
27571,53,5114,2368,3841,26017,1273
23579,5,209,2556,116,5441,93
27020,158,10529,2402,4531,73473,5998
13812,140,7173,3071,7128,106064,45
15220,12,810,2975,703,9941,107
45391,3,36,606,33,1356,3
17486,29,2579,2862,1447,26496,1132
43547,17,332,1070,135,7306,197
20171,2,128,2737,116,5661,12
23268,522,24839,2571,17917,142114,6922
43655,51,669,1030,536,9370,133
36527,841,34388,1912,19447,208896,14941
22699,55,2161,2599,1651,12115,510
27291,26,225,2386,188,3684,37
40778,33,628,1625,495,13590,133
3085,36,3639,3639,3462,22367,177
29997,4,101,2238,86,2672,15
32313,5,121,2119,96,3529,25
24722,26,1504,2502,1227,21398,277
31075,8,183,2184,141,4632,42
42155,176,3550,1422,2371,47742,1179
42784,2,128,1289,104,10108,24
27542,112,10418,2370,5744,66935,4674
36419,10,747,1917,260,10553,487
31528,59,3435,2159,1988,31447,1447
19929,64,4288,2751,2873,38943,1415
33760,17,317,2061,277,9550,40
22862,2,221,2591,192,5385,29
33131,23,408,2084,325,8141,83
11755,742,74926,3204,21397,302869,53529
29919,17,1543,2241,820,14801,723
43638,52,700,1036,581,20957,119
41453,1,195,1541,159,4711,36
46171,2,25,303,18,1084,7
36270,220,6983,1924,5183,50506,1800
39425,33,708,1724,561,12085,147
16912,14,669,2894,503,12763,166
21912,18,446,2639,362,5957,84
31056,4,226,2184,153,10164,73
13448,85,5222,3097,4413,18511,809
30671,1,35,2201,28,5818,7
45540,22,255,566,234,6818,21
38395,7,260,1790,216,5539,44
42997,59,1486,1235,1098,9768,388
29035,102,4737,2286,3125,26617,1612
34672,0,42,2025,27,2704,15
33657,13,398,2065,231,10395,167
10852,298,19957,3251,9902,79591,10055
42190,106,1211,1414,937,17886,274
21074,74,2777,2687,2155,48224,622
42343,12,311,1385,210,8257,101
13945,13,498,3058,390,10044,108
29489,16,201,2262,175,4242,26
35616,19,546,1970,289,10124,257
29806,82,5188,2247,2609,28928,2579
33415,6,122,2075,93,1921,29
39976,25,621,1690,518,16723,103
19247,119,4560,2786,3192,41764,1368
45927,220,3480,409,2636,18595,844
14587,5,245,3013,193,8168,52
18286,0,82,2827,56,3184,26
22355,10,290,2616,172,4116,118
35387,76,806,1987,534,7642,272
19621,4,157,2768,132,4748,25
35126,18,1071,2000,900,19786,171
20948,6,409,2694,249,10571,160
27882,130,1948,2351,1514,10958,434
44785,36,302,805,247,6924,55
13312,138,8769,3109,6063,78378,2706
35791,6,224,1956,175,10835,49
22661,14,922,2601,406,9626,516
8246,7,385,3399,348,7670,37
27105,5,173,2398,146,10498,27
21365,118,3987,2669,2783,24145,1204
40274,3,140,1671,111,4753,29
21587,11,701,2657,555,7814,146
38196,83,2514,1805,1952,28878,562
39146,44,1013,1741,771,16691,242
18605,19,1372,2813,904,17389,468
37993,1,111,1818,77,3961,34
36693,47,1419,1902,903,9510,516
14709,20,699,3005,624,8692,75
42605,9,176,1332,142,3265,34
10834,11,1134,3252,1131,16238,3
34933,19,324,2010,259,5091,65
40028,4,90,1687,74,4360,16
32049,3,153,2132,88,4077,65
27181,2,100,2392,33,3581,67
36867,4,70,1891,57,2604,13
12756,9,389,3151,361,8713,28
31996,3,175,2135,127,3856,48
13143,12,1086,3127,766,9093,320
29314,162,4436,2271,2764,26289,1672
17276,0,55,2872,27,3016,28
15591,122,4536,2957,3264,53864,1272
42208,201,3812,1411,2509,60608,1303
15315,20,2241,2970,1014,14203,1227
30276,21,1944,2224,318,7685,1626
40639,3,271,1637,156,7239,115
28423,9,196,2319,132,4429,64
45035,6,67,729,58,2452,9
33194,2,133,2083,117,4041,16
46125,8,125,326,83,2625,42
31752,27,1757,2147,1388,22840,369
1313,1,208,3860,171,4412,37
28688,70,2436,2304,1858,26874,578
30866,25,788,2192,600,8908,188
30958,2,127,2189,92,2659,35
949,12,272,3986,234,4323,38
36771,12,643,1898,507,13842,136
40054,0,16,1685,11,1103,5
15409,0,57,2967,42,2879,15
12357,7,62468,3173,704,17594,61764
45651,12,115,521,110,6061,5
46178,3,68,300,44,2070,24
43250,2,74,1161,56,2209,18
11497,43,2171,3217,1627,19708,544
31490,69,3356,2161,2168,30197,1188
28130,18,840,2337,458,7464,382
41117,28,312,1590,260,5861,52
28534,203,15736,2312,6972,73359,8764
29565,38,750,2259,609,6918,141
40977,4,140,1607,83,2718,57
7678,7,340,3446,273,9251,67
14079,5,87,3048,83,6129,4
37956,2,69,1820,58,3911,11
30937,3,56,2190,45,1862,11
7791,373,14649,3438,14160,70056,489
23645,34,1671,2552,1321,20515,350
29476,5,86,2263,69,2130,17
36333,2,61,1921,47,3266,14
26204,22,974,2437,750,12953,224
12047,48,2285,3191,2217,24933,68
32160,30,2239,2126,1310,23313,929
42037,401,8891,1446,5975,85112,2916
8904,52,2632,3358,2478,17731,154
38490,33,1153,1784,871,14815,282
45663,4,46,517,40,1671,6
23296,196,4620,2570,3034,23360,1586
21962,4,135,2635,96,10568,39
41806,1,35,1484,28,3231,7
19041,3,313,2795,236,3103,77
33640,13,551,2066,336,6728,215
29574,2,126,2258,105,7041,21
27026,15,891,2401,671,14312,220
40221,0,76,1675,52,4553,24
33658,4,64,2065,59,3508,5
21591,4,147,2656,119,6629,28
31995,11,278,2136,179,4162,99
29016,25,1194,2287,998,16202,196
31411,4,126,2166,107,3224,19
10090,197,11675,3291,7136,62643,4539
15371,3,156,2968,134,4636,22
23887,5,202,2542,177,4664,25
19962,34,1940,2749,1518,30430,422
34331,4,270,2042,194,9262,76
14948,453,33617,2990,22096,129846,11521
27328,6,329,2384,249,3805,80
37211,2,48,1870,41,4011,7
32032,2,101,2134,76,6069,25
17873,20,1130,2847,568,9190,562
28945,292,20844,2291,9580,84921,11264
20009,46,3844,2746,1556,18712,2288
44722,74,587,825,512,15936,75
33735,0,0,2062,0,2328,0
21457,10,468,2664,355,8936,113
16976,1111,234376,2891,31814,530480,202562
16816,2,128,2898,81,5158,47
14550,40,1795,3016,1646,18779,149
35340,35,2187,1989,1168,19034,1019
45247,42,391,649,338,6686,53
44955,20,322,755,177,10866,145
27715,6,191,2360,160,2066,31
18588,1,125,2814,108,2037,17
17884,19,1379,2846,1039,15795,340
39229,10,432,1735,345,10956,87
35878,5,123,1950,104,2828,19
27100,6,104,2398,80,2540,24
18489,12,634,2818,535,15740,99
2457,15,480497,3650,358,9454,480139
25917,15,497,2450,373,5757,124
29699,36,856,2252,612,4033,244
27602,50,1347,2367,1099,24098,248
18025,2,139,2838,119,2728,20
27047,0,119,2400,46,2272,73
26334,2,93,2431,86,3608,7
14863,7,391,2995,338,7276,53
29068,2,44,2284,24,5322,20
31790,10,197,2145,106,1901,91
19088,221,13446,2793,10322,108634,3124
45344,6,52,619,32,2080,20
24461,4,121,2515,89,7032,32
44758,27,445,813,327,7343,118
3763,150,5569,3626,4709,36220,860
46389,61,2066,223,1047,12687,1019
12554,108,8062,3163,5948,61532,2114
35502,0,27,1979,22,3281,5
1009,22,1430,3967,1132,21905,298
36035,20,1247,1939,797,14092,450
32866,5,120,2096,70,5280,50
25561,53,895,2467,726,9292,169
12929,11,528,3141,278,7273,250
26154,1,37,2440,32,1707,5
18315,8,296,2825,246,5498,50
18192,0,112,2831,92,10677,20
40314,4,84,1668,66,6355,18
12980,129,12241,3137,8292,70902,3949
32886,57,5785,2095,4484,15577,1301
23300,0,15,2569,12,2527,3
45398,25,370,604,295,5658,75
30859,158,6436,2192,4464,49422,1972
13814,1612,111426,3070,43870,401036,67556
24008,13,597,2535,478,4020,119
13427,19,510,3100,441,8476,69
20106,201,12094,2741,7641,67673,4453
41455,142,2996,1541,2227,30140,769
16985,39,2428,2890,1260,24935,1168
23155,2,349,2577,200,11968,149
23649,133,5410,2552,4304,38908,1106
28765,552,16121,2299,12382,119971,3739
30785,45,2899,2196,1892,36894,1007
41391,44,471,1551,368,7114,103
38892,40,941,1757,736,16748,205
32185,0,21,2125,19,1506,2
28799,37,1162,2298,874,30993,288
24019,0,951,2535,779,18908,172
9276,264,13710,3335,11867,64053,1843
17167,213,39773,2878,13975,107842,25798
28229,7,423,2331,207,7227,216
11411,7,371,3223,322,2475,49
25171,66,2177,2483,1697,8150,480
36575,27,310,1909,271,4166,39
33254,3,212,2081,132,6952,80
20792,3,330,2704,260,4205,70
45729,90,2845,482,1107,14989,1738
22918,39,652,2588,480,8113,172
39541,2,33,1718,30,2176,3
11859,18,392,3200,350,11299,42
38231,12,245,1802,183,6905,62
14355,14,491,3029,441,10283,50
29808,360,16811,2247,6692,67531,10119
32961,4,100,2092,73,4079,27
27993,5,121,2344,106,3152,15
28809,0,1868,2297,1529,32835,339
39372,21,776,1727,600,7733,176
34206,89,3756,2047,2727,37549,1029
22612,79,2801,2603,2059,23799,742
43228,33,720,1167,449,16087,271
32858,56,1869,2096,1396,26012,473
24091,184,9044,2532,6477,65497,2567
30206,16,318,2227,280,4842,38
27462,14,622,2375,438,8035,184
32956,6,181,2092,147,5609,34
34549,4,54,2032,48,2679,6
31936,7,450,2139,370,8778,80
23724,9,422,2549,302,8049,120
42069,173,3324,1440,2605,30026,719
9338,62,2578,3331,2014,16893,564
15620,38,4052,2956,3130,32789,922
25296,3,206,2478,167,7878,39
40574,9,273,1642,212,5560,61
30735,20,500,2198,425,7318,75
33927,0,62,2056,54,2160,8
46104,117,3367,335,1599,25751,1768
20977,155,5183,2692,3801,28248,1382
41703,10,151,1504,112,2982,39
28045,11,536,2341,330,9219,206
32422,13,508,2115,300,9132,208
17123,0,7809,2881,3285,40359,4524
20603,65,3553,2716,2685,24829,868
26211,4,139,2436,102,5060,37
42092,100,3047,1436,2055,30022,992
9562,12138,957184,3316,381088,3085769,576096
30114,87,2728,2232,2216,16645,512
39525,2,55,1719,49,4320,6
40830,176,4239,1619,3242,40254,997
45001,27,294,742,181,5340,113
41221,168,4209,1578,3132,46388,1077
34067,4,264,2051,232,5850,32
39886,96,2039,1697,1628,14315,411
38675,1,73,1770,51,4161,22
33998,2408,144758,2053,56089,418624,88669
28433,7,95,2319,82,3282,13
35955,4,77,1945,65,4083,12
25643,19,558,2462,441,7216,117
44585,507,6318,860,5291,44812,1027
39923,81,2242,1694,1027,21637,1215
12996,69,3439,3136,1689,20078,1750
42953,1,179,1248,121,6547,58
24261,8,149,2525,127,2398,22
17073,37,2304,2884,1609,7361,695
28029,61,3893,2342,2631,61233,1262
39406,2,112,1725,90,3945,22
42049,15,511,1444,376,9902,135
31883,15,267,2141,226,3600,41
24140,28,987,2530,854,24282,133
26206,7,171,2436,147,2977,24
34822,4,112,2016,91,7250,21
35211,31,830,1996,619,13346,211
8451,94,8596,3386,6140,58704,2456
11234,20,917,3231,847,13765,70
46406,77,1577,213,1413,20639,164
5800,18,1541,3538,1255,18116,286
41670,117,1076,1510,844,14856,232
20378,3,188,2727,121,3870,67
12245,247,17181,3180,12126,112240,5055
37320,15,318,1863,251,3208,67
30177,3,48,2229,44,4939,4
30570,2,242,2206,180,3534,62
19122,15,429,2792,330,5881,99
29394,37,1925,2267,435,4498,1490
28785,7,174,2298,107,1591,67
17745,2,142,2852,125,2213,17
29202,1,99,2278,90,2770,9
42664,27,204,1318,145,4443,59
10710,6,176,3259,168,14394,8
13241,12,263,3114,250,4707,13
37238,3,270,1868,219,19167,51
31149,3,67,2180,62,2153,5
42123,71,576,1430,412,6734,164
23621,22,734,2554,416,11472,318
20553,1,130,2718,95,2702,35
45071,911,14082,713,13490,85114,592
30367,29,1539,2218,467,6404,1072
19390,3,335,2779,246,11203,89
30456,4,95,2212,77,6440,18
22428,0,1119,2613,927,13629,192
39687,13,266,1709,218,4777,48
13922,69,3060,3060,3027,104600,33
35621,1,115,1970,93,2812,22
31734,100,1496,2148,1087,14066,409
15833,19,1001,2947,752,7220,249
13983,7,120,3055,112,8340,8
35563,0,45,1975,38,3539,7
28204,31,1230,2332,988,18440,242
23308,15,643,2569,500,8010,143
8388,163,11041,3389,5114,46119,5927
34032,1,396,2052,171,5015,225
25193,5,278,2482,219,4903,59
14206,34,1324,3042,1289,14009,35
36469,1,212,1915,80,6708,132
42705,6,173,1310,114,6171,59
36554,124,3381,1911,2467,30719,914
16333,0,27,2924,24,1908,3
20456,40,1949,2723,1492,21185,457
30953,0,0,2189,0,4143,0
11539,27,912,3215,883,19919,29
39627,67,1866,1712,1040,10670,826
40815,5,58,1620,52,5208,6
45217,2,31,656,19,1957,12
15736,8,256,2951,197,6653,59
11720,18,509,3205,325,3303,184
29592,9,321,2258,245,3856,76
19789,17,512,2758,406,6889,106
36773,83,4856,1897,1381,27483,3475
34123,2,42,2049,34,2247,8
21271,2,64,2674,56,1325,8
11659,7,358,3209,354,19854,4
6711,96,2077,3499,1802,23477,275
23178,351,31389,2576,14394,108813,16995
16896,46,2366,2895,1786,12491,580
13567,18,845,3088,831,15334,14
24372,186,5973,2519,4654,60755,1319
13209,2,124,3116,34,3550,90
25801,2,95,2455,59,5108,36
42003,9,572,1451,433,16671,139
39564,6,432,1716,263,6760,169
42788,101,1655,1288,1253,29965,402
45629,40,779,531,364,9685,415
42576,27,348,1338,217,3914,131
37420,251,7960,1857,5981,51805,1979
23891,4,308,2542,129,5408,179
23801,2,35,2546,33,4668,2
13223,32,972,3115,928,11942,44
13230,15,485,3115,459,13544,26
30105,22,2480,2233,964,13074,1516
10539,151,8665,3270,8008,45187,657
40412,1306,40502,1658,28717,196528,11785
43687,1,118,1018,70,4156,48
43728,244,3102,1006,2823,15745,279
16690,55,6670,2906,4143,37331,2527
16729,2,314,2904,254,11037,60
19775,0,84,2759,57,2828,27
32280,13,505,2121,415,11407,90
21762,11,914,2647,550,10609,364
35690,1,56,1964,52,18213,4
25996,337,19173,2446,11460,86134,7713
46143,1,107,316,70,3519,37
11446,53,1911,3220,1607,19171,304
34968,24,693,2008,431,8624,262
17611,19,761,2856,615,6510,146
43253,92,1537,1159,1298,22066,239
6357,23,143255,3514,1216,8741,142039
19536,110,4859,2772,3443,27338,1416
32132,12,266,2128,188,10759,78
46446,28,556,188,489,3616,67
17635,8,186,2855,153,3463,33
37557,1,25,1848,22,2914,3
24220,2,321,2526,274,9175,47
25115,17,604,2485,459,13464,145
21562,649,24217,2658,9990,83984,14227
15645,18,743,2955,569,11122,174
34297,11,464,2044,393,3443,71
9950,5,366,3298,284,10623,82
36412,1,109,1917,95,4576,14
42306,61,1706,1391,839,22865,867
34419,68,2268,2038,1730,11799,538
20686,1,164,2711,126,4287,38
29059,4,95,2285,81,3390,14
13443,111,11145,3098,7655,40625,3490
16282,2140,93721,2926,66034,188841,27687
12913,56,2374,3142,1538,21708,836
31431,285,11329,2165,8086,46493,3243
42894,145,10072,1263,2020,37791,8052
22591,51,1323,2604,651,7430,672
17294,6,346,2872,267,2553,79
29306,36,465,2272,393,3999,72
23934,86,2736,2539,1939,50058,797
42619,13,529,1329,367,12218,162
30333,11,292,2220,255,8162,37
32148,2,125,2127,110,3002,15
23093,1,70,2579,62,2083,8
29538,26,2165,2260,1570,15869,595
38769,5,88,1764,75,3481,13
41206,15,376,1581,299,6999,77
34253,3,300,2045,228,13386,72
45126,117,965,682,902,9242,63
35925,7,114,1947,90,2409,24
39895,9,273,1696,181,8497,92
11385,53,1026,3224,978,9984,48
14451,1213,87218,3023,53589,232904,33629
45514,2,36,575,35,2793,1
40618,135,2817,1639,2222,28130,595
32231,2,149,2123,124,3011,25
42680,99,1781,1315,1096,19797,685
17802,0,70,2850,53,5141,17
15120,19,526,2980,450,5963,76
27578,15,369,2368,318,6360,51
16742,67,4184,2903,2552,25152,1632
35261,58,1253,1992,976,12748,277
35940,4,86,1946,64,6080,22
17110,25,1889,2882,1222,24994,667
24455,28,933,2516,755,15453,178
13250,44,1473,3113,1250,15535,223
12013,10,316,3192,310,4262,6
41646,128,2566,1513,1402,20943,1164
27160,96,6458,2394,2197,46585,4261
14176,52,2808,3044,1754,17198,1054
1266,8,198,3881,163,6987,35
12713,24,865,3154,819,4429,46
32647,13,430,2105,368,11649,62
20639,9,621,2714,506,8504,115
45916,6,107,418,90,1573,17
45581,0,120,551,78,2763,42
18895,19,2112,2801,834,6173,1278
4273,176,15473,3610,13254,102945,2219
15245,1151,78937,2974,28755,207279,50182
38656,1,33,1771,27,2473,6
34721,62,725,2023,561,7270,164
33794,5,226,2060,164,3598,62
28875,10,713,2294,553,27561,160
43030,14,113,1227,109,3652,4
33965,0,17,2055,13,1793,4
19691,88,3331,2765,1992,23690,1339
22569,12,380,2604,317,13685,63
20635,4,391,2714,327,5617,64
19031,35,1205,2796,727,26204,478
33427,6,432,2075,287,7684,145
35806,0,52,1955,49,2925,3
25627,0,0,2463,0,7770,0
31488,98,6035,2161,2287,57892,3748
29682,1,138,2253,102,3022,36
37135,58,2084,1875,1621,13642,463
17024,10,381,2887,270,7562,111
19973,3,129,2748,110,5662,19
40644,15,248,1637,198,5853,50
41193,38,1095,1582,678,19455,417
45719,18,506,487,389,8728,117
43777,38,838,990,711,14207,127
39591,363,5126,1714,3916,32473,1210
38961,23,269,1752,246,4516,23
26647,29,709,2417,591,14419,118
36005,17,539,1940,243,4675,296
22543,2,0,2606,0,10659,0
1049,4,199,3948,166,5536,33
12971,32,1306,3138,1164,18482,142
34709,6,199,2023,144,4250,55
26164,0,265,2439,198,7399,67
17320,3,72,2871,59,7071,13
43329,5,168,1139,116,4687,52
27437,235,15761,2377,4673,62920,11088
31370,114,2644,2169,2223,25195,421
22194,9,602,2623,476,27279,126
37639,1,88,1843,73,3176,15
43606,0,18,1046,15,3016,3
25599,46,1749,2464,1375,25956,374
17954,8,423,2842,363,4823,60
20418,51,3675,2724,1799,14321,1876
45971,4,79,390,56,1927,23
25181,36,2530,2482,1677,16096,853
9544,958,40185,3318,31978,124924,8207
29311,16,608,2271,449,5161,159
12385,12,958,3172,807,19204,151
20404,1,54,2725,48,4035,6
10748,24,1998,3257,1509,16958,489
10655,129,4372,3262,4367,28374,5
1840,1786,108860,3662,82651,328850,26209
42227,122,2003,1406,1472,28266,531
17061,9,225,2885,158,8401,67
43882,43,739,976,558,15426,181
39517,18,219,1719,181,4044,38
33031,2,207,2089,172,2537,35
19917,54,5336,2751,2299,50016,3037
19152,1,59,2791,44,3458,15
21673,75,3977,2651,2077,29053,1900
17632,3,237,2855,138,10359,99
22551,43,8272,2605,2998,13000,5274
43618,26,263,1042,215,6395,48
37921,1,35,1822,28,2714,7
29843,0,55,2246,44,4354,11
32270,8,250,2121,206,3913,44
32158,17,336,2126,261,7678,75
40128,8,361,1681,257,7448,104
45828,13,221,449,183,5314,38
15808,2,60,2948,47,3724,13
13966,222,9607,3056,7496,77463,2111
18186,35,1832,2831,1445,36593,387
34875,23,807,2013,661,9045,146
35490,3,55,1980,32,5403,23
40648,59,2575,1637,2065,17469,510
28685,5,117,2304,79,2616,38
20479,25,727,2722,621,15554,106
37150,28,1407,1874,691,22878,716
33573,50,1049,2068,858,19475,191
12232,7,236,3181,206,3857,30
30668,15,1075,2201,835,20096,240
41487,18,586,1536,435,12337,151
26765,17,825,2411,668,7538,157
41224,17,396,1577,272,8056,124
37268,458,15887,1866,11696,94535,4191
35852,3,122,1952,102,4590,20
20918,5,288,2696,150,2221,138
37816,92,4770,1830,3371,46846,1399
25829,11,1009,2454,787,10893,222
17917,43,4283,2845,3099,32734,1184
20947,32,990,2694,793,10057,197
16429,52,4921,2919,3227,22065,1694
38147,66,1852,1807,1528,18360,324
17700,33,2186,2853,1636,14811,550
24049,11,485,2534,436,6185,49
35415,3,153,1985,115,5295,38
23986,20,662,2536,537,3757,125
12741,61,2852,3152,2819,25810,33
40955,7,318,1609,228,6225,90
33602,18,558,2067,403,9671,155
41773,1,24,1491,18,5507,6
25458,0,70,2471,52,3608,18
12249,1645,143808,3180,75678,654011,68130
31261,55,2407,2174,1824,39382,583
15056,56,2021,2983,1467,12897,554
31984,16,980,2136,733,26308,247
42403,2,67,1373,54,3796,13
42380,6,88,1377,67,2433,21
32906,1,48,2094,40,5641,8
18573,252,24975,2815,13783,86570,11192
20919,4,171,2696,144,5243,27
14476,60,3022,3021,2678,26502,344
45811,2,64,456,58,1564,6
38843,26,762,1760,550,7239,212
22125,6,242,2626,190,12490,52
38039,67,3391,1816,1409,25265,1982
40733,9,225,1630,164,3525,61
41153,32,560,1587,395,12712,165
12692,6,293,3155,286,6947,7
41124,12,280,1590,203,5207,77
38009,19,527,1818,456,5730,71
15512,6,80,2962,64,4071,16
13723,19,991,3077,964,11400,27
33901,31,743,2057,575,9471,168
36855,5,275,1891,229,2212,46
29686,0,91,2253,80,4445,11
28111,2,75,2338,58,4030,17
38772,1,82,1764,66,2608,16
26512,11,409,2422,346,5280,63
35264,30,1157,1992,916,13811,241
31319,50,1422,2171,1145,9885,277
25570,51,2677,2466,1270,11185,1407
31403,13,481,2167,308,5871,173
26806,7,275,2409,234,8495,41
42807,3,107,1282,84,6625,23
24478,66,3558,2514,2617,21125,941
20419,31,2541,2724,1647,20365,894
27876,0,0,2351,0,1897,0
41442,15,278,1543,202,5368,76
32914,55,1865,2094,1073,21958,792
25420,0,64,2473,59,3130,5
24937,12,268,2493,191,17651,77
17366,63,1266,2868,927,8893,339
44898,64,777,772,589,13100,188
26626,3,134,2418,116,5469,18
43247,7,157,1162,153,10895,4
32593,10,581,2107,480,7995,101
11413,18,795,3223,758,17399,37
34792,519,9602,2018,7361,54033,2241
32299,102,3575,2120,2873,32599,702
21692,10,319,2650,253,5253,66
12702,54,1510,3154,1339,7493,171
36079,14,973,1935,692,20611,281
13624,0,6436,3086,6190,94104,246
26684,59,6927,2415,4869,47734,2058
18453,9,724,2820,565,8139,159
36688,28,839,1903,491,9712,348
31877,12,368,2141,267,5015,101
34509,31,655,2034,532,6131,123
25172,20,773,2483,519,11460,254
35757,43,1128,1959,851,10620,277
11145,36,1354,3236,1008,12414,346
42305,25,723,1392,486,9375,237
25669,30,681,2460,532,13421,149
28557,41,1403,2310,960,11625,443
45238,40,565,652,425,8443,140
16777,12,666,2900,501,13197,165
32048,50,1204,2132,957,9113,247
34718,60,1329,2023,1105,13048,224
9701,9,344,3310,340,5133,4
25091,285,7829,2487,6044,38471,1785
37351,5,277,1862,189,5829,88
22904,574,41953,2588,23654,189884,18299
46202,2,55,293,47,1779,8
15609,38,659,2956,472,5965,187
36753,14,538,1899,437,9711,101
12611,116,5397,3160,4766,65915,631
29603,17,978,2258,780,24175,198
12565,29,1476,3162,1173,14495,303
42219,91,1867,1407,1381,13469,486
43065,114,3747,1215,2671,56670,1076
10112,17,214,3290,209,4812,5
31353,8,719,2169,90,4355,629
34183,58,2751,2048,2086,23629,665
16128,6,515,2933,418,10399,97
18439,19,925,2820,632,14940,293
39663,7,103,1710,78,5679,25
15038,18,321,2985,289,4597,32
14402,41,1371,3026,1156,9936,215
42128,5,108,1429,92,3645,16
25203,0,2154,2481,1609,11411,545
27028,5,214,2401,176,4065,38
16413,5,146,2919,118,5022,28
41527,48,1268,1532,971,11002,297
36461,10,416,1915,235,6145,181
33468,5,241,2072,180,3018,61
27865,146,9885,2352,6265,74178,3620
38996,10,270,1750,224,5070,46
22539,2,58,2606,49,2414,9
28806,0,38,2297,33,3590,5
18169,16,889,2832,671,7025,218
30557,38,900,2207,647,8125,253
39172,23,420,1740,339,13521,81
31480,17,5883,2162,2167,34084,3716
3791,1008,50136,3626,44117,315724,6019
17158,81,1855,2879,1249,16792,606
19228,940,34019,2787,23479,194281,10540
28382,8,407,2322,327,8219,80
25924,10,442,2449,345,5808,97
31718,0,30,2149,14,2376,16
43776,14,238,990,176,5517,62
25287,1,71,2479,54,1661,17
13697,75,5960,3080,3706,46974,2254
37696,5,380,1840,315,14875,65
20216,9,333,2734,272,4700,61
27118,15,458,2396,372,5877,86
27280,16,588,2387,492,8246,96
24656,31,1250,2505,519,17018,731
41543,71,3098,1530,1571,22937,1527
32772,4,196,2100,169,5793,27
32336,16,346,2118,287,4835,59
45640,189,1917,527,1786,20498,131
32883,78,2032,2095,1440,14939,592
27690,104,4266,2362,3500,24611,766
17363,32,845,2868,574,5706,271
31958,45,1328,2138,943,14212,385
38756,174,4314,1765,3312,35572,1002
30653,5,73,2202,53,3296,20
34278,14,985,2045,777,10210,208
27368,35,1755,2381,931,11119,824
18086,27,1782,2835,1337,30169,445
34846,5,469,2015,343,6357,126
35454,52,1592,1983,1262,12556,330
38188,51,2737,1805,1322,22011,1415
26364,26,1012,2429,793,5823,219
40083,0,417,1683,274,3675,143
11415,457,20588,3223,15556,81851,5032
13436,6,312,3099,304,10813,8
28239,9,400,2330,330,9568,70
29901,155,6385,2242,4567,61459,1818
16923,14,1275,2893,444,15594,831
8457,10,113560,3385,696,14520,112864
26857,11,441,2407,371,10966,70
44660,486,7209,847,5606,35090,1603
20653,5,267,2713,228,5307,39
20643,168,2626,2714,1829,15798,797
33696,27,288,2064,227,2982,61
3244,381,37019,3636,30781,155970,6238
20968,65,1665,2693,1298,11893,367
13640,137,2668,3084,2166,20250,502
33849,19,576,2058,482,7182,94
28167,3,131,2334,114,1954,17
19991,70,2556,2747,1827,22253,729
25107,0,908,2486,666,13583,242
25791,0,23,2455,19,3672,4
40073,0,148,1684,97,2977,51
29462,0,57,2263,45,1392,12
34555,6,230,2032,182,4078,48
19494,8,281,2773,193,4483,88
46181,38,526,299,397,12438,129
18434,400,10557,2820,7731,27507,2826
15776,66,6927,2949,5137,25919,1790
34638,27,851,2027,723,13637,128
19964,7,255,2749,165,5875,90
22049,1,32,2631,29,1672,3
30860,158,3736,2192,2545,21957,1191
18675,38,1866,2810,1478,19135,388
18365,7,210,2823,169,10696,41
22516,1,75,2607,61,3533,14
20988,2,105,2691,92,3441,13
32318,12,610,2119,456,7644,154
11690,16,1046,3207,337,6193,709
4969,396,17014,3582,16893,80528,121
23086,11,367,2580,303,9615,64
20087,21,845,2742,511,12985,334
30382,5,136,2217,112,2363,24
18881,3,275,2801,219,4764,56
25298,0,86,2478,66,7359,20
12961,10,549,3139,536,6814,13
41413,64,1678,1547,1224,17888,454
12000,11,315,3193,311,6875,4
22600,28,900,2603,674,8934,226
31662,1,169,2152,119,7445,50
43422,5,240,1107,155,7682,85
34899,107,8192,2012,4299,62586,3893
41288,3,284,1566,212,7184,72
45076,12,154,712,141,4538,13
39847,91,2271,1700,1587,19752,684
33712,5,204,2063,118,3881,86
24536,3,192,2511,148,4474,44
18691,31,1649,2809,1351,18871,298
16612,5,466,2911,333,6168,133
18438,17,523,2820,379,11904,144
21386,83,7060,2668,2795,39426,4265
45050,3,34,724,29,2380,5
44528,87,1648,872,1215,22500,433
15801,26,1374,2948,605,15057,769
33934,51,2131,2056,1298,16700,833
9403,92,3114,3326,2608,12223,506
23757,132,4117,2548,2788,26699,1329
35142,2,45,1999,37,3681,8
29593,7,434,2258,388,10368,46
31026,46,1950,2185,1002,21908,948
35626,2,47,1970,37,2361,10
28233,8,149,2330,136,3638,13
31214,49,3582,2177,1615,19275,1967
11329,25,878,3227,780,11912,98
23704,0,49,2550,40,3645,9
41436,9,267,1543,195,8497,72
31753,143,6368,2147,2881,25681,3487
32344,32,1392,2118,1081,18564,311
21059,81,4645,2688,3650,31272,995
40939,45,891,1610,651,11736,240
14669,249,11283,3008,6487,49294,4796
25137,82,4757,2484,3695,48381,1062
14823,29,527,2996,440,14712,87
28349,7,344,2324,231,3186,113
28920,68,1507,2292,1206,13624,301
16553,16,766,2913,479,17723,287
39101,11,557,1744,432,13025,125
30360,0,58,2218,34,3710,24
35300,79,1671,1990,1159,18994,512
36906,20,423,1889,317,6682,106
27561,0,104,2369,82,7145,22
20664,2,98,2712,87,4262,11
36514,4,97,1912,87,4928,10
38984,68,2019,1751,1499,22229,520
22796,2,101,2594,81,2897,20
18868,0,70,2802,62,3301,8
41181,42,1500,1583,1121,19420,379
12487,49,1645,3166,1546,17331,99
45934,4,121,404,72,3396,49
27413,9,245,2378,194,3585,51
17571,68,5044,2858,2921,19315,2123
17036,33,2347,2887,1295,29571,1052
30383,28,1360,2217,935,26006,425
33233,13,258,2081,205,4814,53
14128,41,1442,3045,1404,24334,38
30242,6,333,2225,135,4939,198
35885,3,114,1950,93,3023,21
45079,1,36,711,22,2195,14
9778,41,2321,3307,2119,17514,202
27817,9,367,2354,320,5285,47
10940,12,188,3247,172,5198,16
25184,0,45,2482,37,1592,8
23905,43,5941,2541,3251,23402,2690
16432,48,1672,2919,1232,16551,440
28797,9,221,2298,177,2084,44
13988,56,2734,3055,2453,27340,281
27668,3,58,2363,46,2875,12
37090,0,36,1877,29,2794,7
31395,3,114,2167,60,3178,54
20215,2,432,2735,191,7259,241
36138,80,3863,1931,2521,29629,1342
15942,208,16301,2943,8845,41844,7456
18716,38,1331,2808,1042,12864,289
33321,5,172,2078,129,10062,43
35702,55,1688,1963,1202,13579,486
26695,0,61,2414,54,4954,7
28333,174,4738,2325,3708,30317,1030
37466,22,744,1854,578,11380,166
27639,8,432,2365,334,12324,98
14750,51,4145,3002,2665,27223,1480
23395,12,641,2565,471,12053,170
20091,31,1985,2742,1673,17217,312
18570,20,1042,2815,860,23270,182
42247,13,424,1402,268,6032,156
30767,4,104,2196,77,3675,27
40826,180,4524,1619,3387,48143,1137
32553,80,1610,2109,1356,16624,254
22834,225,5746,2592,4081,31227,1665
15692,5,256,2953,214,4863,42
34211,9,332,2047,218,5975,114
6710,121,5738,3499,5730,52309,8
7734,131,7005,3442,6936,48273,69
44738,19,331,820,276,5812,55
39149,80,3681,1740,2156,26980,1525
44854,11,210,781,129,4074,81
13282,13,339,3111,287,5828,52
45593,1,43,549,29,2008,14
20871,7,508,2700,400,21911,108
39478,0,26,1721,22,1548,4
17062,8,430,2885,257,7250,173
36601,224,7075,1907,5683,43939,1392
14433,118,10134,3024,5422,32492,4712
30736,3,49,2198,44,1729,5
41801,68,1309,1485,709,19477,600
30257,194,3799,2225,2608,24997,1191
14330,25,1227,3031,1012,12007,215
30192,47,685,2228,569,4988,116
45672,7,62,511,54,3927,8
22246,0,34,2620,30,4158,4
36835,33,1298,1892,1004,15148,294
30175,2,329,2229,144,5529,185
40681,42,761,1634,618,9043,143
16867,11,588,2896,480,5335,108
17576,20,949,2858,757,6181,192
13326,85,3747,3108,2837,40915,910
41809,2,53,1483,46,2984,7
18455,14,439,2820,334,4548,105
30672,0,44,2201,27,2701,17
17607,9,274,2856,229,5374,45
26669,2,194,2416,164,8266,30
30723,55,3167,2198,2306,13051,861
41096,91,2675,1593,1869,30360,806
43230,38,1812,1167,781,21624,1031
21363,3,261,2669,196,4453,65
19397,3,238,2778,104,9634,134
14271,149,4966,3037,3600,35111,1366
30505,6,254,2209,212,7691,42
17716,49,3673,2853,2239,43722,1434
32779,10,303,2100,264,9567,39
37378,24,767,1860,630,20804,137
31845,2,137,2143,82,2796,55
19099,62,4645,2793,2859,44007,1786
37765,38,442,1834,334,4984,108
14035,36,1591,3051,1262,42273,329
45846,19,542,443,287,7052,255
14674,13,990,3008,943,13969,47
45284,28,229,635,209,6105,20
42472,57,1070,1357,723,13791,347
17047,5,176,2886,144,9115,32
41940,87,1436,1462,1151,18242,285
36264,14,314,1925,237,2116,77
45439,155,1800,595,1676,23869,124
16135,213,17281,2933,9473,113530,7808
18221,55,1290,2830,945,8159,345
45996,97,896,381,868,8548,28
27161,10,331,2394,290,9457,41
43004,149,2123,1233,1389,23491,734
21167,17,572,2680,471,5199,101
18070,89,7918,2836,5084,56739,2834
17793,100,6350,2850,3173,26283,3177
41474,47,802,1538,595,5760,207
32080,33,1760,2130,1321,17812,439
28877,9,357,2294,289,6720,68
36661,17,779,1904,583,6349,196
33172,0,42,2083,40,3922,2
30417,33,1392,2215,1083,21532,309
42693,39,413,1312,334,6912,79
33786,7,513,2060,242,7859,271
15714,18,595,2952,333,5114,262
34688,5,155,2024,99,3056,56
33168,28,1211,2083,1013,16933,198
45694,10,90,502,77,1582,13
42763,10,397,1296,227,9026,170
19454,0,49,2775,39,3361,10
26645,12,514,2417,289,7145,225
44007,85,547,953,481,9877,66
38080,3,59,1813,52,3250,7
32056,1,74,2132,48,5521,26
12784,52,4873,3150,4480,55332,393
36301,3,244,1923,203,5694,41
29536,0,51,2260,49,2992,2
31116,257,20375,2181,6103,93172,14272
40766,136,4172,1626,2574,25932,1598
32513,36,1109,2111,898,12912,211
26683,2,81,2415,70,6606,11
39489,1,25,1720,21,1721,4
19959,33,1780,2749,1406,29035,374
36742,0,41,1900,33,4105,8
25711,6,598,2459,480,5369,118
17292,0,195,2872,152,4832,43
10458,18,2587,3274,937,12018,1650
18163,22,1206,2833,986,25239,220
38287,6,213,1798,152,5598,61
38355,1,29,1792,28,2842,1
37652,17,574,1842,424,5615,150
15894,2,232,2945,145,2774,87
22821,111,5473,2593,3868,50659,1605
25250,17,600,2480,483,6764,117
44285,44,404,909,318,10337,86
16110,5,201,2934,163,3068,38
20816,3,152,2703,135,3995,17
36770,100,3071,1898,1766,23809,1305
29236,4,309,2276,246,4471,63
43493,20,520,964,360,3868,160
28212,24,1732,2331,645,12023,1087
2246,1025,54092,3654,49566,213411,4526
27324,3,188,2384,135,6151,53
15319,38,3256,2970,1528,17327,1728
32296,16,473,2120,361,23244,112
11844,60,2025,3201,1655,13439,370
15198,3,351,2976,293,7244,58
9737,12,445,3308,392,9335,53
28339,15,1532,2324,1086,18338,446
13760,206,9705,3073,7640,62896,2065
36854,989,44838,1891,31213,231934,13625
40572,3,152,1642,117,2659,35
1046,5,128,3949,113,10392,15
45587,0,58,551,53,3863,5
36057,9,252,1936,199,3747,53
33351,4,170,2077,146,4829,24
37424,19,465,1857,373,9340,92
32460,7,204,2113,177,3644,27
21957,148,6885,2636,4985,23438,1900
23820,15,375,2545,293,2109,82
33725,0,75,2063,45,5678,30
38974,4,164,1752,121,4418,43
22854,29,731,2591,495,12072,236
21846,16,1361,2644,871,15314,490
34279,20,441,2045,325,4499,116
4132,185,7187,3615,6817,68969,370
23018,40,4277,2583,2073,43708,2204
14058,0,1618,3049,1196,14211,422
19249,6,837,2786,675,8315,162
3934,1243,65274,3622,56809,279301,8465
23578,62,8585,2556,6272,69052,2313
17190,88,3482,2877,2511,29604,971
43311,12,338,1143,176,10418,162
42976,40,630,1243,460,7530,170
27124,32,546,2396,258,6197,288
27787,6,494,2355,369,9919,125
43657,21,302,1029,196,5871,106
36052,47,5219,1937,3508,18032,1711
42774,84,1401,1293,751,12491,650
44808,2,97,798,66,3377,31
38959,32,599,1752,414,7575,185
38985,170,5151,1751,3843,39813,1308
28934,1,124,2291,106,4049,18
17841,3,197,2848,168,7997,29
27401,0,90,2379,74,2413,16
10565,44,2379,3268,2335,27862,44
33851,466,23649,2058,15546,194090,8103
37720,5,179,1838,150,8482,29
12293,33,902,3178,839,9113,63
20709,0,82,2710,74,2610,8
42962,57,1272,1246,1041,34210,231
21084,2,180,2686,147,4599,33
41739,289,5439,1498,4210,63900,1229
45266,493,8386,640,7487,61783,899
13947,45,4837,3058,3298,36655,1539
43042,9,235,1223,173,3952,62
25513,13,468,2469,318,4471,150
32890,1,34,2095,24,2214,10
34994,1,319,2007,256,8828,63
34098,1,93,2050,77,3037,16
41040,111,4497,1602,2067,42734,2430
45509,3,65,578,30,1556,35
43920,442,8823,967,6601,54386,2222
32273,1,114,2121,85,6473,29
30291,24,402,2223,302,6050,100
35462,1,117,1982,78,2476,39
30620,4,594,2204,452,9831,142
45077,26,620,711,244,7048,376
37965,124,3779,1820,1831,24528,1948
23012,1,57,2583,51,1992,6
42345,13,300,1384,223,10458,77
33796,83,2921,2060,2126,34555,795
35517,12,230,1978,188,4856,42
3002,4377,222205,3641,164014,602564,58191
18341,15,261,2824,212,3239,49
23152,2,114,2577,83,4460,31
41103,36,676,1593,528,3877,148
15614,122,2587,2956,2003,26778,584
30808,3,72,2195,60,2852,12
22368,13324,980647,2615,342283,2205789,638364
41768,2,89,1492,80,2255,9
31306,15,1007,2172,497,10599,510
9531,800,32601,3319,28831,126838,3770
35855,1,105,1952,66,4690,39
26911,23,1195,2404,810,18442,385
27459,25,1263,2375,634,14401,629
15178,2,100,2977,98,12021,2
30645,21,737,2202,477,7626,260
45233,2,50,652,44,1510,6
27152,12,480,2394,418,6324,62
40052,0,3588,1685,2643,16890,945
19847,1199,45700,2755,28215,180920,17485
3813,43,10228,3625,6620,29005,3608
20241,38,1192,2732,844,17794,348
41491,7,196,1536,166,9340,30
20065,63,4458,2743,3468,41275,990
21441,136,16607,2665,5370,80655,11237
951,3,126,3985,96,3941,30
34368,25,800,2041,580,8051,220
31679,21,1194,2151,861,27529,333
30168,65,2107,2230,1765,12801,342
32244,12,316,2122,262,4205,54
40036,222,6697,1686,4016,47014,2681
35016,0,21,2006,17,2009,4
25858,0,80,2453,68,3260,12
33804,40,1178,2059,949,11582,229
21342,2,34,2671,25,3598,9
25673,1,65,2460,38,4624,27
21539,12,374,2659,188,3953,186
43179,10,435,1182,274,6588,161
14454,649,35336,3023,25902,168363,9434
36086,2,56,1934,34,2187,22
24558,9,624,2510,502,14088,122
15697,787,33831,2953,19923,133421,13908
33585,6,154,2068,118,6021,36
26939,21,3192,2403,1864,22262,1328
12454,47,1677,3167,1367,18096,310
34173,21,1137,2048,740,8869,397
20559,11,407,2717,307,15747,100
30586,29,1175,2206,812,12925,363
38591,62,1743,1776,1404,30698,339
15412,6445,344495,2967,158574,1098401,185921
11191,33,822,3233,763,7733,59
14775,0,1417,3000,1242,26664,175
14078,21,681,3048,633,9432,48
28109,9,453,2338,210,7978,243
40460,0,0,1653,0,4083,0
16523,10,614,2914,433,6796,181
16979,1,103,2891,83,4025,20
43644,17,908,1033,186,7924,722
26816,38,3790,2408,1089,19626,2701
29222,24,1066,2277,895,18239,171
35260,69,1636,1992,1334,22906,302
40371,8,170,1661,143,4763,27
41713,10,188,1503,147,3992,41
26229,17,457,2436,272,7354,185
13493,43,3718,3094,2698,48454,1020
41992,3,261,1453,153,11512,108
37063,27,714,1879,543,5456,171
25789,29,1178,2455,922,9880,256
24274,94,1852,2524,1439,14908,413
43050,138,1701,1221,1542,29246,159
27724,142,10517,2360,7054,59400,3463
39819,10,352,1702,261,5371,91
18107,8,298,2835,170,4133,128
16929,16,753,2893,544,12402,209
40467,6,119,1652,92,6391,27
41095,155,3421,1593,1953,38596,1468
39611,200,10630,1713,5163,61568,5467
27500,190,9495,2373,6095,66700,3400
31816,12,783,2144,546,5860,237
36352,3,85,1920,62,3179,23
42866,6,58,1272,50,3698,8
24208,43,2481,2527,1452,18734,1029
14189,7,437,3043,307,7154,130
25524,1416,69406,2468,40350,244135,29056
33871,120,10107,2057,3444,17537,6663
42316,40,814,1390,610,14389,204
30577,160,3110,2206,2673,27284,437
30139,1,110,2231,67,2993,43
20624,0,764,2715,629,27045,135
28821,84,1054,2296,812,5949,242
40795,6,122,1623,92,2931,30
35164,5,197,1998,162,5424,35
21753,3,78,2648,71,3348,7
1098,4,99,3935,90,5191,9
28629,5,729,2306,573,12330,156
41519,27,396,1533,340,10713,56
21444,27,1285,2665,1059,18879,226
26907,8,210,2404,172,8633,38
19320,10,871,2782,672,11906,199
39702,21,811,1708,596,14381,215
37549,27,633,1848,461,15383,172
44655,255,3039,848,2822,19508,217
20041,29,553,2744,443,5703,110
43597,14,201,1051,181,5052,20
37292,2,181,1865,115,3937,66
39448,22,873,1723,639,13029,234
13555,118,6021,3089,4426,15624,1595
10223,1293,59245,3285,40538,229734,18707
34371,12,823,2040,666,16404,157
22582,169,7558,2604,5403,52801,2155
38333,3,73,1795,62,3873,11
29670,3,280,2254,214,6609,66
45791,154,2456,462,2142,29755,314
41144,4,41,1588,35,2104,6
44478,3,59,880,45,6277,14
33891,19,330,2057,292,5256,38
35413,17,458,1985,289,3354,169
38038,0,543,1816,433,8370,110
34361,11,174,2041,137,2977,37
14158,40,3807,3045,3096,23602,711
28554,45,1597,2311,1138,12669,459
36158,87,952,1930,757,7217,195
42569,7,203,1339,139,4552,64
10168,2167,159294,3288,122359,1192543,36935
45488,40,983,582,406,9281,577
34599,15,1163,2030,967,17667,196
32411,16,246,2115,179,5521,67
30675,46,1159,2201,918,12245,241
41386,16,1070,1552,808,15749,262
42909,84,1474,1260,1017,28469,457
32965,6,178,2092,134,5298,44
30411,23,737,2215,623,9064,114
11708,1,172,3206,140,6915,32
20637,409,27431,2714,12636,129130,14795
20001,44,799,2746,654,7965,145
35012,1,215,2006,171,7648,44
12966,15,949,3139,753,25115,196
34664,101,1096,2025,850,11636,246
24794,35,1573,2500,1166,22585,407
27247,13,1021,2388,622,11895,399
41130,44,2016,1589,1232,22771,784
27230,45,2824,2389,1773,17699,1051
41128,1,40,1589,31,4902,9
32646,12,309,2105,259,4375,50
23661,118,8729,2551,6029,44104,2700
36470,9,219,1915,156,6545,63
19722,13,1039,2762,753,7638,286
30829,499,21771,2194,11021,92360,10750
27655,14,293,2364,265,4669,28
20469,0,142,2723,101,6179,41
18728,90,9238,2808,4386,54012,4852
21787,63,2918,2646,2240,38803,678
43752,11171,267549,1001,180462,842979,87087
11068,115,12818,3240,8129,43149,4689
14564,11,320,3014,241,5522,79
41233,8,366,1575,290,11912,76
30875,48,2813,2192,1009,17231,1804
22747,4,359,2597,282,12510,77
31042,15,367,2185,285,5450,82
42919,22,406,1257,260,4661,146
18983,4,366,2798,305,10115,61
32662,170,7709,2105,5123,44975,2586
12436,15,543,3168,537,8128,6
45188,1,17,665,10,1735,7
15841,281,9392,2947,5642,69326,3750
30587,4,239,2206,202,5102,37
28378,829,107688,2322,21456,184456,86232
34586,65,1302,2030,939,28998,363
10841,20,1698,3252,1303,11217,395
18734,4,151,2807,91,2782,60
29160,22,600,2280,463,5305,137
7132,57,3957,3477,3246,30905,711
34888,45,6824,2012,2489,30695,4335
28160,2,65,2335,47,2223,18
40143,39,990,1681,766,12934,224
26405,8,219,2427,195,4477,24
16940,12,453,2892,353,4618,100
12039,75,1688,3191,1453,10370,235
38273,94,3047,1799,2315,27011,732
40762,355,5090,1626,3533,30581,1557
17170,2,210,2878,164,7044,46
28353,2,287,2324,234,10572,53
30792,18,493,2195,384,8411,109
41537,34,771,1531,614,9656,157
20897,12,900,2697,759,26304,141
16344,42,1641,2923,1254,14294,387
46028,243,7362,365,5387,50758,1975
41178,3,198,1584,99,5528,99
35598,18,309,1971,242,3020,67
21115,19,694,2685,323,5094,371
31859,7,186,2142,93,3910,93
28918,44,2202,2292,1723,33817,479
39340,7,220,1728,165,8181,55
19863,4,507,2754,257,11797,250
30980,92,2702,2188,2184,36113,518
27421,214,7379,2378,4827,36308,2552
11105,726,53278,3238,24953,197603,28325
15791,3,140,2948,110,2822,30
37646,1,35,1842,27,3320,8
42794,3,80,1286,60,4294,20
22218,12,814,2622,395,6095,419
16673,49,2683,2907,2139,26570,544
43133,11,133,1195,106,5110,27
15449,4,268,2965,213,5173,55
21267,7,202,2674,150,1898,52
31104,2,198,2182,143,3042,55
36326,6,212,1922,169,4669,43
32325,2,189,2119,106,5554,83
25545,11,383,2467,313,6747,70
38792,198,21931,1763,2375,61119,19556
30582,21,662,2206,533,8570,129
16822,13,1413,2898,731,21906,682
9613,7,395,3313,256,6398,139
27650,78,5346,2364,2212,30299,3134
45586,29,319,551,274,5840,45
25712,2,465,2459,198,7922,267
26282,2,127,2433,105,4234,22
17901,1,224,2846,151,3170,73
29150,0,33,2280,24,1500,9
39491,0,113,1720,96,2895,17
34618,1,86,2029,75,4545,11
37823,656,14779,1829,11092,96234,3687
20593,2,87,2716,57,2136,30
10079,248,11787,3291,10224,39350,1563
35723,336,7479,1961,6341,32150,1138
31340,872,39435,2170,26766,284943,12669
22044,11,965,2631,470,14323,495
23779,48,1958,2547,1521,39484,437
43978,21,706,961,652,9447,54
44884,5,63,776,57,3495,6
37717,26,308,1838,207,3256,101
43585,16,285,1057,185,5078,100
28981,19,878,2289,721,11318,157
38321,41,1416,1795,1147,22654,269
39155,19,613,1740,474,7538,139
38731,69,2093,1767,1658,10428,435
9650,103,8305,3312,8288,86039,17
26774,15,202,2411,168,3800,34
26050,4,72,2444,61,1831,11
44021,54,864,951,631,6406,233
29056,3,272,2285,204,13009,68
20846,35,1947,2701,1109,19909,838
28546,41,1987,2311,1632,22017,355
36616,9,761,1906,570,5258,191
21262,15,357,2674,268,7866,89
15847,60,3862,2947,2671,27253,1191
42162,3,75,1420,60,3838,15
25473,35,3297,2471,1911,14664,1386
45313,17,245,626,186,5906,59
42439,21,944,1364,557,5913,387
43591,66,1274,1053,1026,24138,248
33092,49,1520,2086,1238,35989,282
26791,0,94,2410,72,1424,22
43767,26,301,994,276,4292,25
29473,10,253,2263,203,4051,50
11908,20,885,3198,846,8829,39
19022,531,33503,2796,24259,184509,9244
27862,8,641,2352,486,20099,155
23418,0,54,2563,46,2425,8
43259,7,186,1158,111,2044,75
14028,13,626,3052,566,8917,60
32690,330,12846,2103,10084,92298,2762
15365,8,201,2968,156,5089,45
36263,19,431,1925,285,7142,146
19567,4,539,2771,404,11719,135
40257,2,32,1672,30,2868,2
15647,34,3154,2955,2344,30450,810
17396,8,477,2866,348,11975,129
30094,273,30305,2233,6324,145436,23981
30457,100,9109,2212,3396,57518,5713
26372,35,1250,2429,1025,20498,225
38823,0,45,1761,34,2264,11
18331,2,120,2825,99,2987,21
46298,11,142,265,123,3192,19
38354,56,1384,1792,916,13283,468
22446,963,39568,2612,22464,150812,17104
34764,139,1608,2020,1180,12730,428
45741,11,139,479,136,2899,3
41369,166,4950,1554,2690,27390,2260
1217,4,96,3899,82,2788,14
1271,5,91,3881,72,3501,19
27364,11,273,2381,144,5345,129
19214,6,360,2788,271,4659,89
44954,87,1459,755,977,15735,482
19944,5,360,2750,308,13694,52
44547,45,474,866,342,6068,132
15963,8,487,2942,417,8717,70
40607,7,283,1640,222,4225,61
40758,42,1230,1626,691,14442,539
11288,6,297,3228,297,18874,0
42139,27,273,1425,235,3398,38
16714,1,598,2905,237,8603,361
27045,61,2476,2400,1851,26933,625
30142,51,2762,2231,1307,12275,1455
28921,0,45,2292,42,5658,3
39505,4,93,1720,78,7918,15
24813,29,1734,2499,980,28236,754
39046,58,1876,1748,1363,21343,513
43105,15,231,1203,176,2942,55
28006,22,856,2343,693,12537,163
34788,9,399,2018,313,6601,86
31867,1,149,2142,85,2239,64
31300,7,289,2172,229,7096,60
17748,43,5341,2851,4053,22839,1288
22713,45,2529,2598,1982,9336,547
25992,10,816,2446,602,21397,214
20751,3,282,2708,241,6046,41
29949,7,278,2240,195,3500,83
23748,29,1118,2548,862,12759,256
31587,76,2882,2156,1742,33712,1140
43787,3,166,988,117,7785,49
14339,464,50820,3030,22308,179610,28512
39472,1,42,1721,38,5176,4
21513,5,278,2661,142,6535,136
36686,62,1810,1903,1200,16761,610
46357,1,32,241,27,1051,5
25447,9,532,2472,456,7840,76
43394,17,513,1116,318,11126,195
24429,1,98,2517,89,2857,9
26609,38,1131,2419,891,19274,240
13953,242,8877,3057,6430,63045,2447
41132,7,305,1589,187,9300,118
43984,119,1092,958,866,12323,226
30800,9,813,2195,576,21133,237
37151,4,165,1874,132,12391,33
41080,191,6075,1595,3740,43604,2335
44077,31,395,941,298,10425,97
26001,38,4163,2446,2923,41289,1240
36364,127,5952,1919,3409,56584,2543
7228,124,6814,3472,2432,57310,4382
23020,60,2147,2583,1665,23254,482
39563,28,1737,1716,1049,20626,688
25565,0,646,2466,480,10158,166
8254,91,3747,3398,3208,18981,539
1125,1,34,3929,30,2749,4
31039,17,491,2185,264,7054,227
39222,108,2322,1736,1452,10272,870
43764,201,2614,996,2341,31342,273
40104,1,33,1682,25,3783,8
19223,6,302,2788,200,5524,102
1297,19,494,3871,402,7630,92
39837,8,148,1701,107,5421,41
31208,49,994,2177,677,7117,317
20567,28,2994,2717,1194,28980,1800
36570,0,0,1910,0,1741,0
42241,1,27,1403,26,3142,1
43841,4,59,978,56,3468,3
19804,61,3599,2758,2534,28074,1065
11205,150,4197,3232,4091,36306,106
32310,6,325,2120,297,6214,28
14606,0,65,3012,57,4239,8
22819,899,33338,2593,24191,115006,9147
21220,12,447,2676,315,4838,132
27138,116,2148,2395,1594,11145,554
40214,34,1464,1676,763,19361,701
42912,31,658,1259,284,7685,374
38324,1,39,1795,35,3225,4
45387,5,64,607,52,2441,12
23627,40,876,2553,682,5457,194
34723,51,550,2023,435,5424,115
31187,2,198,2177,161,4967,37
10630,0,0,3264,0,4950,0
23804,65,2605,2546,1525,13925,1080
15526,6,298,2961,238,6131,60
30915,115,6123,2191,4170,46896,1953
18875,695,25111,2801,16346,124735,8765
44542,492,9240,868,7823,89612,1417
23926,116,7895,2539,4474,73426,3421
29183,3,179,2279,156,30171,23
18476,5,206,2819,156,3923,50
43285,120,1601,1151,1330,26528,271
8657,78,124638,3372,2540,19781,122098
13739,10,297,3075,223,6795,74
13107,44,2027,3129,1858,25111,169
35560,1657,69983,1975,42468,282110,27515
27343,67,10983,2383,2320,13632,8663
46384,0,7,226,5,663,2
14856,17,2758,2995,1501,25230,1257
10992,18,1078,3244,979,33922,99
18536,19,881,2817,676,13522,205
35897,124,7179,1949,3652,90094,3527
24110,0,96,2531,85,3891,11
15601,25,806,2957,593,4282,213
22481,4,262,2609,209,5577,53
39029,33,710,1749,589,10483,121
27237,38,1353,2389,1071,17640,282
41938,28,349,1462,263,7286,86
8698,495,15123,3369,11237,103352,3886
29014,28,559,2287,380,7158,179
27239,4,166,2389,138,3827,28
35156,5,147,1998,127,4212,20
39836,2,81,1701,59,3649,22
15664,18,1729,2954,1356,30458,373
12761,92,4835,3151,4650,42109,185
30031,9,375,2237,328,9398,47
11900,10,320,3198,290,5355,30
17617,4,332,2856,224,14484,108
30262,3,109,2225,86,2125,23
15506,1,77,2962,65,1807,12
40661,6,68,1636,59,4065,9
12485,65,3310,3166,2661,30986,649
44863,2,43,776,36,1759,7
30756,33,1078,2197,874,7651,204
15575,8,403,2958,284,7961,119
42478,5,128,1355,110,3166,18
38411,70,624,1789,458,5921,166
43128,2,113,1197,80,2960,33
24965,0,14,2492,12,1572,2
35571,3,250,1974,182,4797,68
45910,27,1085,421,743,11168,342
19537,0,76,2772,34,3925,42
46000,131,1414,380,1411,16751,3
43698,21,354,1015,253,7048,101
43002,16,349,1233,207,6038,142
14362,63,3699,3029,3434,45638,265
19019,6,176,2796,154,9297,22
13100,109,5321,3129,5206,67274,115
35289,88,901,1991,732,9001,169
16273,28,1887,2927,1148,53949,739
40949,6,104,1609,91,5586,13
41672,8,182,1509,127,4020,55
27254,49,2031,2388,1641,12237,390
3025,41,1241,3640,1182,9183,59
15318,9,216,2970,166,1960,50
43191,11,302,1180,201,8608,101
28357,45,1950,2323,1063,12367,887
961,2,213,3983,186,6589,27
18023,33,4266,2838,2796,28004,1470
21781,18,717,2646,565,8038,152
16854,51,2736,2896,2174,41562,562
30673,33,835,2201,702,8526,133
30395,20,1030,2216,834,12433,196
16768,21,915,2901,680,10781,235
46129,7,108,324,100,3456,8
19842,5,293,2755,237,10089,56
14425,285,13916,3024,10223,94500,3693
38110,196,2568,1810,2004,13359,564
6854,1702,74575,3492,63276,236817,11299
20850,66,3591,2701,2076,22108,1515
43666,72,1273,1027,1050,12129,223
40261,45,1094,1672,868,24588,226
18804,45,1530,2804,1131,14785,399
19427,38,3261,2777,1742,27805,1519
32734,21,616,2102,484,11990,132
36540,2,26,1911,26,2168,0
34402,98,2646,2039,2145,14356,501
20072,84,4203,2743,2340,24910,1863
36329,1,32,1921,29,2309,3
28787,0,205,2298,165,6173,40
43457,55,1549,1098,738,17290,811
30052,9,744,2235,272,7356,472
32022,15,377,2134,308,12135,69
29252,3,199,2275,161,3729,38
31825,5,406,2143,319,11750,87
15957,9,1633,2942,1139,19518,494
39010,5,143,1750,104,2343,39
42631,18,330,1327,221,8259,109
35631,271,18616,1969,9177,107710,9439
31361,44,3386,2169,1006,25994,2380
31215,42,804,2177,563,7189,241
34897,18,569,2012,341,5592,228
45452,6,78,591,58,2627,20
19585,79,2901,2770,2233,13812,668
14305,7,394,3034,334,14428,60
14295,292,34750,3034,14331,135456,20419
11909,64,2739,3198,1719,19566,1020
23582,94,3474,2555,2627,39756,847
10806,38,1788,3254,1594,17157,194
43415,11,313,1109,178,5665,135
26798,99,2438,2409,1983,35153,455
30685,373,21639,2200,15671,134057,5968
42556,96,2733,1341,2037,20187,696
21555,25,1118,2659,719,6859,399
43399,52,713,1115,534,7229,179
45560,11,119,556,110,3821,9
22618,3,268,2603,233,3599,35
29876,43,3548,2243,1586,27541,1962
17478,11,171,2863,147,2784,24
14623,9,281,3011,280,12488,1
32696,19,447,2103,352,3655,95
29872,13,1042,2243,550,9758,492
30759,15,331,2197,255,7726,76
15727,3,307,2951,264,10271,43
16897,123,5242,2895,3808,38922,1434
14626,27,2119,3011,1776,21833,343
19420,9,665,2777,482,6169,183
25505,31,579,2469,476,7259,103
36560,37,1867,1910,1542,14708,325
25969,13,292,2447,223,4131,69
18767,4,293,2806,244,7533,49
45419,249,5887,599,3656,24886,2231
42882,3,63,1267,55,3645,8
39088,4,150,1744,126,4119,24
36218,10,236,1927,189,8647,47
35380,4,125,1987,105,4004,20
37503,210,6388,1851,4726,61081,1662
29432,101,1585,2265,1075,10491,510
19868,4,96,2754,87,3783,9
16738,149,9671,2903,6398,55174,3273
17405,30,594,2865,432,23100,162
36579,6,207,1909,162,6693,45
46235,0,11,286,11,994,0
22710,3,275,2598,168,5781,107
46328,1,57,252,53,1666,4
13563,21,1331,3088,1041,9203,290
21615,19,1872,2655,1168,27295,704
25304,54,1234,2478,983,9459,251
34726,47,1443,2023,800,15725,643
23343,3,257,2568,176,4725,81
46153,11,181,313,105,2210,76
30552,5,151,2207,118,3503,33
18993,2,510,2797,336,7898,174
36659,0,72,1904,63,4053,9
9643,33,1187,3312,1014,8751,173
45255,4,32,646,24,2330,8
42291,16,363,1394,286,10777,77
40667,7,384,1635,306,13154,78
40550,37,852,1645,680,14831,172
35965,21,815,1944,679,12338,136
16369,0,0,2922,0,3083,0
8880,85,3750,3359,3525,28879,225
20323,12,621,2730,499,24979,122
28522,5,192,2313,163,7927,29
43267,0,50,1156,45,2538,5
30990,59,5247,2188,3184,46452,2063
33626,868,37266,2067,16838,211139,20428
22793,51,1287,2595,968,6467,319
16302,2,98,2925,88,4328,10
14988,4,138,2988,128,5935,10
8285,63,1911,3396,1754,9936,157
24850,1402,100451,2497,39965,410427,60486
39909,277,9348,1695,6946,51804,2402
14223,11,542,3040,480,8635,62
15820,2,299,2947,248,2937,51
16904,22,859,2895,621,15846,238
22598,72,4701,2604,3746,41600,955
38463,42,1106,1785,859,11974,247
14568,165,15367,3014,12999,132694,2368
20708,43,1998,2710,1569,15496,429
45319,22,348,625,255,4919,93
14649,45,3006,3009,1635,17432,1371
21393,2,89,2668,78,3292,11
22111,145,8241,2627,6341,61210,1900
14535,31,1596,3017,1067,15642,529
40228,107,2196,1674,1689,15474,507
32948,37,1270,2093,1059,24800,211
16021,36,2140,2939,1608,28044,532
13013,182,8718,3136,8595,113383,123
20128,4,237,2740,177,4607,60
23361,46,806,2567,626,6928,180
24173,7,299,2528,241,3845,58
26628,8,315,2418,261,4452,54
18407,114,6806,2822,3362,22120,3444
38042,5,170,1815,147,4902,23
32035,10,287,2134,216,14722,71
18613,61,6965,2813,2943,27643,4022
45098,3,101,698,67,2719,34
13714,605,25364,3078,17022,223881,8342
29632,24,983,2255,760,10608,223
24066,2,67,2533,52,3275,15
42171,13,496,1418,341,10136,155
33477,2,54,2072,42,4132,12
38909,29,1187,1756,869,15133,318
36562,20,466,1910,378,16013,88
33186,4,129,2083,80,3440,49
39833,13,432,1701,336,7450,96
34591,20,818,2030,534,5920,284
34987,64,3013,2008,2143,18155,870
13908,13,1131,3061,1023,6807,108
37142,55,1303,1875,972,13964,331
17331,13,639,2870,330,3340,309
39488,0,27,1720,24,1628,3
43695,1199,24158,1015,19043,147916,5115
40980,119,1858,1607,1336,10615,522
45913,2,79,418,68,1247,11
15750,1,70,2950,57,4266,13
19334,0,34,2782,20,2177,14
15192,1,23,2976,20,2670,3
26871,2,206,2406,183,7465,23
39753,8,224,1706,181,4316,43
27425,190,9394,2378,6027,41515,3367
22675,2,233,2600,204,8964,29
19701,106,4263,2764,3321,15588,942
29617,12,342,2256,306,12745,36
26003,4,194,2446,136,2726,58
31426,9,233,2165,162,4152,71
28153,11,526,2335,451,7421,75
23609,2,77,2554,59,3536,18
20212,155,19534,2735,5747,64257,13787
25904,113,8266,2450,6112,62527,2154
11999,243,7980,3193,5793,70010,2187
36675,6,209,1903,132,11531,77
36010,6,191,1940,112,3603,79
41808,2,122,1483,93,4801,29
13161,17,770,3118,629,9826,141
35479,17,526,1981,431,6361,95
34383,109,3940,2040,3088,47672,852
5197,946,58932,3568,51726,208549,7206
16700,59,5055,2906,3249,37503,1806
44281,134,1409,910,1246,18163,163
12704,2,308,3154,305,8036,3
40380,91,2003,1660,1266,40010,737
41321,34,1235,1561,718,24539,517
16662,96,10528,2908,7753,44120,2775
18703,22,696,2809,516,9316,180
27633,1,62,2365,55,1995,7
22987,11,524,2584,409,12124,115
23666,1437,63124,2551,44007,305592,19117
24276,18,1863,2523,900,20977,963
36056,7,224,1936,199,7919,25
30470,4,218,2212,175,5054,43
8480,117,3382,3383,2827,26246,555
31085,307,13213,2183,9484,60469,3729
22901,30,2880,2588,1312,18804,1568
31597,4,63,2156,49,2320,14
42673,23,596,1317,422,17053,174
23001,4,205,2584,139,4858,66
23132,15,809,2578,610,17517,199
29918,4,177,2241,144,4918,33
34040,5,170,2052,136,3473,34
22174,17,386,2624,313,6282,73
31832,1,47,2143,39,4039,8
29947,44,674,2240,465,9991,209
12034,11,780,3192,613,4200,167
5857,41,175349,3535,2378,39185,172971
32598,4,147,2107,118,6582,29
43011,2,43,1231,38,3049,5
9564,55,2713,3316,2523,21577,190
41635,1,22,1516,19,5579,3
31837,5,428,2143,293,3569,135
18506,6,467,2817,291,5284,176
40551,8,205,1645,162,4322,43
34637,115,1813,2027,1496,19160,317
42740,5,112,1300,85,3839,27
45730,1,14,481,9,2006,5
22546,8,259,2606,158,8620,101
37323,3,114,1863,90,3974,24
29093,4,101,2283,90,2534,11
25816,7,753,2454,594,11896,159
27311,75,2133,2385,1633,28092,500
39575,1,46,1715,39,3073,7
39112,3,169,1743,74,4443,95
18323,34,5151,2825,1552,22755,3599
25788,16,339,2455,264,5168,75
30575,8,269,2206,212,5458,57
28752,13,208,2300,181,5390,27
18538,12,651,2816,555,12803,96
20759,9,579,2707,419,8597,160
16695,5,182,2906,131,4055,51
9388,1248,83073,3327,65123,449595,17950
33780,32,1089,2060,663,12470,426
42515,116,8437,1348,1591,60766,6846
21697,12,265,2650,240,6206,25
14307,25,1334,3033,1142,30943,192
31344,46,1261,2170,1078,21548,183
32124,14,352,2128,301,6072,51
38289,29,613,1798,441,6699,172
27632,9,190,2365,164,5018,26
41016,3,147,1604,113,4837,34
44777,10,109,807,88,2956,21
24550,3,92,2511,83,3118,9
23823,4,301,2545,160,5703,141
19373,153,7462,2780,4699,73567,2763
15713,31,2590,2952,2038,13618,552
25839,146,3269,2453,2486,25507,783
42118,12,238,1431,198,6128,40
19519,2,81,2772,69,3694,12
14637,26,1597,3010,1172,16399,425
13509,88,2426,3093,1999,16467,427
40039,10,207,1686,162,3224,45
40556,15,2251,1644,900,25766,1351
33996,791,17581,2053,9999,77213,7582
17250,66,4684,2874,3859,46349,825
23771,1,47,2547,42,1767,5
36105,0,100,1933,63,3385,37
37331,0,35,1863,23,1858,12
20472,3,138,2722,114,4997,24
41607,18,730,1519,567,9390,163
2347,124,4029,3652,3731,16889,298
45768,16,260,468,198,3374,62
38341,4,242,1793,148,10476,94
18177,4,84,2832,62,3773,22
21899,112,3704,2640,2938,23207,766
45864,126,1959,412,1269,16539,690
21619,57,3134,2655,2232,11019,902
26416,2,135,2427,110,4216,25
10065,166,5089,3292,4697,58769,392
31619,23,606,2155,465,12476,141
29989,10,545,2238,420,11765,125
35843,103,6374,1953,3106,51912,3268
19148,23,451,2791,388,5131,63
25885,89,2435,2451,1963,17677,472
37101,8,459,1877,366,8666,93
23809,10,430,2546,345,4180,85
31997,1,50,2135,41,1727,9
16670,7,112,2907,97,2092,15
36058,29,520,1936,340,5885,180
38342,5,168,1793,97,3224,71
41838,128,4124,1477,2924,45720,1200
42675,70,1523,1317,1304,14584,219
45060,15,223,719,213,5764,10
32932,23,429,2093,360,5021,69
31509,12,1046,2160,555,14355,491
38558,19,1872,1778,1545,6094,327
22297,21,774,2618,653,7529,121
19065,2,221,2794,201,10453,20
12198,3,468,3183,291,14202,177
20876,29,1352,2699,932,13975,420
45820,16,122,452,120,3661,2
43710,57,540,1011,441,6190,99
15855,4,77,2946,62,4304,15
15773,134,10059,2949,4329,48674,5730
36212,207,14112,1928,2339,46242,11773
26704,388,113046,2414,16012,221644,97034
16059,0,221,2937,162,5533,59
44425,80,750,889,611,11228,139
16637,125,5471,2909,3933,42509,1538
23271,12,557,2571,459,9938,98
24565,108,3939,2510,2820,33084,1119
20522,1,106,2720,91,2182,15
42070,5,91,1440,75,3959,16
31758,28,660,2147,528,16226,132
32518,3,122,2111,98,2635,24
43706,35,868,1013,603,9207,265
33413,20,1038,2075,827,14243,211
27758,97,1875,2358,1547,10414,328
25721,144,16499,2458,7353,64194,9146
17088,64,2007,2884,1484,23189,523
45312,2,28,626,20,2997,8
14507,15,1104,3019,929,18276,175
7933,10,567,3424,524,9490,43
30255,8,129,2225,113,6141,16
13388,100,4968,3103,3821,43915,1147
10561,512,17178,3268,12647,60771,4531
42956,6,426,1247,201,6431,225
20290,11,676,2730,525,13633,151
28912,879,38628,2293,21544,218091,17084
18801,325,13169,2805,9865,45864,3304
17535,2,116,2860,78,6931,38
24549,20,1695,2511,933,12795,762
11232,141,8606,3231,7911,47176,695
15284,1,139,2972,124,4346,15
44760,2,41,813,20,1251,21
27321,1,75,2384,62,2263,13
39322,78,2630,1729,2074,15515,556
27292,0,68,2386,58,3207,10
21325,1,62,2671,56,2705,6
16716,9,366,2905,307,6520,59
23085,14,743,2580,612,6767,131
31800,10,456,2145,306,8218,150
36738,25,805,1900,602,22014,203
9257,27,106818,3337,1988,24005,104830
14390,57,2001,3026,1570,19531,431
29414,10,250,2266,206,6033,44
38430,146,3400,1788,2353,38101,1047
11998,226,11061,3193,9447,77729,1614
39409,14,274,1725,198,5511,76
26800,36,1092,2409,624,18208,468
27702,3,234,2361,185,8781,49
13892,217,5710,3063,4889,33730,821
14707,13,3824,3005,1029,75332,2795
18669,612,21962,2810,15081,95158,6881
34870,42,2092,2013,1571,17765,521
24899,12,1001,2495,743,17539,258
31213,18,946,2177,768,15002,178
17261,4,74,2873,62,7506,12
31602,0,37,2156,32,1775,5
38629,18,428,1773,372,8291,56
19218,9,595,2788,333,7959,262
37603,48,1180,1845,679,19847,501
16853,33,1061,2896,796,14420,265
2706,515,34048,3646,29351,146624,4697
41556,8,117,1528,93,4013,24
15710,0,1431,2952,918,12569,513
35518,3,328,1978,214,4998,114
32462,2,144,2113,122,13744,22
28285,7,234,2328,208,3310,26
40006,8,89,1688,59,3641,30
19810,1,61,2757,46,4061,15
20644,201,4039,2714,2747,26660,1292
14090,28,630,3047,541,5438,89
44772,681,19670,799,15090,76100,4580
37820,10,370,1830,320,19895,50
45306,31,336,629,299,12226,37
15982,61,3640,2941,2751,19528,889
23937,1,173,2539,136,3979,37
38176,1,68,1806,59,3808,9
46095,5,64,339,57,1747,7
41086,103,1030,1595,695,12107,335
31264,38,1345,2174,761,11843,584
41682,8,225,1508,158,9228,67
35388,9,143,1987,120,6632,23
24280,1,47,2523,45,5316,2
21671,8,196,2652,161,12377,35
20466,58,2369,2723,1763,32070,606
26233,24,891,2436,439,6542,452
25987,12,467,2447,237,8927,230
38486,6,192,1784,155,10207,37
46054,23,218,350,198,2807,20
34593,5,119,2030,94,3948,25
23624,11,266,2554,220,4667,46
32302,0,34,2120,30,2173,4
22223,2,91,2622,61,3573,30
26343,2,1416,2431,1030,19961,386
20325,21,1484,2730,1196,24648,288
37655,593,9773,1842,7045,59043,2728
29304,20,569,2272,394,6196,175
18633,3,72,2812,62,2874,10
39626,539,32153,1712,11593,168085,20560
32584,2,190,2108,116,3355,74
31064,37,760,2184,646,9914,114
33615,74,2343,2067,1768,48440,575
40462,551,12301,1653,8036,67528,4265
39480,4,284,1721,221,5999,63
32484,11,246,2112,211,4780,35
18945,10,459,2799,350,8592,109
16232,27,1504,2929,1200,26060,304
16479,38,1431,2917,1116,15558,315
42961,18,412,1246,322,6464,90
38427,104,3270,1788,1518,15238,1752
24268,16,491,2524,388,6673,103
18072,532,23376,2836,17811,101781,5565
25531,44,824,2468,610,8708,214
15348,53,3734,2969,2972,38675,762
36699,8,533,1902,389,8302,144
40097,15,413,1683,289,9836,124
37257,1,57,1867,45,3393,12
25616,68,1769,2463,1054,14817,715
22415,2,155,2613,129,4848,26
34000,13,226,2053,174,3563,52
29609,101,1576,2257,1138,22044,438
17421,6,549,2865,422,6274,127
28696,1,164,2303,145,7559,19
38807,0,625,1762,502,14712,123
16607,12,1026,2911,873,12892,153
34250,58,1187,2046,910,8216,277
3756,162,7376,3626,7057,35282,319
28542,1,38,2311,36,2349,2
42999,18,340,1235,259,12266,81
32291,14,822,2121,725,19363,97
25755,5,104,2457,84,3858,20
15019,18,381,2986,343,3319,38
23761,33,1908,2548,1476,34508,432
16358,10,574,2922,399,6846,175
21777,3,58,2646,29,2865,29
21579,706,39209,2657,28660,241086,10549
35784,7,304,1957,236,6778,68
37021,0,21,1882,16,2080,5
42505,19,296,1350,232,5620,64
24943,30,1111,2493,838,19662,273
43199,3,190,1177,107,4815,83
18415,26,1807,2821,1218,18437,589
42020,9,89,1449,74,3465,15
40171,38,634,1679,316,7486,318
16872,2,59,2896,45,4188,14
37691,2,43,1840,36,7452,7
16577,7,212,2912,145,3854,67
37092,11,364,1877,307,13326,57
32759,2,88,2101,61,3661,27
44105,2,24,936,16,1601,8
45642,325,4528,525,3854,46751,674
18840,14,1177,2803,801,7197,376
45707,2,18,493,15,1702,3
40355,5,227,1663,181,6732,46
21935,2,115,2638,92,4648,23
42670,4,76,1318,54,2490,22
12548,7,195,3164,158,15559,37
23091,0,759,2580,529,5062,230
22104,24,2044,2627,839,27021,1205
26331,1,97,2431,80,8380,17
26250,34,6035,2435,972,11244,5063
40333,17,540,1667,392,14146,148
34533,12,521,2033,298,5875,223
37426,28,446,1856,355,8443,91
43151,12,286,1189,172,7398,114
30722,8,416,2198,332,5762,84
7800,143,6811,3437,6702,38005,109
28011,2,52,2343,49,4243,3
39011,10,482,1750,353,16500,129
22279,2,101,2619,86,4548,15
28466,8,474,2317,394,13731,80
22868,2,80,2590,69,4241,11
12526,1,104,3164,95,3761,9
25886,1,149,2451,125,5194,24
27357,96,13633,2382,5536,59100,8097
14410,116,14136,3025,8778,66523,5358
19654,9,213,2766,171,2386,42
45288,78,1504,634,1135,34351,369
14984,246,9619,2988,6860,55029,2759
41384,0,46,1552,38,1600,8
16559,6,654,2913,500,9514,154
30243,57,2656,2225,1399,21381,1257
22586,2,148,2604,117,5091,31
46300,6,109,264,106,2784,3
42368,9,216,1379,182,6507,34
27389,28,1314,2379,932,21428,382
26785,237,7704,2410,5077,59507,2627
18465,2,214,2819,179,4535,35
31495,25,921,2161,611,8683,310
18251,615,30524,2828,21883,113957,8641
26300,10,144,2432,116,5526,28
22202,2,35,2623,33,2272,2
26713,0,97,2414,84,2384,13
13830,14,1011,3069,847,18700,164
44765,11,178,813,138,5376,40
35323,21,827,1990,404,7171,423
10803,1028,48826,3254,37795,167113,11031
7515,167,6091,3456,5029,20474,1062
37955,92,1174,1820,900,17129,274
23487,366,18174,2560,14089,145534,4085
22410,4849,160432,2613,98848,423426,61584
29188,19,794,2279,634,12160,160
39898,51,2331,1696,1613,29016,718
16861,44,2214,2896,1669,9889,545
25915,0,69,2450,53,2951,16
31750,31,865,2147,727,13119,138
9835,135,4363,3303,3944,39823,419
40881,22,463,1614,336,7008,127
25652,89,2739,2461,2014,39094,725
30506,33,694,2209,567,11197,127
34765,0,167,2020,66,2785,101
19843,94,5764,2755,4189,42061,1575
34585,36,524,2030,442,7574,82
38786,1,77,1763,72,2143,5
21225,0,272,2676,202,10362,70
19332,9,1241,2782,771,11554,470
29079,44,1729,2283,970,14956,759
8851,1,71,3360,59,4875,12
14068,10,712,3049,503,5942,209
42243,42,2280,1403,1493,25722,787
40493,1,76,1650,68,7457,8
16443,231,14284,2918,10290,65456,3994
19925,20,1222,2751,858,11058,364
38252,83,3680,1800,1754,34111,1926
38180,37,1771,1806,1112,22222,659
31086,5,210,2183,141,3624,69
11014,271,17973,3243,13661,105412,4312
18843,6,297,2803,235,4112,62
23442,3,289,2562,233,11080,56
39376,4,56,1727,37,3170,19
27033,43,2580,2401,1861,28686,719
28623,29,673,2307,504,7312,169
16788,19,811,2899,659,13177,152
43911,20,688,969,504,9077,184
30183,2,96,2229,86,6692,10
26329,367,13281,2432,8844,62240,4437
30447,8,305,2213,242,2653,63
4257,29,177419,3611,875,3827,176544
41685,80,2021,1507,1479,30147,542
16305,28,2711,2925,850,19478,1861
18373,19,2079,2823,1155,22866,924
17586,2,253,2857,165,7449,88
41424,75,2013,1545,1382,31525,631
6426,4,267,3511,264,9181,3
17847,3,119,2848,104,3221,15
45432,29,298,596,239,4962,59
17150,194,11246,2879,6273,47599,4973
12797,287,11623,3149,9658,36107,1965
34414,24,977,2038,391,7501,586
42750,17,568,1299,398,7033,170
44046,71,886,947,487,48314,399
45384,4,39,609,30,2060,9
18923,11,694,2800,591,4360,103
31188,2,36,2177,33,2993,3
35278,64,2118,1991,1514,23825,604
25588,433,25863,2465,17027,100234,8836
31896,4,159,2141,98,3800,61
18582,45,2809,2815,2265,24088,544
17017,51,3704,2888,2377,34125,1327
44388,6,66,892,47,2851,19
32594,58,4468,2107,2358,14501,2110
28922,21,254,2292,215,4194,39
42178,102,2685,1417,2007,46251,678
43611,0,15,1044,11,2121,4
22657,0,5026,2601,3890,47261,1136
38388,88,2148,1791,1330,16752,818
30054,9386,729609,2235,256064,2026788,473545
33678,10,701,2065,409,8161,292
28883,76,4590,2294,2916,33057,1674
21516,30,2081,2660,1229,33064,852
39826,13,437,1702,334,15603,103
24578,8,314,2509,229,2936,85
31201,7,116,2177,105,3407,11
26929,97,4907,2404,3337,42549,1570
31855,832,26632,2142,16512,122378,10120
38152,6,250,1807,191,7317,59
37654,5,185,1842,148,4953,37
19097,7,320,2793,257,7844,63
30850,4,144,2193,118,2698,26
28302,13,460,2327,333,6664,127
32455,159,4484,2114,3378,26296,1106
37237,41,3050,1868,1716,29575,1334
40650,17,659,1637,323,7394,336
10165,40,1421,3288,1285,5861,136
41878,17,169,1471,131,2886,38
37835,33,357,1828,284,3507,73
15865,37,5891,2946,4475,44576,1416
10769,13,386,3256,337,9746,49
14324,20,1812,3032,1401,19445,411
38320,6,193,1795,126,5199,67
17230,29,1423,2875,840,24909,583
41743,22,1146,1497,607,23300,539
16036,19,941,2938,620,7249,321
15848,3,213,2947,171,10535,42
39200,43,988,1737,791,10624,197
42622,7,345,1328,201,7252,144
30623,14,532,2204,393,12013,139
29256,1,491,2275,341,6528,150
16807,224,19216,2898,7464,74656,11752
25361,11,610,2475,470,6852,140
30227,2,96,2226,69,1996,27
19106,4,240,2793,199,8967,41
17013,244,12718,2888,9819,66321,2899
44812,12,136,797,90,6754,46
21278,7,564,2674,474,13554,90
18920,2,83,2800,74,2357,9
9541,66,4033,3318,3906,29539,127
26525,0,115,2422,98,3619,17
20480,3,442,2722,316,6654,126
23717,44,1085,2549,839,12134,246
45163,17,179,672,148,3899,31
37770,20,344,1834,269,6670,75
15400,7,233,2967,166,4769,67
20240,89,1745,2732,1377,9128,368
29010,45,2150,2288,1647,25301,503
45107,4,50,693,41,3029,9
18429,71,2019,2820,1527,16232,492
18954,8,450,2799,245,4599,205
41310,2,270,1562,183,7629,87
37286,3,295,1865,156,6319,139
37197,957,17142,1870,13053,94423,4089
15457,2,114,2965,98,2324,16
15296,11,383,2971,267,7264,116
43567,391,5233,1064,4073,57195,1160
14614,36,1272,3011,1111,44349,161
45120,15,99,685,88,5436,11
40063,459,9692,1684,7523,58066,2169
44848,32,356,783,246,10848,110
38601,11,640,1775,224,8325,416
19072,0,190,2794,92,4240,98
30746,60,1512,2197,1134,11223,378
33663,3,168,2065,141,6258,27
28395,61,3643,2321,2562,44280,1081
42163,44,1203,1420,578,9082,625
22229,400,26326,2621,18624,137263,7702
39079,59,2254,1745,752,14284,1502
29380,6,183,2268,154,6416,29
24649,481,17405,2505,11272,77120,6133
20682,35,3094,2711,2444,30513,650
21145,8,337,2682,248,7645,89
25377,0,300,2475,221,6650,79
26013,3,410,2445,253,11972,157
39771,40,1042,1705,830,10755,212
27802,3,208,2354,123,6175,85
41715,48,873,1502,525,10855,348
41882,124,5477,1470,2486,43215,2991
20242,0,49,2732,36,2431,13
36919,29,451,1888,364,7231,87
40877,96,2115,1615,1586,28671,529
35303,5,133,1990,116,5239,17
45485,2,27,583,17,1580,10
37713,9,265,1838,214,7260,51
19447,42,2331,2775,1387,12324,944
27554,43,872,2369,656,6686,216
40244,3,400,1673,218,9649,182
34155,113,9668,2049,3660,54502,6008
26869,7,172,2406,136,3366,36
37627,9,268,1843,188,9559,80
39668,58,592,1710,464,5850,128
15578,29,1334,2958,996,12287,338
26137,2,206,2441,165,2886,41
28550,17,897,2311,652,27357,245
20667,16,803,2712,595,13323,208
14230,10,486,3040,452,7869,34
19606,3,76,2769,55,2266,21
10672,23,1324,3261,1298,27850,26
37383,31,536,1860,400,6238,136
14500,5,253,3019,214,6433,39
35703,1,50,1963,41,6371,9
26685,108,2809,2415,1946,36000,863
18589,119,3938,2814,2332,20432,1606
22264,4,256,2620,210,4274,46
45873,29,490,435,460,7977,30
36696,53,1649,1902,1281,17776,368
19932,8,261,2751,206,5899,55
29871,2,140,2244,115,3136,25
33961,20,1270,2055,962,18241,308
33826,5,244,2059,201,6370,43
31823,3,141,2144,107,3456,34
16032,36,2510,2939,2068,6775,442
12828,97,5177,3147,3907,27866,1270
19980,0,144,2747,57,3776,87
44985,224,1910,746,1509,20196,401
34810,16,1395,2016,1007,17947,388
23852,83,2358,2543,1817,28186,541
32741,7,518,2102,350,8129,168
20002,3,238,2746,177,2581,61
40230,266,9522,1674,5404,66469,4118
38115,4,133,1810,92,4362,41
32998,9,214,2091,177,4824,37
29775,5,352,2248,279,3795,73
43468,4,160,1097,107,4884,53
22221,2,188,2622,168,6727,20
24998,54,2740,2491,1941,30005,799
46230,5,64,287,35,1438,29
37825,2320,118774,1829,59001,395517,59773
24725,389,17265,2502,12604,116148,4661
33320,19,568,2078,474,7701,94
31873,9,274,2142,192,4101,82
31571,6,102,2157,88,3491,14
27116,2,123,2397,109,3040,14
37954,5,235,1820,198,8909,37
46214,59,834,290,579,9093,255
22964,13,298,2585,237,4828,61
21664,63,2363,2652,1889,22308,474
18526,64,2377,2817,1981,27551,396
12016,332,50705,3192,9336,168737,41369
44618,193,4712,855,1794,31068,2918
45017,22,316,737,250,4645,66
39468,12,170,1722,109,2493,61
43347,22,279,1134,225,5306,54
20891,336,20744,2698,12647,122109,8097
33991,36,756,2053,521,7121,235
15797,11,806,2948,574,6098,232
38310,11,211,1796,169,3933,42
30550,10,695,2207,508,7337,187
27895,9,684,2350,438,7470,246
45556,2,40,557,20,1632,20
29689,14,207,2253,183,5362,24
19437,6,419,2776,259,6207,160
16362,69,1914,2922,1487,17281,427
17559,4,235,2859,209,5969,26
6997,234,14291,3485,10515,60360,3776
42804,18,175,1283,134,3805,41
20649,34,1818,2713,1447,35775,371
39230,16,742,1735,444,13816,298
19752,12,274,2761,230,4102,44
44797,12,135,801,100,5301,35
39982,2,55,1690,42,2374,13
46341,56,989,247,769,10501,220
31200,2,32,2177,31,1853,1
38447,39,820,1786,610,8041,210
43416,212,4289,1109,3440,32472,849
24913,17,2736,2494,2097,65669,639
33791,2,172,2060,134,5403,38
24799,23,1816,2500,1441,13499,375
11826,2,98,3201,88,7542,10
31562,18,483,2157,275,3765,208
39574,0,0,1715,0,3152,0
24219,4,1176,2526,968,37759,208
45248,42,441,648,425,8192,16
16308,1752,116937,2925,56343,580295,60594
30608,1,19,2204,17,2820,2
20508,16,659,2720,529,9253,130
38295,12,632,1797,357,11511,275
19485,6,359,2774,261,9371,98
30432,11,353,2214,267,5654,86
40513,0,0,1648,0,4060,0
46247,15,122,283,100,2319,22
42904,52,1621,1262,1143,17482,478
42420,41,1140,1368,862,10812,278
39924,5,207,1694,161,4397,46
23193,4,197,2575,152,12624,45
39805,1,41,1703,38,4452,3
30086,19,1073,2234,681,10409,392
35093,3,453,2002,353,7726,100
19950,6,137,2750,113,4638,24
22973,4,363,2585,257,8853,106
6981,832,53394,3485,38749,174530,14645
22404,6,160,2614,133,3954,27
40876,221,4370,1615,3218,34933,1152
25350,5,161,2476,118,7930,43
41579,7,188,1525,153,7949,35
37414,2,26,1858,21,2486,5
37267,11,365,1866,214,3158,151
22441,4,81,2612,59,1686,22
44158,3,27,927,21,5006,6
45605,2,57,546,37,2709,20
45448,4,17,591,12,2348,5
43276,47,1103,1153,863,13176,240
14854,5,388,2995,338,8684,50
43096,6,134,1205,82,3337,52
42002,8,507,1451,352,5258,155
35823,1,108,1954,64,3402,44
43184,29,314,1182,236,7728,78
20793,1,75,2704,54,2482,21
33616,60,1474,2067,1062,24388,412
38072,48,994,1813,823,9789,171
5740,12,286,3541,224,5241,62
43602,57,547,1049,373,6181,174
45437,0,19,596,15,2034,4
45005,112,1307,740,1096,22448,211
8621,108,2719,3374,2392,17623,327
20098,38,5730,2742,1709,45316,4021
29030,30,1625,2286,1123,50845,502
34722,5,191,2023,156,3517,35
29180,0,25,2279,17,2170,8
41081,2,36,1595,24,2355,12
33971,31,1182,2054,930,16898,252
40426,5,282,1657,224,3072,58
36447,5,238,1916,198,5391,40
19371,22,832,2780,678,11816,154
33915,3,547,2056,445,5787,102
15874,24,423,2946,355,5412,68
42309,22,495,1391,219,6233,276
43076,34,415,1211,319,4240,96
15004,2,300,2987,269,3596,31
20120,40,2334,2740,1113,15112,1221
45558,16,217,556,154,2746,63
26622,6,137,2418,128,2974,9
18713,4,209,2808,115,1774,94
35253,5,137,1993,119,4349,18
13287,13,1307,3111,914,9072,393
15025,74,4088,2986,3027,14600,1061
20828,28,1115,2702,867,14946,248
38018,8,252,1817,100,3992,152
36886,23,310,1890,253,4893,57
12058,9,572,3191,451,5321,121
30821,2,504,2194,389,21722,115
32522,48,1566,2111,1080,20364,486
40105,7,311,1682,207,8531,104
14944,8,699,2990,333,8985,366
39272,4,117,1732,89,5155,28
12313,16,288,3176,269,4347,19
34827,0,41,2016,33,2426,8
21245,0,512,2675,314,11655,198
45478,22,145,585,136,4981,9
13909,8,566,3061,526,9781,40
34568,8,340,2031,241,4487,99
41912,5,382,1466,227,8541,155
12395,51,3479,3171,2849,24473,630
34633,9,263,2027,194,3807,69
40496,89,1518,1649,1028,16489,490
2518,1529,89983,3649,80123,477385,9860
16914,22,1624,2894,1235,17226,389
24099,13,491,2531,400,9338,91
22182,53,1576,2624,1185,10272,391
40327,28,1030,1667,838,12511,192
18709,74,2169,2809,1479,21101,690
28113,0,55,2338,45,1425,10
34144,4,706,2049,311,17975,395
24729,64,1697,2502,1309,11756,388
39861,5,160,1699,110,6992,50
39758,52,748,1706,586,7913,162
24654,2,0,2505,0,3254,0
15134,42,3993,2980,1636,23227,2357
18237,58,4401,2829,2652,32630,1749
44965,15,402,752,288,6801,114
21937,21,2401,2638,1436,58840,965
31432,10,180,2165,153,9662,27
16848,32,931,2897,715,5514,216
9515,81,3188,3319,2046,12485,1142
45502,25,213,580,131,4226,82
32264,7,213,2121,179,6571,34
45889,10,133,427,82,1892,51
36635,211,8265,1905,6105,61163,2160
11083,28,630,3240,568,4477,62
26824,16,636,2408,531,8530,105
40641,1,50,1637,40,2405,10
11536,5550,152462,3215,89267,539318,63195
19487,175,4137,2774,3321,17138,816
19068,59,2703,2794,1776,28615,927
34754,3,101,2021,86,3500,15
32829,17,585,2097,457,6891,128
36924,69,2148,1888,1511,31183,637
25747,408,13916,2457,9951,75359,3965
23744,13,715,2548,504,6437,211
26341,45,1773,2431,832,15606,941
22124,0,0,2626,0,76298,0
20370,4,271,2728,219,15054,52
43270,118,2567,1155,1930,35622,637
26426,7,257,2426,230,8842,27
26000,20,526,2446,397,7408,129
45644,7,78,525,52,4905,26
29978,30,981,2239,732,13172,249
37071,0,115,1879,93,4191,22
14835,14,1429,2996,715,7329,714
25311,6,474,2478,239,4725,235
26741,0,57,2412,46,4461,11
15670,16,788,2954,553,10809,235
12976,7,464,3137,421,10703,43
13033,409,14414,3135,11280,80940,3134
30352,2,102,2219,86,4249,16
39521,98,3645,1719,2115,20769,1530
16529,5,150,2914,116,4204,34
38921,60,1622,1755,1121,19387,501
23927,214,9091,2539,4118,56274,4973
20678,1,27,2712,23,3775,4
40005,115,4496,1688,1298,36877,3198
19573,2,39,2770,34,1706,5
4186,801,39229,3613,34178,112053,5051
13426,40,3381,3101,2997,30314,384
9109,1,63,3345,51,2569,12
36783,3,116,1897,83,7644,33
13771,55,3898,3073,3020,49808,878
16524,20,1695,2914,1237,24138,458
17178,5,330,2878,244,8291,86
35297,38,493,1991,394,7028,99
30222,276,8168,2226,6375,68670,1793
43016,4,197,1230,121,3603,76
40223,4,106,1675,72,4078,34
16713,81,4109,2905,3438,13927,671
35744,13,423,1960,349,40987,74
1258,13,415,3884,353,7372,62
14042,0,696,3051,683,4583,13
32413,600,27513,2115,19118,153357,8395
33742,9,444,2062,332,19861,112
27717,7,165,2360,142,5072,23
23752,12,399,2548,324,6817,75
37684,5,156,1840,142,2944,14
13644,15,1058,3084,474,7227,584
26550,3,123,2421,107,1879,16
45449,28,371,591,263,8508,108
44801,19,319,799,249,3214,70
42974,9,573,1243,323,7498,250
45068,19,187,715,142,5443,45
22348,23,1165,2616,770,9326,395
29571,3,102,2259,88,2186,14
28732,14,321,2301,246,3767,75
18828,1,54,2803,44,3194,10
23267,35,1675,2571,1374,13646,301
28399,71,3847,2321,2152,34846,1695
29194,5,207,2278,166,4035,41
14566,15,1022,3014,973,9884,49
17171,3,289,2878,223,3766,66
15514,527,29998,2962,22227,111534,7771
30245,19,893,2225,745,9374,148
11684,537,27107,3207,18432,272002,8675
44129,270,4867,933,3687,28886,1180
13051,930,85164,3133,52941,336400,32223
23810,3,83,2546,76,3116,7
17747,177,12287,2851,7605,44277,4682
19827,10,404,2756,345,5165,59
23408,1,89,2564,76,6811,13
17220,10,1771,2876,810,16154,961
24692,2,164,2503,129,2310,35
28956,11,451,2290,365,4863,86
23368,150,5552,2566,4302,33298,1250
23233,1,169,2573,143,2667,26
28381,6,324,2322,276,6944,48
31445,2,233,2164,185,10561,48
25706,12,368,2459,298,4200,70
25482,6,268,2470,202,14998,66
44269,88,1193,910,932,12849,261
36401,9,211,1918,195,3132,16
13407,4,131,3102,121,2309,10
11644,25,3199,3210,1968,25451,1231
36171,4,104,1929,89,2362,15
45507,2,36,578,28,1904,8
15612,22,4059,2956,3036,68980,1023
40811,20,488,1621,353,9273,135
31656,6,290,2152,241,3487,49
43624,1,34,1041,34,2827,0
25174,1,80,2483,64,3177,16
26795,65,2738,2409,1914,44287,824
46225,0,49,288,41,2008,8
15735,34,1504,2951,1245,8204,259
13673,57,2182,3081,1726,14349,456
39157,15,450,1740,315,12388,135
33736,46,1135,2062,908,14481,227
40741,13,234,1629,197,5578,37
7119,56,2416,3478,1774,20305,642
30196,1,123,2228,100,8464,23
40169,2,83,1679,44,3798,39
26447,3,307,2425,248,3390,59
29279,21,479,2274,396,7397,83
30169,24,544,2230,481,9420,63
37887,57,2290,1825,1637,34282,653
36082,234,7548,1935,4844,75546,2704
33165,17,324,2083,276,7658,48
40280,1,218,1671,146,7894,72
44880,45,292,776,256,7226,36
42493,361,6582,1353,4915,42888,1667
45336,25,691,621,241,4747,450
30170,5,293,2230,190,10040,103
13467,109,3215,3096,2837,20216,378
23127,19,1409,2578,988,6309,421
36957,1,119,1886,73,5522,46
20676,24,883,2712,646,17749,237
3649,14,877,3629,847,17420,30
40322,17,538,1668,353,8719,185
15102,55,2385,2981,1727,28964,658
35792,34,635,1956,475,6544,160
41469,27,761,1539,462,7525,299
25763,11,314,2457,250,4522,64
42963,19,630,1246,449,18230,181
28397,2,71,2321,63,2580,8
21678,58,4620,2651,2453,22929,2167
16510,8,288,2915,210,7877,78
34111,395,6721,2049,5460,26824,1261
45492,253,4829,581,4595,56128,234
15553,24,870,2960,684,9343,186
24412,0,8596,2517,3985,33586,4611
29325,6,80,2270,69,2464,11
30871,11,379,2192,157,4677,222
20674,29,760,2712,534,6536,226
31709,21,542,2149,435,8679,107
44205,39,555,918,425,7092,130
33061,1,107,2088,91,3298,16
29545,12,1047,2260,722,37873,325
10811,829,40638,3253,28191,105803,12447
28465,11,418,2317,329,11897,89
10496,2,235,3272,231,8421,4
40553,3,146,1644,117,4125,29
36354,4,332,1920,186,5843,146
46194,0,10,296,8,1222,2
24079,51,2721,2533,1592,16827,1129
31071,1,96,2184,77,1634,19
40089,1,174,1683,98,6916,76
41207,5,310,1581,233,9266,77
11507,68,7563,3217,4532,44074,3031
29227,10,421,2276,346,5075,75
35538,1,110,1976,95,7274,15
21242,0,23,2675,20,1373,3
19429,34,1582,2776,1188,26049,394
30984,125,3997,2188,2957,33994,1040
32417,24,823,2115,661,17919,162
42821,55,1044,1281,855,25323,189
43153,9,211,1189,153,2652,58
23080,538,15502,2580,11199,72918,4303
39341,493,15905,1728,11421,130834,4484
44298,10,78,906,67,2677,11
40011,2,121,1688,92,4608,29
36123,1,104,1932,79,3300,25
22376,14,1742,2615,1074,14713,668
23477,7,280,2560,205,8625,75
32316,4,572,2119,329,5916,243
28305,58,1289,2326,925,6769,364
31536,15,397,2158,335,4355,62
30744,18,692,2197,559,10363,133
23742,56,1188,2548,990,16156,198
44768,3,47,810,39,1967,8
40058,10,142,1685,107,2507,35
32063,15,1022,2131,664,17257,358
19351,7,593,2781,469,13714,124
31288,1164,50101,2172,30841,158720,19260
16145,70,3223,2933,1964,40101,1259
18782,1,280,2805,220,7715,60
33325,21,538,2078,399,7767,139
38505,1,46,1783,38,2590,8
24282,6,577,2523,446,10251,131
41930,28,349,1463,229,6776,120
34377,26,459,2040,325,6314,134
10925,718,39415,3247,26799,162524,12616
22648,0,27,2601,23,1808,4
42320,161,7913,1389,3296,44221,4617
41547,4,296,1529,225,6456,71
39265,22,733,1732,451,10171,282
46025,30,316,367,216,5195,100
38931,5,62,1754,52,4246,10
28181,49,1660,2333,1266,23939,394
38386,7,136,1791,113,4639,23
41751,49,1292,1495,748,21160,544
21929,8,320,2638,274,2752,46
14879,32,1815,2994,1642,17413,173
18497,650,46039,2818,24018,164605,22021
32999,77,1164,2091,959,22582,205
38845,78,2138,1760,1622,30265,516
26037,14,571,2444,422,7524,149
32352,1,17,2117,16,2713,1
40541,5,162,1646,128,2534,34
18287,27,1836,2827,1430,15409,406
34267,0,420,2045,307,8944,113
41566,5,67,1527,58,4975,9
44762,50,1035,813,502,15103,533
32281,46,1003,2121,612,12341,391
15649,30,3273,2955,2149,54997,1124
36487,7,307,1914,204,5620,103
12288,2,103,3178,73,3793,30
36974,27,1168,1885,847,13895,321
32024,1,46,2134,41,3176,5
34867,30,437,2013,361,5697,76
39311,3,100,1730,86,6786,14
42019,40,1159,1449,800,6575,359
45943,19,96,399,93,2366,3
43997,48,826,956,671,15869,155
991,9,228,3972,192,7313,36
39498,14,251,1720,173,8375,78
28234,3,97,2330,77,4085,20
25683,13,651,2460,480,11924,171
21590,46,2422,2657,1727,29952,695
26860,70,1947,2406,1522,12987,425
26549,11,443,2421,363,7521,80
17341,78,3027,2869,2162,15671,865
12626,504,31331,3159,22746,131528,8585
46164,7,181,306,101,5960,80
25644,77,4205,2462,3141,46381,1064
33274,4,182,2080,160,5325,22
36296,17,608,1923,450,8927,158
24522,2,271,2512,224,7323,47
24938,44,2728,2493,2177,29539,551
43496,237,7137,1088,4863,50403,2274
28089,35,973,2339,737,7411,236
9534,1564,85316,3319,63677,313704,21639
41886,3,172,1470,143,3550,29
22306,67,4347,2618,3061,24710,1286
30508,1,67,2209,55,3432,12
35817,103,2880,1954,1977,33843,903
24771,33,1216,2501,754,7014,462
43227,37,1247,1167,965,20852,282
18863,15,542,2802,427,5139,115
37620,4,130,1844,109,5560,21
20197,4,135,2736,96,6847,39
16724,15,1499,2904,1019,20314,480
35258,0,598,1992,494,13031,104
40397,12,195,1659,162,2641,33
39318,0,24,1729,19,2875,5
28388,114,7212,2322,3248,45091,3964
32827,0,181,2097,148,7108,33
45620,2,56,539,48,2962,8
15898,8,307,2945,221,6355,86
42745,7,228,1299,154,7496,74
23705,30,1551,2550,1110,24280,441
23939,16,600,2538,243,7339,357
17195,90,21260,2877,5015,48761,16245
23781,12,389,2547,325,10350,64
24449,6,314,2516,248,5817,66
43208,11,89,1176,73,3961,16
33403,290,12163,2075,7969,37195,4194
17033,25,1148,2887,886,12891,262
35254,6,142,1993,124,4939,18
31011,3,58,2187,50,1816,8
37600,2,73,1845,61,6568,12
24670,62,1302,2504,1040,16835,262
41665,17,792,1510,582,16405,210
12031,98,17116,3192,5549,79087,11567
11911,1110,61675,3197,47855,171586,13820
33783,31,803,2060,376,4661,427
9169,253,15161,3341,13198,91955,1963
16999,28,507,2890,395,4120,112
23406,126,5560,2564,3889,57719,1671
42356,6,174,1381,121,8398,53
27114,2,199,2397,164,3669,35
37037,6,193,1881,169,14339,24
43893,6,101,973,86,2206,15
40855,4,72,1616,65,3566,7
23651,1,50,2552,43,1732,7
16493,93,1541,2916,1077,14880,464
40045,45,760,1685,624,6476,136
41379,8,367,1553,262,3999,105
22536,100,9158,2606,5445,43591,3713
42811,23,450,1282,284,11339,166
38067,24,857,1813,640,27720,217
15146,64,1492,2978,1264,9572,228
29638,547,27374,2255,10883,72672,16491
16995,14,489,2890,365,5827,124
45708,4,67,493,64,2780,3
44751,89,1604,814,996,21943,608
39883,6,191,1697,154,6115,37
18714,7,272,2808,213,3919,59
43627,2,21,1040,17,1315,4
20299,1,225,2730,191,2416,34
1110,5,223,3932,179,5006,44
14519,5,216,3017,196,5277,20
32437,1,136,2114,92,3926,44
38431,149,3317,1787,2590,28020,727
38123,3,51,1809,33,3124,18
36947,15,325,1887,259,8756,66
43692,9,107,1017,86,2495,21
32751,5,146,2101,128,5687,18
38813,2,15,1762,12,2127,3
37585,0,44,1846,37,2176,7
21170,84,5111,2680,4021,41099,1090
21104,4521,255292,2685,106973,791156,148319
23526,241,12821,2559,7880,83079,4941
30660,0,38,2201,20,1831,18
37395,1,30,1859,25,2439,5
16566,56,2864,2913,2171,33559,693
35752,24,590,1960,502,22705,88
36136,0,46,1931,42,3933,4
35105,1,175,2001,38,2105,137
20248,145,24698,2732,7164,73994,17534
26954,6,201,2402,146,2331,55
30929,18,266,2190,228,3113,38
22397,7,158,2614,132,10826,26
40940,191,4845,1610,3392,34149,1453
32069,3,168,2131,112,9228,56
30519,183,2281,2208,1568,15924,713
33401,2,76,2075,62,2749,14
33443,2,89,2073,31,2326,58
13645,15,907,3083,695,13248,212
8850,24,1381,3360,1108,33041,273
29012,692,37540,2288,16004,128027,21536
18057,4,108,2836,99,2559,9
43341,67,1424,1135,1016,23897,408
30032,0,20,2237,16,4630,4
37496,2,124,1852,89,2594,35
19252,4,133,2786,114,3596,19
3557,0,180669,3630,54,1735,180615
43293,34,536,1149,398,5170,138
19316,32,537,2782,452,5728,85
31994,556,25352,2136,15797,157296,9555
16751,6,539,2902,451,9700,88
46029,118,1028,365,979,15352,49
39616,12,458,1713,236,4911,222
13551,67,7084,3090,5706,83239,1378
45897,30,421,426,393,6492,28
36013,9,451,1940,315,3091,136
42532,67,1353,1345,1034,41294,319
40765,12,243,1626,191,5504,52
38623,22,628,1773,508,12998,120
16313,10,202,2925,161,13623,41
32692,51,2184,2103,1713,14389,471
44871,7,63,778,61,1719,2
31569,50,3091,2157,1363,26455,1728
28620,0,543,2307,429,7519,114
37263,25,669,1867,552,6174,117
24314,0,162,2522,73,3151,89
40235,14,333,1674,281,5456,52
42414,285,10266,1370,5261,98639,5005
37447,122,1510,1855,1255,10132,255
39683,24,450,1709,350,7480,100
36451,15,300,1916,261,8547,39
22381,97,7105,2615,3192,40546,3913
32405,748,15174,2115,11982,76918,3192
39307,16,555,1730,474,16619,81
43897,27,196,972,163,3717,33
31506,25,694,2160,491,6893,203
35202,86,4673,1997,2357,26613,2316
45366,47,478,614,436,11717,42
25317,3,208,2477,174,6090,34
34444,3,402,2037,287,9933,115
30287,11,729,2223,606,9490,123
19926,42,3475,2751,2506,39584,969
15193,12,433,2976,366,5313,67
30415,14,519,2215,438,7832,81
22046,7,790,2631,492,30563,298
19714,47,1412,2763,1117,16141,295
23736,1,63,2548,37,4806,26
19858,28,1926,2754,940,30068,986
32084,10,407,2130,307,10320,100
32920,1,181,2093,100,3986,81
26505,7,444,2423,351,13167,93
41066,5,392,1598,294,15631,98
42136,15,438,1428,359,4720,79
23256,8,0,2572,0,38318,0
25217,10,478,2481,397,6039,81
42300,290,5661,1393,4050,66433,1611
39881,7,145,1697,107,3401,38
18877,2,209,2801,165,2240,44
16565,19,597,2913,406,4915,191
3757,26,264993,3626,1164,29142,263829
45770,0,134,467,72,2593,62
25556,4,168,2467,151,3239,17
12747,18,1124,3152,1014,13939,110
21553,10,585,2659,490,6796,95
39405,4,198,1725,163,3549,35
13876,39,809,3065,714,6220,95
31407,0,49,2167,35,6673,14
21602,6,293,2656,231,30096,62
21128,5,397,2684,306,11524,91
32742,14,602,2102,489,5247,113
14294,14,1044,3035,885,33969,159
31083,8,261,2183,228,6512,33
40403,69,1020,1659,581,11567,439
19731,60,2321,2762,1844,10689,477
24288,8,272,2523,214,2911,58
14400,6,106,3026,104,7052,2
37358,0,0,1861,0,10521,0
25333,136,7351,2476,4606,46236,2745
30071,5,293,2235,236,4573,57
42510,137,1862,1349,1306,17996,556
39701,49,1800,1708,1477,31127,323
45513,78,690,576,549,14778,141
30728,8,93,2198,86,5806,7
45508,2,30,578,25,1629,5
30315,30,1740,2221,1196,22275,544
34338,1,64,2042,53,4086,11
24520,2,360,2512,289,8593,71
33464,1,69,2072,60,4806,9
8414,470,19394,3388,14600,71253,4794
23079,20,824,2580,655,14095,169
38944,42,1283,1754,1019,25265,264
34773,47,1184,2020,1004,12677,180
21117,9,744,2685,529,11727,215
14912,21,1172,2992,939,17286,233
4152,85,5321,3614,4624,80531,697
22122,28,1723,2626,1301,15242,422
38064,209,3126,1814,2523,32002,603
39801,286,19048,1703,4203,92395,14845
19299,0,1200,2783,427,21849,773
36552,51,906,1911,709,16611,197
37370,11,177,1860,148,5202,29
34525,527,44650,2033,17831,172696,26819
40952,1,172,1609,105,4548,67
35831,2,54,1954,49,2907,5
15111,109,5503,2981,3406,59097,2097
35875,18,443,1950,354,5281,89
3407,12,643,3633,639,4225,4
12519,2,134,3164,113,1323,21
45132,2,22,681,17,1666,5
43660,171,2155,1028,1894,17767,261
26503,5,473,2423,317,4334,156
45378,224,2637,611,2500,23476,137
34498,22,1283,2035,1061,15546,222
40591,10,143,1641,106,1526,37
5152,319,13223,3571,9342,82506,3881
24183,0,712,2528,562,12426,150
44537,150,2344,861,1156,16763,1188
19961,5,254,2749,201,7069,53
45012,7,99,738,84,3015,15
25629,90,1976,2462,1371,8876,605
38349,4,339,1793,274,9688,65
10638,383,7075,3263,6142,33642,933
32051,0,51,2132,25,5870,26
16377,47,4613,2921,3223,34051,1390
40930,35,4335,1611,908,23800,3427
43762,194,2394,996,2111,24315,283
30464,2,114,2212,87,2933,27
13199,11,572,3116,457,9194,115
36856,5,123,1891,89,2795,34
13087,40,1510,3131,1091,32205,419
18452,3,65,2820,58,2831,7
46067,11,157,344,119,2766,38
41798,47,1006,1485,781,19132,225
18586,29,770,2814,565,9810,205
18636,6,683,2812,493,9622,190
45223,1,21,655,16,1870,5
21487,15,425,2663,356,4039,69
15721,21,982,2951,797,4928,185
27339,1,178,2383,113,1874,65
18849,3,251,2802,197,5548,54
12093,28,832,3189,799,12034,33
23596,0,48,2555,39,4449,9
36797,6,292,1896,233,4579,59
16808,11,730,2898,593,11307,137
35711,7,185,1962,138,4290,47
20138,17,1649,2739,592,10625,1057
31022,2,57,2186,45,6271,12
18602,76,7110,2813,5330,50824,1780
16472,59,1589,2917,1265,22788,324
36939,1459,67233,1887,38208,299496,29025
27538,2,162,2370,142,5487,20
16879,241,12066,2896,7063,56312,5003
28231,19,740,2330,630,17371,110
22236,37,1301,2621,1080,12918,221
16324,98,2827,2924,1992,10976,835
32190,0,46,2125,37,2312,9
37836,7,334,1828,242,5929,92
29614,0,40,2257,30,2574,10
23088,557,22035,2580,16079,138977,5956
18618,5,228,2813,185,12193,43
40415,295,7387,1658,5403,39237,1984
14497,200,11008,3019,8573,46087,2435
35641,2,83,1968,74,8472,9
15441,29,1177,2965,906,8422,271
21360,3,132,2669,114,3917,18
17248,6,281,2874,219,3752,62
29129,82,3109,2281,1641,41509,1468
39524,2,75,1719,42,3443,33
39523,6,158,1719,124,5736,34
28555,18,586,2311,463,7681,123
35259,54,1259,1992,1040,19547,219
37945,4,119,1821,98,9156,21
31181,4,117,2178,89,2977,28
3657,24,285065,3628,1054,30443,284011
12509,15,369,3164,365,3018,4
31544,8,569,2158,181,7568,388
34634,18,903,2027,640,14579,263
30241,24,1332,2225,530,15581,802
43721,41,258,1007,227,3306,31
39914,6,91,1694,79,4407,12
19562,5,129,2771,105,7181,24
28222,4,305,2331,233,8885,72
16799,5,478,2899,368,7443,110
20277,36,1205,2731,937,12311,268
31641,8,205,2153,174,6585,31
22295,27,1689,2618,1167,15558,522
42367,36,378,1379,281,4837,97
13871,19,1382,3066,1150,17693,232
34828,23,302,2016,249,3602,53
28936,7,320,2291,147,3442,173
20271,27,1298,2731,939,16673,359
17997,0,601,2839,475,17584,126
45474,10,85,586,64,2421,21
39209,20,205,1737,175,3886,30
34916,29,776,2011,575,7330,201
21240,3,199,2675,159,3527,40
38929,76,1999,1755,1600,16590,399
14453,73,7174,3023,5042,61173,2132
43269,6,334,1155,211,3377,123
22156,36,2408,2625,1812,24294,596
37857,7,152,1827,113,9679,39
22555,809,61745,2605,17963,270134,43782
15719,5,474,2952,402,18802,72
20394,46,3734,2726,2981,35209,753
29007,246,3889,2288,2937,17230,952
36704,14,924,1902,559,5573,365
36496,0,31,1913,21,3338,10
28034,2,75,2342,48,3387,27
24704,1,47,2502,36,4241,11
19721,3,150,2762,122,5563,28
37756,46,3288,1835,1494,23398,1794
45167,0,7,671,6,1155,1
39572,4,73,1716,62,4925,11
23686,4,454,2550,350,8601,104
29103,2944,220012,2283,89207,851286,130805
18022,12,883,2838,516,16059,367
20492,23,1682,2722,1355,36243,327
27188,1,92,2392,65,2002,27
31664,25,807,2152,605,14355,202
40491,194,6335,1650,3875,40030,2460
40832,81,1862,1619,846,27572,1016
18980,4,155,2798,122,3771,33
42053,307,8202,1443,5702,81094,2500
41885,6,235,1470,211,4609,24
28155,5,512,2335,405,7930,107
14926,7,275,2991,235,5493,40
21495,39,1780,2662,1368,17171,412
21525,25,816,2660,696,11752,120
18166,58,2826,2832,2300,15220,526
9185,436,19616,3340,18171,189124,1445
39612,3,62,1713,50,5240,12
45377,12,108,611,96,2686,12
28745,88,4476,2300,2466,21964,2010
33327,4,163,2078,96,3835,67
8712,114,1847,3368,1746,16233,101
35662,13,508,1966,436,11411,72
14196,97,5212,3042,4797,49699,415
32791,9,438,2099,322,3381,116
25228,138,3414,2481,2449,34781,965
18567,36,870,2815,696,16656,174
23430,5,130,2563,98,3048,32
41480,2,49,1538,25,1954,24
37834,4,95,1828,74,2794,21
18552,23,759,2816,604,19252,155
40345,5,196,1665,152,5004,44
18482,8,495,2818,391,5936,104
10424,402,29719,3276,13640,103889,16079
12504,76,4812,3165,2231,42536,2581
34779,8,465,2019,361,6710,104
30182,14,691,2229,318,4924,373
16591,52,1835,2912,1530,26682,305
21221,9,567,2676,412,5756,155
36558,9,176,1910,138,2308,38
37265,130,3669,1866,2844,22541,825
46203,3,51,293,43,1143,8
44870,2,67,778,62,5117,5
37158,2,134,1873,111,7317,23
13468,18,1686,3096,1193,27410,493
33341,3,164,2077,133,3011,31
21965,11,759,2635,628,11252,131
29008,20,553,2288,386,4887,167
31961,84,3182,2137,1647,27048,1535
11874,523,31637,3199,25722,201531,5915
28492,68,2110,2316,1388,12867,722
24399,100,5723,2518,3527,39648,2196
26465,19,2053,2425,1301,23507,752
25204,156,4294,2481,3389,40876,905
34245,125,5101,2046,1907,95405,3194
45746,24,264,478,229,3028,35
13081,52,2065,3131,1868,36316,197
43462,4,36,964,30,1066,6
36759,1,42,1898,34,3965,8
25179,0,1552,2482,1209,9590,343
26323,6,176,2432,142,4220,34
19834,11,862,2756,622,10295,240
19724,9,1003,2762,451,10663,552
17584,10,588,2857,423,7020,165
31404,39,1906,2167,1469,18501,437
36500,17,418,1913,198,13371,220
12616,25,581,3159,573,8297,8
23136,13,1394,2578,1041,18296,353
42466,6,168,1359,99,6108,69
43676,154,3066,1024,2560,31081,506
33926,19,2036,2056,1428,18572,608
19660,19,1450,2766,1068,16323,382
39269,2,186,1732,162,5469,24
13834,2600,373480,3069,46440,669542,327040
45716,126,1475,489,950,15228,525
38729,7,148,1767,108,3836,40
34595,1,260,2030,212,5802,48
13833,0,103,3069,96,5582,7
45733,9,126,481,123,4120,3
20963,78,3775,2693,2516,40404,1259
43009,19,372,1232,259,7242,113
45843,6,59,445,46,4806,13
31593,10,558,2156,379,16143,179
29036,13,468,2286,267,10916,201
16079,14,445,2936,358,4728,87
37018,15,552,1882,422,10470,130
21707,1,49,2650,43,1125,6
33087,41,718,2086,590,12609,128
18196,0,303,2831,241,7172,62
33173,13,409,2083,355,5240,54
28223,3011,156571,2331,70224,592907,86347
45876,21,440,434,324,7064,116
45505,70,1070,579,873,9679,197
42801,13,115,1283,103,2338,12
37801,11,198,1831,160,4051,38
15970,131,7662,2942,6038,24513,1624
17787,4,253,2851,201,10368,52
24360,12,600,2520,310,6176,290
9669,11,724,3311,552,4449,172
38531,13,458,1780,361,13952,97
19850,0,1388,2755,1164,14994,224
21919,10,426,2639,330,11266,96
9279,88,5829,3335,5177,33475,652
26844,31,601,2407,418,18459,183
11256,73,3659,3230,3255,26883,404
16047,14,639,2937,490,6778,149
23071,0,25,2581,21,2623,4
34624,15,450,2028,365,8267,85
22294,11,261,2618,196,4465,65
36409,27,847,1918,541,10878,306
37193,53,1279,1871,747,9541,532
21119,26,1134,2684,796,13010,338
39907,2,201,1695,157,6707,44
13350,450,47845,3106,19320,206628,28525
25946,102,4250,2448,994,18236,3256
33795,2,76,2060,65,2416,11
13441,10,597,3098,573,6808,24
35975,5,119,1943,97,4080,22
14596,276,14338,3012,8169,32620,6169
35173,0,81,1998,65,3051,16
24647,298,11969,2505,8512,52706,3457
27934,2,128,2347,113,6044,15
34495,0,69,2035,66,2708,3
10150,490,24871,3288,22493,141947,2378
42229,104,5482,1406,864,15012,4618
32602,0,52,2107,37,3136,15
37188,32,663,1872,491,7375,172
29215,3,276,2277,234,3959,42
22888,25,1168,2589,920,10920,248
38939,7,354,1754,270,10218,84
45706,7,93,494,74,4620,19
40161,1,34,1679,27,4155,7
23534,35,1676,2558,1169,20304,507
32749,3,407,2101,363,6352,44
40933,8,465,1610,343,11986,122
32007,2,115,2135,90,6245,25
27202,4,209,2391,186,10702,23
27741,2,127,2359,104,4251,23
42991,61,1326,1237,1007,14581,319
36460,0,24,1915,20,3575,4
18423,112,6349,2821,4860,41648,1489
28440,1,212,2319,166,5986,46
28300,16,1036,2327,845,13696,191
10198,30,2620,3286,1630,28595,990
29411,0,181,2266,88,4241,93
39596,12,405,1714,272,15057,133
45249,123,1558,647,1525,20891,33
25826,42,1551,2454,641,10100,910
13302,119,5991,3110,4751,31264,1240
41538,70,693,1531,567,8057,126
37044,25,651,1880,510,8880,141
20720,8,669,2709,524,6762,145
13428,30,1514,3100,1510,22246,4
28392,0,131,2321,90,2444,41
12910,125,6069,3142,5399,37194,670
16188,4,146,2931,122,5212,24
19630,3,299,2768,242,3100,57
40555,327,6338,1644,3881,23028,2457
43620,27,475,1042,389,8047,86
46163,51,907,306,730,9147,177
30680,13,908,2200,706,13052,202
22203,6,230,2623,152,3624,78
16817,56,2676,2898,1641,15055,1035
27290,0,1339,2386,357,7056,982
26653,90,2205,2417,1909,20113,296
38426,54,932,1788,722,15536,210
43249,0,11,1161,7,1807,4
20974,8,363,2693,294,4876,69
36990,1,108,1884,100,3405,8
29019,0,147,2287,107,4577,40
41346,80,3840,1557,1947,27649,1893
18144,0,95,2833,85,2871,10
38398,2,97,1790,68,4261,29
26094,7,232,2442,189,1778,43
31715,0,43,2149,37,3648,6
45656,17,254,519,217,7916,37
40041,19,795,1686,543,8596,252
15117,3,410,2980,338,9887,72
37344,20,896,1862,722,11416,174
25131,28,2364,2485,1222,19320,1142
13020,49,1514,3135,1395,14958,119
39690,10,626,1709,472,16373,154
41696,14,486,1506,254,8346,232
9473,13,790,3322,666,7957,124
41871,30,682,1472,501,10492,181
40087,15,592,1683,374,6745,218
14761,81,5398,3001,2669,26929,2729
6778,104,7435,3496,6931,59430,504
19135,56,6465,2792,4769,39601,1696
28064,0,19,2340,17,2016,2
42810,5,146,1282,91,4356,55
25239,1,114,2480,94,6998,20
19260,3,199,2785,178,8132,21
20509,260,5388,2720,3849,23213,1539
26393,2,232,2428,190,2432,42
29172,115,6748,2279,2608,39259,4140
36549,7,245,1911,209,4006,36
3534,126,3619,3631,2823,14565,796
38466,938,15437,1785,12422,67808,3015
31720,32,1017,2149,811,8823,206
35349,58,489,1988,397,4890,92
26612,17,463,2418,322,6258,141
35338,5,303,1989,242,4705,61
32404,2,118,2115,100,6790,18
43953,40,532,963,444,10096,88
25680,0,37,2460,31,1143,6
16226,39,1074,2929,868,9158,206
11210,1396,106767,3232,85456,531673,21311
13558,29,2034,3089,2014,33204,20
6321,85,6661,3516,4642,56053,2019
18451,20,1116,2820,865,9555,251
37790,79,1607,1832,1158,14940,449
27235,555,61267,2389,9893,268158,51374
23906,6,264,2541,196,7468,68
25453,0,400,2472,330,13689,70
11711,13,565,3206,550,12391,15
30423,2,104,2214,49,3202,55
39608,2,145,1713,47,4621,98
44257,368,7207,911,5993,33570,1214
27191,0,64,2392,62,2649,2
12048,517,26520,3191,21447,188369,5073
13345,67,6418,3106,2901,12587,3517
34903,2,270,2012,202,9332,68
20764,6,356,2707,268,10091,88
21855,3,175,2643,98,3202,77
45349,1,39,618,30,2321,9
36808,20,476,1895,383,9220,93
32272,24,197,2121,164,3477,33
37960,28,514,1820,374,5616,140
12134,532,43845,3186,25404,246953,18441
38032,9,239,1816,188,4131,51
26012,14,259,2445,183,6515,76
17993,11,951,2840,693,12976,258
13637,245,16503,3084,10886,129423,5617
31881,3,50,2141,41,2929,9
41205,9,253,1581,209,6155,44
26273,1,56,2434,50,2092,6
16668,285,12993,2907,8126,70103,4867
23854,66,937,2543,692,11353,245
5757,69,88509,3540,2773,15688,85736
21309,8,309,2673,235,7329,74
34698,3,91,2024,52,3739,39
35945,28,591,1946,519,11905,72
16947,60,2714,2892,1823,16958,891
43396,90,2494,1115,1400,16845,1094
44900,8,174,771,121,4323,53
38599,41,1481,1775,858,12070,623
36764,39,1077,1898,798,15017,279
42625,1,180,1328,136,6212,44
33990,47,1097,2053,782,10969,315
22154,8,182,2625,148,3830,34
18825,2,160,2803,135,4308,25
42502,21,296,1351,221,7578,75
24640,13,397,2505,327,5811,70
40035,33,832,1686,647,14447,185
43918,12,259,967,192,5087,67
17079,6,540,2884,449,6605,91
14411,40,1038,3025,864,20219,174
14419,109,6283,3025,5498,56315,785
39677,6,162,1709,146,3749,16
25982,14,645,2447,337,10987,308
16234,163,14999,2929,8004,58600,6995
43274,25,289,1154,200,4127,89
27190,3,118,2392,105,1931,13
37908,34,843,1823,653,13084,190
35111,85,4404,2001,3473,25569,931
30780,2,107,2196,87,3238,20
4057,176,297513,3617,8043,69283,289470
41490,8,187,1536,146,6000,41
10749,38,2284,3257,1336,31951,948
46114,0,46,331,40,1307,6
43370,28,485,1123,336,12173,149
27546,36,1492,2370,944,9806,548
34623,55,1294,2028,976,12673,318
39967,4,121,1691,108,5619,13
19819,16,927,2756,600,27946,327
43197,243,4860,1178,3853,44523,1007
9914,144,9987,3300,7786,61878,2201
14934,6,334,2991,322,4437,12
15392,79,3782,2967,2053,11932,1729
22026,16,579,2631,443,6866,136
28182,20,385,2333,315,3366,70
21588,0,54,2657,45,2387,9
20408,5,147,2725,128,3222,19
15126,31,1239,2980,1133,11935,106
36676,4,131,1903,90,5935,41
17451,46,1222,2864,946,10294,276
15701,574,44506,2952,29557,171191,14949
34260,9,243,2045,118,3486,125
20357,118,5917,2728,3291,21670,2626
17355,79,46607,2868,5670,52729,40937
25543,299,9643,2467,7116,57060,2527
15150,825,66971,2978,35698,361668,31273
45360,63,768,616,596,9260,172
30897,1,51,2191,51,2718,0
35890,24,1355,1949,588,9649,767
12742,20,648,3152,609,9379,39
36932,20,1287,1887,640,12416,647
43622,11,98,1042,83,3410,15
25226,815,29651,2481,14800,118826,14851
32453,19,1417,2114,874,13910,543
24149,0,34,2529,32,2411,2
45043,727,12876,726,11039,105255,1837
45687,10,137,505,97,3486,40
19079,4,143,2794,102,5395,41
37729,43,2826,1837,1952,21622,874
36995,14,343,1883,226,8188,117
30639,5,236,2203,153,6650,83
12800,0,165,3149,127,4027,38
35850,18,427,1952,331,4248,96
3485,111,4723,3632,4414,18766,309
27901,16,525,2349,443,11732,82
30235,13,456,2226,336,8596,120
19343,11,385,2781,299,12066,86
37622,3,272,1843,219,7933,53
36378,110,2612,1919,2004,27974,608
20450,9,378,2723,255,8909,123
40663,9,385,1635,201,11004,184
40264,64,2757,1672,1741,30470,1016
36679,95,3248,1903,2556,22965,692
39694,10,302,1709,230,5471,72
28706,147,7733,2303,5574,34654,2159
33138,2,34,2084,32,2391,2
28292,24,533,2327,389,5234,144
36061,0,53,1936,43,2363,10
38805,2,108,1762,89,4275,19
43725,14,244,1007,187,4927,57
36161,17,417,1930,282,3887,135
45100,8,167,697,126,7873,41
19190,6,389,2789,293,13822,96
41710,13,437,1503,241,13049,196
38760,29,429,1765,323,6170,106
26413,26,1279,2427,1109,8605,170
18543,8,293,2816,233,6147,60
36578,4,105,1909,74,3561,31
34200,13,678,2047,417,11186,261
24289,2,101,2523,83,6136,18
36209,0,108,1928,73,3454,35
23192,188,9272,2575,5779,56322,3493
28931,27,1283,2291,791,7256,492
44691,21,627,837,425,9306,202
19830,0,416,2756,242,7631,174
42733,5,164,1303,126,4275,38
38630,2,126,1773,88,5101,38
40990,23,659,1606,489,9844,170
20459,2712,196815,2723,103496,473111,93319
31645,3,197,2153,137,7764,60
39103,7,146,1743,119,4311,27
26138,4,386,2441,291,8049,95
38415,5,306,1789,168,5776,138
44901,29,363,770,296,3804,67
31182,1,181,2178,156,3749,25
20966,3,229,2693,191,3405,38
22898,9,369,2589,301,8816,68
13099,1070,40796,3130,31011,149367,9785
30036,2,212,2236,150,5543,62
3290,309,18542,3636,17232,91728,1310
24244,7,252,2525,218,2375,34
42384,62,985,1377,705,10294,280
32395,7,275,2116,173,5314,102
22592,6,366,2604,275,15174,91
41550,389,11130,1529,5925,87823,5205
37220,3,274,1869,101,3631,173
16410,20,1108,2919,843,6228,265
40065,13,1534,1684,527,11970,1007
21545,4,190,2659,152,2727,38
20227,230,13087,2734,9455,39590,3632
20420,4,307,2724,228,8642,79
40138,2,145,1681,71,4429,74
15351,155,10441,2969,6358,85968,4083
44957,20,234,754,183,4032,51
18134,0,29,2834,20,2929,9
37895,15,270,1824,218,4078,52
41429,34,1570,1545,1241,7621,329
36234,39,1218,1927,923,11031,295
36430,50,1237,1917,903,16032,334
28605,4,608,2308,497,4794,111
42496,23,845,1353,556,12112,289
11848,375,28041,3201,20106,131057,7935
6457,56,128429,3510,2399,33706,126030
29074,16,2163,2284,1354,19766,809
42528,37,782,1346,399,17776,383
12815,28,604,3148,601,25809,3
13878,68,3713,3065,2809,29127,904
36313,25,479,1922,325,8908,154
28775,3,207,2299,153,6453,54
32892,35,831,2095,607,10160,224
34640,1,64,2026,52,5149,12
32133,15,494,2128,382,4540,112
23972,1,65,2537,60,2909,5
13690,12,387,3080,355,10109,32
12933,36,1240,3141,1054,16263,186
43814,90,2676,984,869,26847,1807
37890,34,1377,1825,732,21907,645
24989,162,5626,2491,3601,61751,2025
17510,11,632,2861,469,8266,163
25902,37,3360,2451,2468,56426,892
40205,43,490,1676,385,8255,105
36249,51,1750,1926,1129,11320,621
32487,5,757,2112,488,5473,269
22590,2,34,2604,30,2840,4
26772,85,2695,2411,1989,15101,706
41522,2,202,1533,92,5646,110
12161,208,9981,3184,7552,117544,2429
34946,10,447,2009,390,8846,57
17538,3,220,2859,145,7072,75
38041,22,345,1815,255,9601,90
37609,2,133,1844,116,4268,17
29219,12,515,2277,377,4003,138
39778,7,225,1705,184,7919,41
45179,1,12,667,8,3536,4
11843,31,1123,3201,720,12784,403
25449,74,2631,2472,1797,16352,834
35445,104,1088,1983,819,6650,269
26849,136,6134,2407,4760,35296,1374
42277,15,258,1396,203,3244,55
23845,1,63,2544,58,2739,5
31629,8,398,2154,301,3744,97
37536,136,3040,1849,2351,22530,689
32975,10,294,2092,258,8690,36
3821,685,38356,3625,37665,289123,691
12512,1,89,3164,84,1374,5
28251,58,2476,2329,1456,16501,1020
8158,79,103731,3405,2615,17013,101116
32438,4,156,2114,119,3196,37
11478,487,30103,3218,25045,77658,5058
19047,11,515,2795,388,5698,127
25160,13,432,2484,336,13752,96
8677,294,13492,3370,13079,80073,413
36020,21,396,1940,331,6508,65
42383,68,1794,1377,1383,29799,411
9771,12,561,3307,473,5818,88
25821,21,1594,2454,672,8490,922
21975,1,65,2634,58,2023,7
31069,0,104,2184,82,4652,22
32919,0,125,2093,100,4391,25
28822,10,436,2296,254,3648,182
34518,6,280,2034,195,5084,85
15617,879,138891,2956,62676,425187,76215
39022,2,73,1749,59,1639,14
1369,4,125,3823,102,10573,23
28444,8,217,2318,175,5826,42
39981,35,861,1690,655,9875,206
23942,12,460,2538,385,21599,75
35249,24,728,1993,568,9705,160
32830,120,6713,2097,3829,26188,2884
9364,11,492,3329,410,3961,82
25953,58,4188,2448,2810,17365,1378
39604,10,464,1713,384,6897,80
15747,65,2599,2950,2071,9626,528
18670,7,645,2810,355,5894,290
21385,8,307,2668,210,4521,97
45369,25,210,612,195,4529,15
38214,19,453,1803,346,5491,107
41349,6,143,1557,96,7326,47
12621,70,2809,3159,2565,24545,244
30394,0,21,2216,10,3761,11
24576,8,398,2509,263,5436,135
13210,18,779,3116,723,10075,56
44491,97,1258,879,1084,22904,174
15349,70,2679,2969,1917,32340,762
21081,12,283,2687,215,5362,68
25033,3,471,2490,375,6912,96
22875,3,166,2590,105,3321,61
32826,10,363,2097,306,4060,57
41791,9,329,1487,183,12958,146
2436,201,13785,3650,13187,90306,598
10475,21,976,3273,932,21134,44
24898,0,50,2495,42,2373,8
20337,14,1085,2729,830,6618,255
27626,21,588,2365,457,8050,131
11163,549,23656,3234,22352,83784,1304
41926,8,398,1464,282,8428,116
19811,8,451,2757,376,14274,75
41306,11,325,1563,227,5636,98
23432,5,151,2563,116,7552,35
32452,83,3309,2114,2062,29234,1247
26603,5,652,2419,526,17153,126
13398,424,21582,3102,16197,116075,5385
41948,153,1927,1460,1419,17324,508
46026,23,365,366,166,6132,199
15999,59,1563,2940,1196,13438,367
42266,22,891,1398,764,13559,127
26122,4,154,2441,130,6206,24
37002,10,338,1883,280,11509,58
18012,215,14433,2839,7690,68313,6743
31063,438,15641,2184,9916,77311,5725
42770,82,3201,1294,1462,40584,1739
34951,0,91,2009,69,3394,22
23057,73,1249,2581,875,6824,374
18308,14,803,2826,517,7442,286
29158,2,76,2280,69,2779,7
30770,2,197,2196,134,3827,63
40845,2,92,1617,70,4479,22
13565,77,6606,3088,3792,33094,2814
36547,4,165,1911,135,3874,30
30529,13,723,2208,346,7710,377
33773,6,148,2061,129,8105,19
32695,28,685,2103,489,8530,196
22885,11,1441,2590,1141,13083,300
27066,7,211,2399,152,4137,59
24890,87,1638,2496,1174,10175,464
12935,63,2748,3141,2290,27516,458
18941,15,874,2799,621,7344,253
14368,56,2495,3028,2088,27210,407
36743,41,749,1900,507,30590,242
20471,63,3763,2723,2713,24592,1050
21831,13,419,2644,360,5259,59
20166,362,23979,2738,9333,86816,14646
33595,68,1548,2068,1055,10726,493
41085,73,4364,1595,1533,22232,2831
21511,1,48,2661,32,3330,16
21405,3,323,2667,245,2669,78
37839,53,897,1828,719,8499,178
13703,19,577,3079,474,3946,103
40745,23,311,1628,256,7085,55
26649,4,197,2417,172,5198,25
23210,4,466,2574,364,4466,102
24922,1,28,2494,15,3776,13
30933,80,3016,2190,2158,32889,858
42926,66,1690,1255,1358,14311,332
41754,143,3905,1494,3233,32206,672
31277,21,1906,2173,495,10924,1411
13626,38,4923,3085,3584,38886,1339
16270,6,365,2927,298,4836,67
37611,34,2501,1844,1085,21302,1416
22718,5,235,2598,184,8235,51
13590,19,2945,3087,897,13597,2048
18834,29,1143,2803,868,9478,275
17718,68,3758,2853,1535,16957,2223
39798,41,995,1703,669,11668,326
9761,30,826,3307,824,15269,2
36048,32,1614,1937,880,17572,734
19100,3,65,2793,61,1889,4
19158,19,455,2791,357,9780,98
26831,2,35,2408,29,1471,6
22411,7,416,2613,322,7572,94
39337,1,58,1729,48,3783,10
42354,8,259,1382,186,3792,73
37272,157,1894,1866,1261,16163,633
26724,83,8322,2413,6043,59378,2279
18229,117,5152,2829,3924,19003,1228
9984,39,1037,3296,932,30273,105
11796,3,193,3202,187,11867,6
28657,6,992,2305,641,7661,351
43550,78,1342,1068,1132,24932,210
16202,154,13662,2931,9720,61256,3942
41644,18,372,1513,295,19957,77
37791,4,63,1832,54,4191,9
9937,217,12980,3299,8962,43103,4018
18269,25,1634,2827,1203,12736,431
38632,2,163,1772,128,6536,35
15748,45,2571,2950,1919,24070,652
15385,12,623,2967,465,8245,158
22052,16,435,2631,350,7520,85
25175,6,194,2483,166,5954,28
29073,60,3370,2284,2706,37569,664
35969,1984,50664,1944,35202,271320,15462
16078,74,2542,2936,1999,54665,543
37763,6,753,1834,396,13338,357
12641,337,17808,3158,14428,158262,3380
23735,8,264,2548,177,3936,87
43061,5,165,1216,109,4630,56
36862,1,99,1891,85,5962,14
21856,295,28757,2643,5280,97922,23477
31574,23,646,2157,532,15449,114
32740,14,230,2102,193,2891,37
15964,7,341,2942,223,6790,118
13661,7,50716,3082,545,23862,50171
15899,15,827,2945,478,15337,349
17302,2,81,2871,54,9424,27
31512,3,140,2160,114,3646,26
39953,14,870,1692,226,6929,644
31271,17,619,2173,375,7521,244
14194,1,142,3042,139,5408,3
28915,23,773,2293,612,9127,161
17638,211,41593,2855,12134,108973,29459
31807,0,40,2145,22,3091,18
8758,55,3865,3365,3549,24664,316
24689,3,91,2504,48,5108,43
41591,30,605,1522,445,10465,160
41560,28,1143,1528,807,17654,336
45590,7,133,550,79,2534,54
24831,250,11518,2498,8608,91597,2910
20713,1060,77978,2709,40004,385391,37974
22452,7,334,2611,283,4775,51
15910,30,3349,2945,1971,23325,1378
19441,15,595,2776,432,8716,163
36186,11,534,1929,402,5866,132
17846,8,178,2848,146,3791,32
42732,22,594,1304,457,12699,137
25016,5,149,2490,136,3786,13
38319,7,135,1796,109,3604,26
24102,0,28,2531,25,1720,3
20026,3,79,2745,53,2394,26
34936,2,52,2010,46,3676,6
33496,6,159,2071,124,3540,35
34009,2,30,2053,26,2126,4
39098,234,11183,1744,4535,75979,6648
10430,43,889,3276,867,13602,22
27352,119,2131,2382,1549,12956,582
22028,12,373,2631,246,11450,127
17259,3,358,2873,295,10041,63
40509,121,3394,1648,1968,36484,1426
39143,41,1703,1741,1088,22812,615
14091,4,188,3047,153,3997,35
14764,22,576,3001,559,8737,17
32485,6,218,2112,181,5078,37
28791,2,110,2298,90,6006,20
31821,350,14718,2144,9722,103358,4996
37296,1,17,1864,16,9988,1
16593,75,4879,2912,3648,57320,1231
15629,15,669,2955,537,15608,132
33948,13,676,2055,536,21895,140
33251,3,85,2081,66,5313,19
38774,35,793,1764,535,10016,258
29717,40,909,2251,749,7519,160
38274,4,241,1799,185,3968,56
19383,13,479,2779,392,5857,87
32086,28,898,2130,600,5411,298
43005,19,260,1233,140,4087,120
38221,2,170,1802,114,3437,56
38513,31,679,1782,488,11940,191
25691,21,760,2460,622,6301,138
19391,7,404,2779,304,10486,100
18001,20,508,2839,338,4723,170
31206,4,218,2177,179,2628,39
24968,43,2222,2492,1426,26214,796
45275,326,4154,638,3512,19824,642
33271,2,68,2080,50,2904,18
36305,20,331,1923,248,5003,83
28504,28,747,2315,629,6816,118
44337,3062,61790,899,45026,257347,16764
29508,91,3605,2261,2868,26443,737
21466,8,155,2664,113,2657,42
21474,9,358,2663,284,8505,74
22843,338,18068,2592,10532,116899,7536
37003,47,1603,1883,1049,13999,554
28387,8,290,2322,222,13985,68
23454,28,629,2562,531,6095,98
27099,99,1833,2398,1297,10074,536
27884,4,135,2351,120,7965,15
36729,0,2593,1901,1736,30700,857
41064,79,3521,1598,2135,32023,1386
38151,0,16,1807,15,4839,1
44100,6,139,920,108,4308,31
41160,181,6775,1586,3268,38532,3507
33829,7,262,2059,150,3023,112
21792,0,326,2646,272,5836,54
27369,1,73,2381,54,2308,19
31609,8,221,2155,179,6145,42
11939,27,597,3196,338,6528,259
26579,6,432,2420,352,18001,80
33383,27,734,2076,606,12609,128
42761,4,94,1296,75,6101,19
41928,30,440,1463,294,9736,146
33859,2,39,2058,34,3011,5
19155,12,1015,2791,726,7870,289
41563,35,1480,1528,793,16287,687
24825,1,113,2499,99,3040,14
22300,2,125,2618,82,3223,43
20180,10,464,2737,396,5358,68
29970,5,565,2239,424,10199,141
33830,7,703,2059,142,3465,561
43715,58,1085,1010,691,18811,394
23049,26,798,2582,506,5872,292
22257,0,41325,2620,22708,156790,18617
23367,64,7591,2566,4328,53529,3263
38413,135,4035,1789,3028,22690,1007
39211,118,2978,1737,2373,30518,605
9479,52,858,3322,858,9863,0
1214,2,95,3899,86,4768,9
29131,19,617,2281,453,8127,164
16291,108,7734,2926,5440,125961,2294
27671,52,2373,2363,958,8013,1415
40679,19,309,1634,182,6312,127
37539,0,184,1849,109,3321,75
30568,532,38728,2206,7949,106646,30779
45160,1,38,673,21,3281,17
34921,0,130,2011,80,4979,50
44889,53,492,774,322,7048,170
37509,0,73,1851,66,2397,7
33621,30,592,2067,519,11169,73
43100,341,4186,1204,4082,40493,104
38787,26,526,1763,460,9129,66
18814,5,228,2804,179,10302,49
19861,83,4552,2754,3480,22540,1072
29534,4,377,2260,279,16512,98
32155,58,2077,2126,1662,15142,415
30396,83,9483,2216,6995,82830,2488
35067,7,270,2003,205,8906,65
39242,464,30867,1734,13322,137765,17545
19414,5,410,2777,304,21548,106
22805,12,352,2594,275,3541,77
25065,12,215,2488,176,3852,39
33836,52,1512,2058,1245,23844,267
44806,11,80,798,75,1692,5
15662,25,896,2954,726,15223,170
20147,19,433,2739,321,4267,112
41783,0,87,1489,65,5232,22
45441,55,568,595,468,6436,100
43437,31,335,1105,291,4405,44
42658,132,1835,1320,1299,16202,536
29783,3,126,2248,103,3960,23
18113,51,3938,2834,3097,21299,841
34406,80,2862,2039,2160,38622,702
19315,0,130,2782,106,2887,24
37863,132,3402,1827,2713,26948,689
18688,168,12657,2809,9268,81204,3389
30541,44,879,2208,670,13432,209
10175,0,77,3287,57,4260,20
18793,0,362,2805,283,9837,79
31627,39,901,2154,707,5983,194
34121,5,322,2049,233,5491,89
45625,35,391,534,362,4569,29
21241,6,302,2675,254,7453,48
15610,2,108,2956,80,2225,28
8497,293,6238,3382,5601,31649,637
33352,159,5747,2077,3429,44220,2318
27286,2,76,2386,51,5491,25
22165,0,74,2625,50,5056,24
11902,16,759,3198,708,10411,51
14285,26,2195,3035,952,35751,1243
34850,6,134,2014,112,3070,22
39769,4,71,1705,62,2962,9
44166,66,803,926,640,25945,163
22069,30,587,2629,489,5929,98
45555,14,436,558,351,7101,85
11609,4,289,3212,261,8701,28
32004,11,482,2135,329,6816,153
39623,27,668,1713,511,5873,157
43318,16,481,1142,343,14106,138
21628,175,8181,2654,4062,39119,4119
32844,26,769,2096,624,13354,145
30408,7,223,2215,199,5677,24
9139,628,29409,3343,25080,100765,4329
22053,5,302,2631,259,3772,43
1208,4,91,3899,80,5565,11
28878,15,342,2294,280,5882,62
27563,26,608,2369,425,4709,183
45407,32,275,601,259,4983,16
44481,8,82,880,73,2594,9
29144,33,1887,2281,1162,20888,725
39882,6,139,1697,118,4964,21
4192,682,32506,3613,28409,77824,4097
45948,550,7413,398,6428,55776,985
19258,16,520,2785,411,7529,109
32440,6,194,2114,169,3436,25
28441,5,177,2319,146,4483,31
23472,38,2130,2561,1289,22398,841
39216,3,186,1736,153,7216,33
30817,6,81,2194,76,3574,5
40524,9,412,1648,225,5835,187
27896,20,2445,2350,1883,21758,562
30313,90,2407,2221,1787,16146,620
28012,55,1058,2343,883,10164,175
35740,1,41,1960,34,6084,7
45965,14,101,392,89,3091,12
41392,8,337,1551,246,4522,91
17172,39,1160,2878,907,11677,253
19457,669,62365,2775,31588,236237,30777
44810,106,2378,797,1378,28403,1000
16247,713,42811,2928,16735,76136,26076
21594,85,3620,2656,2393,16007,1227
37497,12,583,1852,418,15803,165
26711,0,27,2414,26,3403,1
34284,12,489,2044,316,3776,173
11913,4,117,3197,110,3313,7
32848,4,261,2096,147,5155,114
19423,59,2915,2777,1982,11086,933
24737,8,473,2501,302,4896,171
40017,20,371,1688,289,10396,82
45516,1,15,574,14,1779,1
14403,1,111,3026,95,4276,16
45930,21,241,407,218,4723,23
39494,0,23,1720,19,7884,4
32940,22,395,2093,329,4172,66
40742,9,142,1629,118,4273,24
24809,11,278,2499,223,4048,55
29790,1073,27744,2248,19341,131804,8403
14800,58,2689,2997,2257,28458,432
23688,11,505,2550,404,11684,101
38666,3,68,1771,58,2479,10
15574,5,217,2958,177,5377,40
42862,12,384,1273,279,8006,105
8814,33,1733,3362,1339,25064,394
33089,389,15224,2086,5824,94577,9400
29964,43,1453,2239,1125,6882,328
27453,8,212,2376,171,9202,41
40543,0,72,1645,60,6420,12
22499,55,2561,2608,2075,40396,486
11495,8526,419725,3217,226145,1162635,193580
44925,36,284,764,258,4917,26
14101,14,608,3047,533,12530,75
32076,15,452,2131,220,5120,232
38216,5,250,1803,89,7783,161
17118,607,42396,2881,25660,229762,16736
45953,15,183,394,142,3496,41
40790,13,215,1624,177,2387,38
41402,16,584,1549,445,10755,139
12427,1,102,3169,98,2688,4
26710,14,413,2414,313,3766,100
38643,18,707,1772,488,7343,219
27913,26,852,2348,711,15287,141
33328,50,936,2078,744,10423,192
26707,19,720,2414,602,9707,118
7013,118,8182,3484,6843,55159,1339
45114,125,1478,689,943,12238,535
19257,0,204,2785,163,6146,41
10188,82,2282,3287,2152,10759,130
40788,8,183,1624,141,3644,42
23216,1,155,2573,112,7092,43
31059,9,321,2184,131,4471,190
38750,10,282,1766,221,5727,61
22423,1,283,2613,162,3671,121
23283,1,45,2571,42,2940,3
28030,0,829,2342,680,8299,149
31230,4,353,2176,289,6339,64
44779,47,575,806,466,14844,109
17358,42,1183,2868,889,12034,294
30274,15,496,2224,426,13708,70
26651,99,2449,2417,1598,21334,851
20179,0,115,2737,105,2558,10
37052,2,287,1879,220,6420,67
14348,21,1298,3030,1057,10532,241
40090,2,107,1683,83,3760,24
38827,0,11,1761,9,1781,2
46012,40,435,372,318,6054,117
14084,21,1244,3047,1053,16542,191
34796,14,183,2018,152,4369,31
15505,5,362,2962,269,9708,93
29628,7,132,2256,101,2458,31
31944,3,183,2138,143,6781,40
40813,0,14,1621,12,1357,2
39831,2,146,1701,109,6980,37
44805,28,317,798,244,4039,73
13201,25,1301,3116,1228,36071,73
16528,21,3126,2914,2304,25484,822
35329,33,2439,1989,1339,22085,1100
36857,8,222,1891,180,3033,42
32054,0,40,2132,22,2760,18
11842,1,71,3201,69,3681,2
35894,381,11454,1949,8400,52487,3054
19762,5,94,2760,82,12028,12
12433,26,1782,3168,1770,30272,12
33956,9,181,2055,134,3118,47
35458,0,183,1982,152,9275,31
22777,33,1657,2595,1213,21040,444
42959,22,413,1247,315,9066,98
43366,11,104,1125,86,2666,18
29092,1,97,2283,83,2568,14
43263,83,1369,1157,861,26535,508
11462,53,1420,3219,1365,12958,55
10416,493,78053,3276,29797,255770,48256
39182,1,138,1739,105,4738,33
32308,44,2296,2120,1076,19943,1220
13879,2104,78324,3064,48093,393089,30231
32414,7,373,2115,310,2255,63
18353,51,2988,2823,2263,34624,725
26544,2,89,2421,76,1796,13
34650,121,2074,2026,1478,16094,596
37896,1,196,1824,103,4587,93
44828,265,3395,790,2662,36500,733
38126,19,381,1809,324,10062,57
22268,132,7049,2619,2556,42696,4493
42426,32,615,1367,479,8601,136
28311,92,8335,2326,6417,22617,1918
25319,241,5826,2477,4198,42008,1628
19403,36,2235,2778,1747,43355,488
25511,160,4955,2469,3694,16825,1261
33056,5,263,2088,203,4102,60
43025,20,195,1229,145,3618,50
23204,54,1501,2574,1170,9848,331
19102,27,708,2793,597,9339,111
37589,26,466,1846,437,12785,29
41931,123,3953,1463,2347,46115,1606
39567,11,651,1716,494,14682,157
35424,2,147,1984,119,6102,28
22848,197,7780,2591,5795,23778,1985
10891,1003,55390,3249,48100,228076,7290
12985,227,5663,3137,4642,28405,1021
39540,6,72,1718,61,3694,11
41327,26,725,1560,529,13995,196
33176,11,559,2083,426,6991,133
40668,152,7813,1635,4174,40915,3639
15716,10,736,2952,585,8403,151
40537,45,1258,1646,1061,28797,197
21632,2,140,2654,97,4419,43
44850,167,2079,783,1913,20485,166
35370,18,1075,1988,729,11242,346
944,8,530,3987,432,12923,98
46013,1,79,370,61,3182,18
32559,18,889,2109,433,9544,456
23488,109,5331,2560,3968,49758,1363
28999,8,232,2288,220,14412,12
33253,6,379,2081,267,8596,112
16311,10,298,2925,226,12359,72
3409,5604,213274,3633,171538,673894,41736
36749,1,139,1899,102,2669,37
34991,15,1046,2007,813,14042,233
42108,20,458,1433,397,12995,61
39093,18,463,1744,386,10394,77
33411,31,1449,2075,1180,11877,269
6557,11,159770,3505,705,15202,159065
23835,0,68,2544,62,2159,6
18457,2,99,2820,46,5090,53
25699,271,16693,2459,11779,57469,4914
2008,663,45370,3657,37697,202152,7673
19757,170,9035,2760,7072,94700,1963
37442,63,1526,1856,1181,9752,345
34030,50,2318,2052,1733,25413,585
20738,3,173,2709,153,2481,20
19048,0,42,2795,40,2191,2
17770,1,106,2851,90,6161,16
45697,7,162,501,100,2890,62
36240,38,829,1927,563,11160,266
31927,39,2175,2139,942,21923,1233
45009,74,1536,739,1135,18214,401
36658,8,386,1904,295,12964,91
29604,0,151,2257,121,3490,30
40777,30,1298,1625,920,21970,378
14683,60,2518,3007,2176,22000,342
40503,74,1773,1649,1461,17947,312
35287,18,491,1991,396,4441,95
24086,15,687,2532,549,16088,138
18937,22,1001,2800,768,9416,233
44688,70,691,838,612,8861,79
35537,24,1613,1976,659,13820,954
33531,2907,77042,2069,52574,278373,24468
44031,7,114,949,59,2638,55
31282,36,601,2173,473,6970,128
34546,54,2264,2032,1725,28983,539
43564,13,164,1064,128,5977,36
42497,24,610,1352,423,7484,187
14678,0,68,3007,65,2601,3
25695,215,14468,2459,5424,65131,9044
17006,151,11981,2889,9563,64552,2418
46337,0,19,248,18,1248,1
41683,102,867,1508,707,14014,160
18592,117,5895,2814,2794,64671,3101
11577,255,26079,3213,15823,118416,10256
22926,12,688,2587,342,5937,346
35383,27,1100,1987,830,15096,270
34425,2,83,2038,70,2052,13
24368,12,425,2520,319,4695,106
14679,0,63,3007,60,2898,3
34393,22,618,2039,510,15279,108
40636,1,35,1638,32,2548,3
24566,4,381,2509,235,5526,146
13092,1098,62481,3130,42298,174753,20183
41539,205,6310,1530,5122,37884,1188
36777,38,707,1897,597,13539,110
23894,0,9,2542,6,2354,3
16484,12,748,2916,575,6417,173
43466,4,123,1097,99,3489,24
40863,86,1222,1616,857,11888,365
15343,85,5717,2969,4620,60397,1097
19296,9,252,2784,194,4893,58
34052,0,62,2051,46,4489,16
45530,87,882,570,802,7154,80
31906,30,1199,2140,719,17346,480
21980,452,22158,2634,17203,148284,4955
40604,4,91,1640,75,2013,16
9280,56,2110,3335,1907,31890,203
27336,1,150,2383,75,5081,75
21964,6,283,2635,201,4051,82
29475,6,1356,2263,682,11872,674
29272,2,53,2274,47,3525,6
12060,97,4452,3190,4238,51192,214
30421,7,392,2215,315,9534,77
19806,19,778,2758,638,13839,140
27395,50,3994,2379,2868,22632,1126
20311,6,116,2730,80,10892,36
16025,19,627,2939,525,7875,102
18845,5,367,2802,281,6469,86
43505,62,1039,1085,862,13065,177
40806,120,3176,1621,2459,39485,717
43181,6,126,1182,96,3815,30
27170,1,46,2393,39,2313,7
9037,187,12416,3350,9982,86619,2434
22210,19,901,2622,417,14598,484
20973,135,12700,2693,5186,62663,7514
32672,38,2051,2104,1226,13625,825
37616,2,176,1844,141,10377,35
20187,0,77,2736,66,3029,11
35666,16,353,1966,289,4624,64
18961,38,1270,2798,751,12324,519
10027,16,843,3294,712,17100,131
44164,408,7400,927,5764,55352,1636
18171,3,148,2832,129,2390,19
34266,25,1243,2045,907,16743,336
24128,49,3239,2530,2693,10788,546
6068,10,459,3525,450,4388,9
34216,29,764,2047,571,5523,193
34699,2,83,2024,71,2851,12
45710,30,483,492,419,9607,64
45460,29,290,589,211,6711,79
18529,158,11746,2817,6055,78732,5691
40601,17,156,1640,136,5310,20
19737,31,1481,2761,1125,26029,356
13014,19,901,3135,839,18508,62
40542,0,4421,1645,3317,31426,1104
17212,76,6961,2876,3771,40270,3190
34172,4,207,2048,147,3245,60
2556,599,30800,3648,26328,151551,4472
25841,57,2492,2453,1526,23193,966
44521,0,20,875,16,1976,4
45754,141,2726,475,2467,36884,259
29102,42,1916,2283,990,12570,926
36441,2,22,1917,18,6687,4
26856,20,2251,2407,1129,21556,1122
41668,274,10375,1510,5594,87411,4781
25889,2,108,2451,88,5032,20
38377,87,2945,1791,2175,24815,770
15465,53,2684,2965,2209,18540,475
23703,30,595,2550,454,8156,141
38070,0,229,1813,177,3859,52
22550,4,41,2605,33,4555,8
17913,25,1685,2845,1239,20163,446
36443,14,260,1916,209,4360,51
16473,0,33,2917,15,1591,18
37558,35,964,1848,711,18373,253
15098,12,536,2982,514,8312,22
30353,4,115,2219,91,4700,24
25506,0,67,2469,61,1881,6
33649,20,276,2066,214,3832,62
32591,9,705,2107,561,9920,144
1032,7,117,3956,99,3496,18
17568,9,288,2858,224,3725,64
40492,33,891,1650,596,6905,295
31463,424,21034,2163,15296,131430,5738
38185,1,77,1806,67,4283,10
24050,28,666,2534,583,7207,83
39874,841,31232,1698,18427,193534,12805
34168,10,389,2048,153,4610,236
45131,25,212,682,172,4094,40
17895,52,1671,2846,1373,13698,298
16120,3233,427071,2933,140565,1214031,286506
35064,6,238,2004,186,9004,52
15306,8,508,2970,450,13135,58
24626,12,307,2506,217,2818,90
14210,27,1054,3042,913,15163,141
28019,113,18598,2343,6210,61217,12388
17627,2,82,2855,62,4908,20
22315,4,182,2618,96,6470,86
36861,3,70,1891,60,2152,10
19894,29,2265,2752,1265,23457,1000
18550,227,10001,2816,7549,112448,2452
40626,5,86,1638,70,1835,16
18614,68,3834,2813,2730,17938,1104
37546,58,1898,1848,1081,20506,817
15247,27,2622,2973,1927,45130,695
44685,267,3277,839,2794,20289,483
37163,9,402,1873,333,8389,69
34590,2,114,2030,84,4183,30
44665,1,32,845,29,1190,3
45923,2,153,413,60,4169,93
34085,22,383,2051,300,4277,83
10876,39,1151,3250,932,18895,219
31318,17,593,2171,391,4528,202
11451,660,54213,3220,21390,180863,32823
23576,27,521,2556,367,4203,154
19558,7,430,2771,328,7172,102
26876,13,533,2406,421,5231,112
40903,225,5049,1613,3696,37584,1353
40647,2,63,1637,44,1594,19
34317,10,150,2043,132,4827,18
45547,24,323,561,225,3570,98
28817,43,1118,2297,871,18574,247
37004,254,17377,1883,7462,73492,9915
40886,35,996,1614,826,10652,170
46041,1,51,356,33,6143,18
32835,5,134,2097,102,3293,32
14393,30,2436,3026,1867,26812,569
17011,55,1931,2889,1562,8380,369
36095,23,861,1934,582,8019,279
29882,34,1665,2243,1290,19224,375
32192,2,164,2125,137,10080,27
24316,26,621,2522,415,22713,206
24479,41,1625,2514,891,13572,734
13635,23,1949,3085,1726,22343,223
14772,91,5064,3000,3839,40470,1225
15444,6,163,2965,131,3121,32
20556,20,650,2718,520,10885,130
28628,66,3375,2307,1609,26960,1766
34695,70,727,2024,582,8644,145
19665,63,2603,2766,2009,12740,594
36663,0,25,1904,21,2826,4
26936,5,129,2403,109,2796,20
40531,3,196,1647,145,6525,51
37108,19,281,1877,248,4958,33
2257,6,240931,3653,568,8655,240363
15570,0,1206,2958,715,11317,491
42348,8,279,1384,211,14893,68
18648,52,2277,2811,1730,25959,547
9093,100,2091,3346,1988,22733,103
45311,72,1253,627,1001,15258,252
37898,4,146,1824,116,3604,30
30526,52,1255,2208,928,10296,327
45790,16,208,462,198,5172,10
45139,28,298,679,186,5718,112
15290,31,520,2971,435,8051,85
32089,10,701,2130,526,9711,175
39162,3,44,1740,39,4946,5
37723,5,235,1837,138,3926,97
22291,43,1177,2618,865,13772,312
16168,20,725,2932,477,8592,248
13586,2,138,3087,138,7555,0
946,20,966,3986,802,6643,164
17945,6,700,2843,534,26708,166
38133,6,372,1808,274,5952,98
22058,20,3011,2630,786,7097,2225
24290,3,234,2523,171,3984,63
40606,4,108,1640,88,1720,20
43632,84,1179,1037,967,24320,212
38247,10,336,1800,251,7319,85
40398,4,233,1659,185,5981,48
38270,128,2288,1799,1315,17057,973
41004,0,284,1605,224,7559,60
37177,329,14033,1872,8843,90864,5190
29126,762,28709,2281,13199,127863,15510
17439,74,1660,2864,1293,9378,367
25658,32,804,2461,597,6537,207
30234,15,1070,2226,853,19774,217
33225,1,25,2082,21,4699,4
21390,4,141,2668,102,5487,39
14921,72,5320,2991,2221,30335,3099
29331,8,1234,2270,616,13434,618
25579,98,3070,2465,2500,43773,570
12199,20,1434,3183,670,4909,764
45907,3,118,422,71,3699,47
40611,11,227,1639,190,2406,37
30619,14,411,2204,287,8359,124
40167,1,29,1679,28,6054,1
19497,7,508,2773,395,7383,113
32572,2147,106351,2108,62585,504212,43766
39688,6,269,1709,137,5414,132
44822,37,513,793,285,6849,228
27730,346,14246,2359,10544,104559,3702
6320,158,13194,3516,10458,127066,2736
27870,13,257,2352,211,3850,46
35239,4,256,1993,142,6619,114
9757,9,82812,3308,987,13532,81825
45187,0,40,665,29,2000,11
15888,15,560,2945,398,8322,162
9745,32,2016,3308,1913,17468,103
45732,3,60,481,38,1669,22
43449,154,3073,1102,2445,33863,628
25690,30,1399,2460,1134,18650,265
41300,20,1455,1563,949,25616,506
37049,0,141,1880,114,5276,27
34254,34,695,2045,540,7933,155
30003,12,357,2238,204,5092,153
24056,3,190,2534,148,2891,42
18064,27,2021,2836,1274,13460,747
35161,3,69,1998,67,3469,2
17843,206,7714,2848,5177,27683,2537
35700,0,16,1963,15,3124,1
20651,14,445,2713,341,17192,104
25752,31,640,2457,510,7392,130
15537,35,1391,2961,1015,17143,376
15191,85,7014,2976,3279,45728,3735
39899,7,138,1696,115,6343,23
41396,41,1050,1551,789,28689,261
37788,2,27,1833,25,4274,2
34177,9,487,2048,303,7085,184
16887,15,1189,2895,934,10415,255
43786,88,2007,988,1333,21020,674
22042,93,1774,2631,1508,8820,266
43461,8,105,964,70,1732,35
44775,21,205,807,187,5759,18
40954,2,99,1609,81,4319,18
13797,15,566,3072,556,4439,10
41246,154,3988,1573,2706,53281,1282
38657,60,703,1771,566,6197,137
41714,1,90,1503,60,2934,30
36805,4,106,1895,94,5259,12
36063,13,324,1936,262,11697,62
37733,0,127,1837,101,7038,26
14616,48,2607,3011,1561,9913,1046
26643,461,11895,2417,7500,53491,4395
24419,1,188,2517,143,9883,45
41108,103,1168,1592,1067,10280,101
22869,318,7940,2590,5001,57721,2939
38904,28,431,1756,396,5572,35
30002,43,2570,2238,1981,27389,589
1220,4,75,3899,70,4874,5
31131,24,1037,2181,604,13402,433
20537,4,100,2719,81,2639,19
16866,32,1659,2896,1260,5997,399
17487,29,1736,2862,1366,55854,370
30439,36,1432,2214,841,16415,591
21688,21,498,2651,408,3524,90
8804,105,5357,3362,5230,50632,127
23760,32,2483,2548,1995,21125,488
35634,2,150,1969,112,3681,38
32625,3,132,2106,103,2971,29
19264,49,3523,2785,1756,29316,1767
30753,0,138,2197,112,6179,26
14378,27,2787,3027,2269,29055,518
38228,7,687,1802,503,15131,184
28743,11,744,2301,616,41945,128
30099,21,1439,2233,889,11965,550
38122,6,284,1809,172,7345,112
28265,3,83,2329,70,4189,13
37819,77,4016,1830,1556,26539,2460
43182,107,1983,1182,1495,15651,488
29606,37,1278,2257,1060,17208,218
39486,42,1203,1721,901,18137,302
22284,332,7760,2619,6197,37340,1563
36660,26,870,1904,596,4880,274
45806,20,280,457,265,4147,15
30998,4,199,2187,154,8022,45
38033,61,514,1816,427,4948,87
14032,98,4209,3052,3502,16743,707
29390,2,114,2267,95,3099,19
23272,32,1059,2571,676,10612,383
24594,4,100,2508,73,2529,27
42952,14,244,1248,167,13795,77
37076,7,146,1878,124,7442,22
24833,80,2453,2498,1968,12985,485
34182,109,4148,2048,3269,20027,879
36838,2,105,1892,93,3853,12
36864,14,516,1891,421,21516,95
21463,28,1191,2664,945,10729,246
37662,22,781,1842,540,12257,241
41111,30,541,1591,407,10673,134
22239,83,1628,2621,1156,18310,472
41449,109,2987,1542,1532,26872,1455
15253,8,356,2973,271,5712,85
22414,233,5482,2613,3430,32501,2052
25666,10,384,2460,312,6205,72
39954,1,53,1692,46,2839,7
24923,5,208,2494,176,10595,32
30219,13,692,2227,494,13640,198
17686,3,107,2854,92,3457,15
6643,41,1675,3502,1655,18343,20
14344,435,26662,3030,19184,63987,7478
18104,3,265,2835,217,3638,48
13101,93,4790,3129,3537,24818,1253
34806,12,408,2017,320,6106,88
25025,22,1982,2490,1289,10706,693
31546,14,220,2158,174,4100,46
12277,6,580,3178,293,5527,287
17402,33,1945,2866,1489,12071,456
27760,7,161,2358,119,3953,42
12994,251,28250,3136,22973,154293,5277
29161,73,2849,2280,2028,18051,821
22772,22,789,2595,621,3396,168
18241,4,463,2828,248,9106,215
35127,65,914,2000,644,6851,270
35055,8,229,2004,202,5065,27
15256,4041,440454,2973,157067,1504943,283387
2686,52,3801,3646,3522,44850,279
41019,227,6010,1604,4442,52067,1568
23393,43,3258,2565,2603,30075,655
7524,13,985,3455,899,36868,86
45370,12,65,612,60,3188,5
4039,22,1914,3618,1509,26694,405
20986,1,90,2692,80,4794,10
36961,4,75,1885,59,6847,16
25991,8,196,2446,163,4407,33
29675,21,618,2253,465,6249,153
11208,678,36421,3232,22218,159074,14203
30535,1,195,2208,165,5702,30
19509,367,18359,2773,11939,73100,6420
26409,20,453,2427,357,4279,96
41079,2,115,1595,85,5528,30
23475,9,1066,2561,810,12867,256
32627,666,34709,2106,22298,190223,12411
13308,26,515,3109,501,10595,14
29085,3,70,2283,59,1560,11
15922,13,435,2944,327,3731,108
35354,4,82,1988,69,2057,13
40114,46,1326,1682,969,24391,357
27932,101,5625,2347,3518,52686,2107
12533,1,56,3164,52,1336,4
39326,1,60,1729,43,2198,17
38713,13,458,1768,352,6024,106
42970,9,212,1244,150,9473,62
19183,4,648,2790,517,16532,131
46015,3,53,369,37,2820,16
25607,3,371,2463,314,7790,57
11994,64,3365,3193,3205,20797,160
43685,64,531,1019,469,16977,62
1227,1,72,3897,61,3528,11
13764,2,134,3073,130,2586,4
30576,15,541,2206,421,11664,120
19571,7,572,2770,434,7269,138
45431,9,110,596,83,6513,27
25845,33,1025,2453,563,9719,462
11895,46,3686,3198,1260,14727,2426
36651,4,187,1904,149,7322,38
28129,7,360,2337,252,10125,108
43321,15,344,1141,216,6297,128
38626,10,393,1773,321,11351,72
39543,25,401,1718,330,11087,71
44060,18,252,944,175,4225,77
45947,13,235,398,194,4442,41
45945,3,45,398,32,1209,13
37508,8,279,1851,233,7565,46
26312,31,1787,2432,1347,24313,440
39115,95,2165,1743,1653,18446,512
31860,11,357,2142,272,5940,85
36279,9,239,1924,181,8866,58
35152,2,253,1998,215,6809,38
38593,17,319,1776,242,16393,77
8738,10,636,3367,524,7914,112
21207,34,1780,2677,977,11481,803
16297,37,3802,2926,1754,18430,2048
36566,112,2331,1910,1772,18329,559
39593,19,517,1714,412,9181,105
43374,13,216,1121,176,6570,40
39121,19,241,1742,208,4589,33
16578,4,338,2912,260,10936,78
38066,35,698,1813,525,11322,173
40547,2,38,1645,29,2704,9
30318,68,7683,2221,1892,10985,5791
42152,15,538,1422,403,9941,135
20767,31,701,2706,554,7670,147
45036,6,164,728,94,5110,70
21603,60,2142,2656,1611,14787,531
26060,41,3539,2443,1702,36436,1837
24960,0,2168,2492,86,3736,2082
25480,27,889,2470,773,13480,116
40910,14,550,1612,450,13094,100
44351,94,1987,897,1727,20308,260
31164,14,302,2179,243,5389,59
42116,189,3480,1432,2119,27892,1361
45529,32,327,571,252,6841,75
32338,6,720,2118,404,4915,316
33037,426,29333,2089,10973,142351,18360
12003,55,2108,3193,1305,15007,803
30027,17,1035,2237,790,15398,245
43104,257,2812,1204,2707,19849,105
10980,178,13063,3245,7413,47639,5650
40634,3,205,1638,137,5975,68
45425,3,50,598,49,3587,1
42762,38,598,1296,353,5395,245
13011,37,2972,3136,2566,46936,406
29642,218,16130,2255,10633,89907,5497
20393,69,1354,2726,1122,8012,232
26887,0,227,2405,177,9718,50
24606,529,14617,2507,9469,63366,5148
30862,32,2380,2192,839,13764,1541
12366,2,162,3173,151,2374,11
21799,24,892,2645,731,16087,161
7787,5,502,3438,467,4736,35
38251,226,3323,1800,2579,22342,744
43557,4,49,1066,33,2543,16
36260,64,2645,1925,789,16891,1856
36250,77,2027,1926,1322,20499,705
40671,5,178,1635,112,4503,66
19841,20,1155,2755,651,14744,504
44437,125,1658,886,1290,19833,368
29379,1,62,2268,40,4556,22
35785,86,1373,1956,1130,17388,243
7454,30,2067,3459,2006,30006,61
31374,0,0,2168,0,3905,0
13221,48,722,3115,671,41652,51
23328,11,460,2568,398,8785,62
14291,65,7100,3035,3945,42399,3155
45215,4,28,657,20,2155,8
31373,17,885,2168,480,12797,405
32790,30,851,2099,691,8178,160
18257,163,9264,2828,6492,72425,2772
19877,4,686,2754,400,14604,286
29224,8,270,2277,212,6708,58
41614,17,621,1519,456,12921,165
43780,5,115,990,104,5695,11
34232,556,31032,2047,18876,187816,12156
40266,43,1735,1671,1342,20855,393
45134,7,60,680,55,2169,5
22565,33,1035,2605,888,14909,147
37641,7,292,1843,251,6854,41
18778,6,431,2805,337,20062,94
22976,0,3339,2584,2484,24157,855
31013,5,312,2187,134,4791,178
21250,11,328,2675,273,10866,55
45896,75,605,426,521,9754,84
28712,111,2088,2303,1120,13992,968
10080,496,23434,3291,21537,116332,1897
19246,142,8934,2786,6871,74483,2063
12209,73,4008,3182,3408,56357,600
18174,13,122,2832,102,4120,20
12995,12,503,3136,438,9731,65
26301,25,1636,2432,1281,14923,355
16513,8135,886189,2915,208184,2728970,678005
16684,1,18,2906,15,1838,3
32738,89,3802,2102,2854,25517,948
43286,22,442,1150,320,5790,122
46152,0,13,314,12,700,1
35795,1,162,1956,139,4835,23
23904,22,1320,2541,561,5822,759
34307,20,954,2043,746,11775,208
32432,64,1422,2114,1022,17586,400
22100,20,320,2627,255,3921,65
36724,22,571,1901,478,14788,93
20464,13,698,2723,367,9828,331
45991,3,57,382,51,2437,6
32169,22,538,2126,450,13350,88
40168,5,116,1679,86,2226,30
42366,12,615,1380,403,12041,212
37219,13,535,1869,291,12935,244
42609,9,189,1330,132,4268,57
12722,366,23897,3153,20736,162156,3161
12182,69,4000,3183,3595,72591,405
36846,19,424,1891,336,11696,88
16387,223,23200,2920,7223,63936,15977
37183,36,1172,1872,734,7783,438
40887,2,336,1614,240,7242,96
46090,71,917,340,645,20853,272
15285,18,616,2972,503,5183,113
45544,0,35,564,35,2304,0
40440,0,25,1655,19,2296,6
10540,46,1578,3270,1568,14171,10
30704,6,145,2199,121,2305,24
30246,3,92,2225,61,4932,31
23657,30,727,2552,555,5143,172
20396,14,597,2726,501,19901,96
16916,5,215,2894,167,4703,48
13847,54,1859,3068,1854,39464,5
18768,38,2634,2806,2238,12512,396
20921,5,187,2695,165,2654,22
39078,11,646,1745,409,12040,237
34415,55,1637,2038,1053,8064,584
39427,5,81,1724,65,6632,16
26867,3,75,2406,65,1818,10
16842,6,149,2897,122,2998,27
43332,4,57,1138,42,2224,15
18515,2,142,2817,119,2770,23
25931,5,575,2449,463,13533,112
18355,39,1124,2823,907,9356,217
42714,43,590,1309,428,8574,162
22745,24,509,2597,334,5006,175
40894,0,33,1613,27,4866,6
12821,7,406,3148,392,7968,14
30405,32,1343,2216,1047,14985,296
43659,21,325,1028,279,8560,46
31827,57,3712,2143,2100,23876,1612
21875,8,532,2641,461,16136,71
14474,48,3674,3021,2951,24201,723
42558,1,115,1341,84,7758,31
23807,51,1144,2546,865,10371,279
27130,131,6148,2395,4716,61450,1432
21916,6,458,2639,357,10578,101
21435,6,568,2666,421,17144,147
27430,6,216,2378,170,5886,46
10407,54,2017,3277,1666,21339,351
12538,1,59,3164,49,1265,10
44174,5,121,924,101,3421,20
23306,34,2173,2569,1499,28620,674
35650,115,4422,1967,3403,30291,1019
39733,142,4005,1707,2689,25548,1316
25123,54,1560,2485,1205,8261,355
41087,40,378,1595,298,4219,80
35150,4,165,1999,144,5364,21
15406,27,1109,2967,865,10410,244
31416,16,457,2166,368,13308,89
36403,0,31,1918,28,4087,3
14710,1,49,3005,46,6576,3
32800,29,576,2099,476,3278,100
46329,16,137,252,133,4165,4
21214,4,148,2677,92,2804,56
31218,246,5104,2177,3115,48072,1989
37316,0,95,1863,73,3010,22
40490,19,426,1650,357,12793,69
26296,5,347,2433,183,3498,164
33122,4,161,2085,142,5999,19
37321,18,528,1863,421,5979,107
15119,5,142,2980,123,2287,19
45695,8,171,501,113,3683,58
29719,50,724,2251,573,10254,151
36062,31,1003,1936,751,66950,252
35246,242,7807,1993,5674,85885,2133
31966,3,246,2137,220,6325,26
26432,252,10461,2426,8063,83345,2398
40331,57,2299,1667,1671,24273,628
10868,2,82,3251,71,2071,11
32959,4,79,2092,52,2812,27
27722,11,887,2360,320,4951,567
40925,3,163,1611,128,5157,35
26641,20,629,2417,503,5902,126
21102,100,2471,2685,1768,13786,703
22474,458,37292,2610,19370,150888,17922
19913,100,7780,2752,5375,35821,2405
32897,7,252,2094,181,18883,71
33591,6,182,2068,149,4918,33
45688,152,4629,505,1928,24917,2701
21094,25,801,2686,645,5417,156
24807,185,8208,2500,5638,71066,2570
35372,24,270,1988,229,3683,41
27180,0,26,2393,21,4440,5
6330,22,2339,3515,2072,8983,267
30174,13,135,2229,111,4278,24
17043,7,725,2886,514,10095,211
32018,1,151,2134,96,5914,55
40915,8,129,1612,100,6479,29
42519,16,331,1347,246,3333,85
24983,1,101,2491,79,3347,22
13595,26,1784,3087,1664,54655,120
27743,4,198,2359,156,3641,42
25686,1,134,2460,106,7293,28
29700,11,275,2252,236,5460,39
35232,23,542,1994,338,8073,204
16264,62,2730,2927,1937,26012,793
17015,98,8533,2888,4596,58157,3937
44322,13,120,902,109,3633,11
44653,7,161,850,145,4058,16
20677,17,2638,2712,651,13402,1987
28431,1,184,2319,145,14964,39
24272,0,259,2524,213,26228,46
43633,9,129,1038,105,6553,24
43302,22,487,1146,333,5225,154
28704,106,1629,2303,963,12128,666
32454,7,408,2114,321,4608,87
20247,2,48,2732,41,1863,7
12607,0,128,3160,125,6816,3
41745,29,664,1496,374,6657,290
29422,98,1609,2266,1178,11955,431
28337,20,915,2324,709,11072,206
44657,83,915,847,696,16080,219
42140,89,1974,1425,1300,22499,674
26949,7,551,2403,433,9088,118
42833,5,574,1278,290,8904,284
40486,35,809,1651,632,9573,177
19918,4,236,2751,165,14617,71
40330,256,7851,1667,5388,64922,2463
17091,13,667,2883,421,11293,246
34776,4,221,2020,186,5341,35
26146,6,482,2440,318,4869,164
45113,11,105,690,92,4583,13
37445,59,2164,1856,1550,24351,614
43207,16,255,1176,197,4938,58
9456,50,1879,3323,1733,15556,146
31979,32,1530,2136,1105,11333,425
31386,1,86,2168,68,3493,18
34273,0,37,2045,33,7927,4
26485,236,8311,2424,6299,58804,2012
15208,7,383,2975,366,5173,17
39398,6,239,1725,175,5602,64
19349,20,1143,2781,714,7597,429
35049,16,605,2004,492,10149,113
38269,30,813,1799,582,9433,231
43552,64,1481,1068,686,23756,795
45569,53,1597,553,470,8500,1127
26046,9,287,2444,215,4193,72
15604,14,659,2956,479,5757,180
36290,21,615,1923,475,13322,140
19706,8,287,2764,148,15554,139
43006,6,305,1232,197,4924,108
29945,1,65,2240,49,2825,16
12085,10,446,3189,442,3280,4
29034,5,261,2286,192,4489,69
17394,10,631,2866,474,15216,157
30683,1,221,2200,160,3865,61
21411,8,379,2667,312,9770,67
26758,21,539,2412,430,12313,109
16664,14,553,2908,449,8117,104
30229,52,1434,2226,1062,19723,372
8494,31,2437,3382,2288,14863,149
22748,10,413,2597,278,7485,135
22615,0,65,2603,54,4212,11
25157,0,43,2484,28,3640,15
33277,2,81,2080,58,2864,23
41810,1,42,1482,36,4427,6
5824,76,2808,3536,2684,15308,124
14538,2,53,3017,46,2892,7
38422,10,340,1788,221,8837,119
42599,37,843,1334,559,16579,284
14634,36,1601,3010,1438,16862,163
34074,0,77,2051,53,2927,24
27823,10,324,2353,266,7833,58
21473,38,1189,2663,669,20378,520
36885,27,325,1890,265,3198,60
38336,633,22845,1794,17377,114638,5468
26373,30,600,2429,482,5439,118
35674,22,677,1965,533,10078,144
19482,27,1223,2774,794,16330,429
28551,5,88,2311,76,3025,12
8778,19,752,3364,666,11848,86
44678,1099,62248,841,11915,162910,50333
33465,10,584,2072,442,8391,142
35116,9,234,2001,183,5019,51
30528,15,908,2208,532,5994,376
29926,33,2651,2241,1906,10840,745
46196,2,43,295,36,1883,7
45067,18,190,715,188,4280,2
41531,20,207,1532,177,4395,30
43217,16,457,1172,274,14277,183
39177,18,253,1739,218,5506,35
42988,13,90,1239,76,4485,14
15761,2,107,2950,74,2970,33
30496,1,139,2210,117,3724,22
38588,39,1370,1776,1162,14913,208
36702,1,82,1902,60,4124,22
28340,57,8054,2324,5976,29454,2078
33114,153,7626,2085,3058,62958,4568
25782,64,4449,2456,3339,20572,1110
22504,66,7403,2608,3759,36013,3644
41654,3,114,1512,94,3786,20
18464,40,1069,2819,824,16603,245
38204,1477,102889,1804,32389,300913,70500
27029,748,17694,2401,13032,68353,4662
42273,51,1643,1397,1068,15736,575
39237,13,451,1735,372,9213,79
41962,24,586,1457,333,9536,253
43546,64,918,1071,802,17741,116
14275,31,1008,3037,891,7340,117
25741,6,510,2457,410,4222,100
1957,6,579133,3659,906,14226,578227
17214,43,1923,2876,1174,15728,749
11458,671,28083,3220,22938,114612,5145
41135,10,111,1589,92,4695,19
23003,57,3374,2584,2484,25333,890
32762,1,20,2101,19,2185,1
22109,165,9013,2627,6764,65215,2249
31108,25,495,2182,404,3651,91
43473,129,2801,1096,1887,37408,914
30085,18,340,2234,287,5995,53
28355,17,2201,2324,1674,25886,527
14413,32,3884,3025,3184,70332,700
18987,31,2006,2798,1049,16060,957
14830,392,20772,2996,14775,133241,5997
30749,15,687,2197,581,16842,106
16235,107,6944,2929,5540,63007,1404
36513,23,560,1912,474,7894,86
40837,49,1576,1618,798,17902,778
29198,87,2323,2278,2051,14339,272
44970,16,114,750,85,2253,29
25642,213,20960,2462,4939,68788,16021
30376,1,105,2217,77,4396,28
28758,90,2432,2299,1757,12039,675
40191,6,170,1677,130,2063,40
31122,4,98,2181,93,4696,5
18456,8,199,2820,151,3065,48
6977,463,21894,3486,13294,149698,8600
15233,6,225,2974,205,7888,20
31778,0,78,2146,45,3551,33
36113,15,677,1933,517,8643,160
11691,20,1901,3207,1653,27306,248
29800,7,324,2248,272,16148,52
31589,13,1433,2156,1111,16602,322
20765,8,393,2707,302,13001,91
24067,20,654,2533,530,8475,124
36232,21,551,1927,436,2912,115
19794,12,217,2758,109,8558,108
28202,17,1029,2332,659,6691,370
36411,170,3116,1918,2339,14831,777
26201,241,16411,2437,7060,83367,9351
29156,3,107,2280,85,6497,22
21808,8,370,2645,298,8019,72
39375,36,1414,1727,564,11994,850
25425,98,4818,2473,3546,67088,1272
31712,2,154,2149,134,6182,20
15151,10,842,2978,363,16814,479
42276,2,102,1396,75,3697,27
18463,144,13059,2819,7299,72550,5760
44793,23,316,802,252,3362,64
26734,6,146,2413,124,2023,22
10073,97,6242,3292,4979,51650,1263
14251,18,833,3038,790,11775,43
28680,13,316,2304,196,3949,120
42032,1,23,1447,23,5434,0
14065,642,42544,3049,23104,229366,19440
24691,3,89,2503,69,3587,20
15863,8,1258,2946,991,18308,267
1022,5,77,3960,66,2901,11
43361,6,121,1118,101,6647,20
37332,38,1962,1863,1540,22547,422
46087,7,134,340,115,2381,19
28694,11,253,2303,206,15846,47
10254,120,3648,3284,3320,19539,328
34467,1,16,2037,16,2550,0
44968,9,104,751,82,3064,22
32677,71,3208,2104,715,18206,2493
35779,104,5459,1957,2837,40237,2622
39320,3,70,1729,36,3526,34
20913,45,697,2696,524,11148,173
18219,26,1803,2830,1030,16081,773
22719,39,1976,2598,1237,33870,739
23987,4,139,2536,103,1901,36
39021,9,248,1749,191,8098,57
25583,0,98,2465,86,3434,12
40882,447,6316,1614,4377,50343,1939
18495,11,436,2818,358,14381,78
29955,12,858,2240,454,10994,404
15945,0,80,2943,71,2733,9
38293,3,73,1797,60,3702,13
29787,20,1224,2248,865,13168,359
26314,10,5424,2432,1820,15023,3604
27952,113,1693,2346,1345,17011,348
27988,158,15458,2344,9343,91280,6115
22271,31,5371,2619,2860,38590,2511
26586,10,150,2419,114,3020,36
41035,18,531,1603,399,14980,132
23842,1,34,2544,23,3795,11
15827,0,221,2947,187,5044,34
35873,1,18,1950,17,6315,1
2072,510,42983,3656,39672,143465,3311
36624,32,567,1905,434,9462,133
43411,20,292,1111,270,5747,22
7663,185,7488,3446,7072,43072,416
18777,151,8111,2805,5782,26450,2329
42107,3,56,1433,52,7305,4
21568,0,37116,2658,23759,169028,13357
27689,27,629,2362,484,10196,145
38670,16,488,1771,373,11690,115
39418,93,1247,1724,878,11837,369
14677,5,213,3007,176,2637,37
30597,1,195,2205,163,5573,32
38191,11,196,1805,147,8057,49
29853,118,3112,2245,2326,45961,786
37125,182,5015,1875,3722,33889,1293
27612,61,1604,2366,1307,15221,297
34174,1,60,2048,49,2423,11
32370,13,344,2117,274,8611,70
40012,1,100,1688,49,8015,51
33130,1,150,2085,51,2714,99
30887,36,862,2192,710,19436,152
46430,3,33,199,31,2072,2
21631,33,593,2654,461,6961,132
34356,0,81,2041,57,3540,24
41922,108,2753,1464,1973,32464,780
22456,120,5278,2611,3816,53180,1462
45839,40,256,447,217,4090,39
42030,2,122,1448,81,5239,41
40000,22,470,1689,296,5925,174
43072,367,6179,1212,4878,46264,1301
43349,22,352,1132,255,5551,97
38715,20,492,1768,366,5748,126
16046,32,1004,2937,792,14326,212
17298,24,588,2871,487,19343,101
15681,36,1248,2953,931,13579,317
26264,2,451,2434,317,4828,134
28982,49,1528,2289,903,14804,625
27032,18,522,2401,415,16887,107
13724,19,462,3077,442,5140,20
6957,56,297253,3487,2930,27903,294323
37543,79,2737,1849,1905,27582,832
26219,700,28987,2436,11147,130706,17840
40659,177,5410,1636,4058,52929,1352
16782,3,187,2900,157,6544,30
20159,155,9152,2738,7031,47961,2121
34861,2,79,2014,63,7240,16
25144,0,183,2484,156,3972,27
29257,17,422,2275,324,7759,98
40699,252,5959,1632,4682,45354,1277
16613,38,4683,2911,1581,32982,3102
21307,53,1845,2673,1352,18930,493
14950,33,1603,2990,1281,15662,322
19220,461,21129,2788,15575,140126,5554
30386,81,1672,2217,1327,16551,345
41949,362,13936,1460,7682,81005,6254
26047,177,6358,2444,4754,37247,1604
19105,10,748,2793,383,14279,365
38891,103,2731,1757,1883,27180,848
29709,14,458,2252,310,5593,148
26319,41,752,2432,587,8361,165
20076,31,1017,2743,770,18806,247
46176,23,327,301,298,6802,29
23874,11,376,2542,275,8209,101
14442,1252,109732,3023,47678,312326,62054
22816,38,1536,2593,1126,23698,410
43789,5,76,986,54,3013,22
33729,2,147,2063,126,5946,21
12864,14,849,3145,658,11034,191
40923,109,2985,1611,1559,31631,1426
24027,1,226,2534,177,4376,49
40401,37,1870,1659,1335,12368,535
33116,11,811,2085,631,8281,180
43861,18,272,977,205,5951,67
9460,114,3134,3323,2693,15632,441
38521,1,106,1781,87,4269,19
29349,19,1497,2269,1185,17312,312
39092,6,199,1744,167,4640,32
16909,36,3393,2894,2633,28049,760
43743,26,483,1003,407,18694,76
45105,50,487,694,450,6623,37
16197,6,166,2931,136,3801,30
17300,304,9156,2871,7043,46390,2113
23453,28,1178,2562,964,12938,214
35561,1,58,1975,51,4054,7
32217,43,2512,2123,1297,22904,1215
38358,5,112,1792,85,3466,27
8353,130,7697,3391,5479,35764,2218
39259,2,59,1733,41,2542,18
35158,110,5541,1998,4267,76309,1274
37732,7,438,1837,300,15488,138
17701,43,6578,2853,4941,49222,1637
19638,3,79,2767,69,1954,10
42211,38,663,1410,417,7599,246
42058,5,469,1442,280,16428,189
35603,79,3240,1971,2610,21601,630
23153,787,239696,2577,20032,325320,219664
29840,19,546,2246,470,5572,76
5943,29,733,3530,710,22092,23
10662,279,15399,3262,12677,87786,2722
20246,0,95,2732,79,4338,16
31477,56,4513,2162,2516,49019,1997
34656,7,342,2026,293,7016,49
32610,6,165,2106,139,5038,26
36970,6,212,1885,176,5110,36
36535,57,918,1911,746,8113,172
14612,373,19357,3011,16135,150381,3222
21381,27,702,2669,559,14146,143
18750,47,2181,2807,1708,15565,473
39962,38,651,1691,510,6923,141
8810,17,421,3362,354,16740,67
42529,92,1758,1346,1343,37752,415
17927,35,1974,2844,1447,21048,527
19587,1,50,2769,47,5516,3
37781,4,362,1833,270,17248,92
39863,12,431,1699,317,6945,114
43204,188,5799,1177,3403,17691,2396
15250,58,1022,2973,967,13479,55
45622,48,605,534,512,10671,93
20562,3,54,2717,50,3103,4
37567,5,504,1847,435,11784,69
25956,3,350,2448,302,9614,48
25332,337,14875,2476,10852,84788,4023
43536,44,674,1074,460,19703,214
26812,48,2614,2409,1930,24149,684
31949,1,139,2138,114,5854,25
31061,1,131,2184,100,3392,31
14373,16,661,3028,611,12525,50
34194,13,250,2048,176,4419,74
46286,23,305,271,287,6234,18
23935,28,2419,2539,1452,17592,967
25749,7,134,2457,114,1911,20
28084,2,128,2339,111,7529,17
11260,203,7467,3229,6406,45041,1061
16653,150,9821,2908,7013,58515,2808
22489,22,1675,2609,1454,16598,221
41724,142,3788,1501,2890,29219,898
13577,9,838,3088,456,12014,382
44800,5,65,800,53,2763,12
37222,49,1142,1869,967,5382,175
21595,32,2947,2656,2228,55988,719
35466,88,2092,1981,1161,19680,931
33339,74,3185,2077,1840,39540,1345
1259,3,44,3883,39,2747,5
37353,7,131,1862,105,5129,26
23893,5,164,2542,147,8411,17
39190,15,621,1738,319,4355,302
9678,24,977,3311,934,15703,43
23832,2,163,2544,131,4014,32
45900,13,232,425,172,7207,60
16224,0,141,2929,115,3395,26
11777,15,418,3202,383,4635,35
43592,4,29,1053,24,6142,5
44633,17,181,854,166,2333,15
35083,15,771,2003,588,8240,183
42487,21,1476,1354,894,18745,582
28702,640,14547,2303,6603,59814,7944
45143,19,180,678,135,5014,45
32292,14,409,2121,312,13759,97
34405,102,4300,2039,2939,28975,1361
29911,81,4754,2241,3256,37568,1498
33471,1,84,2072,74,3607,10
29691,4,68,2253,64,4539,4
21294,0,244,2673,185,6931,59
37571,0,119,1847,102,4404,17
15468,33,956,2964,709,12221,247
11885,98,5202,3199,4676,55321,526
42682,30,428,1314,362,3968,66
35551,3309,144628,1975,64135,531447,80493
27701,37,939,2361,716,9841,223
25427,0,798,2473,607,11144,191
8897,385,24686,3358,22121,144658,2565
36417,8,475,1917,339,6708,136
22463,17,382,2610,337,3376,45
29178,15,337,2279,272,4872,65
35504,7,287,1979,167,7376,120
32332,2,174,2118,113,2597,61
13531,55,3726,3091,2876,16502,850
19462,2,390,2775,149,5466,241
31006,12,496,2187,406,7676,90
25090,3,123,2487,97,2476,26
41264,20,434,1570,353,12569,81
16048,10,381,2937,289,6351,92
45260,21,180,644,110,3250,70
22802,17,775,2594,312,5778,463
44911,4,45,769,41,1892,4
32311,8,120,2119,114,2215,6
17041,6,146,2886,118,5692,28
20619,8,981,2715,618,12873,363
8398,45,1441,3388,1406,15497,35
23817,10,230,2545,189,6819,41
19173,3,168,2790,132,3506,36
14197,22,691,3042,638,9163,53
14827,11,280,2996,216,19259,64
19969,43,3872,2748,3108,34189,764
37937,4,105,1821,71,3723,34
26330,1,55,2431,52,2610,3
42830,54,1790,1278,1057,18071,733
17440,44,1890,2864,1547,11899,343
42425,7,393,1367,292,9985,101
38744,19,717,1766,463,9553,254
43502,9,110,1085,98,2638,12
20896,232,20098,2697,14789,127821,5309
32090,6,872,2130,586,11743,286
31014,6,255,2187,125,8353,130
40805,281,9394,1622,6156,84329,3238
45751,12,69,475,67,3645,2
29025,5,349,2287,304,13882,45
15307,14,509,2970,445,7735,64
8630,31,2015,3374,1887,45079,128
34783,0,48,2019,46,3669,2
43226,2,49,1168,44,2515,5
20658,10,1028,2713,563,9642,465
23514,0,100,2559,79,3263,21
41800,26,377,1485,281,8934,96
41106,15,200,1592,165,4160,35
13980,7,877,3055,767,22415,110
31382,32,2267,2168,851,16499,1416
45703,24,204,497,149,6026,55
25888,1,37,2451,33,2857,4
36328,50,1526,1921,1216,13186,310
33650,0,133,2066,119,3572,14
17254,79,3367,2873,2018,22698,1349
38707,19,669,1768,327,6471,342
35960,423,20955,1944,8576,65111,12379
22145,1,90,2626,76,8115,14
31962,22,933,2137,610,11605,323
19907,14,621,2752,497,8781,124
36881,3,143,1890,123,2111,20
25031,10,262,2490,159,5567,103
14767,99,3571,3000,3030,13946,541
39751,27,963,1706,805,11199,158
46118,106,3006,330,1275,26284,1731
27406,2,48,2379,47,2063,1
33500,149,10737,2071,5308,82690,5429
15810,11,507,2948,434,8521,73
40382,36,1076,1660,543,10209,533
31908,145,4547,2140,3899,30190,648
22585,4,296,2604,243,4799,53
17269,15,418,2873,356,4893,62
16852,5,154,2896,118,4153,36
15588,6,185,2957,147,3973,38
43598,13,139,1050,104,2666,35
40776,42,1338,1625,1037,8611,301
17246,16,1081,2874,609,10965,472
39858,9,349,1699,257,6198,92
35760,44,782,1959,629,6854,153
35948,4,305,1945,208,17922,97
22962,1247,112179,2585,29134,311888,83045
23573,558,18222,2556,12760,60196,5462
9324,186,7769,3332,6795,53076,974
29933,2,57,2240,52,3854,5
40578,168,3847,1642,2931,24156,916
31209,7,323,2177,251,6781,72
17663,1,79,2854,64,5655,15
39629,1,64,1712,58,12744,6
43668,4,117,1026,75,4122,42
21352,12,766,2670,553,13178,213
25200,0,121,2481,96,10678,25
19208,57,1144,2788,942,11392,202
39026,5,107,1749,97,3569,10
32476,9,296,2113,244,5342,52
29887,19,687,2243,261,6003,426
30964,100,2506,2189,1304,18365,1202
9123,57,2638,3345,2478,12813,160
1671,68,3338,3700,2909,28437,429
22357,22,2563,2616,1536,19855,1027
39586,24,361,1715,267,6363,94
30659,78,4097,2201,3166,30110,931
26387,0,63,2428,56,1721,7
16906,145,6565,2894,4451,46108,2114
14832,15,1056,2996,825,18052,231
27642,2,29,2364,25,2259,4
22163,266,7436,2625,4913,49960,2523
35510,14,182,1978,149,5685,33
32345,24,591,2118,488,10590,103
42205,11,423,1411,316,9237,107
37964,66,2392,1820,1972,31594,420
45059,89,1990,720,793,14715,1197
45279,288,5600,636,5053,48963,547
12221,62,2387,3182,2113,23293,274
27341,20,1225,2383,860,23217,365
35527,10,406,1977,262,8912,144
15139,79,4136,2979,3155,30806,981
38031,0,2777,1816,1445,21470,1332
43947,148,2208,963,1624,22636,584
19370,7282,372111,2780,210331,1298473,161780
20117,25,1476,2741,1157,13466,319
15241,74,4360,2974,2717,32883,1643
41661,5,217,1511,143,11622,74
34008,16,851,2053,481,14481,370
34042,11,394,2052,324,25891,70
17359,11,1373,2868,1028,50981,345
16669,4,197,2907,151,2607,46
16396,363,65411,2920,16072,131784,49339
20314,13,464,2730,369,13365,95
15518,24,888,2961,682,8117,206
14195,53,2784,3042,1465,29083,1319
38362,146,4337,1792,2522,20094,1815
37637,10,201,1843,146,3148,55
21541,29,1119,2659,843,17898,276
33178,2,78,2083,60,2081,18
37701,43,1545,1839,737,8406,808
20810,38,1651,2703,1096,17015,555
38517,76,2040,1782,1545,27284,495
18971,0,94,2798,56,2002,38
19064,9,514,2795,388,15408,126
21978,17,835,2634,675,8986,160
39151,5,153,1740,118,7165,35
17032,3549,482335,2887,125211,1325730,357124
46186,1,23,298,19,1509,4
10958,31,3066,3246,2762,29862,304
17382,370,15288,2867,11392,96448,3896
41732,92,4952,1499,1767,29088,3185
29382,4,168,2267,146,8603,22
15800,7,585,2948,472,7756,113
43603,229,3768,1045,2668,33316,1100
28112,0,96,2338,83,4372,13
45456,6,101,590,80,3452,21
32747,496,11590,2101,9073,50464,2517
36733,9,202,1900,169,5935,33
28094,21,834,2339,544,14515,290
31748,424,12353,2147,9029,70476,3324
31111,2,120,2181,103,4397,17
11277,27,1184,3229,1158,29800,26
34381,8,381,2040,301,7110,80
24340,32,1590,2521,1261,15757,329
4432,1414,98384,3604,70926,402450,27458
9670,16,534,3311,514,4753,20
14542,24,1055,3016,813,5232,242
35115,51,952,2001,728,8029,224
35714,27,898,1962,708,6195,190
8256,1276,29145,3398,25899,250521,3246
21343,3,167,2671,144,2550,23
19367,19,386,2780,281,3955,105
45970,26,290,391,257,6026,33
37266,0,6,1866,4,2806,2
37176,8,264,1872,217,11040,47
29996,24,1118,2238,883,21338,235
35548,3,166,1975,131,3658,35
29153,42,2260,2280,1702,24196,558
17457,5,276,2864,223,4768,53
16800,7,758,2899,610,14223,148
23590,246,18849,2555,13242,100436,5607
41599,987,23104,1520,16331,129808,6773
45468,2,88,588,53,2157,35
37728,94,862,1837,630,8286,232
13769,9,566,3073,495,6049,71
25971,107,7322,2447,5289,44406,2033
42433,8,265,1365,195,6450,70
22720,88,3654,2598,2873,26306,781
25316,50,2682,2477,2192,14993,490
45774,9,93,465,92,3030,1
15077,261,16394,2982,12849,70519,3545
34475,2,120,2036,96,4498,24
20834,0,163,2702,145,3840,18
42144,37,1061,1425,873,26347,188
31707,5,280,2149,230,6776,50
31605,23,549,2155,471,31414,78
26538,52,1286,2421,967,11997,319
46309,1,41,257,27,1077,14
45917,13,175,417,142,2326,33
36064,41,430,1936,327,3953,103
45470,0,40,588,29,2459,11
37437,2,304,1856,145,7003,159
25372,428,17087,2475,13158,69332,3929
33230,171,9151,2082,4861,61122,4290
24327,247,11840,2521,8611,84436,3229
25840,2,73,2453,49,2964,24
39102,8,264,1744,201,11210,63
21976,1,95,2634,77,11632,18
41705,46,1778,1503,808,17068,970
17544,2,47,2859,42,3259,5
36623,33,562,1905,417,12232,145
42886,73,2251,1266,1197,21931,1054
18277,2,206,2827,170,2644,36
33346,202,19064,2077,8167,94318,10897
24754,67,2109,2501,1181,12487,928
19501,13,567,2773,418,8068,149
17202,9,366,2877,290,15420,76
32162,21,1743,2126,1365,18681,378
36930,4,176,1888,153,7906,23
13785,7,316,3072,310,7562,6
38856,88,2044,1759,1484,10630,560
25067,6,287,2488,211,5493,76
29412,32,610,2266,464,5846,146
39848,22,620,1700,472,9388,148
34895,14,296,2012,231,7089,65
29483,9,986,2262,750,18710,236
34242,104,1517,2046,1121,34875,396
38738,47,1455,1766,946,16999,509
6978,70,1290,3485,1136,14462,154
41240,168,5030,1574,3852,40788,1178
43130,2,118,1196,93,6161,25
39528,0,98,1718,83,11931,15
31670,7,286,2151,236,8562,50
17768,0,168,2851,133,3170,35
29168,4,440,2280,141,4241,299
41749,3,162,1495,128,7507,34
22650,9,779,2601,602,8625,177
16778,31,2160,2900,1784,15387,376
43391,1,77,1117,50,5077,27
42412,52,1757,1371,1247,17124,510
25877,18,1061,2452,719,14816,342
28081,2,255,2339,196,5998,59
41374,17,618,1553,465,8589,153
27205,28,1373,2391,945,10119,428
27835,0,63,2353,44,4625,19
40631,12,274,1638,162,3369,112
38357,52,1083,1792,775,24055,308
45463,2,44,589,17,1774,27
12266,3,428,3179,345,7810,83
30308,11,342,2222,279,3649,63
7322,200,5517,3466,4750,25537,767
19788,104,6586,2758,4374,68932,2212
41843,32,756,1477,423,13569,333
30776,23,466,2196,336,4509,130
30042,0,18,2236,16,2101,2
19366,19,1816,2780,848,17121,968
5232,195,5022,3566,4111,25954,911
9412,1169,51117,3326,35014,185389,16103
38469,39,899,1785,727,10229,172
30184,6,226,2229,182,6300,44
14426,18,847,3024,734,10053,113
28644,2,156,2306,101,5823,55
32349,3,186,2117,133,4511,53
32401,27,844,2115,707,16676,137
34769,10,334,2020,259,5755,75
14298,2,201,3034,184,3961,17
20206,2,318,2735,286,6383,32
18858,66,5451,2802,3983,25722,1468
37697,4,417,1840,246,6073,171
18671,0,133,2810,99,3323,34
24757,6,195,2501,109,3101,86
17969,20,684,2841,524,7453,160
44820,17,194,793,169,6415,25
43529,19,298,1076,222,9696,76
30848,87,2396,2193,1894,23037,502
25464,0,17,2471,10,1246,7
33653,22,553,2066,439,6462,114
16346,31,2413,2923,1852,13975,561
32720,3,82,2102,75,2120,7
15829,1105,114254,2947,53670,369263,60584
16330,184,7605,2924,5221,54162,2384
42161,3,149,1420,108,11997,41
35964,3,262,1944,221,5197,41
19038,343,18170,2795,13135,42821,5035
21234,15,377,2675,294,3413,83
2429,167,5872,3650,5131,31969,741
9051,301,13395,3350,12474,59948,921
26848,93,3243,2407,2613,20012,630
21410,149,12809,2667,7653,65063,5156
27056,0,139,2400,114,5903,25
43711,90,1404,1011,1100,26304,304
28189,105,2406,2333,1810,12580,596
44764,14,210,813,135,2723,75
42517,0,0,1348,0,2556,0
36471,0,295,1915,241,5950,54
41913,45,1305,1466,754,23022,551
27923,16,573,2348,345,10464,228
37139,12,403,1875,333,11080,70
12155,58,2967,3184,2483,33449,484
17615,9,825,2856,459,10985,366
33679,8,447,2065,293,8490,154
44015,6,116,952,109,2298,7
20372,255,35568,2727,13692,119212,21876
39955,19,236,1692,197,5801,39
38844,95,4476,1760,2184,31257,2292
16290,14,1348,2926,901,12762,447
38222,55,1245,1802,976,9612,269
20177,26,3826,2737,2661,54399,1165
4654,117,6645,3596,6282,22690,363
40552,2,323,1645,259,11102,64
15500,144,5874,2963,3984,23567,1890
36453,8,257,1916,211,6750,46
33491,1,41,2071,37,2647,4
940,7,647,3988,453,6535,194
36572,157,7841,1910,3032,50293,4809
43825,106,1266,981,1097,9730,169
21878,47,1702,2641,737,12059,965
28643,100,4797,2306,1943,29159,2854
15169,65,2395,2977,1899,16378,496
42969,43,555,1245,398,7862,157
36848,6,353,1891,201,10116,152
43483,30,389,1093,272,5577,117
36559,1,85,1910,58,2728,27
30581,4,166,2206,147,5739,19
26859,32,780,2407,569,8197,211
45892,125,1382,427,1258,12477,124
21824,32,2277,2644,1330,9515,947
45548,14,378,561,289,10648,89
33646,7,562,2066,345,9656,217
31458,8,421,2163,322,5815,99
40206,31,947,1676,670,7672,277
15359,7,723,2968,519,26057,204
14839,71,3382,2996,2604,28065,778
36814,559,7787,1895,6106,33127,1681
22881,15,632,2590,505,7516,127
35789,65,1291,1956,1047,8838,244
19532,4,228,2772,157,3570,71
25307,127,4725,2478,3508,35102,1217
13304,7,458,3110,436,7861,22
7094,160,12436,3479,11627,82960,809
24954,0,7,2492,6,3918,1
36142,2,106,1931,71,5358,35
24821,8,375,2499,294,3249,81
41134,27,577,1589,431,7116,146
29321,114,2760,2270,2174,17171,586
33586,5,137,2068,112,7616,25
23585,98,3303,2555,2534,18166,769
32143,5,249,2127,194,3976,55
17029,16,550,2887,391,17019,159
14608,17,732,3011,699,9067,33
19132,139,17612,2792,5339,83555,12273
29320,499,21024,2270,11848,103306,9176
18701,1,67,2809,55,2289,12
36091,29,1621,1934,1240,14447,381
31786,22,851,2146,632,7982,219
29386,103,3694,2267,2402,21994,1292
30574,13,214,2206,191,3376,23
25527,331,11456,2468,8026,63886,3430
21415,13,436,2667,370,14815,66
42361,24,1600,1381,987,15084,613
43693,5,150,1017,107,3369,43
43561,4,62,1066,58,5036,4
20485,60,3038,2722,2137,21763,901
16031,28,1304,2939,982,17725,322
24622,55,1181,2506,892,4790,289
19686,79,2335,2765,1725,22152,610
41548,6,411,1529,127,7873,284
15971,8,216,2942,153,13846,63
28962,8,420,2290,328,12343,92
18240,3,116,2828,98,6496,18
21281,29,652,2674,507,9641,145
32799,9,187,2099,166,4021,21
46321,1,50,253,30,1335,20
40072,0,212,1684,160,3484,52
20638,17,794,2714,629,10376,165
46165,2,35,306,29,1098,6
41865,11,370,1473,194,12124,176
15354,11,417,2969,346,10086,71
39777,17,687,1705,500,12090,187
39719,1,49,1707,38,2680,11
30310,16,373,2221,334,8777,39
27427,128,6751,2378,4077,46210,2674
28736,39,2005,2301,1248,21219,757
33951,37,1676,2055,787,29244,889
19659,14,819,2766,654,17044,165
28173,31,1374,2334,832,14837,542
27956,0,45,2346,41,2649,4
35248,0,391,1993,317,4687,74
26644,171,14979,2417,11113,86978,3866
15544,7,355,2961,272,4121,83
38907,2,124,1756,91,11441,33
38283,5,211,1798,141,6019,70
37285,88,1602,1865,1134,18442,468
17978,65,4565,2841,3459,45694,1106
28475,2,59,2317,50,3088,9
42564,8,175,1340,127,6671,48
35514,118,2722,1978,1905,33081,817
34554,6,158,2032,133,2652,25
35291,46,473,1991,389,4315,84
18638,202,12258,2812,8673,128427,3585
37518,7,433,1850,291,8340,142
28731,173,5452,2301,3631,34309,1821
25933,38,2861,2449,2162,20717,699
36899,3,90,1890,34,2782,56
29146,3,118,2280,93,2049,25
36692,4,295,1902,198,4335,97
11718,3,118,3206,118,11996,0
34565,23,459,2031,381,7479,78
44415,66,858,890,704,10475,154
17026,15,461,2887,242,6583,219
7608,53,1822,3450,1774,23470,48
26458,4,506,2425,228,6740,278
43639,41,678,1035,571,9732,107
13494,80,3714,3094,3579,43704,135
14639,44,1817,3009,1516,15285,301
44034,8,93,948,83,2722,10
26168,43,1435,2439,1156,13239,279
33366,43,2571,2076,1653,30597,918
24858,2,143,2497,117,4810,26
36689,12,253,1903,185,4934,68
20572,735,43117,2717,26120,165961,16997
20565,2,63,2717,56,3287,7
32502,38,903,2112,586,12393,317
25015,45,1645,2490,1260,19431,385
46108,10,92,333,80,2457,12
38281,2,174,1799,131,4621,43
15130,35,1803,2980,1576,25546,227
20976,5,262,2693,202,6332,60
14438,345,16600,3024,14568,152910,2032
25476,19,606,2471,484,9702,122
45007,16,126,739,105,4210,21
14943,162,10972,2990,9226,91651,1746
25156,203,7805,2484,5047,45983,2758
15356,37,3992,2968,3023,25439,969
26919,5,289,2404,174,3773,115
40003,13,411,1688,313,8536,98
40332,47,1068,1667,750,11812,318
16465,12,332,2917,259,4230,73
37091,4,71,1877,58,3114,13
39084,18,1014,1745,792,7084,222
43238,61,1463,1164,656,12205,807
31307,43,1050,2171,842,21149,208
24437,9,332,2516,274,6004,58
33564,3,61,2069,50,3052,11
14051,143,9063,3050,5836,59240,3227
35429,141,1506,1984,1178,10959,328
38471,1835,129225,1785,47501,469611,81724
19177,187,5785,2790,4165,37097,1620
18841,0,108,2803,88,3567,20
16105,20,1045,2934,817,8799,228
14000,93,9115,3054,5003,44288,4112
29586,41,1432,2258,1220,14347,212
32257,14,275,2122,204,5125,71
17155,9,196,2879,160,10937,36
40098,32,561,1683,371,8169,190
35882,17,448,1950,359,7541,89
28602,42,1170,2308,912,26067,258
42983,22,404,1240,220,17042,184
19568,19,1116,2770,706,31558,410
35929,18,165,1946,134,2990,31
13591,279,20378,3087,10898,113295,9480
45127,77,1471,683,1033,16952,438
13249,51,1524,3113,1293,21891,231
16446,3,114,2918,90,2337,24
18350,31,837,2824,518,6909,319
18908,28,1683,2800,1262,21343,421
27776,1,50,2356,41,2600,9
45308,36,413,629,392,5374,21
28590,3,69,2309,51,2317,18
40992,6,297,1606,228,4217,69
27851,9,425,2352,340,8216,85
17134,28,613,2881,492,5738,121
17019,61,4236,2888,1976,17000,2260
33294,0,42,2079,30,1900,12
21918,4,197,2639,156,5117,41
36434,27,1357,1917,803,16223,554
19029,4,210,2796,172,5723,38
17488,25,847,2862,516,6722,331
32367,22,465,2117,317,5984,148
37932,1,192,1822,160,7164,32
20018,9,435,2745,274,5990,161
32237,4,49,2122,43,3040,6
32472,3,112,2113,79,3428,33
14713,25,703,3004,674,10163,29
19577,3,312,2770,267,3808,45
21039,10,386,2688,304,19864,82
15383,99,2156,2968,1626,12673,530
44672,17,242,843,212,6757,30
35935,12,329,1946,212,6231,117
34821,3,137,2016,117,5051,20
28591,6,111,2309,99,2644,12
17454,10,621,2864,439,10237,182
31607,5,99,2155,85,1599,14
19058,65,3322,2795,1873,21190,1449
22432,7,313,2612,243,4744,70
43051,43,409,1220,359,6910,50
21282,7,339,2674,257,8014,82
34508,67,1748,2034,1322,16682,426
43155,0,43,1189,34,2660,9
29084,1,170,2283,143,5429,27
42943,6,110,1249,72,2565,38
43380,5,184,1120,139,3214,45
16927,37,1175,2893,946,23100,229
37974,60,590,1819,476,6930,114
22412,503,22072,2613,14883,116565,7189
26789,5,372,2410,321,5575,51
23246,17,559,2572,444,9338,115
38503,0,100,1783,74,3852,26
34262,67,2430,2045,1996,18851,434
40096,300,9090,1683,5687,49443,3403
30319,4,177,2221,128,5974,49
37520,32,930,1850,499,9952,431
15527,6,139,2961,121,3375,18
40878,23,435,1614,354,13560,81
22979,11,454,2584,369,4919,85
33051,13,445,2088,351,13798,94
14731,23,2707,3003,1931,19729,776
45987,14,101,384,91,2250,10
20081,5,143,2742,86,2330,57
7103,828,32263,3479,27306,118696,4957
30349,2,118,2219,98,11378,20
19240,106,4125,2787,3114,27727,1011
39194,81,775,1738,638,6863,137
26213,0,692,2436,553,18234,139
36736,67,2327,1900,1682,14669,645
9622,39,999,3313,982,12290,17
20346,54,4299,2729,3256,26800,1043
40353,7,154,1663,123,10297,31
35872,3,73,1951,62,4583,11
25530,151,6579,2468,2608,74915,3971
33009,10,319,2090,276,4918,43
36199,422,23405,1928,12577,110547,10828
37421,9,365,1857,260,3991,105
28150,29,952,2336,758,12573,194
26005,2,319,2446,150,7733,169
37458,9,465,1855,335,7947,130
34782,0,83,2019,72,4832,11
16385,1,184,2921,142,5564,42
29233,42,2653,2276,1204,15585,1449
33495,6,223,2071,147,4340,76
36227,4,159,1927,128,2598,31
36220,1,15,1927,13,2013,2
19552,16,466,2771,382,6182,84
43605,24,482,1046,397,16936,85
20807,0,924,2703,738,12207,186
28121,12,597,2337,493,8774,104
35450,24,757,1983,592,13070,165
43820,9,111,982,88,4758,23
38040,5,124,1816,110,5095,14
40898,20,493,1613,388,7629,105
15630,36,2846,2955,2083,21639,763
21028,7,112,2689,99,4649,13
46048,8,107,352,65,3782,42
17996,1,192,2840,107,4095,85
33069,2,148,2087,116,3352,32
34225,5,471,2047,314,5322,157
7070,110,10776,3480,7645,38583,3131
10083,52,3250,3291,2588,31592,662
4065,1530,48677,3617,40748,194457,7929
20163,250,20804,2738,14203,95394,6601
35146,4,46,1999,40,3228,6
36866,30,1895,1891,1469,33857,426
23437,3,258,2562,111,4349,147
32611,17,705,2106,514,17081,191
33746,3,119,2062,92,3615,27
18032,3,341,2838,230,7211,111
17858,51,2100,2847,1190,8126,910
23554,29,1494,2557,1210,15780,284
40341,16,341,1665,270,8267,71
28673,0,53,2305,41,4355,12
15568,2860,704139,2958,155380,1208289,548759
15559,11,462,2959,328,8582,134
39139,0,64,1742,47,3475,17
11212,51,3766,3232,3381,38580,385
28541,2,48,2311,29,2774,19
16075,75,4538,2936,3040,33867,1498
18869,11,431,2801,353,7012,78
40321,11,370,1668,304,4925,66
29049,11,573,2286,393,12450,180
39348,21,2895,1728,1963,12830,932
30402,13,517,2216,415,7952,102
46131,115,2055,323,1979,14772,76
19338,7,407,2781,317,8596,90
31058,6,154,2184,121,6888,33
28919,11,132,2292,115,2412,17
33035,13,485,2089,419,10132,66