Mod,likes,downloads,time,unique_dl,views,dl_dif
15253,387,8338,1411,5687,92270,2651
20900,1887,35544,1313,23463,167615,12081
34311,49,770,1058,581,6517,189
16895,40,1820,1384,1300,35577,520
1419,160,5660,1553,4073,164892,1587
7504,158,4171,1486,2887,36102,1284
51943,43,488,718,456,9741,32
50669,59,695,753,541,5594,154
69457,5,111,172,110,3694,1
40329,33,765,925,624,22632,141
40934,82,878,914,676,18807,202
6244,4,264,1502,203,4638,61
18546,65,2085,1355,1612,26506,473
841,49,1772,1558,1287,20836,485
39930,30,608,931,446,8121,162
49743,15180,322283,776,254548,657020,67735
50021,11,192,769,156,8651,36
6141,1,91,1503,60,8079,31
41311,42,1077,909,894,31536,183
30101,39,822,1133,611,20179,211
4344,65,2450,1526,1858,42409,592
4870,53,2114,1519,1378,18813,736
59446,95,1207,485,946,16171,261
49529,24,357,782,305,11038,52
7723,54,1329,1483,952,17929,377
35646,30,1135,1027,803,18100,332
12847,15,907,1444,520,23037,387
16701,8,747,1388,522,19511,225
32597,21188,562490,1091,386075,1834843,176415
33795,168,2940,1069,1985,45066,955
49382,5,59,785,51,5039,8
353,18,917,1562,629,42202,288
46378,216,2984,843,2246,34166,738
68392,19,127,208,86,4701,41
26250,21,1068,1213,648,13909,420
51438,4,58,732,34,2545,24
48626,143,1659,809,1291,20182,368
34851,20,733,1045,461,10028,272
29527,116,4521,1145,3134,26930,1387
33881,65,1223,1066,810,6641,413
57273,30,549,554,435,8951,114
49315,5,84,787,55,2964,29
27630,99,1965,1181,1408,36620,557
63871,1,7,344,4,2380,3
22774,777,18429,1283,11848,154170,6581
55275,0,0,610,0,4850,0
17569,73,2987,1372,2061,27406,926
46973,10,432,835,268,17568,164
57821,354,4869,539,3984,23645,885
19821,116,1723,1332,1172,13308,551
19827,84,4294,1332,2311,52846,1983
8315,48,1263,1478,928,9405,335
25431,273,5489,1230,3861,49311,1628
51161,92,1651,739,1210,30675,441
59020,10,113,500,81,6158,32
3583,680,18599,1535,13166,52772,5433
3245,130,1609,1538,1155,17094,454
54397,103,1431,639,1125,20291,306
31252,231,2404,1112,1564,34795,840
60263,17,287,457,219,10052,68
9826,53,2396,1471,1470,14328,926
33000,5,47,1083,37,9122,10
16606,108,2840,1390,1768,31306,1072
27076,92,2437,1194,1583,19144,854
56053,25,294,588,219,5602,75
16767,5,43,1386,33,3929,10
58650,5,103,511,61,4496,42
60037,56,512,465,420,8265,92
12913,14,825,1443,404,29900,421
4383,60,2082,1525,1483,19913,599
49010,304,4893,797,3469,26694,1424
33278,123,3391,1076,2063,28254,1328
4983,5,383,1517,278,6451,105
54531,130,4909,634,3602,20373,1307
27416,18,815,1187,488,6073,327
12280,0,0,1451,0,8590,0
41518,11,178,906,148,7719,30
34332,25,549,1058,374,10586,175
70121,67,1113,150,1091,15035,22
15070,7,269,1413,200,33716,69
38187,25,326,959,278,9110,48
68482,541,13230,204,11121,80938,2109
23035,276,6548,1279,4428,45003,2120
32182,420,7033,1098,4954,25690,2079
58248,14,180,525,147,7457,33
28635,22,321,1162,186,8516,135
54366,41,548,640,441,7591,107
1188,414,9113,1555,5817,28945,3296
15717,12,301,1404,250,16870,51
58558,30,312,514,253,6334,59
9899,20,748,1470,535,9720,213
62612,1200,16486,333,13769,116986,2717
1638,216,5817,1552,4042,24167,1775
49908,35,316,772,245,9619,71
19990,263,12763,1329,7753,123902,5010
52158,48,573,708,425,10237,148
1242,1,107,1555,76,16586,31
3730,126,6313,1533,4197,66436,2116
14880,184,2800,1416,1964,105017,836
29792,4,134,1140,124,16726,10
51965,40,411,717,351,7529,60
61225,51,503,420,415,8717,88
70513,0,15,137,13,1480,2
6805,18,983,1495,645,14857,338
21940,15,297,1296,190,6688,107
249,6,273,1563,200,22855,73
34612,15379,304555,1050,178501,794151,126054
61439,41,491,414,405,15256,86
12593,45,888,1447,505,10416,383
49777,501,5774,775,4384,36372,1390
14996,17,617,1414,419,9044,198
7215,28,1050,1489,636,25328,414
1177,1088,58156,1555,28170,170683,29986
16648,210,3263,1389,2195,46563,1068
28561,18,249,1163,194,11978,55
19032,16,730,1346,554,15213,176
39437,30,576,937,431,8582,145
51896,20,326,719,262,6374,64
21214,1,56,1307,40,11726,16
14834,12,1080,1416,708,15313,372
11859,29,1939,1455,934,22979,1005
68181,1,56,215,9,1537,47
24710,1044,91884,1245,54983,179688,36901
43285,11,455,877,346,12368,109
70478,246,3859,138,3756,19475,103
50100,393,5810,767,4895,64123,915
62513,117,2241,380,1512,20378,729
49636,67,997,779,775,8316,222
38500,110,1253,951,996,23288,257
46230,39,353,844,310,16559,43
3056,90,3521,1540,2197,25262,1324
64043,73,593,338,460,9330,133
25148,5,331,1236,218,9331,113
30010,296,6708,1135,4542,38130,2166
21579,62,2748,1301,1614,35005,1134
25407,4,161,1231,97,8585,64
10370,1596,63547,1467,34627,237019,28920
49859,242,4129,773,3435,39871,694
4061,376,11686,1529,7737,137832,3949
60906,2672,32974,432,28422,115671,4552
25230,39,526,1235,335,8235,191
2668,33,1176,1544,809,32655,367
49006,14,280,797,218,4014,62
13081,21,803,1440,453,22265,350
402,110,4206,1561,2675,59447,1531
10796,8,637,1464,422,13685,215
20872,48,1024,1314,784,20479,240
68417,161,1994,207,1636,14204,358
16961,41,1411,1383,998,51652,413
20471,11,271,1321,204,12234,67
24110,22,816,1259,626,14124,190
58836,32,289,506,233,3800,56
50734,367,6856,751,5135,25636,1721
48346,774,9379,817,7271,82046,2108
69855,2,58,158,47,2653,11
51080,71,877,742,686,12877,191
24244,110,1686,1256,1154,29524,532
10136,49,1325,1469,824,7730,501
67433,31,320,239,266,4531,54
64365,2,109,328,60,2351,49
8489,4532,118156,1477,81148,378803,37008
49118,6,115,794,92,9576,23
57113,519,7109,558,5882,40085,1227
12028,112,10349,1453,5074,24723,5275
22534,101,3147,1288,2074,32412,1073
32398,30,269,1095,218,5404,51
14467,49,1179,1420,766,11531,413
38146,101,2150,960,1515,21308,635
19617,3,171,1336,131,9683,40
36044,81,1278,1016,1000,11463,278
2667,0,77,1544,60,18179,17
64085,0,19,337,15,966,4
8978,7997,230138,1475,149266,745973,80872
70407,59,880,140,812,5003,68
23345,24,1204,1274,794,12139,410
26193,46,1224,1214,751,13081,473
46753,25,385,838,326,21935,59
3958,31,1120,1530,881,30609,239
717,6,512,1559,341,5884,171
63286,17,225,360,183,8046,42
18324,196,3282,1359,2402,23054,880
67438,27,463,238,397,12415,66
34972,94,2889,1042,2098,30507,791
37405,278,5624,980,4559,53969,1065
59883,22,363,470,267,5104,96
38826,63,901,944,680,9503,221
53076,41,521,679,431,9950,90
55650,18,205,599,148,4553,57
19410,30,1983,1339,1456,20058,527
69469,4,75,172,66,2726,9
875,6,578,1557,421,16180,157
55993,103,1486,590,1070,19838,416
53485,43,1149,669,852,21351,297
14260,13,322,1423,205,25350,117
15955,2524,60968,1400,40561,256692,20407
48756,7,52,805,42,3985,10
11684,57,2691,1457,1287,10046,1404
48857,3,73,802,54,4297,19
33534,55,1306,1074,972,7320,334
67986,6,43,221,35,2542,8
3951,445,24235,1531,16206,134644,8029
60995,3,136,429,105,3151,31
3628,113,4922,1534,2796,29297,2126
50073,14,240,767,187,12386,53
936,6,327,1557,238,19163,89
20910,960,19119,1313,12468,65799,6651
21944,4,225,1296,161,5402,64
46575,564,6900,840,5344,34032,1556
28338,224,6290,1167,4254,48924,2036
36269,76,1258,1010,969,18897,289
5763,147,2200,1508,1313,37352,887
61239,46,372,420,291,9390,81
32286,39,1431,1096,775,6626,656
59418,45,500,486,394,5269,106
63186,10,82,363,67,11337,15
63287,69,726,360,548,12210,178
63308,60,380,360,340,5390,40
46740,39,611,838,524,11250,87
28912,12,197,1156,135,8335,62
28438,1102,21553,1166,14649,107549,6904
16361,13,271,1393,207,7873,64
49894,38,458,772,409,13046,49
56094,116,973,587,776,7565,197
54281,3,30,643,27,2591,3
69249,17,223,178,151,4002,72
4900,205,8470,1518,5580,123435,2890
65091,47,734,306,556,5602,178
38058,63,523,963,415,11083,108
8230,216,8863,1478,5356,69326,3507
61682,192,3389,388,2699,46265,690
50985,270,6771,744,4883,54878,1888
29889,198,3392,1138,2480,29841,912
8505,1067,25344,1477,14951,79452,10393
55548,1017,16833,602,13932,86110,2901
11113,24,825,1462,485,15020,340
60696,27,160,440,125,6019,35
58687,231,5048,510,4182,30556,866
62540,35,315,379,243,8977,72
7264,25,359,1488,217,6634,142
59441,1,100,486,59,5239,41
48840,0,45,802,35,6035,10
30483,289,9384,1125,5662,36362,3722
9619,24,1209,1472,807,13867,402
5530,21,463,1510,357,7295,106
17749,0,99,1369,86,8035,13
33513,423,32959,1074,24630,96309,8329
23313,28,634,1275,445,12807,189
6481,111,2411,1499,1526,10234,885
8446,11,977,1477,614,20653,363
16369,2,40,1393,26,3277,14
69168,49,439,180,364,4284,75
15742,908,91876,1403,53651,154690,38225
32491,106,3086,1093,1784,17848,1302
3540,7,389,1535,284,15431,105
6722,19,770,1496,486,54498,284
50013,6356,96416,769,63622,262554,32794
24572,98,3737,1249,2411,38021,1326
58264,14,177,524,144,9742,33
46542,6,92,840,76,10897,16
16991,3515,88286,1383,59836,407511,28450
36813,278,4025,998,2902,21651,1123
49568,14,166,781,130,4715,36
18829,13,623,1350,464,11613,159
21704,69,1176,1299,763,31215,413
23272,0,0,1275,0,12105,0
1578,13,902,1552,629,10224,273
62559,87,1177,379,885,7991,292
22311,28,938,1292,766,49223,172
17559,489,13036,1373,9120,68231,3916
21832,44,597,1298,446,12641,151
37059,41,789,990,565,7863,224
10914,774,107366,1463,58595,323869,48771
56740,15,270,568,205,8241,65
58991,103,760,500,631,6545,129
21048,46,747,1311,508,8829,239
62144,353,4901,390,3958,42876,943
62749,7,79,374,58,1559,21
34056,68,1976,1063,1199,16909,777
11621,942,24220,1457,15444,160921,8776
39770,269,6417,933,5213,44858,1204
4201,194,4533,1528,3100,51191,1433
48308,2,24,817,17,1622,7
5785,89,3758,1508,2979,63027,779
62563,49,765,379,595,10208,170
3384,0,158,1537,113,16542,45
9767,56,1244,1471,801,21628,443
58003,39,321,533,258,5977,63
29834,22,519,1139,329,15195,190
67723,13,157,230,111,5426,46
33378,159,2036,1077,1430,11567,606
65431,119,3077,298,2449,14378,628
57798,5,77,540,59,1628,18
69004,8,138,186,111,2845,27
61335,56,472,417,384,21618,88
26904,1521,41080,1198,24877,316674,16203
19963,2,24,1330,21,3323,3
44288,6,78,866,63,3725,15
68281,9,108,212,76,5074,32
51276,4,112,736,94,14927,18
61795,42,468,403,355,3565,113
17335,16,427,1377,318,12150,109
30475,26,1062,1125,686,10361,376
30437,273,6625,1126,4755,78772,1870
34786,148,2566,1047,1950,39311,616
4055,27,820,1530,567,7469,253
65800,10,80,289,60,2982,20
34953,13,306,1043,217,3509,89
25524,52,788,1229,515,8061,273
10782,22,1018,1464,639,33415,379
10837,43,1800,1464,1203,23230,597
5183,30,1458,1514,947,13595,511
48916,68,1117,800,800,11574,317
4835,81,3160,1519,2317,41842,843
39385,52,438,937,365,9508,73
23074,71,2921,1278,2061,50763,860
40825,243,5419,917,4074,33474,1345
35671,33,732,1026,557,11907,175
38012,233,6644,964,5610,52433,1034
58164,227,2438,528,1945,18029,493
68634,382,6595,198,5479,60529,1116
19498,14,526,1338,424,31296,102
52018,59,819,715,726,11586,93
38233,13,207,885,174,7523,33
47508,5,82,828,58,4546,24
22034,72,2113,1295,1317,21131,796
54872,214,3753,621,3112,36687,641
65689,4,22,292,18,2768,4
57299,47,644,553,523,11077,121
59006,94,2275,499,1744,22136,531
60340,1150,13295,454,9746,58010,3549
8038,517,8517,1479,5790,84720,2727
26254,47,2451,1213,1541,26412,910
27478,5,207,1185,122,9496,85
17097,42,1567,1381,1259,44192,308
3679,57,1067,1534,769,20156,298
62282,14,300,387,242,8159,58
2084,1029,48801,1548,29433,132900,19368
28842,28,280,1158,256,4776,24
35527,14,211,1029,136,6432,75
36129,454,13101,1014,11230,74249,1871
1597,123,6846,1552,4680,79968,2166
64481,0,36,325,28,993,8
64112,6,83,336,68,6009,15
64835,259,5678,314,4678,42041,1000
29318,45,684,1149,509,20593,175
50763,8,225,751,152,10468,73
2974,852,53894,1540,34359,283455,19535
62928,2686,54489,369,43807,209900,10682
21531,92,5443,1302,3618,51123,1825
4828,86,3962,1519,2920,45272,1042
31873,3,50,1102,41,5917,9
40174,296,7245,927,5794,39649,1451
69032,4,61,185,54,3530,7
5612,5,275,1509,185,22197,90
54618,26,140,630,104,4698,36
2275,12057,471903,1547,283603,1153639,188300
11055,134,4886,1462,3406,66701,1480
4787,0,0,1520,0,24672,0
62714,0,27,375,27,1340,0
27821,6,108,1178,64,4404,44
27674,10,210,1180,118,5892,92
15745,2,124,1403,53,2554,71
24790,37,885,1244,569,13447,316
61822,20,187,402,142,2252,45
28741,4156,92676,1160,64052,193719,28624
11955,29,641,1454,303,6086,338
9990,361,11506,1469,7347,76526,4159
2831,15,640,1542,428,22997,212
29078,5,493,1153,263,7802,230
43939,41,882,870,738,21721,144
57787,272,3416,539,2748,31426,668
33256,885,13786,1079,9558,54141,4228
50855,2749,52265,748,42492,255601,9773
62082,100,1097,393,891,6776,206
5242,34,495,1514,365,9024,130
15214,6,170,1411,124,12054,46
55852,41,351,594,261,7869,90
57127,101,1494,558,1021,18126,473
51097,669,7681,741,5453,57319,2228
49388,49,469,785,343,5311,126
30156,22,694,1132,468,15386,226
45303,2,31,855,16,6086,15
3592,3349,282312,1535,128464,2576551,153848
7367,47,2693,1487,1790,28964,903
55625,55,465,600,395,10465,70
25520,30,748,1229,571,12470,177
10987,41,1228,1463,791,44500,437
54594,12,86,631,68,3905,18
48685,490,10621,806,8728,55989,1893
66761,9,85,261,79,3914,6
66077,18,60,282,50,2434,10
35271,5,137,1035,103,6805,34
21880,187,2741,1297,2016,15091,725
63488,4,62,355,43,4413,19
58728,3228,54571,509,41259,178249,13312
67687,8,193,230,165,4179,28
9280,251,6925,1474,4415,31917,2510
29892,37,878,1138,510,8483,368
38337,12,526,956,285,5731,241
58701,52,404,509,309,8486,95
4088,16,903,1529,615,15667,288
26864,159,3500,1198,2424,24530,1076
37237,33,737,985,473,14722,264
34317,70,1264,1059,994,10135,270
52721,623,6104,690,4610,26477,1494
14166,20,456,1425,330,11696,126
5088,34,1446,1516,878,27851,568
24373,0,0,1253,0,10365,0
10937,560,51115,1463,24376,156090,26739
30348,431,6425,1128,4431,41009,1994
23213,1,84,1276,59,4066,25
34933,345,7225,1044,4628,23689,2597
53398,135,1644,671,1290,17609,354
6961,28,802,1493,507,8259,295
60704,21,175,440,133,10006,42
15307,1179,28312,1410,17763,157792,10549
84,79,3040,1565,2105,26219,935
60165,76,427,460,349,7009,78
48557,1206,17416,811,14207,140966,3209
54848,19,149,621,137,5003,12
52207,50,530,709,455,6116,75
3461,2,55,1536,42,6443,13
64294,16,120,330,86,6029,34
23989,38,1946,1262,1583,15132,363
56487,188,3811,576,2927,44904,884
22840,48,970,1282,701,21917,269
61925,14,175,399,114,3771,61
19228,129,1846,1343,1383,27668,463
59236,29,703,493,522,13281,181
24506,249,5264,1250,3403,23661,1861
57479,13,331,549,191,8511,140
28839,452,5834,1158,4175,75917,1659
24641,673,15822,1247,11703,88702,4119
13975,17,755,1428,416,7939,339
59950,9,74,468,49,2733,25
60304,61,1395,455,1155,14811,240
20761,31,1604,1316,1017,16290,587
22283,265,6450,1292,4225,39476,2225
54092,28,202,649,169,5830,33
69287,20,230,177,212,7831,18
33106,794,9061,1082,7575,54867,1486
70242,243,3017,146,2942,12417,75
29638,6,135,1143,103,10121,32
46836,89,1336,837,921,9319,415
64551,1,21,323,17,1776,4
17075,4,50,1381,44,8259,6
27182,803,15219,1192,8983,66059,6236
35219,361,6413,1036,4593,36737,1820
63099,24,425,365,333,5306,92
6074,33,916,1504,709,20633,207
21034,122,3561,1311,2561,45373,1000
58124,2,13,529,6,4996,7
60216,15,298,458,214,4973,84
9241,192,7253,1474,4934,61678,2319
11137,51,1454,1461,788,26573,666
24836,36,1014,1243,730,9248,284
57215,9,71,556,61,1838,10
9583,954,38955,1472,25206,140252,13749
53565,604,7160,667,5988,51446,1172
40815,55,761,917,588,16713,173
18756,46,700,1351,438,14294,262
32576,129,2978,1091,1871,21773,1107
45293,151,1637,855,1288,29741,349
33072,49,1589,1082,1065,21527,524
32404,516,11318,1094,7426,77915,3892
50437,5,118,758,58,2920,60
11769,588,13573,1456,7733,49309,5840
44743,93,964,861,783,9107,181
14869,154,6895,1416,4428,66056,2467
14159,121,2250,1425,1467,14811,783
10625,1444,41198,1466,26112,101542,15086
62333,10,167,385,120,5709,47
63199,314,3191,363,2719,29109,472
48868,202,2810,801,2229,24619,581
970,5,309,1557,201,12248,108
53574,54,653,667,479,10933,174
15569,27,952,1406,688,15365,264
55242,13,148,611,108,7595,40
14408,86,2080,1421,1619,23949,461
948,2,104,1557,67,11686,37
13307,763,18374,1437,12651,131723,5723
53575,173,1565,667,1264,9273,301
2527,22,936,1545,615,27742,321
13291,13,604,1438,303,10990,301
56350,12,243,580,169,7399,74
67432,19,231,239,172,5010,59
1696,18,1019,1551,740,14275,279
19594,121,1935,1336,1330,22512,605
68069,10,128,218,88,3704,40
1523,5,285,1553,194,8102,91
30877,1088,17683,1118,11479,61444,6204
28652,57,695,1161,514,18100,181
56682,77,1018,570,834,8994,184
67250,6,76,244,53,6989,23
4786,903,29349,1520,15227,60438,14122
27202,56,2097,1191,1331,20496,766
10140,192,5447,1469,3490,34993,1957
29198,9,305,1151,163,6815,142
11534,4014,112252,1458,68168,378805,44084
25617,38,1657,1226,964,28662,693
15603,72,793,1405,524,9114,269
38848,429,8451,944,6962,83247,1489
173,715,30667,1564,19277,122091,11390
19570,3,111,1337,58,5648,53
11881,10,647,1455,327,15534,320
40675,415,6000,920,4455,56846,1545
29525,36,1034,1145,773,12577,261
7803,2,168,1481,81,7621,87
51304,19,385,735,298,12621,87
50525,168,2583,756,1999,35495,584
43030,35,340,881,269,12499,71
37570,25,637,975,483,13227,154
37301,12,149,982,120,5350,29
2054,1024,29514,1549,17973,98743,11541
38238,462,5461,958,3543,35768,1918
50497,8,116,757,81,15209,35
30991,5,210,1116,163,9230,47
183,753,22326,1564,13485,99178,8841
20555,488,18213,1320,10176,66408,8037
31813,6388,211055,1103,128197,881773,82858
3885,4,133,1531,96,16937,37
30788,175,3484,1119,2396,26732,1088
39422,267,3588,937,2833,23522,755
33535,6,178,1074,131,4017,47
40629,60,719,920,581,12340,138
54544,822,12305,633,10210,49039,2095
5297,82,1790,1513,1307,17732,483
21040,197,3404,1311,2371,21117,1033
57197,25,348,556,285,6330,63
63876,14,275,344,244,9856,31
53859,7,74,658,69,4669,5
13663,461,11875,1432,8050,98597,3825
28052,6,242,1173,176,10949,66
15506,13754,363804,1407,236184,753567,127620
53612,10,127,665,107,8816,20
60531,20,321,446,235,9301,86
63635,1642,29944,351,24715,170733,5229
65195,11,73,304,62,2224,11
36220,5,153,1012,130,13939,23
37517,9,438,977,334,22170,104
58055,5591,79171,531,62147,224595,17024
55320,133,1514,608,1354,17845,160
68076,0,115,218,103,3579,12
27790,354,9554,1178,6502,74181,3052
68890,6,79,190,52,5389,27
5750,69,1561,1508,1101,20474,460
68295,6,92,211,73,5678,19
38237,226,3516,958,2719,20261,797
61649,32,924,408,655,16580,269
1697,7,248,1551,168,14058,80
18749,8,581,1351,385,18183,196
59947,2,61,468,48,2153,13
55939,17,360,592,285,5874,75
22521,78,3175,1288,2202,25330,973
43897,12,421,871,368,13330,53
377,15,679,1562,391,20453,288
19366,46,1112,1340,884,37686,228
35754,14,576,1024,419,11048,157
8875,35,1775,1475,1180,23851,595
20207,59,2186,1325,1526,26045,660
32950,40,615,1085,392,8576,223
17847,133,2267,1367,1516,22949,751
18620,0,0,1354,0,9903,0
1566,36,1249,1552,910,48367,339
32074,35,1082,1099,622,12614,460
49047,29,453,796,356,3773,97
31145,96,1188,1113,786,21864,402
64746,55,767,317,632,8794,135
61618,33,399,409,298,10461,101
35457,30,723,1030,534,22555,189
24869,10,465,1242,239,5588,226
60140,28,511,461,409,9464,102
33054,329,8926,1082,6391,83179,2535
28262,182,5449,1169,3706,45657,1743
61920,114,1203,399,887,13849,316
53114,53,576,678,486,9118,90
34146,22,657,1062,428,6283,229
1133,17,436,1555,312,4937,124
28336,13,318,1167,216,7434,102
52423,13525,279089,702,217749,820633,61340
18889,8,171,1349,128,13797,43
6633,217,7043,1497,4612,36716,2431
57489,420,10778,500,7305,84099,3473
33770,76,1740,1058,1172,17938,568
49296,134,3172,788,2369,34842,803
59748,25,321,475,248,7280,73
13600,11,246,1433,167,11189,79
63148,27,1025,364,797,10703,228
17574,481,7235,1372,5658,48851,1577
55676,19,243,599,189,5827,54
50151,42,527,766,414,6303,113
57404,652,9295,550,7705,37169,1590
18819,129,3410,1350,2195,21711,1215
21234,121,2308,1307,1648,32581,660
32261,41,452,1097,263,3943,189
67917,36,268,223,186,4440,82
22158,52,1377,1293,1015,19672,362
60937,52,404,431,331,8254,73
63440,28,269,356,213,4016,56
29614,27,837,1144,554,12853,283
20643,130,3390,1318,2368,37369,1022
33077,26,525,1082,342,7443,183
23137,147,3021,1277,2099,30183,922
24309,6,202,1255,138,12679,64
7506,84,3572,1486,2387,16182,1185
30588,42,699,1124,440,6166,259
58154,184,2614,528,1917,15056,697
45449,0,144,853,102,4232,42
21967,251,8864,1296,6114,54242,2750
35165,9,243,1038,166,4387,77
2313,220,7552,1546,5115,30412,2437
19576,13,496,1337,389,16582,107
31356,26,447,1110,273,13202,174
50793,6,167,601,139,14957,28
36388,6,415,1007,334,11403,81
28016,430,8855,1173,6267,44125,2588
36493,71,1166,1003,1041,29606,125
36375,6,343,1007,258,7143,85
20345,880,18348,1323,12791,52529,5557
59509,6,75,483,35,4345,40
33720,80,1491,1070,950,15490,541
59494,4,50,484,37,3240,13
55232,115,3925,611,3056,44913,869
58833,21,192,506,158,5006,34
13078,136,6601,1440,4272,51066,2329
8782,117,3207,1476,2057,27872,1150
4015,20,935,1530,661,9510,274
66686,13,273,263,214,4059,59
14795,4,46,1417,35,4708,11
25042,8,358,1238,255,8126,103
28385,13,501,1167,344,9484,157
309,20,1201,1562,844,25764,357
17341,24,672,1377,495,12374,177
14365,245,8096,1422,4700,40582,3396
33308,29,1423,1078,951,13497,472
20350,40,1941,1323,1357,17215,584
50725,4,137,752,96,9371,41
66183,13,150,278,115,3746,35
54942,1,14,619,11,2459,3
10965,66,1737,1463,1088,28169,649
32407,100,1424,1094,998,15586,426
6584,16,882,1498,585,38975,297
20933,20,479,1313,318,7503,161
22464,17,429,1289,296,8135,133
9716,728,29212,1471,18738,198092,10474
38461,135,3172,952,2566,34928,606
32322,14,495,1096,323,12869,172
28844,4,195,1158,120,6011,75
52270,10,219,707,168,10186,51
64458,35,534,325,442,8584,92
29196,3528,126824,1151,80888,449576,45936
18644,7,198,1353,160,8272,38
14900,50,2920,1415,2114,14194,806
32339,1072,32009,1096,21279,174673,10730
42596,6,144,888,106,4237,38
33213,1165,19332,1080,13045,180613,6287
13564,2,258,1433,121,6310,137
24804,108,1552,1243,941,14134,611
1671,44,1150,1552,809,36287,341
15965,2,78,1399,53,16139,25
36907,13,689,995,518,25351,171
48749,3,46,805,34,2560,12
49514,20,287,782,238,4980,49
61641,9,241,408,175,18539,66
27704,37,707,1180,404,9252,303
54425,306,6204,638,5013,47960,1191
60434,24,396,450,308,5341,88
35315,12,632,1034,439,8062,193
23214,20,426,1276,317,13605,109
34323,190,5078,1058,3666,76343,1412
5702,108,2829,1509,2101,33404,728
15133,12,670,1412,478,18157,192
24878,4,156,1242,112,10620,44
9080,11200,346655,1474,184215,1082795,162440
2636,7348,233166,1544,129604,436042,103562
25980,253,9946,1218,6186,125391,3760
22571,18,568,1287,446,14430,122
66275,5,78,276,60,4916,18
18891,1,107,1349,76,6227,31
64809,17,159,315,129,14925,30
7551,41,1388,1485,940,11797,448
21630,80,2269,1300,1430,37859,839
15576,104,2154,1406,1477,38143,677
22658,197,3982,1286,2847,46515,1135
16842,0,0,1385,0,8180,0
53933,16,171,656,125,14360,46
57975,91,1122,534,1005,16875,117
65550,24,160,296,121,5178,39
29294,14,231,1149,181,9517,50
55274,13,202,610,169,7324,33
3200,553,13569,1538,9071,49777,4498
60960,19,249,430,189,5854,60
65142,15,333,305,240,5642,93
56993,26,264,561,208,6287,56
38814,99,3498,944,2079,29220,1419
30626,123,2124,1123,1590,27395,534
31402,156,3406,1110,2185,39996,1221
26246,74,2044,1213,1524,14013,520
17703,500,14156,1370,9404,98187,4752
34505,416,7785,1054,5514,38675,2271
67706,1,19,230,15,2963,4
58743,586,11102,508,9151,101029,1951
23198,13,288,1276,184,4800,104
11112,74,2751,1462,1712,31874,1039
33153,14,491,1081,295,15203,196
11007,373,12546,1462,7920,85582,4626
24967,540,9274,1240,6465,75856,2809
24271,188,1577,1256,1161,19237,416
28044,2723,68581,1173,45292,346287,23289
49571,25,352,781,284,9137,68
69483,19,254,171,218,4007,36
35681,9,340,1026,222,5481,118
15714,43,1742,1404,1269,27325,473
22518,41,1432,1288,1100,36141,332
3573,216,5112,1535,3416,63019,1696
67169,4,114,247,91,3249,23
2198,312,21749,1547,11762,170470,9987
29622,10919,237525,1144,133175,1098689,104350
68407,14,96,208,75,3855,21
776,1001,57364,1558,36001,145768,21363
374,36,1752,1562,1074,20598,678
64442,1189,18912,326,15632,109027,3280
69321,22,191,176,144,2700,47
68272,147,3471,212,3015,28666,456
51407,10,194,732,149,8205,45
11791,172,4637,1456,2272,23961,2365
29985,176,7258,1136,4821,21917,2437
2906,2631,86683,1541,58593,218902,28090
65234,14,235,303,200,6190,35
28833,25,1028,1158,656,32922,372
54117,38,401,649,334,10104,67
37938,11,313,966,252,9404,61
30739,21,448,1121,293,3165,155
21148,5258,134303,1309,89145,285602,45158
19256,53,1725,1342,1089,29360,636
31243,124,2756,1112,1815,21291,941
36352,11,168,1008,145,14652,23
33531,53,1561,964,1249,25738,312
53232,77,797,675,583,11324,214
14248,96,3485,1423,2418,37894,1067
50613,52,1034,754,776,9726,258
11953,109,4804,1454,2793,40835,2011
27683,6,273,1180,165,6681,108
67258,842,15882,244,11630,96049,4252
61890,111,778,400,632,5754,146
1333,9,293,1554,210,11899,83
43405,29,430,876,324,8903,106
41331,54,686,908,576,12051,110
44874,25,626,860,477,12866,149
22526,84,2748,1288,2238,62017,510
35443,470,9955,1031,7581,117522,2374
2269,21,531,1547,342,26198,189
6665,302,9201,1496,6988,78441,2213
25534,19,1076,1228,664,21436,412
49673,601,9137,778,7960,69974,1177
52445,2303,28446,701,22667,224289,5779
21239,0,0,1307,0,14299,0
9177,2,82,1474,51,8262,31
4860,816,20309,1519,12431,113154,7878
352,7,180,1562,128,11805,52
7418,55,1158,1487,770,13136,388
6735,40,1771,1496,1157,33521,614
18500,67,1667,1355,1259,44500,408
10306,2,109,1468,71,13391,38
52680,71,1317,692,1074,11671,243
62315,33,1026,386,797,11907,229
50976,97,1966,745,1487,10369,479
6113,49,2377,1504,1638,19041,739
62004,1,17,396,12,1953,5
68607,57,650,200,550,14253,100
13728,21,1157,1431,695,43070,462
66620,18,193,265,156,2961,37
49468,4,113,783,80,6279,33
45329,87,1425,855,1130,20722,295
51192,10,149,738,121,4860,28
66578,225,2395,266,2114,18938,281
16169,21,281,1396,230,14977,51
38004,5622,222088,964,188002,521322,34086
21450,64,802,1303,552,10976,250
30407,226,6583,1127,5272,67367,1311
57803,14,124,540,93,3256,31
42484,25,412,890,338,8436,74
39418,404,8109,937,6043,55604,2066
23385,81,1232,1273,897,11764,335
33148,508,9991,1081,7017,63081,2974
64671,18,172,319,152,4104,20
48730,1066,33976,806,26828,203989,7148
34651,24,288,1050,194,6191,94
1254,3,223,1555,144,33412,79
37070,1164,17063,990,14035,214220,3028
11538,32,1055,1458,680,13649,375
49120,1,136,794,112,10510,24
62174,11,244,390,192,6157,52
42794,187,3528,884,2654,40066,874
22694,0,0,1285,0,3291,0
57812,40,361,539,249,6143,112
460,36,1747,1561,1037,19035,710
11145,45,1464,1461,850,24060,614
26177,6,424,1214,283,11622,141
38522,2110,29250,950,23297,87371,5953
22969,14,530,1280,382,11671,148
192,203,8797,1564,5254,75707,3543
23755,7881,250149,1266,158531,906238,91618
16901,157,4092,1384,2532,40280,1560
27119,1224,32732,1193,17906,135168,14826
36012,439,6670,1018,5402,77179,1268
8341,853,23107,1478,15733,239178,7374
69200,20,336,180,313,3355,23
18708,3,226,1352,147,5384,79
31258,209,7715,1112,4950,39994,2765
54277,162,3352,643,2736,42709,616
3140,25,691,1539,514,26791,177
61946,52,415,398,289,4356,126
442,886,45082,1561,30583,207254,14499
41824,471,6721,900,5055,46892,1666
51131,1169,64508,740,48156,161612,16352
44337,97,1354,865,1063,6531,291
54211,14,128,646,108,4388,20
35693,931,11904,1026,8359,44140,3545
22950,1274,25639,1280,17243,174837,8396
16230,0,227,1395,142,4302,85
7647,508,7809,1484,5268,35795,2541
25344,373,10627,1232,6253,30058,4374
42686,13,264,886,194,14492,70
64706,35,184,319,146,3331,38
31340,10,315,1110,203,26583,112
69463,44,401,167,342,7181,59
67181,516,4705,246,3724,29765,981
22055,391,5620,1295,3727,41268,1893
37755,12,163,971,130,15490,33
68647,2,57,198,42,5695,15
7693,110,5765,1483,3746,93297,2019
13616,35,1637,1433,990,24211,647
34065,9,374,1063,244,7744,130
4727,331,5632,1520,3882,43766,1750
61144,23,584,424,489,10767,95
4649,7,449,1522,313,9029,136
17776,50,1271,1368,907,26161,364
54152,85,514,648,401,12049,113
63179,13,282,363,229,6022,53
63419,18,318,357,275,2881,43
61886,275,6012,400,4733,40231,1279
66644,4,129,265,104,2579,25
10590,60,2309,1466,1392,21512,917
64742,42,391,318,334,8005,57
55043,9,161,616,135,5785,26
29283,20,417,1149,262,10096,155
51,768,32909,1566,21354,184248,11555
49465,564,7866,784,5531,57975,2335
49086,11,155,794,126,4822,29
23194,42,921,1276,822,55360,99
69341,621,14606,175,13587,34657,1019
60631,77,1193,443,938,14895,255
20755,17,515,1316,391,18366,124
22800,2325,51546,1283,32689,152789,18857
58229,86,1736,525,1416,16255,320
51316,69,789,735,626,17063,163
60000,71,1736,466,1287,44001,449
60418,22,268,452,237,8032,31
51324,56,530,735,415,13499,115
32431,276,5632,1094,3973,26091,1659
106,1151,132178,1565,80171,586334,52007
6123,8,260,1503,180,12121,80
7151,11,374,1490,264,10678,110
3328,1453,25723,1537,18703,100381,7020
35978,77,1253,1019,917,24459,336
34575,115,1475,1053,976,15519,499
19243,122,2548,1342,1711,32910,837
3562,1097,29232,1535,21163,158367,8069
41524,3609,48136,906,36997,246391,11139
54672,2613,27925,628,22671,184031,5254
26477,67,1097,1208,689,5992,408
53624,14,109,665,90,10116,19
3125,12,205,1539,144,10201,61
41621,16,444,904,351,7416,93
22568,55,2064,1287,1356,61380,708
822,9339,628526,1558,420677,2568055,207849
4198,512,20274,1528,13726,134936,6548
16821,45,1987,1386,1263,38344,724
65185,124,1703,304,1367,12208,336
63931,13,104,342,88,2799,16
20375,37,1707,1323,1135,14571,572
66114,1,6,281,5,1160,1
34562,47,2259,1053,1725,18808,534
23335,24,646,1274,463,16603,183
50726,178,5050,752,3773,60684,1277
27337,53,1155,1188,820,22928,335
1509,76,2643,1553,1872,12766,771
47188,8,190,832,161,8832,29
50033,20,618,769,364,11407,254
21464,4,182,1303,158,23558,24
1997,202,10843,1549,6452,133049,4391
37282,63,1060,983,776,25571,284
48721,21,257,806,210,6463,47
223,303,12690,1563,8180,55689,4510
2864,1,92,1542,61,7281,31
46681,34,797,838,649,18806,148
26308,2127,95511,1211,53860,323480,41651
50871,4,68,748,46,2488,22
9059,8,348,1474,219,9339,129
37302,2267,37437,974,29513,282531,7924
7484,7922,205859,1486,119366,596800,86493
30220,7,243,1131,154,15791,89
40482,27,584,922,526,11869,58
21386,19,481,1304,334,17806,147
38457,2,132,952,100,11857,32
4592,4,156,1522,101,7035,55
11976,256,8237,1454,5151,51725,3086
26088,5,61,1216,44,4773,17
53535,34,452,668,405,23268,47
35091,41,847,1040,611,17750,236
2186,12,294,1547,217,12044,77
49798,235,4791,774,3710,39978,1081
63389,182,2710,358,2237,28997,473
20024,22,685,1329,480,16779,205
31174,70,1680,1113,1076,25733,604
65929,42,765,286,619,14604,146
34927,85,1994,1044,1356,26087,638
41727,2,56,902,35,8307,21
15790,63,1877,1403,1326,52198,551
14685,33,434,1418,287,10973,147
25173,23,533,1236,292,5251,241
15244,17,665,1411,458,14247,207
52418,216,2673,702,2161,33804,512
58470,259,4222,517,3212,27964,1010
48172,967,10785,820,8242,57625,2543
32878,698,12819,1082,9633,94378,3186
17907,16,543,1366,354,15678,189
33483,116,4205,1075,2712,34892,1493
38404,68,1067,954,854,34305,213
3352,835,25887,1537,16504,103059,9383
51029,338,3559,743,2864,31428,695
61501,29,456,413,349,7417,107
37719,602,13727,971,10921,46708,2806
28891,229,4613,1157,2829,38691,1784
15646,164,4178,1405,2840,30995,1338
31924,25,1053,1100,667,10574,386
52361,109,2565,704,2281,19055,284
31631,11,395,1106,235,5920,160
29565,3,122,1144,89,2851,33
10788,0,372,1464,245,13104,127
35950,217,5096,1019,3708,35565,1388
9894,2019,64540,1470,43253,178507,21287
68666,4,109,198,84,4657,25
20580,8,547,1319,376,37351,171
22587,25,553,1287,372,10252,181
49938,6,111,771,68,3524,43
60576,3535,52123,445,40838,155486,11285
58543,240,3296,515,2452,19392,844
57874,24,244,537,173,9692,71
50921,166,2430,746,1959,24767,471
51459,111,1149,732,962,14721,187
59846,17,296,472,264,7956,32
3099,22,667,1539,433,46747,234
36148,158,2240,1014,1897,55277,343
50294,139,2529,762,1882,22631,647
28958,81,1447,1155,955,13492,492
57818,16,280,539,247,11443,33
51189,9697,197395,734,154542,793637,42853
20319,25,380,1324,233,5883,147
25845,22,1323,1222,818,13170,505
11836,1347,34576,1455,20966,163155,13610
836,28940,1250708,1558,718811,2535798,531897
30525,176,6275,1124,3563,23083,2712
7235,14,260,1489,178,10113,82
20446,10,175,1321,146,7418,29
54908,1864,36999,620,29046,226946,7953
60019,44,961,466,647,15315,314
68235,27,355,214,241,8404,114
14860,226,7311,1416,5079,33562,2232
1327,2142,101522,1554,63053,374886,38469
8293,0,0,1478,0,5852,0
53938,133,2571,655,1819,52060,752
30765,127,2097,1120,1285,17846,812
6749,497,15208,1495,9657,141883,5551
55475,274,3459,601,2720,27309,739
5402,30,1174,1512,753,20814,421
31695,55,1002,1105,697,16724,305
43,422,17903,1566,10744,156556,7159
31154,33,1508,1113,929,22038,579
3261,3835,101750,1538,67039,518749,34711
62501,29,237,380,188,2629,49
56738,53,507,568,438,10068,69
57523,139,1412,548,1116,29252,296
56857,3,19,561,14,4297,5
12695,42,1160,1446,696,6339,464
54957,97,1607,619,1238,17752,369
33638,0,34,1072,28,4602,6
65443,26,498,298,407,7698,91
2686,405,10593,1543,7159,68606,3434
42890,235,3863,883,3188,30010,675
54595,50,495,631,427,15921,68
45795,8,87,849,67,7195,20
62367,59,777,384,594,7416,183
20988,14,279,1312,191,5094,88
10811,603,21177,1464,13712,124968,7465
40497,456,5397,922,4262,63654,1135
23407,221,7061,1273,4967,48297,2094
28585,31,1493,1163,933,19758,560
69041,143,8294,184,6425,27467,1869
64251,1357,29554,332,22154,176973,7400
861,38,2518,1557,1571,36921,947
51682,2719,52600,725,42769,357405,9831
4859,273,5009,1519,3326,75842,1683
27125,1245,25424,1193,17138,163628,8286
62389,7,163,384,91,5217,72
10154,1165,46053,1469,24695,228492,21358
12893,125,4753,1443,2509,38868,2244
33948,269,2734,1066,2084,36003,650
29571,187,4270,1144,2769,20349,1501
66173,5,48,278,41,1775,7
52126,73,1875,711,1418,14054,457
27120,24,582,1193,340,17714,242
61046,29,553,428,425,12731,128
67913,8,155,223,131,2645,24
6896,25,1492,1494,1004,20608,488
34990,28,392,1042,351,15721,41
31661,12,182,1106,134,5400,48
1368,729,27498,1554,17225,120818,10273
62753,67,932,372,779,10851,153
1575,339,8161,1552,5472,25534,2689
18363,3,204,1358,146,10788,58
13053,31,851,1440,488,8786,363
6307,149,2813,1502,1877,21465,936
13581,865,41315,1433,24061,239813,17254
19242,637,7803,1342,5814,33875,1989
26024,41,1351,1217,798,39130,553
54464,37,411,636,274,23804,137
36777,437,9123,997,7265,98372,1858
2374,60,1308,1546,872,22224,436
60907,11,255,432,190,11133,65
52832,0,17,687,15,2323,2
61246,136,2944,420,2460,21255,484
10524,36,1282,1466,863,27237,419
62885,10,265,370,232,6165,33
9709,106,2456,1471,1756,61801,700
25857,76,1896,1221,1231,13934,665
28446,19,966,1166,566,12293,400
1738,13,669,1551,448,14270,221
48693,18,253,807,198,4249,55
32152,5,171,1099,106,10981,65
8915,94,1729,1475,1142,16263,587
17014,41,936,1382,628,11075,308
33434,31,1039,1076,799,14987,240
17671,7,164,1370,128,7788,36
10174,7,369,1468,242,25270,127
56520,17,161,574,132,4168,29
22447,35,715,1289,529,15817,186
67808,99,1302,226,1043,13297,259
4489,1504,40134,1524,25765,211861,14369
21971,100,1730,1296,1188,9560,542
53962,41,539,655,349,9680,190
12665,89,2169,1446,1252,29917,917
60444,33,318,450,281,7643,37
18567,133,3408,1354,2556,33275,852
4096,76,2247,1529,1424,24341,823
41599,499,7922,904,5889,38659,2033
49084,3862,56323,787,45439,225201,10884
57237,194,1763,555,1328,14509,435
20929,134,3444,1313,2218,28171,1226
36899,47,579,995,460,12762,119
6361,110,3041,1501,2127,43163,914
1860,19,923,1550,675,23015,248
23519,5,199,1271,146,9776,53
38651,391,5704,947,4386,41704,1318
10135,860,20495,1469,12858,148766,7637
27246,11,298,1191,238,21365,60
66749,6,219,261,122,2655,97
56331,323,4192,580,3226,28677,966
4112,18,683,1529,436,22623,247
35643,26,469,1027,392,12563,77
9647,370,9630,1472,5463,58640,4167
833,29,764,1558,557,29874,207
34555,968,17213,1053,12849,108936,4364
66377,128,1659,273,1326,22201,333
9941,78,1637,1470,1069,13984,568
412,8,849,1561,555,10795,294
18800,29,1202,1350,865,15995,337
66417,645,7951,272,6474,54217,1477
25674,15,534,1225,377,13346,157
13513,2,260,1434,150,17145,110
3705,58,1577,1533,1102,24479,475
35524,365,15693,1029,10560,58651,5133
68202,98,1054,215,858,11456,196
34010,1348,17233,1065,11250,59570,5983
48567,3,41,810,32,4074,9
17759,22,427,1369,294,14149,133
5696,28828,1067418,1509,589830,4237220,477588
21835,0,0,1298,0,7423,0
12404,40,1424,1449,948,13416,476
52558,84,999,697,875,15669,124
2903,661,20297,1541,13053,78837,7244
63939,14,82,342,71,3653,11
22965,129,3223,1280,2148,38273,1075
6101,4,223,1504,152,22515,71
58683,120,2465,510,2085,24075,380
4635,16,481,1522,345,18491,136
9513,457,15351,1472,8997,48956,6354
21548,19,219,1302,179,5827,40
10733,126,4100,1465,2532,24530,1568
20132,166,3702,1327,2620,22391,1082
39146,29,736,940,576,12689,160
7587,6494,248298,1484,165898,658454,82400
6580,107,3129,1498,2093,21221,1036
57614,10,277,546,218,8688,59
52858,223,2269,686,1550,7425,719
39326,81,754,938,583,8819,171
58679,21,218,510,153,4072,65
59535,37,585,482,472,6775,113
3960,41,1236,1530,936,38814,300
18105,1051,28862,1362,20343,195841,8519
56822,21,235,566,180,5514,55
1363,23,691,1554,468,26502,223
38655,28,786,947,581,25905,205
61525,13,98,412,97,4022,1
27564,41,1324,1183,818,10489,506
35817,1194,19368,1023,15444,151709,3924
34254,15,576,1058,396,4701,180
65429,0,14,299,9,1521,5
24821,34,894,1243,604,23398,290
60599,160,2492,445,1960,29273,532
66005,10,163,284,114,2939,49
46767,79,831,837,660,20797,171
49816,70,940,774,728,16557,212
17887,47,840,1366,661,15217,179
31592,120,3345,1107,2427,27928,918
1431,59,2111,1553,1430,15705,681
3301,135,2290,1537,1652,25039,638
67440,4,45,238,38,2317,7
22405,26,828,1290,583,26812,245
59099,8,231,497,171,5104,60
22259,15,244,1292,214,8298,30
59404,14,210,487,154,7622,56
8246,228,4736,1478,3109,29740,1627
53726,337,4334,662,3442,29695,892
15122,3827,149110,1412,93995,520467,55115
1280,4,157,1554,96,26174,61
35077,78,2414,1040,1796,27586,618
57042,10,75,560,62,2592,13
49804,141,2121,773,1747,32196,374
56227,33,479,583,356,13960,123
19227,7,515,1343,343,12637,172
7509,23,1087,1486,696,32774,391
6571,35,1106,1498,812,41025,294
35027,8,136,1041,125,8082,11
19673,91,2188,1335,1484,17774,704
52316,51,646,705,440,29375,206
28840,4,121,1158,77,4933,44
17410,49,474,1376,331,9040,143
48711,27,689,806,530,31927,159
63949,197,3875,341,3048,16730,827
31282,145,3526,1111,2188,30742,1338
22616,414,8436,1286,5125,70918,3311
4299,4,279,1527,142,17458,137
67936,31,400,223,353,5001,47
6393,183,6066,1500,4222,35734,1844
11293,131,3375,1460,2252,24109,1123
30,44227,1763685,1567,967504,4323724,796181
16214,1125,20788,1395,14197,97252,6591
16037,55,1355,1398,1025,20418,330
9002,23,829,1475,553,16317,276
6368,19,1087,1501,782,10575,305
36662,92,1503,999,1024,15123,479
56418,133,1968,578,1482,15380,486
30052,199,4802,1134,3092,103084,1710
63175,48,511,363,415,5297,96
34459,28,830,1055,567,5558,263
59942,42,353,468,255,5393,98
24960,191,3603,1240,2498,53750,1105
56531,18,215,574,178,5839,37
32996,28,877,1084,580,7879,297
35969,79,1589,1019,1314,33384,275
13778,114,4262,1431,2873,37865,1389
16158,12,316,1396,226,7824,90
37056,6,396,990,263,8571,133
47264,182,3227,831,2780,29088,447
64006,31,240,340,163,4481,77
56013,56,1092,590,808,27874,284
25953,22,708,1219,498,31924,210
32823,72,2090,1087,1393,19844,697
15462,12,398,1407,280,14344,118
67657,23,163,231,137,2008,26
33799,278,6400,1069,4560,61960,1840
5259,73,2763,1513,1898,27618,865
52198,4,47,709,42,5315,5
5181,5,281,1514,206,5033,75
61905,12,189,399,144,5511,45
65807,8,130,289,104,4552,26
49666,7,75,778,50,10641,25
60173,16,318,460,189,4544,129
59315,16,105,489,85,4529,20
29020,249,5052,1154,3495,33527,1557
38333,1,50,956,35,3255,15
68225,5,94,214,77,2431,17
63224,1,23,362,11,2224,12
69673,9,137,165,106,6942,31
65862,25,431,288,330,9620,101
20609,6,248,1319,190,5719,58
61524,253,4541,412,3292,32908,1249
14569,8925,624199,1419,332695,1383683,291504
59220,215,2038,493,1726,20551,312
33332,2,189,1077,113,5687,76
18938,420,5205,1348,3172,23423,2033
60178,14,158,460,122,5850,36
26110,67,1462,1215,938,20314,524
55276,1211,10514,610,9284,93073,1230
18483,1,81,1356,58,4560,23
24402,2953,83893,1253,58023,243286,25870
27913,40,1116,1175,626,9615,490
29731,279,6009,1141,3901,63658,2108
21777,25,886,1298,540,5953,346
32675,25,620,1090,368,6049,252
56936,10,127,563,107,3190,20
51069,4375,87400,742,67272,225753,20128
58282,8,119,524,90,5245,29
69207,1,14,179,10,3209,4
49702,1397,22150,777,18530,131549,3620
44172,347,4339,867,3645,102658,694
58073,30,492,530,334,6577,158
29490,274,4246,1146,3394,23691,852
22829,116,4431,1282,2871,80228,1560
13338,13,483,1437,268,10940,215
55841,1,9,595,6,1440,3
66835,5,33,258,26,2562,7
21658,9,479,1300,262,10444,217
51085,2,34,742,24,4633,10
20286,120,5063,1324,3859,56703,1204
16497,13,298,1391,188,11770,110
25770,4,262,1223,168,17862,94
47149,53,875,833,673,17744,202
50662,64,558,753,456,9478,102
58447,81,782,517,694,13328,88
18633,22,650,1353,497,9665,153
1078,427,23724,1556,16325,137617,7399
56714,8,89,569,71,8320,18
15913,8,349,1400,193,8865,156
61411,105,2264,415,1566,16408,698
35678,1417,25104,1026,17693,168214,7411
4366,432,14713,1526,8870,41360,5843
65521,35,980,297,614,9676,366
19628,88,2199,1336,1501,23301,698
45325,1,56,855,48,4866,8
23420,56,1795,1272,1337,40092,458
9972,278,5163,1470,3432,34082,1731
6867,8,404,1494,282,7973,122
53224,216,2785,675,2328,16325,457
20623,145,4175,1319,2637,34962,1538
67282,4,36,243,28,3805,8
36098,0,0,1015,0,3103,0
37407,350,7006,980,5379,66610,1627
63061,4,48,364,41,3330,7
51216,5,47,738,33,4759,14
28862,135,3471,1158,2089,49009,1382
33714,91,1448,1070,1049,11932,399
19049,63,1346,1346,963,20961,383
13500,1881,44731,1434,29144,314262,15587
51025,80,1194,735,945,19239,249
69567,16,145,168,121,1650,24
19805,61,1891,1332,1294,10941,597
60562,19,388,446,289,7324,99
50129,95,1485,766,1172,23839,313
18344,24,1040,1358,625,8349,415
36757,20,332,999,281,11043,51
8301,103,1144,1478,752,9742,392
25332,0,0,1232,0,5551,0
18533,115,2303,1355,1725,25783,578
55642,5,59,600,43,4302,16
63887,3,62,343,52,4962,10
65993,4,102,284,82,4817,20
60744,7,99,439,73,2408,26
62833,77,707,372,557,5505,150
38130,6,149,961,110,8074,39
66507,13,201,269,168,4120,33
14937,4,285,1415,177,5906,108
5038,6,409,1516,285,17741,124
57417,283,3202,551,2639,30974,563
39030,149,3302,942,2519,23232,783
59958,10,134,468,85,3582,49
52661,33,765,693,573,15587,192
24654,10,428,1247,283,9986,145
60629,10,94,443,82,3151,12
22315,49,1452,1291,1023,12502,429
23880,69,1323,1264,932,14403,391
7374,94,5905,1487,4075,81144,1830
22668,7,312,1285,249,13690,63
3430,13,506,1536,319,12950,187
6999,95,2658,1492,1773,17570,885
70035,104,1121,152,1098,8720,23
61321,4,166,418,110,5755,56
26164,6,129,1215,89,16471,40
37306,23,591,983,442,13520,149
30874,21,901,1118,611,5795,290
63261,91,1393,361,1193,7881,200
7419,139,3988,1487,2586,41755,1402
68680,4,27,197,25,934,2
14938,130,2627,1415,1665,25845,962
47223,19,627,831,555,25643,72
1107,81,3246,1556,2022,17201,1224
4806,1278,26054,1519,17138,121465,8916
47649,6452,121330,825,98365,675595,22965
40201,0,0,926,0,2079,0
56913,58,1012,563,817,21645,195
36222,687,17817,1012,12205,58212,5612
28352,81,1305,1167,893,18765,412
45970,10300,188576,847,144125,768744,44451
63755,18,204,348,162,3482,42
32441,18,810,1094,499,8138,311
48032,155,1834,822,1479,19716,355
41245,4,201,910,112,3521,89
34873,7,151,1045,111,2158,40
69096,14,180,183,149,4886,31
58477,81,736,517,579,6902,157
1446,52,1557,1553,1104,30805,453
10073,1079,21109,1469,13532,99517,7577
59338,15,449,489,307,14610,142
15996,10,467,1399,312,6770,155
51302,736,10690,736,8125,104920,2565
927,2,161,1557,126,19516,35
26230,20153,887876,1213,519716,1846758,368160
37695,126,3335,972,2572,56172,763
2812,58878,2647433,1542,1326640,6785823,1320793
69288,151,3083,177,2628,28566,455
36488,70,536,1003,410,7758,126
7280,21,479,1488,315,12988,164
50587,1003,13685,754,10641,89964,3044
27069,42,851,1194,519,21163,332
60733,47,370,439,282,7672,88
23080,7,667,1278,451,15504,216
69410,0,80,173,57,3052,23
24755,6,181,1244,132,5297,49
27912,78,2041,1175,1567,12492,474
8476,35,1764,1477,1086,26328,678
34736,384,7676,1045,5434,81665,2242
62113,120,2547,392,2115,27784,432
5393,33,1913,1512,1287,24743,626
23431,1053,11552,1272,7246,64639,4306
46027,78,1396,847,1103,33566,293
12155,9,548,1452,310,45055,238
56304,62,1056,581,843,13105,213
26501,1228,28489,1207,18982,112801,9507
24505,79,3691,1250,1972,22477,1719
18489,888,14433,1356,11067,92258,3366
52431,7735,133706,701,104719,576906,28987
6514,134,3113,1498,2100,43172,1013
52113,0,0,712,0,3164,0
28083,13,335,1172,221,5965,114
37929,38,705,967,574,12661,131
33471,57,1330,1074,830,13081,500
37095,33,579,989,441,7057,138
33696,39,797,1070,560,8903,237
61813,77,1044,402,884,12997,160
23386,309,6953,1273,3982,36446,2971
56297,13,251,581,171,4574,80
10043,6,268,1469,157,17416,111
65226,28,344,303,275,7155,69
34640,35,510,1051,370,5853,140
34246,17,1698,1060,916,22058,782
29692,24,774,1142,460,13160,314
44995,4,83,856,65,7550,18
27904,115,3567,1176,2580,59409,987
22093,82,3095,1294,1983,16514,1112
28504,162,4397,1164,3083,50107,1314
51074,637,11752,742,9152,79159,2600
63543,116,1155,354,675,5527,480
9000,404,6912,1475,4713,50934,2199
64642,13,246,320,170,10907,76
20186,21,589,1326,422,7484,167
28475,29,616,1165,429,10938,187
18550,24,860,1355,581,21488,279
8153,81,2787,1478,1799,22968,988
21928,69,1872,1296,1302,27175,570
52583,8055,88626,696,69745,331774,18881
63229,29,236,362,180,12397,56
20804,4,104,1315,72,10178,32
53271,18610,264842,662,186489,1089352,78353
24893,44,730,1241,523,14492,207
54327,24,290,642,238,7941,52
48794,94,1166,803,940,24256,226
49520,34,384,782,278,4864,106
17374,12,416,1376,329,21130,87
37261,471,7979,983,6464,113912,1515
69599,8,136,167,112,4624,24
8046,42,415,1479,252,4299,163
45362,225,3118,854,2437,27175,681
36429,195,3401,1005,2604,26483,797
67821,2,15,226,14,1398,1
19858,151,2813,1331,1966,18083,847
28568,23,360,1163,253,19216,107
2132,58,928,1548,660,18812,268
32172,314,4704,1098,3045,29001,1659
19241,25,910,1342,618,9791,292
2920,152,6042,1541,3980,99378,2062
26615,31,1303,1204,975,12081,328
26077,31,626,1216,428,21741,198
47356,390,6507,830,5165,53605,1342
24501,27,577,1250,464,10205,113
4556,86,9682,1523,6313,32912,3369
25749,269,15529,1223,10194,71635,5335
49285,4146,70088,788,51707,280123,18381
62471,26,396,381,326,12001,70
23358,21,314,1274,228,7606,86
4874,217,7024,1519,4866,57232,2158
12667,4,328,1446,181,29621,147
17395,10,540,1376,414,16869,126
18682,24,842,1353,634,24662,208
57294,14,195,554,152,3506,43
35140,32,1067,1038,874,35553,193
26291,23,867,1212,526,10141,341
35840,8,264,1022,213,6948,51
14276,10,404,1423,317,9728,87
64402,3,54,327,54,5458,0
25417,32,398,1231,367,26545,31
30524,50,876,1124,591,9077,285
67988,827,18804,221,15569,108692,3235
2963,10,139,1540,92,5372,47
49875,67,774,773,625,11959,149
19880,201,6360,1331,4355,72507,2005
12346,62,936,1450,526,9713,410
33864,36,1240,1068,893,14107,347
1348,87,4775,1554,3292,35301,1483
2411,591,20529,1546,15196,56926,5333
15494,8819,247309,1407,148788,1029920,98521
68972,24,223,187,195,4018,28
32740,17,564,1089,330,8221,234
4784,5726,115537,1520,71883,370599,43654
2116,83,5236,1548,3437,46354,1799
49981,327,5506,770,4379,63257,1127
44531,22,270,863,199,5661,71
30099,147,2452,1133,1730,29473,722
27511,786,26224,1184,16674,128323,9550
35398,67,1604,1032,1164,13591,440
42522,1,35,890,22,1588,13
4389,26,574,1525,408,62148,166
33029,73,1733,1083,1325,25649,408
50535,48,585,755,449,10877,136
24310,724,28424,1255,17874,205758,10550
36489,26,330,1003,280,8368,50
3138,6,204,1539,145,22911,59
59287,37,265,490,217,6502,48
69009,1,41,186,28,1020,13
67470,37,479,237,382,4558,97
32108,123,1571,1099,1109,10717,462
1670,30,950,1552,679,22564,271
18238,45,1729,1360,1297,33143,432
63934,36,453,342,363,7396,90
37159,86,2032,829,1421,29022,611
22649,14,489,1286,334,7041,155
56474,373,5344,576,4281,28747,1063
29256,17,759,1150,387,21326,372
56553,2,31,573,27,6103,4
26278,25,547,1212,326,6398,221
25558,97,2181,1228,1501,16580,680
37605,3391,47936,975,35567,251873,12369
29999,195,5627,1135,3665,46653,1962
3576,9,448,1535,336,17918,112
31883,43,1877,1102,1177,13395,700
16712,9469,467187,1388,319110,1369307,148077
55273,33,324,610,270,14768,54
56533,1672,24737,574,20122,142174,4615
29824,3616,80828,1139,55930,272816,24898
54380,22,504,640,382,6903,122
51197,12,110,738,79,3630,31
60920,7,123,432,51,6342,72
14734,5,133,1417,81,8944,52
9729,22,339,1471,228,7296,111
40302,775,13181,925,10476,45644,2705
25261,4251,127507,1234,85719,505393,41788
67584,6,83,233,74,3675,9
54547,43,789,633,635,6290,154
21760,28,781,1299,512,13527,269
31231,134,4675,1112,3762,32230,913
19787,3,110,1333,82,10495,28
13189,161,3557,1439,2401,23399,1156
24097,138,5707,1259,3724,38969,1983
59677,7,52,477,42,2345,10
25040,5,480,1238,306,18171,174
55657,34,679,599,520,8666,159
58629,15,211,512,169,4386,42
52625,118,970,694,831,22418,139
37246,374,13263,984,10696,76765,2567
53281,56,867,674,700,7848,167
52464,39,320,699,238,6376,82
20780,976,21621,1316,14449,224507,7172
62116,15,123,392,95,11615,28
66444,3,26,271,17,1112,9
40203,18,620,926,447,9475,173
42279,5,97,894,68,3930,29
69580,85,487,166,409,10509,78
32465,112,3793,1093,2038,30069,1755
62538,10,109,379,86,3623,23
30084,32,646,1133,425,12693,221
11814,62,1517,1456,790,14756,727
54831,28,279,622,213,6558,66
37447,12,285,979,191,13180,94
41322,97,1401,897,1093,19823,308
8986,740,26760,1475,18279,105074,8481
17792,9,220,1368,135,4656,85
19943,2780,42965,1330,29465,139472,13500
28493,166,2636,1165,1701,37833,935
51641,0,24,726,18,2641,6
22479,23,1070,1289,761,18414,309
64233,10,138,332,121,8867,17
45115,38,485,857,349,3747,136
26269,2793,226035,1212,171792,251533,54243
26453,185,4534,1208,3068,21717,1466
55471,0,30,604,19,1840,11
34003,41,754,1065,559,59010,195
10252,6,445,1468,256,6978,189
62582,16,133,378,97,3194,36
14028,67,1699,1427,1007,15372,692
36113,45,720,1015,612,15454,108
60106,38,553,463,477,8449,76
3441,49,1555,1536,1084,14064,471
65297,24,241,302,205,5710,36
8699,49,2597,1476,1548,17604,1049
14556,0,0,1419,0,7270,0
7854,38,1087,1481,741,20064,346
8683,1315,36928,1476,24142,190074,12786
62735,219,3537,374,3030,25414,507
68651,19,269,198,186,3614,83
1435,24,640,1553,412,26095,228
34717,7,135,1048,95,7027,40
64972,2,20,309,16,1796,4
59507,117,1696,483,1294,26299,402
46888,90,1134,836,867,15489,267
29701,39,1071,1142,615,8328,456
19237,54,1319,1343,1034,9715,285
33161,354,3554,1081,2466,22216,1088
40369,123,2060,924,1426,40019,634
8452,245,5618,1477,3719,47713,1899
62443,9,103,382,77,4846,26
13375,0,0,1436,0,7473,0
51959,6,119,717,84,6073,35
7081,50,1511,1491,926,14139,585
27127,4,317,1193,202,9775,115
68293,7,48,211,39,2617,9
34123,7,194,1062,138,2462,56
55299,103,873,608,741,8651,132
6241,210,3534,1502,2694,20310,840
26329,3374,79699,1211,53633,328261,26066
51575,815,14503,728,11273,116173,3230
61779,4,90,403,75,8666,15
1487,10,814,1553,527,14058,287
54114,64,709,649,568,5543,141
69266,211,6293,178,6054,26000,239
38441,607,9445,953,7477,84616,1968
33659,48,1143,1071,809,18663,334
38126,49,566,961,450,13169,116
61100,2,37,425,27,2321,10
58493,59,501,516,387,9812,114
63537,136,1133,338,1021,11127,112
15669,38,1353,1404,856,7733,497
26360,37,638,1210,410,12318,228
40512,8190,289757,921,204344,737418,85413
66095,507,6950,281,5775,64280,1175
31651,9,280,1106,175,5335,105
14465,1015,29859,1420,20172,232366,9687
34306,773,35848,1059,27298,126571,8550
16656,0,0,1389,0,7248,0
12353,16,951,1450,466,9198,485
54389,13,175,639,156,10973,19
67744,1,31,229,19,5650,12
56409,4,53,578,44,3568,9
36073,210,2674,1016,1983,19138,691
25389,16748,457766,1231,283214,2060098,174552
12315,12,469,1450,292,27989,177
48779,8,236,804,190,6939,46
52382,21,370,703,283,6805,87
56378,89,1005,579,869,7556,136
40406,32,359,923,290,4965,69
12981,170,7835,1442,3924,99369,3911
38445,10,184,953,117,5651,67
45926,63,1503,848,1135,12859,368
25356,103,1948,1232,1426,35425,522
23533,65,1228,1271,790,16766,438
64002,13,202,340,169,4099,33
48870,21,297,801,248,6304,49
28488,647,40883,1165,27373,141544,13510
46799,39,410,837,341,6391,69
1535,46,851,1553,679,40127,172
69002,53,456,186,406,6133,50
16108,108,1938,1397,1269,13586,669
40522,41,363,921,300,5551,63
15266,2,111,1410,65,6632,46
20819,59,1610,1315,1139,48891,471
40727,5,97,918,75,5778,22
3962,28,852,1530,661,12553,191
63154,5,91,364,60,5683,31
225,3322,158166,1563,92837,386380,65329
20800,15,670,1315,469,9128,201
30565,43,2702,1124,1642,21873,1060
1461,41,1682,1553,1154,28058,528
3590,201,3936,1535,2974,58118,962
70342,4,43,143,39,4345,4
57733,83,975,542,854,10902,121
14761,75,2379,1417,1597,22877,782
56133,30,272,586,220,9293,52
41356,50,1008,908,848,20385,160
31344,6,375,1110,241,11461,134
23301,10,313,1275,214,8063,99
52947,148,2578,683,2087,11080,491
3653,2,126,1534,84,15542,42
37598,83,1070,974,837,19349,233
26886,4,341,1198,222,9273,119
17732,41,1557,1369,1038,17429,519
21742,39,1471,1299,851,13825,620
13641,11974,353475,1432,221865,1298461,131610
67019,17,155,252,118,3186,37
32480,36,1465,1093,973,22575,492
46741,1606,34598,838,23391,72853,11207
26787,40,644,1200,445,9421,199
60590,17,270,445,220,12829,50
37327,61,1234,982,1020,14586,214
67218,29,357,245,276,2961,81
11933,144,5020,1454,3099,43219,1921
1601,10700,839573,1552,428476,3743958,411097
7205,703,28453,1489,17867,152358,10586
20098,179,7354,1327,4754,67589,2600
15046,30,1102,1413,792,20642,310
21497,1,33,1302,27,3648,6
63464,66,831,355,628,9083,203
20062,32,1210,1328,801,9847,409
7123,26,1227,1490,820,82195,407
6464,10,198,1499,131,35564,67
67264,14,126,244,88,2083,38
54701,5,30,627,28,4653,2
17218,413,11304,1379,7942,52056,3362
22729,16,383,1284,250,10918,133
20499,85,4734,1321,3461,36771,1273
15161,32,1187,1412,857,23432,330
60934,4798,80938,431,64906,225586,16032
66607,25,378,265,321,8946,57
27421,95,1871,1186,1176,17959,695
23763,45,1411,1266,971,29953,440
24144,11,322,1258,202,7444,120
62441,23,658,382,485,14218,173
42462,28,294,890,209,9159,85
25297,12,518,1233,338,12614,180
3201,5061,152480,1538,86654,520758,65826
59305,3172,90539,490,68987,365842,21552
55351,56,867,608,647,7126,220
30168,13,677,1132,400,9867,277
13795,111,1523,1430,909,16056,614
64484,10,89,324,76,4424,13
49853,1018,12837,773,9788,93516,3049
1268,22,1135,1554,840,39603,295
24058,32,685,1260,497,12168,188
6321,226,7636,1501,4784,43981,2852
36712,277,5973,999,4994,39889,979
35626,9,160,1027,124,7404,36
47138,8,260,833,192,9371,68
17087,176,2484,1381,1674,44382,810
1015,9,215,1556,145,19311,70
2215,634,10737,1547,7253,163630,3484
52430,6,161,701,128,7713,33
63210,10,125,362,97,3947,28
68940,3,14,188,11,1913,3
2327,35,1276,1546,953,46930,323
19501,621,19794,1338,14301,205832,5493
13199,70,1642,1439,1098,24906,544
65803,12,157,289,128,4788,29
21677,1,103,1300,72,4633,31
66137,4,76,280,54,3796,22
7756,27,1885,1482,1131,38719,754
32647,210,4508,1090,3264,42350,1244
64398,83,884,326,697,8212,187
62065,93,1078,376,902,8830,176
50988,262,5196,744,3548,54005,1648
51976,290,3470,717,2906,32336,564
57607,163,3558,546,2836,33101,722
20314,23,451,1324,335,10423,116
56518,8,142,574,109,5171,33
19070,55,1742,1346,1357,45962,385
47495,52,435,828,356,11680,79
62140,113,1061,388,820,12374,241
20343,1575,60797,1323,36127,187081,24670
18593,1807,47600,1354,31562,219041,16038
23571,249,5746,1270,3865,19933,1881
62231,9,185,388,159,3245,26
57418,7,65,551,55,2593,10
22963,10,452,1280,273,11876,179
21124,16,860,1309,445,15700,415
66950,11,114,254,76,3297,38
63535,3,96,354,68,4574,28
61111,13,200,425,146,2379,54
35084,83,1625,1040,1346,19327,279
25353,38,940,1232,669,27599,271
27865,73,702,1176,545,7318,157
60863,11,90,434,51,5297,39
20354,64,1607,1323,1120,37739,487
67506,0,15,236,10,3859,5
18970,535,13704,1347,9584,78001,4120
49559,3,110,781,94,6707,16
16771,19,820,1386,587,13256,233
20836,1344,37679,1315,26499,369255,11180
41402,39,331,908,273,8186,58
7135,54,2590,1490,1696,66206,894
24737,1396,30490,1245,21470,110627,9020
52853,5274,108619,686,84455,356254,24164
23769,68,2423,1266,1635,38445,788
69220,75,999,179,906,9624,93
69353,40,598,175,517,5840,81
29308,22,592,1149,471,21903,121
66223,21,257,277,195,5538,62
17877,150,3822,1366,2859,30705,963
36713,57,1789,999,1493,39561,296
29640,120,1308,1143,871,7540,437
34258,247,4954,1058,3637,26060,1317
8606,16,938,1476,596,14418,342
63307,5,29,360,20,1694,9
37831,618,14401,969,11812,45896,2589
5461,30,911,1511,622,19718,289
63738,111,1304,348,939,11990,365
40796,4,107,917,80,7708,27
4844,6,182,1519,134,10115,48
50230,12,147,764,118,5774,29
16084,5602,131070,1397,89588,339174,41482
15093,6,710,1413,458,6072,252
21857,1093,25008,1297,15756,148845,9252
38471,56,937,952,720,12768,217
47385,90,970,829,789,7235,181
23851,0,0,1265,0,13460,0
13794,8,375,1430,191,9713,184
51573,65,1083,728,888,13700,195
40209,384,4257,926,3371,36718,886
13656,188,3418,1432,2594,26731,824
12339,16,689,1450,413,23426,276
70368,5,61,142,58,2386,3
14568,476,14467,1419,10093,100001,4374
70008,15,100,154,89,1718,11
68159,28,504,215,398,7332,106
49730,60,588,776,476,14818,112
60575,196,3456,445,2552,27392,904
30047,33,1230,1134,779,31549,451
30644,5,183,1123,150,6974,33
30795,29,1337,1119,833,13229,504
55060,92,675,615,544,11384,131
19213,31,780,1343,555,24864,225
54016,8,110,652,81,5701,29
17128,27,776,1381,643,25626,133
68814,12,187,193,156,4375,31
27975,85,1865,1174,1200,19126,665
69693,11,227,164,154,8744,73
63981,144,1428,340,1057,12778,371
46513,7,109,841,85,6156,24
60477,179,2224,449,1750,51984,474
58241,2,30,525,22,4702,8
5497,15,397,1511,243,16132,154
6567,20,492,1498,344,19383,148
27833,395,9990,1177,6458,53848,3532
22512,19,1050,1288,787,20037,263
17373,1,70,1376,55,6324,15
54441,95,900,637,626,8120,274
27554,1757,31668,1183,21887,100761,9781
41123,127,1371,911,1039,16079,332
70015,53,1060,153,980,12975,80
55974,286,3938,591,2776,27588,1162
49925,5,155,771,134,8606,21
6878,20,581,1494,407,17907,174
54473,3250,44352,636,35036,255065,9316
1650,47,1316,1552,905,17599,411
53296,119,1771,674,1193,16113,578
60002,189,6688,466,3952,47847,2736
60541,43,341,446,291,3111,50
30783,45,625,1120,506,11490,119
33601,12,349,1072,223,5754,126
32630,27,774,1090,587,18293,187
60709,8,154,440,134,15636,20
13214,125,5123,1439,3197,90681,1926
55638,125,3274,599,2089,17338,1185
67910,16,218,223,173,8501,45
53362,64,806,672,646,20731,160
45129,14,137,857,105,4393,32
36078,627,6953,1016,5875,56181,1078
37584,556,14206,975,11051,62386,3155
39346,6,111,938,88,3881,23
68567,460,10250,201,8932,74392,1318
32697,408,12476,1090,7825,115748,4651
1922,14,877,1550,623,14225,254
24182,52,1468,1258,927,38674,541
52823,149,1927,687,1621,19022,306
55374,23,317,607,252,13181,65
811,12,473,1558,316,26463,157
25092,0,0,1237,0,8165,0
54608,22,658,631,474,22527,184
65240,34,226,303,187,4928,39
14740,7,237,1417,153,13927,84
51761,6,42,723,37,4179,5
41288,3,100,909,59,6843,41
68679,4,92,195,56,6203,36
52436,865,14653,701,12144,42037,2509
48786,8,408,804,259,9706,149
5193,117,2974,1514,1997,53376,977
5822,55,1172,1507,820,19307,352
3780,1286,29533,1532,20209,180946,9324
26331,2,267,1211,178,8701,89
58331,313,5305,522,4293,35862,1012
57625,84,1125,545,929,32236,196
41314,6,193,909,146,21243,47
23643,204,5422,1269,3499,38377,1923
26603,12,262,1204,177,12741,85
22735,127,2431,1284,1679,21335,752
49240,225,3482,789,2690,34204,792
20709,184,3021,1317,2038,27681,983
35863,929,15183,1018,12024,131060,3159
45570,11,147,851,98,2627,49
2610,157,9633,1544,5836,47279,3797
1782,1063,32693,1551,22532,131979,10161
23930,7,166,1263,117,4355,49
49061,74,1288,795,1020,14323,268
22338,90,1765,1291,1135,16202,630
52505,226,1873,698,1333,15039,540
7169,2026,45779,1490,28680,309856,17099
54659,26,226,628,208,9898,18
33436,11,196,1075,122,4710,74
51359,4,153,734,122,4254,31
22197,229,4660,1293,2583,33597,2077
66134,48,1636,280,997,16190,639
27613,0,0,1181,0,17932,0
60324,18,229,455,182,5499,47
17120,305,8405,1381,6106,59485,2299
36842,9,273,997,229,19298,44
63071,14,193,366,150,2758,43
62517,21,410,380,335,4061,75
23655,0,0,1268,0,8804,0
50875,5034,131070,747,96348,422482,34722
140,2296,150554,1565,101094,561820,49460
50544,109,1147,755,933,29622,214
52334,25,368,705,280,10857,88
54243,61,534,645,413,8041,121
35826,618,8477,1022,6577,56928,1900
7056,163,4302,1491,3067,57669,1235
67810,11,120,226,111,3611,9
18977,183,4398,1347,3226,42394,1172
43505,84,1275,874,1058,17314,217
59340,2806,48888,489,39204,197098,9684
27228,19,547,1191,350,4892,197
52963,4,51,683,35,3671,16
29830,70,2712,1139,1730,20262,982
56569,69,1089,573,893,10989,196
15620,12,347,1405,265,7806,82
29532,0,0,1145,0,39871,0
28109,405,14076,1172,9067,126330,5009
990,1750,92655,1556,54568,264667,38087
67667,14,170,231,105,4543,65
37469,77,2386,978,1490,11442,896
17508,9,297,1374,213,8020,84
18570,14,245,1354,198,23929,47
29385,116,3265,1147,1995,26083,1270
62737,15,190,374,138,5408,52
30230,16,585,1131,499,11098,86
36538,16,396,1002,306,12809,90
58021,27,459,533,362,10837,97
29108,4,307,1153,189,6390,118
60433,8,129,451,111,7874,18
26887,20,235,1198,156,6952,79
55713,18,381,598,285,8193,96
65434,67,1051,298,757,13419,294
19966,52,1397,1330,1094,12736,303
50144,290,4390,766,3557,43481,833
30351,102,1867,1128,1331,38362,536
48729,28,361,806,283,11036,78
2185,53,2984,1547,1901,27841,1083
13083,54,2322,1440,1490,25030,832
26885,23,343,1198,241,9541,102
36158,2318,40140,1013,31524,198856,8616
33620,46,946,1072,685,23886,261
25968,1406,35558,1218,21817,204606,13741
34,4289,184015,1567,85485,689446,98530
9992,38,1126,1469,712,19652,414
68286,62,1256,212,1096,23144,160
20221,30,630,1325,495,17635,135
43725,201,4233,872,3274,51684,959
22911,95,1932,1281,1358,19799,574
19699,68,2949,1334,1968,71499,981
65400,73,601,299,494,7384,107
9696,4,214,1471,166,8473,48
53090,142,1368,679,1085,19898,283
35124,227,3585,1033,2559,27769,1026
17127,42,2911,1381,2185,39654,726
16923,4,96,1384,67,4056,29
4037,1,55,1530,37,13465,18
44327,33,615,865,483,12794,132
60363,25,463,453,351,6279,112
35438,33,614,1031,435,11639,179
52378,81,723,703,606,14564,117
53064,16,346,680,226,10030,120
26660,1598,25286,1202,16927,147413,8359
42708,101,763,886,618,12494,145
27783,6632,215399,1179,120431,489219,94968
46014,13,281,847,206,5963,75
1126,11,562,1555,419,17862,143
17176,73,1072,1380,803,20302,269
13321,2480,71687,1437,47551,109007,24136
11346,0,0,1460,0,11072,0
68527,49,704,203,611,10252,93
61368,5,50,416,37,3794,13
1680,6,330,1551,241,29003,89
64405,2,24,327,19,1994,5
35771,38,1517,1024,1106,19928,411
50536,9,83,756,77,3142,6
16981,609,14927,1383,10201,131606,4726
20542,4,250,1320,164,7500,86
18245,27,499,1360,378,12561,121
67538,8,64,235,48,2342,16
8086,44,663,1479,393,6510,270
6844,76,3508,1494,2037,49569,1471
38170,68,2413,960,1812,16426,601
2904,16,804,1541,512,34280,292
29673,466,6924,1143,4932,39142,1992
63327,21,293,356,239,4950,54
64416,18,364,327,266,3881,98
7370,46,1697,1487,1239,32613,458
3758,176,7029,1533,4971,66301,2058
19635,87,3931,1336,2800,29273,1131
1036,2700,63060,1556,43982,205827,19078
32671,11,572,1090,382,10880,190
64943,19,182,310,139,8979,43
53744,9,174,662,146,5726,28
52045,2,47,714,32,2745,15
63688,16,258,349,175,5853,83
34133,32,1011,1062,577,10959,434
57919,28,393,536,317,11530,76
62727,32,358,374,290,6097,68
3838,614,46172,1532,27454,302657,18718
69373,5,27,174,19,735,8
48833,3,94,802,65,14497,29
67331,11,169,242,131,5075,38
4658,12,793,1522,575,16326,218
30972,48,898,1116,634,20374,264
6199,133,3741,1503,2615,26975,1126
19235,2,164,1343,118,23725,46
59506,291,5942,483,4327,31878,1615
12885,166,7066,1443,4312,93592,2754
50546,1829,21958,755,17419,124952,4539
41984,185,3084,898,2413,35619,671
24968,80,4139,1240,2482,21541,1657
57037,14,362,560,287,4651,75
9621,1241,27033,1472,16916,97206,10117
40539,259,4026,921,3314,50716,712
34099,288,7538,1062,5108,45008,2430
61747,24,267,405,232,4223,35
53807,8,189,660,104,12746,85
56546,18,180,574,130,4703,50
56093,199,3421,587,2434,50640,987
9041,60,1050,1475,723,19362,327
29506,0,0,1145,0,10640,0
729,10,689,1559,485,13613,204
56034,43,777,589,572,18714,205
52621,38,602,694,458,13880,144
68599,19,270,200,217,9264,53
58844,22,230,505,184,4425,46
49864,35,176,773,150,6223,26
28980,325,6421,1155,4078,59477,2343
29124,32,1614,1152,897,19458,717
26437,2294,69030,1208,42195,330515,26835
7578,19,450,1485,353,11287,97
35259,10,260,1035,167,6890,93
10456,3528,114875,1467,76181,627792,38694
27531,8065,135058,1184,82633,347547,52425
27463,8162,271653,1186,151707,977815,119946
17321,72,1435,1377,1052,12269,383
49605,1391,21214,780,16140,133965,5074
9614,4950,345581,1472,202253,1013513,143328
26831,31,1484,1199,854,12631,630
11454,205,7304,1459,4571,47303,2733
27614,1300,43391,1181,30090,185454,13301
5409,130,4982,1512,3334,31631,1648
11259,3249,112505,1461,58881,599958,53624
12123,40,1056,1453,708,19298,348
58499,7,90,516,73,1869,17
18971,199,8197,1347,4885,118916,3312
58716,169,2304,509,1810,17123,494
51928,7,91,718,68,2780,23
7316,79,12440,1488,5753,49488,6687
21567,28,678,1301,498,32982,180
11842,7,510,1455,271,14632,239
15666,743,20369,1404,13290,160673,7079
51467,1933,60393,731,45934,333265,14459
36248,26,267,1011,209,8977,58
37943,5,130,966,105,3897,25
58822,194,1699,506,1342,15102,357
8559,65,2417,1477,1713,45499,704
2647,26,997,1544,677,10457,320
520,177,10085,1560,6628,178256,3457
4910,8259,250895,1518,155024,576633,95871
26683,24,378,1202,217,8685,161
11646,148,3274,1457,2231,49002,1043
29947,16,741,1136,418,12394,323
58214,342,5776,526,4886,39103,890
375,17,868,1562,654,16342,214
1854,487,18361,1550,12900,129116,5461
59414,62,1262,486,921,14986,341
10050,2501,57687,1469,35491,121524,22196
64874,304,8770,313,3854,66077,4916
50380,28,438,757,361,6849,77
68539,20,317,202,309,14307,8
260,47,1247,1563,922,28332,325
22300,2935,113340,1292,81087,373714,32253
24367,1216,21329,1253,15022,114778,6307
24204,5,967,1257,624,19675,343
33300,100,1858,1078,1351,9309,507
17975,12,486,1364,285,6546,201
2905,964,30243,1541,18274,122224,11969
24638,25,1461,1247,952,15713,509
58060,6,142,531,70,3938,72
23608,450,17484,1270,11086,231839,6398
51950,528,6152,715,4562,80778,1590
68431,7,92,207,71,2819,21
9518,9,246,1472,173,8432,73
32925,1,114,1085,71,4853,43
16379,6,696,1393,566,16922,130
33858,5,283,1068,196,7137,87
66170,86,881,278,717,4849,164
52547,19,178,697,149,2790,29
7800,126,4053,1481,2705,29631,1348
54344,1384,15278,641,12519,120283,2759
7072,24,345,1491,250,10263,95
6590,33,781,1497,559,17214,222
37096,19,343,989,266,7202,77
7008,3,662,1492,504,38985,158
13817,4,169,1430,110,8045,59
68756,78,1002,195,817,11521,185
24489,83,3021,1251,1858,19827,1163
15935,219,4778,1400,3136,20697,1642
64343,15,270,329,199,7318,71
3253,47,991,1538,706,31935,285
63167,88,1242,363,1020,11727,222
53004,250,3068,682,2160,43734,908
55353,171,2637,607,1991,27342,646
11274,0,0,1460,0,11581,0
49843,48,376,774,268,3689,108
51271,8,204,737,174,6612,30
2597,89,2400,1544,1546,26884,854
31478,18,749,1109,463,7869,286
19254,27,359,1342,260,10354,99
37556,1888,47352,976,35206,96907,12146
61047,7,73,428,51,4170,22
18921,8,134,1348,99,10526,35
43693,49,571,872,439,14372,132
53908,323,10965,656,8830,41861,2135
16831,364,6711,1386,4508,45948,2203
56316,3,36,580,31,2719,5
50287,37,486,762,405,18049,81
65960,12,73,285,62,5202,11
14846,94,1663,1416,1028,8394,635
28854,8,356,1158,161,11936,195
14076,140,3532,1426,2364,56831,1168
332,43,1479,1562,1054,23613,425
10654,46,1930,1465,1265,18449,665
50805,135,1530,749,1244,25500,286
25163,895,15194,1236,10383,70547,4811
9343,205,4003,1473,2643,23059,1360
41008,61,1188,913,965,27622,223
4314,24,1282,1526,959,18380,323
629,3,206,1559,150,11344,56
55010,6,41,617,33,2860,8
3686,161,5911,1534,4260,24315,1651
38252,83,763,958,579,7043,184
30254,1518,24474,1130,18113,175095,6361
36956,196,4321,993,3113,22593,1208
16559,4,325,1390,215,12467,110
22893,53,2228,1281,1492,27896,736
58058,88,1235,531,923,22287,312
9958,241,7489,1470,4418,80809,3071
24423,10,380,1252,236,7900,144
18618,6,444,1354,351,15941,93
24180,115,2712,1258,1814,12740,898
7663,531,24326,1483,15587,238027,8739
66900,31,450,256,363,6447,87
25552,423,14090,1228,9394,141138,4696
23679,42,1196,1268,888,21229,308
21862,8,301,1297,207,20598,94
8818,40,1073,1475,745,6230,328
25180,14,256,1236,186,12482,70
34630,3,153,1051,103,6155,50
10151,53,1940,1469,1071,13593,869
67968,43,408,221,342,10264,66
12902,699,12196,1443,7595,44457,4601
56524,226,4230,574,3389,29123,841
3607,59,1763,1535,1197,7349,566
1805,30,1123,1551,700,14970,423
30352,161,11503,1128,7973,49980,3530
62283,59,916,386,703,17188,213
51106,63,1143,741,904,10107,239
12725,59,1664,1445,974,30509,690
60941,157,2528,431,2039,40399,489
56998,6124,124205,560,85636,594757,38569
25516,2737,54564,1229,36973,166871,17591
8637,13,632,1476,415,10377,217
15225,940,19488,1411,14693,94113,4795
15233,3,198,1411,139,15294,59
27124,20,402,1193,249,5620,153
14426,87,1480,1421,976,13052,504
60725,23,328,439,239,3426,89
66827,60,892,258,701,8723,191
33370,398,29780,1077,20961,34037,8819
23837,4,120,1265,91,6331,29
12199,12,358,1452,205,10649,153
15453,13,216,1408,159,5285,57
607,132671,17112581,1559,8224648,19251164,8887933
33183,49,2105,1080,1695,64760,410
2884,10,288,1541,203,16192,85
40752,36,710,918,531,7589,179
6736,16,718,1496,479,11418,239
58624,3,37,512,34,3769,3
70563,1,24,135,21,1419,3
61849,17,389,402,270,3635,119
23199,77,1224,1276,986,24972,238
60053,7,191,465,146,4304,45
69382,47,800,174,624,6137,176
18453,32,506,1356,360,10618,146
33790,8,187,1069,127,7977,60
67225,1,114,245,82,2076,32
10112,20,637,1469,474,12185,163
38076,53,737,962,661,11979,76
39284,8,110,939,85,2053,25
11704,320,4636,1457,3004,23024,1632
12483,20,874,1448,457,11952,417
66914,16,215,255,133,4745,82
55971,4,139,591,93,6023,46
2157,253,9278,1548,5442,76125,3836
66089,56,1149,281,991,15075,158
65281,11,181,302,135,4082,46
62868,57,705,371,624,8656,81
56952,6,53,562,37,3641,16
53510,3,76,669,58,4131,18
33036,12,367,1083,245,7952,122
28266,24,924,1169,607,14605,317
21724,505,17003,1299,10824,97814,6179
27659,121,3122,1181,2000,52463,1122
61936,75,1240,398,1013,21934,227
9340,76,3393,1473,2312,45477,1081
10686,188,6642,1465,3748,41057,2894
62880,47,780,371,553,9141,227
27594,4409,140946,1182,90272,678820,50674
24122,20,588,1259,459,6626,129
23890,930,22920,1264,15013,140748,7907
29477,63,1754,1146,1211,28162,543
2596,395,5308,1544,3491,43512,1817
69409,5,68,173,57,1608,11
7598,15,775,1484,535,32147,240
40685,153,2663,918,2275,54034,388
68996,14,299,186,233,5390,66
58777,52,543,507,427,15665,116
24358,8,125,1253,94,7248,31
67497,9,199,235,148,5301,51
13325,67,4190,1437,2680,49676,1510
70295,4,38,144,32,1176,6
14474,699,20258,1420,13481,74595,6777
58990,397,6933,500,5090,37916,1843
40295,36,471,925,362,8113,109
57178,63,1125,550,873,8470,252
22196,215,6629,1293,4637,48601,1992
10786,0,376,1464,214,14659,162
19656,135,5128,1335,3617,44999,1511
23482,192,5257,1272,3098,40336,2159
22722,525,7108,1284,4977,91442,2131
35214,2,44,1036,30,5644,14
24385,448,21269,1253,15750,87541,5519
26280,282,7861,1212,5190,71043,2671
58890,11,140,504,118,3550,22
62395,10,149,383,117,2697,32
24521,1815,74811,1250,47624,177223,27187
17427,1820,33709,1375,22980,108459,10729
55598,874,8104,601,7423,55004,681
62299,33,356,386,289,4642,67
58854,42,435,505,350,9892,85
41028,56,711,913,549,20426,162
10479,116,2508,1466,1508,35035,1000
6528,8,330,1498,237,28934,93
65941,156,4999,286,3673,36407,1326
4669,37,1091,1521,843,25494,248
65043,10,54,307,43,4380,11
61924,16,104,399,81,2489,23
33815,7,189,1069,155,11449,34
17742,217,5807,1369,4235,34276,1572
57964,26,287,534,230,8185,57
56466,127,1113,576,933,10403,180
7098,11,516,1491,347,33733,169
23806,2,201,1265,153,16899,48
58741,2,41,508,28,5951,13
59981,143,1739,467,1529,17675,210
23026,37,821,1279,561,14495,260
19425,1414,35663,1339,24383,192671,11280
70115,3,82,150,76,3978,6
62914,3,49,370,39,1857,10
34799,1083,17172,1047,12555,98535,4617
66942,20,274,254,190,9148,84
40731,378,8221,916,6437,51642,1784
50882,2451,38161,747,25636,196909,12525
65502,852,9200,297,7305,69112,1895
65257,51,533,303,425,6984,108
22940,1399,32762,1280,24276,100083,8486
47881,5,91,824,75,11161,16
48488,75,950,814,733,21166,217
31191,5233,110757,1113,68526,420218,42231
11852,33,946,1455,592,10227,354
55524,1291,20971,603,17649,89758,3322
54222,146,1054,645,810,22959,244
35156,17,214,1038,144,3333,70
60104,14,213,463,159,5609,54
57718,21,244,543,207,3892,37
14848,7,1021,1416,599,14830,422
13710,31,562,1431,382,16613,180
32120,927,19158,1099,12838,110856,6320
19651,152,4443,1335,3088,38488,1355
2842,63,3441,1542,2286,16897,1155
42744,57,1408,885,1023,20709,385
36124,1177,19390,1015,13029,85910,6361
4097,11,632,1529,467,10508,165
29103,66,893,1153,515,8324,378
12574,32,4567,1447,2716,18836,1851
63162,1,8,363,6,2642,2
32689,122,2134,1090,1570,37407,564
35338,29,545,1033,393,7579,152
15709,50,1304,1404,920,14342,384
2139,15,674,1548,440,12275,234
39248,5,143,939,125,6017,18
10119,23,796,1469,512,12387,284
3362,25,452,1537,333,14924,119
52005,21,209,716,166,4935,43
219,30674,948804,1563,434485,1892141,514319
9749,114,2782,1471,1653,29261,1129
6422,148,3871,1500,2291,27532,1580
53553,39,233,668,184,10584,49
21217,8,399,1307,266,4710,133
2306,79,3449,1546,2414,92839,1035
14709,2880,74402,1418,52674,379123,21728
29679,57,1708,1143,1071,9985,637
10163,343,7310,1469,4235,56160,3075
15003,178,3468,1414,2412,24951,1056
13448,841,16682,1435,11512,53040,5170
12145,86,2782,1452,1850,51426,932
62598,79,729,378,568,14137,161
54335,19,192,641,147,23396,45
7012,95,2752,1492,1978,85572,774
39526,2,41,936,34,1679,7
1099,7,341,1556,227,16330,114
54428,14,172,638,131,3536,41
36370,388,4634,1007,3858,53325,776
50488,66,991,757,800,16086,191
70456,11,184,138,170,2648,14
53257,0,4,675,3,1612,1
1767,328,19586,1551,14226,141136,5360
30331,339,6720,1129,4844,39135,1876
67741,626,7580,229,5630,34636,1950
21299,16,515,1306,395,13813,120
1541,31,1107,1553,796,28222,311
63049,69,1732,366,637,10790,1095
50917,34,458,746,419,16183,39
38086,369,5824,962,4205,41831,1619
56685,376,4072,570,3202,35951,870
14401,14,314,1421,243,8196,71
20195,9,423,1326,317,14472,106
18934,6,676,1348,463,6211,213
56132,18,351,586,226,9154,125
60179,342,5355,459,4393,67170,962
63273,103,1482,361,1226,17476,256
10067,542,14610,1469,8778,78604,5832
67036,15,174,251,145,3660,29
11124,15,585,1461,337,8435,248
38044,56,1135,963,821,34391,314
30686,33,537,1121,350,6440,187
58556,36,595,514,509,16021,86
55538,108,1071,603,811,14726,260
21580,401,9858,1301,6549,76518,3309
67638,82,882,232,690,13921,192
3470,9,299,1536,200,12148,99
55343,8,85,608,70,7462,15
52517,2,57,698,51,4100,6
29345,18,414,1148,266,17522,148
31621,94,3210,1106,2131,37245,1079
39427,58,883,937,685,9501,198
27072,9,329,1194,230,9881,99
55983,94,1839,588,1393,13551,446
54305,706,20067,642,16163,115858,3904
30720,48,1250,1121,754,19620,496
11200,59,1150,1461,744,9812,406
52751,10,170,690,129,7618,41
11525,645,26288,1458,17060,192382,9228
30429,21,935,1127,620,7985,315
14134,726,6167,1425,4178,55806,1989
15684,2,73,1404,49,3183,24
18220,166,6917,1360,4725,106479,2192
29162,10,312,1151,198,20482,114
26737,20,539,1201,315,14513,224
19180,4448,114434,1344,75102,435393,39332
48449,110,1074,815,832,21677,242
50954,5469,65632,745,49403,300973,16229
63205,12,136,362,96,3278,40
27568,59,778,1183,460,7064,318
11733,14,332,1456,149,18104,183
1427,17,1206,1553,711,6846,495
32877,489,9279,1086,7555,42357,1724
24825,8,610,1243,387,26312,223
37229,94,1244,985,942,20371,302
923,30,1090,1557,813,37130,277
10874,5,366,1463,200,10572,166
50973,18,279,745,215,6542,64
13968,369,10749,1428,6643,114316,4106
9553,2157,45131,1472,28646,118938,16485
9218,69,1734,1474,1075,11122,659
18699,10,595,1352,470,19470,125
7347,483,19108,1488,8751,94960,10357
28400,22,795,1166,410,6136,385
42410,8,70,891,54,8606,16
8060,1594,34241,1479,22094,89563,12147
2113,57,2342,1548,1502,27532,840
2109,9,423,1548,298,16183,125
63260,90,1491,333,1238,19958,253
3769,12,452,1533,305,19909,147
12298,327,8793,1451,6011,33162,2782
18784,90,2890,1351,2133,24737,757
28356,11,506,1167,321,13178,185
22944,50,1220,1280,744,16999,476
54160,63,669,648,471,8479,198
2118,16,1144,1548,839,39997,305
1961,156,5939,1549,4126,59776,1813
31702,26,916,1105,563,7670,353
10333,14,785,1467,452,13552,333
55938,56,609,592,479,7897,130
53186,377,4659,675,3701,31970,958
8665,38,615,1476,337,10034,278
4510,227,10668,1524,7088,60549,3580
640,69,3798,1559,2817,68430,981
52726,107,3559,690,2277,26361,1282
53604,72,1529,666,1016,25913,513
64952,11,163,310,126,2432,37
17480,59,3228,1374,2357,32269,871
9577,720,20974,1472,13138,75259,7836
334,479,13387,1562,8480,73033,4907
64254,12,85,331,67,5690,18
17268,38,2020,1378,1417,32052,603
60687,35,593,441,506,18370,87
34689,31,723,1049,554,11653,169
29844,62,3062,1139,1833,37185,1229
23780,1500,36066,1266,26160,263611,9906
46795,47,705,837,599,12051,106
10632,91,2021,1465,1305,13716,716
3864,16,451,1531,307,16671,144
2972,28,1768,1540,1398,11195,370
48754,0,43,805,28,5098,15
61087,10,230,426,175,4535,55
62024,29,343,395,267,4149,76
633,107,4323,1559,2930,32355,1393
66157,1,23,279,14,1606,9
29024,1,23,1154,16,3996,7
3098,21,1178,1539,836,18715,342
48836,669,7079,802,5893,93275,1186
1231,5,307,1555,218,21366,89
41877,86,1907,899,1172,20658,735
50983,3,62,745,44,2862,18
14227,34140,972171,1424,662198,2090621,309973
36276,32,671,1010,547,8281,124
13456,0,0,1435,0,68612,0
31808,4,144,1103,99,7322,45
13051,6,324,1440,173,10213,151
54463,27,351,636,301,11090,50
15667,175,5378,1404,3369,29358,2009
39769,113,2191,933,1691,19582,500
20162,86,2800,1326,1881,26145,919
52506,3854,80220,698,63600,318771,16620
62006,54,551,396,429,9548,122
10765,35,3663,1464,2132,16942,1531
67303,181,3074,242,2526,23863,548
33499,130,3100,1074,2174,26161,926
61129,37,417,424,322,12066,95
61961,47,519,397,365,8577,154
20753,20,842,1316,579,14776,263
54654,14,113,629,69,6674,44
64312,54,550,330,438,4369,112
50730,120,2022,751,1583,28054,439
27773,737,24057,1179,14329,89213,9728
59383,48,691,487,584,15984,107
30833,4023,63508,1119,41169,260370,22339
63937,10,71,342,50,5436,21
61214,8,122,421,94,8930,28
61816,23,575,402,454,14950,121
11032,47,2157,1462,1257,30218,900
29451,13,382,1146,312,11243,70
6956,522,7833,1493,4776,57154,3057
7057,40,3330,1491,2213,48384,1117
64303,961,19142,330,15176,121450,3966
22909,163,2964,1281,2034,23611,930
42153,15,256,895,180,12404,76
56990,2,44,561,31,3627,13
26200,27,1608,1214,948,6694,660
9882,10,153,1470,96,7679,57
62350,191,1818,385,1510,21641,308
59845,1,42,472,21,5565,21
53841,17,146,658,120,4322,26
24687,45,1022,1246,756,15606,266
6587,37,769,1497,563,9711,206
1434,1,187,1553,117,28030,70
12813,269,6005,1444,3977,35911,2028
20405,14,402,1322,299,13553,103
51566,83,794,728,621,15664,173
8615,52,1603,1476,932,12506,671
68858,10,80,189,75,1498,5
7856,9,505,1481,369,29440,136
42704,85,1366,882,1195,23287,171
67946,37,305,222,256,7694,49
12227,0,0,1452,0,8937,0
29197,12,670,1151,379,22570,291
12433,571,24531,1449,13561,101441,10970
68981,55,742,186,601,6095,141
16287,6,481,1394,331,16618,150
87,976,44433,1565,26419,171305,18014
52666,26,243,692,170,6604,73
41592,16910,348311,904,192319,900238,155992
20997,881,18460,1312,13007,60551,5453
24308,2,175,1255,117,7069,58
20543,170,5804,1320,3965,36713,1839
52993,79,1695,682,1365,17553,330
59890,44,855,470,691,29778,164
31499,784,11675,1108,10447,79748,1228
57162,854,59589,556,44106,159017,15483
37699,2172,32584,972,21489,109977,11095
13462,296,10475,1435,6013,91415,4462
15150,6,566,1412,449,9947,117
68390,21,443,208,360,9180,83
20782,119,4751,1316,3410,65710,1341
50643,101,1446,753,1141,23354,305
8689,83,3170,1476,2026,25272,1144
1023,68,2491,1556,1638,12301,853
67276,11,182,243,119,5900,63
2254,232,3450,1547,2122,39852,1328
39591,271,7257,935,5823,53202,1434
20821,67,972,1315,622,12718,350
10179,355,8797,1468,6232,72285,2565
25801,21,404,1222,267,13497,137
6779,16,672,1495,415,13464,257
25982,235,4693,1218,3215,48116,1478
2720,76,3616,1543,2267,26057,1349
61596,141,1285,410,1064,12302,221
57646,1195,31736,545,25762,152717,5974
68362,645,11726,209,9788,95334,1938
18016,53,1539,1364,1060,32832,479
4225,4,111,1528,71,12745,40
16745,594,13610,1387,10439,108024,3171
20554,0,0,1320,0,6822,0
25009,28,1448,1239,959,24790,489
50777,13,299,750,215,5812,84
40188,33,287,926,238,6154,49
68615,1,53,199,31,2924,22
21844,143,2877,1298,2028,62048,849
49308,4,34,787,28,5211,6
43468,32,352,875,279,5584,73
68885,2,65,190,22,6252,43
27607,32,376,1182,248,5117,128
36050,64,1145,1016,990,22027,155
1935,5325,290892,1550,177888,1147443,113004
59817,33,378,473,318,12429,60
64714,44,527,318,466,20054,61
5744,22,821,1508,559,20757,262
36108,19,474,1015,351,15910,123
64364,35,385,328,310,7674,75
36035,7,242,1017,198,6273,44
57093,31,326,559,251,4507,75
47358,35,240,830,192,6778,48
50447,773,7979,758,5936,25922,2043
67187,3,61,246,39,3752,22
46399,46,887,843,659,15465,228
42556,64,1359,889,895,18721,464
21103,1026,20758,1309,13993,140377,6765
17320,58,2167,1377,1304,20894,863
31553,7,161,1107,95,7316,66
59475,127,1439,484,1122,14224,317
10538,2,89,1466,56,9817,33
21187,7,496,1308,355,19304,141
19383,103,4857,1340,3592,47575,1265
58843,124,1327,505,1013,8597,314
14944,55,1485,1415,1004,12544,481
64751,51,517,317,452,5602,65
17775,52,1429,1368,1004,15319,425
1669,3,50,1552,40,3981,10
8326,105,932,1478,593,11736,339
43125,35,599,879,446,12541,153
6759,11,191,1495,143,19442,48
68176,4,170,215,58,7125,112
9353,85,2386,1473,1614,30635,772
64094,454,4766,336,4124,49799,642
26805,6,315,1200,189,7489,126
14358,14,553,1422,400,14889,153
24276,90,3627,1256,2667,42195,960
37524,112,1329,977,1065,13858,264
37721,98,2022,971,1740,24893,282
7204,141,3198,1489,2111,44554,1087
64245,14,232,332,184,5159,48
6428,236,11292,1500,7508,66968,3784
7125,45,1239,1490,812,15489,427
50068,14,226,767,203,7971,23
31352,96,1905,1110,1371,17171,534
69568,5,49,168,44,2313,5
45982,4,45,847,31,9476,14
25164,18,867,1236,615,15053,252
23277,20,954,1275,691,26992,263
17707,1987,58451,1370,37693,221075,20758
20412,180,8519,1322,5699,57721,2820
38251,16,494,958,429,12887,65
37496,5676,115973,978,83705,306011,32268
14219,828,28652,1424,18019,165974,10633
19375,285,5255,1340,3485,20072,1770
19344,300,4366,1341,2802,58000,1564
8125,59,2101,1478,1353,18851,748
31829,4,272,1103,172,3518,100
57804,10,92,538,70,3161,22
14674,142,3654,1418,2585,29775,1069
41780,246,5636,901,4431,44962,1205
11883,362,13252,1455,7904,63424,5348
7768,26,627,1482,375,7455,252
1647,3548,98483,1552,59825,181462,38658
51018,98,855,744,730,8923,125
18832,179,4781,1350,3352,64574,1429
35495,196,3882,1029,3036,51416,846
17134,120,2796,1380,1953,21801,843
23897,27,770,1264,486,12490,284
56934,5,83,563,67,3178,16
31884,261,8421,1102,5068,22888,3353
50515,22,406,756,263,4071,143
16473,3,35,1391,22,3803,13
40073,42,730,928,581,7896,149
27618,77,2077,1181,1343,17061,734
67066,14,242,251,167,3113,75
2187,77,4664,1547,3193,50894,1471
39368,57,807,938,662,10266,145
67994,16,199,221,163,6770,36
19676,28,1211,1335,866,19385,345
70101,1,36,151,31,2094,5
31965,21,588,1101,393,6740,195
14629,426,13281,1418,9148,64958,4133
10078,123,5435,1469,3423,45339,2012
40651,328,5455,915,4595,75831,860
20617,133,2534,1319,1644,35033,890
585,225,10497,1560,7264,162809,3233
55556,23,140,602,112,9269,28
23123,4,179,1278,148,5684,31
16847,146,16308,1385,9308,67337,7000
55859,223,3030,594,2448,20894,582
9109,2626,115219,1474,68062,506931,47157
10000,53,1185,1469,661,19560,524
9868,87,5048,1470,2788,31818,2260
60249,7,167,457,119,9590,48
32771,22,321,1088,227,6568,94
51933,29,305,718,213,12055,92
14998,47,1754,1414,1315,22578,439
14453,109,3293,1420,2093,21522,1200
59259,8,197,492,167,7700,30
19088,7,230,1345,199,9501,31
27863,9,588,1177,351,10669,237
30093,521,11957,1133,7984,63661,3973
48545,10,148,811,119,8438,29
67524,614,13039,235,10690,89656,2349
54867,4873,91489,620,66162,425293,25327
70030,2,24,153,21,1134,3
30605,106,1038,1123,726,12738,312
63998,39,448,340,369,8196,79
37911,259,4137,967,3543,71424,594
32281,27,1157,1097,703,12464,454
29204,237,10985,1151,7579,110750,3406
59877,33,419,470,337,10532,82
61499,135,1083,413,887,16849,196
63399,10,96,357,83,6400,13
34075,94,1606,1063,1079,12021,527
23681,6009,232720,1268,152733,599147,79987
39217,98,1186,940,860,13273,326
52425,139,1431,702,1071,16376,360
4457,4499,145872,1525,100320,253461,45552
10261,308,11287,1468,7022,68784,4265
58537,302,7145,515,5720,37462,1425
13698,75,3078,1432,1873,25252,1205
9551,99,1887,1472,1151,15788,736
67916,95,1634,220,1373,17198,261
29285,7,279,1149,250,12240,29
59406,684,8007,487,6243,48097,1764
68249,39,386,213,340,7622,46
628,53,2304,1559,1644,76198,660
5261,113,1406,1513,974,15085,432
68720,232,5161,196,4706,19426,455
25844,94,2248,1222,1503,33289,745
8633,32,728,1476,474,9866,254
55256,12,130,608,102,9781,28
9664,35,1689,1472,1028,40056,661
66874,11,259,257,229,6183,30
34431,0,0,1056,0,4116,0
22406,70,3989,1290,2339,14713,1650
12262,109,1994,1451,1269,19541,725
21874,35,1324,1297,1035,34080,289
15831,40,1241,1402,789,25756,452
20590,227,2860,1319,2309,38671,551
34508,21009,431892,1054,299393,1244154,132499
48735,15,155,806,124,3993,31
26387,3280,65486,1209,45315,196364,20171
12469,70,2172,1448,1186,12768,986
60731,23,263,439,174,4269,89
10732,10,396,1465,271,9129,125
24108,35,586,1259,437,8481,149
66891,5,77,256,71,6996,6
53876,198,2819,657,2369,21282,450
55375,162,2232,607,1720,31156,512
1830,42,1160,1550,805,31425,355
55996,19,151,590,108,4443,43
32944,171,3934,1085,2867,44190,1067
47753,484,8129,825,6586,68673,1543
39015,8,234,942,173,6823,61
63079,3,34,365,21,1638,13
54791,97,1381,624,955,26950,426
17314,14,895,1377,669,33673,226
65473,7,218,298,164,3567,54
64386,4,71,328,44,4151,27
31059,179,3220,1114,2375,39419,845
57858,1037,14497,537,11288,99478,3209
19621,0,109,1336,76,6705,33
6142,17,605,1503,370,7019,235
15280,80,1947,1410,1330,14859,617
17784,878,77892,1368,29087,143318,48805
66927,6,70,255,55,3387,15
54017,55,728,652,549,5771,179
60399,79,895,452,652,14626,243
35313,87,2185,1034,1614,7481,571
47891,10,161,824,131,4699,30
55280,263,3172,609,2707,43411,465
62967,44,616,368,479,8648,137
60854,10,138,434,113,3177,25
50908,34,376,747,294,5071,82
2815,29,834,1542,647,16505,187
21423,27,826,1304,511,10308,315
63354,2540,39734,355,30622,353830,9112
25345,86,1056,1232,633,11212,423
30749,6,175,1120,108,5544,67
14557,16,459,1419,288,20919,171
69603,11,164,167,126,3978,38
31638,53,1852,1106,1305,29993,547
1372,69,1917,1554,1301,18426,616
66864,3,18,257,11,1294,7
49812,97,2172,774,1851,18048,321
39280,24,792,937,591,21616,201
26997,190,2847,1195,1926,18927,921
18250,4640,144286,1360,90507,374707,53779
31465,124,1917,1108,1316,24259,601
53089,77,1568,679,1073,15758,495
64589,129,2526,322,1972,12873,554
21250,34,2006,1307,1344,10066,662
57439,2,33,550,28,2791,5
51175,86,974,739,852,22887,122
4124,759,16039,1529,11189,100145,4850
33261,5926,108720,1078,71963,336120,36757
52057,2514,33348,714,25843,216064,7505
21308,399,8323,1306,5615,40122,2708
29538,27,1035,1145,667,12309,368
15058,2,540,1413,391,19132,149
53877,130,1664,657,1459,18634,205
30318,56,1750,1129,1143,26655,607
67138,13,232,248,158,5318,74
49733,91,1174,776,891,30613,283
51880,311,3740,719,3325,28590,415
55139,58,789,613,667,14258,122
18480,24264,795152,1356,489137,2904495,306015
54707,63,459,627,355,6099,104
41565,9,284,905,205,5445,79
11352,174,5453,1460,3429,39331,2024
50032,7587,119584,706,93145,470076,26439
8541,13,789,1477,525,13009,264
30196,205,6151,1131,4444,114706,1707
22981,10,539,1280,406,10246,133
6747,226,11002,1495,6241,328905,4761
28455,83,2813,1165,1825,34583,988
54171,0,208,647,116,5195,92
50772,654,8937,750,7695,67916,1242
9237,24,456,1474,268,4486,188
10919,76,3466,1463,1799,19924,1667
17492,15,286,1374,220,8524,66
24289,42,1204,1255,733,6267,471
23921,13,203,1263,169,12434,34
17194,133,3577,1379,2232,22085,1345
20808,10,190,1315,151,6931,39
24223,192,3723,1257,2757,58188,966
63617,116,2117,352,1625,21131,492
7664,537,33754,1483,18632,205315,15122
66719,3,25,262,18,1195,7
34373,45,502,1056,376,8473,126
7805,3,75,1481,55,22218,20
10396,79,4595,1467,2920,76585,1675
20962,85,4282,1312,2031,32520,2251
64152,203,5009,335,3376,55958,1633
6674,20,2413,1496,1638,15654,775
38403,110,1534,954,1150,16907,384
28204,33,598,1170,373,19930,225
59181,0,381,495,296,6288,85
27670,36,474,1180,334,13883,140
43493,8608,102385,875,66227,219265,36158
61470,11,170,413,136,6192,34
17634,93,1592,1371,1088,35793,504
37080,16,297,990,223,5243,74
60627,72,1360,443,1074,32040,286
37952,24,227,966,149,9358,78
47632,0,69,827,63,10571,6
36271,208,2174,1010,1656,43777,518
4909,4,220,1518,149,26688,71
12519,17,1117,1448,554,17409,563
22606,8,274,1287,208,31797,66
66110,59,904,281,762,10625,142
16446,40,385,1392,297,19517,88
66356,55,1384,274,1142,6265,242
59314,215,7407,489,5810,28125,1597
64916,31,510,312,377,10020,133
24680,434,17426,1246,12687,102356,4739
14334,4,163,1422,107,7253,56
4315,3,92,1526,67,5823,25
42013,4,166,897,130,4389,36
52614,220,2315,694,1668,30537,647
22020,289,12889,1295,8316,116245,4573
60267,20,249,457,160,6203,89
4434,35,1129,1525,908,13056,221
57340,99,1566,552,1278,14702,288
41620,663,10269,902,8157,80556,2112
16393,6,88,1392,62,18981,26
55885,211,1851,593,1432,12095,419
36731,1,68,999,53,7076,15
30346,436,13067,1128,8822,106816,4245
28487,15,405,1165,223,7263,182
14168,2,128,1425,87,6797,41
18002,8,218,1364,139,5249,79
17205,9,776,1379,566,28392,210
15339,3285,87199,1409,59365,402196,27834
2924,38,1209,1541,804,25407,405
51546,69,335,729,288,13983,47
20531,16,460,1320,329,5726,131
67147,164,1738,247,1301,9562,437
13394,31,721,1436,458,21034,263
29344,1,56,1148,36,3471,20
28226,8,392,1170,250,6997,142
37485,29,508,978,369,10844,139
21280,28,603,1306,422,8889,181
29644,43,1871,1143,1111,15944,760
70016,0,19,153,12,1545,7
50560,96,1269,755,1028,26895,241
29132,14,515,1152,311,5163,204
33196,4277,64774,1080,41378,283851,23396
18270,27,696,1360,528,15394,168
31287,7,135,1111,89,24484,46
50830,1,67,749,51,4844,16
67152,4,29,247,24,1624,5
34639,54,1251,1051,888,22777,363
12379,63,2471,1450,1387,28808,1084
4942,146,7408,1518,5200,48162,2208
39997,216,4480,911,3538,33139,942
53346,44,512,672,393,13906,119
58273,9,102,524,84,6154,18
128,412,19385,1565,12778,108746,6607
34539,5239,155330,1054,101547,490285,53783
37806,1942,69642,969,53396,414559,16246
9904,2535,95779,1470,58370,501333,37409
57841,1035,13464,538,11228,90837,2236
23882,636,17176,1264,11487,101100,5689
12528,69,2571,1448,1648,16094,923
57988,166,2337,534,1737,56543,600
5222,91,1445,1514,1138,22333,307
26731,972,19884,1201,13402,144321,6482
13202,8559,207748,1439,131128,417817,76620
54945,20,143,619,106,6577,37
15138,21,596,1412,413,13485,183
66363,40,684,274,433,3788,251
17809,124,2298,1368,1759,22987,539
16051,5,160,1398,113,33137,47
34579,0,52,1053,31,1931,21
38466,167,1616,952,1292,41114,324
14241,6,227,1424,175,7171,52
34084,16,446,1063,257,8129,189
51448,34,631,732,413,6740,218
62927,5,52,369,33,5846,19
23393,99,3773,1273,2338,51772,1435
12491,2654,119325,1448,66139,556611,53186
56582,24,280,573,215,7143,65
17817,1341,33627,1368,23064,140940,10563
13897,40,1351,1429,875,43326,476
47517,251,2669,828,2139,35863,530
3833,61,2320,1532,1689,25924,631
34184,147,1619,1061,1050,15870,569
29729,326,5135,1141,3150,50391,1985
58831,21,164,506,112,4173,52
16933,49,1412,1384,884,12046,528
64923,120,1005,311,812,15207,193
27146,381,7350,1192,5200,63086,2150
3239,73,1549,1538,1008,26971,541
31381,17,466,1110,315,3945,151
51008,39,708,744,407,5929,301
4698,70,1969,1521,1485,33018,484
4165,13,300,1528,190,22891,110
64807,151,4619,315,3679,31008,940
67823,262,4400,226,3347,32441,1053
17503,365,15195,1374,10833,96719,4362
22684,1594,26719,1285,17999,153291,8720
34116,107,1703,1062,1132,25696,571
50737,1125,20306,751,16114,110872,4192
30504,13,620,1125,367,12554,253
35907,3,76,1020,58,4474,18
63501,183,5398,353,3862,41181,1536
4051,2,123,1530,87,11462,36
64342,129,2126,329,1567,11358,559
57508,29,214,549,155,3714,59
67100,19,271,249,212,1610,59
9185,2868,96336,1474,64700,275559,31636
63429,20,178,356,136,3108,42
23453,30,1807,1272,805,14755,1002
22524,831,18391,1288,11007,126893,7384
13527,0,0,1434,0,6251,0
69205,8,227,179,193,4229,34
69047,370,9652,185,8183,43511,1469
8622,550,32093,1476,19069,243485,13024
39388,275,3309,938,2341,25271,968
69310,233,4092,176,3713,33155,379
67426,9,34,239,30,1247,4
17898,161,3815,1366,2512,19903,1303
6018,11,230,1505,172,9145,58
55411,71,1006,606,789,6455,217
65925,21,141,286,116,4691,25
46186,34,481,845,377,6341,104
60404,761,19624,452,14689,103080,4935
52941,85,1163,684,938,13738,225
19182,7,223,1344,175,7583,48
5997,23,455,1505,288,20089,167
28322,2,54,1167,37,3173,17
31677,41,602,1106,418,12666,184
14560,10,402,1419,293,6804,109
42148,222,4841,895,3881,34078,960
56782,14,247,567,207,5200,40
2797,476,8501,1542,5870,57678,2631
667,6042,311887,1559,176771,1444265,135116
3598,151,5639,1535,3971,34917,1668
52540,12,157,697,136,12571,21
58481,265,2318,517,1914,18717,404
10410,200,7111,1467,4566,75932,2545
29606,402,9805,1144,6530,69799,3275
66180,23,182,278,146,2681,36
40026,107,1959,929,1766,28168,193
70176,4,28,148,23,1891,5
69938,2,20,155,14,2249,6
25690,33,906,1224,588,24230,318
57617,1,33,546,27,4851,6
6239,2192,68232,1502,41614,367409,26618
60732,36,513,439,428,9894,85
12401,11,392,1449,218,8750,174
1711,5,233,1551,164,7095,69
69306,875,19241,147,17325,119837,1916
62270,35,899,387,734,7736,165
14534,52,1175,1419,837,24381,338
5346,10,233,1513,160,12904,73
50651,3,78,753,60,4165,18
17656,1,66,1371,47,3910,19
50887,5975,89045,747,62600,258439,26445
31305,82,4527,1111,2642,21213,1885
63896,5,53,343,38,2602,15
57282,12,247,553,223,7725,24
64800,36,406,288,328,9893,78
9417,99,3308,1473,2112,20548,1196
69842,6,47,159,33,2333,14
63638,3,48,351,32,1839,16
54096,37,601,649,449,8762,152
64543,3,69,323,58,4388,11
39866,13,341,932,294,9965,47
9864,95,1832,1470,1256,24307,576
51063,53,767,742,588,12542,179
24898,2820,103059,1241,64526,267573,38533
69268,13,112,177,95,4090,17
18835,65,1859,1350,1293,64357,566
8016,106,5428,1479,3233,41721,2195
58907,107,1723,503,1277,14831,446
28670,181,5220,1161,3334,44810,1886
52718,2597,33753,690,21329,206722,12424
36554,68,1875,1001,1487,47077,388
18700,24,1122,1352,880,7675,242
10494,1597,56458,1466,34330,188617,22128
65321,68,596,300,499,8824,97
23243,173,3650,1276,2497,63463,1153
17273,260,10387,1378,6407,66715,3980
65911,101,852,287,562,7096,290
70166,18,282,148,244,3713,38
10090,15,392,1469,286,13675,106
52104,193,2554,712,2003,44928,551
5527,183,6543,1510,4503,50475,2040
24716,152,3176,1245,2089,24631,1087
27204,37,720,1191,467,9230,253
64441,7,124,326,86,5539,38
54564,101,862,633,756,15044,106
53350,2953,42059,672,32889,234489,9170
181,60,2346,1564,1652,92219,694
64187,20,278,333,224,8737,54
11184,69,3028,1461,1609,26380,1419
62543,2,58,379,35,7495,23
9755,1244,93167,1471,51616,264449,41551
16943,87,2671,1384,1761,20923,910
64332,7,79,329,61,3462,18
26965,11,491,1196,315,7079,176
53611,284,3157,666,2848,31416,309
19273,8,385,1342,276,20187,109
49716,1311,26103,777,19473,107682,6630
13929,617,26440,1428,16873,162736,9567
9760,47,1306,1471,865,18420,441
38325,6,189,956,142,7766,47
1478,17,492,1553,344,13570,148
46580,6269,127945,840,95966,789165,31979
6814,171,8093,1495,5450,46861,2643
21185,39,1389,1308,917,13471,472
19916,71,2164,1331,1512,20844,652
66763,3,148,260,56,2538,92
17292,21,852,1377,639,15027,213
59606,7,219,480,154,7684,65
23552,70,1833,1270,1013,10164,820
32715,45,877,1088,608,26499,269
31509,56,1652,1108,1070,28320,582
34359,656,17210,1057,12705,118749,4505
10347,48,1436,1467,926,13856,510
47487,70,1145,828,870,28856,275
29779,119,2752,1140,1630,36207,1122
18064,0,157,1363,124,16990,33
35912,60,1830,1020,1439,18985,391
61462,21,278,414,216,3777,62
7689,75,5208,1483,3095,24773,2113
65655,45,1128,293,768,14551,360
42356,2491,52653,892,41844,161863,10809
1981,16,821,1549,472,36048,349
54749,84,791,625,583,17499,208
59776,30,369,474,288,5827,81
28418,4502,105424,1166,76543,529875,28881
13002,2,221,1441,104,6570,117
12690,665,22342,1446,13843,86120,8499
5557,154,2476,1510,1515,34919,961
60253,1,104,457,71,10857,33
9835,244,4391,1471,2316,18586,2075
32269,124,2550,1097,1786,21876,764
27588,335,4952,1182,3278,37959,1674
67547,93,1327,235,1133,8517,194
24216,38,1089,1257,664,7642,425
9672,202,5125,1472,3312,15232,1813
30920,26,1031,1117,639,10551,392
13499,25,2934,1434,1662,33439,1272
3021,106,16690,1540,8810,81390,7880
8385,220,6092,1477,3712,31386,2380
34292,32,884,1059,552,5951,332
16879,16,689,1385,570,36100,119
63923,62,1072,342,780,11642,292
32460,32,773,1093,499,14369,274
976,46,2571,1557,1714,54341,857
10638,138,3334,1465,2255,66506,1079
17513,3,141,1373,114,4786,27
60890,15,130,433,105,5231,25
40379,28,583,923,538,22613,45
20294,40,541,1324,409,23198,132
62733,174,2061,374,1805,23739,256
21338,11,540,1305,447,11949,93
14013,344,7488,1427,4863,59343,2625
18448,79,2152,1356,1503,12349,649
29910,42,680,1137,398,7076,282
26352,1355,33952,1210,20527,185603,13425
62806,57,886,372,611,10754,275
1510,17,286,1553,193,14560,93
3757,8,114,1533,83,10130,31
24168,34151,1008917,1258,664121,2185162,344796
23777,14,693,1266,471,22224,222
40371,12,289,924,230,6322,59
25326,243,8912,1232,6269,48574,2643
40405,7,122,923,85,9095,37
62400,4,91,383,52,3220,39
31495,59,985,1109,721,16171,264
131,12925,845158,1565,473894,3588066,371264
55283,34,333,609,258,8162,75
16604,54,1266,1390,908,26382,358
5448,29,993,1511,724,31232,269
27945,15,599,1175,357,20617,242
27163,16,631,1192,378,5940,253
56222,16,183,583,118,7346,65
7197,94,2394,1489,1640,23794,754
21158,62,1561,1308,1106,20222,455
27402,41,1181,1187,819,17678,362
10887,28,1106,1463,658,17971,448
16352,54,998,1393,678,9127,320
10948,56,847,1463,562,13569,285
17963,636,27306,1365,18996,99133,8310
29785,13,742,1140,417,15752,325
16245,11,235,1395,181,18579,54
50573,469,6160,755,5142,65887,1018
17329,1127,16461,1377,10428,64364,6033
17010,1326,42670,1382,27609,147642,15061
65844,175,3186,288,2613,62850,573
34031,1053,18227,1064,12303,71389,5924
8609,412,12508,1476,7184,42261,5324
24422,266,5401,1252,3282,34200,2119
17309,42,519,1377,313,7366,206
27720,15,317,1180,194,8875,123
1178,2856,98027,1555,62625,327811,35402
61853,20,393,401,330,5063,63
29372,0,0,1148,0,5902,0
70103,29,592,150,553,6373,39
4453,1,101,1525,73,1953,28
63775,4,131,347,85,2198,46
847,144,6844,1558,5143,66045,1701
17436,16,240,1375,208,16898,32
43207,138,1958,878,1462,18097,496
53023,190,1661,681,1232,15992,429
40298,41,580,925,432,5781,148
55462,887,7296,605,6584,47205,712
70278,15,474,144,399,7911,75
41466,482,8179,905,6715,70836,1464
68553,597,10539,196,9113,70340,1426
9806,24,422,1471,324,8457,98
7246,9,246,1489,143,10615,103
17297,5,102,1377,78,6105,24
28483,3,71,1165,47,5293,24
53416,19,239,670,163,5516,76
28544,129,3397,1164,3030,38450,367
66029,21,204,283,181,6243,23
40196,13,559,926,444,8851,115
16215,21,851,1395,714,22790,137
13350,69,2808,1436,1716,36023,1092
38275,30,531,957,480,16212,51
61708,15,166,406,151,3204,15
36492,18,335,1003,271,9308,64
37767,15,350,970,275,8165,75
28979,11,409,1155,246,8486,163
49295,120,2100,787,1786,27228,314
11035,14,357,1462,202,5360,155
7249,57,1635,1488,955,16673,680
65432,99,1182,298,1021,15269,161
14784,0,0,1417,0,13342,0
18323,69,1489,1359,1078,70175,411
2285,354,12497,1547,8456,101929,4041
23767,76,1364,1266,974,23091,390
12222,18,647,1452,350,5836,297
16504,10,290,1391,187,10162,103
32655,1189,34069,1090,23365,248469,10704
65997,12,104,284,86,4918,18
20176,1,94,1326,71,2343,23
5718,25,413,1508,298,9851,115
55957,16,442,591,282,11398,160
68776,97,1609,194,1325,13775,284
447,25,632,1561,503,30893,129
59192,4551,84601,494,64355,252191,20246
8831,89,2736,1475,1636,17043,1100
37172,17,249,987,194,8637,55
12261,158,10769,1451,6418,32789,4351
66252,5,62,276,34,3470,28
38824,5,83,944,72,2971,11
60603,1674,26137,444,20480,111551,5657
37547,28,554,976,429,9222,125
15772,19,853,1403,581,22851,272
8739,2338,89697,1476,54067,269138,35630
51439,3,87,732,57,4899,30
34878,142,1542,1045,1085,18647,457
15098,5,76,1413,49,9693,27
17603,24,882,1372,660,28227,222
10024,14,1314,1469,911,14784,403
60237,5,199,458,134,3742,65
10256,161,6369,1468,3114,67051,3255
66764,1,14,260,10,2000,4
67903,2,43,224,29,1941,14
4424,555,24482,1525,15125,145599,9357
51355,26,261,734,241,9554,20
28940,94,4129,1156,2745,56612,1384
53480,24,492,670,384,6369,108
50707,3,15,752,10,1909,5
58786,43,470,507,347,6989,123
16968,13,202,1383,157,11224,45
65055,1,100,307,89,3481,11
13827,2,127,1430,99,5631,28
33071,416,13476,1082,10213,131991,3263
38778,496,4538,945,3686,45785,852
11286,18,593,1460,321,17573,272
59089,19,226,498,188,6460,38
15608,2,210,1405,126,4914,84
54780,9,96,625,65,3139,31
32557,356,9675,1091,7043,42749,2632
11718,59,2230,1457,840,11044,1390
58899,10,143,503,115,9851,28
18711,10,852,1352,582,14139,270
55218,13,358,611,215,12049,143
12957,864,46425,1442,25353,269124,21072
31498,23,657,1108,391,9382,266
19534,527,22672,1337,16396,141041,6276
6646,47,1801,1497,1052,18298,749
17943,2,148,1365,114,8696,34
16457,21,688,1391,531,24907,157
22647,7200,106320,1286,73605,217943,32715
63802,102,1973,346,1591,21000,382
1255,81,3189,1555,2226,30609,963
60972,56,494,430,404,11101,90
10123,681,16003,1469,11223,131531,4780
44223,115,1858,866,1455,22398,403
26290,359,11828,1212,7885,95725,3943
48,639,42863,1566,24031,179876,18832
21060,6,328,1310,210,23615,118
60790,136,2396,436,1900,33826,496
49367,39,581,785,439,4866,142
58577,106,2108,513,1605,9601,503
69479,0,3,171,3,1257,0
11012,33,1311,1462,758,12599,553
66128,95,1287,280,1066,12957,221
7149,9,528,1490,343,16319,185
60716,34,893,440,606,10281,287
1629,6,140,1552,103,16093,37
9134,72,2021,1474,1010,19509,1011
31558,61,1828,1108,1040,31177,788
62620,123,1271,377,1007,7460,264
57434,26,899,550,763,8696,136
18999,2,69,1347,50,16664,19
31328,442,12630,1111,7891,100073,4739
41012,14,461,913,304,8710,157
5114,23,377,1515,258,16014,119
11168,70,802,1461,513,14374,289
25236,189,2119,1234,1322,12688,797
29236,27,930,1150,670,8795,260
53160,132,1382,677,961,13968,421
15367,110,3596,1409,2482,43695,1114
17434,2,320,1375,228,32891,92
2022,6,164,1549,101,10259,63
26444,9,136,1208,78,17616,58
40332,8,143,924,117,9338,26
3141,38,1032,1539,719,30903,313
27380,7,487,1188,278,28756,209
271,157,13870,1563,9223,59446,4647
9560,209,6419,1472,4226,34874,2193
19174,0,0,1344,0,5304,0
66440,98,1536,261,1326,18752,210
31380,8388,184915,1110,145073,778178,39842
20455,21,630,1321,482,7845,148
17353,448,11418,1376,7239,118367,4179
54720,36,591,624,350,13657,241
68739,63,1078,195,885,11849,193
30969,225,6760,1116,4025,27990,2735
3371,35,1097,1537,749,33330,348
65033,395,5744,307,4955,25463,789
35736,9,230,1025,168,7800,62
4461,62,2218,1525,1595,14521,623
51510,24,347,730,257,3508,90
20498,7,598,1321,482,33842,116
70568,9,73,134,72,2243,1
307,11,452,1562,278,15169,174
68540,0,36,202,25,4782,11
13648,167,3122,1432,1893,24767,1229
49398,36,574,785,456,19564,118
21807,98,3730,1298,2362,50650,1368
21095,32,773,1310,521,12317,252
22133,82,1505,1294,1013,17090,492
34509,121,2864,1054,2465,30488,399
65811,7,71,289,41,4490,30
36043,13,448,1016,329,9238,119
17870,339,11922,1366,7616,55641,4306
7496,613,20888,1486,14243,104532,6645
14012,13,776,1427,552,39163,224
28950,2099,75974,1156,54328,438260,21646
23744,27,495,1267,354,12442,141
18543,189,11022,1355,6831,49206,4191
35151,2,119,1038,73,4980,46
69894,32,301,156,254,2937,47
24610,122,6655,1248,4466,63693,2189
20607,148,10927,1319,6919,67404,4008
51184,279,2916,739,2314,24815,602
26340,7,182,1210,165,9541,17
60943,17,324,431,247,5884,77
9385,31514,579534,1473,338802,1027570,240732
1441,8,651,1553,475,12923,176
25291,14,660,1233,508,4077,152
17808,232,3777,1368,2509,26242,1268
55257,16,155,610,138,5221,17
28410,110,2734,1166,1881,18926,853
55665,20,418,599,336,6762,82
57624,62,928,545,734,20078,194
60073,631,10771,464,7634,43415,3137
64595,8,110,322,78,3698,32
1759,24,1267,1551,842,12583,425
51126,138,2562,740,1926,26515,636
35973,17,472,1019,353,5521,119
8017,1,160,1479,90,11871,70
65359,1237,21651,300,18714,89178,2937
52893,43,792,685,587,10723,205
70135,13,115,149,98,1879,17
35538,3,133,1029,67,4642,66
50564,117,1800,755,1519,17465,281
64431,50,684,326,573,7370,111
26841,224,4125,1199,2965,42987,1160
18691,128,2346,1352,1652,19893,694
36339,1405,28870,1008,25443,156424,3427
33894,0,60,1067,36,4664,24
55772,108,864,596,677,13147,187
27575,201,3694,1182,2603,44879,1091
69520,19,566,170,556,13585,10
28698,96,2694,1160,1944,32398,750
32266,29,1495,1097,1021,22317,474
19168,7,434,1344,346,13060,88
52676,24,464,692,389,18107,75
57823,128,4146,539,3254,34842,892
4711,16,397,1521,282,12850,115
10677,211,10213,1465,6302,70231,3911
50774,67,842,750,696,22777,146
66279,23,207,276,151,5684,56
26112,1930,58171,1215,35420,376837,22751
17270,236,7046,1378,4994,65911,2052
54604,58,744,631,590,10794,154
821,7,452,1558,340,11061,112
4266,12,727,1527,404,28016,323
60292,529,9251,456,7244,57778,2007
20116,33,593,1327,398,18641,195
66142,14,189,279,145,6529,44
2724,77,3679,1543,2440,83273,1239
24469,431,11715,1251,7800,94242,3915
32126,2622,48678,1099,31406,297351,17272
56901,45,560,564,418,9065,142
60416,50,843,452,729,13205,114
655,323,15404,1559,9304,52754,6100
60654,52,764,442,611,8739,153
29705,109,2120,1142,1541,23322,579
1551,34,1687,1552,1087,11200,600
53581,2708,29518,667,23689,253597,5829
68192,2,19,215,19,4925,0
22539,12,329,1288,250,30241,79
17150,38,845,1380,538,7496,307
15725,2193,71581,1404,47570,465414,24011
52717,3339,39924,690,26162,118652,13762
14883,7,208,1416,147,9396,61
49766,981,15381,775,12192,109384,3189
43881,6,168,871,108,3329,60
46201,5,141,845,85,5351,56
24400,10,179,1253,124,9048,55
63698,91,1328,349,1156,36656,172
1755,79,2484,1551,1785,33977,699
35680,73,1159,1015,949,13895,210
39830,27,400,932,368,11853,32
30975,26,416,1116,261,5099,155
27106,2,134,1193,82,4243,52
26641,111,2225,1203,1543,26314,682
35134,8,204,1039,143,6931,61
27673,364,5725,1180,3928,68186,1797
63295,20,394,360,325,7106,69
57600,83,1416,546,1082,12349,334
36775,14,849,998,727,14579,122
11370,13377,303087,1460,169218,845773,133869
8286,20,1032,1478,715,22543,317
69201,12,177,179,140,3832,37
63835,9,210,345,138,6809,72
15478,57,1497,1407,1068,17066,429
18139,118,6803,1362,4823,91318,1980
50428,8,123,759,103,16655,20
59022,42,397,500,293,6048,104
622,136,3582,1559,2334,37009,1248
23324,150,4452,1275,3115,85091,1337
3794,6406,181151,1532,113198,399231,67953
33895,22,388,1067,275,6995,113
4520,9,440,1524,262,11063,178
28182,2,32,1171,18,2786,14
19011,40,3716,1347,2183,14720,1533
19688,52,1230,1335,904,45136,326
68132,22,789,217,623,5401,166
24669,43,1150,1246,713,10834,437
31109,16,414,1114,381,26174,33
37838,2,88,969,50,9518,38
20105,1,97,1327,81,6460,16
63643,4,39,351,30,3201,9
11277,267,15688,1460,9048,159223,6640
24217,38,1434,1257,889,15089,545
9564,7,242,1472,161,8334,81
40918,95,2659,915,2102,27691,557
9490,18,638,1472,411,9453,227
66890,3,17,256,14,3779,3
37458,52,914,979,694,8839,220
29310,1,113,1149,71,6748,42
25315,398,10995,1232,6493,65336,4502
51714,63,738,724,622,14173,116
26398,246,7839,1209,5168,82024,2671
69270,4,36,177,34,1846,2
48662,52,450,808,356,7276,94
11780,0,0,1456,0,6696,0
9960,1892,38573,1470,24331,108125,14242
23318,272,7149,1275,4766,41769,2383
25425,28,1287,1230,868,16997,419
23389,59,1892,1273,1393,34764,499
38061,14,368,963,268,6243,100
30787,140,2440,1119,1768,26727,672
22072,11,293,1295,194,14455,99
65385,6,57,300,48,3675,9
69214,83,1200,179,921,9660,279
19270,5317,166496,1342,110177,539809,56319
61077,77,3141,426,2513,20168,628
15071,18,950,1413,671,36513,279
3601,4,100,1535,61,6662,39
34734,4,55,1048,41,5166,14
37658,287,4972,973,3322,41299,1650
38911,36,871,943,628,11085,243
53429,18,207,670,138,6162,69
29083,3,137,1153,87,7345,50
63391,36,578,358,439,6785,139
37475,270,8546,978,3386,45454,5160
40646,211,5723,920,4457,46636,1266
23396,175,4368,1273,3051,53902,1317
11388,37,1787,1460,1202,32125,585
16261,3,114,1395,85,17812,29
69153,52,325,181,282,5742,43
25158,1004,20404,1236,14193,72912,6211
17859,115,3840,1367,2807,47819,1033
20277,86,3725,1324,2474,26207,1251
17552,70,3313,1373,2501,38344,812
1705,16,659,1551,451,22920,208
31506,189,2673,1108,1631,12741,1042
23609,105,3981,1270,2427,66591,1554
22265,3,195,1292,143,7362,52
34419,2,125,1056,80,6866,45
13446,2688,92968,1435,58050,279030,34918
21243,43,1115,1307,741,12670,374
48179,6,46,820,38,3797,8
3908,17,1009,1531,698,25402,311
60818,0,0,260,0,4389,0
5102,20,807,1516,533,25380,274
55469,23,288,605,205,5812,83
29788,14,436,1140,292,10534,144
69589,44,296,168,280,7550,16
15096,339,6996,1413,5184,59971,1812
1345,4589,124677,1554,73435,355760,51242
21699,242,2738,1299,1919,19292,819
56804,27,233,566,180,9483,53
66217,14,264,277,144,8656,120
32707,65,2503,1089,1416,17044,1087
22084,531,15316,1294,9034,86721,6282
21442,10,313,1303,205,6204,108
52524,10,131,697,84,7343,47
52391,900,12849,703,9436,59623,3413
53095,206,3024,679,2626,27941,398
15751,311,8727,1403,6287,135191,2440
55613,1019,14643,600,11367,52970,3276
16028,7074,152556,1398,97652,713424,54904
42662,5479,107991,886,76487,386110,31504
54679,3474,36052,628,28850,120169,7202
54846,82,597,622,461,10960,136
60219,3913,106947,458,84139,412504,22808
13086,394,20858,1440,12347,110396,8511
30286,14,278,1130,178,6100,100
10913,0,15,1463,10,8101,5
18282,105,2284,1359,1759,32708,525
21495,33,412,1302,297,6178,115
30677,14,293,1122,190,3152,103
58149,15,194,529,151,6350,43
1806,71,3253,1550,2086,21675,1167
20654,101,4061,1318,3254,40425,807
58917,66,1012,503,722,17383,290
34582,8,224,1053,155,10246,69
625,25,2739,1559,1659,30793,1080
8774,2,63,1476,44,6091,19
57336,40,473,553,359,4984,114
31350,3,107,1110,71,4475,36
3228,20,1235,1538,882,12788,353
38140,29,551,961,415,5791,136
5468,260,12958,1511,5797,47713,7161
10759,11,1108,1464,749,16866,359
61507,29,423,412,378,12218,45
10867,63,2855,1464,1533,19988,1322
30347,227,3903,1128,2600,22507,1303
58018,216,2519,533,1957,33610,562
18959,67,1169,1348,772,26724,397
50890,18,161,747,132,5777,29
62658,10,101,376,89,9028,12
56095,118,1900,587,1423,12043,477
33019,66,1164,1083,834,16510,330
29765,3,261,1140,166,9314,95
22565,8279,354291,1287,223297,842438,130994
40673,4,164,920,133,13773,31
18774,49,2160,1351,1440,41909,720
25310,4319,73407,1233,52442,172995,20965
24426,349,8626,1252,5914,67394,2712
20772,182,5449,1316,3702,38256,1747
974,93,2830,1557,1950,52651,880
29780,10,375,1140,243,5915,132
53638,2442,44084,665,27920,83340,16164
35469,12,383,1030,254,6807,129
31541,68,1714,1108,1148,19144,566
56961,2521,41526,562,32023,154821,9503
48739,36,927,805,487,12404,440
33028,188,4853,1083,3183,41454,1670
68254,5,66,213,35,1663,31
11106,92,2517,1462,1379,18292,1138
12121,211,10898,1453,6151,56797,4747
31130,64,1482,1114,913,26391,569
51597,171,1930,727,1641,22914,289
69768,0,82,161,60,3245,22
24733,46,563,1245,438,8466,125
27547,53,1071,1183,805,30385,266
34180,76,1481,1061,1090,24131,391
8571,13,908,1477,601,20044,307
67989,49,857,221,692,8892,165
51860,1198,14023,720,10743,75120,3280
49423,106,1063,784,869,7611,194
61709,34,363,406,308,5892,55
44697,128,1396,862,1211,17741,185
59514,19,327,483,248,6999,79
24786,66,1570,1244,1087,31224,483
68669,8,89,198,73,4534,16
58592,104,827,513,664,10650,163
28595,73,1287,1163,793,15190,494
27795,13,193,1178,163,15379,30
17905,57,1890,1366,1410,23202,480
45679,144,2568,851,2015,50238,553
63483,0,0,355,0,2903,0
20418,606,14470,1322,8569,142645,5901
28470,5,212,1165,123,13900,89
58302,8,133,523,117,20002,16
19918,417,15397,1331,9846,45805,5551
34550,295,4867,1053,3435,28840,1432
16339,105,2252,1394,1604,26059,648
54505,118,1892,635,1359,32927,533
13833,16,448,1430,277,19239,171
63166,80,1549,363,1194,22354,355
35141,395,7403,1038,5897,56780,1506
56327,24,404,580,249,8044,155
13224,152,2978,1439,1811,34232,1167
29481,27,386,1146,318,7967,68
40013,92,1216,929,925,18609,291
1889,73,2056,1550,1434,29188,622
4666,37,2239,1521,1551,39236,688
30931,9,241,1117,151,5192,90
56650,46,347,571,236,11477,111
37026,1375,23486,991,17432,210786,6054
29356,468,8367,1148,5747,83539,2620
56108,6,88,587,67,3234,21
54116,897,12926,649,9890,72624,3036
49668,4,89,778,67,5655,22
21161,16,682,1308,529,23125,153
17729,36,2299,1369,1652,65780,647
33679,92,1402,1071,1009,20593,393
16747,12,458,1387,341,19232,117
1656,18,934,1552,688,25504,246
58573,11,124,514,100,4644,24
66520,9,90,268,68,1693,22
65934,226,4174,286,3430,44190,744
21397,21,781,1304,608,11084,173
7035,13,481,1492,374,29999,107
59092,49,1695,497,1414,34720,281
3232,35,670,1538,456,14968,214
59079,40,528,498,415,15464,113
48253,22,464,819,310,17857,154
69452,4,123,172,99,3793,24
18765,23,411,1351,275,11955,136
29754,1276,37152,1141,26821,243711,10331
50346,621,9383,761,6759,36399,2624
6891,121,2688,1494,1904,28079,784
2154,28,641,1548,428,20084,213
3672,2,80,1534,51,11454,29
29642,0,0,1143,0,4884,0
53629,76,1058,665,942,14959,116
32809,1590,45699,1087,34520,122465,11179
43977,13,231,869,179,12701,52
35116,96,2336,1039,1659,14199,677
51022,62,1232,743,1008,18459,224
50842,0,202,748,165,12948,37
24248,194,3336,1256,2362,30156,974
5217,70,2403,1514,1580,18191,823
33834,6,130,1068,90,5052,40
51728,66,1538,724,1171,35729,367
35441,9,200,1031,157,4803,43
15689,38,610,1404,377,18702,233
16010,76,2935,1398,2117,49426,818
36323,40,735,1008,624,9062,111
13855,5,235,1429,128,8539,107
8905,749,15569,1475,10324,63418,5245
21075,54,1371,1310,1071,21932,300
28258,2546,91959,1169,54768,425152,37191
14404,38,1108,1421,824,15970,284
17581,138,13418,1372,8858,67576,4560
35066,10,245,1040,163,6871,82
50332,6,177,761,133,2901,44
25446,34,797,1230,507,4856,290
43757,55,1080,872,923,24329,157
8658,127,3522,1476,2263,18349,1259
8374,106,4868,1477,3112,53188,1756
18339,1,145,1359,119,8102,26
36778,1,332,998,283,14216,49
39532,1225,25853,936,19949,135879,5904
38083,68,778,962,689,14744,89
49096,5,104,794,85,10292,19
43689,106,1759,872,1296,13986,463
36047,5111,120125,1012,82676,649009,37449
38176,27,681,960,489,5538,192
23093,178,3051,1278,2053,41424,998
34487,18,201,1055,119,7477,82
46760,129,3466,837,2588,20130,878
70036,6,141,152,125,3008,16
57183,550,7079,556,5149,38024,1930
34121,192,3961,1062,2961,45813,1000
31999,74,1416,1101,934,12585,482
451,1,285,1561,181,10842,104
17679,4,199,1370,162,11425,37
54147,34,312,648,252,9145,60
16293,250,7293,1394,5047,56914,2246
6950,3626,112657,1493,69256,204443,43401
16531,9160,171677,1390,118152,373169,53525
33185,122,3066,1080,1927,84340,1139
3778,60,1405,1532,907,16779,498
42280,8393,158694,894,119143,621916,39551
29225,166,3755,1150,2844,22434,911
32686,16,513,1090,328,19490,185
54272,196,2641,643,1856,20520,785
27769,139,4647,1179,3150,39896,1497
6702,27,977,1496,715,32453,262
21787,643,13714,1298,9916,34007,3798
6977,13,1262,1493,941,13179,321
49635,200,2682,779,2072,37631,610
66293,13,189,275,145,15810,44
63591,104,2015,353,1601,23968,414
61429,327,5841,414,4820,64720,1021
35848,36,833,1021,628,12509,205
51990,14,278,716,216,4478,62
35709,11,299,1025,232,8415,67
40729,122,1501,496,1021,16998,480
49618,176,2882,769,2324,34864,558
11918,6,243,1455,103,8331,140
1095,277,12959,1556,9532,93566,3427
32957,31,511,1084,337,5033,174
62017,265,4886,395,4092,31997,794
5802,25,1869,1507,1381,18199,488
33119,273,2758,1082,2064,23013,694
25755,13,322,1223,206,12273,116
28926,4353,152664,1156,103664,721284,49000
69106,39,534,183,458,8782,76
49698,268,5772,777,4499,43811,1273
51980,3347,38968,717,31654,277243,7314
1150,25,413,1555,330,16518,83
27960,1589,85356,1174,55957,171770,29399
26619,877,19035,1204,11780,125212,7255
34671,175,3530,1042,2780,29296,750
25902,92,2873,1220,1733,21744,1140
31143,193,3433,1114,2189,16825,1244
51605,42,728,727,669,16188,59
65747,9,110,291,87,3693,23
69759,5,92,161,75,3591,17
63124,19,493,364,331,10527,162
62397,35,253,383,210,5122,43
66705,3,34,263,24,2479,10
37696,3652,175900,972,127179,223537,48721
1547,70,2269,1552,1576,52393,693
52054,0,22,714,19,2148,3
29867,6,412,1138,251,5944,161
14035,292,9082,1427,5856,91636,3226
51188,10239,138390,738,97076,458236,41314
10990,81,3019,1463,1816,36839,1203
64703,113,2204,319,1636,9272,568
13049,14445,342543,1441,185773,1047392,156770
10727,5,411,1465,247,6054,164
21499,14,707,1302,458,19819,249
29183,57,1425,1151,923,16136,502
69117,2,26,182,20,2792,6
8316,163,5413,1478,3189,55395,2224
35038,795,30773,1041,19196,222166,11577
19527,8,268,1337,175,5306,93
54613,135,1895,631,1590,17343,305
23703,50,986,1267,757,35147,229
50508,64,824,756,673,22246,151
3418,482,25848,1536,16891,172124,8957
33868,50,613,1068,430,6456,183
68130,5,174,217,123,8213,51
11450,3461,68663,1459,45896,578185,22767
27392,51,2524,1187,1634,28811,890
26237,3,195,1213,132,4203,63
17643,8,482,1371,361,16087,121
63723,10,269,348,196,9270,73
23295,10,227,1275,134,4038,93
27460,39,476,1186,440,11368,36
30072,5883,123078,1134,74062,537332,49016
33460,24,1124,1075,766,12756,358
63792,9,214,347,147,5130,67
4008,489,12391,1530,8688,68874,3703
55410,17,255,606,180,3038,75
65838,6,37,288,35,4421,2
6876,177,8907,1494,5969,64741,2938
58533,84,934,515,705,17446,229
9052,79,1702,1474,1049,15844,653
57984,27,467,534,372,24375,95
10060,171,4817,1469,3321,24441,1496
3255,86,1712,1538,1210,43267,502
66332,8,223,274,186,4751,37
53589,540,7134,667,5030,26289,2104
30440,3,73,1126,49,5023,24
7884,46,977,1480,639,23049,338
18472,1,84,1356,73,9085,11
59578,73,461,481,379,9987,82
3220,17,889,1538,644,16934,245
15115,4,103,1412,81,11698,22
50479,83,1287,757,966,16094,321
53684,38,429,663,346,11645,83
25002,24,828,1239,556,14492,272
26359,10708,342549,1210,207056,610219,135493
20110,22,697,1327,531,13965,166
19086,3,277,1345,198,15045,79
70385,15,444,141,383,8151,61
28858,246,7620,1158,4713,62243,2907
19008,487,15596,1347,9274,42659,6322
44737,9,128,861,84,4115,44
35980,143,4585,1019,3771,55640,814
31845,36,635,1103,388,11759,247
14559,6391,158933,1419,101198,409622,57735
68236,19,671,213,379,13434,292
62890,2,35,370,35,2869,0
60664,43,290,442,231,2500,59
19306,62,2095,1341,1470,31809,625
10976,376,5686,1463,3216,18200,2470
50209,30,627,764,452,14382,175
68655,22,268,198,198,3815,70
30441,279,8696,1126,6048,42893,2648
33908,529,8296,1067,5967,59898,2329
23916,4305,78837,1264,49202,201724,29635
16035,3,160,1398,114,20199,46
57006,33,661,561,497,12409,164
29583,108,2259,1144,1266,19090,993
38188,10,190,959,138,5016,52
17360,14,228,1376,152,6607,76
49071,38,524,795,437,6669,87
40093,14,257,928,201,6804,56
22033,8508,277803,1295,159616,580348,118187
18102,14,492,1362,358,8348,134
61520,367,7748,412,5371,36876,2377
9538,161,4243,1472,2839,23320,1404
63195,7,136,362,107,5005,29
18901,192,3918,1349,2721,44257,1197
61168,316,8503,423,6932,62486,1571
56991,5,64,560,45,3691,19
69912,15,309,156,290,7182,19
22754,618,14430,1284,9362,64750,5068
18389,14,819,1357,630,15490,189
10011,150,2703,1469,1758,27542,945
58207,28,192,527,157,7299,35
21268,6,468,1307,328,7706,140
31603,109,1479,1107,988,18471,491
1284,4,133,1554,80,23468,53
61626,5,42,409,31,1777,11
16373,14,857,1393,599,34063,258
62672,184,2757,375,2208,19550,549
24019,7312,169544,1261,103931,604415,65613
35206,16,361,1036,268,5726,93
54663,89,890,628,773,17846,117
25432,22,704,1230,459,13448,245
64563,14,102,323,86,1720,16
28719,19,593,1160,355,14864,238
67073,5,56,250,45,2697,11
53944,109,1472,655,1182,16650,290
61842,13,138,402,112,4834,26
29526,535,13829,1145,10055,74917,3774
54426,643,7183,638,5996,54463,1187
28350,27,1131,1167,610,7866,521
55922,63,781,592,658,9781,123
66475,2,71,270,59,2676,12
25999,313,8932,1218,5631,39891,3301
56959,14,227,562,148,3714,79
22214,173,2780,1293,1725,34584,1055
24922,28,1483,1241,989,59710,494
23288,3,51,1275,31,2281,20
5666,871,11624,1509,7903,45113,3721
60579,7,77,445,58,2937,19
36175,1431,46675,1013,36741,245724,9934
60609,7,476,444,311,7212,165
32985,35,558,1084,344,6947,214
25157,0,0,1236,0,9486,0
62732,62,400,374,284,6493,116
7010,1690,138891,1492,79626,664088,59265
4944,12,249,1518,165,21218,84
37611,3,48,974,36,3341,12
18933,20,645,1348,407,8990,238
1824,46,1306,1550,951,39043,355
49684,379,4549,777,3676,29934,873
63083,43,395,365,339,13748,56
17945,8,888,1365,355,16484,533
1294,486,18117,1554,11907,89805,6210
19770,82,1503,1333,996,9987,507
16488,22,508,1391,355,13859,153
16753,270,8441,1387,6118,58731,2323
31971,34,952,1101,645,16356,307
52322,4651,87202,704,57338,367210,29864
19849,56,1925,1332,1389,25248,536
69747,24,486,162,400,6191,86
5340,90,2474,1513,1631,37967,843
69415,38,365,173,305,7405,60
5570,95,2311,1510,1422,17822,889
55685,33,553,599,442,10908,111
65122,3,73,305,54,2040,19
60747,38,488,438,389,6933,99
54406,142,1047,639,866,29126,181
4512,32,738,1524,551,18193,187
69782,8,157,160,115,6595,42
29574,17,773,1144,509,14627,264
5194,35,1310,1514,795,18741,515
6799,17,555,1495,412,31768,143
27982,340,5612,1174,3173,46020,2439
28569,72,1696,1163,1110,9897,586
11261,51,2633,1461,1394,17599,1239
70205,23,182,147,159,7670,23
37725,142,2228,971,1946,21976,282
6224,197,7811,1502,4439,17858,3372
61812,91,1243,393,1041,14868,202
24021,176,7987,1261,5212,29262,2775
5078,64,1160,1516,816,40779,344
28043,472,22639,1173,15613,131288,7026
53166,14,185,676,151,2930,34
49905,577,7993,762,6155,49496,1838
11311,32,1255,1460,721,10781,534
13779,19328,757629,1431,452647,1269907,304982
37689,52,1156,972,1000,24674,156
40822,83,1243,917,956,10969,287
10940,3714,100338,1463,61764,182532,38574
23988,4,83,1262,67,9486,16
36916,248,3868,995,2983,30940,885
64476,2,10,325,10,2063,0
25403,62,1261,1231,870,11659,391
40194,134,3273,926,2141,67447,1132
16195,121,3663,1396,2460,30857,1203
20109,24,1070,1327,733,18577,337
22256,63,3121,1292,2405,46958,716
3276,7,544,1538,405,33700,139
58714,45,704,509,556,7093,148
67811,1189,23852,226,18494,130737,5358
53505,76,1269,669,1096,19916,173
24791,33,906,1244,632,21367,274
16332,272,2940,1394,2367,40083,573
48504,66,775,812,544,6451,231
64291,47,571,330,445,15436,126
54905,22,1079,620,650,4310,429
31096,379,10932,1114,6807,51496,4125
11248,3,210,1461,124,17125,86
30778,44,1055,1120,742,27652,313
5957,4,360,1506,276,9155,84
4346,337,20855,1526,12445,102067,8410
64177,17,348,334,264,6659,84
63895,248,5752,343,4647,29503,1105
57033,5,141,560,112,11074,29
58486,75,874,516,709,10346,165
67243,18,333,244,279,3950,54
11511,829,19338,1458,12000,58158,7338
14263,1085,26005,1423,16081,103184,9924
34001,13,315,1065,182,3606,133
48885,110,1689,800,1398,20514,291
22564,2,140,1287,100,8795,40
61689,72,1046,407,811,7697,235
3777,9,536,1532,393,20739,143
21626,32,548,1300,364,9221,184
4726,11,497,1520,369,17699,128
10629,109,3136,1465,2134,37741,1002
20372,618,17628,1323,12606,97379,5022
54230,4,44,645,36,3515,8
27636,1022,41204,1181,27562,189909,13642
33931,42,1374,1066,948,32313,426
59762,35,236,474,203,5196,33
62016,39,1559,395,1205,35808,354
32084,96,784,1099,541,7728,243
62491,240,2689,381,2227,17173,462
34676,72,1585,1050,918,8608,667
65524,0,26,297,21,2461,5
48899,7,79,794,62,5683,17
36966,9,946,985,788,9107,158
49033,141,3860,796,2960,17892,900
30685,90,1058,1122,751,17165,307
38048,285,8350,963,5971,57744,2379
29311,1574,22358,1149,16336,145439,6022
20053,1,51,1328,35,8234,16
44425,0,25,864,20,7094,5
61001,2,52,429,40,3360,12
41020,33,446,913,352,5230,94
50055,10,149,768,117,10903,32
33296,1985,34558,1078,25739,123306,8819
27998,6,90,1174,67,4718,23
36925,10372,444035,994,317283,1074880,126752
66201,330,4241,277,3270,32630,971
42622,81,925,887,722,18548,203
22147,30,668,1294,450,13803,218
10337,72,2065,1467,1373,18040,692
23953,138,4063,1263,2172,92584,1891
39603,12,405,935,313,6379,92
16154,11,423,1396,291,7099,132
38020,2008,41439,964,29382,355892,12057
58619,103,2170,512,1712,8884,458
23180,41,878,1276,617,17041,261
24807,191,4016,1243,2549,25614,1467
7901,7804,186796,1480,99173,370649,87623
5200,16,839,1514,580,22934,259
47135,216,4639,833,3617,52153,1022
66218,14,224,277,186,7439,38
8233,53,1298,1478,966,25571,332
35519,12,275,1029,152,5292,123
1763,159,5579,1551,3910,45698,1669
13289,0,0,1438,0,5734,0
35263,76,1813,1035,1359,13157,454
8860,86,3945,1475,2499,40071,1446
495,46,1706,1561,1216,19415,490
31400,1,66,1110,34,3447,32
26604,17,710,1204,444,15967,266
21389,105,1082,1304,850,10972,232
67973,19,221,221,197,3404,24
26928,20,717,1197,434,36287,283
58343,16,415,522,309,8583,106
29630,66,1602,1143,968,52500,634
35891,39,1362,1021,1002,10170,360
9590,143,3892,1472,2575,46828,1317
57333,23,270,553,210,4038,60
41967,43,455,898,331,4641,124
66721,2,27,262,24,1939,3
21118,164,2961,1309,2152,19601,809
51798,1307,17335,721,15019,178787,2316
20112,39,1351,1327,1000,76187,351
29232,247,5372,1150,3716,28258,1656
62474,17,435,381,382,8809,53
38418,13,131,953,107,5734,24
12448,48,1265,1449,866,35179,399
3256,68,1201,1538,809,21647,392
22613,312,14023,1286,9377,81803,4646
40579,1289,36881,921,22010,90386,14871
26454,5,370,1208,232,15419,138
35048,1423,30867,1041,22939,245002,7928
36308,12,305,1009,246,8828,59
54512,27,314,635,249,5108,65
34931,84,1615,1044,1138,18066,477
23319,3,140,1275,99,6716,41
20511,4,98,1320,85,6013,13
682,15,1007,1559,684,12684,323
30708,15,516,1121,343,23559,173
65258,125,2439,301,1902,22634,537
8110,202,3800,1478,2295,19082,1505
54690,23,146,628,116,4326,30
980,17,1363,1557,1027,16596,336
34150,2639,45058,1062,29268,178728,15790
627,2120,75654,1559,44531,214300,31123
5440,131,3525,1511,2323,60172,1202
54156,105,963,648,796,10461,167
56180,204,3132,584,2141,32144,991
53482,19,174,669,134,5524,40
44445,237,3851,864,3131,30448,720
36367,63,488,1007,370,5969,118
28116,9,197,1172,135,8432,62
22699,75,2720,1285,1824,54714,896
50357,1009,36408,760,28300,117717,8108
55887,30,302,593,219,4603,83
2458,111,2700,1545,1504,22959,1196
22785,0,0,1283,0,14787,0
17655,45,928,1371,623,6663,305
53856,17,333,658,248,7916,85
68494,107,1388,204,1274,18492,114
67873,118,1912,224,1679,13306,233
68378,16,180,209,138,2870,42
49756,9277,133786,775,96460,557083,37326
2454,150,4551,1545,3105,42025,1446
10559,351,17529,1466,9539,55103,7990
37787,0,111,970,86,5903,25
23933,4,191,1263,89,5523,102
32241,16,291,1097,181,6661,110
18900,59,3171,1349,1745,22222,1426
40525,653,12968,921,10587,90961,2381
25704,34254,708398,1224,500205,2124682,208193
21261,642,18775,1307,12595,95944,6180
53154,54,769,676,564,12853,205
7529,137,3107,1485,2065,21675,1042
16248,11590,268444,1395,195707,788839,72737
33526,59553,1468675,1074,771839,2679141,696836
62787,112,1128,373,971,8936,157
33295,73,1553,1078,1133,16475,420
42920,17,547,882,468,9572,79
66554,23,308,267,214,8497,94
60476,10,120,449,91,6040,29
32012,34,1600,1100,1062,31208,538
18267,1,71,1360,55,2990,16
53819,6,141,659,91,4632,50
37169,95,1098,987,821,13988,277
5652,42,1148,1509,806,19780,342
65123,17,155,305,131,3076,24
14886,248,6138,1416,4814,53373,1324
67594,9,97,233,77,1623,20
13064,841,15952,1440,11008,44756,4944
20784,431,7803,1316,5204,104091,2599
6156,112,4485,1503,3010,72481,1475
46415,3,35,843,28,4512,7
11108,306,15937,1462,8980,68987,6957
12967,2,112,1442,66,9014,46
65568,21,106,295,88,2624,18
56146,19,236,585,179,7244,57
12135,125,5763,1453,2589,98271,3174
34144,16,383,1062,248,9039,135
17861,168,3150,1367,2225,49389,925
58866,16,152,505,117,4918,35
4552,12,357,1523,260,13970,97
27980,335,11291,1174,7162,59072,4129
14390,24,644,1421,472,10280,172
50235,16,238,763,201,4673,37
62319,39,360,386,289,6439,71
49709,5,92,777,65,10662,27
42768,233,4862,885,3864,47996,998
59705,11,271,476,236,4685,35
52404,51,431,702,299,3980,132
31193,63,1265,1113,863,11780,402
35126,424,12529,1039,9613,70209,2916
44693,5,124,862,93,5803,31
4352,38,1742,1526,1213,25301,529
58955,27,374,501,331,6788,43
14176,4237,168279,1425,119253,489708,49026
6369,7,177,1501,121,6092,56
49696,115,1535,777,1375,21112,160
33960,5,64,1066,41,4473,23
6546,1848,49111,1498,30612,194890,18499
42456,98,1681,890,1103,5605,578
26546,23,430,1206,339,10031,91
7342,10,261,1488,181,9361,80
180,772,53522,1564,37386,299367,16136
39349,290,5464,938,4441,35767,1023
18447,7,320,1356,211,12177,109
66100,9,168,281,118,4060,50
16017,648,22660,1398,16250,140721,6410
23357,0,0,1274,0,3114,0
4146,14,467,1529,288,8265,179
55355,85,646,607,516,8865,130
53118,175,3566,678,2144,23771,1422
66082,2,49,282,35,2672,14
44536,22,702,863,518,10579,184
48035,134,1913,822,1533,14480,380
29794,65,2635,1140,1517,19366,1118
217,97,7817,1563,5447,52806,2370
67670,10,158,231,114,6785,44
10500,50,1320,1466,889,15304,431
60419,46,418,452,362,9142,56
63563,19,316,353,225,7585,91
23535,37,901,1271,753,40115,148
25228,130,2998,1235,1879,58822,1119
31399,78,1019,1110,677,11417,342
1313,11,692,1554,450,12977,242
37903,99,3640,968,2887,31163,753
69055,2,67,185,41,3054,26
51931,42,2426,718,1697,25581,729
23720,288,5797,1267,3724,61354,2073
63467,22,383,355,279,5334,104
50747,12,233,713,202,10625,31
68995,17,447,186,407,17773,40
18530,107,3185,1355,2324,37249,861
2501,9,308,1545,232,15410,76
11480,27,891,1459,592,19326,299
68311,5124,117448,199,84043,372335,33405
21084,284,6672,1310,4511,41784,2161
1053,2,88,1556,52,7594,36
49937,68,1192,771,956,40557,236
28897,46,864,1157,589,43857,275
38959,64,2401,943,2043,27773,358
27578,734,17783,1182,11620,82448,6163
41633,79,1527,903,1268,32370,259
57108,3,111,558,56,7753,55
17895,42,1655,1366,1229,16875,426
54440,43,542,637,406,10915,136
20091,18,616,1327,431,14763,185
66997,61,676,236,523,6453,153
8983,14,1285,1475,864,14121,421
25748,94,2483,1223,1576,40480,907
62036,350,7945,395,6072,33316,1873
31325,2518,61389,1111,36128,230334,25261
27403,15,411,1187,368,22994,43
57312,30,237,553,176,5439,61
56566,170,1588,573,1295,12151,293
12006,894,22121,1454,13446,109955,8675
41247,12,86,910,74,8552,12
16279,4,84,1395,41,6068,43
51062,111,899,742,742,16651,157
17711,727,17144,1370,12714,86572,4430
48699,14,1277,806,1001,14182,276
59366,105,1703,488,1324,12028,379
48751,38,626,805,440,15406,186
68979,13,179,187,153,4844,26
1585,379,13967,1552,9221,183668,4746
25556,168,5272,1228,3433,30515,1839
8561,251,11494,1477,7043,113868,4451
28963,120,2991,1155,1931,14647,1060
23191,19,537,1276,460,36925,77
34647,34,795,1051,602,10601,193
20769,104,3555,1316,2256,42381,1299
621,50,1611,1559,1176,19438,435
30490,25,799,1125,532,16341,267
70160,11,83,148,66,2005,17
69232,9,56,179,47,1386,9
61241,1,15,420,12,1766,3
24767,163,3005,1244,1886,16468,1119
61828,10,197,402,157,6473,40
54012,96,749,653,642,25814,107
56957,189,2002,562,1655,15131,347
41132,192,3049,911,2284,59955,765
67974,12,207,221,140,4247,67
10344,23,788,1467,505,14429,283
32435,5,445,1094,264,8847,181
49538,68,1516,781,1327,13048,189
34900,25,587,1044,540,17115,47
59916,27,293,469,239,3306,54
35713,2768,76769,1025,55817,348941,20952
67831,92,829,226,622,5908,207
52277,689,9721,707,7658,56251,2063
19084,29,379,1345,252,9031,127
28332,0,58,1167,36,8718,22
20395,21,880,1322,682,22762,198
4362,10,224,1526,156,9091,68
21638,91,1488,1300,957,15583,531
68681,3,29,197,19,3852,10
36448,1,29,1005,26,1676,3
27237,5,443,1191,284,10377,159
6764,80,1448,1495,1054,11202,394
52223,7,83,708,75,6206,8
35110,11,144,1039,104,4986,40
29228,99,3357,1150,2107,29228,1250
65390,14,363,300,257,4440,106
43891,510,12630,871,9693,137761,2937
2877,222,5694,1541,4040,24244,1654
48265,6370,94021,819,68635,260732,25386
6034,190,7283,1504,4688,90230,2595
66154,11,219,279,176,4579,43
64390,33,869,328,738,10749,131
3118,20,692,1539,481,21403,211
22553,27,717,1288,516,8450,201
3084,929,44013,1540,24026,135432,19987
70319,7,263,143,238,4808,25
46703,526,8859,838,5807,52021,3052
53990,67,673,653,561,11339,112
62830,342,4604,372,3737,37513,867
31837,63,1839,1103,1305,9443,534
40142,394,6821,927,4538,26378,2283
56557,503,10493,573,8301,134027,2192
62977,14,336,368,222,7211,114
47415,11,336,829,263,6429,73
68568,7,47,201,37,2174,10
69099,15,226,183,172,8862,54
21044,38,1229,1311,861,32707,368
5488,12,796,1511,570,12542,226
26572,120,4641,1205,3040,21432,1601
58309,6,35,523,34,2579,1
22202,0,490,1293,304,11375,186
36897,140,1466,995,1092,12390,374
17862,8,191,1367,123,6778,68
28122,89,2470,1172,1580,51441,890
49892,2020,29970,772,25034,183866,4936
17780,147,4654,1368,3275,160847,1379
34014,63,1125,1064,800,16966,325
21364,135,3162,1305,1990,23863,1172
63249,11,242,361,189,5453,53
19424,2,92,1339,74,8989,18
39263,34,384,939,302,14664,82
22708,19,336,1285,244,3366,92
32333,10,421,1096,272,26959,149
29760,16,1418,1141,803,32313,615
17769,81,3164,1369,2311,61057,853
39738,221,3945,933,3102,33683,843
12107,1,346,1453,176,16135,170
60429,6,105,451,72,4728,33
55698,8,76,598,64,9565,12
7320,20,461,1488,323,20537,138
17121,48,1463,1381,1050,19468,413
65422,6,103,299,72,5159,31
8252,19,663,1478,479,13758,184
53432,10,175,670,123,4794,52
12578,127,4619,1447,2980,45529,1639
61988,21,239,396,175,7267,64
50101,159,2076,767,1206,16564,870
20079,0,137,1328,107,9039,30
51887,3,50,719,47,4759,3
6755,2,142,1495,86,10062,56
58911,22,293,503,214,5350,79
7184,2816,50180,1489,33584,352053,16596
65983,59,982,285,724,3925,258
19185,3,53,1344,42,5359,11
66783,837,15449,259,11509,92355,3940
65509,43,804,297,720,10941,84
63211,15,306,362,201,7818,105
40495,1412,26479,921,20540,211193,5939
42566,47,989,889,727,23302,262
6969,29,712,1493,492,31508,220
56333,58,897,580,748,12012,149
15933,38,558,1400,422,24362,136
52723,110,1078,690,881,15842,197
60636,944,15534,442,12540,137709,2994
21238,39,767,1307,615,28353,152
14646,832,51145,1418,37242,294078,13903
33117,3208,86201,1081,59543,308679,26658
33845,9,293,1068,247,12353,46
30599,420,3091,1123,2170,27665,921
26647,10,290,1203,159,5653,131
54509,13476,200410,607,156847,1125981,43563
5421,9,1007,1512,628,35436,379
58212,1088,17072,526,12334,64277,4738
53763,50,481,661,348,7525,133
10254,814,24073,1468,14864,69678,9209
6948,11,646,1493,463,31697,183
61969,48,926,397,786,30222,140
560,62,1924,1560,1377,20115,547
64467,17,295,325,225,5555,70
34715,273,7248,1048,5322,93931,1926
13263,82,1539,1438,992,35151,547
8207,1735,66652,1478,37082,162525,29570
61677,10,151,407,120,3468,31
33536,2,118,1074,71,6544,47
41836,144,4044,900,3100,57324,944
6906,174,2433,1494,1701,18242,732
55272,10,104,610,60,2402,44
25060,0,0,1237,0,12794,0
33984,13,95,1065,87,12793,8
49595,6,306,780,228,18078,78
22547,42,1020,1288,795,14290,225
69089,11,174,184,140,5769,34
51166,953,11759,739,8714,37916,3045
16539,788,37917,1390,22509,199172,15408
69211,2,34,179,22,1625,12
35974,18,402,1019,298,18084,104
6425,276,6407,1500,4300,67198,2107
47253,25,530,831,445,9501,85
7027,60,1603,1492,1146,37994,457
56267,15,156,582,99,2455,57
24557,505,14742,1249,9981,101092,4761
66908,54,663,255,445,8961,218
558,74,2985,1560,2160,45339,825
62960,299,5275,369,4107,68256,1168
53251,215,4073,675,3345,55052,728
34307,6298,133133,1059,86906,326330,46227
48469,42,1034,814,750,10399,284
24759,778,22178,1244,14565,92074,7613
14626,1583,93219,1418,52329,432924,40890
61016,531,7559,429,5961,52464,1598
13938,54,2749,1428,1559,11999,1190
21667,157,6823,1300,4167,71408,2656
27714,98,2258,1180,1510,44529,748
5519,455,15167,1510,9427,44865,5740
52856,244,2296,686,1769,18078,527
49562,643,8336,781,6778,59234,1558
32498,190,2852,1092,2098,34815,754
5571,31,1417,1510,963,66436,454
58678,20,434,510,361,13996,73
34646,11,490,1051,316,5149,174
14505,227,6408,1420,3954,34780,2454
32445,38,726,1094,402,9230,324
22317,23,710,1291,527,11561,183
9849,12,791,1471,506,18644,285
49437,61,1013,784,784,20224,229
59918,39,705,469,571,12621,134
52565,29,658,696,482,16536,176
56748,54,1026,566,783,24047,243
17382,24,1235,1376,845,12788,390
70119,22,216,150,186,1898,30
67495,7,143,236,119,4768,24
54301,12,126,642,102,4266,24
16022,340,17437,1398,11446,68984,5991
26056,225,8326,1216,5545,65837,2781
58244,233,4843,525,3799,25364,1044
15069,19,555,1413,374,16173,181
27620,1375,23785,1181,15331,149587,8454
20301,82,1194,1324,869,12578,325
25494,191,3989,1229,2575,36157,1414
29685,44,805,1142,554,5869,251
69706,30,301,164,271,4590,30
37561,55,974,976,774,22254,200
5577,3899,160406,1510,101522,1206502,58884
53655,85,686,664,512,7850,174
21414,330,5288,1304,3513,71477,1775
21179,2,220,1308,152,6965,68
60772,573,10815,437,8446,55919,2369
70187,2,77,147,37,2292,40
31758,516,9680,1018,6823,28971,2857
54966,357,4553,618,3690,47159,863
3582,307,14273,1535,7304,53605,6969
21322,64,1515,1306,1053,9172,462
12869,24,1663,1443,765,11825,898
18113,4067,201804,1362,129804,837175,72000
63456,476,6685,356,4483,26746,2202
46121,1996,42165,846,32923,198263,9242
10142,339,10711,1469,7467,28060,3244
36708,50,555,1000,414,9768,141
37558,8,221,976,170,7998,51
29018,150,2816,1154,2497,13496,319
54826,195,1374,623,1061,12630,313
19179,116,4147,1344,2532,18469,1615
53554,0,117,667,108,7805,9
9867,6,151,1470,94,5266,57
37621,269,4720,974,3754,29222,966
491,5,398,1561,253,27500,145
22996,1231,21471,1280,15227,68954,6244
12633,59,2405,1446,1415,26842,990
30725,9,125,1121,88,5967,37
29182,105,4115,1151,2959,41791,1156
5373,32,740,1512,491,15594,249
27553,10,301,1183,200,10676,101
17717,256,5100,1370,3502,30742,1598
23415,135,3209,1272,2236,27396,973
2862,6,108,1542,63,10036,45
13857,9,264,1429,156,8704,108
69547,85,1115,169,1068,10692,47
36076,6,60,1016,47,4075,13
401,32,858,1561,576,21375,282
54956,3094,49205,617,39497,265474,9708
36486,117,1233,1003,993,18832,240
62452,2,21,382,20,3619,1
55693,3,33,598,33,5912,0
37483,281,4790,974,3947,45648,843
64774,53,815,317,391,5086,424
68873,45,487,190,400,2814,87
54842,7,61,622,52,4838,9
11459,1743,37741,1459,23604,157938,14137
64789,23,335,316,254,5553,81
1055,29,693,1556,525,17809,168
25067,7,191,1237,149,7733,42
67376,29,184,240,135,2754,49
20752,26,622,1316,441,5993,181
37351,261,3837,981,3044,27837,793
64824,93,719,315,562,5441,157
58218,212,3048,526,2344,16813,704
69178,44,732,180,656,6529,76
12307,412,12301,1451,7506,60451,4795
55032,999,12329,616,9620,54107,2709
66966,26,280,253,230,5711,50
25141,16,189,1236,125,4452,64
63701,2,9,349,7,1374,2
6271,96,2540,1502,1764,54676,776
11282,769,23793,1460,15049,140305,8744
6062,72,1389,1504,887,14304,502
27331,158,9092,1188,5756,50909,3336
14307,282,8765,1423,6053,101852,2712
68705,2,57,196,35,3964,22
15325,411,18502,1410,11742,99420,6760
40485,18,247,922,178,7647,69
19701,175,6298,1334,4413,30394,1885
22752,0,51,1284,44,11279,7
8918,232,8177,1475,4999,40551,3178
15100,92,4776,1413,3406,27699,1370
284,20,696,1562,463,74212,233
56255,8,97,582,74,3319,23
36221,1232,23876,1012,19516,129284,4360
40195,47,654,926,483,13078,171
68804,4,61,193,53,4014,8
31255,68574,1284656,1112,865013,2719614,419643
28870,31,1814,1158,1046,22091,768
144,126,8604,1565,4390,32770,4214
53958,187,2245,655,1878,13719,367
66870,39,413,257,336,8521,77
18223,14,1385,1360,1024,36825,361
25555,55,1531,1228,1017,11680,514
69620,22,221,165,198,10210,23
16401,173,4885,1392,3559,52588,1326
10644,7,269,1465,188,9090,81
32816,23,583,1087,370,16871,213
20490,22,919,1321,641,9907,278
772,251,8796,1558,6064,37987,2732
51569,3480,58773,728,48369,351169,10404
9070,411,9574,1474,5994,114042,3580
33870,3,137,1068,100,13449,37
17432,74,1900,1375,1352,19073,548
52925,36,524,684,423,14753,101
40380,33,300,703,200,4268,100
23084,60,2507,1278,1645,41478,862
64065,80,815,337,701,8020,114
59362,876,19889,488,13387,107386,6502
64944,4,68,311,65,8005,3
10388,5,158,1467,88,7769,70
1914,141,4126,1550,2694,30000,1432
31034,823,22383,1115,14472,50899,7911
10666,7,728,1465,451,13758,277
60622,11,183,443,153,10768,30
44927,12,149,859,123,6505,26
36177,4690,117439,1013,74727,379114,42712
64171,192,2867,334,2054,11815,813
63177,667,9644,362,8088,53348,1556
9318,556,35033,1473,21521,198106,13512
17666,36,992,1371,765,26415,227
24054,15,336,1260,255,9712,81
6583,594,26867,1498,16472,180499,10395
2024,78,2382,1549,1376,20507,1006
54309,521,5328,642,4314,53028,1014
15034,300,3859,1413,2464,28031,1395
21982,70,2431,1296,1506,14461,925
5904,141,5563,1506,3631,108422,1932
4374,8095,165427,1525,106175,667970,59252
16382,71,1770,1393,1167,13817,603
48467,1939,45536,814,31481,264179,14055
56224,30,371,576,285,7525,86
67139,6,100,248,72,9831,28
9669,197,11368,1472,7069,202156,4299
13057,806,12443,1440,8617,92937,3826
58936,24,486,502,335,10658,151
12884,83,739,1443,514,13333,225
56265,29,294,582,241,7637,53
39021,169,2882,942,2169,23139,713
65683,92,1250,292,975,6819,275
17885,7,111,1366,88,12061,23
58231,19,200,525,165,7898,35
20969,59,3259,1312,2162,58004,1097
56099,364,6578,587,5256,50411,1322
22037,526,16465,1295,11176,164436,5289
36120,302,5671,1015,4545,70372,1126
14424,110,3082,1421,2290,29072,792
37443,93,1442,979,1197,14434,245
13137,135,5161,1439,3307,40182,1854
53522,28,228,669,181,4563,47
30560,11,248,1124,158,2706,90
55767,672,8929,596,7474,56172,1455
61445,5,48,414,37,2570,11
23356,9,364,1274,305,13195,59
23909,74,1746,1264,1230,35746,516
52467,25,225,699,197,5784,28
8416,3,145,1477,96,3970,49
60648,20,216,442,180,13595,36
58551,60,1253,514,975,14670,278
16341,290,4681,1394,3420,54121,1261
15033,37,839,1413,551,14202,288
11837,86,5364,1455,3152,31558,2212
56046,43,661,588,553,4993,108
52687,27,334,691,248,14407,86
48907,693,10010,800,7138,47349,2872
13,116,4262,1567,2462,52325,1800
48911,59,646,800,515,19297,131
49419,182,3026,783,2559,39946,467
17534,213,3555,1373,2518,53168,1037
32073,471,9914,1100,7202,49735,2712
53912,283,4451,656,3445,17858,1006
58411,13,312,520,220,10461,92
3398,112,2648,1537,1911,23342,737
23183,22,1225,1276,814,17741,411
52593,2196,39562,691,31007,265588,8555
243,187,7487,1563,5138,54954,2349
12786,28,988,1444,512,7345,476
21513,6,118,1302,77,9084,41
32902,146,2605,1085,1608,19043,997
28171,2,58,1171,37,7359,21
1862,7,455,1550,315,17420,140
15728,6,601,1403,410,15695,191
884,7,302,1557,205,22741,97
56111,581,4548,587,4164,40440,384
63676,69,623,350,490,4726,133
8867,250,11358,1475,7865,74797,3493
61562,2,64,411,43,2447,21
22502,31,610,1289,397,17438,213
57609,44,947,546,643,15765,304
3130,0,154,1539,118,14829,36
34122,165,3301,1062,2388,29261,913
40721,85,1581,919,1234,18950,347
41848,163,3438,900,2743,58660,695
68950,2233,63501,188,53795,253960,9706
14669,9,460,1418,332,11666,128
7667,11,600,1483,441,41472,159
29335,561,20118,1148,13493,86127,6625
44185,8,266,867,208,7780,58
10038,35,984,1469,621,24240,363
69107,2,68,183,56,2936,12
24752,22,494,1244,351,10194,143
17764,29,440,1369,301,12565,139
63784,2,36,347,35,3102,1
10617,56,3030,1466,1924,76924,1106
70365,28,322,142,284,2935,38
60239,34,267,458,217,2779,50
6496,3026,78533,1499,45947,221556,32586
51474,87,960,731,638,6831,322
68233,13,199,214,166,4029,33
60861,41,448,419,342,8575,106
39780,664,6919,933,5377,33593,1542
53002,24,272,682,212,7647,60
63444,10,202,356,158,5075,44
392,57,1257,1561,942,14241,315
54204,107,1399,646,1283,20532,116
794,13,471,1558,347,24839,124
53541,4001,50552,668,40263,281025,10289
27908,226,6320,1175,4350,75757,1970
63078,33,929,365,681,6442,248
66821,44,373,258,320,5503,53
57805,363,7701,540,5400,29270,2301
38566,417,5957,820,4808,32026,1149
70199,46,739,147,708,8259,31
22705,52,1574,1285,1102,33027,472
17155,71,2060,1380,1451,31268,609
65054,125,2221,307,1909,16150,312
32843,17,383,1087,266,9538,117
50150,24,327,766,286,13994,41
51625,70,872,726,671,12997,201
31852,23,445,1103,383,14372,62
24213,39,986,1257,721,15631,265
22578,49,1519,1287,1156,10129,363
56505,1,30,575,24,6382,6
30140,38,919,1132,820,57076,99
15720,8,823,1404,418,14931,405
23786,89,2733,1266,1965,18930,768
65058,6,100,306,80,2343,20
4321,47,1427,1526,953,19577,474
69977,13,226,155,204,2693,22
19975,41,1190,1330,922,15935,268
59532,4,53,482,43,3686,10
19251,30,916,1342,722,13083,194
17639,81,1963,1371,1366,25575,597
20470,138,3846,1321,2633,30212,1213
44896,350,4851,859,3764,79102,1087
64518,154,2971,324,2356,26662,615
20636,118,2260,1318,1609,20145,651
68317,5,33,210,24,3541,9
6756,43,2090,1495,1383,21545,707
25594,127,2868,1227,1917,48976,951
21595,176,5069,1301,3309,29689,1760
8796,227,9820,1476,6024,95869,3796
70608,19,336,133,313,7524,23
6228,105,4233,1502,2793,73147,1440
65988,10,178,285,107,4380,71
31951,27,636,1102,443,20457,193
24965,53,1589,1240,983,7794,606
7673,18,448,1483,277,13279,171
26975,51,986,1196,590,21912,396
39845,111,1866,930,1504,54799,362
25179,543,10956,1236,7403,36468,3553
36207,292,5779,999,4491,56038,1288
12430,206,5384,1449,3305,40169,2079
11766,56,2616,1456,1070,25318,1546
2530,24,1082,1545,725,21845,357
1762,21,1060,1551,687,25514,373
13069,78,3186,1440,1849,61633,1337
12195,238,11448,1452,7160,77987,4288
40374,27,320,924,283,8399,37
1409,3629,126976,1553,78057,266847,48919
58682,10,72,510,45,18393,27
507,236,6102,1560,4700,273622,1402
51742,144,2682,723,2217,40906,465
41868,354,4648,899,3851,22898,797
51713,171,1412,724,1121,19802,291
35861,39,536,1022,403,3860,133
52298,507,6345,705,5266,76234,1079
12424,2895,128565,1449,69486,667111,59079
49916,5,65,771,49,2885,16
64212,6,54,331,42,3607,12
28267,71,5466,1169,3989,67069,1477
62256,10,163,388,131,2736,32
35208,6,141,1036,96,6487,45
36230,7,143,1012,113,5251,30
17448,4,232,1375,185,29157,47
5642,783,39506,1509,25102,203580,14404
31462,58,1097,1105,705,28073,392
4694,36,993,1521,679,22417,314
57806,39,397,539,320,11006,77
53831,9,61,659,55,5699,6
67196,57,1356,246,949,16173,407
2909,641,10451,1541,8350,49764,2101
58186,17,277,527,223,5609,54
14212,12,529,1424,382,26924,147
176,229,9014,1564,6047,32486,2967
5548,67,2311,1510,1479,13205,832
26808,16,374,1200,190,5184,184
16941,55,1627,1384,1118,18790,509
21074,32,1045,1310,661,10111,384
57931,79,629,536,502,5727,127
6394,1016,56495,1500,36834,293491,19661
35910,16,232,994,158,7873,74
50214,3212,83307,764,65010,626823,18297
23144,56,3318,1277,2119,30659,1199
10350,17,444,1467,271,8184,173
46845,27,263,836,226,6720,37
23696,130,4012,1268,2603,19135,1409
57638,42,434,545,312,16088,122
11280,41,1761,1460,986,55705,775
36395,46,711,1006,528,10874,183
67002,76,800,252,623,6973,177
16232,7,325,1395,210,4866,115
62571,41,289,378,233,4250,56
18576,34,1604,1354,1255,32807,349
626,48,1381,1559,914,23423,467
33640,4,328,1072,178,7332,150
32542,83,1298,1091,946,8224,352
15695,0,0,1404,0,5154,0
70080,4,48,151,39,2718,9
29988,75,1500,1136,929,21454,571
53067,2316,48070,680,38276,181997,9794
37853,58,1103,968,860,9850,243
66471,33,509,270,372,12897,137
14895,71,6300,1415,4384,20823,1916
58152,31,404,528,324,6173,80
1971,2624,112102,1549,69295,390150,42807
11574,31,855,1458,524,33900,331
23294,15,356,1275,220,5413,136
6451,19,426,1499,317,20769,109
28576,120,9405,1163,5239,53745,4166
30450,63034,1989997,1126,1226217,4643018,763780
21050,11,447,1311,323,8393,124
66582,2,37,266,28,1154,9
68037,75,886,219,643,15536,243
15175,92,3025,1411,2051,40093,974
62253,13,317,388,263,8295,54
53298,73,900,674,753,12349,147
64918,220,5126,312,4117,25624,1009
42438,42,918,891,721,13940,197
18307,16,765,1359,512,15946,253
52665,78,747,690,594,10829,153
69999,76,2082,154,1846,12067,236
59482,40,659,484,492,18140,167
15057,18,789,1413,564,53418,225
1596,61,2094,1552,1466,49495,628
45515,16,866,852,663,20143,203
17130,178,4646,1381,3377,31718,1269
16562,29,1637,1390,1038,12743,599
68062,13,152,217,108,4275,44
56249,161,5505,583,4449,34242,1056
21685,0,0,1300,0,4419,0
64235,9,56,332,55,1616,1
32981,96,817,1084,506,8073,311
68376,17,253,209,199,7656,54
53836,59,581,659,480,9419,101
13131,18,1053,1439,535,14848,518
63602,33,387,352,311,6524,76
3075,478,16303,1540,10421,97116,5882
32533,0,55,1092,44,4171,11
66391,39,301,272,241,2496,60
6276,4787,243266,1502,144592,789628,98674
27465,15,380,1186,226,3305,154
50207,188,3114,764,2466,43541,648
67708,76,687,230,534,7323,153
60447,44,504,450,393,7543,111
29059,762,15273,1154,10456,81564,4817
57322,78,1051,553,858,33318,193
32408,546,8380,1094,5654,138947,2726
16698,70,1839,1388,1456,20509,383
41531,44,934,906,749,12298,185
7413,6,515,1487,330,8234,185
14287,0,0,1423,0,9967,0
36042,6,187,1017,139,2751,48
41138,25,500,911,398,7019,102
27196,5,224,1191,141,4673,83
62197,7,181,389,131,5064,50
65603,3,66,295,43,2916,23
9235,16,324,1474,217,13938,107
2079,26,544,1548,374,18741,170
11439,830,37239,1459,21333,282628,15906
365,209,8948,1562,5540,57188,3408
70034,57,1029,152,960,10907,69
57314,14,298,553,201,7567,97
32372,714,26956,1095,18002,161243,8954
51098,14,150,741,126,6186,24
9494,25975,1189416,1472,678759,3352158,510657
67502,1,41,236,36,4414,5
65129,4,27,305,17,5246,10
65580,99,1010,295,767,6630,243
56864,4,101,565,71,5708,30
31891,66,2585,1102,1659,30455,926
4851,15,986,1519,680,28077,306
15413,12,853,1408,523,9329,330
34939,157,2949,1043,2099,13343,850
64385,62,1809,328,1382,15063,427
30212,30951,629293,1131,372695,1396830,256598
5858,2,211,1507,139,4882,72
28297,21,499,1168,385,11441,114
1581,433,12384,1552,8532,126856,3852
29742,209,2636,1141,1568,20263,1068
68098,6,57,217,44,2409,13
47133,24,208,833,176,7119,32
15218,112,2579,1411,2080,42310,499
47235,45,1051,831,756,16688,295
48489,23,269,814,193,8802,76
4573,28,1741,1523,1179,22161,562
8546,36,956,1477,710,19704,246
26225,165,3349,1213,2888,28979,461
12001,13,489,1454,245,6315,244
68425,3763,112048,207,96228,492410,15820
68301,200,3856,211,3101,27853,755
47162,75,2881,832,2021,27970,860
11992,221,2186,1454,1220,14526,966
52959,95,749,683,625,11668,124
35590,171,2797,1027,2105,20544,692
61863,8,136,401,109,6793,27
8250,5,307,1478,185,16152,122
32045,316,5869,1100,4019,54076,1850
35568,165,4104,1028,3329,18226,775
11449,24,1913,1459,1139,17715,774
37955,1284,45749,966,34625,104845,11124
56475,1688,37001,576,28767,245772,8234
48509,16,241,813,162,12066,79
60241,14,181,457,147,6665,34
47376,6478,191589,830,149614,637542,41975
9833,45,2597,1471,1798,41274,799
18158,219,3446,1362,2581,32613,865
18428,177,5563,1357,3981,94123,1582
3183,286,7251,1538,4712,43066,2539
33086,32,1059,1082,711,9207,348
14330,216,6262,1422,4202,30007,2060
65333,34,242,301,202,3513,40
10585,116,2727,1466,1775,18491,952
54694,7,171,628,121,2770,50
8229,492,12790,1478,8526,103649,4264
59716,145,2386,476,1648,11757,738
8930,10,602,1475,434,13033,168
13905,1328,37771,1429,24775,120625,12996
10711,53,1765,1465,1174,36645,591
32365,41,1433,1095,962,39520,471
38545,192,3603,950,2671,52722,932
20875,41,1563,1314,1086,18249,477
9778,5097,187944,1471,111197,685552,76747
23507,28,939,1271,803,20618,136
66081,38,1181,282,889,10514,292
61818,3789,80791,402,64752,291672,16039
56279,3550,54211,581,43872,170517,10339
11971,68,1305,1454,703,12104,602
8800,5,198,1475,130,5360,68
67630,4,84,232,69,2074,15
43195,25,626,878,488,30714,138
62000,35,509,396,393,4821,116
12609,12,857,1447,443,9232,414
15160,776,18716,1412,12578,198003,6138
15513,1021,15468,1407,9697,73873,5771
27493,13,533,1185,319,19070,214
59117,115,1221,497,874,7914,347
22655,2,163,1286,118,12115,45
7153,60,1855,1490,1192,38048,663
15681,9,302,1404,208,8932,94
69660,68,764,165,681,10941,83
67237,1,36,245,22,2731,14
17990,16,455,1364,343,19735,112
4001,188,7442,1530,5143,142517,2299
4244,0,101,1527,50,10002,51
54603,38,323,631,240,6168,83
58421,37,491,519,371,16684,120
30844,68,2627,1118,1490,14989,1137
13879,6,602,1429,354,12204,248
56230,322,8313,583,5955,52946,2358
6818,49,2233,1495,1432,12736,801
51559,409,4985,729,4051,46629,934
58686,21,327,510,237,4259,90
10771,145,3860,1464,2652,33833,1208
7799,5,122,1481,77,5917,45
232,7,407,1563,278,21024,129
21133,21,937,1309,691,21412,246
69940,8,98,155,86,6770,12
27914,131,2687,1175,1630,18561,1057
37455,14,351,979,277,9743,74
58582,11,155,513,104,9494,51
8432,47,878,1477,553,12441,325
61732,150,2071,405,1639,7521,432
49998,5,79,769,67,3708,12
67511,7,70,236,50,3556,20
61790,27,459,403,400,6799,59
42020,871,16884,896,13832,158579,3052
53098,21,439,678,348,27804,91
7191,23,2004,1489,1227,28723,777
64182,28,373,334,292,10125,81
57105,52,1046,558,700,8342,346
61956,80,565,398,449,13586,116
48339,329,4836,817,3875,63298,961
10407,38,1241,1467,673,9109,568
60901,1740,25820,432,21174,94056,4646
17235,363,8209,1379,6222,78570,1987
29645,20,593,1143,335,9841,258
54455,102,1111,637,925,12067,186
36052,143,1832,1016,1442,20298,390
49352,52,927,785,547,18215,380
31430,100,1782,1109,1212,27274,570
1721,11,444,1551,311,15423,133
36072,13,439,1016,341,5196,98
60927,58,715,432,577,13782,138
7646,54,1275,1484,902,27396,373
13623,333,10029,1433,6197,88692,3832
59835,24,404,472,250,4632,154
7658,257,5441,1483,3896,35512,1545
28489,362,18355,1165,12083,88891,6272
34594,3,90,1052,64,2397,26
67959,4,56,222,44,5058,12
28041,6,108,1173,96,8464,12
22011,9,414,1295,310,25379,104
6634,16,521,1497,340,12842,181
42528,1,33,890,24,2384,9
25133,11,198,1236,134,5307,64
27325,2,174,1189,113,4716,61
58185,1,61,527,48,2976,13
62926,28,630,369,567,16169,63
18211,250,4920,1361,3274,45929,1646
3837,25,2120,1532,1537,33523,583
34409,19,644,1056,440,10486,204
28428,15720,442851,1166,271196,1473553,171655
12697,656,17680,1446,10033,100541,7647
34238,12,548,1060,324,11709,224
16621,203,4275,1389,3245,32055,1030
2964,64,2539,1540,1852,45021,687
35137,38,880,1039,679,16833,201
6761,70,4227,1495,2743,27771,1484
14992,0,0,1414,0,5848,0
29741,92,2711,1141,1664,22425,1047
24398,4741,80044,1253,55110,319080,24934
4340,6,119,1526,88,10576,31
61965,38,894,397,503,22431,391
22545,1933,80466,1288,56151,375876,24315
30768,10,310,1120,211,4798,99
20251,192,4979,1325,3558,41847,1421
26309,16,671,1211,351,6219,320
31976,5,156,1101,108,5929,48
18256,4,60,1360,46,13732,14
34782,59,2493,1047,1598,37787,895
26930,18,423,1197,291,22891,132
18145,81,4175,1362,2824,35974,1351
20371,232,5667,1323,3966,69437,1701
32212,244,3674,1098,2557,18943,1117
53803,63,1265,660,1003,8545,262
25940,17,323,1219,220,10124,103
16638,271,4255,1389,3005,24950,1250
20006,26,548,1329,401,11211,147
4752,12,216,1520,141,19781,75
43081,530,5748,880,4550,52886,1198
25371,86,3132,1231,2063,19693,1069
29277,25,645,1149,364,7227,281
30769,55,840,1120,514,8344,326
20287,205,9510,1324,5693,64713,3817
45183,31,636,856,479,7418,157
15647,119,5326,1405,3900,29972,1426
2567,6,501,1544,371,26595,130
9277,283,5739,1474,3727,39508,2012
16186,144,5231,1396,3545,71353,1686
9434,28,1210,1473,762,12382,448
1625,84,5702,1552,3700,44176,2002
3977,16,962,1530,648,38759,314
62957,3,48,369,35,2697,13
53191,1,81,676,59,4950,22
52295,275,2304,706,1866,56233,438
21769,15,251,1299,161,6475,90
52535,33,390,697,315,10216,75
16459,6,528,1391,373,21246,155
36477,25,691,1004,604,21019,87
69303,22,411,176,365,10042,46
775,108,4394,1558,3371,40397,1023
32770,14,371,1088,242,11791,129
19085,327,13996,1345,9004,43810,4992
68622,11,206,199,156,4860,50
4952,116,7636,1517,4803,52720,2833
14452,52,1437,1420,1064,23328,373
15196,12,1017,1411,647,11963,370
54384,258,3035,640,2559,24128,476
50824,46,797,749,624,11243,173
60501,18,411,448,368,12645,43
17735,31,963,1369,659,12722,304
35999,96,1648,1018,1430,18187,218
20095,44,1130,1327,800,20114,330
43637,46,470,873,360,13314,110
31124,107,2046,1114,1319,17576,727
59891,94,1503,470,1169,18807,334
38265,6,129,958,95,4488,34
29555,39,545,1145,350,13006,195
11193,4758,170992,1461,101245,446565,69747
69570,23,270,168,215,2655,55
14825,95,3032,1416,2016,28187,1016
57947,9,88,535,66,5209,22
21420,11,542,1304,347,10663,195
56586,79,664,573,598,11897,66
50885,84,1752,747,1374,20668,378
13847,181,2343,1429,1538,24260,805
57345,73,697,552,620,15473,77
20880,197,3881,1314,2732,33096,1149
7388,42,2324,1487,1633,17603,691
32044,8,403,1100,278,4508,125
67938,106,1376,222,1090,12418,286
4447,29,694,1525,534,17478,160
58432,19,149,519,123,7077,26
33530,199,2977,1074,1869,21741,1108
42103,585,20760,894,16012,113841,4748
57297,5,75,553,51,3838,24
61182,4,48,422,35,3913,13
40767,5,86,918,54,6038,32
33172,471,12904,1080,10290,59479,2614
48645,278,2585,808,1909,17511,676
29689,7,435,1142,229,4270,206
9588,243,8627,1472,5697,42337,2930
51073,351,4591,742,3957,29047,634
12232,323,6173,1451,3822,42478,2351
34166,95,2699,1061,1896,29450,803
27201,67,970,1191,686,15072,284
43179,136,2154,878,1651,32115,503
46187,1,312,845,212,9480,100
35889,38,607,1020,472,21212,135
30712,23,1327,1121,942,16364,385
9458,1149,27872,1473,17137,124532,10735
24625,70,1479,1247,1015,18494,464
52458,99,1198,700,867,8870,331
25756,11,665,1223,596,16033,69
57873,9650,146663,537,109661,405940,37002
38172,16,560,960,382,15642,178
48471,40,300,815,266,7944,34
60812,5,103,436,85,4267,18
66609,219,3708,265,3026,30916,682
45283,328,5783,855,4866,35082,917
48968,274,4328,798,3621,57635,707
66222,110,1645,277,1465,18322,180
30124,132,2268,1132,1598,14503,670
64895,61,646,312,518,6010,128
63230,19,228,362,186,4555,42
61413,39,324,415,271,7019,53
33020,937,17397,1083,11668,141474,5729
19936,1924,50192,1330,35201,188229,14991
37486,1539,34441,978,26466,129226,7975
19030,286,12931,1346,8887,60225,4044
31208,954,17842,1112,12615,54131,5227
50745,3,91,751,78,9669,13
60532,194,1703,447,1311,9995,392
54102,274,2257,649,1761,13038,496
31840,70,1598,1103,1095,25762,503
60681,29,447,441,380,22060,67
54023,8,147,652,140,6199,7
53026,4,127,681,51,3652,76
31880,89,1662,1102,1104,9268,558
37759,22,367,970,298,6372,69
52394,2,27,703,21,3606,6
28855,113,1862,1158,1030,8789,832
38152,33,703,960,594,17133,109
30491,15,433,1125,180,4565,253
67559,1884,42108,160,33048,217973,9060
12990,295,11539,1442,6913,164019,4626
44807,1774,21192,860,15058,124238,6134
27312,0,100,1189,68,5162,32
68770,47,757,194,685,15795,72
24668,337,10157,1246,7541,53814,2616
28957,4319,88067,1156,63185,324653,24882
38039,328,3932,963,3194,43131,738
64457,2,31,325,26,4704,5
37763,5,162,970,119,8141,43
6816,5,99,1495,65,6693,34
3466,112,3838,1536,2780,54686,1058
57714,59,521,543,409,8248,112
4810,30,1306,1519,915,31581,391
12828,184,3245,1444,2137,28786,1108
8090,320,4689,1479,3125,22740,1564
57253,37,599,555,458,10826,141
12511,12,198,1448,111,6212,87
31007,21,801,1116,512,8034,289
11631,172,7399,1457,4492,53483,2907
48465,149,2145,815,1543,14809,602
40988,17,407,913,319,7387,88
51445,669,6464,732,4880,24915,1584
65547,182,3110,296,2647,32500,463
6197,21,472,1503,375,9496,97
53171,4689,72206,676,56688,301717,15518
19722,4,170,1334,137,10222,33
37591,471,15387,971,12958,129561,2429
52020,4,93,715,80,7237,13
19334,53,927,1341,599,9464,328
55002,13,87,617,66,6269,21
39628,7,85,934,61,2496,24
1861,6,525,1550,391,22107,134
56100,14,146,587,135,4995,11
8891,7,268,1475,189,10051,79
14578,0,76,1419,42,13276,34
53410,47,588,671,461,9801,127
68458,16,271,205,203,4690,68
17103,18,837,1381,609,7495,228
49474,1,24,783,20,3653,4
2475,370,9960,1545,6410,101598,3550
15500,22,958,1407,664,20835,294
52002,265,2571,716,2066,31791,505
21781,6,174,1298,122,6415,52
59487,92,1155,484,862,10405,293
35211,0,32,1036,26,2571,6
53625,28,651,665,242,8655,409
29426,146,2850,1147,2051,43797,799
35212,19,441,1036,319,18649,122
40535,8,444,921,342,11775,102
64077,8,166,337,110,6220,56
56443,9,136,577,109,3695,27
5310,44,1002,1513,741,13640,261
7491,9,236,1486,166,6004,70
521,598,31123,1560,20707,125331,10416
12766,3924,119519,1445,74219,415282,45300
8227,211,4672,1478,3334,28179,1338
31616,65,2740,1107,1896,14222,844
476,7,364,1561,229,15921,135
25152,8,369,1236,230,9636,139
51528,2,43,725,35,2420,8
52,146,10314,1566,6704,69108,3610
16679,190,6307,1388,4302,67257,2005
26381,34,844,1209,511,9305,333
2970,126,2718,1540,2038,29211,680
33060,19,552,1082,375,31624,177
9932,35,1251,1470,858,17176,393
8576,41,2245,1477,1430,45421,815
11636,34,758,1457,414,6462,344
312,17,890,1562,667,49107,223
30830,98,3352,1119,2429,36148,923
18837,373,8300,1349,5634,71520,2666
62265,9,149,387,89,8026,60
16138,614,17582,1397,11534,154112,6048
57445,10,186,550,145,3783,41
49706,59,843,777,729,13358,114
68897,33,422,190,359,11862,63
5562,65,1964,1510,1196,13226,768
43017,266,3540,881,2683,24899,857
67134,57,665,248,520,11945,145
58921,251,2626,502,1976,12662,650
24139,171,3175,1258,2339,29981,836
30494,99,919,1125,761,26912,158
34063,4578,219581,1063,143283,600796,76298
12417,15,708,1449,357,11260,351
2068,1910,46583,1548,29180,111355,17403
36413,633,13342,1006,10518,79872,2824
6282,5,315,1502,198,22514,117
68598,23,379,200,329,6241,50
30465,7,187,1126,177,7979,10
24876,8,386,1242,315,6688,71
2595,13,809,1544,539,25490,270
11949,94,7240,1454,3778,49899,3462
67646,44,548,232,444,13522,104
21661,634,14187,1300,9203,41652,4984
66056,8,158,282,134,3243,24
51678,232,3300,725,2666,33401,634
52979,471,6798,682,5105,48408,1693
61523,151,3128,412,2207,26397,921
17648,398,6319,1371,4302,61374,2017
23891,154,2983,1264,2046,28637,937
12675,17,710,1446,385,14091,325
69181,12,219,180,192,3501,27
18967,3,299,1347,230,22859,69
62774,54,946,373,640,6111,306
11348,13,803,1460,456,16189,347
60675,5,62,441,51,3149,11
10272,226,4063,1468,2917,53845,1146
25458,6,190,1230,129,5579,61
25352,127,2783,1232,1892,35054,891
64901,11,107,312,101,4654,6
18799,10828,308104,1350,203324,665813,104780
31392,6894,144630,1110,85851,455030,58779
18262,5,226,1360,181,10912,45
1529,19,541,1553,385,17168,156
23472,6,92,1272,60,3917,32
14541,153,3379,1419,2457,41492,922
66680,15,264,263,210,7937,54
18494,64,2603,1356,1909,34636,694
40893,115,2062,915,1690,20119,372
5951,4,93,1506,53,10514,40
64415,12,251,327,200,5716,51
33431,9,320,1076,183,4763,137
51508,38,623,730,482,5353,141
58691,25,271,510,220,7435,51
63250,55,1338,361,1066,23030,272
56924,6,100,563,66,7103,34
29942,288,4087,1137,2676,30025,1411
48317,253,3265,817,2648,14458,617
25610,13,500,1227,327,7567,173
46902,1136,21939,836,17708,138176,4231
48160,1777,16598,820,12763,335048,3835
15322,105,3329,1410,2091,31556,1238
7634,135,5208,1484,3342,21013,1866
26970,0,54,1196,45,6842,9
69170,8,138,180,104,2305,34
22396,9,651,1290,433,14244,218
29461,4,132,1146,93,6393,39
26,13194,619142,1567,385278,2244353,233864
20056,317,1700,1328,1071,14022,629
17546,6,191,1373,143,17544,48
15828,22,770,1402,526,28190,244
4449,37,1957,1525,1343,20904,614
69944,30,260,153,239,7071,21
4400,1001,70032,1525,43604,354329,26428
67320,0,14,242,10,2716,4
10438,70,2674,1467,1848,18769,826
5789,35,580,1508,460,12526,120
64499,10,84,325,57,2529,27
67859,38,433,224,333,7612,100
29391,15,769,1147,485,6670,284
37747,16,603,970,348,8605,255
14237,52,2401,1424,1583,18270,818
34768,6,227,1047,168,8682,59
30372,14,1159,1128,708,27480,451
12903,5,105,1443,58,3099,47
52134,103,975,711,852,10168,123
18752,27,677,1351,420,14861,257
50227,71,942,764,749,16621,193
70459,5,151,138,148,4303,3
12351,14,681,1450,348,14528,333
2284,49,1705,1547,1221,11273,484
60337,44,452,454,360,4890,92
5367,9,227,1512,171,6068,56
20496,1145,25159,1321,16272,118696,8887
8584,1,214,1477,130,8057,84
36228,5,123,1012,91,6613,32
4613,371,9161,1522,5736,64473,3425
62852,35,723,371,553,3147,170
48000,99,1879,822,1351,31258,528
56426,2,38,578,34,1555,4
66770,807,10071,258,7763,51306,2308
34302,375,4690,1059,3201,24735,1489
18625,46,4564,1353,3220,51337,1344
61361,935,12587,416,9928,138256,2659
15558,26,1200,1406,788,10616,412
63395,26,327,357,272,3295,55
25057,38,871,1238,613,22207,258
58278,22,186,524,147,7930,39
27158,5,384,1192,234,11311,150
49994,965,14044,770,10878,81435,3166
23079,47,1207,1278,879,17905,328
37073,140,1469,990,1034,17874,435
53336,26,163,673,133,23460,30
51002,372,4488,744,3532,45739,956
32549,33,1072,1092,699,20389,373
25896,56,1162,1220,620,8368,542
17281,10,377,1378,285,6660,92
49011,7809,194939,797,151022,452925,43917
23092,65,2009,1278,1373,35481,636
11863,82,2611,1455,1230,39509,1381
8990,147,3539,1475,2273,15351,1266
21445,13,216,1303,162,14532,54
28329,165,2958,1167,2229,26134,729
13424,90,4079,1436,2481,88626,1598
56416,46,644,578,469,8438,175
11565,52,1992,1458,1209,17907,783
25127,125771,2645514,1236,1951675,4026225,693839
67715,18,441,230,333,8846,108
39365,22,437,938,303,11618,134
63310,4,66,359,56,3044,10
32972,184,4325,1084,3480,50866,845
29633,1222,25771,1143,16971,236628,8800
18710,5,518,1352,348,13968,170
60240,177,1902,457,1548,28595,354
29508,30,1340,1145,772,12583,568
49312,36,2518,787,2156,25453,362
41325,4,104,908,82,3820,22
39816,102,2031,932,1468,20375,563
67932,22,474,223,377,7715,97
32496,34,1097,1093,732,21261,365
69710,48,588,160,522,13908,66
9111,110,2956,1474,1992,30402,964
14648,11,564,1418,368,11831,196
19472,6,154,1338,119,21638,35
5247,537,15107,1514,9650,55746,5457
9008,627,18559,1475,11722,55731,6837
16791,1586,25711,1386,16714,103789,8997
36317,3443,71623,1008,55990,316683,15633
9048,663,13318,1474,7872,137332,5446
53572,20,234,667,167,9626,67
31454,72,1418,1109,866,16125,552
5758,367,21451,1508,14049,95901,7402
23470,177,3560,1272,2554,21670,1006
60540,8,156,447,114,8284,42
20932,89,2118,1313,1359,25524,759
32796,35,878,1088,516,8497,362
68263,0,20,212,20,1625,0
21999,7,192,1295,145,37674,47
43917,5,49,871,42,1440,7
69922,22,179,156,166,2469,13
54612,8,86,631,64,4506,22
20265,227,4948,1324,3287,42408,1661
69112,137,1282,182,1054,12815,228
65514,2,49,297,28,2468,21
7099,14,526,1491,312,12490,214
24429,269,7108,1252,4608,32273,2500
69916,11,128,156,113,2487,15
49509,41,830,781,648,8932,182
68852,13,154,189,125,4164,29
27432,1472,46439,1186,30407,272366,16032
4816,15,567,1519,395,27116,172
49125,5,113,793,83,7574,30
27274,7,331,1190,210,8202,121
1655,43,2211,1552,1542,42640,669
20321,123,3066,1324,1798,12987,1268
31804,28,896,1103,718,12587,178
15385,6,186,1409,120,2979,66
29896,8,144,1137,132,13036,12
9725,1,182,1471,108,8060,74
58975,89,1147,501,948,7428,199
28003,4,305,1173,194,9762,111
38378,310,3660,955,2732,36398,928
22137,15,496,1294,346,15907,150
844,34,1059,1558,735,25137,324
22205,19,732,1293,423,54244,309
9885,148,3421,1470,2105,41022,1316
53103,33,347,678,275,5647,72
11772,53,2154,1456,1109,11234,1045
3655,88,3982,1534,2875,54092,1107
53717,127,1302,662,1067,17327,235
63780,16,218,347,167,4415,51
18091,820,21659,1363,16319,90542,5340
58529,57,597,515,546,9976,51
21849,21,457,1298,291,14011,166
14180,21,1033,1425,613,9205,420
32085,26,646,1099,395,11862,251
955,516,19623,1557,14144,69423,5479
54427,6,44,638,33,1698,11
8649,178,8628,1476,5576,64916,3052
25765,71,1202,1223,782,11043,420
54485,1554,28092,636,20045,60361,8047
34743,287,5044,1047,3835,33607,1209
8305,8,310,1478,215,13184,95
54091,167,1740,649,1438,31547,302
32730,169,4426,1089,2864,19428,1562
63459,19,294,355,232,5689,62
65955,0,12,285,4,1375,8
66792,9,158,260,108,5230,50
17188,80,2234,1379,1689,43727,545
39137,13,209,940,175,9989,34
67437,45,615,239,486,6191,129
25871,137,2949,1221,1917,47738,1032
18056,2172,65976,1363,43309,445017,22667
32146,29,598,1099,409,8835,189
37287,120,2940,983,2372,40856,568
57259,7,94,555,66,5200,28
11420,30,1016,1459,585,13801,431
7694,88,6427,1483,4501,43980,1926
1833,5,213,1550,157,14182,56
40229,47,854,926,645,17695,209
1225,26,674,1555,492,19823,182
4153,75,2566,1528,1734,14053,832
50705,18,190,752,149,6835,41
50640,164,3047,753,2475,21188,572
27595,119,2097,1182,1374,8935,723
25640,26,442,1226,292,6970,150
55658,544,4390,599,3521,29829,869
14601,272,7723,1419,5325,47831,2398
70516,10,106,137,105,3089,1
8442,5,219,1477,146,10406,73
2361,71,1208,1546,882,33863,326
39323,39,927,938,714,44733,213
20139,281,6944,1326,5314,65933,1630
27601,250,5668,1182,3754,43394,1914
56417,146,1498,578,1137,34333,361
69929,149,4055,156,3708,33782,347
20333,38,921,1323,653,16936,268
60190,62,744,460,583,11181,161
7513,20,565,1485,409,23265,156
25876,23,762,1221,647,15333,115
44034,172,4623,869,3317,84026,1306
37514,680,14718,977,11038,32597,3680
69183,23,137,180,117,8802,20
57797,9,133,540,112,5928,21
50577,9,386,754,224,3930,162
57254,285,4842,555,3685,12068,1157
40547,664,12647,921,9414,37577,3233
25066,386,7765,1237,5060,46597,2705
59932,155,1707,468,1317,26987,390
16426,12,259,1392,192,5428,67
54788,15,245,624,165,3173,80
5864,30,1175,1507,775,46818,400
33391,6477,178969,1076,119642,613766,59327
4947,3091,81573,1518,46535,201722,35038
7777,7,451,1482,214,25905,237
25354,41,1106,1232,867,25849,239
13512,259,3294,1434,2138,63776,1156
7612,19,1191,1484,862,27457,329
70039,8,84,152,78,4885,6
26066,120,11116,1216,6472,36096,4644
53862,57,524,657,441,8608,83
51932,76,925,718,661,10080,264
18536,8,400,1355,247,6927,153
28316,154,3105,1168,1888,42998,1217
2387,13,914,1546,665,7766,249
17380,4,168,1376,145,10230,23
19629,37,1228,1336,847,17339,381
63900,266,2901,343,2362,20315,539
69666,9,82,165,72,4213,10
33991,33,1101,1065,759,13858,342
54478,4,50,636,38,2921,12
41295,74,479,909,419,29608,60
61082,276,11193,426,8745,56907,2448
26502,1062,23427,1207,15271,100712,8156
22937,4805,160169,1280,109550,669522,50619
10045,286,5032,1469,3151,34444,1881
56477,7,86,576,80,22487,6
64404,2,21,327,16,3576,5
19531,3,121,1337,89,9160,32
7828,24,998,1481,692,37814,306
52096,32,1031,712,589,11357,442
39684,43,932,934,737,28067,195
35675,7,103,1026,98,4701,5
25422,1477,18617,1230,11929,114214,6688
42286,670,9847,894,8096,55937,1751
23078,209,10061,1278,7115,46010,2946
63547,10,118,354,94,4820,24
70356,92,1612,142,1526,14016,86
21683,62,749,1300,445,12867,304
20495,69,1097,1321,834,11360,263
55696,4,98,598,73,18291,25
40862,25,405,916,272,3515,133
64069,810,9762,337,7454,62417,2308
57520,5,62,549,52,7463,10
11860,27,1060,1455,598,18728,462
25666,10471,233838,1225,149421,528081,84417
69127,89,4076,182,3544,27019,532
69623,35,280,166,223,2897,57
4791,63,1418,1520,987,22763,431
63532,225,4617,354,3862,36465,755
34479,22,573,1055,349,15749,224
21758,124,3639,1299,2357,34662,1282
33748,67,807,1070,558,8192,249
62359,5,62,384,48,5157,14
18772,2146,40132,1351,27561,164904,12571
59715,164,2441,476,1908,29782,533
24030,35,986,1261,678,32450,308
4175,2,130,1528,94,30802,36
7028,145,2268,1492,1441,12160,827
22499,53,1292,1289,998,18471,294
12446,0,0,1449,0,9528,0
39042,33,501,942,392,6677,109
22471,186,5161,1289,3634,40241,1527
23594,5,151,1270,108,3329,43
619,12,569,1559,416,19481,153
59091,3592,84359,497,59442,165594,24917
2497,167,4796,1545,3173,46112,1623
41090,32,638,912,523,14336,115
18730,8,96,1352,70,32855,26
10284,0,180,1468,115,3693,65
38136,38,793,961,677,16652,116
837,38,2296,1558,1724,25817,572
49203,49,950,791,716,30743,234
18945,15,1089,1348,702,28849,387
61431,481,4375,415,3432,25045,943
13296,41,2374,1438,1378,29594,996
66685,13,200,263,136,3704,64
56906,19,409,563,231,5822,178
53782,8,76,661,70,7427,6
4185,161,4462,1528,2983,73388,1479
29253,8898,277990,1150,176969,471355,101021
14433,304,9527,1420,6526,45219,3001
28732,207,1380,1160,1055,28665,325
5747,80,2376,1508,1779,20251,597
62044,8,73,395,63,4183,10
14024,35,662,1427,427,10346,235
58417,348,4012,519,3060,32719,952
9642,305,12179,1472,7569,42554,4610
51392,10,207,733,151,4060,56
48595,180,3793,809,3032,75101,761
22784,60,3051,1283,2011,25166,1040
27338,23,862,1188,499,11533,363
28239,40,1530,1169,935,28295,595
33113,164,5334,1082,3574,43098,1760
27786,27,1169,1178,665,21159,504
9293,11,423,1474,275,11189,148
23863,28,591,1264,418,8582,173
41344,43,781,908,653,8579,128
12542,138,7899,1448,3879,26369,4020
5451,243,23571,1511,12386,75112,11185
8284,44,962,1478,642,5248,320
29621,28,1378,1144,848,18558,530
5956,133,8365,1506,5599,75685,2766
24657,16,366,1246,230,5427,136
57240,18,275,555,222,7325,53
20384,91,2591,1323,1827,24937,764
28287,7955,195448,1168,123728,1020710,71720
26698,98,1675,1202,1040,7929,635
53252,4,174,675,133,4661,41
52225,21,211,708,173,3674,38
28075,19,471,1173,309,6649,162
12858,21,678,1444,374,15362,304
11381,30,1465,1460,981,24349,484
41226,13,573,910,389,13674,184
40083,68,1320,928,982,62673,338
66611,29,431,265,345,3914,86
16736,1176,22750,1387,14025,140817,8725
24723,15639,342901,1245,220928,1508698,121973
59170,82,963,495,798,21490,165
69573,46,945,168,702,10370,243
68686,1,34,197,22,831,12
36516,56,1083,1002,939,17043,144
51137,174,1884,740,1500,20051,384
22362,147,9481,1291,5710,83760,3771
5317,1,97,1513,57,5462,40
11494,0,0,1459,0,16126,0
21800,15,521,1298,275,18031,246
68989,30,619,186,490,5292,129
4264,49,1519,1527,1024,13675,495
20320,0,36,1324,35,10390,1
52756,53,557,689,493,18630,64
36520,982,18849,1002,12710,119611,6139
14829,271,10229,1416,7533,128374,2696
59458,2,120,485,94,5795,26
42470,1798,34752,890,26872,254426,7880
55850,456,7212,594,6063,45932,1149
64610,12,115,321,77,2475,38
15522,267,18391,1406,11945,110863,6446
26172,0,120,1215,80,8963,40
4236,248,4832,1528,3030,47499,1802
31945,74,2234,1102,1405,23968,829
10824,717,17132,1464,11425,87932,5707
3675,4,182,1534,133,15611,49
57662,24,259,544,211,4860,48
46559,91,1057,840,839,12353,218
61338,15,219,417,154,11585,65
2429,481,30917,1545,21861,143455,9056
23310,589,16264,1275,9855,68035,6409
29416,74,1793,1147,1316,35398,477
55872,108,1046,594,817,15698,229
61866,14,125,401,97,7386,28
16651,95,2599,1389,1684,33328,915
3807,68,3941,1532,2850,41857,1091
3074,10,554,1540,374,34726,180
53132,86,580,677,539,10407,41
23216,1125,19109,1276,13487,86983,5622
8993,1,172,1475,100,3282,72
8672,24,855,1476,540,18771,315
38183,3,31,959,24,5113,7
66913,47,671,255,530,11709,141
54349,2452,30700,641,22907,98213,7793
25351,28,1621,1232,1037,13741,584
33775,1118,25244,1069,16571,159629,8673
57745,169,2900,542,2123,22724,777
53018,53,1117,681,935,15968,182
2256,30,1173,1547,830,19301,343
50505,147,2168,756,1880,34382,288
67464,4,33,238,27,2264,6
53936,54,632,656,451,28172,181
6616,103,2662,1497,1881,35472,781
16766,374,5266,1386,3540,68946,1726
19043,8,350,1346,203,6974,147
19930,754,36536,1330,22756,209215,13780
35051,1106,24053,1041,18505,113510,5548
10657,92,3220,1465,2081,26717,1139
20077,15873,728321,1328,445190,1791593,283131
26875,24,806,1198,594,13181,212
41908,250,3140,898,2676,31477,464
31523,44,1468,1108,972,41063,496
65829,49,475,289,377,9966,98
27887,106,1632,1176,980,8670,652
10852,135,3019,1464,1890,14989,1129
18591,0,0,1354,0,7029,0
63393,4,43,358,26,1959,17
26423,142,4840,1209,2629,38798,2211
38645,195,5478,947,4325,62943,1153
49213,12,320,790,220,8278,100
56950,234,11463,562,8928,50714,2535
17091,21,337,1381,277,9024,60
34441,10,211,1055,132,4665,79
62848,198,2306,371,1836,14000,470
32447,16,803,1094,498,14296,305
24667,119,4020,1246,2812,42029,1208
22667,133,3402,1285,2317,30209,1085
5934,39,1171,1506,875,17588,296
68242,105,1797,213,1568,24719,229
39975,461,8185,930,6848,68991,1337
67702,83,805,230,613,5253,192
24439,1300,25690,1252,17501,110303,8189
64127,47,622,332,514,4960,108
51571,193,3004,728,2378,22756,626
61975,298,4468,397,3304,21298,1164
8761,3,238,1476,157,3413,81
61020,13,264,429,201,9375,63
23267,41,2791,1275,1969,48606,822
51647,102,1573,726,1267,19088,306
9797,300,4154,1471,3007,27835,1147
65274,24,377,302,320,5722,57
34349,8,145,1058,121,4778,24
4903,569,34187,1518,21698,145721,12489
19295,17,694,1341,532,14617,162
36871,224,5473,996,4782,58608,691
61681,13,89,407,71,3292,18
6376,22,693,1500,458,46255,235
31187,95,2305,1113,1346,18167,959
37520,30,884,977,721,36134,163
18150,141,4110,1362,2777,67932,1333
25613,34,772,1226,503,10095,269
67343,37,455,241,369,9273,86
60077,416,6853,463,5712,74148,1141
26211,35,330,1214,205,4803,125
22611,3893,107264,1287,69444,416937,37820
50706,30,250,752,166,3349,84
24341,314,7395,1254,5402,40006,1993
12272,0,36,1451,21,4201,15
1022,480,26934,1556,15935,92335,10999
2480,460,15351,1545,10764,111065,4587
29700,63,1391,1142,780,12457,611
56720,873,11985,569,9219,141938,2766
14826,45,805,1416,657,17390,148
31222,2361,46893,1112,31742,227415,15151
28389,0,0,1166,0,11289,0
19532,31,631,1337,421,12948,210
22899,2912,67195,1281,44081,494506,23114
31094,57,1055,1114,763,15824,292
68258,64,821,212,631,7941,190
33965,1,13,1066,9,4359,4
35502,34,588,1030,445,10203,143
35298,80,1189,1034,818,11402,371
32916,229,7132,1085,6121,86274,1011
3091,31,1082,1539,678,22186,404
50526,46,591,756,474,11308,117
24278,7,280,1256,242,14072,38
41007,35,702,913,570,9538,132
63384,0,6,358,5,1279,1
35890,137,3025,1021,2366,72535,659
50700,21,224,752,195,13126,29
49827,3500,50557,774,39980,577651,10577
19132,11,560,1344,377,21666,183
52560,13,202,697,165,10579,37
47637,41,465,826,344,14412,121
9427,50,1884,1473,1136,26532,748
32962,32,1327,1084,894,21512,433
1056,18,1398,1556,963,13983,435
11448,221,10843,1459,5850,44483,4993
57099,7,154,558,113,8681,41
6052,21,537,1504,352,19343,185
38977,51,627,943,558,11896,69
24622,14,415,1247,271,8743,144
50814,16898,363583,749,278696,1373546,84887
65892,1,37,287,26,4054,11
29956,150,6339,1136,4053,48491,2286
51401,4685,86021,733,67260,519079,18761
35157,8,132,1038,87,9428,45
56873,89,1356,564,1083,31550,273
18288,221,7657,1359,5875,61122,1782
63080,2,45,365,35,2738,10
1090,46,1987,1556,1372,68879,615
24556,17,497,1249,337,5999,160
54306,6434,104527,642,77948,362189,26579
24259,13,414,1256,347,8922,67
6063,413,17301,1504,12541,88638,4760
23190,15,376,1276,312,26946,64
8419,226,8433,1477,5399,37318,3034
28037,16,391,1173,259,22944,132
15354,153,10138,1409,6513,51505,3625
49923,71,1199,771,958,11572,241
48970,81,979,798,821,7308,158
54692,242,3075,628,2018,74048,1057
12142,40,1858,1452,1096,29040,762
59868,22,652,471,461,14679,191
37766,294,4899,970,3892,79336,1007
32551,168,4338,1092,3063,36885,1275
582,99,4845,1560,3258,121448,1587
9211,14,749,1474,447,15512,302
41998,38,874,897,565,6264,309
18658,95,1688,1353,1218,20555,470
38024,41,1245,964,1045,18571,200
10010,55,1674,1469,1059,27242,615
29424,567,9715,1147,6760,86999,2955
39061,40,1040,941,720,21460,320
50580,25,320,754,264,9095,56
41761,27,533,901,406,13939,127
13982,5,319,1427,181,8316,138
2544,1289,45183,1544,27486,285637,17697
30520,164,8521,1124,6079,36883,2442
51054,7,76,742,64,4829,12
22023,3725,155975,1295,96889,929035,59086
69558,7,79,169,74,7830,5
29038,4,35,1154,34,5888,1
36769,346,4816,998,3895,37221,921
53278,125,3757,674,2514,33900,1243
61444,13,143,414,107,6698,36
6183,91,3642,1503,2390,16142,1252
26626,2,61,1203,48,8987,13
6071,20,370,1504,263,8581,107
23622,57,947,1269,631,6569,316
3456,70,7299,1536,4563,34507,2736
41257,48,1200,910,946,16994,254
13892,85,4227,1429,2509,22152,1718
68709,31,404,196,333,8609,71
58026,29,322,532,281,19740,41
35549,136,2740,1028,2052,18802,688
55717,25,301,598,210,10484,91
68087,4,120,218,80,3930,40
13734,25,1103,1431,677,17890,426
29316,971,21422,1149,14409,90386,7013
26923,6,209,1197,164,2714,45
1931,2431,68872,1550,41291,242230,27581
20057,46,2790,1328,1986,35607,804
429,13,626,1561,510,10372,116
32458,3835,80652,1093,55152,416177,25500
61079,12,146,426,126,3354,20
16498,0,40,1391,27,5106,13
48353,203,3108,817,2544,46267,564
7109,3572,103282,1491,60878,639131,42404
5609,13,503,1510,335,14872,168
14650,4,247,1418,160,4234,87
15918,32,649,1400,442,14224,207
6099,465,18437,1504,11645,168204,6792
12532,50,1466,1448,802,9746,664
42078,2,93,896,86,9875,7
37225,7,97,985,72,5286,25
58110,2271,27556,530,21903,119038,5653
48446,5085,103834,815,77163,646887,26671
33574,10,217,1072,191,9487,26
31794,18,324,1103,211,7868,113
33176,169,3310,1080,2336,34516,974
21309,17,841,1306,618,13987,223
36187,564,11061,1013,9221,70634,1840
14455,153,5402,1420,3833,29607,1569
63612,112,1543,352,1282,10715,261
35616,21,391,1027,282,5489,109
59882,4,22,470,16,1592,6
3033,7,662,1540,433,16834,229
54649,5,72,629,57,7953,15
18910,25,1138,1348,739,8269,399
36459,3368,53483,1004,43356,323355,10127
20634,31,1665,1318,1294,24300,371
61736,21,261,405,210,8340,51
14261,38,1088,1423,683,12893,405
32997,40,1052,1084,703,11160,349
65489,44,471,297,417,12898,54
22954,2,96,1280,77,11281,19
55881,0,12,593,12,3200,0
19176,56,1693,1344,1140,13502,553
33904,11,436,1067,258,5888,178
14891,0,0,1416,0,37543,0
27902,13,321,1176,188,5002,133
57843,90,1548,538,1192,36908,356
435,44,1921,1561,1350,33076,571
60423,148,4405,451,3637,34705,768
31978,108,2711,1101,1794,36218,917
43809,203,3253,872,2429,63033,824
57142,107,1967,558,1491,11314,476
35304,41,1211,1034,876,14439,335
64336,3,60,329,47,4948,13
24435,41,1038,1252,652,23546,386
16669,629,16973,1388,11044,109344,5929
60309,70,830,439,642,8537,188
22087,33,1180,1294,845,27517,335
9872,69,1840,1470,1274,31732,566
33231,34,2248,1079,1623,49398,625
780,219,7104,1558,4141,114212,2963
22854,15,338,1282,202,7722,136
579,44,853,1560,610,34142,243
38543,36,636,950,532,11592,104
64707,106,1287,318,980,13687,307
4093,197,4628,1529,3041,41968,1587
18466,4308,74857,1356,49980,281805,24877
16438,50885,1239113,1392,704999,2871659,534114
6560,17,446,1498,340,37211,106
55249,2,27,611,22,2439,5
38548,894,12161,950,10054,105812,2107
19377,3617,111444,1340,75423,714137,36021
39759,5820,122942,919,92431,341208,30511
29029,42,784,1154,482,7901,302
16798,14,386,1386,266,4382,120
57713,127,950,543,766,12341,184
16139,6028,112721,1396,77742,408042,34979
34872,217,4512,1045,3272,38783,1240
36729,9,106,999,77,2152,29
27029,185,4660,1195,2771,43717,1889
12041,37,1203,1453,575,9991,628
17278,10,291,1378,232,10647,59
60625,2542,48733,443,39531,259458,9202
51513,51,1104,730,853,18905,251
68164,15,170,215,142,2777,28
20876,55,641,1314,439,11209,202
39370,18,356,938,294,10844,62
54521,27237,414980,634,282417,1798012,132563
23240,59,1984,1276,1693,36674,291
14753,51,2147,1417,1622,39272,525
16948,19,1120,1383,736,16102,384
18045,25819,555015,1363,326053,1447934,228962
15079,26,834,1413,628,13879,206
23899,450,11387,1264,8218,46129,3169
5312,16845,348541,1513,237208,677194,111333
15676,41,1187,1404,846,14554,341
68962,1,27,188,19,1280,8
34860,7,270,1045,185,8850,85
5020,56,1695,1517,1316,25197,379
30715,42,1210,1121,646,15525,564
67663,515,12666,227,10484,62320,2182
38225,9,229,959,204,7498,25
16247,1,226,1395,125,7435,101
50744,76,1022,751,748,12608,274
10480,199,5162,1466,3129,53098,2033
38144,30,482,961,265,6785,217
50961,27,437,745,337,7783,100
67271,6,107,243,75,5277,32
19814,139,8526,1332,5563,69767,2963
6700,34,1541,1496,984,26539,557
48781,47,516,804,415,7429,101
54442,63,821,637,619,9135,202
8321,118,3199,1478,2096,17352,1103
70413,9,80,140,68,2745,12
7179,3,152,1489,110,7089,42
937,3046,117287,1557,72857,249690,44430
47082,72,1458,834,1091,14778,367
26754,37,1053,1201,613,10535,440
31537,56,1049,1108,626,19191,423
10964,84,1749,1463,1085,27440,664
28731,181,3991,1160,2361,11409,1630
33443,24,1236,1075,735,20521,501
61960,76,857,398,687,11146,170
5283,581,51586,1513,32857,238916,18729
22080,15,432,1294,309,4976,123
53910,55,920,656,705,13723,215
60602,177,3098,441,2582,21486,516
60561,55,911,446,747,15086,164
11405,318,11640,1459,7746,33089,3894
59899,27,310,470,228,8794,82
58166,2727,39871,528,31734,238043,8137
25861,37,1158,1221,781,23257,377
22848,43,1118,1282,834,8128,284
60529,42,377,447,339,7155,38
32338,26,507,1090,419,7968,88
67173,6,148,246,113,6512,35
5737,5819,148654,1508,100897,821802,47757
59873,177,1525,470,1159,12609,366
13906,0,0,1429,0,17823,0
75,13,626,1566,381,25543,245
3709,8,194,1533,128,9798,66
8441,57,1280,1477,898,14119,382
65902,217,6158,287,4764,39759,1394
11187,2647,97657,1461,55004,536404,42653
50919,22,220,746,175,7825,45
19372,1411,30125,1340,21044,313708,9081
63052,31,244,366,207,9477,37
7751,15,649,1482,372,18798,277
59799,130,1307,473,1036,12510,271
33260,161,3544,1079,2451,22443,1093
32459,13,270,1090,197,7547,73
51042,24,606,743,402,7162,204
49771,459,6805,775,5468,81483,1337
30823,3715,84051,1119,55557,249352,28494
37507,18,366,977,272,20975,94
36408,36,754,1006,627,13214,127
69179,9,166,180,135,3686,31
67792,9,71,221,68,1184,3
42724,24,398,886,315,5799,83
14724,7,174,1417,123,12837,51
59929,47,569,469,470,11909,99
17381,7,134,1376,84,3396,50
20068,39,1177,1328,808,18258,369
24409,188,3138,1252,1906,13540,1232
50220,83,1506,764,1133,19029,373
4365,35,1837,1526,1195,21088,642
3532,317,17541,1535,12448,109877,5093
10868,174,4454,1463,2609,29869,1845
20632,34,490,1318,374,15603,116
6240,8,313,1502,202,26678,111
65510,121,1248,297,1022,16149,226
21063,41,944,1310,638,16197,306
20264,9,335,1325,266,34052,69
20240,0,0,1325,0,7523,0
17528,1267,57672,1373,40555,243219,17117
31535,19,153,1108,93,5220,60
10769,58,2988,1464,1864,24537,1124
23868,19,510,1264,338,9613,172
33541,6,243,1074,152,4749,91
9375,2315,64136,1473,40675,243856,23461
2757,115,3235,1543,2253,16719,982
68067,66,1292,218,948,8724,344
55259,33,536,610,439,33497,97
52610,118,1446,695,1122,12101,324
51600,32,451,727,370,7455,81
62171,17,175,390,148,8840,27
61288,148,2096,419,1733,29394,363
67372,1,12,240,7,1248,5
4757,12,520,1520,353,27907,167
21694,91,1362,1299,929,13767,433
68716,3,99,196,65,1852,34
52969,31,236,683,185,2656,51
60565,70,723,446,594,7031,129
50365,496,6364,758,4984,67900,1380
52730,10,138,690,110,3978,28
12151,22,618,1452,360,20665,258
19735,10,614,1334,475,21959,139
25800,36,963,1222,580,31699,383
9907,5,255,1470,178,13851,77
69054,88,702,185,652,9000,50
8340,165,13471,1478,8420,37896,5051
50732,3,103,751,85,4364,18
5965,752,19421,1505,10537,87382,8884
23306,10,343,1275,276,29652,67
50133,419,7941,766,6427,115192,1514
30924,5,116,1117,80,11085,36
148,1365,75636,1564,46025,336366,29611
5356,15,284,1512,205,8494,79
11721,88,4087,1457,2347,42375,1740
4039,13,195,1530,140,10468,55
28653,27,835,1161,544,13819,291
65742,70,1893,291,1402,16785,491
4572,128,3569,1523,2494,40210,1075
13113,7,107,1440,73,4431,34
67130,0,7,249,4,2006,3
54408,6,49,570,42,5861,7
7857,64,3259,1481,1874,14018,1385
12728,72,3299,1445,1644,16328,1655
1428,426,26543,1553,17568,241255,8975
17350,21,631,1377,442,14898,189
68496,873,17570,204,13804,89159,3766
27265,82,1763,1190,1342,38422,421
368,590,17660,1562,9922,85905,7738
28785,475,14564,1159,12771,108594,1793
9053,14,685,1474,466,13749,219
35714,329,7747,1025,5940,47165,1807
10217,3,196,1468,141,7813,55
13080,0,0,1440,0,7687,0
38881,2,79,944,44,4302,35
17122,68,1982,1381,1492,18464,490
40065,77,1204,928,938,16314,266
18486,36,830,1356,592,19517,238
60487,16,203,448,160,3196,43
56692,37,401,570,347,9418,54
67558,15,92,235,82,2500,10
3766,19,556,1533,419,11040,137
41277,23,525,909,443,13448,82
62354,56,573,385,440,6199,133
60468,21,287,447,247,10664,40
57830,63,449,539,374,7215,75
4113,68,2429,1529,1729,52861,700
14369,14,503,1422,388,18387,115
53865,23,307,657,247,9929,60
37824,70,959,969,745,11725,214
65237,37,640,303,491,5103,149
23583,39,828,1270,479,4944,349
39637,24,308,934,240,5255,68
6564,527,26126,1498,15223,90261,10903
11225,1,115,1461,66,4983,49
30541,24,1046,1124,788,10003,258
69492,10,221,171,196,6721,25
18811,1785,39372,1350,28649,201222,10723
11593,169,7128,1458,4314,20398,2814
46937,967,14315,835,11255,104732,3060
25949,192,9040,1219,5492,44579,3548
50578,80,1712,754,1281,19340,431
24783,11,215,1244,138,6274,77
27456,20,585,1186,386,12240,199
12442,119,2845,1449,1510,31403,1335
15147,425,6509,1412,4687,44986,1822
21962,426,5217,1296,3070,24896,2147
55686,32,434,599,339,8308,95
63910,19,256,343,212,5718,44
54693,13,162,628,126,19861,36
34196,12,210,1061,183,5032,27
35733,259,4089,1025,3099,39754,990
24282,8068,139540,1256,84835,338978,54705
50915,39,481,746,407,9627,74
29661,20,327,1143,205,8647,122
14561,548,21017,1419,13496,67028,7521
20829,36,932,1315,620,7124,312
20960,1,109,1312,87,6708,22
35439,50,972,1031,696,12990,276
70253,20,190,146,184,3958,6
56686,4,84,570,58,4572,26
20885,20,469,1314,296,5529,173
14128,152,3291,1425,2216,38878,1075
61071,27,366,426,280,9826,86
51471,52,1007,731,876,28239,131
41812,11,222,900,201,8313,21
67828,205,2088,225,1610,18712,478
33549,73,2542,1073,1484,20739,1058
50857,347,3224,748,2460,28260,764
13301,3,209,1437,125,8369,84
58597,25,390,513,251,10801,139
8118,475,16599,1478,9757,61831,6842
13550,82,2225,1433,1362,11618,863
12043,6,499,1453,254,12524,245
21728,10,205,1299,140,17234,65
11850,33,1513,1455,767,24651,746
48790,17,203,804,161,2983,42
12438,108,1775,1449,1012,17630,763
44608,18,849,863,522,9303,327
36947,37,505,994,386,4753,119
55697,4,109,598,90,14255,19
43141,37,902,879,717,10288,185
67170,5,100,247,66,2195,34
8228,1085,38033,1478,24209,259480,13824
24909,50387,4308870,1241,2306127,5429334,2002743
7669,1,101,1483,66,12272,35
63567,15,98,353,71,5831,27
8534,28,1141,1477,851,13455,290
25826,8,590,1222,357,24803,233
50808,93,1651,749,1141,30722,510
8898,149,9731,1475,5920,112437,3811
49793,6,42,775,33,3624,9
66648,8,122,264,87,4617,35
18273,2785,64924,1360,45677,232384,19247
8282,90,5675,1478,3361,47304,2314
58873,1077,26139,504,20406,124454,5733
25911,49,1399,1220,858,26490,541
54125,109,1320,648,1070,19996,250
26959,341,4136,1196,3339,21880,797
35235,133,2696,1036,2071,23952,625
63367,2,5,358,5,1370,0
52365,57,904,704,683,21212,221
4241,19,515,1527,348,13504,167
37181,570,15149,986,12485,33954,2664
52185,23,285,709,171,13742,114
1482,4,275,1553,208,9099,67
58631,17,224,512,194,6467,30
44506,58,1352,864,1022,33363,330
37569,23,278,975,247,7055,31
65530,43,785,297,620,12284,165
65697,22,256,292,219,3846,37
34426,12,281,1056,207,8220,74
17832,78,3045,1367,2096,26264,949
204,183,8493,1564,5844,47336,2649
57222,15,174,556,109,7656,65
64062,448,6229,337,4313,21914,1916
60831,33,309,435,238,10592,71
9870,87,2205,1470,1306,28511,899
42510,94,1018,890,867,46492,151
43895,202,6315,871,5094,61712,1221
11050,10172,335832,1462,187745,1328262,148087
64156,25,398,335,345,10563,53
52495,98,1086,699,932,22786,154
4842,205,4756,1519,3210,23007,1546
8178,116,3034,1478,2137,29209,897
67183,166,2667,246,2176,46224,491
50752,387,5621,751,4443,62774,1178
62151,306,4408,390,3605,53845,803
21469,260,5649,1303,4754,112107,895
57123,6,33,558,25,2094,8
4070,95,5393,1529,3409,44731,1984
32161,23,1060,1098,629,24495,431
12598,145,3950,1447,2287,24219,1663
19538,2127,46162,1337,32018,136438,14144
60910,3337,46373,425,36810,234534,9563
25764,2,120,1223,80,3940,40
28995,175,5607,1155,4373,102793,1234
21540,1729,36698,1302,21681,207403,15017
4845,89,2674,1519,1759,58296,915
21602,10990,446369,1301,250678,1468243,195691
10226,61,1520,1468,978,10506,542
20952,11,549,1312,376,5350,173
48692,1,156,807,125,6503,31
49846,36,906,774,701,12952,205
70536,4,76,135,69,3461,7
60628,87,1285,443,1061,12164,224
37428,19,270,980,223,7366,47
35104,10,173,1039,145,5243,28
57548,29,478,548,336,9619,142
50511,36,541,756,445,8967,96
7867,117,5748,1480,3448,58460,2300
15983,8899,319199,1399,248199,1271360,71000
1712,55,1989,1551,1439,41091,550
20099,12,480,1327,367,18744,113
64868,9,294,313,200,4562,94
1612,5,361,1552,202,8416,159
16919,2004,71877,1384,57577,583464,14300
18817,32,783,1350,605,14694,178
67208,110,2182,245,1783,17371,399
66467,7,83,270,56,3949,27
52152,301,4136,711,3389,36749,747
9380,1586,90614,1473,60584,397366,30030
56464,24,341,576,243,7896,98
52654,1,33,693,16,3982,17
34797,13,196,1047,138,3407,58
7840,94,1658,1481,1059,16322,599
16198,17,1001,1396,735,12699,266
5650,34,1458,1509,1013,20062,445
4812,63,2085,1519,1367,16538,718
35392,14,235,1032,212,9982,23
62331,194,3010,385,2537,29524,473
62309,14,82,386,76,2734,6
37255,13,258,984,232,6206,26
55591,13,237,601,177,13559,60
40894,32,495,915,406,7960,89
63581,391,5255,353,4256,53849,999
60446,34,373,450,283,5085,90
18608,47,1155,1354,903,16884,252
16636,36,1284,1389,911,20605,373
56155,32,529,585,422,8473,107
67587,16,250,233,223,6804,27
29971,20,500,1136,336,7816,164
16616,44,1072,1389,845,19545,227
7891,92,5180,1480,3141,43361,2039
21886,138,3989,1297,2601,25886,1388
33423,56,1472,1076,1090,26339,382
50397,5,43,759,30,4977,13
39361,54,459,938,345,6281,114
32522,5,541,1092,345,19164,196
67074,13,417,250,315,7770,102
66537,8,76,268,74,2354,2
8961,46,1591,1475,1053,40198,538
2517,169,4571,1545,2857,56298,1714
57854,239,4725,537,3834,47175,891
36179,1,20,1013,16,2821,4
51194,216,2007,738,1597,50890,410
21980,68,1440,1296,951,16773,489
16511,186,5015,1391,3317,66027,1698
12540,7,464,1448,222,15256,242
1160,147,4940,1555,3263,26079,1677
50939,150,1970,746,1603,19451,367
23089,316,7113,1278,4921,49837,2192
36191,297,3366,1013,2319,34242,1047
67565,0,30,234,23,2886,7
68849,128,2606,189,2305,23030,301
67956,26,526,222,432,14996,94
18257,189,15309,1360,10712,77600,4597
38382,8,196,955,100,3816,96
54648,20,311,629,245,4306,66
16637,553,7286,1389,4903,72073,2383
17289,1254,28526,1377,19046,245339,9480
1083,36,2977,1556,2223,86423,754
19335,31,1032,1341,726,15260,306
55578,15,89,601,74,7663,15
57726,514,6891,541,5989,60397,902
51783,596,10113,722,7995,77092,2118
63151,28,281,363,211,4637,70
25106,23,705,1237,482,15534,223
38847,113,2585,944,2280,46249,305
9594,4,240,1472,145,8114,95
19911,63,3617,1331,2659,46595,958
60220,7607,280185,458,206412,758650,73773
17347,88,2911,1377,2102,61160,809
65948,19,225,286,204,4383,21
17109,284,6175,1381,4627,31299,1548
13839,41,1294,1430,690,11292,604
21162,34,536,1308,332,10593,204
18822,28,1215,1350,889,16220,326
35843,1502,41168,1022,32462,188614,8706
18498,41,3590,1356,2703,47499,887
59805,39,349,473,273,5996,76
68861,10,85,191,66,3105,19
63378,3,27,358,26,2759,1
62947,4,51,369,21,5029,30
26918,27,827,1197,487,6128,340
43145,798,15581,879,12184,219158,3397
33545,120,2320,1073,1645,45992,675
32078,393,5782,1100,3960,36400,1822
66049,73,1392,283,1164,28023,228
54822,109,1459,623,1156,16609,303
29908,28,981,1137,605,15273,376
48120,118,1799,821,1393,18675,406
22546,21,518,1288,366,9367,152
15095,808,31641,1413,19292,153241,12349
40388,16,330,923,236,6611,94
60711,21,212,440,156,9854,56
51263,1506,26299,737,21759,117794,4540
26521,59,2028,1207,1211,19312,817
44074,188,2929,869,2436,19522,493
6550,1,50,1498,40,6405,10
33947,58,1294,1066,915,10584,379
28735,9,888,1160,535,14215,353
50286,5,48,762,39,3957,9
62901,10,172,370,130,3829,42
7675,179,4318,1483,2907,42988,1411
7341,3,139,1488,99,11177,40
10036,22,1171,1469,751,12032,420
60362,1285,20581,436,15870,94459,4711
2004,96,2384,1549,1755,39729,629
5162,5108,247872,1515,140786,928048,107086
10063,0,0,1469,0,7356,0
8160,263,5572,1478,3586,30805,1986
30905,662,11254,1117,6845,48058,4409
34682,2,104,1050,57,3358,47
11414,404,19588,1459,11130,71920,8458
4208,13,667,1528,497,20199,170
8088,441,13804,1479,8882,71003,4922
52787,146,2504,688,2047,19814,457
50324,1373,19191,761,15343,73030,3848
26591,0,0,1205,0,9936,0
27562,2038,38375,1183,25343,193257,13032
26068,89,1875,1216,1315,22133,560
54020,17,400,652,276,8951,124
32144,6,167,1099,128,3271,39
63855,73,1513,345,1237,10677,276
36087,10,239,1015,179,10970,60
57562,100,1919,547,1489,12421,430
27001,177,7910,1195,5196,72567,2714
1925,72,1634,1550,1184,49761,450
64012,10,87,339,78,5696,9
12822,64,2748,1444,1552,45719,1196
17932,101,1389,1365,992,20168,397
37129,1052,20386,988,15127,239017,5259
10608,100,2770,1466,1701,28435,1069
27997,790,22160,1174,14611,161784,7549
32550,2038,31952,1092,23368,118039,8584
59727,5,28,476,26,2758,2
49458,8,181,784,132,5873,49
18204,1157,25215,1361,15726,180441,9489
49805,2,51,774,44,5142,7
13432,34,1296,1435,779,40785,517
58403,115,1925,520,1508,21252,417
16470,0,41,1391,27,5462,14
35053,167,2606,1041,2105,24755,501
59111,0,604,497,445,8247,159
24179,23,244,1258,184,8034,60
10414,45,1120,1467,735,26753,385
25333,0,0,1232,0,8876,0
54496,7,132,635,99,5954,33
57280,25,286,554,205,3936,81
61821,60,1462,402,1087,15644,375
64178,35,222,334,175,4778,47
19779,39,830,1333,606,15048,224
27306,73,2396,1189,1859,22734,537
37713,4,103,972,90,11293,13
20575,42,1801,1319,1277,33402,524
32885,12,576,1086,394,11849,182
22475,8,311,1289,235,8519,76
20069,495,14456,1328,9821,76171,4635
1610,80,3906,1552,2347,28893,1559
33259,170,3706,1079,2361,19383,1345
454,283,25590,1561,16281,171399,9309
4762,1175,21626,1520,13857,201260,7769
55189,171,2080,613,1708,23340,372
22142,8,487,1294,348,9960,139
55114,55,1487,614,668,14788,819
1979,14,971,1549,675,39708,296
17619,157,2529,1372,1874,17008,655
10376,109,3607,1467,2116,54305,1491
54460,38,350,636,303,10666,47
9718,259,13689,1471,6713,122912,6976
3283,76,2452,1537,1720,23552,732
19974,397,8029,1330,5045,64553,2984
3444,13,289,1536,236,11328,53
4293,480,23407,1527,15170,99420,8237
51915,212,1683,719,1383,20384,300
58326,10,180,522,141,4853,39
42306,124,1220,893,927,17516,293
65855,146,3625,288,2780,17943,845
57538,2254,51542,548,39905,232962,11637
10234,104,9971,1468,6006,37979,3965
26458,79,2509,1208,1753,33573,756
38495,4,103,951,87,7184,16
13392,17,868,1436,498,10994,370
29423,0,0,1147,0,11154,0
583,94,3989,1560,2654,48255,1335
32642,117,3012,1090,1999,16281,1013
63153,50,475,364,377,10453,98
46921,149,3052,836,2234,39437,818
2006,2540,62590,1549,41001,233824,21589
56459,125,1342,577,1121,16266,221
2710,135,7498,1543,4782,95046,2716
7574,14,916,1485,688,19610,228
36418,5,132,1006,109,4990,23
12544,27,2048,1447,1035,11215,1013
40680,0,560,920,393,5575,167
64633,138,1410,321,1079,10628,331
7588,115,3340,1484,2401,46869,939
55672,172,2137,599,1533,24545,604
15916,17,662,1400,488,15529,174
35972,24,343,1019,278,16330,65
66149,22,580,279,476,5917,104
1684,17,373,1551,235,8684,138
11404,173,5299,1459,3274,40202,2025
1532,12,335,1553,238,19081,97
8146,13,412,1478,251,14572,161
30468,254,5849,1126,3778,29924,2071
53664,352,3046,664,2212,20151,834
53021,304,4519,681,3401,49142,1118
57143,493,6818,558,5648,40623,1170
10033,207,4340,1469,2936,28940,1404
53247,18,345,675,271,5285,74
28629,114,3531,1162,2357,16842,1174
22060,20,1010,1295,715,20004,295
66502,665,12985,269,11094,83797,1891
52861,44,407,686,339,5069,68
58059,126,2962,531,2444,14522,518
69362,29,306,174,239,5432,67
26861,9,411,1198,206,9697,205
21036,67,1488,1311,874,7357,614
3024,23,723,1540,569,12465,154
59901,261,6017,469,4987,51018,1030
16556,5,234,1390,185,13007,49
15288,8,844,1410,540,20973,304
29680,1,61,1143,42,11580,19
6287,5,223,1502,167,7330,56
21339,3,79,1305,59,3891,20
4523,31,1591,1524,986,25067,605
1295,354,9723,1554,6668,84254,3055
9646,152,5070,1472,2553,24644,2517
13632,2347,33913,1432,23287,185808,10626
19364,21,512,1340,364,13921,148
51380,3,55,733,53,3257,2
63217,10,213,362,168,4912,45
32842,282,5205,1086,3532,35558,1673
38034,230,3189,963,2441,43309,748
24753,40,1699,1244,1163,14786,536
20239,2,94,1325,77,5375,17
8510,384,7414,1477,4826,27164,2588
3339,198,7410,1537,4861,64420,2549
36231,726,18680,1011,14073,149274,4607
48618,1401,17869,809,14211,126621,3658
11136,27,907,1461,496,15631,411
34073,3,39,1063,32,1932,7
52803,12,159,688,119,3439,40
30141,358,12155,1132,7813,100534,4342
36387,32,1061,1005,765,14209,296
52367,62,439,704,337,8613,102
14768,41,869,1417,629,21650,240
22638,673,11541,1286,7501,49836,4040
46465,36082,720665,842,425841,1848025,294824
13277,6,187,1438,121,23138,66
62205,15,182,389,127,5312,55
32751,77,1018,1085,719,25965,299
22108,93,6841,1294,3979,30970,2862
60254,54,1110,457,743,19058,367
62294,93,1361,386,1117,21234,244
14758,84,1243,1417,931,12208,312
38751,49,914,946,802,25574,112
31648,20,737,1106,510,40313,227
17189,6,207,1379,160,9699,47
26322,153,3681,1211,2548,23709,1133
60889,47,575,433,475,16914,100
23031,40,857,1279,562,7993,295
7825,21,1766,1481,1005,20677,761
10963,49,939,1463,613,12427,326
14591,73,1663,1419,1079,16025,584
47533,71,1061,828,820,12775,241
28943,5,315,1156,189,6680,126
36210,88,2846,1012,2384,22146,462
66,0,1,1566,0,54844,1
36898,607,11529,995,9171,96805,2358
15207,0,0,1411,0,28378,0
22523,362,8886,1288,6438,42856,2448
61887,20,259,400,192,7581,67
29551,2120,31443,1145,19959,149768,11484
65949,127,2661,286,2253,40566,408
21447,7,390,1303,251,12856,139
56218,9,132,584,109,4881,23
16533,197,5073,1390,3496,55637,1577
7670,30,444,1483,265,11710,179
29359,45,905,1148,610,11469,295
11021,149,2969,1462,1866,21524,1103
17229,138,2828,1379,2051,22579,777
55704,12,301,598,262,14358,39
15019,84,1790,1414,1337,28889,453
25823,521,10345,1222,6043,98157,4302
64244,130,1901,332,1613,21576,288
1113,159,5447,1556,3523,39907,1924
67126,4,37,249,30,4329,7
53697,8159,122986,656,101100,593693,21886
14089,9,761,1426,534,21105,227
2093,52,2070,1548,1337,31349,733
55508,12,261,603,176,6117,85
57785,7,45,540,36,5939,9
70099,19,188,151,179,4597,9
58770,2,34,507,30,2533,4
27109,12,621,1193,395,16662,226
19308,19,356,1341,242,6400,114
34730,571,12075,1048,9479,66658,2596
23796,1211,27296,1266,18180,112361,9116
17626,44,1380,1371,1095,52360,285
22118,41,1899,1294,1321,60672,578
9095,34,1086,1474,746,14649,340
15089,46,2859,1413,1769,19130,1090
55420,66,895,606,634,15176,261
23405,17,581,1273,473,11673,108
49438,51,1045,784,778,16476,267
37789,1633,24472,969,20078,139593,4394
48153,34,545,820,394,15870,151
40372,312,4190,924,3486,41965,704
57921,13,183,536,134,5846,49
20725,21,1182,1317,853,16290,329
2177,4,242,1547,182,8901,60
16434,84,1572,1392,1053,26017,519
27097,97,2263,1193,1406,15724,857
1882,185,3798,1550,2674,30743,1124
43241,9602,192502,877,152224,1297240,40278
12025,3383,136032,1454,93751,436004,42281
9534,2165,74201,1472,44288,212533,29913
20895,5,163,1313,118,5857,45
70558,4,38,135,34,2245,4
41126,11,121,911,91,10782,30
66184,3,35,278,28,1763,7
24515,4,260,1250,174,4872,86
30691,5,198,1121,115,7663,83
37562,21,223,976,165,4159,58
16897,642,13023,1384,9685,56801,3338
69238,5,103,178,78,1810,25
17017,22,1155,1382,814,19671,341
19339,0,66,1341,36,4565,30
9223,170,3000,1474,1884,34499,1116
49815,34,344,774,286,4186,58
19761,43,1464,1333,1071,34006,393
8776,9,476,1476,299,6837,177
13768,51,1401,1431,935,11323,466
35773,3,280,1024,171,9937,109
20335,309,8343,1323,5558,45981,2785
4710,222,6862,1521,4716,33791,2146
4777,28,1094,1520,807,13944,287
245,129,6486,1563,3505,36958,2981
38482,40,656,952,500,10404,156
33616,19,229,1072,198,3927,31
36546,58,929,1001,769,11842,160
36456,19,324,1005,251,9581,73
48955,51,1054,798,780,16216,274
65155,1836,57853,305,45182,202055,12671
21347,0,17,1305,16,4336,1
13970,2765,70683,1428,46790,330092,23893
5123,1933,76654,1515,41920,315449,34734
55186,77,1282,613,1116,14519,166
53723,5,109,662,72,4073,37
38148,1039,19841,960,13767,62402,6074
8457,115,3713,1477,2379,20728,1334
29178,71,2375,1151,1608,54033,767
60286,6,46,456,40,6355,6
56972,136,1642,562,1267,16203,375
61039,53,526,428,436,9715,90
30244,95,2898,1130,2009,24896,889
26282,360,12581,1212,7965,166973,4616
61786,33,451,403,326,9477,125
28296,121,3667,1168,2342,54507,1325
52618,83,891,694,711,8095,180
4665,33,719,1521,515,26169,204
6279,99,8017,1502,4885,39143,3132
6602,109,2441,1497,1742,24566,699
18400,3,198,1357,123,3606,75
14516,73,2069,1420,1476,11000,593
45259,217,1809,855,1582,50628,227
815,51,1474,1558,967,47230,507
69006,136,2264,186,1838,18782,426
57570,36,416,547,314,8653,102
43673,1367,24706,873,17334,151763,7372
44688,35,752,862,568,20504,184
16525,1198,20473,1391,16328,143846,4145
65126,10,54,305,43,3531,11
67030,59,489,252,389,5215,100
48791,256,4126,804,3222,52983,904
846,86,2718,1558,2030,50376,688
7743,151,5303,1482,3496,45280,1807
68102,10,68,217,55,2385,13
40123,30,397,927,328,6543,69
14403,76,1326,1421,841,13323,485
48747,122,2708,805,2006,23356,702
68930,7,49,189,44,2511,5
22239,4413,95130,1292,54619,522462,40511
36144,8,393,1014,302,15654,91
19829,20,933,1332,666,15337,267
58471,211,3524,517,2742,28941,782
70541,0,12,135,12,984,0
22603,164,7058,1287,4940,56418,2118
70138,152,1685,149,1635,8468,50
29163,39,1774,1151,899,17518,875
17345,14,266,1377,195,8148,71
21833,9,397,1298,260,10187,137
25757,54,2036,1223,1305,11701,731
61023,33,768,428,569,14628,199
23549,16,310,1271,251,11486,59
31501,19,474,1108,359,11439,115
36318,1070,30768,1008,20814,105083,9954
20984,112,2075,1312,1406,38801,669
70537,5,134,136,126,5727,8
11299,45,1078,1460,709,12331,369
34823,157,1996,1046,1441,31792,555
5839,15,504,1507,378,11482,126
62917,3,131,370,78,12547,53
34745,58,2496,1048,1562,23774,934
453,24,2388,1561,1679,19101,709
21110,22,1016,1309,746,19843,270
13668,28,548,1432,326,11268,222
2944,102,2510,1541,1864,20708,646
55652,86,1338,599,1062,8954,276
22088,10,313,1294,204,9014,109
55627,426,9008,600,6721,72690,2287
4999,8,212,1517,157,9616,55
66987,2,73,253,46,4001,27
17867,0,83,1366,62,11006,21
19519,29,1466,1338,993,16396,473
68537,28,609,202,510,7328,99
63443,31,450,356,389,11072,61
19826,6872,272619,1332,168603,733630,104016
33053,20,524,1083,370,5319,154
37210,0,25,983,19,2505,6
12570,84,2057,1447,1089,25742,968
49255,66,1674,789,1230,19687,444
42568,54,757,889,592,14419,165
31788,992,26972,1104,18068,111264,8904
67820,4,70,226,46,4188,24
28017,21,303,1173,222,7685,81
11180,56,1482,1461,810,18695,672
7514,27,631,1485,496,8602,135
64354,37,283,329,231,3838,52
24407,120,4571,1252,2795,43207,1776
34769,23,975,1047,651,23791,324
51988,125,1491,717,1013,13806,478
20767,17,431,1316,314,36386,117
20029,104,3853,1328,2614,28954,1239
34585,40,2484,1052,1632,24916,852
51301,514,8470,736,6386,40014,2084
22173,121,4919,1293,3190,52313,1729
28377,2208,37287,1167,26370,124044,10917
36364,1,56,1007,47,4604,9
16396,2,43,1392,26,4908,17
4149,416,10276,1529,6328,50413,3948
59174,4777,91603,495,69721,281327,21882
60325,14,223,454,175,7539,48
56997,21,215,560,177,5459,38
11036,404,9198,1462,6019,80630,3179
28911,2,147,1156,89,9591,58
7015,2773,93859,1492,55349,346120,38510
35161,666,11688,1038,7729,62231,3959
63827,34,425,346,364,11094,61
5624,4512,127032,1509,72444,426455,54588
59957,0,0,468,0,2373,0
14280,39,1301,1423,842,24696,459
56277,57,907,581,668,14345,239
12305,47,1362,1451,743,12848,619
59399,8164,215894,486,164425,649552,51469
68116,14,221,217,173,6456,48
6475,426,17948,1499,11490,123703,6458
21530,399,21591,1302,13581,90374,8010
52513,415,3774,698,3236,37746,538
51434,119,1941,732,1554,16375,387
49044,47,586,796,499,8933,87
62923,20,214,369,180,4509,34
7457,2,252,1486,169,8856,83
30495,43,862,1125,583,19205,279
42113,33,619,895,473,14769,146
102,18,965,1565,646,33639,319
15286,3,161,1410,114,5430,47
36812,1497,33016,998,23098,97390,9918
15405,4,171,1408,129,5673,42
68772,0,9,194,7,738,2
22234,471,11464,1292,7924,62619,3540
20127,72,1797,1327,1336,12705,461
22887,14,534,1281,408,21410,126
55845,18,352,595,284,7281,68
65556,4,54,296,46,3557,8
66122,10,97,280,73,1857,24
29965,278,7458,1136,4738,44881,2720
22689,291,4875,1285,3286,30978,1589
58517,117,1420,515,1110,25464,310
66994,18,247,252,182,4546,65
48477,27,312,814,216,11144,96
18857,2,109,1349,74,4395,35
52269,583,24954,706,20019,94518,4935
15136,22,379,1412,250,11250,129
7796,309,19138,1481,9982,157009,9156
53314,891,11536,673,9817,62514,1719
28331,32,1299,1167,578,17827,721
14144,16,351,1425,244,10627,107
26039,78,1700,1217,1011,19150,689
21045,49,1162,1311,880,21128,282
48810,23,309,803,258,15420,51
60374,41,1772,453,1192,17918,580
21613,39,1109,1301,690,27793,419
47885,467,7908,824,6689,87992,1219
52878,111,1508,685,1220,49367,288
28792,268,11608,1159,8896,76257,2712
61612,39,786,409,632,8744,154
34316,119,2555,1058,1527,17976,1028
32948,324,9572,1085,5937,91503,3635
64650,74,988,320,701,4693,287
20975,26,1068,1312,726,24208,342
26483,89,2551,1208,1577,14803,974
38569,22,522,949,432,19824,90
48581,20,595,810,383,10489,212
42454,103,1975,890,1265,7481,710
31548,149,4664,1108,2923,48705,1741
20096,18,931,1327,690,10721,241
60877,12,120,434,102,3393,18
18872,54,1415,1349,1031,12598,384
3845,28,452,1532,275,8811,177
5925,331,29584,1506,19514,179660,10070
65405,30,484,299,336,5204,148
63601,9,165,352,116,5912,49
23558,46,663,1270,471,10459,192
2204,56,1570,1547,1086,20577,484
50412,39,345,759,303,8711,42
54292,43,596,643,420,10005,176
65871,18,265,287,223,2679,42
7650,57,1829,1484,1313,16825,516
1190,12,674,1555,473,17115,201
58037,107,1371,532,1130,17906,241
62544,16,355,379,244,10175,111
67775,11,219,228,192,3478,27
43157,102,1171,879,854,15500,317
5898,10651,493005,1506,323493,1431457,169512
29806,454,9333,1139,6801,76243,2532
5252,58,2853,1514,1812,15179,1041
25206,36,929,1235,660,24327,269
2901,49,1543,1541,1044,33453,499
20443,13,336,1321,255,12860,81
48805,31,391,803,289,6739,102
39914,48,1313,931,1044,21201,269
13000,26,3326,1441,1808,37431,1518
27911,49,1871,1175,1263,30396,608
12634,9,704,1446,317,11475,387
37901,20,353,968,252,2941,101
11481,639,17228,1459,9575,112384,7653
35545,16,707,1028,518,12738,189
69817,39,226,159,207,4604,19
26260,44,1568,1213,1041,17809,527
64999,50,576,309,494,4501,82
16575,1114,37707,1390,21802,150132,15905
24264,801,17988,1256,12265,88825,5723
5665,513,10404,1509,7091,47386,3313
18008,9120,244414,1364,160624,1357932,83790
30172,70,1185,1132,734,17613,451
43377,491,7043,876,5495,84942,1548
45601,7,173,852,131,4365,42
34340,132,6786,1057,4777,77369,2009
51537,114,1236,729,989,18744,247
14412,251,6653,1421,4394,45908,2259
57727,614,10177,542,8463,46751,1714
8397,96,1121,1477,743,10452,378
58636,53,1099,512,774,10815,325
64013,105,712,339,569,7517,143
18793,8,109,1350,92,8469,17
11908,218,19404,1455,9386,142683,10018
21068,6,441,1310,283,7240,158
14613,18,491,1419,346,18294,145
11446,535,23473,1459,13607,250999,9866
25655,424,6804,1225,4389,41310,2415
24816,69,1170,1243,734,21728,436
15295,27,955,1410,686,29958,269
37821,33,917,969,706,19392,211
14850,10,441,1416,313,9835,128
5120,14,521,1515,381,11763,140
7107,85,4738,1491,2991,49067,1747
46043,64,1221,846,954,27404,267
64958,41,278,310,245,4457,33
11954,24785,1065857,1454,689611,2885024,376246
13480,27,908,1435,588,25628,320
66465,86,1476,269,976,19791,500
28312,478,10261,1168,7017,62677,3244
66147,22,263,279,218,4090,45
20765,37,965,1316,689,46788,276
51698,40,329,725,262,3233,67
68556,30,423,202,373,11950,50
48053,298,5671,822,4519,29256,1152
55008,61,1153,617,963,9265,190
56642,11,162,571,116,5170,46
40055,49,1040,929,790,7291,250
57511,36,296,549,261,12703,35
13335,342,15011,1437,9368,44554,5643
12086,32,1526,1453,882,9008,644
68163,12,214,215,189,4135,25
27058,106,2115,1194,1378,18079,737
64001,218,4324,340,3539,19779,785
23842,60,2786,1265,1689,26787,1097
23698,6903,127398,1268,90155,295356,37243
58640,17,307,511,234,8094,73
8082,28,2225,1479,1491,23929,734
32515,18,421,1092,350,18855,71
17422,23,822,1376,571,13704,251
32860,16,421,1086,274,7971,147
8296,2,132,1478,102,9141,30
3812,18828,808268,1532,501123,1438528,307145
20063,23,642,1328,437,14311,205
11986,232,8730,1454,5619,72711,3111
63280,26,426,360,305,10056,121
28388,126,4170,1166,2754,22487,1416
5032,48,2509,1516,1666,40374,843
69694,0,15,164,14,1875,1
51341,38,486,734,377,10593,109
68107,17,161,217,130,3437,31
69515,1080,25143,169,21636,140422,3507
69918,282,6586,156,6224,48977,362
58662,4,160,511,73,11203,87
25438,142,5820,1230,3566,90664,2254
60597,64,905,445,699,11931,206
3876,25,984,1531,672,26228,312
54108,64,546,649,447,12056,99
3792,63,2338,1532,1610,16087,728
7569,51,1915,1485,1121,23323,794
10818,9,542,1464,356,27232,186
36390,104,2591,1006,2174,24176,417
12258,1368,51701,1451,28963,316363,22738
36857,11,336,997,259,8126,77
34384,578,10741,1057,8239,82370,2502
12020,18,897,1454,493,20855,404
20535,16,988,1320,637,15855,351
34429,87,1814,1056,1303,8385,511
69396,339,7644,174,5478,51791,2166
20874,514,6287,1314,3536,33931,2751
40860,76,1052,916,726,15365,326
52110,27,303,712,243,5203,60
3043,17,1023,1540,802,10489,221
2014,5,284,1549,223,16624,61
21966,12,597,1296,355,6641,242
27599,19,589,1182,336,6517,253
430,31,1176,1561,747,35410,429
43103,22,307,880,242,11662,65
17545,1113,39918,1373,27237,254962,12681
59052,105,1606,499,1146,6383,460
69634,39,351,166,302,4544,49
18624,112,2736,1353,1861,44738,875
25224,59,1743,1235,1199,8551,544
28825,75,1292,1158,848,14925,444
12213,52,4299,1452,2218,31457,2081
7511,283,6083,1486,3631,47688,2452
59419,1266,22460,486,17503,128526,4957
51480,85,1595,731,1383,73880,212
53343,53,1007,672,782,35971,225
13087,73,3001,1440,1811,20491,1190
69764,2,81,161,62,1621,19
35690,25,372,1026,313,11926,59
67419,15,123,239,90,2743,33
3718,31,716,1533,535,23332,181
50152,275,4979,766,4103,37380,876
60701,11,134,440,116,8467,18
64615,42,744,321,664,17176,80
70300,1,32,144,30,1946,2
35448,121,2602,1026,1878,21058,724
8503,68,3631,1477,2258,29011,1373
34345,101,2878,1058,2138,38458,740
55201,22,255,612,209,7003,46
69061,17,251,184,210,5511,41
64459,29,256,325,204,8405,52
59963,30,487,468,375,6052,112
7512,64,2024,1485,1431,29246,593
7816,1,116,1481,75,25567,41
10725,26,1070,1465,704,24443,366
31420,0,47,1110,35,3631,12
69337,12,203,175,170,2518,33
37990,4576,83637,964,63390,242219,20247
36534,6143,88356,1002,54831,252752,33525
64819,62,783,315,632,5064,151
8356,1383,47372,1478,31757,188502,15615
57815,47,464,539,363,8181,101
59760,391,6638,474,5599,30505,1039
6505,112,3129,1498,2179,19284,950
50074,63,549,767,474,16080,75
57207,55,897,556,747,8538,150
39450,15304,335651,937,256666,988834,78985
23212,7,198,1276,139,7652,59
27684,0,0,1180,0,4970,0
14799,64,1919,1416,1409,20756,510
57546,66,792,548,534,9022,258
9476,41,1592,1473,971,10609,621
50035,87,1080,768,864,17319,216
11606,66,3279,1458,2053,35621,1226
4967,8,296,1517,216,27687,80
36491,338,4604,1003,3299,30683,1305
8370,15,592,1477,394,18669,198
62843,82,760,371,625,7056,135
1679,13,363,1551,279,8891,84
27051,310,4962,1194,3189,22254,1773
6204,29,929,1503,644,14543,285
15769,36,1167,1403,831,42296,336
13185,339,11141,1439,6826,61105,4315
52879,223,2145,685,1715,15178,430
7804,4138,83420,1481,60012,283620,23408
55141,2,52,613,49,7760,3
15618,276,5762,1405,4382,33436,1380
3996,410,7651,1530,5277,58924,2374
574,12,533,1560,378,23627,155
26758,2,117,1201,77,5247,40
23107,275,11689,1278,7389,61196,4300
50102,25,354,767,318,12859,36
26379,9,968,1210,625,29011,343
25985,9,451,1218,283,11573,168
20792,5962,112247,1316,75438,417784,36809
1901,77,3622,1550,2568,29109,1054
13460,146,4597,1435,2807,45622,1790
22068,0,0,1295,0,5405,0
12644,542,10960,1446,7500,38903,3460
10031,12,483,1469,298,6589,185
67704,790,11617,230,9183,81136,2434
20151,16,654,1326,449,4991,205
68450,2,58,206,43,3990,15
20055,3,77,1328,68,4813,9
3435,3,190,1536,108,13932,82
12993,610,14956,1441,8500,35514,6456
14651,904,42211,1418,27934,276257,14277
11167,62,1759,1461,1157,23241,602
61610,80,1345,409,1116,9752,229
60448,12,73,450,58,4531,15
806,504,22508,1558,16034,139763,6474
54739,15,128,626,90,8543,38
2613,17,996,1544,596,36425,400
59196,12,169,494,121,5179,48
32819,54,1282,1087,763,12540,519
35784,38,504,1024,346,5755,158
29140,275,8956,1152,5731,30383,3225
26150,28,634,1215,375,10924,259
55891,31,163,593,122,3493,41
6418,95,1137,1500,741,9264,396
31846,31,1627,1103,1033,11316,594
55278,106,1225,609,914,11407,311
57466,85,1359,550,1048,9170,311
59082,51,661,498,579,16300,82
47026,7,60,834,43,8026,17
58084,1748,28047,531,22208,123019,5839
32257,33,1010,1097,659,8391,351
51107,22,235,741,213,12704,22
7452,229,17531,1486,10495,132615,7036
2315,98,4015,1546,2978,67543,1037
11027,14,621,1462,362,32717,259
69235,18,221,179,172,2394,49
732,39,2056,1558,1461,56564,595
46676,101,1717,838,1455,30571,262
49621,2,59,779,47,5325,12
35022,46,1285,1041,825,12028,460
35967,41,1304,1019,1017,12899,287
11906,12,485,1455,250,6451,235
20807,422,10496,1315,6730,75954,3766
4623,5,298,1522,194,13870,104
23197,29,590,1276,460,11527,130
23378,16,341,1273,230,7170,111
60040,34,250,465,200,7088,50
57003,5,91,561,69,3450,22
15559,13,644,1406,475,57430,169
26974,27,681,1196,415,16770,266
55285,149,2226,609,1787,15246,439
8109,27,433,1478,305,6841,128
17178,1073,72182,1379,44097,414716,28085
1974,2,339,1549,235,20123,104
5081,77,2195,1516,1495,25224,700
21838,2,88,1298,60,5090,28
26606,38,819,1204,473,6861,346
30033,1964,57939,1135,39201,314105,18738
46205,596,20227,845,11257,51007,8970
61134,70,1311,424,899,35920,412
24616,106,2395,1248,1629,16997,766
64179,3,96,334,75,3069,21
8139,23,1052,1478,648,13748,404
16377,25,1712,1393,1024,15557,688
58644,41,391,510,308,6405,83
18794,150,3042,1350,2214,21947,828
50624,36,427,754,340,10053,87
33771,13,225,1069,168,7373,57
59070,61,811,498,617,19610,194
66873,0,18,257,10,1612,8
31140,236,8467,1114,5647,95925,2820
30287,54,4044,1130,2261,50364,1783
23448,82,2571,1272,1562,42388,1009
67373,35,586,235,483,9172,103
59685,215,4027,477,3265,45569,762
60955,249,2689,431,2243,10324,446
37081,804,20461,990,15506,91570,4955
14933,136,2772,1415,1891,26567,881
66736,303,4430,261,3243,23726,1187
31445,16,215,1109,147,10495,68
2332,2833,118786,1546,70481,436873,48305
24121,115,3616,1259,2536,98820,1080
63694,59,680,349,599,16916,81
20951,14,199,1312,124,5220,75
67065,20,206,251,148,2521,58
15111,7,255,1412,163,16286,92
57729,157,2669,541,1821,32846,848
20996,13,277,1312,194,6800,83
26215,5,347,1214,213,8740,134
67637,213,4740,232,4001,29687,739
41109,33,532,912,456,20766,76
69760,8,185,161,164,3106,21
28687,11,298,1161,182,8613,116
8678,47,1396,1476,935,19085,461
30961,6,304,1116,195,10818,109
1263,5,306,1554,218,18453,88
66798,15,149,259,121,2512,28
58672,5373,108025,510,77444,573686,30581
28861,12,298,1158,185,7920,113
5751,49,1594,1508,1149,24432,445
37021,273,3788,991,2994,18702,794
50631,5,109,754,88,2643,21
25554,1118,25365,1228,18535,75032,6830
60774,329,3760,437,3291,23005,469
11700,0,0,1457,0,16367,0
48673,8,102,807,70,16864,32
19159,1079,17587,1344,11462,125958,6125
10445,4613,120276,1467,70985,277356,49291
70019,26,229,153,193,7838,36
70200,331,4752,147,4182,35988,570
13302,114,5476,1437,3208,100930,2268
6109,0,75,1504,45,19584,30
53401,127,1911,671,1664,32778,247
36319,8,101,1008,79,6184,22
50325,432,5679,761,4360,51613,1319
69884,27,472,157,471,11434,1
40480,1,36,922,33,4449,3
43473,0,40,875,35,2522,5
1288,46,996,1554,722,22827,274
52922,89,950,684,669,9975,281
19385,23,1061,1340,685,9468,376
8667,16,717,1476,439,13372,278
53518,3320,35208,669,27105,247162,8103
25249,1090,22847,1234,14960,164139,7887
10701,0,184,1465,110,5756,74
64592,20,249,322,179,4913,70
15451,80,1156,1408,729,7137,427
62186,143,3071,324,2461,17276,610
64260,90,1892,331,1491,32627,401
34352,11,237,1058,161,5326,76
64500,15,129,324,91,4557,38
44091,44401,697300,868,497028,1594871,200272
37445,58,775,979,637,9887,138
31781,11,264,1104,173,2817,91
17844,18,577,1367,485,38910,92
9137,22,1095,1474,699,13512,396
64060,4,156,338,62,3144,94
59349,31,348,489,286,7451,62
25548,17,384,1228,308,11827,76
63297,20,566,360,412,8105,154
18297,38,915,1359,746,48008,169
11119,1516,27754,1462,16099,75522,11655
27486,43,2597,1185,1530,17943,1067
12337,338,6840,1450,4519,39416,2321
5416,67,4380,1512,3005,39106,1375
8451,501,17541,1477,10966,106086,6575
35279,109,2699,1035,1747,32746,952
32191,28,425,1098,251,4862,174
20325,2,72,1323,59,5042,13
33573,6,397,1073,258,9472,139
68000,6060,150536,210,122220,572790,28316
32113,84,1159,1099,873,23989,286
13769,39,1542,1431,920,13326,622
27449,442,27639,1186,17091,49507,10548
57017,230,4922,561,3663,31426,1259
22703,392,10327,1285,5930,25740,4397
35011,8,288,1042,185,7141,103
6429,1115,48195,1500,32698,241218,15497
32127,5,77,1099,56,5535,21
11578,52,1056,1458,636,14474,420
51776,41,370,722,313,6547,57
62215,8,137,389,81,1902,56
41338,25,467,908,391,28906,76
54830,8,85,623,63,5636,22
28074,16,648,1173,378,14469,270
49451,0,0,784,0,3636,0
65546,14,144,296,128,6050,16
69995,33,585,155,557,12222,28
31741,1531,19616,1104,11988,95007,7628
10831,31,1153,1464,780,23203,373
16266,454,7189,1395,5147,62036,2042
25834,118,3944,1222,2320,14294,1624
58399,64,1354,520,1056,24245,298
52889,7,132,685,114,19716,18
56612,58,516,572,408,12497,108
68816,15,140,193,119,4815,21
59902,42,503,469,398,11433,105
49570,1,41,781,32,2185,9
58140,19,394,529,253,5443,141
37199,1,23,986,20,3407,3
20927,161,5259,1313,3261,81822,1998
23371,18,370,1273,253,10800,117
62698,1613,51403,357,33506,115310,17897
56871,16,731,564,610,4959,121
59894,12,99,470,82,3764,17
21015,77,1355,1311,1032,12381,323
33157,11,403,1081,274,10037,129
20479,198,3922,1321,2927,23780,995
28462,190,1606,1165,1335,14813,271
70315,12,94,144,78,2120,16
34545,16,400,1054,258,9749,142
32370,94,2187,1095,1511,15785,676
69937,18,295,155,248,4146,47
14862,9,504,1416,379,28188,125
27891,11,298,1176,215,17365,83
58362,32,559,521,398,10108,161
52942,33,380,683,301,7201,79
62976,73,1811,368,1300,18540,511
50379,374,6090,759,4710,54574,1380
46364,128,1408,843,1038,17064,370
19018,265,5874,1346,4107,62793,1767
23275,53,1630,1275,1386,69743,244
2368,397,12565,1546,9598,84540,2967
59280,18,315,491,231,6077,84
68918,654,13281,189,11777,103282,1504
17437,85,1690,1375,1020,14816,670
65135,28,472,305,404,11445,68
17242,68,2501,1379,1735,17928,766
42428,31,819,891,617,16543,202
66268,20,185,276,146,4382,39
62796,66,663,373,569,6058,94
26900,225,7092,1198,4561,31319,2531
9714,37,790,1471,476,13841,314
10977,11,499,1463,295,9804,204
20525,439,8350,1320,5745,80566,2605
27350,29,651,1188,489,14118,162
56729,183,3692,569,2992,28801,700
2379,48,1259,1546,880,16983,379
6054,6,278,1504,195,18020,83
48012,193,3442,822,2651,47416,791
51339,4003,57794,735,42376,136984,15418
20811,3,249,1315,180,18808,69
23630,79,1670,1269,1073,11319,597
19337,79,1192,1341,876,16209,316
37105,9,243,989,219,13428,24
43445,25,338,875,295,9447,43
4410,7,168,1525,118,22411,50
18461,97,3276,1356,2276,73011,1000
8241,35,1977,1478,1230,24113,747
16090,1957,37274,1397,27209,151059,10065
6877,150,2457,1494,1542,18226,915
63007,44,584,368,456,7989,128
30375,37,2034,1128,1280,20276,754
57684,22,248,544,173,7357,75
24633,7,199,1247,140,7596,59
61990,1,25,396,25,1693,0
36759,249,2138,999,1497,9901,641
42678,85,1921,886,1511,47388,410
44183,24,393,867,255,10860,138
11897,87,4283,1455,2327,20574,1956
3500,10,282,1536,199,19585,83
3471,900,32646,1536,19485,237666,13161
22497,10,261,1289,175,12313,86
44849,39,437,860,300,10829,137
9141,102,1505,1474,1170,18374,335
320,8,674,1562,475,39937,199
31074,0,0,1114,0,57249,0
16520,713,15245,1391,9295,54240,5950
62062,30,572,394,346,11074,226
64753,484,9270,317,7514,54466,1756
9033,65,1311,1475,893,14487,418
62114,25,233,392,178,2196,55
35343,60,1522,1033,1109,19148,413
24266,261,4704,1256,3006,26478,1698
56070,12,48,588,46,3537,2
66715,75,1369,262,1012,29070,357
5174,780,40694,1515,25949,200373,14745
20146,41,1247,1326,947,18598,300
56600,27,347,572,298,10293,49
53242,29,226,675,183,4195,43
14949,30,587,1415,438,18962,149
36067,2723,83870,1016,59502,451868,24368
17631,8,206,1371,146,9257,60
51096,51,419,741,327,9394,92
57031,48,1340,560,1007,37321,333
703,515,11773,1559,7250,81076,4523
12110,10757,260889,1453,155887,740115,105002
21689,5277,141036,1300,90218,415659,50818
61,43,1466,1566,942,26725,524
30163,88,1168,1132,860,32003,308
54699,7,65,628,48,6535,17
49658,5,193,778,90,3510,103
32919,128,4481,1084,3243,45738,1238
54706,76,683,627,484,7492,199
52174,24,244,710,212,6584,32
30611,523,12791,1123,9063,90882,3728
24378,10,269,1253,202,8743,67
67163,1,27,247,20,2370,7
17531,40,2716,1373,1889,25877,827
3652,18,238,1534,184,23467,54
19631,160,1662,1336,1116,22138,546
39958,9,118,930,93,3843,25
21160,90,2455,1308,1751,27188,704
15425,4906,146459,1408,84258,936927,62201
5943,126,10633,1506,7242,47309,3391
30683,10,564,1122,343,3792,221
27626,39,1217,1181,705,7698,512
8132,360,5611,1478,3460,24741,2151
12525,22457,655866,1448,337313,1655714,318553
2696,252,6649,1543,4753,75492,1896
27375,221,2977,1188,2035,20763,942
33286,212,4403,1078,3225,35677,1178
63870,11,177,344,126,4138,51
15541,17,850,1406,636,15208,214
63917,14,179,342,135,8380,44
59289,4,114,491,83,2584,31
68092,0,33,218,20,2916,13
25466,46,1843,1230,1043,22848,800
12449,179,3602,1449,2167,43641,1435
1377,799,79753,1554,51842,227892,27911
4948,116,5131,1518,3110,28648,2021
29795,84,1560,1140,1052,27656,508
19812,2,99,1332,77,4197,22
35088,1170,21752,1040,15979,199054,5773
5027,818,17149,1516,10934,138575,6215
3240,24,537,1538,376,40571,161
2071,23,1071,1548,731,34589,340
12243,14,626,1451,363,31814,263
24995,156,4088,1239,2770,40944,1318
36718,47,496,999,408,9496,88
29428,5,281,1147,164,6881,117
49822,11,193,774,154,8555,39
36548,1,84,1002,65,3260,19
16202,23,435,1395,292,8407,143
38313,13,235,957,176,5558,59
25930,27,592,1220,405,20253,187
36393,926,12950,1006,10000,135637,2950
24939,22,473,1240,339,6225,134
25409,30,1463,1231,980,18320,483
41994,78,845,897,647,6210,198
61792,53,607,403,514,10609,93
5613,37,1538,1509,990,14725,548
31785,4,66,1104,55,5123,11
32833,185,2811,1087,1798,23474,1013
38116,55,575,961,440,5667,135
50636,3,169,753,128,5157,41
26618,21,1127,1204,718,16603,409
50377,4024,66889,760,46635,343960,20254
68544,27,329,202,269,4334,60
29134,151,3565,1152,2295,25562,1270
31019,754,14597,1115,10245,124225,4352
62805,6,100,186,90,5072,10
14584,0,1442,1419,981,28405,461
19840,373,9219,1332,6439,86072,2780
24002,66,2397,1262,1699,36809,698
34770,836,19704,1047,13872,90951,5832
15853,24,850,1401,610,26770,240
54001,60,578,653,518,18232,60
24740,943,18208,1245,12821,53156,5387
14252,37,1237,1423,930,27747,307
5569,128,3671,1510,2621,19108,1050
34563,372,5563,1053,3866,39826,1697
18523,61,2221,1355,1659,10535,562
65647,28,204,293,178,6948,26
31158,31,480,1113,298,5513,182
52819,125,1173,687,1040,19970,133
57527,9,120,548,95,5129,25
60896,662,9065,433,7541,72102,1524
29979,8132,152520,1136,92135,467090,60385
29142,74,2485,1152,1363,11985,1122
49397,287,5776,785,3590,43635,2186
32425,20,518,1094,361,9864,157
68605,395,5268,200,4293,51409,975
66562,18,256,267,200,3787,56
32363,3575,52180,1095,42258,874545,9922
25864,52,1227,1221,936,21645,291
1840,35342,1019231,1550,739485,2621236,279746
38138,220,2770,961,2181,22917,589
53153,179,2034,677,1663,22786,371
25404,10273,241241,1231,138019,680238,103222
5810,86,3743,1507,2641,49234,1102
52800,1529,37071,688,24163,265842,12908
36249,1940,44975,1011,34317,178754,10658
24159,112,2431,1258,1527,19922,904
67539,28,432,235,334,4222,98
9414,31,1866,1473,1191,41609,675
67732,62,707,229,562,8832,145
14957,3,435,1415,317,21687,118
31664,22,554,1106,359,6434,195
23727,88,2253,1267,1643,23651,610
64304,30,355,330,257,7987,98
52182,11,125,710,98,6751,27
67659,203,3592,231,2569,51227,1023
1125,9,228,1555,170,16127,58
37151,293,4734,988,3927,41665,807
4847,17,816,1519,544,10668,272
11510,27,1423,1458,742,19857,681
52736,23,211,690,188,7550,23
70236,0,12,146,9,770,3
60068,10,160,464,126,4794,34
22407,2693,69389,1290,48257,354782,21132
43261,133,1892,877,1597,29995,295
41680,42,670,903,521,8175,149
40418,18,273,923,221,5957,52
35319,34,378,1034,258,6765,120
57291,2507,27847,554,21725,123096,6122
50710,92,1703,752,1443,27468,260
28511,584,13105,1164,9412,52520,3693
51951,41,733,718,642,9739,91
34110,246,5058,1062,4183,51216,875
18983,61,1182,1347,838,10163,344
54161,3,54,648,32,5914,22
60234,41,558,458,454,7429,104
53921,34,312,656,254,16585,58
12487,77,2325,1448,1280,33506,1045
12289,384,15575,1451,9134,56460,6441
69380,6,75,174,68,2878,7
20281,74,1872,1324,1333,21858,539
21767,145,3078,1299,1744,17294,1334
7118,99,4309,1490,2722,31436,1587
18527,16,395,1355,302,6184,93
54857,3,70,621,59,3463,11
11086,34,580,1462,365,13906,215
4731,53,861,1520,586,11233,275
9381,48,2129,1473,1435,45361,694
13355,745,28044,1436,16936,109053,11108
1673,0,67,1552,54,13355,13
34013,19,753,1064,474,11031,279
487,107,4515,1561,3120,54923,1395
61609,221,2854,409,2403,23912,451
23631,6,520,1269,351,9718,169
67794,16,90,227,80,2713,10
49687,395,7255,777,6196,79382,1059
51110,39,379,741,293,6352,86
57794,108,2013,540,1650,15429,363
33791,1189,30470,1069,21700,128876,8770
25252,17,354,1234,257,6400,97
339,206,8396,1562,5701,64083,2695
15557,15,448,1406,323,55279,125
48279,155,2805,818,2304,32204,501
11307,346,8839,1460,5682,54878,3157
52967,50,749,683,596,30344,153
62075,37,220,393,194,5078,26
58356,36,521,521,412,15405,109
51612,1961,30807,720,24248,238059,6559
19216,11,332,1343,216,6399,116
18541,7,453,1355,372,7373,81
61879,112,3186,400,2544,15581,642
60481,72,1162,449,880,18453,282
39686,1192,19061,934,14368,88713,4693
49090,8,81,794,65,5479,16
1831,115,3710,1550,2806,57683,904
13072,61,2541,1440,1473,11050,1068
21895,55,1242,1297,838,32817,404
9271,35,1334,1474,814,11433,520
19524,31,1134,1337,879,44925,255
55607,2203,23292,601,17108,102613,6184
50632,71,1052,753,884,14492,168
28777,4,213,1159,139,10137,74
69459,15,190,172,163,2432,27
70062,11,83,151,69,3115,14
7652,33,978,1484,661,17009,317
69258,576,13051,178,10171,92833,2880
25658,470,5492,1225,3381,28548,2111
60892,0,27,433,22,3571,5
39434,526,8279,937,6162,80857,2117
23244,423,7339,1276,5360,54213,1979
17620,124,3323,1371,2354,35844,969
52210,85,1055,709,845,16130,210
64828,23,259,315,194,2845,65
21582,41,1166,1301,845,15440,321
28540,108,2964,1164,2182,24353,782
32075,355,6552,1100,4143,28996,2409
41424,26,799,908,593,8258,206
54777,27,441,625,335,10679,106
66878,93,1330,256,1153,24146,177
59921,24,447,469,355,13350,92
38231,40,697,958,599,16087,98
27631,87,1535,1181,923,15907,612
32766,26,575,1088,369,3493,206
68127,108,2807,217,2124,19217,683
1844,180,6010,1550,4071,74429,1939
21350,532,8831,1305,6384,106151,2447
52545,24,455,697,330,11125,125
28282,1075,26506,1169,17090,207340,9416
38341,136,1946,956,1522,17850,424
15395,49,856,1408,590,12996,266
31181,971,27771,1113,17969,120651,9802
68139,26,188,216,157,3682,31
64053,11,131,338,97,7978,34
24857,152,2827,1242,1891,24772,936
33885,83,2789,1067,1989,29382,800
35052,11,178,1041,120,6276,58
55239,64,887,606,655,9065,232
2994,12,266,1540,203,9079,63
70504,7,68,137,61,1660,7
36056,529,10520,1016,8564,33664,1956
28278,35,1126,1169,819,10583,307
19591,109,2206,1336,1541,18550,665
67700,53,1084,230,882,12739,202
65538,88,1096,296,868,6000,228
24451,117,2743,1251,1997,31551,746
48829,11,633,802,497,13455,136
31411,4,105,1108,72,2674,33
69365,0,216,174,201,6894,15
27257,3,102,1190,91,7573,11
4973,101,4069,1517,3070,40382,999
53389,4,59,671,49,2504,10
32466,27,288,1093,235,11958,53
23408,48,1192,1273,829,19350,363
15173,14,590,1412,405,18251,185
17154,27,994,1380,693,44696,301
46847,28,608,837,410,32502,198
27632,15,461,1181,378,16407,83
2570,214,16729,1544,9790,92974,6939
70280,86,1038,145,1004,17009,34
60284,147,1627,456,1298,13607,329
33594,9,172,1073,139,8039,33
4991,1196,24946,1517,19381,178809,5565
18874,5,526,1349,389,21974,137
16178,315,8246,1396,4585,45120,3661
61358,27,473,417,376,10239,97
29422,50,718,1147,541,11218,177
1954,6,399,1549,315,43756,84
38857,48,904,944,659,9360,245
5550,50,2012,1510,1292,18407,720
53005,28,213,681,191,13118,22
56655,18,233,571,207,10888,26
25528,125,2253,1229,1594,21836,659
28913,3,179,1156,94,5038,85
64756,59,1478,317,1270,7656,208
41969,8,238,898,178,6568,60
9299,30,806,1474,563,13008,243
16282,2501,69097,1395,48384,416436,20713
56930,429,6071,563,5034,64160,1037
1834,13,745,1550,449,28410,296
29519,474,6086,1145,3671,43130,2415
27260,14,259,1190,169,4994,90
5660,18,1108,1509,728,16538,380
36827,189,2580,997,2149,43977,431
11387,267,10329,1460,6135,125427,4194
3145,1259,50383,1539,30539,121877,19844
33005,4,210,1083,132,4632,78
22473,151,4543,1289,3165,73081,1378
49067,32,372,795,297,5923,75
60039,88,2323,465,1512,46897,811
30501,704,20297,1125,12901,181137,7396
3300,550,16514,1537,10707,95717,5807
37705,7,112,972,89,5570,23
36259,47,1430,1011,1035,22567,395
32758,21,436,1088,276,8749,160
33229,148,2603,1079,1924,19184,679
2002,178,5901,1549,3685,59220,2216
49976,1,22,770,21,3613,1
27273,16,559,1190,335,6377,224
4766,182,2990,1520,2169,41931,821
16796,137,2452,1386,1702,28704,750
21438,76,3053,1303,2254,66001,799
47339,14,287,830,228,8877,59
11774,147,4432,1456,2109,15935,2323
19318,410,12610,1341,8699,149846,3911
6231,7,145,1502,96,19766,49
30650,7,259,1122,155,8885,104
62856,1800,36396,371,28566,192529,7830
2729,100,4876,1543,3775,64553,1101
11314,211,5784,1460,3570,56615,2214
49131,178,3624,793,2054,30001,1570
47231,157,3050,831,2160,34450,890
68955,52,457,188,393,6980,64
43043,60,880,881,733,16410,147
70470,6,151,138,128,6515,23
29036,2103,74060,1154,48167,216141,25893
34970,20,356,1042,245,10643,111
13534,302,10258,1434,5919,46007,4339
18063,6,234,1363,174,13856,60
14331,31,1385,1422,996,20087,389
1120,168,5581,1555,3426,32138,2155
27187,3,93,1192,57,3669,36
64362,23,305,328,240,5525,65
46035,49,796,846,612,15369,184
14379,146,2800,1421,1930,44842,870
35098,15,425,1040,282,13437,143
40747,15,232,918,181,8251,51
57146,31,475,557,414,10099,61
59640,10,159,479,105,3126,54
23452,25,574,1272,406,14635,168
49279,3885,55578,788,39112,206536,16466
6595,43,997,1497,647,19381,350
16116,41,2342,1397,1435,13876,907
44143,7,198,868,157,5036,41
49797,58,566,774,469,9878,97
38444,54,524,953,381,11563,143
23186,29,1173,1276,797,11364,376
11236,45,2223,1461,1248,38676,975
17723,18590,481623,1369,307226,1121101,174397
60394,55,858,452,655,8031,203
55321,10,97,608,52,8105,45
28341,8,229,1167,161,21269,68
36494,2,196,1003,153,7754,43
56641,6,82,571,76,2656,6
52338,52,535,704,415,9175,120
3603,5,262,1535,175,22120,87
13192,115,1752,1439,987,11114,765
58886,86,1278,504,1009,18388,269
30515,16,545,1125,387,9829,158
59941,7,130,468,98,5372,32
16455,1953,40505,1391,26409,208503,14096
35432,93,1842,1031,1383,19963,459
26966,42,1063,1196,606,10635,457
41714,63,1514,902,1230,23511,284
65908,11,194,287,128,3869,66
4932,127,3907,1518,2445,76550,1462
54424,62,541,638,402,5370,139
47011,395,4095,835,3100,22916,995
14439,231,8069,1420,5648,72565,2421
35804,587,10651,1023,7480,42237,3171
53045,3767,47172,680,39360,225630,7812
26665,221,8925,1202,5730,48076,3195
50760,76,855,751,681,8825,174
27170,3,82,1192,65,3519,17
17005,47,735,1383,525,11678,210
33482,1624,26657,1075,18603,126704,8054
18890,281,8388,1349,5710,36453,2678
34163,42,1796,1061,1177,6041,619
58137,2449,68235,529,52590,288686,15645
56716,25,240,569,170,9706,70
52896,193,5277,684,3790,38231,1487
2226,258,13010,1547,7808,66217,5202
62343,9,179,385,108,3608,71
47473,0,65,829,43,2202,22
9004,98,3363,1475,2312,33884,1051
9196,1410,58300,1474,35827,238289,22473
58494,29,381,516,301,12428,80
30467,7,314,1126,208,4169,106
3114,1,136,1539,110,10110,26
52289,130,824,706,652,14264,172
25794,1752,52110,1222,35015,184879,17095
43065,14,333,880,258,6567,75
64678,24,440,319,301,7957,139
60690,7,93,440,82,10258,11
29682,11,568,1142,342,11976,226
56003,21,344,590,210,7326,134
33703,103,1315,1070,1013,8425,302
23562,8,480,1270,357,8155,123
31479,21,355,1109,255,6364,100
44069,59,953,869,800,27675,153
25309,435,11972,1233,8043,150989,3929
8468,107,3341,1477,2009,48165,1332
9508,85,1683,1472,1112,8838,571
9165,46,1202,1474,834,12650,368
66962,24,495,253,381,14617,114
59754,29,409,475,308,6409,101
23747,14,372,1267,252,10733,120
2127,633,15861,1548,11396,86727,4465
2330,14,592,1546,413,12297,179
61416,1138,56582,415,41755,120415,14827
13567,275,11910,1433,7866,99028,4044
46968,19,301,835,258,8033,43
26245,61,764,1213,536,9031,228
8024,62,2219,1479,1412,13351,807
18214,158,6763,1361,4560,48446,2203
54082,96,1569,648,1407,21929,162
22439,48,1534,1290,1079,24004,455
14277,15,840,1423,666,23807,174
18529,113,3255,1355,2030,26388,1225
10954,9,213,1463,134,5090,79
10127,64,2118,1469,1248,17478,870
50750,14,345,751,223,9138,122
16327,40,2002,1394,1420,31383,582
38895,2,74,941,64,21532,10
59830,16,150,472,122,3047,28
4253,182,4341,1527,3277,70517,1064
63300,170,2654,360,2113,22839,541
28819,282,13002,1159,8918,43792,4084
33383,4,54,1077,29,4846,25
48924,15,220,799,180,5543,40
2365,966,45037,1546,26928,309018,18109
36958,982,17670,993,14277,106056,3393
66442,111,1376,271,1162,14385,214
26812,31,1085,1199,701,12664,384
56434,20,388,577,258,6387,130
27671,5,99,1180,67,2877,32
38198,6,128,959,107,15172,21
14493,20,1641,1420,1001,7734,640
63832,120,1603,346,1299,32251,304
60944,56,672,431,487,9094,185
22318,587,11646,1291,8190,55641,3456
65451,4,42,298,29,2447,13
55409,12,166,606,125,10637,41
29678,66,1800,1143,1158,37701,642
20385,4,226,1323,161,10069,65
60978,364,4517,430,3839,84359,678
8093,329,15069,1478,8944,69619,6125
12240,15,477,1451,247,7839,230
21735,75,1991,1299,1349,27408,642
47098,4,52,834,32,3338,20
35849,16,325,1022,225,5427,100
14124,12,335,1425,247,8543,88
27707,435,19364,1180,10486,114753,8878
21680,27,1661,1300,981,13771,680
63220,35,555,362,399,10631,156
67191,5,76,246,60,3896,16
42518,6,51,890,32,1330,19
52529,76,829,697,652,12690,177
55396,291,3468,606,2659,31282,809
6463,381,5241,1499,3404,48824,1837
32489,85,2352,1093,1408,28088,944
48927,146,2619,799,1992,25054,627
53592,4,186,667,153,4277,33
14178,6005,148957,1425,107997,433124,40960
14946,238,6034,1415,4206,41631,1828
59028,415,5652,499,4368,57628,1284
57608,27,229,546,207,5148,22
51804,27,425,721,259,8007,166
35483,10,193,1030,139,3965,54
50419,59,594,759,467,5136,127
4741,183,4523,1520,2955,26532,1568
67388,23,293,240,285,6120,8
58561,37,486,514,394,9383,92
35710,8,526,1025,356,10306,170
56390,244,4426,575,3772,35405,654
57656,19,202,544,172,3931,30
70231,67,1272,146,1165,15188,107
63877,32,272,344,200,5093,72
25050,25,750,1238,622,11180,128
30197,0,36,1131,28,5158,8
211,53,6359,1564,3959,35487,2400
16235,268,5672,1395,3990,68242,1682
65391,0,16,300,13,1701,3
64124,28,552,334,402,5844,150
8198,143,2881,1478,1686,20840,1195
60281,20,383,455,287,3922,96
36168,57,1391,885,1041,15597,350
19986,12,607,1329,420,5869,187
66681,15,393,263,317,6875,76
12175,1743,64027,1452,37554,182541,26473
29099,20,1135,1153,665,15151,470
16310,9,269,1394,201,5542,68
58436,0,0,518,0,5862,0
10841,48,1101,1464,743,33638,358
47736,55,642,825,506,8228,136
65768,0,0,290,0,5072,0
8896,145,3410,1475,2190,19106,1220
50079,39,663,767,523,12766,140
66803,15,171,259,146,1957,25
52613,57,740,695,599,11156,141
33024,32,888,1083,625,23458,263
9599,74,2042,1472,1333,32311,709
47963,0,0,823,0,2361,0
25346,0,0,1232,0,12219,0
23948,343,4691,1263,3591,16875,1100
19019,6,146,1346,120,16134,26
37003,185,2916,992,2285,51521,631
22701,7852,172551,1285,105202,579111,67349
25971,691,18038,1218,9789,131954,8249
29007,9,722,1155,429,16951,293
46958,864,19961,817,15258,98332,4703
38387,15,283,954,190,8488,93
10148,1,102,1469,65,4733,37
53889,89,1942,656,1190,11262,752
22888,6,144,1281,95,14712,49
68207,45,529,214,438,12637,91
27462,226,7818,1186,4551,70256,3267
67207,114,1562,245,1326,17027,236
67062,18,264,251,201,7262,63
19320,47,1810,1341,1175,33961,635
57783,99,3234,540,2473,32476,761
9486,609,11324,1473,7306,40316,4018
30001,5,222,1135,145,28056,77
67231,25,275,245,214,2917,61
21775,6,302,1298,201,9932,101
22217,145,2768,1293,1697,26172,1071
64147,101,1569,335,1188,30592,381
33713,1150,29289,1070,20564,69580,8725
8955,346,13446,1475,8498,60909,4948
27549,7,533,1183,350,15941,183
31500,68,852,1108,569,12342,283
30890,21,965,1118,608,25385,357
14104,147,4610,1425,3208,76244,1402
25641,7,199,1226,119,4334,80
50064,2326,28733,768,21358,118947,7375
51532,22,172,730,133,10195,39
45150,33,329,857,263,10849,66
38481,24,818,951,634,11292,184
64317,47,429,330,374,7870,55
68888,18,167,190,151,2794,16
9129,60,2221,1474,1321,11971,900
11309,5,111,1460,82,10612,29
41567,22,369,905,254,5883,115
58536,1558,69905,514,47726,193555,22179
38517,11,147,951,110,2051,37
48576,53,1044,810,920,12385,124
57218,10,65,556,56,2865,9
36252,3247,90653,1011,64233,350705,26420
38345,47,896,956,711,31397,185
51601,164,3614,727,2939,44708,675
7487,13,209,1486,140,7390,69
53979,99,1297,654,1049,29385,248
51808,436,7777,721,6673,58328,1104
56131,179,1634,586,1312,12291,322
50135,35,381,766,282,7679,99
52946,23,588,683,480,18207,108
63735,26,218,348,175,12438,43
50615,132,2052,754,1640,37009,412
20023,86,2275,1329,1604,24154,671
32774,0,69,1088,43,3695,26
9643,17,691,1472,472,25045,219
54004,35,543,653,461,8409,82
18694,4,219,1352,198,8499,21
15936,7,159,1400,89,6014,70
69010,1,11,186,9,1847,2
49297,57,1741,788,1338,7168,403
4854,85,3340,1519,2289,63005,1051
62388,8,345,384,181,7955,164
30585,47,2215,1124,1409,17235,806
16378,622,10410,1393,7601,62405,2809
57502,46,647,549,519,6814,128
1094,459,20784,1556,11422,120482,9362
59635,15,119,479,107,4310,12
32828,908,18006,1083,13446,175487,4560
51995,5,75,716,66,3636,9
61556,10,184,411,162,3708,22
51120,6,91,740,84,12014,7
23633,153,3865,1269,2786,72710,1079
39221,46,1411,940,1024,17376,387
50865,23,517,748,388,8300,129
36417,281,4656,1005,3523,41792,1133
807,23,613,1558,487,31791,126
14979,11,533,1414,348,15613,185
57362,16,233,552,170,6251,63
13073,97,4383,1440,2554,29466,1829
34791,24,702,1047,464,5278,238
58136,129,1895,529,1493,26213,402
35284,241,2761,1035,2277,41052,484
15562,7,503,1406,400,37367,103
1335,60,1392,1554,977,19364,415
46420,9,66,842,55,4605,11
3001,88,5786,1540,3629,49082,2157
933,208,8897,1557,6593,31073,2304
20425,16,279,1322,242,11100,37
57284,42,627,554,548,11730,79
15974,752,17434,1399,12285,133811,5149
51806,21,198,721,173,6857,25
4257,80,2969,1527,2102,45554,867
2095,123,5213,1548,3534,88844,1679
16986,73,2099,1383,1173,19563,926
445,62,1942,1561,1409,27580,533
24899,5,279,1241,207,7419,72
10793,13,494,1464,306,11947,188
19572,10,355,1337,241,9248,114
4247,80,2296,1527,1415,31023,881
70377,13,129,141,113,3034,16
50274,244,4070,762,3307,21031,763
24796,2,125,1244,79,5797,46
18436,12819,391935,1357,235565,1561161,156370
30531,4,127,1124,74,5694,53
67324,50,472,242,376,8324,96
25742,19,541,1223,330,15596,211
34470,41,936,1055,626,11281,310
59188,22,383,495,259,4371,124
63867,96,909,344,752,20073,157
3680,18,794,1534,562,23387,232
57420,18,183,551,159,4078,24
64279,6,107,330,73,4767,34
605,37,2292,1559,1554,65406,738
39677,9,198,934,165,7112,33
21346,16,929,1305,613,38778,316
46429,30,1200,842,729,15733,471
55397,33,369,606,280,6976,89
3621,18951,689950,1534,398713,1700158,291237
26008,32,992,1217,657,17770,335
67772,11,327,228,269,6514,58
36324,36,842,1008,748,11346,94
3227,1277,32569,1538,21257,211063,11312
15289,8,602,1410,396,20818,206
11737,14,927,1456,467,19229,460
48708,36,369,806,280,7178,89
68479,26,374,204,331,4150,43
28146,45,860,1171,593,13846,267
23025,23,835,1279,602,15188,233
16625,262,2650,1389,1897,40375,753
51354,1033,18130,734,14670,133440,3460
14571,1,99,1419,66,10751,33
69584,457,5484,168,4856,46914,628
34232,63,1220,1060,892,24933,328
45966,21,247,847,199,13399,48
32669,1126,30764,1090,21935,279265,8829
60982,64,473,430,381,8797,92
21207,22,401,1308,298,6703,103
62455,12,196,382,146,4062,50
60075,177,2769,464,2330,19898,439
54208,373,4218,646,3587,59060,631
40460,38,936,922,725,10594,211
33186,19,696,1080,397,9622,299
1952,2377,87271,1549,53912,300335,33359
300,419,17055,1562,11971,99772,5084
52496,317,5879,699,4449,41510,1430
69896,42,446,157,401,3912,45
21981,36,903,1296,598,16936,305
62522,42,638,380,504,10781,134
29984,16,607,1136,463,4579,144
6003,25,422,1505,300,12277,122
18474,3041,88525,1356,50724,336166,37801
3349,81,1870,1537,1253,21981,617
64548,5,94,323,73,4323,21
7711,4,213,1483,101,6089,112
59193,27,276,494,217,3908,59
58981,56,647,501,476,13076,171
47967,31,398,823,284,8696,114
59405,343,6701,487,5476,45871,1225
55312,104,934,608,753,11704,181
25817,173,4186,1222,2534,26185,1652
57782,66,980,540,690,15243,290
18896,114,2647,1349,1744,23156,903
31492,31,501,1109,381,12419,120
60784,104,1196,437,948,14847,248
51888,30,380,719,313,4297,67
30663,554,10291,1122,7281,62571,3010
68887,10,123,190,89,3016,34
58057,3142,41319,531,32949,119066,8370
32949,2007,37480,1085,23783,114971,13697
8003,9007,282813,1480,155903,896349,126910
20731,19,715,1317,505,25516,210
28212,61,1656,1170,1088,13240,568
6656,233,5181,1497,3243,16834,1938
35724,7,185,1025,125,13940,60
5711,10569,364603,1508,225964,747076,138639
17622,1252,38437,1371,27700,143166,10737
7011,297,8052,1492,5859,41354,2193
32937,135,3530,1085,2359,30189,1171
40706,12917,261470,919,175765,680917,85705
30631,4355,86950,1123,63548,237485,23402
63743,158,2260,348,1919,16661,341
69077,21,376,184,334,6682,42
759,791,95899,1558,64510,574528,31389
9073,15,804,1474,514,22101,290
5152,1115,79437,1515,49953,400897,29484
4684,60,1799,1521,1287,23541,512
69825,30,246,159,214,2537,32
35449,31,469,1031,339,3923,130
30388,15,802,1127,474,11700,328
54824,6,87,623,67,3332,20
46586,11,242,840,213,9577,29
58333,1607,39829,522,29634,171149,10195
66006,27,189,284,148,3673,41
52790,444,5470,688,4465,39785,1005
53637,9,157,665,119,4185,38
4466,129,2944,1525,1949,54961,995
3486,56,1134,1536,752,23436,382
14660,149,2918,1418,2129,35261,789
17957,26,839,1365,703,21571,136
68346,1,112,210,34,2461,78
66508,106,1100,269,908,13107,192
4465,7,282,1525,211,15701,71
11433,92,3251,1459,1894,23238,1357
49786,20,363,775,287,8296,76
19288,0,0,1342,0,4880,0
830,514,11085,1558,7782,72366,3303
62534,147,2208,379,1946,29575,262
30082,25,966,1133,673,18051,293
4256,24,2724,1527,2026,39600,698
1366,2,290,1554,196,11934,94
27633,57,1573,1181,1029,17501,544
893,13,592,1557,370,7589,222
55326,32,412,608,294,5876,118
26571,38,744,1205,466,16997,278
48073,20,257,821,210,10575,47
28007,8,442,1173,263,9991,179
22426,73,4529,1290,3682,34056,847
27938,7,193,1175,109,3162,84
21181,840,17682,1308,12540,176838,5142
37347,11535,196242,982,137005,635798,59237
1970,9,413,1549,282,15148,131
20217,601,11904,1325,8316,90571,3588
4581,1267,43849,1523,29421,129622,14428
11486,644,35208,1459,19020,217589,16188
19025,9,176,1346,129,12946,47
10195,21,925,1468,604,38706,321
6986,101,2235,1493,1634,15731,601
53710,19,211,662,176,6209,35
33368,1001,17547,1077,12700,145242,4847
53354,47,406,672,363,16542,43
61058,655,10821,427,8824,61543,1997
26275,63,2054,1212,1178,25961,876
3299,5,253,1537,174,6352,79
25116,38,861,1237,501,9364,360
14226,75,3266,1424,2250,53344,1016
68005,584,8027,220,6181,45833,1846
34721,76,1385,1048,956,14341,429
27565,79,3357,1183,2078,42507,1279
24611,8,218,1248,145,10026,73
32560,4,39,1092,36,3673,3
31994,36,345,1101,238,9572,107
63422,47,646,357,510,21524,136
56872,1,38,564,38,4126,0
2676,4414,181713,1543,120033,1087066,61680
67937,4,33,222,31,3619,2
11781,1400,113488,1456,53205,294486,60283
10651,115,4152,1465,2921,52404,1231
25464,50,899,1230,845,12768,54
34733,303,5319,1048,3751,29465,1568
63402,12,171,357,124,4242,47
64149,48,606,335,441,13722,165
47227,51,877,831,723,29309,154
5133,110,4293,1515,2792,40337,1501
28879,2762,77543,1157,46286,275643,31257
37285,43,723,983,580,18076,143
32265,122,3252,1096,2770,57935,482
12557,80,1970,1447,1058,19347,912
42332,1776,42758,893,35778,230647,6980
17055,10,150,1382,120,8778,30
52389,45,911,703,697,13544,214
42630,32,888,887,663,11457,225
33285,56,1398,1078,928,7724,470
49083,70,1874,794,1441,18147,433
27057,135,4834,1194,3695,50680,1139
13902,16,382,1429,220,6829,162
37509,10,344,977,241,4265,103
12444,1,130,1449,74,5221,56
25363,2,37,1231,28,2682,9
27689,9,321,1180,184,10312,137
63245,38,395,361,302,4504,93
42706,52,830,886,662,25964,168
53204,21,508,675,390,22236,118
68472,12,224,205,189,4205,35
55545,10,157,602,139,7905,18
22460,4,345,1289,256,14302,89
65145,8,120,305,96,7491,24
66460,10,140,271,86,10082,54
22943,18,661,1280,457,8746,204
54670,161,2832,628,2188,18195,644
18897,176,5225,1349,4506,60908,719
12878,52,2195,1443,1271,19080,924
2982,46,1634,1540,1093,25932,541
32031,110,3456,1100,2767,29503,689
3238,32,800,1538,477,8577,323
63680,446,7295,350,5693,95189,1602
58251,14,109,525,99,10420,10
4026,23,1283,1530,891,17653,392
48732,8,240,806,175,7435,65
36793,66,2558,998,1863,12652,695
14503,268,8013,1420,5341,122444,2672
40803,118,1894,917,1640,15087,254
58821,19,289,506,212,8335,77
31814,38,346,1103,265,5536,81
9756,8,504,1471,338,6081,166
53633,29,360,665,271,4797,89
18018,55,1313,1364,955,18782,358
20473,531,6771,1321,5380,94698,1391
41579,486,4460,905,3004,19343,1456
18310,694,20684,1359,14509,176392,6175
24209,57,1762,1257,1125,15140,637
22349,23,738,1291,579,32743,159
66744,277,3607,261,3068,26085,539
9309,15,547,1473,367,8827,180
6586,7,274,1497,166,3773,108
40884,1,28,916,20,5397,8
21972,61,1956,1296,974,18492,982
9944,10,600,1470,394,11754,206
5306,63,2881,1513,2081,12621,800
50180,36,394,765,317,8465,77
18657,550,16224,1353,10012,66665,6212
18164,18,391,1362,304,8062,87
11840,1,249,1455,125,5337,124
56745,103,1605,568,1118,15898,487
48584,18,255,810,188,10098,67
8971,231,11294,1475,6977,66149,4317
16660,911,27236,1389,17892,180105,9344
5894,3,293,1507,186,9907,107
34321,2532,50150,1058,31759,275233,18391
30760,446,13430,1120,9737,190508,3693
18507,33,1198,1355,971,18151,227
66448,0,23,271,15,3706,8
12316,111,1876,1450,1112,12980,764
23061,188,3086,1278,2104,64500,982
46495,1794,50995,841,36012,127382,14983
21337,177,5185,1305,3773,32736,1412
38633,239,3060,948,2452,34350,608
34070,35,605,1063,397,10841,208
38323,50,481,956,359,8053,122
29153,15,1168,1151,675,17218,493
29707,1982,67156,1142,42513,313621,24643
1618,1721,41471,1552,29205,102653,12266
1422,23,982,1553,683,16138,299
51243,6,50,737,40,3229,10
56659,86,974,571,797,10796,177
53526,6,57,668,49,5271,8
67970,36,426,221,333,4655,93
32776,23,521,1088,363,16395,158
46561,59,1086,840,880,19040,206
2259,5,268,1547,198,13091,70
17981,811,10918,1364,7980,87840,2938
25609,27,888,1227,498,13162,390
64091,0,19,337,15,1704,4
61579,48,1309,410,1017,6840,292
819,51,2645,1558,1760,30106,885
4459,48,1684,1525,1175,19791,509
59346,9,132,489,113,3916,19
25146,548,14292,1236,11824,63076,2468
20894,22,421,1314,289,18751,132
53295,42,731,674,512,7508,219
61034,118,2649,428,1916,23842,733
23878,202,3286,1264,2681,42323,605
22779,22,1113,1283,711,15802,402
4031,166,3431,1530,2217,41566,1214
67753,9,90,228,71,12841,19
69240,540,8570,178,7531,85028,1039
50264,31,507,763,413,8841,94
66411,788,15228,272,12642,60664,2586
40448,7,228,922,181,7414,47
13851,54,1640,1429,975,30273,665
57050,1218,19446,560,16515,122939,2931
10377,115,3856,1467,2535,38586,1321
18866,8623,243014,1349,168397,1034200,74617
30713,350,8531,1121,5836,54724,2695
26099,51,2027,1215,1195,19823,832
20308,132,1825,1324,1097,11775,728
70033,1,42,152,41,1245,1
2761,359,7657,1543,5441,57252,2216
37835,2,33,969,28,8613,5
48554,4936,88609,810,58561,723718,30048
62728,290,6913,374,5257,48210,1656
16193,204,8703,1396,5887,91508,2816
33009,4,163,1083,99,4827,64
32598,5929,129562,1091,95235,531672,34327
48534,9,184,812,153,7989,31
15123,17644,578678,1412,391827,2136239,186851
28133,110,1922,1171,1287,36629,635
34813,68,1943,1046,1474,25394,469
70210,0,2,147,2,1306,0
8707,592,28920,1476,15864,118281,13056
62512,20,531,380,479,7676,52
33249,808,13858,1079,9599,60420,4259
50556,81,804,755,678,16968,126
10906,83501,2871679,1463,1637748,6225691,1233931
31833,83,2546,1103,1571,21728,975
6482,18,383,1499,254,8690,129
14772,5,185,1417,143,5696,42
67308,11,113,242,66,4347,47
36761,788,13823,999,11222,89474,2601
57463,51,754,550,534,20813,220
64167,30,186,334,151,4952,35
32646,26,789,1090,551,11200,238
53573,60,1111,667,818,15456,293
49316,13,172,787,148,6214,24
5026,18,834,1516,565,20878,269
8902,24,1222,1475,792,11694,430
9977,94,1530,1470,1029,12925,501
69987,5,48,155,40,3996,8
10761,62,1021,1464,613,15572,408
62404,11,106,383,82,3136,24
63583,2230,13266,353,10612,258928,2654
5131,47,2673,1515,1775,15606,898
35380,40,585,1032,419,8754,166
35941,154,2770,1019,1742,45032,1028
29763,557,14281,1140,9230,135811,5051
35236,90,1289,1036,884,12879,405
55021,2,30,617,24,1554,6
28507,540,10178,1164,6936,48309,3242
4190,124,2881,1528,2063,23788,818
26456,154,2578,1208,2170,35593,408
10889,49,750,1463,512,10577,238
48590,12,169,809,134,6320,35
66498,13,285,269,203,5016,82
30473,2915,72064,1125,50697,214098,21367
53308,45,696,673,561,7177,135
1691,1,116,1551,66,14766,50
3731,18,1026,1533,666,48554,360
64099,41,264,336,205,3682,59
34850,58,1067,1046,747,21804,320
29980,6,775,1136,387,8826,388
114,2269,127825,1565,81373,805162,46452
12415,11,617,1449,322,11467,295
30930,474,6759,1117,4601,34467,2158
32389,160,2684,1094,1791,21670,893
36100,243,5124,1015,3874,49964,1250
8592,27,1403,1477,866,24074,537
15888,12,512,1401,357,17398,155
66626,24,140,265,124,5071,16
30492,15,298,1125,195,13054,103
4843,8,301,1519,201,8804,100
26578,40,1275,1205,823,14776,452
63044,56,1094,366,824,11512,270
22162,17,327,1293,249,5879,78
48516,13,419,813,303,7827,116
38926,1,80,943,54,4571,26
51594,128,1903,727,1523,23351,380
36267,5,45,1010,36,3472,9
9930,12528,440932,1470,233627,892844,207305
12838,36,2517,1444,1337,26395,1180
42310,3412,42816,893,33737,198084,9079
5344,9,345,1513,251,13270,94
48940,85,1141,799,951,13553,190
49547,1541,38751,781,27374,268566,11377
69132,0,15,182,13,2223,2
30086,1215,17191,1133,11213,69151,5978
21295,178,4607,1306,3053,28232,1554
19218,41,1631,1343,1156,25220,475
1681,63,1725,1551,1204,25435,521
41036,177,1497,913,1177,30196,320
69857,73,1134,158,1108,11315,26
15463,26,699,1407,468,42292,231
52030,37,420,715,370,11174,50
37379,993,14300,981,11014,110749,3286
57968,213,4723,534,3850,28836,873
31215,48,1452,1112,938,17061,514
8979,570,11739,1475,7893,45445,3846
52536,404,5505,697,4570,42995,935
14319,419,7904,1422,5287,47339,2617
45212,426,7106,856,5805,38133,1301
54412,1272,13579,638,11312,128757,2267
41468,22,572,907,451,14397,121
6411,2262,41055,1500,28082,191080,12973
18405,3,135,1357,92,3162,43
18703,20,505,1352,410,15065,95
54514,31,315,635,262,8664,53
69979,4,123,155,95,3048,28
7301,17,566,1488,362,15969,204
35476,50,1354,1030,967,10916,387
25175,13,118,1236,89,3377,29
54911,3,19,620,12,2376,7
18809,20,865,1350,602,9235,263
11596,4,416,1458,207,6248,209
25884,196,4350,1221,2989,30219,1361
24882,22,734,1241,524,17049,210
34711,203,4255,1048,2948,37962,1307
100,4462,161546,1565,101018,443670,60528
26067,6,303,1216,198,10453,105
68091,157,2632,216,1671,35536,961
60493,433,6718,448,5636,48939,1082
12977,52477,1312796,1442,971612,3048522,341184
17081,25,516,1381,408,13672,108
8520,1462,26773,1477,15104,64377,11669
26777,405,8960,1201,6059,90365,2901
24738,45,1632,1245,1104,19660,528
62878,49,400,371,297,3224,103
27586,14,396,1182,245,16640,151
59023,25,199,500,154,4670,45
17274,3,152,1378,108,15606,44
15546,93,2923,1406,2147,57517,776
51504,32,177,730,160,5324,17
30391,41,1161,1127,729,15214,432
66702,30,341,263,263,3584,78
10143,1375,54518,1469,32921,134027,21597
43020,37,619,881,486,14015,133
68676,7,115,196,99,3500,16
65325,311,3654,301,3050,31397,604
66699,22,525,263,464,6290,61
38019,11,541,964,452,12637,89
58219,62,575,526,432,11020,143
21269,553,22489,1307,13750,123705,8739
33090,44,661,1082,563,10056,98
38460,51,2088,952,1594,14279,494
33207,23,498,1080,345,7997,153
23469,52,1303,1272,886,26254,417
8483,41,1217,1477,789,11895,428
38066,1085,19618,963,14675,105769,4943
9521,541,17655,1472,10839,71718,6816
29819,12,708,1139,454,26659,254
64126,726,27263,335,21640,94844,5623
8821,4,280,1475,180,9031,100
62539,7,119,379,98,6978,21
64505,20,483,324,374,3633,109
8738,5,179,1476,118,6990,61
66185,685,8269,278,6035,26344,2234
67461,156,3306,238,2592,32674,714
23015,16,799,1279,567,24947,232
30923,54,1333,1108,905,12485,428
17187,26,714,1379,548,10002,166
35824,2,45,1022,38,1384,7
30066,20,481,1134,291,9600,190
57979,1050,21391,534,17470,85027,3921
49268,12,252,789,197,5168,55
32943,208,3501,1085,2433,28319,1068
24197,42,1468,1257,986,16853,482
24163,10,519,1258,351,18423,168
68144,296,6093,216,4362,55022,1731
182,141,3761,1564,2737,42450,1024
150,64,2746,1564,1557,70401,1189
68065,58,667,218,512,6226,155
24473,53,1046,1251,692,32576,354
9751,72,6163,1471,3932,47728,2231
24828,5718,234758,1243,178793,1092678,55965
61714,50,473,406,406,8954,67
37634,2,95,974,78,27551,17
4316,73,1642,1526,1263,15728,379
63641,133,2575,350,2130,27925,445
5532,2,52,1510,29,4767,23
17481,11,122,1374,95,6760,27
14693,992,18284,1418,13204,122167,5080
1913,47,1398,1550,963,25004,435
29031,607,14776,1154,9637,143763,5139
46284,293,4844,844,3770,89216,1074
42302,125,1806,893,1338,27715,468
32625,38,1400,1089,783,9783,617
10419,93,4758,1467,2974,34360,1784
25859,70195,1420388,1221,1039693,4178555,380695
5119,84,3368,1515,2223,38250,1145
54343,98,1231,641,1079,17477,152
67089,2,45,250,37,2659,8
49426,0,18,784,13,2241,5
33237,37,1019,1079,596,9399,423
63546,1,17,354,12,1733,5
11514,7,749,1458,438,20736,311
33134,195,9461,1081,6439,70535,3022
23677,113,2783,1268,1892,22418,891
19981,48,1014,1329,705,44239,309
19616,404,8473,1336,5541,65782,2932
10720,25,438,1465,310,19610,128
60835,524,7749,435,6012,45338,1737
21607,148,4492,1301,3089,19554,1403
21249,17,1360,1307,933,29577,427
33863,27,691,1067,399,14211,292
28517,80,2100,1164,1706,13462,394
8070,713,23047,1479,14035,77016,9012
16832,50,1130,1386,756,27824,374
19387,30,717,1340,543,20718,174
883,141,3625,1557,2551,52349,1074
58783,9,131,507,87,8231,44
42726,254,3893,883,3149,50264,744
35742,22,462,1025,364,24140,98
10495,52,1385,1466,882,8510,503
34764,866,36987,1047,26545,186906,10442
19298,43,1166,1341,774,20902,392
34473,194,3627,1055,2508,28838,1119
14378,49,2674,1421,1798,41221,876
11045,290,25077,1462,13137,78810,11940
39671,603,4970,934,3834,32271,1136
11141,72,1806,1461,1165,19560,641
59459,20,289,485,215,6330,74
68781,7,136,194,112,4624,24
62071,257,4543,394,3820,35131,723
37412,40,645,977,467,23445,178
10839,10,545,1464,296,14361,249
64771,115,963,317,727,5072,236
61245,4,22,177,19,1525,3
3894,340,12921,1531,6797,42248,6124
36227,16,246,1012,211,11937,35
49250,0,42,789,31,2499,11
60591,6,76,445,62,1817,14
63652,0,17,351,13,1996,4
5231,1108,24169,1514,15673,73751,8496
37312,18,458,983,349,9187,109
34206,62,868,1060,614,18363,254
7431,84,2492,1487,1843,26305,649
9504,9063,321445,1472,192880,650651,128565
5689,4,309,1509,208,25489,101
6808,545,13251,1495,8942,44244,4309
29098,41,2024,1153,1308,47842,716
10540,520,10397,1466,7070,69874,3327
20135,5,286,1327,231,15438,55
61130,18,155,424,115,3696,40
42894,346,8761,883,7283,52177,1478
48623,53,562,809,493,9306,69
16597,19,403,1390,305,14779,98
28516,56,2311,1164,1602,49636,709
51684,0,21,725,16,2819,5
34751,52,1449,1048,971,6255,478
58568,231,2050,514,1698,18520,352
24542,35,1638,1249,1155,18292,483
20305,2084,64231,1324,44334,445765,19897
18987,67,1609,1347,1121,17953,488
37531,65,668,977,546,14137,122
28546,25,523,1164,328,9070,195
30562,117,3646,1124,2386,65231,1260
28120,10,700,1172,416,9801,284
1661,433,11416,1552,7806,53227,3610
35618,205,3733,1024,2865,35283,868
15563,14,655,1406,480,22445,175
36440,48,1100,1005,837,10262,263
25948,7,98,1219,93,9092,5
63471,89,748,354,638,18426,110
174,129,8303,1564,6171,47465,2132
35079,1697,27194,1040,18896,191271,8298
33038,271,4214,1083,3101,28102,1113
30281,14,314,1130,214,6815,100
35339,11287,218181,1033,172232,876960,45949
68420,20,419,207,350,7887,69
31748,51,988,1104,787,20069,201
57682,28,289,544,204,3246,85
54586,618,7115,629,5820,104054,1295
48961,74,578,798,464,7720,114
44712,25,218,861,176,6942,42
26233,66,1290,1213,808,17590,482
47343,15,213,830,161,6531,52
51941,68,968,718,776,13720,192
31803,280,5938,1103,4119,54597,1819
22520,23,882,1288,624,10173,258
56047,137,1579,588,1123,17794,456
48107,616,10830,820,8120,97688,2710
20113,88,2828,1327,1868,22771,960
25560,2,62,1228,51,5201,11
17551,36,1588,1373,888,10559,700
68685,10,176,197,155,4684,21
67528,42,511,235,414,3964,97
12733,11,1061,1445,525,12307,536
27536,383,9487,1184,6222,116892,3265
561,40,1236,1560,879,17489,357
31425,36,803,1109,544,13433,259
56723,12,223,569,166,7634,57
59421,13,147,486,103,7931,44
53670,138,1704,664,1341,22059,363
19598,49,1395,1336,980,28038,415
58328,152,1986,522,1476,13838,510
30893,22,948,1118,608,11748,340
15801,622,19212,1402,11308,87470,7904
49860,504,6101,773,4733,39522,1368
8969,104,2225,1475,1599,21288,626
18643,38,985,1353,738,24070,247
13314,107,1301,1437,827,16487,474
15261,152,7410,1411,5135,115313,2275
547,1464,36275,1560,21388,87743,14887
17447,22,308,1375,242,17769,66
9722,39,810,1471,518,6191,292
51751,69,862,723,713,13001,149
65448,19,223,298,208,4816,15
44949,45,1517,858,927,19843,590
26486,2503,58545,1208,39239,298253,19306
26495,15,724,1207,440,12714,284
40923,24,694,915,495,6458,199
38350,69,854,956,673,16813,181
55900,745,17086,593,13308,95692,3778
37121,7592,142055,988,110838,565871,31217
10955,178,6827,1463,3979,48005,2848
2578,20,1470,1544,931,27710,539
65475,2,69,298,48,2253,21
16317,9,246,1394,149,16240,97
33126,53,1237,1081,888,17532,349
59385,33,486,487,381,15784,105
37297,36,370,983,281,10007,89
49257,30,899,789,707,6643,192
5425,51,3023,1512,1873,63301,1150
16487,35,739,1391,540,7857,199
33651,5,171,1069,106,4599,65
13675,194,10454,1432,6656,58641,3798
8518,17,239,1477,184,12030,55
36969,263,1779,993,1351,24159,428
35155,1330,49903,1038,35391,146912,14512
12455,101,2382,1449,1438,31290,944
11484,37,1741,1459,1117,19629,624
37049,35,921,991,768,37780,153
28022,3205,131012,1173,86374,376178,44638
57687,10,119,543,91,4641,28
51929,127,1926,718,1748,17443,178
13476,31,1721,1435,901,14315,820
5535,7,217,1510,164,5970,53
49421,1298,25086,655,18274,88739,6812
56214,34,475,584,374,5839,101
5914,8,253,1506,182,19001,71
59021,7,75,500,56,4315,19
20436,854,11214,1322,7827,94111,3387
20847,19,880,1315,650,13847,230
26337,36,1165,1211,970,28861,195
51567,52,679,728,587,17235,92
3048,134,5828,1540,4193,49271,1635
59393,55,714,487,604,11569,110
21082,1689,36680,1310,22708,121336,13972
68732,2,73,196,51,3102,22
12508,32,863,1448,553,26814,310
31586,12,612,1107,423,10118,189
55489,223,2909,603,2111,19455,798
65069,3,21,306,19,4528,2
25503,620,16818,1229,11880,54330,4938
37363,3,108,981,80,4729,28
14934,400,29759,1415,12988,124757,16771
66022,85,836,284,691,10642,145
6314,5,347,1501,260,22668,87
25725,34,1171,1224,738,8064,433
26627,4,202,1203,113,4925,89
57160,1180,16172,557,12284,91938,3888
47845,96,1710,824,1247,13199,463
7159,612,18749,1490,10856,151050,7893
572,45,1765,1560,1307,22956,458
64803,27,401,316,325,4649,76
16914,26,505,1384,371,13081,134
30602,484,3509,1123,2462,27170,1047
15756,38,1413,1403,969,17573,444
41101,163,2444,912,2045,49364,399
14866,9,177,1416,115,9136,62
16170,78,2819,1396,1919,43480,900
28038,1,284,1173,216,12741,68
16508,17,532,1391,363,9617,169
60659,22,367,442,248,11023,119
21273,9,481,1306,303,7512,178
70281,15,123,145,109,4837,14
35253,1101,19915,1036,15210,151706,4705
19904,663,28849,1331,18376,234423,10473
59742,184,1538,475,1172,16571,366
37371,34,404,981,300,10175,104
18219,87,3003,1360,2243,87280,760
53951,5,49,655,34,3229,15
4959,8,263,1517,185,14477,78
41030,8,184,913,146,20967,38
41237,26,461,910,405,10459,56
21965,76,2429,1296,1594,25719,835
54563,65,1684,633,1220,9718,464
21147,5,334,1309,233,6945,101
25286,28,678,1233,471,11002,207
42847,48,629,883,496,9404,133
49227,17,409,790,251,9963,158
25501,11366,432113,1229,264294,952335,167819
18292,21,818,1359,593,21746,225
1546,8985,255832,1552,142265,541442,113567
58430,28,307,519,231,11670,76
41009,379,4502,913,3638,46188,864
14636,27,403,1418,294,13317,109
14363,165,2381,1422,1703,28910,678
34637,503,8413,1051,6795,124802,1618
27440,22,565,1186,384,4906,181
40341,34,712,924,537,30311,175
24862,50,602,1242,463,7962,139
4858,46,823,1519,573,9665,250
15153,103,4661,1412,3336,36628,1325
19543,4,79,1337,61,12799,18
68696,15,219,186,201,13316,18
55479,70,932,604,744,24656,188
28826,24,443,1158,389,18888,54
242,1449,43967,1563,28282,148182,15685
54299,53,724,643,609,15720,115
2438,18,908,1545,664,16341,244
39392,634,12856,938,9614,63849,3242
69509,35,519,170,477,10508,42
58034,13,188,532,166,5833,22
57390,12,177,551,126,4158,51
66917,59,825,255,607,7005,218
25445,30,424,1230,275,4919,149
37823,22,912,969,738,18318,174
36820,10,333,997,232,17678,101
56179,369,9863,584,6840,125443,3023
10704,0,299,1465,155,13750,144
61208,48,547,421,453,12136,94
56025,5,60,589,47,4749,13
22896,4,299,1281,169,7622,130
6011,44,1791,1505,1215,57122,576
27759,259,5108,1179,3442,39403,1666
1702,14765,574004,1551,344560,1176289,229444
28061,222,5099,1173,3224,33136,1875
30633,107,1685,1123,1003,17383,682
22372,102,3961,1291,2619,32447,1342
37032,82,2543,991,1939,13254,604
61614,1132,21822,409,16835,110539,4987
30619,609,12691,1123,8822,111779,3869
30776,8,365,1120,199,8576,166
53169,372,3921,676,3148,32527,773
23809,8,185,1265,135,10173,50
13995,800,18838,1427,11947,150097,6891
60598,19,457,445,157,7664,300
52981,386,5121,682,4343,55135,778
23613,207,3588,1269,2407,79090,1181
10075,36,1409,1469,973,14279,436
31596,10,592,1107,357,10510,235
28767,5,277,1160,180,3587,97
32395,4,262,1095,148,4750,114
29199,15,469,1151,351,18508,118
41003,38,889,913,666,12055,223
65180,39,275,304,236,7086,39
66514,41,232,269,178,4973,54
19458,82,2698,1339,1901,22374,797
33717,104,2591,1070,1804,24424,787
15313,26,777,1410,563,14527,214
19393,11,352,1340,275,12463,77
65901,3,62,287,40,1571,22
30115,110,1777,1133,1131,10904,646
24377,244,7971,1253,5443,104924,2528
1376,304,17344,1554,12385,190321,4959
9474,36,1213,1473,760,10225,453
57394,186,1126,551,853,15199,273
37394,92,1849,980,1295,14140,554
35745,6,121,1025,85,3041,36
30536,255,5104,1124,3766,60727,1338
62948,78,1210,369,1054,20646,156
65602,1669,17552,295,13098,67790,4454
24712,31,1095,1245,776,13931,319
54681,148,1058,628,854,12012,204
35434,37,603,1031,431,12856,172
66376,13,272,273,193,3496,79
2701,209,5180,1543,3373,47034,1807
7416,13799,581595,1487,280793,1245118,300802
1760,410,15468,1551,11294,75136,4174
60939,7,181,431,45,2805,136
27233,8,177,1191,123,12316,54
65109,152,1547,306,1190,6800,357
34554,1,47,1053,30,3253,17
64934,191,2093,311,1608,12187,485
26326,1244,30457,1211,20377,175571,10080
8706,157,5232,1476,3430,92569,1802
61290,26,393,418,307,7707,86
65435,7,91,298,62,2791,29
49284,2,66,788,54,7338,12
13922,1593,56784,1428,39649,121046,17135
222,206,3038,1563,2003,28378,1035
3681,15,537,1534,364,30146,173
42392,424,5853,892,4527,28302,1326
59875,1679,30826,471,24051,111261,6775
4162,640,14989,1528,9948,67312,5041
58838,52,539,506,473,8383,66
65280,62,911,300,766,14019,145
69163,45,551,180,452,5493,99
51186,11,189,739,135,13892,54
1463,8,334,1553,230,18858,104
11316,307,7501,1460,5289,60193,2212
25048,56,1082,1238,733,23916,349
3656,54,3476,1534,2314,60842,1162
27288,579,11685,1189,7627,85836,4058
56787,4146,81353,567,53232,460157,28121
13241,1223,36075,1438,25795,196365,10280
60504,16,276,448,216,7633,60
24650,38,2252,1247,1628,34035,624
35762,1448,28283,1024,21142,96605,7141
50300,18,157,761,127,7021,30
46736,184,2687,838,2080,30038,607
35272,98,1407,1035,1140,19329,267
49956,53,1086,771,742,18239,344
55703,279,5087,598,4044,44393,1043
34710,52,930,1048,656,13406,274
3636,12,956,1534,646,22342,310
30570,59,874,1124,562,8278,312
68435,28,561,207,479,2731,82
27020,15,664,1195,372,9156,292
31239,424,11315,1112,7392,87780,3923
66708,51,757,262,583,11127,174
22765,14887,323623,1284,198646,754173,124977
55105,4,42,614,35,4372,7
17982,22,598,1364,467,15470,131
57905,80,1274,536,1065,17996,209
9618,151,5751,1472,3755,53028,1996
8939,495,8165,1475,5538,75684,2627
53141,88,840,677,704,15898,136
26910,39,1054,1197,832,29653,222
52301,46,789,705,651,12783,138
29695,394,11311,1142,6508,42304,4803
51003,149,1779,744,1341,12618,438
18302,14,1031,1359,843,66875,188
42418,18,213,891,171,11717,42
36349,22,294,1008,243,14821,51
51850,45,1033,720,767,14757,266
60649,219,3796,442,3310,41560,486
69313,95,1526,176,1277,7992,249
9361,24,1003,1473,690,17612,313
21419,319,6675,1304,4772,89543,1903
14831,0,31,1416,28,2600,3
27227,5,268,1191,149,4117,119
69513,122,1704,170,1470,18273,234
24822,16,393,1243,248,10217,145
54238,1,657,645,411,25252,246
5586,145,4187,1510,2827,37868,1360
30985,32,419,1116,381,68747,38
69079,14,171,184,156,2121,15
37782,318,3851,970,2863,34482,988
23614,738,21079,1269,15098,82309,5981
16360,8,357,1393,224,14050,133
37958,452,5652,965,4674,50807,978
48694,6,126,807,80,3003,46
38430,34,344,953,273,5559,71
66361,22,333,274,228,2314,105
34168,9,169,1061,108,15984,61
58165,1456,35995,528,26470,167026,9525
21422,237,4570,1304,3027,16909,1543
36533,4,231,1002,169,6765,62
13808,54,818,1430,438,12161,380
19522,85,2920,1338,2041,66323,879
23601,10,175,1270,134,6524,41
50877,180,2232,747,1852,23929,380
65414,60,839,299,572,10249,267
61650,33,603,408,436,7231,167
23205,157,2864,1276,1864,22721,1000
35920,1596,38658,1020,30610,182968,8048
36701,1935,24845,1000,19688,67012,5157
68411,18,454,205,376,13728,78
12488,268,12457,1448,7638,78534,4819
49122,2,134,794,95,5844,39
35445,36,456,1030,352,4314,104
23062,111,2191,1278,1460,33303,731
60236,43,677,458,541,11863,136
55016,43,496,617,357,12546,139
66014,7,141,284,55,1258,86
14919,14,350,1415,223,9775,127
10084,1731,93970,1469,57826,342888,36144
5228,20,432,1514,333,15100,99
16940,39,1953,1384,1446,17581,507
11063,41,1326,1462,855,11365,471
30753,137,3678,1120,2597,39309,1081
10446,3,90,1467,61,6973,29
5139,57,1448,1515,1011,33329,437
23110,117,4273,1278,3045,50328,1228
47374,14,341,830,247,11474,94
3869,21,458,1531,320,20751,138
28674,40,684,1161,462,15493,222
8406,16,723,1477,456,17185,267
15682,1,66,1404,41,7285,25
8519,3,148,1477,86,12796,62
70041,6,54,152,40,2193,14
11313,11,590,1460,311,8842,279
25193,101,2422,1235,1611,40838,811
17366,20,2055,1376,1397,24870,658
12825,2,123,1444,72,10006,51
60376,194,6423,453,3055,27712,3368
17579,21,564,1372,455,12323,109
60007,19,269,466,174,11692,95
34674,57,1443,1050,1009,18268,434
58098,17,186,530,145,4489,41
14667,4,218,1418,163,10540,55
30390,44,1023,1127,663,19660,360
9335,711,16732,1473,10185,45220,6547
22482,56,735,1289,531,12399,204
61249,2618,44434,416,33921,237764,10513
52156,3275,55206,711,42138,217569,13068
44398,3,42,865,33,3107,9
61896,54,1110,400,752,18842,358
28752,6,148,1160,88,2690,60
46877,7,79,835,67,4906,12
15739,9,267,1403,193,9410,74
48283,3680,74548,803,57040,471780,17508
62949,1,145,369,108,3005,37
63165,15,253,357,231,2340,22
19765,9,491,1333,359,10370,132
5267,75,3837,1513,2555,52285,1282
56315,3,37,580,34,2062,3
3347,245,5104,1537,3505,55944,1599
50826,13,174,749,149,5481,25
23390,52501,1117573,1273,680420,2113589,437153
9144,30,909,1474,598,20780,311
43127,696,14499,879,11436,176189,3063
65307,33,520,302,433,21435,87
32150,93,2869,1099,1971,15307,898
5873,319,7548,1507,4974,40799,2574
32543,108,2222,1077,1522,29791,700
27221,125,2826,1191,1881,69126,945
36748,5,113,999,83,1731,30
14308,12325,262158,1423,183799,977049,78359
9406,99,4986,1473,2813,46003,2173
21753,119,3545,1299,2014,40967,1531
10598,162,2791,1466,1852,25324,939
60588,19,172,445,137,2709,35
2749,29,1265,1543,883,21019,382
12917,2,167,1443,83,8404,84
23841,183,4441,1265,3346,58285,1095
67142,1,20,248,17,1603,3
3077,42,1866,1540,1300,18226,566
54068,358,3471,651,2680,24074,791
67802,11,202,226,145,3838,57
33140,4,37,1081,30,1893,7
602,10,657,1559,400,22537,257
35243,56,854,1036,663,15318,191
10418,0,1337,1467,869,10465,468
67460,43,627,238,579,6635,48
67374,8,86,240,69,3343,17
17874,13,529,1366,391,11410,138
60751,18,479,438,347,6819,132
48047,0,41,822,31,8182,10
24039,254,8284,1261,5860,70172,2424
36835,319,9349,997,7185,52778,2164
28620,21,842,1162,544,16641,298
645,25,634,1559,445,13225,189
12319,6,245,1450,135,6748,110
14398,460,18619,1421,12865,195484,5754
20153,11,604,1326,400,7978,204
21120,10742,381922,1309,265180,1175493,116742
14628,82,3608,1418,2595,53867,1013
56244,4,67,583,43,6504,24
6270,19,475,1502,345,13838,130
24307,828,25645,1255,16713,98084,8932
49405,1499,39767,785,26153,259353,13614
67712,3,29,230,25,3075,4
2076,45,2363,1548,1785,61540,578
32709,22,431,1089,333,9926,98
20101,36,1622,1327,1141,44031,481
11622,38,3188,1457,1781,30950,1407
49302,27,396,788,330,8782,66
1928,391,7237,1550,4934,36819,2303
47395,35,522,829,417,13391,105
36737,14,202,997,165,7567,37
27022,26148,712199,1195,450809,1586470,261390
42694,157,1480,886,1077,13644,403
5784,10,306,1508,188,6049,118
32739,287,8841,1089,6624,40004,2217
21826,188,5205,1298,3585,48533,1620
24507,9,172,1250,122,13848,50
69617,14,106,167,90,3214,16
54870,28,175,621,139,7137,36
36996,25,635,991,518,15569,117
18084,4,237,1363,162,3357,75
64104,7,142,336,109,4330,33
8554,16,992,1477,615,18170,377
6866,37,786,1494,526,30946,260
26932,24,224,1197,165,10885,59
15344,46,1306,1409,916,11613,390
23979,115,1702,1262,1337,23290,365
20462,3,69,1321,57,7229,12
13754,29,990,1431,581,18790,409
16570,11,140,1390,102,9678,38
13642,138,3408,1432,1906,46226,1502
8703,17,307,1476,193,5738,114
2929,1051,25433,1541,16088,159578,9345
54785,1713,18121,624,14856,129639,3265
25143,172,2392,1236,1533,14002,859
60953,27,501,431,368,8079,133
70287,13,73,144,62,3149,11
34700,232,5878,1049,4289,51298,1589
41308,397,5241,909,3918,18558,1323
19750,216,4458,1334,3160,43388,1298
58759,1978,44438,507,36122,193266,8316
66392,16,227,272,165,5953,62
56666,0,133,571,86,6168,47
59747,9,156,475,129,9406,27
24972,80,4242,1239,2242,19971,2000
17069,38,1267,1382,933,11337,334
764,2,124,1558,72,14562,52
417,45,2031,1561,1459,71699,572
8444,1598,80762,1477,50341,298539,30421
56226,11,81,583,63,2946,18
13869,0,0,1429,0,10989,0
62710,90,891,375,688,8959,203
24119,22,225,1259,171,4229,54
8076,6,325,1479,221,19728,104
57296,458,7843,553,5771,60314,2072
61953,28,203,398,152,3690,51
38572,703,10661,949,8293,71768,2368
18397,0,0,1357,0,20468,0
44818,439,6468,860,4990,74433,1478
26662,2677,39543,1202,24541,104181,15002
26380,48,1725,1209,1226,50735,499
47923,1,112,823,76,7609,36
36444,123,3990,1005,3164,45724,826
3286,34,949,1537,670,15668,279
58965,20,351,501,239,6640,112
3035,8,109,1540,83,6117,26
56423,8,141,578,114,4975,27
33051,102,2562,1083,1569,18775,993
68085,14,274,218,185,5562,89
35695,25,591,1026,449,19118,142
5279,25,1101,1513,711,19661,390
23007,29,435,1279,290,7454,145
39662,10,227,934,188,4955,39
68410,21,188,206,174,2572,14
24235,4704,154049,1257,117645,828083,36404
24354,89,2511,1254,1635,16637,876
55352,345,12640,607,6208,400709,6432
59367,52,1714,488,831,12178,883
69418,3,60,173,47,2628,13
14312,35,905,1423,669,30156,236
62788,6,67,373,54,2687,13
4739,13,558,1520,404,15639,154
482,431,10015,1561,4936,71362,5079
1340,22,950,1554,674,7907,276
54588,1,23,632,16,3352,7
53866,7,158,657,128,16542,30
9222,1438,45923,1474,31016,263413,14907
3468,40,1307,1536,899,14822,408
13426,26,2269,1435,1114,16758,1155
65937,36,562,286,452,6498,110
58883,0,755,504,530,11272,225
7775,5,163,1482,118,20369,45
23478,6,280,1272,184,7908,96
9331,931,29404,1473,18449,144269,10955
69289,551,10106,177,8367,68965,1739
26791,5,62,1200,51,15699,11
60389,1743,25284,452,20188,184284,5096
23411,10,240,1273,169,6709,71
823,1435,78782,1558,48215,304475,30567
46226,58,986,844,824,19595,162
60141,12,129,461,94,8045,35
55092,913,12986,615,10523,79065,2463
57631,13,71,545,57,5443,14
19568,1242,27242,1337,17209,192067,10033
3085,6,284,1540,198,12327,86
17665,11,341,1371,246,14379,95
21792,247,5047,1298,3428,32315,1619
53636,3,10,665,8,1546,2
35555,5,103,1028,80,6907,23
42496,36,525,890,379,10264,146
14652,49,1312,1418,988,16995,324
9533,1312,59321,1472,35933,191717,23388
3408,11,225,1536,139,7504,86
193,45224,1481098,1564,722039,2699078,759059
63365,1911,38837,358,29785,210394,9052
21400,45,1140,1304,795,39830,345
60232,95,1205,458,962,16054,243
12521,4,508,1448,229,7407,279
13957,32,727,1428,417,8604,310
31771,18,635,1104,443,12566,192
1014,120,4612,1556,3260,68152,1352
38785,1152,17075,945,14297,183745,2778
29275,316,7078,1149,4414,62140,2664
28135,105,2149,1171,1385,22493,764
66398,56,688,272,544,5318,144
10276,13,994,1468,581,15409,413
34380,36,782,1057,550,8650,232
34683,13,393,1049,274,13629,119
36551,17,517,1001,404,8228,113
40236,73,1531,926,1186,8754,345
68104,39,598,217,475,7543,123
50161,49,731,765,604,21309,127
56410,307,5327,578,4402,62439,925
8303,2608,56623,1478,38611,136783,18012
23276,13,205,1275,177,21355,28
62346,1839,17968,385,15100,95398,2868
56730,66,668,568,463,16653,205
64270,16,268,331,204,7099,64
29135,209,8009,1152,4513,26836,3496
49038,1836,27385,796,20439,125499,6946
11553,15,544,1458,285,10130,259
15707,445,14186,1404,9824,53321,4362
35852,74,1151,1022,930,32585,221
28904,131,3417,1157,2363,19079,1054
7649,668,21407,1484,13983,181613,7424
19895,29,1089,1331,845,15401,244
43997,4,176,869,133,24356,43
4863,767,31973,1519,21297,171022,10676
23303,27,595,1275,465,17951,130
17600,5,200,1372,133,6202,67
24154,330,26630,1258,16035,109019,10595
14715,1412,46892,1417,31652,458509,15240
21979,15,302,1296,194,23073,108
26202,20,447,1214,297,9429,150
64449,21,240,326,201,3259,39
69187,32,452,180,403,6763,49
69441,42,605,172,552,12510,53
56724,146,2900,569,2465,26279,435
15199,70,894,1411,618,14212,276
12510,207,4439,1448,3076,36806,1363
3171,57,1057,1539,726,9732,331
1642,1,167,1552,135,14720,32
11871,6152,361238,1455,185583,1254807,175655
65995,1,10,284,9,1307,1
67890,1,45,224,35,2019,10
20433,753,22934,1322,14907,147218,8027
62968,2,40,368,35,1876,5
2537,26,734,1545,545,26232,189
4865,126,3293,1519,2350,69084,943
18505,433,16876,1355,11144,161508,5732
51938,183,1897,716,1634,22588,263
58300,75,651,523,551,12857,100
31297,322,5945,1111,4119,105441,1826
21615,1226,24291,1301,15161,139988,9130
66777,8,140,260,104,4804,36
19513,14,502,1338,384,17493,118
35521,194,3905,1029,3054,87194,851
26978,116,3023,1196,1712,28352,1311
29915,2,176,1137,115,5957,61
21851,3,147,1298,99,4784,48
35740,5,239,1025,164,3496,75
29776,50,2421,1140,1681,54477,740
8621,6,281,1476,173,7738,108
59136,12,96,496,78,6657,18
30543,51,3844,1124,2399,36737,1445
17369,7,536,1376,367,14620,169
26019,393,9884,1217,6652,39320,3232
64768,12,117,317,81,2175,36
55018,8,171,616,95,4797,76
28443,104,3047,1166,1837,13329,1210
48585,5,59,810,44,3978,15
12281,1580,44100,1451,27164,208413,16936
3611,464,19921,1535,12200,107072,7721
64123,18,160,335,125,4294,35
56414,1,63,578,54,4055,9
64371,8,71,328,58,3869,13
4444,17,714,1525,417,9849,297
51580,464,8960,728,6990,40419,1970
61778,60,884,404,685,13765,199
31635,115,4464,1106,3183,38507,1281
3954,20,1057,1531,761,15019,296
50571,48,953,755,655,4317,298
15084,0,0,1413,0,6136,0
37240,45,1250,946,952,24043,298
16209,853,23857,1395,14647,184636,9210
62851,50,567,371,471,6904,96
32971,32,755,1084,518,6046,237
8096,10,112,1478,83,18072,29
55534,10,147,603,119,7379,28
4505,28,1216,1524,864,48654,352
47993,912,13656,822,10067,143184,3589
30794,74,920,1119,602,11224,318
46486,35,733,841,520,12173,213
43781,17,519,872,375,12667,144
10943,55,2528,1463,1387,53779,1141
9735,28,1354,1471,801,22134,553
30838,16,782,1118,408,9838,374
39048,98,1080,941,696,7559,384
48125,82,1146,821,982,11105,164
68241,0,399,213,343,1975,56
8306,21,1033,1478,595,11475,438
30655,192,3176,1122,1845,22618,1331
3189,5,368,1538,235,9756,133
23564,14,384,1270,284,19956,100
57355,790,14099,551,10907,69824,3192
57141,5756,146155,489,101720,591594,44435
35150,698,19816,1037,13526,115737,6290
651,6,132,1559,77,8044,55
20282,5,197,1324,132,6140,65
40571,69,1282,921,1011,12548,271
40588,411,21475,915,17065,112913,4410
49195,169,1945,791,1488,14079,457
52309,108,1380,705,1115,12808,265
52248,4471,269591,707,197589,997326,72002
33772,128,3670,1069,2499,64975,1171
53382,497,8440,671,7138,81466,1302
69974,0,76,155,59,5823,17
59704,101,1181,476,944,7311,237
35009,53,1609,1042,1169,13299,440
62518,5,218,379,193,5396,25
14819,16,642,1416,460,22817,182
8797,41,1188,1476,661,16219,527
64526,17,180,324,147,4365,33
69231,32,451,179,378,3839,73
2933,2504,152531,1541,87804,628026,64727
23959,319,11578,1263,7546,39581,4032
54717,62,1121,627,601,29587,520
54999,6,46,617,33,3922,13
45107,6,172,857,136,5422,36
40433,30,355,923,302,7253,53
8876,5,142,1475,91,5054,51
68245,4,60,213,34,3586,26
17785,243,7385,1368,4732,68476,2653
40811,9,110,917,87,4207,23
13737,205,3300,1431,2004,12900,1296
98,17086,469241,1565,244789,1074694,224452
16217,17,307,1395,229,11501,78
42564,1043,12963,889,10013,98725,2950
17706,66,3432,1370,1330,40316,2102
34843,137,3087,1046,2302,35754,785
36463,20,442,1004,338,7626,104
36474,3,94,1004,73,8472,21
62257,8,244,388,208,1672,36
14175,170,2909,1425,1714,37938,1195
40801,67,404,917,365,6532,39
55373,224,1781,607,1357,17809,424
60671,35,419,441,275,4479,144
35986,464,10364,1018,7868,51543,2496
68154,2,31,216,19,4347,12
63872,16,200,344,149,9273,51
56977,33,585,561,440,9293,145
34626,45,508,1049,414,7023,94
3588,27,1137,1535,759,27868,378
28238,36,1496,1169,995,21714,501
63933,130,2018,342,1671,19680,347
44273,30,328,866,238,7475,90
28467,20500,546532,1165,321939,1498324,224593
20827,67,3123,1315,2175,49025,948
16793,3,185,1386,125,7341,60
48543,97,2290,811,1578,37366,712
49030,9,172,796,150,4918,22
43773,32242,768481,872,550130,1771744,218351
11041,10,359,1462,223,7416,136
44792,209,4550,860,3876,26687,674
19903,136,1290,1331,891,10064,399
2940,32,910,1541,710,30399,200
23659,23,758,1268,552,28983,206
33907,87,2444,1066,1657,14009,787
21786,23,666,1298,425,17036,241
63874,2818,43309,319,34051,163969,9258
61688,44,473,407,392,14394,81
64321,35,987,330,685,11028,302
21959,93,1722,1296,1187,18443,535
36882,27,394,996,266,5038,128
53404,38,478,671,391,9815,87
69436,30,378,172,334,6501,44
9283,12,350,1474,235,12693,115
53071,1642,21414,679,14797,66107,6617
64136,54,594,335,432,6780,162
12951,62589,2284568,1442,1275131,6292971,1009437
62147,110,1445,390,1138,14206,307
12407,2,308,1449,145,6447,163
13557,58,1996,1433,1067,18513,929
30508,16,583,1125,361,7963,222
4082,204,5916,1529,4241,26514,1675
32079,33,802,1100,552,29332,250
48901,19,526,800,379,11140,147
60595,9,96,445,80,2454,16
28230,1,18,1169,12,2964,6
19078,14,266,1345,193,9300,73
35688,96,2985,1026,1962,28259,1023
24055,72,3211,1260,1857,21716,1354
60311,435,4999,455,3810,59872,1189
4367,43,1635,1526,950,17106,685
66357,6,154,274,116,2370,38
37127,158,2358,988,1876,15479,482
69140,30,486,181,425,5764,61
873,159,11997,1557,8035,105635,3962
27137,10,252,1193,170,11659,82
55759,53,1030,597,796,7917,234
11760,111,2663,1456,1506,28936,1157
32507,20,439,1092,297,7468,142
12534,1351,42427,1448,25895,259641,16532
31003,56,1409,1116,944,11769,465
65532,92,845,296,742,12045,103
48506,1,83,813,64,3538,19
54191,56,612,646,480,10976,132
57426,7,275,551,223,4796,52
15091,243,4301,1413,3365,47295,936
31555,111,4526,1108,2788,39258,1738
63451,144,1491,356,1155,8642,336
8081,5,215,1479,126,6061,89
52997,55,1056,682,821,7655,235
6025,16,1119,1505,692,30908,427
64585,30,434,322,340,5786,94
10239,145,4903,1468,3242,51504,1661
19166,24,782,1344,615,12288,167
6763,114,5170,1495,3490,87334,1680
25760,23,1446,1223,579,13625,867
66638,579,11793,265,8693,89822,3100
8438,12,355,1477,248,5921,107
11410,121,6591,1459,4325,40606,2266
58463,98,832,517,583,7728,249
51429,5,119,732,91,8903,28
69798,28,683,160,648,8697,35
39134,56,1711,940,1393,27565,318
28240,89,1039,1169,666,23031,373
31928,88,3270,1102,2279,29684,991
20341,148,5112,1323,3415,25390,1697
32200,37,384,1098,284,8558,100
19269,1583,31129,1342,20089,100934,11040
13130,564,20703,1439,12427,75805,8276
36132,1383,22981,1014,16507,93431,6474
15443,29,887,1408,573,7659,314
62873,10,154,371,112,7234,42
34620,671,11519,1050,8359,67655,3160
62342,5,18,385,16,3150,2
665,361,14682,1559,10415,77069,4267
66925,13,210,255,129,3782,81
32368,13,304,1095,201,5428,103
31225,92,2967,1112,1960,50027,1007
47383,79,2836,829,1996,37424,840
26781,12,199,1200,139,7955,60
3904,106,6635,1531,4489,91393,2146
18021,1623,23372,1364,17558,106113,5814
36983,10,187,992,146,7391,41
53945,138,1942,655,1419,12686,523
9597,221,6679,1472,4680,92845,1999
63716,23,222,349,171,4720,51
24166,3,96,1258,71,5816,25
63523,184,1764,354,1476,25956,288
53177,30,661,676,540,10362,121
18779,109,3012,1351,2234,25910,778
42732,2,80,885,65,10484,15
20178,6,221,1326,165,13249,56
60038,12,208,465,166,6211,42
4408,1308,46173,1525,31480,158002,14693
39790,1056,15150,932,10682,42073,4468
68528,92,1495,203,1246,16893,249
20992,114,4387,1312,3193,57123,1194
20357,1149,25257,1323,18004,93497,7253
6453,11,281,1499,190,36647,91
59491,272,3262,484,2574,32002,688
63067,56,978,366,783,10217,195
62587,21,249,378,185,13790,64
59910,3,295,469,232,9475,63
25027,126,3072,1238,2006,25544,1066
25628,1528,48347,1226,30382,242391,17965
42412,18,506,891,386,11032,120
14725,118,3190,1417,2027,64651,1163
33068,143,2366,1082,1641,10103,725
68912,179,4196,189,3618,22525,578
58489,4844,61703,516,47339,172697,14364
13575,24,1076,1433,728,13604,348
47723,58,666,825,569,11891,97
1408,212,4479,1553,2990,44706,1489
16374,11646,416028,1393,259566,1845877,156462
58894,2255,27539,504,22215,163847,5324
55076,564,11037,615,8833,66070,2204
30687,50,898,1122,788,16081,110
26479,18,1055,1208,932,16418,123
15488,30,1432,1407,1008,15391,424
66635,23,218,265,180,5606,38
58530,112,1434,515,1193,27243,241
52324,145,4107,705,3569,19732,538
5450,53,1912,1511,1441,19694,471
60089,5,37,463,30,2635,7
32393,4,266,1095,160,3111,106
36934,54,1097,994,851,17286,246
69978,8,152,155,128,2355,24
24120,35,523,1259,346,6612,177
37208,26,391,986,255,9844,136
23339,10,371,1274,274,12756,97
5405,231,5427,1512,3675,29189,1752
69659,77,1522,165,1403,16010,119
18399,14,198,1357,126,2684,72
35201,98,919,1037,686,7592,233
29556,3,95,1145,88,13392,7
13059,810,12481,1440,8166,90190,4315
38514,153,4375,951,3575,45157,800
70229,8,127,146,117,2584,10
18831,1,129,1350,96,6859,33
66732,7,114,261,94,4580,20
29010,29,877,1155,559,32208,318
64699,437,8632,319,6669,84834,1963
30138,106,4632,1132,3301,64073,1331
22648,317,7614,1286,5652,32939,1962
14056,22,906,1426,569,26301,337
28889,34,1755,1157,1119,20914,636
56694,31,247,570,201,5276,46
64989,4,36,309,28,1945,8
63272,16,165,361,137,3126,28
2420,260,10284,1545,6664,101011,3620
64814,14,134,315,121,2574,13
16548,3,60,1390,40,10276,20
34592,354,3875,1052,2786,28142,1089
66879,24,264,256,230,6429,34
54808,1136,12787,623,10481,106474,2306
66298,4,85,275,51,4332,34
69982,22,243,155,227,4127,16
11812,197,4867,1456,2632,42611,2235
6642,12,372,1497,258,20357,114
13876,151,4413,1429,2873,43907,1540
68711,7,103,196,90,4863,13
1894,40,820,1550,585,29028,235
48224,128,1889,819,1479,13182,410
9692,22,697,1471,473,24622,224
2381,9,251,1546,171,28947,80
10506,1489,47768,1466,30247,283271,17521
69669,26,219,165,190,2349,29
56442,31,553,577,408,11348,145
26642,907,33993,1203,22967,231004,11026
64998,17,244,308,203,7015,41
51478,5,119,731,97,6738,22
15438,3750,133584,1408,83875,578376,49709
33163,77,777,1081,716,7123,61
22486,403,9083,1289,5922,57846,3161
47532,215,5846,828,4927,51737,919
25460,33,1254,1230,814,10061,440
30240,37,1194,1130,872,13416,322
20582,3,190,1319,134,10121,56
23322,140,4486,1275,3134,37064,1352
49332,142,1609,787,1105,10765,504
20892,31,817,1314,580,29331,237
8298,2611,51993,1478,32362,108343,19631
8752,70,2963,1476,1811,39066,1152
70018,1,23,152,20,2775,3
24977,748,14636,1239,9811,81779,4825
20978,50,2407,1312,1609,13337,798
68704,6,73,196,59,2147,14
28070,79,1262,1173,879,18029,383
17072,236,4904,1381,3117,43317,1787
29665,78,1284,1143,826,20818,458
32791,134,2622,1088,1703,35642,919
70386,233,1987,141,1804,13428,183
50487,62,822,757,518,31687,304
37248,32,732,984,548,12410,184
15010,14,199,1414,136,6672,63
68439,89,1794,205,1365,30985,429
35175,66,979,1037,638,12987,341
54625,151,2634,630,2194,25685,440
246,1223,23900,1563,14135,160161,9765
56335,7,48,580,36,2622,12
42690,288,1798,886,1348,16695,450
10520,44,2122,1466,1318,22085,804
4580,41,1122,1523,779,12603,343
68250,9,75,213,68,2401,7
59226,209,5750,493,4851,43994,899
69990,2,19,155,19,883,0
68893,3,53,190,40,1681,13
29544,10,288,1145,168,6952,120
58608,23,240,513,191,5087,49
59379,25,424,487,327,10026,97
67773,48,522,228,424,7628,98
60384,124,1552,453,1282,20602,270
762,399,27844,1558,18079,238675,9765
26877,3,68,1198,62,7034,6
22224,52,2416,1292,1771,14619,645
29435,19,739,1147,435,7959,304
68842,18,185,192,155,3836,30
24806,239,8057,1243,6186,62973,1871
36332,211,2717,1008,2005,21490,712
21741,416,8419,1299,6259,47720,2160
69712,344,6826,164,5573,56866,1253
67624,5,37,232,32,2881,5
23252,9,343,1275,263,8770,80
29418,402,6255,1147,3727,26419,2528
54644,170,2463,629,1950,22618,513
59652,46,878,478,611,16116,267
55902,40,550,593,424,16420,126
33922,292,4338,1067,3528,27898,810
61179,16,127,422,101,4377,26
34275,12,428,1058,307,4237,121
61178,4185,113495,422,80102,518483,33393
35698,53,1232,1026,907,7691,325
14688,54,1145,1418,789,10075,356
53201,51,1329,676,1094,11571,235
17580,23,897,1372,689,35832,208
22107,32,815,1294,660,21535,155
3710,6,277,1533,177,22340,100
64072,22,324,337,239,4445,85
53656,43,795,664,500,12280,295
14434,2,190,1420,138,7258,52
50820,45,688,749,560,7386,128
57073,11,165,559,114,3386,51
13495,11,440,1434,265,5933,175
65268,16,114,302,93,4421,21
39082,3,263,941,185,7725,78
37266,382,8523,907,7050,59816,1473
2588,272,17250,1544,8649,129409,8601
65360,94,1260,300,1056,16274,204
62301,65,864,386,741,25933,123
3510,660,21231,1535,14654,54658,6577
15795,126,3644,1402,2512,24118,1132
59679,128,1804,477,1512,19851,292
52363,15886,234892,704,170473,833860,64419
33570,7,138,1073,115,7662,23
48362,29,527,817,412,18575,115
66698,16,218,263,181,8144,37
31497,7,336,1108,205,7958,131
1192,10642,348394,1555,205404,698961,142990
25012,200,7778,1238,5298,50324,2480
48832,2,41,802,35,2018,6
47489,44,841,828,584,9742,257
31656,13,368,1106,220,5649,148
67521,43,346,236,273,5259,73
49604,181,2142,780,1689,19325,453
10196,17,649,1468,442,11030,207
13798,1905,45855,1430,32976,159373,12879
30021,110,3484,1135,2650,34960,834
49057,45,761,795,631,12542,130
45721,139,1451,850,1111,16947,340
3721,948,26933,1533,19325,101914,7608
52909,771,10420,684,8401,44926,2019
54269,10,201,644,148,7274,53
25951,57,444,1219,308,10197,136
14457,1848,35791,1420,23560,128469,12231
14590,859,25845,1419,17752,131371,8093
7494,69,2276,1486,1537,32891,739
17865,1015,34348,1366,22512,135171,11836
45219,19,263,856,201,4406,62
4838,22,1076,1519,771,9369,305
38467,535,14407,952,11131,94729,3276
32746,4,128,1089,107,1572,21
5867,51,1217,1507,796,23457,421
25978,12,183,1218,130,7038,53
26576,374,6090,1205,4091,47492,1999
37623,303,5645,974,4850,51047,795
13612,11,348,1433,191,10767,157
63569,6,117,353,88,2953,29
7898,3,216,1480,139,15991,77
16150,58,1159,1396,791,15308,368
14441,206,4076,1420,3017,36456,1059
9078,265,6089,1474,3910,38585,2179
35111,19,419,1039,296,5457,123
7336,7,340,1488,207,13528,133
35239,22,312,1036,234,9547,78
53519,25,217,669,163,10429,54
57668,53,447,544,369,9418,78
8157,6166,181043,1478,109706,463712,71337
5994,21,866,1505,606,15432,260
5307,585,17782,1513,10744,87643,7038
18446,1,65,1356,55,4618,10
41320,148,2230,909,1836,14154,394
34923,18,563,1044,413,5678,150
37466,9,78,978,64,12455,14
13438,2,136,1435,73,6741,63
50540,173,1930,755,1443,20758,487
62272,44,560,387,473,7891,87
8263,84,1093,1478,714,7695,379
12292,40,1227,1451,677,26899,550
18916,33849,1250579,1348,731924,2059157,518655
52814,58,1419,687,875,13163,544
4963,18,1158,1517,706,19566,452
9742,61,2440,1471,1668,21949,772
55166,623,8489,613,6656,41396,1833
30164,13606,410475,1132,270719,873850,139756
31290,31,513,1111,314,4231,199
34615,2928,54187,1051,33593,321855,20594
552,61,2466,1560,1760,82683,706
18758,18,1714,1351,980,11929,734
22947,25,891,1280,676,15638,215
66639,19,322,265,282,6553,40
17408,3,112,1376,87,3589,25
9645,5062,112433,1472,78648,528169,33785
33179,548,18149,1080,13087,151436,5062
10821,20,1005,1464,649,14457,356
35868,37,522,1020,350,5693,172
38790,92,2720,945,2155,39302,565
14581,98,4871,1419,3180,85510,1691
6935,153,4125,1493,2666,70793,1459
18014,1282,66803,1364,43339,436246,23464
53226,930,9663,675,7714,74079,1949
3623,329,8564,1534,6021,53647,2543
32162,6,410,1098,216,7222,194
600,17,609,1560,438,49322,171
31272,110,3371,1111,2140,37942,1231
60243,673,9426,457,7595,74017,1831
55780,136,1605,596,1370,18851,235
36243,6,184,1011,122,17265,62
38013,35,618,964,497,5915,121
47904,9,184,823,142,11459,42
52617,38,411,694,312,12979,99
33318,67,2203,1078,1226,7648,977
581,148,7007,1560,4903,111657,2104
21457,833,34870,1303,23040,241984,11830
22540,66,1097,1288,892,12321,205
56785,871,11979,567,10023,82377,1956
4009,568,23248,1530,15245,64202,8003
433,18,332,1561,248,14261,84
28831,20,520,1158,303,7584,217
53340,100,855,672,683,10320,172
9548,1995,58717,1472,40810,247390,17907
60781,47,565,437,441,14660,124
69226,4,56,179,46,3796,10
30364,32,689,1128,425,4315,264
5432,453,15014,1512,10665,165529,4349
5266,206,4289,1513,2873,34315,1416
38776,145,2523,945,1835,62689,688
70532,15,172,134,167,4381,5
11519,167,2592,1458,1651,14699,941
57287,35,561,554,413,12680,148
47701,52,850,825,659,16985,191
8240,159,4360,1478,2798,31327,1562
53342,35,527,673,429,10277,98
28988,160,3183,1155,2186,49564,997
26438,20,668,1208,394,6682,274
20648,96,3305,1318,2279,39091,1026
2239,0,91,1547,64,11495,27
13491,501,21477,1434,14112,110506,7365
7680,14,562,1483,418,32023,144
68546,23,526,202,297,9247,229
28320,9,429,1168,285,9361,144
64370,7,133,328,99,3823,34
16966,316,9396,1383,7088,95997,2308
32964,84,3792,1084,2695,26845,1097
13753,76,3024,1431,1780,22283,1244
41120,14,215,912,169,4799,46
51667,0,471,725,421,10432,50
14535,4,50,1419,43,6888,7
63905,95,1083,343,833,10657,250
7055,6,233,1492,131,9419,102
57165,16,172,557,132,5604,40
32623,57,753,1091,519,12155,234
15006,8,440,1414,304,15628,136
9195,48,1427,1474,882,23209,545
27301,3091,83644,1189,52787,535184,30857
65232,10,121,303,108,2238,13
52169,22,402,710,300,9939,102
70482,10,253,138,221,2453,32
2176,579,50094,1547,32832,280325,17262
22063,32,1084,1295,709,45796,375
51102,19,247,741,180,3899,67
14218,51,2909,1424,2007,75995,902
12259,542,41357,1451,24976,240098,16381
37764,2139,26969,970,20174,112905,6795
4184,16,1149,1528,740,10759,409
65331,12,177,301,141,3838,36
60415,26,280,452,240,10296,40
26197,31,1425,1214,866,12669,559
25879,144,3692,1221,2561,17937,1131
22574,23,810,1287,552,11729,258
24941,7666,142949,1240,95320,687041,47629
49633,346,10766,779,8407,140628,2359
55491,11,181,604,139,4980,42
10848,52,922,1464,551,6124,371
49480,5,103,783,79,2844,24
70352,4,33,143,31,2501,2
24596,331,13234,1248,8029,77222,5205
16411,2717,106126,1392,71305,660723,34821
31241,1,61,1112,43,3023,18
35176,19,596,1037,413,20204,183
53888,1030,16390,656,13726,174755,2664
56113,132,1325,586,1018,14374,307
20432,13,386,1322,286,9520,100
17802,129804,6567355,1368,3350716,10540958,3216639
66126,850,10005,280,8541,60751,1464
13628,52,3372,1432,2137,38975,1235
25563,129,4307,1228,2726,22558,1581
19325,7,292,1341,218,11894,74
68332,33,602,210,508,9041,94
7036,16,567,1492,382,18786,185
64491,7,197,325,160,3032,37
22456,5,261,1289,203,11843,58
17939,5,243,1365,163,8139,80
49783,16,237,775,201,6163,36
18057,3,70,1363,55,3531,15
50306,62,701,762,567,7562,134
43365,440,8051,876,6308,107847,1743
9786,49,2878,1471,1810,37863,1068
62594,80,715,378,537,8889,178
63315,369,5548,359,4699,32177,849
18088,43,1546,1363,972,10410,574
22379,88,2627,1290,1811,37713,816
38179,55,851,960,677,10082,174
60783,160,5113,437,3937,42969,1176
70148,10,128,148,99,3443,29
6812,157,3653,1495,2355,19773,1298
37464,189,2518,978,2046,16503,472
5877,1077,23510,1507,15654,110382,7856
36703,113,737,1000,569,13120,168
54057,20,266,651,216,7079,50
17946,164,2990,1365,2273,38720,717
16723,34,731,1387,502,13546,229
57724,16,126,542,86,5090,40
27735,2,56,1180,41,13146,15
47327,12764,228483,830,177213,904967,51270
7310,11,367,1488,277,22844,90
707,19,1467,1559,899,39717,568
39403,12,127,938,99,6265,28
17869,3,127,1366,78,6669,49
11462,162,8632,1459,5764,51584,2868
33045,47,603,1083,398,4835,205
56049,1255,18485,588,15629,119872,2856
25145,47,587,1236,427,13478,160
13175,150,11449,1439,6371,66219,5078
2272,57,2715,1547,1820,39493,895
48991,298,3251,797,2616,37561,635
50614,199,2320,754,1952,46924,368
61534,27,325,412,240,6211,85
40993,17,525,913,414,11722,111
15189,21,450,1411,322,18193,128
17828,50,2059,1367,1551,32054,508
41782,22,628,901,479,22930,149
43837,256,3532,871,2564,15054,968
27837,5,107,1177,67,4966,40
47052,267,2749,834,2228,36787,521
12620,348,7417,1447,4692,36156,2725
68796,9,93,193,70,2023,23
64198,64,554,333,486,13387,68
28063,51,1525,1173,982,16585,543
25701,36,621,1224,527,11734,94
61275,3,60,419,53,2065,7
27316,317,7881,1189,5380,49106,2501
13156,56,1970,1439,1253,28289,717
31233,27,711,1112,622,17069,89
20211,1481,36552,1325,25813,209630,10739
63090,464,9558,365,7671,55206,1887
14811,148,5355,1416,3740,48579,1615
38728,1032,14932,946,12368,104047,2564
1761,227,8332,1551,4985,45847,3347
16828,121,2858,1386,1840,32175,1018
1354,65,2834,1554,1846,23219,988
61546,609,19030,411,14796,127370,4234
54353,9,23,641,20,3066,3
27494,51,2515,1185,1569,18029,946
37198,0,57,986,43,4217,14
7733,12,523,1482,350,20814,173
24902,11,482,1241,338,9307,144
11816,12,849,1456,278,11600,571
15652,0,0,1404,0,9359,0
5979,32,1190,1505,840,34662,350
34012,53,825,1065,652,7505,173
29725,35,1465,1141,1177,20217,288
20165,9,416,1326,339,25462,77
29238,145,3697,1150,2517,31023,1180
61919,27,430,399,327,6513,103
44614,25,368,863,287,5789,81
53799,42,411,660,313,7505,98
15364,0,0,1409,0,5258,0
40847,100,1405,916,1142,28996,263
26046,37,1388,1217,833,14055,555
55964,38,347,591,276,3583,71
51235,7,114,738,88,3749,26
678,73,1517,1559,1077,27318,440
30077,9,193,1134,126,19681,67
62031,24,384,395,310,9357,74
60724,15,182,439,150,5627,32
23494,20,964,1271,681,11671,283
29101,6,181,1153,154,6673,27
48069,40,349,821,230,3747,119
16231,663,8640,1395,5113,37663,3527
26727,620,7012,1201,4717,51026,2295
52438,20,221,701,164,2589,57
59553,199,3100,482,2329,12513,771
2762,610,13993,1543,7777,67742,6216
62061,136,2110,385,1766,12186,344
17827,181,6546,1367,4459,48833,2087
56438,427,6590,577,5465,45950,1125
49176,1557,28761,792,24060,144007,4701
4197,104,5900,1528,3834,36373,2066
10690,510,9085,1465,5250,35677,3835
4978,470,26237,1517,16268,182695,9969
68397,13,376,208,300,13496,76
17416,49167,1144461,1376,711948,2516389,432513
68383,59,847,208,688,9523,159
64509,14,196,324,149,9232,47
18669,7,147,1353,100,18060,47
14563,61,1962,1419,1311,14831,651
39132,30,590,940,461,9902,129
15889,9,431,1401,335,5903,96
49670,49,1214,778,760,20673,454
38477,10,210,952,162,4731,48
6138,4,151,1503,98,9207,53
4633,13,327,1522,219,13617,108
24877,34,1880,1242,1157,26356,723
17589,8,206,1372,137,9014,69
50337,20,240,761,199,7024,41
60306,42,797,455,634,8395,163
28499,61,2108,1164,1325,16392,783
13823,1,58,1430,30,3421,28
51061,29,219,742,173,8139,46
39087,38,751,941,576,10736,175
28376,18,705,1167,443,4524,262
6830,762,23070,1495,13926,64488,9144
51853,243,2612,720,2198,49632,414
36378,13,343,1007,279,7152,64
58888,54,556,504,461,9450,95
26306,41,1034,1211,611,9813,423
30215,14,421,1131,277,4415,144
53767,2893,38888,661,32155,158312,6733
8608,123,5382,1476,3158,59138,2224
21894,656,17199,1297,10509,56702,6690
3752,15,661,1533,483,9212,178
59358,37,506,488,401,8434,105
12719,15,765,1445,435,6413,330
28613,96,5033,1162,3016,34343,2017
40737,138,1567,918,1205,12471,362
12915,0,21,1443,12,3753,9
10812,42,1109,1464,547,42099,562
41381,7768,237146,908,166625,903600,70521
15200,27,1019,1411,714,20312,305
12861,53,1335,1443,765,16220,570
7200,43,1321,1489,857,43921,464
5683,11,602,1509,380,15900,222
5805,10,169,1507,133,7539,36
52208,193,2171,709,1824,26331,347
10312,70,1316,1468,971,23490,345
39782,8,138,933,104,3564,34
54285,146,1260,642,989,14922,271
20483,7072,219712,1321,153966,768336,65746
13732,3813,109051,1431,67616,384432,41435
7794,56,2726,1482,1883,60764,843
58834,83,833,506,692,10036,141
59312,63,608,490,513,8902,95
34000,44,656,1065,521,13058,135
65599,51,403,295,339,4911,64
7769,264,8868,1482,5855,65559,3013
11438,33,1447,1459,945,11574,502
17657,16,942,1371,580,9262,362
8674,71,3267,1476,2066,23791,1201
28764,1,76,1160,39,3335,37
53587,5,81,667,56,4122,25
69926,14,174,156,136,4146,38
22984,30,1008,1280,734,10710,274
31717,948,17793,1105,12631,77368,5162
1154,385,17324,1555,12779,81843,4545
43697,115,1435,872,1137,12704,298
21177,15,418,1308,329,6535,89
23454,164,5709,1272,3775,32354,1934
21789,28,504,1298,330,15027,174
37607,45,966,975,779,9241,187
59204,13,114,494,85,2986,29
53124,2041,21318,677,16716,164454,4602
62224,115,1756,389,1523,16219,233
53555,4,38,668,25,2365,13
35375,23,498,1033,427,14621,71
23788,74,3095,1266,2304,56705,791
29224,84,2553,1150,1518,14449,1035
3416,63,1226,1536,838,14999,388
5645,63,2615,1509,1866,68119,749
56828,84,1010,565,773,11096,237
62837,6,73,372,41,4115,32
24371,228,7541,1253,4630,82826,2911
8186,295,5165,1478,3313,16826,1852
11935,84,2198,1454,1309,13690,889
3605,445,11783,1535,8272,43160,3511
21946,11,430,1296,303,9054,127
41171,104,1095,909,890,15127,205
30669,18,413,1122,273,4637,140
12705,420,21772,1446,13510,100869,8262
33882,0,31,1067,20,6212,11
61415,7,134,415,112,3875,22
17838,4,67,1367,59,10356,8
43131,26,481,879,371,7620,110
21936,1019,21184,1296,14731,245215,6453
48290,1097,17884,805,13169,74340,4715
28895,15,959,1157,599,11147,360
66544,47,494,268,406,7012,88
8636,506,27842,1476,15528,88166,12314
26759,7,281,1201,170,5582,111
21307,355,9961,1306,6779,64611,3182
28324,177,6062,1167,3902,46957,2160
54770,83,666,625,552,23160,114
37392,53,825,980,622,15266,203
10755,255,7288,1464,4718,54691,2570
29012,70,1027,1155,699,8288,328
26628,200,3872,1203,2165,18333,1707
40009,207,3135,929,2610,31909,525
19511,97,2797,1338,2048,22825,749
17483,385,6312,1374,4152,41294,2160
32406,12,153,1094,111,11572,42
22428,24,694,1290,589,7035,105
57398,19,179,551,121,4406,58
483,4,208,1561,139,12080,69
21859,5,202,1297,149,5047,53
27529,423,10520,1184,6444,64670,4076
14732,53,2830,1417,2014,25091,816
30897,15,550,1118,388,10005,162
6379,14,432,1500,304,23145,128
59417,788,13656,486,11348,81804,2308
68889,11,120,190,97,2329,23
29651,14,533,1143,367,13427,166
24279,135,3371,1256,2392,36364,979
19749,356,7493,1334,5238,62325,2255
6026,40,1631,1505,1129,43859,502
13268,88508,3702386,1438,2421124,7364114,1281262
35317,12,182,1033,162,7060,20
41590,25,707,904,563,15805,144
44912,94,1626,859,1285,19050,341
48570,938,13943,810,10685,118627,3258
60833,6,52,435,45,10000,7
8045,578,7706,1479,5279,70827,2427
3199,3,87,1538,60,11539,27
17110,7,180,1381,127,5565,53
10574,237,5406,1466,3681,28905,1725
60367,34,400,453,324,7468,76
68907,5,100,190,75,2491,25
29298,255,8975,1149,6347,71406,2628
60798,129,2165,437,1712,29446,453
30840,7,224,1118,150,3688,74
16552,35,659,1390,479,11852,180
28675,125,4076,1161,2491,47496,1585
22150,57,2311,1294,1569,15802,742
37925,0,28,967,24,6060,4
11813,255,12542,1456,6692,57175,5850
12759,21,581,1445,345,20155,236
66883,10,206,256,168,2398,38
2881,117,8561,1541,5713,106090,2848
49638,373,10564,779,8148,72503,2416
61909,18,250,399,186,5585,64
61005,152,1455,429,1268,21676,187
23599,31,388,1270,274,5265,114
19757,44,1525,1333,1038,35010,487
56018,5,125,589,94,7216,31
41047,147,4600,913,2303,21143,2297
24792,25,1404,1244,882,16079,522
3558,44,1576,1535,1072,48378,504
14029,120,4722,1427,2972,33588,1750
69811,1214,35473,158,30165,163653,5308
28908,149,1791,1157,1176,19450,615
55835,7,39,595,24,3259,15
56917,12,108,563,91,7805,17
66337,20,221,274,171,1573,50
66726,26,335,262,283,11226,52
36480,1649,38125,1004,30707,144377,7418
20050,140,5957,1328,3519,34028,2438
8492,78,1158,1477,757,7849,401
40343,152,2259,924,1958,26649,301
70617,7,64,133,63,3656,1
50762,258,3584,751,2668,55351,916
19443,542,9432,1339,6361,94756,3071
10578,1098,24612,1466,14399,161637,10213
16746,792,14061,1387,8278,74455,5783
60172,34,444,460,393,12027,51
5825,27,1285,1507,759,20085,526
48520,9,138,813,96,4051,42
17536,1955,75102,1373,44667,303372,30435
37463,13,317,978,282,9250,35
25585,133,5499,1227,3686,39071,1813
16974,111,4538,1383,3187,28170,1351
64310,4,189,330,110,3515,79
11670,16,503,1457,288,20261,215
27572,163,3052,1182,2111,27562,941
25122,78,1659,1237,1079,30013,580
3164,16,1016,1539,713,32428,303
6114,57,1692,1504,1153,47135,539
34106,1256,27116,1062,20073,106248,7043
62419,26,388,383,295,6603,93
54294,151,2949,643,2170,32149,779
33571,337,7433,1073,4875,64907,2558
20370,108,5307,1323,3257,44165,2050
53568,44,541,667,470,9577,71
12080,19,817,1453,407,11133,410
34771,19,690,1047,493,10404,197
23540,23,357,1271,285,31355,72
65295,8,60,302,47,2770,13
26138,42,835,1215,518,19325,317
14910,4,419,1415,293,9949,126
69233,126,1312,179,1006,21249,306
61253,144,2047,419,1779,21639,268
15386,1032,32037,1409,17410,206229,14627
38134,102,1759,961,1362,17231,397
60935,445,8429,414,6397,77052,2032
57395,137,2111,551,1765,35232,346
2654,30,1837,1544,1227,28138,610
57591,5653,83216,546,65372,216882,17844
12820,8,589,1444,340,21021,249
17459,35,580,1375,426,10954,154
26999,24,1060,1195,874,18052,186
7161,19,364,1490,246,9280,118
51330,2312,55485,735,39750,97516,15735
34362,25,916,1057,647,16886,269
25398,61,1914,1231,1443,13342,471
53244,21,306,675,258,8857,48
53508,36,391,669,331,18156,60
38356,272,3288,956,2818,18984,470
69865,99,1602,158,1311,15515,291
23514,6,271,1271,205,9845,66
53299,41,526,674,381,6386,145
25921,87,2317,1220,1234,26615,1083
50124,65,1130,766,860,11923,270
4776,5,351,1520,204,6551,147
62809,233,1952,372,1645,7472,307
55430,1064,10243,606,9270,66792,973
18491,72,2098,1356,1443,24163,655
38191,234,6159,959,4419,35385,1740
57436,48,498,550,381,6000,117
66923,8,159,255,119,5478,40
2699,3119,164064,1543,98057,532913,66007
64677,17,141,319,118,4508,23
2665,95,2327,1544,1785,48240,542
51617,959,11972,726,9810,67259,2162
17765,58,2139,1369,1572,27268,567
49972,1430,23710,770,17487,143313,6223
61881,37,365,400,283,5936,82
11372,30,1553,1460,782,17655,771
26842,2609,86979,1199,52317,592885,34662
34175,6,200,1061,124,2389,76
21366,1649,42623,1305,28776,342241,13847
12672,81,1901,1446,1077,33576,824
6882,309,5430,1494,3995,30315,1435
41822,1346,55704,900,34728,163505,20976
12314,195,3473,1450,1980,21858,1493
51115,44,488,741,389,4005,99
10260,3,321,1468,198,15619,123
47117,10,285,833,257,10041,28
34093,23926,543884,1062,360770,1306170,183114
24720,55,1377,1245,927,23491,450
15452,29,1434,1408,948,18458,486
849,2454,150822,1558,98123,367571,52699
14244,37,1126,1424,746,17321,380
50257,1410,35140,760,29056,259625,6084
11697,7,289,1457,146,9700,143
29722,77,1714,1141,1092,17170,622
64651,6408,111940,320,83677,562022,28263
16619,2193,65892,1389,43306,221126,22586
518,23,1072,1560,775,20007,297
16460,0,0,1391,0,31522,0
59866,40,419,471,317,7330,102
66840,28,522,258,407,12954,115
69785,13,373,161,280,6474,93
6163,234,7047,1503,5279,63528,1768
39534,6,167,936,113,2407,54
53442,10627,221049,670,161499,911688,59550
16601,109,2285,1390,1573,16914,712
30132,262,6933,1132,5812,53358,1121
14647,12,579,1418,421,13049,158
28596,576,12552,1163,8219,99673,4333
33017,12547,585475,1081,323021,1775123,262454
27850,2,101,1177,78,4244,23
28354,31,901,1167,575,30041,326
26365,24,627,1210,525,13127,102
59249,85,999,492,824,14525,175
14139,153,4083,1425,2829,22985,1254
61658,399,8439,408,7144,70947,1295
13738,7,757,1431,452,19966,305
30415,20,544,1127,398,5306,146
45338,209,2380,854,1996,50504,384
27943,70,2794,1175,1540,22612,1254
11507,81,2131,1459,1341,18750,790
69400,29,301,173,277,5265,24
28179,11,424,1171,272,7424,152
6476,1028,45811,1499,29302,275607,16509
4554,11692,507958,1523,282378,1611006,225580
19584,18,536,1336,363,18516,173
59118,250,4664,496,3381,44916,1283
1044,20,443,1556,331,17686,112
13365,5,398,1436,224,8700,174
24243,203,8130,1256,5378,48306,2752
838,255,8337,1558,5749,41525,2588
39951,563,5991,930,4488,69586,1503
67300,3,138,242,53,3716,85
62332,13,300,385,249,6545,51
18631,0,70,1353,48,4469,22
41610,3,76,903,60,3003,16
53048,16,252,680,161,8223,91
26510,289,6537,1207,4760,65674,1777
69800,29,494,160,477,9299,17
1219,6,674,1555,435,18207,239
13618,23,1176,1433,821,31204,355
51646,62,1133,726,908,21531,225
30060,59,2016,1134,1279,19055,737
53640,49,362,664,297,8777,65
20120,248,7503,1327,5369,55093,2134
64128,31,239,335,196,2848,43
18605,11,645,1354,505,7517,140
45234,73,883,856,719,13593,164
27730,21,267,1180,242,6606,25
18947,19,509,1348,367,10602,142
29675,44,1056,1143,712,5022,344
40020,45,1106,929,822,17969,284
716,4,181,1559,129,15096,52
6914,193,8383,1494,5796,37665,2587
65562,27,449,296,333,6633,116
12060,2456,96226,1453,62316,480609,33910
34074,3739,98985,1063,64874,452214,34111
22176,8,404,1293,263,7972,141
51849,33,586,720,447,13354,139
69571,13,245,168,201,5053,44
51460,138,1929,732,1577,26199,352
29587,191,4448,1144,2819,21203,1629
64159,4,47,335,33,2208,14
57121,52,747,558,572,20311,175
8491,52,1983,1477,1178,32876,805
55322,217,4414,608,3521,41178,893
15649,22,688,1405,511,6646,177
15697,12,484,1404,345,15708,139
9447,6,385,1473,226,5795,159
35289,123,2584,1035,1954,26815,630
70322,15,130,143,120,3797,10
31706,26,540,1105,386,10475,154
24702,258,7972,1245,5639,161965,2333
53995,1275,14358,653,10631,44899,3727
36465,9,161,1004,117,8397,44
34062,60,1666,1063,970,13171,696
34449,27,845,1055,569,24015,276
46366,44,477,843,354,6775,123
45299,4,48,855,39,4608,9
65973,210,4098,285,3152,11120,946
3674,11,186,1534,128,19943,58
2037,99,2299,1549,1742,33227,557
34724,63,1392,1048,999,12937,393
49147,121,2647,793,2141,35257,506
11126,126,5200,1461,3030,24007,2170
25440,264,3152,1230,1988,22536,1164
48281,92,1316,818,1036,26065,280
54195,11,168,646,115,12425,53
57433,95,1122,550,895,10522,227
34609,35,465,1052,291,12775,174
11927,9,704,1454,344,13863,360
14625,0,50,1418,32,4177,18
36458,39,1247,1002,882,33010,365
69745,1,18,162,16,2344,2
15871,31,736,1401,555,17331,181
54359,5,60,641,39,1885,21
37809,14,287,969,232,9517,55
21711,17,895,1299,631,19928,264
22531,3,202,1288,150,7777,52
13128,1011,46843,1439,28368,157893,18475
48483,16,369,814,283,14604,86
48593,1794,25586,809,20212,268656,5374
60897,236,3365,432,2989,28854,376
20798,43,1317,1316,888,17177,429
53729,226,2198,662,1705,13744,493
38216,137,1610,959,1095,21051,515
66754,4,39,261,30,4971,9
801,638,26346,1558,15856,112922,10490
3425,132,10712,1536,5423,69474,5289
31468,174,2691,1109,1780,22530,911
24485,232,6839,1251,4664,54991,2175
65497,55,639,297,542,7054,97
5363,99,3498,1512,2711,26330,787
35397,53,1510,1032,1120,18122,390
53413,11,142,670,125,4670,17
61774,19,193,404,153,6433,40
30600,178,1350,1123,1006,13446,344
20955,11,251,1312,186,10917,65
64701,30,610,319,481,10973,129
55012,9,61,617,43,5551,18
61782,14,164,403,132,9046,32
69024,2,29,185,27,913,2
16113,29,440,1397,337,6809,103
25367,104,2140,1231,1473,30141,667
33676,44,1243,1071,738,11422,505
54071,80,787,650,692,12356,95
6313,19,724,1501,494,11176,230
1020,9647,364995,1556,214320,1168517,150675
56920,27,720,562,494,12619,226
9842,846,31104,1471,18024,112230,13080
31711,161,4422,1105,2687,14688,1735
18445,36,1129,1356,697,8051,432
24531,179,5685,1250,3904,34334,1781
31247,5,301,1112,186,7221,115
4004,125,4013,1530,2707,61347,1306
3437,6,222,1536,139,19523,83
22505,50,2663,1289,1864,38634,799
57778,47,937,540,690,23174,247
59602,68,496,480,401,7340,95
24413,31,794,1252,537,18377,257
33637,66,2175,1066,1387,19533,788
26838,1362,34427,1199,23463,163657,10964
2692,17206,582408,1543,388623,1308097,193785
1836,152,5801,1550,3835,24421,1966
7402,6,429,1487,291,14808,138
13672,78,2521,1432,1660,18492,861
27988,28,855,1174,526,11018,329
42752,357,7026,885,5576,28181,1450
69893,264,6489,157,6134,42984,355
154,495,17607,1564,12164,73167,5443
23862,24,708,1264,565,63551,143
9268,4,187,1474,134,6999,53
18272,5583,105453,1360,70064,336416,35389
30377,23,454,1128,368,5605,86
52940,38,404,683,338,16723,66
55096,38,431,614,320,17500,111
51791,2972,46721,722,37283,258080,9438
14080,19,798,1426,457,19741,341
69121,27,144,182,125,3245,19
62548,44,1026,379,708,14662,318
35808,23,468,1022,373,21931,95
67585,60,590,233,469,6345,121
60719,153,1610,437,1376,21210,234
53049,3,40,680,32,6290,8
63374,22,213,358,171,9867,42
68135,36,357,216,330,8320,27
22631,195,8280,1286,6194,37314,2086
35323,20,1037,1034,722,12099,315
25380,259,5258,1231,3476,36358,1782
15625,331,7436,1405,5053,67344,2383
68203,18,591,215,441,12377,150
16064,26,731,1397,473,17138,258
40478,2062,22659,922,16421,131818,6238
30847,9,255,1118,159,6697,96
21199,5731,165433,1308,112329,789639,53104
12126,14,593,1453,352,16330,241
11717,22,1750,1457,976,29017,774
26286,328,9329,1212,6547,97741,2782
65570,65,1157,295,979,9316,178
55734,25,375,597,292,7560,83
18300,14,369,1359,264,30346,105
32067,14,451,1100,270,13316,181
15002,30,1189,1414,878,19160,311
26347,84,3928,1210,2163,24860,1765
62850,19,178,371,124,5556,54
18920,79,2412,1348,1730,15208,682
53074,107,2464,679,1954,24934,510
32691,442,11995,1090,8819,138949,3176
37618,40,572,974,451,17187,121
8363,10,332,1477,237,11126,95
60582,76,1370,445,1096,11012,274
57423,24,308,550,260,8866,48
34603,2,157,1052,111,11609,46
32899,65,2878,1086,2048,36493,830
15970,18,314,1399,216,8796,98
67025,50,1883,252,1137,16547,746
63357,30,1059,358,849,15378,210
34557,61,1594,1053,1099,17894,495
21157,173,5212,1308,3723,61576,1489
61538,174,5113,411,3607,58797,1506
2032,199,4345,1549,2994,29591,1351
65972,8,122,285,106,8828,16
51418,34,340,727,306,11315,34
64902,1,31,312,8,3278,23
29864,18,1045,1138,778,23907,267
66199,9,151,277,119,3818,32
51105,722,11067,741,8993,57340,2074
31720,92,2141,1105,1365,24660,776
29677,239,7313,1143,4050,29501,3263
9205,607,23616,1474,14060,124639,9556
55695,10,158,598,125,5124,33
2990,40,815,1540,590,16414,225
61809,30,507,287,406,3932,101
47915,0,0,823,0,3203,0
22313,344,7032,1292,4726,58932,2306
10832,487,14267,1464,8402,47374,5865
38010,10,41,964,38,1656,3
31313,3,47,1111,45,4892,2
56903,7,143,564,99,3990,44
21563,69,1131,1301,770,21100,361
11183,151,3950,1461,2346,21160,1604
3284,98,5711,1537,4025,27578,1686
69427,9,90,173,82,1340,8
42398,5383,166648,892,127468,805097,39180
48366,1155,14049,817,10922,108810,3127
61948,30,684,398,555,8224,129
28040,31,783,1173,516,10841,267
14151,97,2284,1425,1553,23506,731
25068,3379,84887,1237,59218,338023,25669
13252,114,5661,1438,2917,24376,2744
1032,31,1170,1556,882,49101,288
19360,36,892,1340,665,16404,227
17397,10,429,1376,282,12765,147
8342,224,3484,1478,2616,26116,868
31779,33,947,1104,648,9315,299
20550,22,530,1320,371,12709,159
53179,219,3499,676,2841,23327,658
16162,1301,40045,1396,29071,177817,10974
44762,15,426,861,289,7250,137
62361,21,223,384,171,4079,52
9305,11,368,1474,246,10748,122
70167,6,50,148,47,1585,3
55668,2815,92846,599,62753,181552,30093
31455,58,1060,1109,678,11898,382
31326,6,517,1111,306,10821,211
58620,210,3208,511,2033,29531,1175
21178,4,260,1308,211,21582,49
28427,2620,90874,1166,61385,255224,29489
8011,13,848,1479,503,23482,345
68785,75,840,194,771,13695,69
14730,1451,45051,1417,32863,306188,12188
34324,38,1112,1058,790,22876,322
3643,14,413,1534,308,17396,105
19432,14,1006,1339,718,9934,288
66333,99,1695,274,1415,28369,280
48707,2730,48024,806,38773,242690,9251
69467,386,9902,172,8814,50493,1088
37628,119,1409,974,1154,16208,255
28353,47,942,1167,626,12882,316
59558,2525,50684,482,38676,310677,12008
28938,46,944,1156,667,16953,277
33342,15,932,1077,586,24877,346
20456,95,1680,1321,1247,18174,433
52992,65,519,682,362,5803,157
66720,17,277,262,187,7723,90
55314,262,4031,608,3333,44467,698
8513,642,11630,1477,8312,46767,3318
7837,94,1537,1481,1147,36675,390
64530,20,287,324,213,4662,74
35737,0,653,1025,508,3353,145
20520,112,1874,1320,1473,41006,401
38119,157,3197,961,2649,51536,548
1189,307,12696,1555,8281,45809,4415
44998,0,42,858,24,1789,18
25349,22,834,1232,604,25988,230
15407,68,2158,1408,1572,27838,586
9151,33,1828,1474,1167,20806,661
69058,4,91,184,81,2756,10
67090,596,12071,250,10007,64256,2064
21659,1863,40208,1300,26893,130773,13315
49855,15,264,773,230,12126,34
662,1,79,1559,53,6466,26
25917,15,166,1220,159,13272,7
64885,139,2707,313,2184,26636,523
67354,4,36,241,26,1591,10
25370,2412,71489,1231,47230,285492,24259
55561,1,52,602,38,2835,14
18664,95,2761,1353,2124,34211,637
13058,372,25015,1440,13848,56641,11167
36350,92,967,1008,802,16343,165
32056,1612,34624,1100,22087,149616,12537
57891,19,194,536,155,5445,39
49226,12,237,790,175,4751,62
30629,18,293,1123,206,4917,87
55252,42,759,610,618,16506,141
59185,96,940,495,663,8256,277
48638,14,426,809,340,17616,86
15258,5,190,1411,142,25822,48
50678,10,219,753,193,9967,26
49282,16,246,788,186,8297,60
31885,185,3859,1102,2503,17592,1356
30178,46,2149,1131,1251,33083,898
54417,7,79,638,66,5662,13
47276,80,2058,831,1595,15978,463
15468,5,374,1407,279,7751,95
26018,16,180,1217,145,16848,35
68359,0,8,209,8,1693,0
49669,552,8496,778,7044,115492,1452
35850,16,280,1021,213,6799,67
1153,10,239,1555,184,14645,55
59674,95,1201,477,1036,15777,165
15732,24,1004,1403,673,19676,331
69915,0,9,156,5,1579,4
8720,4211,139877,1476,87645,780107,52232
16704,16,367,1388,277,12857,90
68668,1,64,198,47,4131,17
15628,137,5774,1405,4158,113561,1616
57503,137,1494,549,1227,9006,267
18854,5,337,1349,251,5477,86
49851,30,458,773,364,7784,94
17890,15,465,1366,376,13566,89
56897,36,458,564,360,18333,98
18450,500,12217,1356,8959,41548,3258
8660,25,1230,1476,865,19805,365
22508,9,372,1289,286,11518,86
27191,29,739,1192,560,13269,179
17143,28,627,1380,488,9684,139
6128,8,139,1503,87,12192,52
6570,23,659,1498,407,17615,252
23058,6,324,1278,284,18865,40
34912,27,1086,1044,615,35786,471
17893,1077,26425,1366,20269,147869,6156
54855,25,220,621,181,7069,39
68324,31,326,210,256,9501,70
17199,4,98,1379,86,18981,12
57504,6,129,549,96,5409,33
64015,25,378,339,316,4987,62
26397,75,1823,1209,1274,21140,549
2231,337,7856,1547,5540,81324,2316
9781,7,348,1471,248,9891,100
69124,5,48,182,35,1122,13
36359,16,493,1008,370,11651,123
27791,606,12162,1178,8429,50299,3733
64020,36,608,339,449,4390,159
50907,110,1153,747,822,7482,331
28147,6641,260984,1171,180043,794168,80941
32138,3,125,1099,83,4588,42
29648,128,2655,1143,1791,18698,864
31099,3,80,1114,53,2649,27
13163,211,9419,1439,6324,60301,3095
17494,176,5600,1374,3784,44080,1816
40755,84,2793,918,2325,57231,468
63381,1,19,358,17,6603,2
63916,14,293,342,220,5100,73
8317,66,2117,1478,1292,32537,825
7286,13,384,1488,278,11931,106
23968,22,587,1262,500,20999,87
13488,7,236,1434,153,16638,83
14888,32,712,1416,520,15001,192
60984,39,398,430,299,9507,99
51848,36,547,720,427,10032,120
27582,14,460,1182,314,10094,146
8057,21,244,1479,171,9421,73
27100,18,857,1193,537,16912,320
68818,37,570,193,408,4710,162
63783,27,207,347,152,4337,55
56446,37,366,577,315,9517,51
25323,83,809,1232,467,6709,342
15190,15,459,1411,327,6840,132
25507,21,894,1229,588,34365,306
31047,282,7824,1115,5278,59820,2546
358,4,349,1562,190,10180,159
66422,89,949,271,778,8969,171
68308,169,2336,211,1979,23160,357
22069,105,1814,1295,1105,11555,709
7462,86,3400,1486,2525,38860,875
6746,219,5888,1495,4059,64304,1829
69787,210,3177,158,2587,24059,590
19608,226,8756,1336,6718,101018,2038
69569,9,135,168,130,3946,5
32708,96,1974,1089,1317,11612,657
39875,8,67,931,50,3160,17
16680,28,901,1388,602,4916,299
49146,64,714,793,571,12728,143
42552,349,6825,889,5897,53406,928
58322,295,2438,522,2008,18667,430
60513,32,366,447,260,11057,106
23086,172,3941,1278,2946,30997,995
57335,5035,57561,553,46369,173786,11192
56989,3,29,561,24,3629,5
70222,158,2469,146,2316,16560,153
69437,23,219,172,182,5281,37
44216,372,6160,866,4524,49868,1636
51765,94,996,722,850,19921,146
64640,8,173,320,98,8465,75
32001,26,593,1100,386,3064,207
15953,773,10738,1400,6879,77213,3859
57725,134,1924,542,1520,18682,404
56296,24,386,581,259,6493,127
32227,340,8120,1097,5791,60255,2329
37745,124,2257,971,1744,14466,513
1741,29,1672,1551,1091,22382,581
19456,193,8290,1339,5162,33448,3128
25463,21,331,1230,280,19083,51
22185,17,602,1293,349,9793,253
12562,343,6250,1447,4047,21799,2203
31822,1480,34368,1103,23714,143179,10654
66841,4,47,258,26,1735,21
63960,41,437,341,350,5449,87
234,12,973,1563,704,16909,269
64869,18,903,313,309,6648,594
35664,186,2182,1026,1705,20365,477
28464,48,2087,1165,1191,29172,896
22641,29,502,1286,322,11158,180
54738,273,1561,626,1320,23469,241
8502,3405,125172,1477,76620,303851,48552
28624,152,5730,1162,3657,67483,2073
17036,866,53841,1382,38353,346997,15488
70132,53,797,149,752,7428,45
38162,14,242,960,198,11340,44
49999,11,170,769,138,9674,32
14500,2,95,1420,73,10464,22
38508,24,520,951,364,14140,156
6852,8,277,1494,212,7042,65
31038,6,59,1115,43,8533,16
28605,9,184,1163,116,4463,68
65569,99,916,295,659,4374,257
33305,216,6890,1078,4819,54755,2071
20037,110,1972,1328,1337,34422,635
67256,42,327,155,307,5710,20
8825,1318,30171,1475,20385,138786,9786
58449,34,490,518,335,4844,155
31507,19,307,897,247,5477,60
9480,2,165,1473,84,7110,81
55340,131,2494,608,1987,33170,507
60894,9,92,433,34,3928,58
13246,469,13155,1438,9616,106966,3539
35806,100,1829,1023,1327,36340,502
23560,603,13099,1270,8894,35487,4205
18263,2747,62754,1360,42021,165839,20733
28757,26,782,1160,653,15469,129
13374,78,2239,1436,1274,15565,965
17133,339,7848,1380,5077,85493,2771
29420,127,3119,1147,1799,15589,1320
7449,14,515,1486,305,15859,210
13519,15,1277,1434,766,32757,511
27916,7,453,1175,283,18042,170
21814,1,99,1298,68,10049,31
35633,461,23327,1027,18932,97278,4395
3516,10,573,1535,381,23489,192
22773,17,546,1283,424,7947,122
13466,2827,106165,1435,74096,213372,32069
54516,118,1197,634,1054,22521,143
31645,30,436,1106,296,6472,140
69545,15,257,169,202,7150,55
38716,33,307,946,224,4817,83
40753,215,3552,918,2820,46420,732
68939,15,159,188,132,4573,27
20663,442,12466,1318,8976,103888,3490
36061,1550,25310,1016,20841,136424,4469
14763,88,2919,1417,2199,37774,720
4380,312,15600,1525,11231,46056,4369
19207,15,290,1343,265,15186,25
68466,0,30,205,16,3734,14
59612,301,5776,480,4471,35838,1305
60873,67,863,434,689,19939,174
49921,28,297,771,240,14224,57
59998,23,172,466,145,5030,27
22906,4,177,1281,131,8656,46
12027,152,3303,1453,1819,26850,1484
69664,39,474,165,433,7938,41
20214,68,1719,1325,1214,19458,505
26052,7,359,1217,247,32579,112
26368,473,6490,1210,4594,24859,1896
639,88,3153,1559,2184,37302,969
65592,9,99,295,83,6328,16
65007,15,116,308,95,3052,21
7343,33,927,1488,641,41857,286
25581,104,1490,1227,864,16858,626
30724,54,1406,1121,1176,26683,230
63833,2,84,346,54,3412,30
55440,5,117,605,74,4078,43
28722,7,554,1160,321,27198,233
63463,70,617,355,440,4041,177
48527,52,421,812,326,4832,95
35202,19,321,1037,229,4047,92
38309,6,273,957,230,7839,43
4050,539,16482,1530,11802,130197,4680
29218,51,1599,1150,1164,22703,435
18314,34,298,1359,246,9682,52
67094,10,236,250,177,5933,59
28887,5664,208569,1157,135684,888559,72885
65103,2,12,306,8,2055,4
1682,9,289,1551,191,13814,98
19906,12,695,1331,512,8338,183
29796,13,245,1140,149,6722,96
64440,4209,79748,326,60466,353853,19282
22279,32,773,1292,505,14172,268
38485,15,372,951,295,10345,77
65542,15,124,296,76,2978,48
29114,446,11871,1153,7755,91162,4116
20964,11,310,1312,217,11128,93
20814,12,243,1315,170,6016,73
4946,545,46021,1518,30329,207512,15692
61311,3,46,418,40,7235,6
36744,23,704,999,497,13127,207
24081,28,819,1260,504,10158,315
22065,4406,74060,1295,46096,289408,27964
37341,131,2712,982,2429,39882,283
62079,461,6634,393,5358,61670,1276
65418,73,1154,299,1018,15382,136
30601,251,1872,1123,1377,17084,495
8117,27,502,1478,332,5710,170
39547,61,1463,936,1153,19315,310
67106,31,508,249,392,11136,116
12418,26,1166,1449,730,30392,436
9871,729,14888,1470,8636,49093,6252
59194,25,234,494,183,7401,51
19708,21,973,1334,720,37336,253
19599,48,1360,1336,951,11958,409
12612,32,1036,1447,607,18777,429
57848,43,1005,538,874,18764,131
62715,69,1242,374,1033,16011,209
35353,4,239,1033,168,8845,71
29405,2,40,1147,27,3550,13
38087,4,109,962,69,4406,40
11736,10,378,1456,211,12153,167
36948,1,20,994,16,5726,4
13408,0,39,1436,33,1838,6
67176,56,757,214,608,13467,149
30567,4,88,1124,54,1935,34
20260,8,251,1325,191,7112,60
10402,56,784,1467,529,15823,255
35286,3114,100477,1035,71636,157501,28841
41525,11,508,906,324,14180,184
26490,544,12785,1208,8660,68191,4125
60274,18,615,456,323,11845,292
18515,3,164,1355,112,6023,52
51057,893,23257,742,18906,104598,4351
52667,3155,44167,690,35068,336892,9099
4363,109,9064,1526,6157,56304,2907
54986,4,25,618,25,3738,0
1151,74,5493,1555,3544,49670,1949
10721,36,929,1465,600,8825,329
54377,1549,21465,640,17150,110206,4315
18357,18,702,1358,552,23871,150
43996,0,1065,869,697,24141,368
3166,13,362,1539,253,6155,109
36356,4220,67784,1008,56503,366146,11281
40615,1251,46372,919,31766,317228,14606
48147,8,134,820,103,7757,31
68920,383,5723,189,4611,46013,1112
32018,20,531,1100,301,6958,230
20124,18,308,1327,183,4587,125
26429,499,21130,1208,13154,80348,7976
66160,880,13809,248,10562,135744,3247
30049,10,244,1134,161,15170,83
7600,389,10924,1484,7016,59175,3908
4058,169,2954,1529,2440,16954,514
28057,60,870,1173,559,8708,311
32099,57,1559,1099,969,9150,590
29442,37,971,1146,589,9800,382
53345,148,1503,672,1255,29816,248
50844,659,10561,748,8111,38652,2450
5611,87,2777,1509,1766,29651,1011
64125,1238,13901,335,11014,63534,2887
11182,542,29910,1461,16807,93889,13103
48734,14,179,806,129,15397,50
20545,25,1252,1320,961,19140,291
33800,24,685,1069,480,17729,205
27682,18,707,1180,446,8538,261
5887,165,7305,1507,5220,53755,2085
31423,149,3905,1109,2855,30526,1050
21963,1,223,1296,109,10862,114
41341,4,135,908,110,7435,25
58700,20,207,510,170,2168,37
28401,35,830,1166,545,10752,285
4826,6,283,1519,196,17021,87
5701,1119,71709,1509,38720,187684,32989
50312,93,1445,761,1253,23035,192
36262,0,0,1011,0,3264,0
22633,33,686,1286,587,11665,99
62364,71,1171,384,954,9050,217
31192,86,1284,1113,950,21938,334
44353,41,471,865,340,11120,131
27210,116,3075,1191,1837,25755,1238
34692,29,562,1049,364,9914,198
28184,101,2780,1170,1726,21444,1054
20898,71,1572,1313,1216,17927,356
6374,21,431,1501,279,15620,152
35429,97,1022,1031,821,13504,201
28006,2,41,1173,30,7659,11
21372,72,1441,1305,1134,19410,307
6994,19,388,1492,283,13875,105
10946,202,9528,1463,5892,32199,3636
36398,11,245,1006,183,10092,62
59573,3,69,481,46,5758,23
38006,309,7083,964,5846,72471,1237
66305,9,163,275,138,3832,25
8729,870,41453,1476,23352,165251,18101
34011,55,1325,1065,895,18733,430
10137,37,1109,1469,745,21867,364
30522,596,10679,1124,6661,73489,4018
53306,36,534,673,385,4975,149
53698,351,3596,663,2719,51616,877
21643,219,5025,1300,3523,53621,1502
18962,93,1294,1348,861,9806,433
61573,154,1584,410,1205,11170,379
35047,9,193,1041,135,7123,58
54129,5,51,648,36,4445,15
51699,542,9761,724,8201,58689,1560
13122,105,3566,1440,2219,59432,1347
56029,0,0,587,0,6967,0
7679,63,3480,1483,2189,41607,1291
964,42,2997,1557,2109,64933,888
10384,94,1732,1467,1222,8840,510
70468,10,190,138,169,2905,21
5628,337,12662,1509,8128,44335,4534
55562,20,226,587,173,8401,53
32428,6,123,1094,73,7568,50
47260,32,659,830,579,18668,80
45734,5,83,850,50,3607,33
48634,553,10267,808,7893,67623,2374
42444,46,1857,891,1383,37300,474
17444,28,592,1375,476,20185,116
3859,9,291,1532,192,12024,99
35544,64,1633,1028,1153,11212,480
57667,29,381,544,305,6885,76
17523,39,1620,1373,1140,20987,480
38384,1879,29085,954,22070,295048,7015
20896,6,105,1313,77,5478,28
19702,33,2186,1334,1511,19827,675
49140,224,2922,793,2293,31702,629
53781,846,12073,661,10375,66860,1698
46934,366,7348,835,5844,116126,1504
55824,72,1049,595,696,139277,353
52855,50,914,686,707,8583,207
51011,1777,22545,744,18629,69567,3916
60769,471,9581,438,7722,47492,1859
54744,1391,13349,626,11129,110893,2220
33906,2,127,1067,90,2916,37
21456,470,12599,1303,9002,77579,3597
20691,518,18844,1317,12622,73391,6222
67605,337,5665,233,4799,59522,866
62418,50,521,383,442,9434,79
19841,5483,147661,1332,90544,442719,57117
48676,22,334,807,291,14532,43
37599,154,2024,975,1543,15437,481
8327,49,880,1478,548,12087,332
34174,8,101,1061,84,9249,17
270,34,1354,1563,864,65780,490
31113,241,8112,1114,4349,25034,3763
21634,32,1777,1300,1067,10151,710
60763,1065,19123,438,15009,133045,4114
69443,11,115,172,98,3766,17
58892,15,224,504,159,5755,65
14210,776,12411,1424,7750,59359,4661
34481,140,3806,1054,2675,26708,1131
54422,22,225,638,188,8987,37
34265,25,704,1059,522,10572,182
66612,3811,77234,265,51686,253610,25548
28079,122,4977,1172,3355,50518,1622
27663,65,1758,1181,1390,42307,368
61613,77,1914,409,1387,15700,527
13264,47,1987,1438,1301,54274,686
29148,3971,166113,1152,121581,314830,44532
50491,4303,58692,757,49361,234340,9331
26330,35,815,1211,637,9482,178
24562,4,239,1249,176,7375,63
3120,979,66155,1539,43263,344287,22892
38871,29,576,944,422,4289,154
51108,25,459,741,355,10815,104
51440,1,69,732,41,2072,28
53403,54,1118,671,774,18228,344
7832,264,6649,1481,3979,31167,2670
22813,8,237,1283,196,13901,41
8653,12,529,1476,366,9345,163
49637,32,444,779,290,3821,154
27691,33,1172,1180,820,51848,352
5588,3890,183970,1510,105009,936077,78961
52508,4,79,698,51,5018,28
64346,8,223,326,185,4897,38
47911,22,300,823,238,18755,62
15182,278,9422,1411,5946,50087,3476
31323,1,118,1111,74,4778,44
57026,129,1545,560,1202,19205,343
66172,30,269,278,210,3824,59
13218,342,9807,1439,5729,73182,4078
70218,21,281,146,257,5015,24
63317,182,6507,359,5430,28386,1077
55055,54,408,616,305,13185,103
61322,3,106,418,78,3463,28
63189,46,929,363,681,8313,248
15869,5,164,1401,96,3205,68
44939,27,295,859,226,10548,69
23638,73,2041,1269,1381,50619,660
48752,24,415,805,325,8272,90
30693,91,1346,1121,964,9160,382
61977,32,405,397,324,5646,81
69370,20,217,174,203,8998,14
28160,43,590,1171,414,7710,176
25505,152,3133,1229,2152,36318,981
53380,36,308,671,246,12155,62
22412,32,702,1290,518,8659,184
31847,109,1870,1103,1381,26069,489
13746,68,4346,1431,2579,65053,1767
46489,76,1023,841,797,32225,226
57565,13,150,547,127,3030,23
36294,64,1497,1010,1297,19854,200
59577,17,136,481,118,7596,18
22273,882,16860,1292,11085,38507,5775
14067,1572,55170,1426,34879,339236,20291
61575,36,425,410,339,8024,86
62105,254,6001,391,5142,49568,859
21176,3,116,1308,76,6140,40
25362,116,1994,1231,941,20465,1053
5155,44,1193,1515,773,11416,420
61528,15,186,412,152,7310,34
9617,9,226,1472,147,9698,79
46755,5,164,838,130,10053,34
10810,10,458,1464,247,20375,211
57427,219,10305,551,7517,48397,2788
3498,177,11592,1536,7672,111518,3920
20822,177,5780,1315,4161,48421,1619
18894,68,2262,1349,1471,23213,791
40703,48,1305,919,1071,17813,234
59529,11,284,483,197,8191,87
19355,47,949,1340,673,19428,276
4296,75,2615,1527,1820,34442,795
28515,1222,32072,1164,20832,158222,11240
43123,9019,140136,875,97962,598324,42174
55719,35,680,598,562,18396,118
10330,26,678,1467,455,19562,223
67703,23,152,230,139,2456,13
13840,13,785,1430,484,9505,301
37355,442,9527,981,6225,62781,3302
2515,221,8307,1545,5526,40978,2781
7401,9,467,1487,309,24564,158
11888,23,1766,1455,1046,45113,720
51803,18,515,721,403,9334,112
34530,12,433,1054,275,11266,158
29898,35,1240,1137,799,16055,441
23886,948,24319,1264,16544,98277,7775
19647,21,454,1335,328,11062,126
66362,125,1263,274,1065,14006,198
59595,59,724,480,598,14475,126
31599,23,290,1107,219,4633,71
31955,267,3443,1101,2211,47612,1232
29993,108,1913,1136,1700,42711,213
26558,1413,26928,1205,14350,97068,12578
3406,120,5870,1536,4007,124671,1863
10826,132,2667,1464,1673,23658,994
25769,20,937,1223,584,11117,353
21134,22,429,1309,283,4059,146
23375,1146,26877,1273,15569,123103,11308
32307,88,2276,1096,1334,29068,942
42374,0,108,892,50,5501,58
62030,5,142,395,98,8853,44
45764,376,6313,850,4920,52686,1393
6134,23,885,1503,589,28683,296
40299,44,815,925,613,11666,202
28469,52,1411,1165,1075,15970,336
15422,1243,24260,1408,15422,193553,8838
54967,1673,26762,616,21096,210556,5666
19017,23,460,1346,317,11320,143
48363,47,907,817,717,26404,190
25642,3866,128893,1226,76777,577445,52116
27229,70,1380,1191,907,75272,473
39541,610,8272,936,6363,54858,1909
10537,347,9764,1466,7073,59323,2691
52194,663,17723,709,15177,69333,2546
848,51,1855,1558,1389,36322,466
69640,373,5018,166,4375,66806,643
45542,213,2022,852,1589,26864,433
25937,436,10595,1219,6974,46916,3621
42792,125,1164,884,897,11135,267
51430,28,348,732,299,9718,49
4780,170,8079,1520,5457,148201,2622
33243,16,592,1079,386,7010,206
13722,66988,2780692,1431,1590485,4473984,1190207
20380,17,813,1323,639,19134,174
58122,239,3547,529,2678,12963,869
67005,45,798,251,613,7024,185
62827,10,260,372,193,10233,67
22990,72,1814,1280,1374,54390,440
49345,50,755,786,569,22321,186
19435,206,3500,1339,2787,41210,713
47077,28,557,834,389,23820,168
30805,31,809,1119,542,8808,267
13992,532,20296,1427,13365,119918,6931
9787,66,3282,1471,1851,21580,1431
8982,29,995,1475,633,27351,362
68292,15,173,211,132,3251,41
59415,206,6312,486,5143,46468,1169
12804,2405,49032,1444,27399,138546,21633
38193,151,2091,959,1446,14192,645
48560,164,1836,811,1544,17156,292
31028,78,2510,1115,1544,19020,966
42362,258,1757,860,1341,19794,416
54961,228,2442,618,1970,25674,472
48728,21,453,806,397,6244,56
58452,1181,16872,518,13570,50435,3302
40889,32,344,915,262,8070,82
64971,4,56,309,35,6184,21
32440,9,336,1094,195,4120,141
4526,145,3967,1523,2678,32967,1289
69110,4,55,183,51,1980,4
24411,35,868,1252,533,7564,335
24431,189,1846,1252,1339,14659,507
43733,6,141,872,95,3771,46
56521,73,867,574,644,12303,223
31163,102,2495,1113,1599,72940,896
16789,12,361,1386,241,11963,120
1508,289,9513,1553,6595,62872,2918
66943,25,246,254,211,6807,35
29467,462,7899,1146,4959,47481,2940
17396,89,5343,1376,3852,34392,1491
17288,11,381,1377,301,20226,80
64334,13,167,329,114,7840,53
38510,564,16522,951,12449,82784,4073
49138,99,2715,793,1869,25039,846
26021,4,195,1217,164,5847,31
53971,2037,22101,654,18083,84403,4018
15596,140,2349,1405,1633,42689,716
41800,3,57,901,39,5839,18
31000,226,5451,1116,3422,20732,2029
64113,12,225,336,142,2909,83
2584,52,1317,1544,883,19567,434
33608,30,774,1072,507,8344,267
32841,158,9531,1086,6221,54687,3310
29560,322,9260,1145,6093,66409,3167
65611,8,258,294,197,4476,61
63439,537,9540,356,8012,52759,1528
57397,2,33,551,24,308,9
23098,141,3123,1278,2010,63443,1113
18687,132,3339,1352,2279,37242,1060
18122,34,586,1362,397,15511,189
51404,583,5249,733,4116,24662,1133
37321,0,0,983,0,8045,0
37015,90,2278,991,1820,49711,458
17181,126,2291,1379,1553,15623,738
69277,14,198,177,172,2144,26
66796,732,10068,259,8011,31556,2057
47137,5,83,833,61,3328,22
15923,26,1042,1400,825,25390,217
36892,32,345,995,288,9616,57
47439,106,1568,829,1356,13914,212
9999,142,7650,1469,4618,57788,3032
31029,164,4174,1115,2245,22770,1929
49971,69,717,770,623,14124,94
37042,279,4908,991,4139,73564,769
6178,1898,77594,1503,51955,181168,25639
12812,319,8006,1444,5183,42474,2823
30243,74,1262,1130,786,34596,476
17455,75,3141,1375,2175,36771,966
62384,725,16249,384,12888,83459,3361
37006,803,12408,991,8756,71673,3652
35508,14,157,1029,118,8116,39
24167,508,26297,1258,20186,138238,6111
66872,36,415,257,344,4313,71
56663,34,598,571,414,13312,184
59970,736,12789,467,9417,82369,3372
27377,2037,38025,1188,24371,125375,13654
23045,40,643,1279,476,22073,167
54923,22,185,619,156,3294,29
19123,30,1120,1344,872,43895,248
59757,166,8756,475,6488,49338,2268
57286,101,2109,554,1609,25404,500
9633,22,1271,1472,864,20262,407
20789,6,341,1316,216,7586,125
46516,7,364,841,277,8554,87
55646,13,102,599,93,12440,9
60400,34,496,452,279,7813,217
39001,8,118,942,98,4742,20
23145,61,1177,1277,993,19841,184
28086,14,184,1172,111,6792,73
23283,4,305,1275,247,11298,58
58315,11,90,523,70,3607,20
62369,4,79,384,73,3652,6
26315,46,2091,1211,1183,23595,908
21341,1113,23250,1305,16476,177554,6774
31980,233,5072,1101,3086,17152,1986
64181,8,49,334,35,4123,14
68621,1,53,199,44,2298,9
57909,6545,116939,533,84767,598363,32172
22832,31,577,1282,393,12935,184
9994,306,9000,1469,5719,69926,3281
7481,6,315,1486,224,36040,91
12382,7,519,1450,273,6958,246
54049,34,445,651,297,4213,148
56798,53,972,567,748,24737,224
29378,677,16576,1148,9389,74095,7187
35715,32,936,1025,742,21125,194
30479,32,993,1125,615,16297,378
28598,116,5005,1163,2925,66911,2080
49049,59,707,796,551,7008,156
29243,623,13406,1150,9588,32380,3818
57660,36,634,544,540,11127,94
50659,11,159,753,104,5830,55
14984,308,8009,1414,5594,69009,2415
34004,80,1469,1058,973,16102,496
15860,164,2092,1401,1368,32488,724
27225,11,260,1191,154,3655,106
24214,519,17895,1257,12617,128973,5278
2624,302,12066,1544,7729,132557,4337
30419,33,954,1127,546,10742,408
63489,3,15,355,11,3236,4
66793,14,435,260,369,3784,66
8853,94,3922,1475,2316,36876,1606
37204,2411,50897,983,41627,398796,9270
31213,31,610,1112,395,13360,215
50679,2,69,753,48,1992,21
23326,122,2668,1275,1886,34933,782
57233,53,595,555,475,7581,120
67329,6,86,242,63,2333,23
21248,31,485,1307,322,6295,163
32437,28,397,1094,270,6441,127
15752,94,3580,1403,2645,74673,935
191,452,24059,1564,17406,185585,6653
45374,500,10250,854,8397,96143,1853
27467,66,2100,1186,1267,22126,833
31514,28,478,1108,371,9660,107
63305,11,152,360,109,4123,43
752,4,286,1558,178,11677,108
52894,32,387,685,307,11531,80
25664,791,14709,1225,9759,88787,4950
32143,8,247,1099,148,5177,99
5589,2961,118827,1510,71125,484849,47702
25620,61,1993,1226,1203,21046,790
24063,17,358,1260,258,20949,100
20869,42,348,1314,288,15109,60
44201,12699,358605,866,240193,665024,118412
28751,298,5683,1160,3786,34720,1897
9278,39,1844,1474,1175,21236,669
5508,279,12220,1511,8454,98090,3766
50318,10,250,761,185,3215,65
51469,906,11780,731,9023,76105,2757
47689,33,686,825,556,29330,130
68015,59,1188,220,919,15556,269
54209,13,87,646,62,5095,25
35387,62,757,1032,555,10804,202
60369,29,309,453,254,7699,55
69411,21,168,173,143,6656,25
37813,35,974,969,783,8358,191
16244,385,9403,1395,6232,60176,3171
62879,36,504,369,398,5961,106
26481,42,486,1208,388,17959,98
24552,28,674,1249,553,27834,121
55504,33,294,604,220,6247,74
7255,3673,108733,1488,63032,237692,45701
52743,59,1020,690,725,17135,295
59400,9,165,487,132,9652,33
65023,8,91,307,56,2587,35
65372,251,2556,297,2059,12246,497
31354,302,5849,1110,3484,71189,2365
1042,1942,48629,1556,33578,288690,15051
10212,151,5001,1468,3494,66579,1507
8040,6,142,1479,98,5168,44
24333,60,830,1254,497,7511,333
7645,16,227,1484,182,5171,45
15496,12,116,1407,93,3840,23
28460,57,1048,1165,641,10326,407
6841,6,243,1494,152,5346,91
49642,35,522,779,443,17063,79
33034,1269,17893,1083,13398,88483,4495
29702,149,4289,1142,2965,36907,1324
35509,4,139,1029,85,6024,54
70001,3,84,154,79,4334,5
1069,473,9823,1556,6874,103021,2949
14437,14,778,1420,542,22190,236
28572,91,1398,1163,911,14775,487
8834,24,1675,1475,979,20188,696
17193,23,529,1379,374,5896,155
55045,30,292,616,240,7231,52
35265,40,930,1035,641,19084,289
64856,571,23002,314,15035,59153,7967
10169,45,1491,1468,1003,7788,488
6905,17,427,1494,294,17258,133
70528,13,292,136,291,6830,1
10886,42467,1360559,1463,837027,2281723,523532
59884,8,77,470,64,4654,13
20985,76,2221,1312,1660,42699,561
70126,16,242,149,180,9786,62
52090,453,4410,713,3611,24582,799
39965,203,6691,930,4832,43691,1859
57024,5,49,561,36,2918,13
22059,1,94,1295,72,5928,22
24157,2115,49712,1258,42745,226728,6967
25955,26,825,1219,542,13832,283
5878,71,2276,1507,1633,40431,643
34925,1988,46802,1044,32050,161862,14752
39601,197,3732,935,3206,46044,526
19409,240,6012,1339,4061,57434,1951
17825,28,805,1367,627,14640,178
66776,13,346,260,303,2794,43
24326,212,2849,1254,1966,10869,883
1766,5,181,1551,138,7448,43
29829,199,3147,1139,2121,42249,1026
64287,10,253,329,195,6517,58
21085,217,8271,1310,5406,44188,2865
23589,20,549,1270,394,46949,155
54369,27,374,640,306,15708,68
37123,159,3141,988,2532,28627,609
20130,337,7022,1327,4439,98270,2583
15917,919,60170,1400,37923,185852,22247
50163,3,81,765,59,6236,22
5169,284,17452,1515,10627,76559,6825
15329,908,19671,1409,12397,143740,7274
28726,29,469,1160,330,6220,139
48862,53,558,801,464,12299,94
29421,10,243,1147,177,20539,66
47173,1786,28774,831,24113,108824,4661
10836,4340,176855,1464,100801,420835,76054
44943,101,1380,859,1098,9397,282
4429,685,39810,1525,21055,205387,18755
50894,81,1330,747,1169,27670,161
54572,419,4881,632,3876,35238,1005
35359,940,16382,1032,12549,124832,3833
31744,82,2270,1104,1465,30172,805
23258,7,179,1275,139,16010,40
25240,1,151,1234,98,10152,53
52315,9,222,705,181,3921,41
57326,50,822,553,646,8502,176
56290,20,427,581,280,9776,147
4985,66,1080,1517,717,32995,363
8066,1224,30606,1479,19349,173237,11257
9819,91,3561,1471,2071,33786,1490
11712,131,2790,1457,1615,41022,1175
9214,27,1012,1474,646,9980,366
51133,33,670,740,469,3973,201
62747,55,953,374,632,16381,321
69642,23,271,166,223,3906,48
19109,0,0,1345,0,17243,0
15495,70,881,1407,494,6915,387
69719,1,57,163,53,2075,4
21846,59,1096,1298,752,12813,344
61398,64,2338,416,1705,14121,633
29105,301,7863,1153,5318,61354,2545
16705,122,3911,1388,2583,29267,1328
10255,510,11730,1468,6569,67155,5161
12320,374,11250,1450,7211,97099,4039
24092,214,5358,1259,3898,42163,1460
61212,7,97,421,67,2002,30
36856,27,607,997,466,7623,141
5010,3523,146537,1517,107741,373403,38796
12747,67,3373,1445,2080,69592,1293
8963,1,139,1475,87,2793,52
33004,30,667,1083,475,11225,192
5969,16,582,1505,413,14502,169
26857,8,238,1199,147,6240,91
6075,1115,42932,1504,30655,239087,12277
37238,87,2035,985,1574,21075,461
29769,49,3233,1140,1809,17492,1424
61084,17,202,426,177,4859,25
60373,41,729,419,590,6373,139
60372,15,168,453,113,5721,55
60699,53,872,440,669,19213,203
16982,6,227,1383,159,8666,68
61908,6,78,399,71,2819,7
66331,3,78,274,61,6190,17
27994,27,957,1174,664,28024,293
17860,24,1081,1367,810,13376,271
969,12,602,1557,430,13463,172
36045,45,748,1016,656,12897,92
12036,34,2912,1453,1368,15527,1544
51028,32,588,743,440,9738,148
30818,85,1928,1119,1295,15506,633
4764,1409,56272,1520,34633,158439,21639
29966,16,515,1136,362,11624,153
22610,2372,47310,1287,33526,167313,13784
34243,8,174,1059,128,8463,46
64579,14,223,322,175,3414,48
49561,427,10900,781,7821,51310,3079
46712,211,3542,838,2758,87431,784
56594,49,515,572,417,3850,98
10264,1,93,1468,68,5971,25
67359,672,11656,240,8445,70820,3211
718,431,19157,1559,13373,147194,5784
20478,20,765,1321,498,12955,267
34731,226,2994,1048,2154,27583,840
59784,44,518,473,425,7370,93
55332,130,1255,608,1141,24381,114
25043,7,124,1238,75,4557,49
23943,268,16729,1263,10967,67991,5762
34085,17,432,1063,253,7628,179
42326,18,272,893,211,10817,61
54468,41,214,636,162,4214,52
4692,231,10770,1521,6992,60550,3778
37128,49,1155,988,810,7812,345
27064,3699,65444,1194,43119,258811,22325
51549,1,12,729,10,2221,2
9532,43,1031,1472,660,11723,371
26207,445,10243,1214,6453,59949,3790
32201,349,7082,1098,4397,37753,2685
51984,14,211,717,170,11296,41
4993,25,761,1517,537,30343,224
47961,53,841,823,668,6110,173
50731,798,22474,751,15894,110896,6580
372,8,480,1562,351,9632,129
68620,119,2717,199,2308,20402,409
18993,186,5068,1347,3774,62928,1294
18473,32,825,1356,516,21056,309
25882,548,9112,1221,6125,90376,2987
787,16,945,1558,599,12876,346
35668,48,703,1026,620,11887,83
7753,6,355,1482,253,34771,102
26493,27,1533,1207,987,23535,546
23030,1944,39363,1279,26056,156859,13307
35333,310,5645,1033,3840,106367,1805
69526,12,209,170,187,7347,22
64816,98,1041,315,908,21088,133
26182,13,664,1214,385,12698,279
35561,218,4084,1028,3165,14757,919
59296,40,310,490,241,6614,69
984,62,4541,1556,3112,74835,1429
32575,11,240,1091,143,4499,97
40056,16,283,928,228,9656,55
38389,1863,29649,954,21331,77636,8318
28243,575,14728,1169,9501,77042,5227
545,742,38238,1560,24681,93874,13557
65653,11,613,293,429,6013,184
34747,144,4449,1047,3050,26306,1399
11990,46,2418,1454,1217,33737,1201
60275,57,348,457,255,4397,93
45026,36,532,858,328,3734,204
50977,304,3265,745,2476,25810,789
60279,4,191,456,129,9020,62
805,11,345,1558,213,9751,132
61206,482,9643,421,6284,100401,3359
7555,72,2151,1485,1418,60320,733
26261,8596,260661,1212,168090,801787,92571
27727,573,11346,1180,7095,50407,4251
32137,83,1318,1099,855,7649,463
9572,216,4471,1472,3032,32280,1439
19356,71,1563,1340,1080,23428,483
227,149,8783,1563,5541,43334,3242
63077,24,809,363,622,6903,187
54374,14,206,640,144,4426,62
41964,44,471,898,371,9895,100
17886,88,4865,1366,3195,51686,1670
5445,14,438,1511,354,11141,84
21575,137,1816,1301,1212,19842,604
32654,44,2053,1090,1213,18150,840
17693,19,680,1370,451,7761,229
66340,5,47,274,42,2624,5
38491,8611,191842,951,132738,619708,59104
34960,7131,161356,1020,122324,619235,39032
54449,58,516,637,480,16403,36
66938,22,542,255,482,7317,60
37544,118,2986,976,2631,50321,355
44324,519,11105,865,7432,41704,3673
41606,9,85,904,67,5897,18
14600,33,742,1419,568,21530,174
6319,205,5729,1501,3941,33393,1788
38506,243,5469,897,4504,74643,965
22302,41,1660,1292,1057,15633,603
23099,2181,58483,1278,37964,280766,20519
43107,1870,40215,879,32214,148163,8001
37549,9,201,976,172,2408,29
35954,2,47,1019,33,1371,14
62835,245,3482,371,2837,20281,645
57690,60,1209,543,829,19287,380
21824,130,4538,1298,2991,30588,1547
11005,4825,166263,1462,103066,523348,63197
57124,602,8479,558,7130,68804,1349
33635,231,7110,1072,5159,68932,1951
65808,94,1676,289,1437,14966,239
7093,6124,204000,1491,127508,718072,76492
28435,40,2185,1166,1435,12896,750
28386,205,3312,1166,2199,52038,1113
11513,61,2984,1458,1773,26069,1211
53532,128,2041,668,1474,15512,567
2161,17,585,1548,450,27651,135
2685,57,2294,1543,1573,56302,721
29185,1730,35581,1151,23451,106275,12130
65245,44,854,303,665,11539,189
62454,21,205,382,176,3585,29
21831,126,3187,1298,1973,53795,1214
59656,1,19,478,16,4275,3
37272,7,199,984,146,12050,53
27066,117,3389,1194,1873,17833,1516
67718,18,241,230,193,2537,48
32434,60,955,1094,732,9907,223
8461,272,6914,1477,4251,75808,2663
53988,131,773,653,666,14282,107
7904,90,3567,1480,2454,63431,1113
45921,47,832,848,539,9153,293
62778,22,175,373,131,3513,44
4522,24,826,1524,522,27666,304
70625,2,56,132,42,1634,14
3970,10,1026,1530,769,10323,257
49626,283,2119,779,1823,37331,296
6976,148,9983,1493,6009,64495,3974
7092,45,1273,1491,863,16923,410
54561,25,293,633,222,7984,71
2879,9,465,1541,295,15477,170
30545,1798,40606,1124,26901,163737,13705
11301,53,2220,1460,1306,13752,914
69186,20,206,180,179,2687,27
9260,4,169,1474,105,10987,64
2985,94,2421,1540,1656,22666,765
51231,97,1596,738,1160,14648,436
38988,9,184,942,141,4141,43
29537,5,253,1145,150,6324,103
55670,292,3992,598,3256,315828,736
54747,3,57,626,44,4752,13
32648,1491,26482,1089,20855,175441,5627
5505,100,7135,1511,5087,43464,2048
3031,82,5022,1540,3124,34345,1898
65503,4,22,297,15,1909,7
19403,940,22476,1340,14510,72111,7966
12520,43,1959,1448,1206,40907,753
69224,69,1020,179,853,9972,167
24095,13,486,1259,321,20594,165
14135,441,3518,1425,2425,31258,1093
24908,292,7540,1241,5146,58053,2394
26955,795,22884,1196,15942,93992,6942
35042,29,400,1041,296,11704,104
13926,15,690,1428,431,11796,259
29312,742,15768,1149,10976,113248,4792
51408,45,522,733,386,9395,136
14800,403,11972,1416,7918,46154,4054
54674,15,189,628,143,11104,46
34523,12,180,1054,127,8779,53
12740,194,3331,1445,2047,37223,1284
25708,990,16639,1224,9576,54078,7063
62681,132,1571,375,1256,21767,315
13251,21,1185,1438,646,15692,539
17605,9386,367196,1372,214634,1068026,152562
65879,0,16,287,11,1644,5
14871,9417,350332,1416,204176,1519243,146156
45897,22,315,848,282,21720,33
39179,70,1073,940,938,18298,135
24368,15,427,1253,312,10560,115
18839,391,8728,1349,6663,76445,2065
16763,36,729,1386,490,11578,239
59843,3,36,472,30,2635,6
12987,1318,49798,1442,27512,305135,22286
61735,23,311,405,227,5401,84
1752,638,35233,1551,24847,187954,10386
56542,108,1757,574,1381,15384,376
46773,193,5372,837,4633,74696,739
23932,4,188,1263,139,8530,49
62785,9,132,373,98,5552,34
44798,33,403,860,286,5905,117
44804,101,1435,860,1164,17432,271
32391,5,177,1095,117,2372,60
30810,98,2569,1118,2141,27629,428
41638,239,3033,903,2284,38549,749
30671,16,477,1122,305,5822,172
61052,34,506,427,420,16728,86
60226,46,810,458,644,29730,166
22103,41,557,1294,411,16742,146
22837,1,61,1282,47,5397,14
27122,239,5266,1193,3408,55850,1858
36128,135,2377,1014,1859,23267,518
8521,459,8859,1477,5796,34691,3063
64597,69,1286,322,1093,14035,193
35095,50,1541,1034,912,15176,629
33254,24,595,1079,429,14074,166
43737,46,887,872,723,23212,164
3205,346,10087,1538,6009,55774,4078
7066,0,0,1491,0,4417,0
70085,7,57,151,51,2324,6
810,2753,89200,1558,57953,225181,31247
12866,6889,233409,1443,147942,555864,85467
19922,5926,149089,1331,100142,355581,48947
66446,1,26,271,22,2472,4
48925,124,1723,791,1434,14564,289
29745,155,5923,1141,3669,32863,2254
22330,6946,201814,1291,125605,894249,76209
14337,0,0,1422,0,9254,0
39317,42,638,938,510,12236,128
52549,20,245,697,194,8670,51
52671,102,1046,692,818,11763,228
13551,3045,78456,1433,47942,304883,30514
21923,103,1960,1296,1109,16727,851
64953,5,56,310,40,1804,16
36105,54,942,1015,808,17642,134
66499,4,79,269,67,2545,12
3781,63,2025,1532,1374,33676,651
6936,523,11192,1493,7609,41924,3583
53583,18,202,667,154,7621,48
3750,91,2252,1533,1622,13726,630
66919,679,15534,254,11936,79378,3598
60086,4,57,464,51,11318,6
17738,23,974,1369,644,17903,330
8698,304,12675,1476,7797,121269,4878
60491,25,174,448,141,2611,33
67603,10,437,233,340,6053,97
15906,3047,155247,1400,87390,400989,67857
12387,98,4542,1450,2448,34146,2094
66916,29,629,255,453,9019,176
63117,23,254,365,197,4183,57
2921,121,3787,1541,2784,25781,1003
61222,24,387,421,290,9228,97
28379,19,523,1167,330,16916,193
69939,472,9517,155,8451,76362,1066
51015,1083,20053,744,16028,70065,4025
40117,154,2287,927,1825,21057,462
2125,9,500,1548,309,31883,191
8713,1,135,1476,75,6729,60
61350,72,1828,416,1436,36331,392
31401,74,4149,1110,2472,17893,1677
56162,22,606,585,509,16903,97
33201,23509,426357,1080,305210,1335790,121147
22682,76,2317,1285,1585,56879,732
30673,463,17413,1098,12382,111187,5031
3326,1,166,1537,115,16591,51
13782,54,1307,1430,662,17650,645
22894,2429,82354,1281,56946,325626,25408
9301,121,2596,1474,1679,15112,917
19896,164,3886,1331,2758,35396,1128
49964,992,20224,769,14702,166907,5522
63450,23,198,356,138,4671,60
39993,1193,19372,930,16136,119648,3236
17080,21,1724,1381,1348,16427,376
63924,37,611,342,521,10077,90
33169,302,4945,1080,3385,58420,1560
9242,80,7092,1474,4441,53271,2651
22936,18,1092,1281,707,12323,385
68523,0,11,203,7,1658,4
11178,37,1581,1461,890,21617,691
27906,793,15702,1175,10921,110694,4781
61372,16,296,416,200,10983,96
61236,96,2412,420,1589,24105,823
69628,29,244,166,212,2708,32
66822,50,1110,258,924,15563,186
68902,0,2,188,1,785,1
14607,791,8933,1419,6427,48614,2506
18,2135,155359,1567,90386,648551,64973
17424,6949,229803,1376,152020,769091,77783
53078,323,5502,679,4771,56693,731
46720,399,5316,838,4216,30294,1100
51643,47,761,726,613,19666,148
60619,260,4168,444,3510,23820,658
6335,4033,108048,1501,73818,267451,34230
37632,26,299,974,243,7924,56
50686,64,1193,752,923,21634,270
34986,37,845,1042,650,14813,195
61074,16,266,426,189,3579,77
30241,491,7141,1130,4550,66968,2591
22309,15,425,1292,308,33880,117
53467,9,208,670,137,3511,71
33773,19,1292,1069,804,22683,488
47859,75,1552,824,1225,22344,327
9691,5,224,1471,162,7261,62
39918,408,9597,931,7539,57676,2058
5084,2096,64088,1516,46494,169125,17594
62502,8,101,380,75,3064,26
51511,0,2019,730,1594,9046,425
14221,1932,83651,1424,57108,492357,26543
5506,4,248,1511,173,22814,75
56796,55,592,566,449,15878,143
26313,1499,38214,1211,24474,313092,13740
5902,131,4206,1506,2869,40624,1337
4667,6,556,1521,359,21021,197
56469,21,327,576,245,13643,82
41792,13,190,901,151,10008,39
9388,4,265,1473,201,19323,64
18242,18,899,1360,621,18674,278
36157,18,196,283,146,8466,50
30587,216,3752,1124,2411,24690,1341
36372,290,4434,1007,3241,50174,1193
20224,76,1834,1325,1294,30635,540
56187,107,1217,584,925,16899,292
45147,3,114,857,83,4588,31
25932,10,755,1219,436,30785,319
31710,7,204,1105,177,7187,27
48659,29,817,808,583,8246,234
17096,212,3659,1381,2686,60011,973
64898,16,261,312,205,3803,56
5546,52,2977,1510,2018,28337,959
32452,306,6843,1093,4708,40772,2135
6249,2778,112004,1502,70106,605461,41898
14400,224,3909,1421,2553,37043,1356
27461,7,138,1186,81,4999,57
1205,452,11465,1555,7496,146056,3969
54271,60,997,643,757,19498,240
4628,54,702,1522,473,13169,229
22796,29,568,1283,344,12746,224
2581,3925,122968,1544,63084,453734,59884
35473,12,469,1030,295,8735,174
66700,26,776,263,568,12391,208
5397,425,12370,1512,8321,132446,4049
35260,17,248,1035,165,7022,83
672,52,2147,1559,1351,32878,796
49175,167,1818,792,1488,16871,330
18053,15,740,1363,533,8273,207
22971,934,19372,1280,12798,167822,6574
50576,22,371,754,340,5551,31
10134,35,913,1469,611,12238,302
27320,84,1035,1189,674,10056,361
2345,124,2999,1546,2143,48339,856
8657,46,1101,1476,732,11590,369
4123,32,3602,1529,2608,29099,994
33422,165,3438,1076,2219,25485,1219
5473,620,22104,1511,14804,72924,7300
52987,120,1181,682,1044,17388,137
70007,12,136,154,136,6643,0
58756,8,71,508,53,3877,18
9846,620,28825,1471,17141,66577,11684
17486,117,6218,1374,4267,55168,1951
11163,78615,1811662,1461,1082741,6344357,728921
31165,20,358,1113,233,7921,125
14555,36,1053,1419,801,11537,252
35224,211,3050,1036,2049,36783,1001
67044,1,70,251,51,3063,19
51922,1,24,719,15,3563,9
9112,9,130,1474,95,4233,35
48686,9,119,807,107,6201,12
56837,244,3349,565,2619,37597,730
63046,1,10,367,9,1094,1
50411,165,2754,759,2379,22950,375
41580,872,11490,905,7907,55743,3583
19510,50,1469,1338,1013,19212,456
29339,24,749,1148,512,33820,237
10466,149,4053,1467,2908,45900,1145
70159,44,794,148,791,7848,3
23138,33,1369,1277,1112,20470,257
38336,145,2666,956,1956,18487,710
60758,19,368,438,246,5651,122
1317,42,2169,1554,1540,14286,629
57380,4,42,552,32,1557,10
55389,2,44,606,35,6075,9
54254,301,3245,644,2411,29164,834
14803,17,415,1416,317,25323,98
33988,75,1059,1065,794,15148,265
53318,609,8394,673,6944,68161,1450
15426,19,862,1408,538,17817,324
65967,48,1127,285,779,12280,348
45867,3,71,849,48,2807,23
32698,155,3274,1089,2118,79539,1156
43613,888,19112,872,14876,75764,4236
19204,22,709,1343,526,7875,183
54593,1645,24412,631,19039,167996,5373
4488,0,12323,1524,7610,95468,4713
13647,39,1707,1432,1061,44639,646
3338,69,4176,1537,2857,56290,1319
14530,70,3862,1419,2549,33012,1313
1615,8,212,1552,158,9511,54
25895,119,1897,1220,1239,22910,658
25551,287,14109,1228,8898,115262,5211
70096,20,360,149,287,4391,73
28439,21,267,1166,166,4717,101
66216,5,144,277,115,1755,29
27476,89,3055,1185,2040,27849,1015
59119,238,4639,496,3478,20666,1161
11691,858,20762,1457,13579,119404,7183
8394,5,232,1477,156,6732,76
4343,218,7065,1526,4448,52911,2617
69225,0,8,179,8,3615,0
58316,18,307,523,238,17380,69
4563,48,1850,1523,1200,36883,650
55211,69,679,612,574,12759,105
40108,623,11378,928,8378,109944,3000
60318,4,49,455,37,5428,12
20022,2743,72278,1329,49607,311640,22671
27844,63,1884,1177,1130,16091,754
59339,5,59,489,40,4166,19
24649,72,1052,1247,718,10182,334
32275,2846,59094,1097,44733,285345,14361
51333,39,565,735,473,10060,92
52046,5,160,714,112,6680,48
3281,35,1386,1537,949,51203,437
912,673,18093,1557,12639,135504,5454
20524,69,1169,1320,851,22167,318
22827,26,929,1282,642,12912,287
26610,25,683,1204,412,17559,271
49610,53,787,780,418,9947,369
8216,591,16067,1478,9842,75164,6225
59822,30,495,472,310,10766,185
14293,37,1626,1423,1258,23513,368
50797,7,70,750,66,10242,4
33486,30,871,1075,434,8307,437
48313,106,1291,818,1107,31537,184
32738,3,80,1089,51,2931,29
7706,3,228,1483,161,7831,67
7140,1,80,1490,50,17148,30
35021,31,442,1041,337,7990,105
41204,79,1178,911,955,9931,223
9153,657,25440,1474,15682,152493,9758
29612,93,3073,1144,1897,15702,1176
13459,33,1517,1435,955,13639,562
57083,1374,26411,559,19272,116763,7139
60298,81,1364,455,1060,7792,304
66751,0,10,261,9,1303,1
26086,19,295,1216,200,9263,95
27333,29,1058,1188,629,7623,429
4637,8,165,1522,121,13648,44
59749,16,157,475,126,8996,31
26356,20,572,1210,374,10593,198
8080,2549,162852,1479,86712,334198,76140
7001,256,7946,1492,5419,43508,2527
69534,49,644,163,558,10223,86
5866,870,33112,1507,20608,182775,12504
50069,159,2511,767,2044,45930,467
1058,2,242,1556,175,22012,67
61442,50,478,414,348,6183,130
50057,3,113,768,91,6146,22
67077,370,4704,250,3681,32614,1023
52584,7,103,696,82,15067,21
51202,263,3644,738,3184,22450,460
32710,83,1310,1089,851,15815,459
17371,167,4304,1376,2934,49290,1370
40710,46,515,919,408,4760,107
67087,97,1356,250,1122,18747,234
4689,18,904,1521,680,18599,224
31035,24,842,1115,490,9941,352
44596,9360,151157,863,97622,524289,53535
1309,44,1473,1554,1060,24851,413
28218,41,742,1170,525,26042,217
5128,113,3304,1515,2401,24022,903
24527,19,820,1250,563,20834,257
10259,20,675,1468,461,9468,214
25495,1374,26506,1229,18505,91311,8001
70575,7,124,134,111,2871,13
34518,56,3136,1054,2141,30426,995
66820,68,806,258,628,20011,178
13412,144,3654,1436,2232,18751,1422
16971,97,2846,1383,1898,49663,948
31493,64,1797,1108,1319,17534,478
10663,313,10650,1465,6532,102995,4118
30062,2797,51225,1134,36613,222706,14612
17065,67,1346,1382,1020,31506,326
30553,44,1602,1124,1093,26757,509
45443,46,583,853,439,8309,144
32993,67,859,1084,606,6110,253
3559,3,163,1535,118,17957,45
21395,0,0,1304,0,7293,0
68047,15,167,219,124,4294,43
34248,9,208,1060,156,2144,52
21265,15277,280389,1307,175144,591529,105245
28021,6,150,1173,126,23670,24
66360,12,107,274,65,2828,42
29205,20,617,1151,404,9261,213
7453,45,2535,1486,1473,40822,1062
5813,34,887,1507,593,12482,294
4127,18,603,1529,405,12607,198
17686,6,225,1370,173,13807,52
64023,79,3008,339,2133,26169,875
29056,24,1102,1154,671,14040,431
25149,22,750,1236,647,16681,103
13034,49,1831,1441,961,22641,870
60449,50,369,450,254,4445,115
64026,79,3660,339,2441,23701,1219
36476,20,347,1004,304,9629,43
3487,75,4718,1536,3344,52319,1374
18442,7,471,1356,295,6184,176
22304,14,1047,1292,680,8588,367
8152,29,965,1478,685,13356,280
34979,16,535,1042,365,5407,170
26568,756,19453,1205,11326,102730,8127
63830,3,69,346,47,2355,22
67145,178,4059,247,3069,25621,990
40660,1,110,920,92,4199,18
4230,15,374,1528,303,12295,71
25123,11,398,1237,283,18229,115
54773,43,487,625,380,7608,107
40451,248,5083,922,3485,24353,1598
25003,40,950,1239,657,11244,293
7162,25,765,1490,460,14931,305
4782,30,1811,1520,1256,22001,555
24401,30,580,1253,378,14307,202
34210,13,529,1060,383,17684,146
38344,2373,33597,950,28219,218865,5378
12837,12,449,1444,228,6389,221
3806,392,24673,1532,15306,168811,9367
63556,452,6771,354,5222,24126,1549
40970,552,12854,914,9994,58634,2860
18460,4,212,1356,170,5481,42
30446,108,1288,1126,929,18563,359
62088,13,87,393,68,3437,19
64759,739,27335,317,21568,101230,5767
66511,74,984,269,762,8132,222
41177,27,383,911,277,6726,106
51148,842,12240,739,10054,55257,2186
32356,3,89,1095,61,4871,28
27323,6,123,1189,110,12009,13
56221,103,1603,584,1341,20447,262
25512,12,156,1229,111,3147,45
67914,9,157,223,104,4083,53
29019,105,1904,1154,1249,21682,655
31559,55,3677,1108,2402,45069,1275
58275,5336,92212,524,67056,331092,25156
62184,55,899,389,683,13338,216
10734,12,260,1465,179,4936,81
55926,6,33,592,29,4327,4
19395,52,1585,1340,1073,15290,512
746,12790,287583,1558,169359,521013,118224
66404,233,3643,272,3063,21841,580
22989,115,3733,1280,2596,66902,1137
23160,39,2230,1277,1587,42473,643
21409,0,0,1304,0,5705,0
24322,3,145,1254,103,6846,42
65953,176,1801,285,1483,11322,318
3305,26,1048,1537,812,9823,236
50899,6,62,747,43,3277,19
52507,56,1043,698,779,19450,264
37294,17,213,983,165,5521,48
21440,46,1481,1303,922,36036,559
5427,5,366,1512,250,8253,116
24290,1110,21498,1255,15257,49656,6241
9857,919,38970,1470,27945,249550,11025
23913,2505,53606,1264,33374,267426,20232
32329,4866,201688,1096,137331,915122,64357
40820,35,841,917,647,10532,194
52531,35,447,697,361,7555,86
69196,7,104,180,96,5601,8
69661,2,9,165,9,1336,0
61048,210,2047,428,1725,14293,322
7207,69,2622,1489,1704,19264,918
4604,27,1017,1522,610,15024,407
18071,12,497,1363,349,7552,148
65918,28,566,286,387,10956,179
109,9,508,1565,353,6689,155
13363,743,23091,1436,13160,181442,9931
62149,771,16045,390,13259,86747,2786
69014,5,171,186,140,4289,31
3788,858,55303,1532,32321,219883,22982
39492,21,223,936,170,3552,53
59057,151,1793,499,1404,7922,389
2057,301,24915,1549,16387,171385,8528
400,465,19452,1561,11127,64766,8325
58765,100,1771,508,1440,13936,331
33480,9,275,1075,177,7708,98
25989,143,4070,1218,2545,20805,1525
652,56,7690,1559,5230,52147,2460
27275,29,1380,1190,812,13970,568
60183,25,338,460,244,8061,94
25439,1329,24266,1230,17356,152733,6910
69307,208,2646,176,2263,33828,383
11010,532,18900,1462,11145,108000,7755
13151,24,1778,1439,991,12686,787
58600,5,68,513,42,3604,26
2394,412,12235,1546,8281,99385,3954
17277,14,1215,1378,764,12596,451
52833,441,5474,687,4443,91833,1031
18518,19,580,1355,436,15377,144
28241,42,1076,1169,697,15828,379
47996,2,91,822,70,6317,21
10460,1063,19797,1467,14096,54688,5701
51114,8,138,741,119,11268,19
62581,163,1982,378,1564,25664,418
38677,918,13463,947,10414,66878,3049
69753,150,1726,162,1446,26685,280
10375,66,2000,1467,1216,45199,784
56143,13,169,586,125,8526,44
59474,56,656,484,539,21023,117
33674,2305,56075,1071,38794,273386,17281
10282,7,345,1468,208,10210,137
48052,221,2760,822,2123,35789,637
5458,330,13126,1511,8308,66183,4818
44282,31,683,866,556,13516,127
13390,42,2187,1436,1291,23594,896
6647,6,277,1497,187,12069,90
22718,25,2177,1284,1374,26564,803
26247,207,4889,1213,3332,69523,1557
37415,238,6648,980,5541,118318,1107
43833,1650,26263,871,20353,145081,5910
18820,3177,86741,1350,55569,362867,31172
59650,173,2783,478,1397,28161,1386
29272,15,518,1149,311,7196,207
6356,233,13767,1501,8495,82512,5272
33466,394,8269,1075,6180,56709,2089
57992,37,442,534,358,22018,84
67906,19,207,224,173,2990,34
32021,1,65,1100,41,8618,24
9555,696,12421,1472,8218,80286,4203
28175,6,545,1171,309,10108,236
10175,29321,960653,1468,640673,2322330,319980
18503,17,1121,1355,735,14054,386
12655,65,2515,1446,1529,43836,986
66781,2,34,260,22,1081,12
13182,51,1795,1439,1089,11890,706
67515,37,546,236,395,7824,151
32516,254,6115,1092,4187,65680,1928
55927,115,1344,592,1120,22321,224
2459,406,10861,1545,8095,103330,2766
30497,26,646,1125,450,4715,196
3526,34,825,1535,620,21214,205
20717,2,264,1317,191,4324,73
17094,64,2340,1381,1790,35933,550
67362,35,447,228,398,8339,49
29229,0,0,1150,0,7849,0
12395,229,9482,1449,5530,32719,3952
17997,40,610,1364,457,7138,153
30866,437,9239,1118,6871,51129,2368
12552,316,10377,1447,6106,63601,4271
21547,41,789,1302,605,18191,184
1387,623,23145,1554,14562,356937,8583
65124,22,231,305,206,5268,25
16750,194,3504,1387,2275,24790,1229
40347,25,433,924,373,9350,60
67787,2,11,227,7,2304,4
30967,31,973,1116,685,10423,288
37773,95,1707,970,1207,21319,500
23512,528,29174,1271,16562,78607,12612
30210,24,553,1131,411,7217,142
31529,23,1087,1108,668,10586,419
32501,19,221,1093,126,4891,95
25331,736,18366,1232,12817,112868,5549
58359,1237,13981,521,10317,60426,3664
36334,26474,620784,1008,485010,1626378,135774
3439,93,5624,1536,3504,89498,2120
69070,286,2750,184,2238,12156,512
66723,977,16246,262,13170,150724,3076
27810,4328,74947,1178,45295,305497,29652
26468,1337,26264,1208,14734,156750,11530
26264,49,1280,1212,836,9847,444
9233,14,444,1474,262,11142,182
67839,26,239,225,189,6995,50
51319,1656,35824,735,21984,280328,13840
59936,420,8659,468,6698,76756,1961
19659,5,285,1335,191,19859,94
23591,68,2036,1270,1571,26883,465
660,617,16154,1559,10500,63786,5654
33879,474,9499,1067,6949,76425,2550
40874,180,2361,916,1817,19172,544
24595,256,8837,1248,6146,90431,2691
53682,5,66,663,56,3750,10
15932,3,116,1400,63,5678,53
751,125,8518,1558,6216,102566,2302
45353,81,845,854,700,20989,145
22556,11,317,1288,248,12845,69
63985,10,229,340,185,4843,44
43143,202,1196,879,880,14317,316
34913,748,18139,1044,13366,166628,4773
10447,5,164,1467,110,7327,54
22541,21,627,1288,448,7621,179
51585,123,1864,728,1486,24741,378
25904,17,477,1220,310,12312,167
63037,1,29,367,23,3153,6
58661,11,111,511,71,3143,40
63925,4,94,342,85,6563,9
54677,89,542,628,476,6474,66
27328,9,472,1188,307,25294,165
70419,4,68,139,63,2423,5
51687,1,14,725,14,1689,0
10194,1140,25191,1468,14126,83952,11065
56699,442,7169,569,5946,67243,1223
32237,2529,54576,1097,39155,261192,15421
42740,1,102,885,81,6490,21
9201,10163,309054,1474,191334,793219,117720
57940,0,5,535,4,2264,1
59842,136,1973,472,1383,22419,590
32827,23,523,1087,341,8014,182
54506,221,3444,635,2916,43584,528
31002,1919,35774,1116,23388,215164,12386
14635,74,1495,1418,919,16354,576
32290,53,1122,1096,823,13367,299
53412,421,5077,670,4023,39269,1054
24311,141,3485,1255,2209,21307,1276
384,33,1914,1561,1293,20127,621
39203,43,482,940,394,12412,88
40199,38,1053,926,833,10477,220
6910,13,201,1494,138,5619,63
19105,21,1086,1345,829,25339,257
33288,13,199,1078,165,5903,34
68604,2,34,200,26,1180,8
10393,6,250,1467,179,7414,71
31543,85,2761,1108,1911,67922,850
60899,10,57,433,43,5547,14
9967,10,388,1470,246,12457,142
18180,2366,47919,1361,31724,149843,16195
35167,14,300,1038,215,5775,85
67780,10,171,227,145,5226,26
29911,0,360,1137,223,6670,137
8002,16,925,1480,724,17451,201
14756,4,234,1417,180,7200,54
24771,13,867,1244,598,8379,269
38889,30,719,944,571,11981,148
55934,193,2785,592,2150,27783,635
19719,37,1625,1334,1212,38873,413
38565,20,398,949,298,3898,100
28665,108,1766,1161,1228,15305,538
30169,256,7912,1132,4990,24377,2922
55555,27311,681107,601,429414,1807573,251693
29720,238,5502,1142,3705,32458,1797
57301,147,2369,553,1762,28870,607
64716,142,3626,318,2966,32081,660
59999,156,1729,466,1387,12818,342
55344,61,876,608,663,8286,213
1920,151,6556,1550,4462,141860,2094
41076,38254,1156796,912,705159,2273530,451637
21431,226,5553,1304,3870,62118,1683
15582,89,1279,1405,810,14029,469
36496,12,259,1003,202,6879,57
69350,5,42,175,27,1988,15
11011,352,8865,1462,5186,51821,3679
36063,4,131,1013,119,9284,12
23815,36,1021,1265,772,25143,249
6169,10,384,1503,239,6747,145
15880,235,9273,1401,6299,130429,2974
30511,6,378,1125,214,8565,164
55966,89,1043,591,740,12209,303
54585,15,227,632,179,11006,48
23690,293,5019,1268,3776,33081,1243
39184,43,1520,940,1128,27693,392
13213,0,0,1439,0,6056,0
51855,10,194,720,164,3513,30
28820,33,524,1159,471,23203,53
62293,43,1033,386,713,18243,320
17491,10854,198778,1374,118031,440872,80747
60218,68,789,458,690,22478,99
33813,29,657,1068,471,13450,186
9602,25,1032,1472,639,13255,393
16754,364,10088,1387,6405,44981,3683
2199,17,380,1547,284,58169,96
16852,170,6003,1385,3859,29425,2144
27781,5,361,1179,243,16523,118
12502,207,5907,1448,3591,41598,2316
11373,18,1153,1460,639,17552,514
28009,202,4320,1173,2939,25284,1381
25709,700,22736,1224,14791,145782,7945
54011,52,854,653,677,14111,177
12490,0,0,1448,0,6968,0
17820,322,9442,1367,6424,103626,3018
20054,3174,97843,1328,63071,311365,34772
54902,32,362,620,280,9839,82
12615,13360,350882,1447,218636,993580,132246
16759,149,5417,1387,4037,51739,1380
7214,74,1703,1489,1176,36235,527
67683,53,667,231,489,6429,178
60916,1169,22815,431,17694,100440,5121
51911,8,290,719,225,13606,65
47296,41,1109,831,844,31398,265
15919,380,15937,1400,11917,49543,4020
7144,5,209,1490,129,13601,80
64826,18,251,315,214,9577,37
37577,1,12,975,9,3855,3
69525,0,24,170,21,2045,3
2998,421,10045,1540,5910,33353,4135
17301,14,545,1377,412,9974,133
30095,149,2025,1133,1227,15922,798
66204,9,176,277,132,3157,44
50329,954,13989,761,10888,91333,3101
7570,6,85,1485,58,3845,27
42865,173,2022,883,1469,17959,553
33516,21,454,1074,306,7782,148
8051,7,275,1479,196,11932,79
43581,24,440,873,294,5737,146
63883,0,24,344,14,2055,10
67660,58,962,231,680,13465,282
19340,4914,87968,1341,59700,253778,28268
24689,115,2047,1246,1361,29224,686
21656,1490,36215,1300,25380,259315,10835
67405,21,352,240,268,4884,84
65777,807,17183,290,14164,100106,3019
23456,52,1000,1272,703,20687,297
47191,52,816,832,609,21586,207
41021,36,715,913,574,40854,141
24793,4,198,1244,127,11565,71
37397,17,229,980,194,6149,35
35205,13,326,1036,259,7873,67
52154,1,97,710,49,6102,48
15977,27,974,1399,692,6388,282
65410,16,229,299,189,8239,40
1498,34,671,1553,527,43784,144
37739,23,627,971,505,27788,122
62406,177,6258,381,5183,29474,1075
42158,7,257,895,176,8513,81
66566,15,227,266,171,9138,56
29709,1,100,1142,61,4761,39
31219,334,8576,1112,5517,50845,3059
13707,59,2509,1432,1351,22097,1158
20474,40,673,1321,473,15919,200
33162,7811,192432,1079,144352,890215,48080
38181,10,135,960,104,2328,31
6252,21,946,1502,597,29458,349
27967,7,351,1174,204,5244,147
37304,137,3709,983,3280,34082,429
37454,29,482,979,367,9461,115
63047,32,281,367,200,3267,81
50514,6,102,756,79,8128,23
59397,71,679,487,523,4279,156
29446,178,3304,1146,2436,104309,868
61565,14,211,411,137,3008,74
47212,114,2810,832,2258,23233,552
22215,2,124,1293,89,4694,35
34016,57,1085,1064,590,26830,495
49378,4,27,785,25,2564,2
19950,3,121,1330,92,12131,29
66021,528,10799,284,8836,74322,1963
21821,86,4407,1298,3238,33708,1169
26320,115,4056,1211,2317,20694,1739
4819,465,12451,1519,8198,204971,4253
49609,34,469,780,369,20144,100
60679,45,623,441,518,11760,105
43210,89,3361,878,2593,34747,768
12154,18,781,1452,446,15055,335
54218,308,2505,642,2039,37080,466
22278,34,712,1292,528,20196,184
2094,235,8141,1548,5511,101082,2630
27347,14,508,1188,311,24605,197
37439,50,1001,979,780,17508,221
59286,96,1620,491,1224,17868,396
20899,32,864,1313,611,12666,253
9412,9,348,1473,211,7740,137
69972,25,473,155,461,4992,12
33607,137,2371,1072,1645,20626,726
31372,19,537,1110,358,11511,179
68333,0,7,210,6,1211,1
58637,246,2885,512,2280,21305,605
18141,6,254,1362,216,40315,38
41333,77,1440,908,1171,18456,269
48678,28,437,807,358,8299,79
34368,877,9229,1057,7603,112495,1626
68795,1,16,193,14,5582,2
66784,17,383,260,300,11386,83
27657,133,1837,1181,1116,31394,721
56504,25,456,575,226,3783,230
26803,84,1927,1200,1177,24555,750
30825,5,255,1119,138,4640,117
15901,3,164,1400,119,13164,45
27199,13,574,1191,368,16043,206
27628,83,2947,1181,1749,21301,1198
69147,1,57,181,42,1458,15
5828,962,57336,1507,35362,315941,21974
15446,48,973,1408,683,12123,290
65393,875,19643,298,15523,118283,4120
6438,4,166,1500,101,17014,65
61078,29,643,426,557,6562,86
49045,171,2458,796,1612,20630,846
30804,701,10985,1119,8238,32670,2747
26500,124,3241,1207,1931,18211,1310
67540,36,339,235,268,3866,71
7707,547,24129,1483,15723,85246,8406
30851,43,1492,1118,950,10550,542
5734,55,1582,1508,1053,13720,529
19037,749,36648,1346,23308,181185,13340
22324,231,3991,1291,2736,26763,1255
66936,4,153,255,112,2518,41
467,211,10646,1561,7115,67642,3531
4066,57,3911,1529,2591,49557,1320
5330,22,1345,1513,1007,22899,338
29738,116,2509,1141,1601,28011,908
56599,529,11949,572,9079,51523,2870
6662,4,78,1497,52,6163,26
20420,73,3353,1322,2380,36048,973
37986,0,29,965,22,2383,7
33609,249,4843,1072,3475,57514,1368
17140,1739,35709,1380,24164,148611,11545
35322,150,2488,1034,1975,37637,513
57452,20,264,550,217,5466,47
44086,22,473,868,398,28657,75
61582,89,1700,410,1381,22436,319
29327,3,200,1148,120,4639,80
5543,7,278,1510,187,9756,91
10630,107,4180,1465,2542,41739,1638
66271,36,409,276,327,3722,82
32121,8,177,1099,118,9177,59
35901,33,532,1021,428,13037,104
70351,11,316,143,256,3590,60
38310,277,3547,957,2669,16388,878
27516,9,483,1184,285,19259,198
2149,23,668,1548,458,17556,210
43221,8873,513619,877,370398,608663,143221
6038,18,1107,1504,783,35649,324
32183,46,1676,1098,1110,20894,566
61639,264,3361,408,2944,11063,417
15994,196,8461,1399,6436,81377,2025
12368,20,880,1450,512,18521,368
19296,65,1795,1341,1089,39526,706
36724,4,88,999,70,16062,18
57595,13,280,546,213,3163,67
26119,11,448,1215,286,24296,162
23443,11,301,1272,212,9770,89
55459,29,340,605,274,7697,66
28402,16,609,1166,386,36313,223
37017,263,6984,991,5506,58562,1478
24698,188,5627,1245,3702,41889,1925
27247,343,5707,1191,2939,61881,2768
2182,643,36832,1547,22153,148173,14679
52116,34,410,712,288,11300,122
49997,75,830,769,581,10636,249
19311,119,4648,1341,3117,57809,1531
46509,79,942,841,661,9320,281
52804,85,1039,688,817,15670,222
21740,14,505,1299,294,7143,211
20382,123,5843,1323,3864,55993,1979
12073,35,2231,1453,1039,24433,1192
66485,13,225,270,148,3841,77
13674,57,2237,1432,1372,29065,865
7075,75,2125,1491,1522,51742,603
27198,435,17695,1191,11872,103810,5823
15589,319,4552,1405,2972,51739,1580
15731,21,575,1403,395,10797,180
19305,411,8916,1341,5747,99856,3169
7444,8,905,1486,637,47631,268
13607,505,13671,1433,9302,162691,4369
41328,13,319,909,241,7027,78
5791,43,811,1507,571,19984,240
37383,68,1489,981,1179,23803,310
4325,4,731,1526,531,29144,200
38450,11,168,952,134,6157,34
17705,79,3330,1370,2340,33661,990
25199,170,8318,1235,4820,43470,3498
67508,10,84,236,72,2448,12
24569,16,407,1249,283,9029,124
3543,120,6186,1535,4536,33409,1650
42223,193,3889,894,2971,68580,918
23406,60,1453,1273,1088,18297,365
29215,49,1436,1151,1086,10643,350
18383,80,2314,1358,1462,24813,852
43950,41,378,869,297,9915,81
57085,15,418,559,332,7755,86
12748,63,1765,1445,993,12685,772
58646,443,5579,511,4506,87756,1073
523,513,13628,1560,9264,98371,4364
25521,100,1875,1229,1138,23623,737
66313,44,764,275,620,3545,144
30121,2460,35188,1133,25584,125189,9604
57473,6,92,550,71,4571,21
50506,7,117,756,85,5296,32
37221,6,199,985,166,5095,33
15021,181,5094,1414,3345,51915,1749
62906,355,3870,369,2928,37365,942
67317,11,152,242,114,2606,38
65273,30,324,302,263,3498,61
55653,39,448,599,368,7676,80
57680,37,362,544,282,6295,80
58281,48,1003,524,793,17608,210
28579,104,4941,1163,3152,43513,1789
26526,555,14723,1207,9568,106630,5155
32900,259,3311,1086,2291,16367,1020
56429,4,120,577,97,9719,23
5634,39,1017,1509,790,24972,227
67305,479,4608,242,3697,28904,911
69334,3,41,175,38,1902,3
53250,52,498,675,404,7358,94
33421,142,3052,1076,2148,16425,904
10170,2224,63509,1468,41047,214453,22462
29364,14,282,1148,198,9536,84
69343,7,73,175,60,1211,13
6461,218,9813,1499,5904,175236,3909
61105,2,40,425,16,6773,24
1798,73,2236,1551,1562,17109,674
40640,1267,41096,897,32723,206498,8373
1488,14,307,1553,216,8007,91
23280,54,1066,1275,698,15431,368
13903,257,9179,1429,4724,45970,4455
12128,127,4572,1453,2414,38599,2158
12647,1860,58082,1446,39913,228010,18169
34798,22,332,1047,236,4462,96
30339,2659,47015,1128,34319,189753,12696
26129,746,14296,1215,8684,187383,5612
49820,24,434,774,301,5390,133
69716,3,78,163,64,1139,14
2922,47,3851,1541,2336,59891,1515
7545,2,164,1485,126,8491,38
7170,16,298,1489,205,11181,93
1654,150,4002,1552,2933,24532,1069
4376,185,5239,1525,3641,71757,1598
36091,4,87,1015,77,10779,10
54009,409,4490,653,3538,60688,952
31591,3497,93055,1107,60456,241736,32599
49164,124,2245,792,1702,28224,543
1908,37,3040,1550,1988,66992,1052
49249,2,16,789,13,2248,3
21934,68,1820,1296,1089,11155,731
20809,479,12338,1315,8743,120538,3595
10295,5,234,1468,167,22274,67
64544,28,341,323,258,4985,83
20363,22,680,1323,458,13099,222
17328,54,689,1377,494,12625,195
24136,56,1297,1258,840,19960,457
62874,2,41,371,33,3324,8
57451,100,1576,550,1399,43317,177
8967,13,1133,1475,740,13421,393
11134,116,4915,1461,3111,34542,1804
54432,342,3943,638,3318,42116,625
26392,62,2608,1209,1492,14296,1116
61800,11,120,403,93,6345,27
65030,94,732,307,617,11166,115
31065,39,1743,1114,1165,13134,578
23672,4,175,1268,152,12974,23
31549,524,9097,1108,5942,45492,3155
66495,47,435,269,367,9192,68
13179,170,6560,1439,3484,82511,3076
19287,16,357,1342,294,12466,63
48744,41,639,805,457,6702,182
59732,21,156,475,127,2727,29
46511,10,153,841,109,10199,44
42900,22,447,883,321,14139,126
59,36,1079,1566,809,23726,270
66369,7,231,273,188,4998,43
48639,9,210,808,170,9860,40
30026,5831,110840,1135,73732,247343,37108
37964,12,241,965,202,8104,39
23585,248,4216,1270,3179,33392,1037
31211,80,1086,1112,762,12131,324
2498,125,3168,1545,2268,47765,900
6931,75,8517,1493,5215,49701,3302
17485,4,147,1374,107,6639,40
69771,17,241,161,199,2195,42
16515,24,545,1391,387,13605,158
3243,295,10959,1538,7338,96368,3621
24225,7,252,1257,211,22347,41
15146,278,7358,1412,5123,40061,2235
40030,2,84,929,76,7472,8
7752,315,15052,1482,9429,85297,5623
528,385,15277,1560,10445,117887,4832
3772,38,917,1533,685,13848,232
58488,258,12241,516,9948,87294,2293
59165,22,207,495,169,8558,38
54143,260,1981,648,1530,16727,451
64908,38,519,312,412,12842,107
49091,302,3321,794,2433,23748,888
34861,5,319,1045,273,15849,46
68406,3021,101432,207,63479,545487,37953
51823,790,18524,721,14876,68766,3648
22179,9,581,1293,416,27602,165
60717,28,432,440,293,7761,139
31182,115,2076,1113,1403,18625,673
48211,121,1615,818,1322,28861,293
50338,46,441,761,347,7074,94
61947,104,935,397,757,10251,178
61312,6,78,418,62,4851,16
29089,623,13764,1153,9670,75455,4094
19496,15,587,1338,466,15294,121
68157,9,143,216,129,3210,14
38413,139,2565,954,2092,23137,473
2875,2849,81194,1541,45373,137466,35821
28012,330,8635,1173,5769,93416,2866
37676,170,6331,973,4718,30070,1613
28575,150,3037,1163,2074,12440,963
55277,30,332,610,250,6759,82
32813,2197,44266,1087,33191,184931,11075
44708,28,493,862,397,30756,96
69116,12,182,182,140,2751,42
21180,12,366,1308,329,24236,37
25574,297,8751,1228,6088,434486,2663
19473,131,4175,1338,3029,117330,1146
59003,4,77,500,61,4756,16
68779,7,151,194,112,2412,39
60122,1106,19038,462,12819,81332,6219
66358,11,209,274,166,2916,43
23778,4,598,1266,323,11265,275
55634,2,58,600,51,5743,7
19530,36,1643,1337,1185,67070,458
67136,19,141,248,123,9054,18
56564,1689,32164,573,24159,179354,8005
27177,42,1859,1192,1199,27010,660
31278,290,6110,1111,4581,44149,1529
26826,1922,52521,1199,31029,294824,21492
19101,62,1179,1345,805,19079,374
41072,132,2568,912,2005,49454,563
50471,10002,132479,757,83042,448436,49437
709,32,1855,1559,1280,53370,575
5592,3,326,1510,217,16914,109
63062,18,281,366,225,5840,56
68896,671,9967,190,8640,33243,1327
60289,95,1447,456,1167,21301,280
35694,23,681,1026,479,7784,202
21774,134,2962,1298,2021,22285,941
7677,10,663,1483,485,12008,178
1716,4,197,1551,135,20462,62
14965,51,753,1414,515,11466,238
8954,3895,103919,1475,59695,294780,44224
7792,99,3872,1482,2558,44719,1314
62366,55,710,384,574,11783,136
13965,102,2868,1428,2179,41026,689
3979,1987,64315,1530,40045,271160,24270
40354,7,83,924,66,2663,17
17906,58,2682,1366,2030,40943,652
64473,207,3534,325,2659,25963,875
11049,733,46645,1462,26519,167451,20126
47704,249,3289,825,2626,33197,663
14681,24,722,1418,518,19410,204
57557,32,273,547,226,6271,47
57356,34,823,552,508,21115,315
15904,49,2304,1400,1611,23213,693
66503,120,2011,269,1742,16841,269
8029,259,7817,1479,5185,127100,2632
53157,26,204,677,173,5565,31
60841,170,7054,435,5216,45147,1838
10079,132,5787,1469,3438,57544,2349
8861,24,1993,1475,1260,48095,733
6131,216,6553,1503,5075,82324,1478
3823,258,17798,1532,9958,72496,7840
39804,2,76,932,56,5105,20
53900,0,281,656,228,12678,53
17207,67,1652,1379,1346,17040,306
3729,451,25697,1533,16745,195594,8952
69477,23,440,171,374,8117,66
36340,2,184,1008,141,5690,43
25085,17,403,1237,336,13362,67
10820,62,3212,1464,2149,15186,1063
30192,198,4372,1131,3776,50847,596
63592,45,687,352,537,12211,150
27551,13,264,1183,171,17484,93
31830,398,12457,1103,8920,104909,3537
48619,43,499,809,378,12922,121
60125,97,661,462,498,9015,163
12406,0,0,1449,0,27065,0
3537,6,130,1535,90,12781,40
38190,15,168,959,133,4970,35
31902,74,1746,1102,1318,40476,428
5394,19,593,1512,407,10960,186
25869,2285,66333,1221,42011,395530,24322
4102,389,12805,1529,8582,101929,4223
17111,15,376,1381,242,13077,134
69635,100,2361,166,2068,32156,293
53059,797,13667,680,10231,33384,3436
61680,112,1157,407,902,9637,255
68987,22,534,187,430,6625,104
53390,50,1895,671,1533,13552,362
47243,7,307,830,224,6406,83
50913,2,54,747,41,2003,13
68589,15,235,200,193,6014,42
50642,88,1452,753,1074,19740,378
28114,294,6234,1172,4393,41225,1841
23237,2,101,1276,78,5195,23
58769,114,1442,507,1227,14362,215
33951,377,5695,1066,4722,24812,973
43991,4,70,870,56,4680,14
17940,8,163,1365,122,12502,41
68700,17,401,197,371,10947,30
53367,20,236,672,176,9679,60
6266,13,973,1502,630,7042,343
14311,15,466,1423,352,23164,114
60155,712,17799,461,13303,82861,4496
37512,181,5862,977,3864,36806,1998
7795,5,230,1482,146,10207,84
33,579,12106,1567,7237,102237,4869
5430,6,167,1512,106,6191,61
12548,11,1017,1447,482,11599,535
41636,83,1054,903,911,34730,143
24253,4446,152475,1256,101274,592982,51201
61467,18,231,413,189,6342,42
15703,20232,982923,1404,688240,2379672,294683
60341,1,8,454,7,1208,1
67664,48,710,231,563,12897,147
63731,420,6673,334,5503,52049,1170
68794,117,2597,193,2112,14181,485
65421,35,616,299,375,9229,241
29536,13,310,1145,284,15945,26
69490,32,491,171,402,9722,89
35377,19,343,1033,271,4985,72
18689,2559,44485,1352,29639,359647,14846
2932,131,6085,1541,4217,48883,1868
40043,1252,42080,929,30583,166340,11497
47104,73,666,833,520,7992,146
1127,32,1164,1555,769,26211,395
55384,11,182,607,144,8688,38
57228,87,955,555,697,9493,258
28340,5,351,1167,216,6073,135
9844,197,6344,1471,4130,37318,2214
22235,62,2359,1292,1564,40097,795
62200,19,203,389,160,5682,43
29456,27,534,1146,357,8181,177
3995,1,108,1530,67,6465,41
54212,668,13774,645,11060,63651,2714
60635,86,1669,443,1371,20296,298
166,303,12308,1564,6746,135955,5562
47043,18,147,834,115,5453,32
51466,2,59,731,37,13922,22
61162,15,115,423,91,4975,24
26835,885,18214,1199,15472,171000,2742
13996,6,174,1427,119,10815,55
18998,72,2783,1347,1927,54135,856
61957,17,194,398,140,4968,54
38534,1094,16041,949,12877,184879,3164
34502,118,3796,1054,2793,42666,1003
22562,1066,24837,1287,14786,74422,10051
1828,158,9514,1550,6788,44673,2726
31102,997,31826,1114,22744,160727,9082
56082,101,1400,588,1021,10992,379
50870,158,1249,748,970,14604,279
11620,24,591,1457,333,5953,258
40036,78,886,929,712,12029,174
23065,547,15518,1278,10119,62802,5399
10693,126,2746,1465,1749,32753,997
35802,12,225,1023,183,7258,42
64529,2,66,324,49,9352,17
31024,61,1531,1115,1066,25661,465
44078,400,6045,868,5121,63370,924
30400,5,220,1127,135,8023,85
58052,34,248,532,214,9223,34
8693,23,1336,1476,877,17117,459
240,347,26523,1563,18227,129333,8296
27413,1568,30421,1187,21556,147174,8865
38057,513,7755,962,6330,69743,1425
62797,294,5168,373,3969,29356,1199
29756,673,15619,1141,11373,34935,4246
67265,21,194,244,137,2677,57
22697,15,321,1285,206,7520,115
65440,28,340,298,260,9126,80
13820,57,771,1430,457,10433,314
63864,15,344,344,280,7329,64
14283,52,1722,1423,1118,39718,604
25656,2,83,1225,50,6466,33
20802,83,2698,1315,1888,17788,810
64022,33,554,339,418,9289,136
31389,304,8232,1110,5630,55262,2602
56203,34,323,584,253,3847,70
67622,0,40,232,30,2067,10
19206,577,17967,1343,12829,127594,5138
27669,277,4094,1180,2440,20611,1654
64038,143,1918,338,1611,27769,307
28543,170,4305,1164,2583,36664,1722
65148,4,14,305,12,2248,2
1497,226,3345,1553,1977,15045,1368
30618,5,91,1123,71,11758,20
3127,43,1274,1539,1002,12071,272
27433,21,625,1186,394,20306,231
38472,218,3285,952,2490,24976,795
51140,27,222,740,174,4558,48
35069,138,1731,1040,1270,13970,461
63604,43,478,352,359,7221,119
24296,1065,23757,1255,17078,199119,6679
8696,72,1238,1476,805,12048,433
31675,1733,36664,1106,25992,262059,10672
2939,38,1417,1541,1095,19003,322
68034,3,83,219,56,3066,27
64612,758,8701,321,7109,51749,1592
23938,0,0,1263,0,12983,0
61963,75,846,397,601,11412,245
9047,78,3100,1474,2113,32694,987
23960,17,793,1263,619,7569,174
2196,4,406,1547,264,27479,142
54971,362,7188,618,6659,54506,529
45268,71,1669,855,1046,13909,623
7688,9,471,1483,311,15431,160
64681,2,36,319,29,2841,7
59403,71,1004,487,726,26662,278
32438,29,869,1094,552,31097,317
50208,43,873,764,703,16394,170
70268,3,32,145,29,916,3
51208,422,7552,738,5864,93636,1688
10905,574,8007,1463,4767,26490,3240
12864,1271,68995,1443,38672,253319,30323
36057,272,8609,1016,6215,64863,2394
4659,14,413,1522,304,5835,109
54221,64,1214,645,905,13105,309
53628,126,1861,665,1365,28829,496
64888,4,88,313,57,5375,31
23548,544,36891,1271,23485,143268,13406
59987,24,461,467,363,9040,98
19014,307,11264,1347,7286,96812,3978
10099,34,494,1469,309,5465,185
30193,5,333,1131,198,4283,135
12356,89,1973,1450,1066,16432,907
54555,62,367,633,295,5589,72
59971,3,70,467,39,7875,31
782,20,568,1558,389,6593,179
36535,1192,18097,1002,14346,110575,3751
39471,164,2910,937,2365,28141,545
59069,26,332,498,280,4156,52
42243,474,8261,894,6743,70274,1518
38080,1,142,962,70,4618,72
8364,6,322,1477,208,12948,114
32799,56,1718,914,1356,34159,362
10573,8223,177802,1466,120980,551315,56822
60080,61,865,461,655,8304,210
70497,3,40,137,34,1115,6
18944,8,408,1348,317,12782,91
19232,0,0,1343,0,9178,0
20020,5525,114367,1329,72571,200429,41796
63703,6,142,349,125,12999,17
5658,43,733,1509,516,11974,217
29815,2359,43567,1139,25532,275147,18035
59556,667,16045,481,12846,97518,3199
57698,97,2965,543,2366,18910,599
61637,21,280,408,213,7034,67
1843,30,951,1550,669,19271,282
9727,15,671,1471,421,9242,250
9549,13,725,1472,397,11646,328
49614,920,19223,779,14378,94431,4845
64228,33,292,332,257,5823,35
36764,345,3499,999,2848,31956,651
58213,183,1259,526,1018,8452,241
26840,1056,33920,1199,20206,234158,13714
64726,32,439,318,310,5570,129
44577,8,160,863,113,7720,47
29512,2064,37246,1145,23358,100051,13888
21522,88,1978,1302,1327,23236,651
23134,192,4149,1277,2842,40040,1307
35480,77,2038,1030,1472,18316,566
1329,5135,207093,1554,132495,1024239,74598
18586,14,601,1354,483,8672,118
29188,187,3565,1151,2593,26601,972
38291,48,689,957,536,6811,153
19121,12,359,1344,278,12516,81
6491,8473,147425,1499,114115,581834,33310
65853,55,1106,288,877,16713,229
36376,97,2128,1007,1798,17090,330
48433,34,479,816,394,10526,85
27321,749,18933,1189,12814,67467,6119
68601,32,613,200,479,9159,134
64132,81,1273,335,1063,26964,210
34904,236,5260,1044,3670,104950,1590
54924,387,4031,619,3371,75324,660
14509,5646,95390,1420,64844,258521,30546
34035,321,4974,1064,3540,24025,1434
55834,84,727,595,604,15742,123
19731,1,59,1334,43,11223,16
50541,3,73,755,53,4053,20
64283,2512,62813,330,43773,318369,19040
70429,23,472,139,418,4563,54
17720,966,28142,1370,19693,153961,8449
31205,106,2368,1112,1466,12071,902
65005,3,64,308,53,3383,11
8508,37,1185,1477,716,12474,469
51001,219,3849,744,3029,27524,820
18813,24,1492,1350,1010,8911,482
12968,239,6635,1442,4109,103736,2526
2535,1437,71327,1545,42925,359132,28402
12297,58,3190,1451,2100,42087,1090
24582,6,317,1248,274,7098,43
68886,1,97,190,94,1969,3
19233,1443,37522,1343,26421,126320,11101
69576,2,29,168,21,1850,8
9312,94,2901,1473,1991,27241,910
52465,48,352,699,273,5271,79
27823,57,1339,1177,1016,13574,323
448,0,69,1561,43,8359,26
14821,86,2251,1416,1492,53270,759
52710,47,533,691,407,23994,126
3822,159,3880,1532,2490,20412,1390
70267,19,229,145,219,2184,10
9049,82,2359,1474,1580,17855,779
64837,111,1103,314,891,14400,212
35637,11,252,1027,192,3459,60
27955,4286,114255,1174,69754,697324,44501
20536,3,260,1320,196,5032,64
60834,46,819,435,473,19281,346
24391,173,5106,1253,3653,78014,1453
60799,186,4812,437,3659,33980,1153
32263,12,324,1097,219,13705,105
67824,57,979,226,830,11380,149
4538,12,389,1523,278,19578,111
29808,46,1748,1139,1182,24431,566
39024,88,1161,942,921,9768,240
34631,75,1498,1051,1075,10576,423
40384,12,318,923,233,8750,85
9229,1527,71477,1474,43607,259837,27870
13075,5,405,1440,195,16419,210
28966,52,2286,1155,1374,34476,912
64206,20,367,333,279,23759,88
65136,103,736,305,595,5389,141
52261,63,1198,707,821,24854,377
5238,5,341,1514,236,8715,105
58341,645,10377,522,8150,81230,2227
68313,4,32,211,20,1220,12
67856,4,104,225,50,2470,54
62321,0,3,386,3,1479,0
64927,109,1036,303,763,7003,273
17554,81,1977,1373,1349,19571,628
64739,28,482,318,372,19041,110
22923,68,1999,1281,1270,18804,729
33338,5,155,1077,121,9848,34
53852,2,28,658,23,5080,5
16587,51,3004,1390,2242,31687,762
61917,9,123,399,102,2412,21
66546,26,424,268,320,4048,104
27893,5,186,1176,126,14934,60
21344,792,15866,1305,10850,72085,5016
19069,1920,68376,1346,46002,293750,22374
45996,15,164,847,133,5932,31
25681,31,795,1225,563,17355,232
16857,240,11473,1385,7897,76903,3576
27884,17,874,1176,546,28930,328
49724,20,228,776,180,4669,48
69797,59,451,160,382,11933,69
35241,315,5179,1031,3905,43652,1274
29634,54,1147,1143,644,10265,503
42728,450,6691,886,5104,32070,1587
34855,55,1247,1045,789,12958,458
50421,28,431,759,197,34538,234
57534,165,1844,548,1602,13897,242
10715,19,621,1465,441,6748,180
22222,118,2772,1293,1819,17355,953
42776,39,1080,885,802,14901,278
18278,184,6910,1360,4392,49852,2518
28265,145,6551,1169,4895,66491,1656
31595,77,2620,1107,1820,37448,800
15332,126,3862,1409,2669,42156,1193
68282,25,346,212,280,6045,66
20067,55,2216,1328,1415,18916,801
21232,1659,43157,1307,28270,170545,14887
46914,0,0,836,0,4094,0
47371,33,732,829,573,19025,159
65667,53,714,292,556,10614,158
23812,13739,503942,1265,355695,1914917,148247
44952,2,70,858,52,10124,18
20292,95,3382,1324,2746,33173,636
10206,258,11974,1468,7272,55961,4702
31790,1,151,1104,106,6394,45
64740,0,2,318,2,2321,0
65090,42,1190,306,909,23237,281
4357,491,14022,1526,9702,86591,4320
28397,13,800,1166,443,10204,357
38550,104,889,950,654,15981,235
18692,2,109,1352,79,4918,30
46421,43,838,843,702,37374,136
2472,69,2205,1545,1544,55836,661
70422,279,5072,139,4881,61365,191
50320,823,11115,761,9484,101364,1631
29934,456,11061,1137,8308,85935,2753
29464,87,3458,1146,2362,28050,1096
33805,2,124,1069,74,36944,50
6452,86,2419,1499,1524,14430,895
37441,21,427,979,347,5738,80
61483,1383,16756,413,13718,107771,3038
40757,19,252,918,186,4195,66
7717,13,799,1483,573,39205,226
10126,336,10957,1469,7014,56221,3943
52271,23,207,707,158,7210,49
19824,0,60,1332,50,11981,10
34272,302,4156,1059,2993,41163,1163
52284,53,711,706,587,8612,124
34914,817,12194,1044,8789,74883,3405
4779,980,24295,1520,15695,136527,8600
18629,82,3501,1353,1894,56937,1607
55136,16,211,614,175,6191,36
6168,386,6997,1503,4674,31761,2323
16018,370,8072,1398,5050,26197,3022
37855,1137,21991,968,17856,134254,4135
57876,110,1959,537,1631,26888,328
60499,47,454,448,361,5527,93
33386,41,829,1076,572,15084,257
57437,98,1083,550,895,12700,188
50959,9,71,745,63,5411,8
3066,295,9696,1540,6891,103684,2805
38420,37,942,953,726,13647,216
32034,20,385,1100,235,8091,150
37305,81,1888,983,1596,46567,292
30574,96,2045,1124,1315,13185,730
68493,903,10583,203,8392,33907,2191
15610,122,3771,1405,2559,32382,1212
44921,152,2374,859,2016,30320,358
13033,13,784,1441,457,17488,327
68190,10,516,215,428,12465,88
26825,44,1808,1199,1141,32311,667
10210,6,304,1468,170,4413,134
55465,307,3729,605,3201,48950,528
38451,20,302,952,269,4897,33
51487,8,111,731,87,2547,24
58162,223,3469,528,2773,50819,696
63392,126,1201,358,948,12779,253
28209,23,941,1170,546,10063,395
53121,251,6020,677,4911,36701,1109
11244,1,149,1461,61,2713,88
21275,3,301,1306,198,8764,103
1404,2,258,1553,168,12074,90
15271,13,452,1410,285,19052,167
45751,177,2137,850,1489,15660,648
23798,2264,83705,1266,61669,166261,22036
61728,78,1354,405,1120,17218,234
59861,28,397,471,337,8830,60
70589,15,244,134,243,3706,1
10619,130,2622,1466,1753,23783,869
49616,339,4737,776,3255,49435,1482
3020,14,1383,1540,973,50460,410
21933,1788,27796,1296,16989,129197,10807
1128,69,1143,1555,854,20686,289
8042,966,40416,1479,25080,263655,15336
1768,2,305,1551,219,24750,86
23646,122,1497,1269,1234,35748,263
18919,1513,26563,1348,18268,132719,8295
31567,590,8231,1107,5859,49722,2372
36499,244,1482,1003,1077,18938,405
49581,90,1009,781,786,10006,223
15942,222,4945,1400,2831,27989,2114
65194,31,562,304,486,8363,76
15374,106,1647,1409,1254,60327,393
49323,254,2785,787,2182,35739,603
40766,3,84,918,67,4497,17
19961,1548,57094,1330,41142,320222,15952
10514,20,1026,1466,706,15883,320
50217,1175,22564,764,17222,76013,5342
66387,18,202,259,160,6002,42
9119,7,454,1474,317,10964,137
35419,44,496,1031,357,4894,139
48510,103,1136,812,914,12927,222
2602,24,987,1544,685,48342,302
8114,47,1417,1478,908,15878,509
32478,22,1163,1093,882,11427,281
19415,69,1132,1339,743,17391,389
11506,92,4349,1459,2501,38191,1848
15597,19,589,1405,365,19230,224
40732,93,1043,918,838,18483,205
14380,3705,118112,1421,78027,608133,40085
40394,27,277,923,195,4152,82
9419,98,3064,1473,1913,24260,1151
68632,8,105,199,84,3106,21
24603,300,7849,1248,4822,44865,3027
57850,23,418,538,320,9887,98
38486,33,537,951,416,10309,121
60145,120,1808,461,1424,12001,384
12124,124,2609,1453,1631,8976,978
67479,334,2247,237,1984,16175,263
69699,13,161,164,145,3191,16
25653,124,3253,1225,2019,30032,1234
36913,6881,115513,963,85604,439928,29909
41253,288,3605,910,2927,21953,678
65044,2256,33720,307,26754,193878,6966
22885,1092,29119,1282,21550,172325,7569
17433,133,1972,1375,1474,20523,498
49784,23949,455377,774,295635,1827830,159742
11458,68,2024,1459,1348,18514,676
12159,7,303,1452,166,6675,137
4213,30,1319,1528,888,38568,431
8558,17,642,1477,414,10858,228
18554,32,557,1355,408,12021,149
13548,351,6884,1433,4671,44836,2213
21650,764,35146,1300,22265,169721,12881
6968,30,803,1493,560,10271,243
59693,6,86,477,64,2352,22
10916,0,22,1463,17,8887,5
17746,11494,758884,1369,415294,1886518,343590
48847,200,2484,802,1933,32837,551
60735,23,701,439,364,8046,337
32869,14,380,1086,243,13836,137
36828,48,611,977,531,11732,80
38283,174,2474,957,1859,24592,615
60409,7,351,451,124,4059,227
48583,61,1995,810,1616,9207,379
2201,244,9358,1547,6047,71373,3311
43281,1518,62229,877,49552,217319,12677
15878,4599,77863,1401,50054,322857,27809
34699,3,101,1049,66,3746,35
48334,167,6174,817,5017,66480,1157
11643,555,16054,1457,10355,104711,5699
9337,76,1453,1473,945,18174,508
45659,17,210,851,187,6889,23
20522,7,713,1320,549,10392,164
38512,286,3669,950,2952,25372,717
56160,88,1391,585,1129,16157,262
45652,58,790,851,622,13418,168
23976,51,919,1262,619,19128,300
6793,15,918,1495,435,8417,483
24369,193,4490,1253,3114,35688,1376
21380,176,5613,1305,4091,66552,1522
22408,28,707,1290,481,15083,226
58066,44,524,529,441,16487,83
12702,226,11094,1446,6535,158695,4559
70239,3,42,146,34,2624,8
55213,76,1336,611,1076,22063,260
27276,860,13778,1190,9693,56586,4085
10028,10,556,1469,312,9527,244
24210,84,2625,1257,1876,20524,749
55121,457,5701,614,4769,32282,932
27509,143,4227,1184,2541,86934,1686
28631,5,119,1162,81,14507,38
51179,103,1879,739,1375,31913,504
800,100,3903,1558,2281,20592,1622
56313,23,364,580,256,7321,108
32110,42,1026,1099,703,14331,323
5481,372,11826,1511,7704,89312,4122
9991,36,1121,1469,712,12214,409
29144,70,1836,1152,1152,10866,684
70435,10,118,139,108,4105,10
44377,75,1244,865,1012,17594,232
16440,98,3371,1392,2572,22351,799
16151,41,1389,1396,939,16555,450
32511,17,496,1092,302,7396,194
30383,74,1614,1127,1080,15178,534
65305,20,249,302,197,6180,52
11135,4415,120423,1461,67705,302345,52718
66844,12,229,257,180,5432,49
66690,567,14405,263,11282,85585,3123
26844,121,4316,1199,3007,80049,1309
4901,10,305,1518,228,25936,77
55476,13,144,604,100,12596,44
2247,27,599,1547,441,13327,158
12629,2975,104652,1446,58179,464921,46473
38093,0,19,962,16,7888,3
69720,8,135,163,119,5272,16
16275,10,520,1395,416,19028,104
24538,44,1635,1249,1080,42373,555
29570,134,3172,1144,1979,91763,1193
27407,692,12890,1187,9600,177707,3290
24314,49,965,1255,674,15344,291
59703,55,1014,476,745,12179,269
15843,10,164,1402,113,14394,51
9370,244,4819,1473,3023,74653,1796
53976,8,106,654,73,3400,33
52516,3858,86758,698,64626,447713,22132
14386,78,2976,1421,2015,46396,961
31081,75,1420,1114,914,16985,506
58121,206,3131,529,2442,18001,689
32184,40,1023,1098,593,8868,430
1159,66,3893,1555,2653,42529,1240
56091,43,614,587,415,7209,199
61979,310,7157,397,5386,38924,1771
22440,178,5395,1290,3997,31022,1398
24801,139,4827,1243,3189,59238,1638
27417,127,1834,1186,1189,18423,645
26760,53,1673,1201,1387,41272,286
52519,66,912,687,780,16637,132
60194,22,220,460,177,4571,43
10806,466,37159,1464,20869,77057,16290
25837,105,1968,1222,1259,16601,709
9558,2565,113883,1472,76987,265151,36896
30203,25,803,1131,584,6130,219
60884,70,467,433,419,19698,48
21850,198,4094,1298,2598,48096,1496
41375,1405,23144,908,15277,77131,7867
30171,240,7728,1132,5359,106904,2369
60431,8,144,451,70,6519,74
68099,15,105,217,92,3899,13
5694,2,323,1509,200,21194,123
2518,457,13252,1545,8754,73529,4498
58299,41,412,523,336,6715,76
23072,265,4105,1278,2602,37563,1503
11146,45,2100,1461,1296,36325,804
21512,1052,27208,1302,19923,142804,7285
52561,0,940,696,752,9428,188
396,20,663,1561,526,49715,137
56830,234,3493,566,2588,26122,905
4550,194,4791,1523,3130,72673,1661
70360,84,866,142,747,6087,119
16550,18,695,1390,512,9950,183
20825,60,1485,1315,1052,34651,433
19610,41,711,1336,525,12297,186
2184,8,96,1547,76,9476,20
40088,1049,26972,928,20358,173121,6614
68148,10,185,212,170,2541,15
64961,7,221,310,193,3992,28
2800,20,777,1542,463,17011,314
33076,14,336,1082,204,20578,132
29865,11270,227017,1138,151179,614092,75838
37023,5,38,991,29,3261,9
29955,72,1152,1136,771,30593,381
34480,344,6903,1055,5168,63579,1735
56932,1,22,563,15,2380,7
7163,601,10766,1490,7688,106788,3078
20945,140,6005,1312,4175,45904,1830
29649,1804,55508,1143,33631,258720,21877
23660,151,6886,1268,4569,36089,2317
26958,7,500,1196,298,7420,202
45021,278,3587,858,2755,30242,832
51856,19,251,720,205,5656,46
36760,31,427,999,331,20008,96
631,26,1172,1559,684,32157,488
57186,115,1304,556,997,19080,307
40781,67,1826,917,1586,26159,240
16591,47,560,1390,383,33341,177
52965,11,321,683,244,7441,77
68577,40,926,201,793,15862,133
36,453,10737,1567,4819,64997,5918
57784,59,1744,540,1398,15723,346
64492,2,56,325,49,2686,7
36483,7,211,1003,170,5814,41
65133,5,72,305,50,4717,22
49041,169,3218,796,2612,17614,606
50356,131,2107,760,1693,18781,414
69590,2,39,168,34,1486,5
6716,4,259,1496,163,13994,96
12058,411,18194,1453,11290,134417,6904
565,195,7851,1560,5589,53319,2262
35864,22,397,1021,346,12744,51
25612,203,5874,1226,3770,31708,2104
37655,192,3538,973,2474,17608,1064
28642,35959,1187986,1162,734949,1985546,453037
24765,83,2507,1244,1695,20916,812
63145,20,273,364,214,5524,59
15483,20,624,1407,461,38114,163
26289,277,6177,1212,3699,43318,2478
47953,486,9165,823,7210,103034,1955
47857,14,198,824,125,7681,73
13393,12,710,1436,397,26503,313
26141,8,137,1215,124,5614,13
64278,71,1246,330,1075,9383,171
12072,171,5756,1453,3643,34144,2113
31031,215,5576,1115,3940,22713,1636
31175,67,1402,1113,856,13568,546
18356,7,144,1358,123,14144,21
22733,658,22898,1284,13952,98638,8946
27386,10,176,1187,143,6408,33
1076,96,5914,1556,4216,33140,1698
57381,22,254,551,223,5460,31
32346,53,1913,1096,1329,37697,584
49962,51,520,771,408,11579,112
60412,2566,27542,452,20067,97443,7475
62718,0,26,374,22,3116,4
63955,17,370,341,318,5972,52
2653,2147,55830,1544,35451,149059,20379
17731,94,1093,1369,786,6964,307
64359,1,13,328,10,4091,3
15685,2,66,1404,43,3984,23
18565,33,2446,1355,1825,24314,621
33544,203,3046,1074,2204,23056,842
53168,40,392,676,303,13781,89
20018,549,13443,1329,8663,109660,4780
34891,24,537,1044,380,5598,157
14813,12,308,1416,212,12411,96
55335,0,96,608,68,5541,28
10103,30,1203,1469,818,22047,385
53407,143,1665,671,1283,19221,382
10843,6120,221840,1464,124023,723752,97817
20680,161,4013,1318,2587,31195,1426
56186,8,78,584,59,3995,19
22945,19,557,1280,389,6502,168
25293,23,703,1233,528,24718,175
64608,23,187,321,153,8651,34
30868,70,6835,1118,4366,32664,2469
61403,16,745,416,589,7806,156
41569,89,1134,905,817,14322,317
59854,2890,66614,471,53333,183893,13281
15775,15772,358280,1403,219163,1504776,139117
21184,1503,64294,1308,41243,331262,23051
30690,65,2794,1121,1723,15396,1071
32755,32,939,1088,584,9560,355
65515,30,213,297,171,5683,42
687,616,11734,1559,7459,71188,4275
4794,97,1641,1520,1147,20518,494
18677,15,401,1353,308,10836,93
24340,2124,53395,1254,33179,260278,20216
22710,658,11324,1285,6860,65680,4464
27429,98,3214,1186,2108,58999,1106
18623,59,2473,1354,1541,27129,932
14198,4630,156430,1424,97918,742733,58512
24593,101,3496,1248,2396,56880,1100
63468,50,696,355,558,9309,138
18348,2,205,1358,168,6931,37
40014,26,617,929,529,8059,88
33649,34,496,1071,442,5986,54
34193,280,8088,1060,6188,58462,1900
7715,675,16214,1483,11052,110122,5162
57681,47,382,544,298,9443,84
24148,7,194,1258,148,8557,46
12200,3,276,1452,159,5968,117
49220,92,1528,790,1263,18816,265
16735,17,582,1387,469,11567,113
4030,97,4060,1530,2483,27593,1577
46820,41,1330,837,1094,33523,236
16811,18,522,1386,306,10050,216
64272,10,75,331,70,3065,5
46373,167,1673,843,1319,8602,354
53050,31,385,680,289,5465,96
49717,90,3432,777,1731,12612,1701
68833,1,14,192,8,510,6
55871,22,312,594,255,11967,57
56135,25,335,586,290,13429,45
6711,9,569,1496,416,8100,153
49523,398,3658,782,2686,33466,972
20434,779,19535,1322,12777,148522,6758
18787,995,27885,1351,18182,220416,9703
17524,298,13388,1373,8141,83521,5247
17126,95,2768,1381,1827,36949,941
56660,7,100,571,83,4940,17
27918,27,899,1175,601,14668,298
30775,55,1750,1120,1151,44290,599
494,99,2411,1561,1517,32522,894
55149,39,1453,613,1057,20913,396
63498,6,70,355,56,3494,14
51624,317,9175,726,7267,64453,1908
41735,782,24725,902,20946,229929,3779
54378,81,2735,640,2047,14452,688
27492,916,13264,1185,9402,104525,3862
37252,29,423,984,315,4341,108
57213,88,749,556,595,17633,154
31281,77,1125,1111,725,32331,400
65984,173,2503,285,2131,22540,372
19027,143,4767,1346,3533,32038,1234
19718,2123,38696,1334,25988,211447,12708
13832,23,794,1430,565,24236,229
67879,6,85,224,60,7702,25
14332,4,256,1422,155,7917,101
16496,76,2188,1391,1591,77609,597
68481,10,255,205,190,5330,65
11278,2089,61452,1460,34497,138618,26955
11924,554,16792,1454,11141,70789,5651
66282,110,785,276,683,7678,102
42560,46,536,889,399,11508,137
51165,9,140,739,107,5823,33
38371,94,2811,955,2203,34602,608
67070,50,702,251,540,13054,162
30839,11,219,1118,158,4514,61
17473,2100,66374,1374,43627,497858,22747
15925,16,264,1400,157,7872,107
23951,105,4123,1263,2388,57211,1735
35728,87,1993,1025,1492,15559,501
20579,15,807,1319,610,16468,197
23963,176,5199,1263,3696,43356,1503
19790,9,332,1333,229,7519,103
4179,62,2313,1528,1436,28126,877
23119,646,12698,1278,8206,162202,4492
30900,188,2075,1118,1410,29175,665
53188,20,214,676,169,9916,45
5274,49,1118,1513,734,13855,384
54164,11,163,648,136,8225,27
43381,1394,39018,871,28400,208074,10618
18826,0,0,1350,0,17817,0
25200,188,3081,1235,2194,21059,887
14930,29,977,1415,687,12966,290
54371,189,1620,640,1295,11399,325
17635,26,1627,1371,1145,44048,482
30179,4710,135630,1131,82385,427691,53245
12420,64,2211,1449,1128,16750,1083
69243,8,169,178,119,6259,50
54201,16,173,646,138,5283,35
2655,74,2531,1544,1836,25880,695
59201,41,497,494,414,11450,83
28077,7,332,1172,265,7091,67
2576,76,3765,1544,2494,117855,1271
27027,4,72,1195,48,4702,24
702,77,4307,1559,3053,35108,1254
35351,39,404,1033,313,9789,91
15240,15,647,1411,497,18098,150
16799,105,2054,1386,1510,24971,544
60962,21,301,430,209,6407,92
14142,76,1706,1425,1080,11080,626
23896,24,1372,1264,875,14187,497
39055,150,2512,941,2179,31987,333
54583,27,454,632,312,10649,142
20990,0,0,1312,0,4196,0
3855,104,3849,1532,2630,42600,1219
20209,211,3991,1325,2812,84832,1179
6108,2,90,1504,67,6357,23
20051,18,322,1328,237,9933,85
64674,1,16,319,15,2239,1
18488,314,11639,1356,8263,42450,3376
51769,2896,48543,722,31571,102662,16972
33306,29,515,1078,323,5728,192
33529,7,129,1074,110,10943,19
12318,154,5351,1450,3198,40717,2153
51424,5,83,732,61,3944,22
2658,1615,83134,1544,54755,546310,28379
66441,319,4940,271,4137,64194,803
61902,110,1826,399,1484,28956,342
31756,26,778,1104,471,18439,307
34333,100,2258,1058,1381,18518,877
68973,42,622,187,519,8542,103
89,640,29582,1565,17760,147798,11822
11614,556,15711,1457,9777,100877,5934
3149,250,5765,1539,4155,48220,1610
19231,237,9078,1343,5033,30975,4045
18589,2,76,1354,61,24440,15
63324,55,467,359,357,7390,110
59531,14,131,482,91,5258,40
12273,29972,1098973,1451,607125,3277097,491848
68659,5,71,198,56,3498,15
33155,54,1134,1081,765,14787,369
36164,37,839,1013,719,42568,120
38908,19,357,943,265,7264,92
2975,388,8772,1540,5696,33967,3076
59090,307,4233,482,3314,30543,919
68768,27,446,194,392,5062,54
2010,39,838,1549,605,21403,233
68100,2,50,217,38,3486,12
25541,35,2226,1228,1453,25314,773
41291,310,4425,909,3291,27752,1134
58236,41,557,525,457,25236,100
56749,38,428,568,322,6707,106
59388,46,493,487,378,6344,115
62536,24,698,380,528,13120,170
3196,92,2572,1538,1612,28683,960
61143,3,72,424,55,2434,17
4568,3,115,1523,86,15067,29
50512,4,108,756,85,3755,23
22056,5013,153073,1295,107249,770655,45824
59554,6,74,482,49,6496,25
15265,303,7416,1410,4803,60159,2613
13223,317,20102,1439,12248,90804,7854
28107,21,210,1172,129,5075,81
15837,146,4040,1402,2935,51620,1105
62802,11,62,372,52,4905,10
27766,21,461,1179,315,5879,146
60743,15,164,438,140,5386,24
64307,6,89,330,70,5944,19
31625,8,187,1106,121,9991,66
17092,113,13250,1381,7869,41150,5381
8401,23,556,1477,365,8110,191
13911,108,3327,1429,2158,61490,1169
39341,398,4027,938,2726,35642,1301
34969,241,1510,1043,1194,14421,316
30025,11,1193,1135,592,13843,601
43946,22,347,870,294,11655,53
209,312,16123,1564,10814,193233,5309
60386,221,4632,453,3553,20731,1079
14103,31,963,1425,711,51185,252
3948,42,2051,1531,1455,32407,596
12131,25,1194,1453,579,32027,615
6898,17,867,1494,647,20622,220
38023,30,614,963,498,12793,116
59917,7,47,469,24,10173,23
15617,55,1384,1405,953,12779,431
24935,38,1657,1240,1096,17616,561
64705,23,340,319,259,3975,81
55251,28,252,611,203,4055,49
13294,17,308,1438,192,6050,116
3368,33,1229,1537,849,32104,380
56803,54,910,566,720,13784,190
48837,4,359,801,248,4651,111
277,171,8215,1562,5502,86039,2713
33314,128,3783,1078,2725,31122,1058
57795,890,9103,540,6851,36648,2252
18377,299,12002,1358,7619,45963,4383
32652,6,409,1090,276,17249,133
60411,142,2038,449,1526,25724,512
29784,116,5892,1140,3286,32187,2606
6235,176,6316,1502,4287,49955,2029
65991,595,6872,284,5819,68991,1053
45539,55,872,852,661,13178,211
4632,731,29940,1522,17426,342532,12514
62322,13,117,386,100,4204,17
55908,198,3681,593,2726,29606,955
21367,661,13982,1305,9231,65269,4751
61674,79,776,407,653,8834,123
27242,84,3640,1191,2083,17362,1557
36766,389,7718,998,6336,65230,1382
6436,311,21944,1500,14106,140664,7838
51986,0,14,717,13,3573,1
21359,22,1074,1305,731,8224,343
41495,507,9688,904,8168,107168,1520
8437,70,3606,1477,2314,36834,1292
68219,71,1186,214,956,9427,230
24632,33,1286,1247,843,18919,443
51136,3579,88205,740,63502,882082,24703
25061,89,3138,1237,1969,18722,1169
11155,18,804,1461,531,8942,273
36419,20,530,1006,424,18239,106
54086,8,104,649,59,4027,45
15359,18,353,1409,273,11381,80
50905,0,18,740,14,1325,4
37583,9,129,975,109,3971,20
52440,928,15182,701,12628,83412,2554
34787,7,101,1047,76,3715,25
18627,193,8508,1353,5838,32613,2670
19396,51,2280,1340,1639,33937,641
28315,182,2981,1168,1711,19252,1270
50261,2,47,763,37,2649,10
69378,181,1501,174,1396,13605,105
3767,5,355,1533,254,24779,101
29623,36,1868,1144,1201,34163,667
5756,53,2327,1508,1534,47479,793
56134,96,1506,586,1129,12877,377
69815,4,51,159,46,1605,5
45915,4,111,848,73,6214,38
1880,58,1217,1550,834,11960,383
33228,24,470,1079,310,7720,160
53461,186,1933,670,1519,20966,414
8956,30,822,1475,589,7390,233
33472,3,86,1075,54,4824,32
26942,23,580,1197,375,12336,205
68029,4,30,220,25,2372,5
35470,20695,393331,1030,251053,1705540,142278
58444,97,1495,518,1223,15984,272
12343,28,2706,1450,1374,17984,1332
17628,266,5841,1371,4059,50628,1782
4270,38,858,1527,542,18743,316
64380,56,615,328,517,6368,98
20222,5,113,1325,80,6959,33
45662,343,4682,851,3904,62339,778
60227,20,178,458,142,7844,36
17849,3458,96025,1367,65885,247832,30140
6139,214,8441,1503,5739,102008,2702
62146,1,14,390,11,1971,3
12085,2271,64685,1453,36774,141514,27911
33976,29,1485,1066,979,37311,506
18191,11,326,1361,261,10006,65
64649,74,1115,320,812,11287,303
1653,1822,59352,1552,39001,201467,20351
27181,19,412,1192,299,17759,113
27037,4,307,1194,193,13203,114
62330,3,37,385,28,6417,9
44312,43,2248,866,1725,14249,523
8195,1125,23211,1478,15552,75789,7659
54031,12,520,652,405,5279,115
15811,109,3007,1402,2152,40662,855
505,10,253,1561,188,24369,65
8742,245,10559,1476,7134,135394,3425
27533,55,1568,1184,974,13914,594
35707,96,2537,1025,1786,25589,751
25154,731,9074,1236,5597,42572,3477
29531,28,2006,1145,1219,16850,787
37956,237,4822,966,3772,33655,1050
44782,2040,27473,860,19385,109499,8088
30376,9,346,1128,208,11330,138
1735,10,374,1551,303,18028,71
27544,12,496,1183,312,26136,184
12451,3226,114332,1449,71320,215670,43012
36404,165,3312,1006,2541,23001,771
6574,142,6285,1498,3821,26842,2464
22354,54,1114,1291,767,15501,347
70484,6,127,138,124,5030,3
57151,95,2224,557,1899,29398,325
54283,18,302,643,234,7011,68
11487,1451,66485,1459,36068,382725,30417
49216,16,368,790,297,8949,71
8119,16,356,1478,243,3865,113
49012,39,569,797,488,14521,81
36503,29,434,1003,356,9926,78
64080,2,38,337,29,1414,9
1659,86,4437,1552,3406,64753,1031
64453,9,227,326,162,7007,65
19416,585,14808,1339,9845,130289,4963
68706,25,424,196,318,7659,106
53549,97,1142,668,861,11492,281
59456,7,112,485,92,4858,20
1985,26,844,1549,643,33986,201
58388,48,576,520,454,6614,122
19310,278,7695,1341,4818,93227,2877
25867,104,2019,1221,1343,23193,676
50716,11,238,752,167,6713,71
16628,82,2832,1389,2053,49185,779
56940,10,178,562,137,8001,41
32604,3,43,1091,38,6839,5
42870,27,784,883,614,9001,170
17411,213,5670,1376,3980,37260,1690
33419,159,2827,1076,1901,15947,926
10847,115,4245,1464,2665,19500,1580
35437,78,1189,1031,897,42345,292
58591,96,650,513,474,6620,176
49144,17,535,793,418,5080,117
36289,95,2468,1009,1937,26223,531
14913,558,12783,1415,8744,127836,4039
3329,686,17476,1537,11724,92926,5752
62624,13,112,377,89,4340,23
69073,48,347,184,320,7272,27
24355,212,4374,1254,2820,31357,1554
29219,33,1081,1150,668,31189,413
22481,89,2864,1289,2008,27732,856
29156,88,2579,1151,1646,17094,933
28590,49,1796,1163,1204,24477,592
34556,10,313,1053,221,10450,92
30297,636,25870,1129,16211,157117,9659
14093,22,811,1426,589,16299,222
52883,310,5712,685,4433,95247,1279
52058,7,78,714,61,5171,17
37867,1110,34394,968,24467,240514,9927
40337,404,6681,920,5158,57961,1523
33687,1,14,1071,14,3101,0
51940,13,173,718,132,9220,41
30423,48,366,1127,287,12959,79
54375,75,908,640,719,8739,189
68441,31,515,206,442,10870,73
66765,58,560,260,471,5689,89
27206,58,1456,1191,933,18593,523
26464,25,2075,1208,1027,7307,1048
1166,4,229,1555,147,25392,82
25873,1613,41454,1221,25877,279566,15577
35246,2,24,1036,21,5888,3
9790,53,1414,1471,996,10662,418
2164,38,1592,1548,1008,12026,584
66862,8,144,257,99,3728,45
35424,53,824,1031,647,22456,177
3519,137,2857,1535,1897,18631,960
31289,98,2552,1111,1904,18887,648
21332,283,4187,1306,3092,23149,1095
7065,44,1652,1491,1163,22747,489
18087,616,27760,1363,16798,85955,10962
14371,60,1933,1422,1190,26584,743
45208,45,906,856,654,16034,252
8952,0,0,1475,0,9321,0
53683,9,80,663,72,5255,8
27249,26,912,1190,582,14452,330
7528,21,1196,1485,804,59454,392
7532,210,2739,1485,2171,15968,568
28531,431,7472,1164,5427,47358,2045
63289,17,363,360,253,7267,110
29610,36,727,1144,614,16243,113
36234,2167,35206,1011,28618,345414,6588
856,8,683,1557,466,17348,217
50746,16,392,751,312,11112,80
18613,9,977,1354,603,17418,374
68891,7,64,190,45,4108,19
67111,13,139,249,121,6917,18
61022,934,19677,429,16843,80552,2834
27876,2,124,1176,86,7591,38
69451,37,251,172,231,4151,20
17872,22,632,1366,475,11979,157
29563,703,12726,1144,8807,84684,3919
36875,6693,148140,996,110535,708667,37605
64893,8,135,313,114,6231,21
15571,24,1643,1406,1190,24074,453
15778,37,1130,1403,824,17735,306
10595,26,1134,1466,752,28409,382
13126,5,611,1439,331,16256,280
58667,4,51,511,37,4482,14
63828,146,5017,346,3558,17020,1459
14746,6,95,1417,58,4911,37
69111,27,774,183,670,8439,104
23353,2325,38244,1274,25762,141494,12482
68797,2,33,193,24,2092,9
36960,793,11892,993,9448,93997,2444
65623,82,1068,294,923,18596,145
53272,5,148,674,60,2927,88
15268,26,1056,1410,791,41889,265
6504,21,675,1499,437,26120,238
13842,70,2137,1430,1299,39163,838
59597,54,505,480,401,8087,104
21200,49,1576,1308,1196,23288,380
28242,1,107,1169,65,6162,42
20081,98,2220,1327,1597,34980,623
5063,210,5935,1516,4115,58873,1820
27480,24,995,1185,562,8333,433
27155,6,1056,1192,615,14596,441
5324,169,3676,1513,2740,38448,936
55962,18,262,591,235,16033,27
64798,4021,64562,316,51588,330241,12974
68321,32,666,210,550,12371,116
11824,45,805,1456,456,24138,349
9855,119,3099,1470,2238,29496,861
35221,22,394,1036,337,5722,57
35878,113,2014,1021,1417,26056,597
23473,3,133,1272,96,4691,37
24041,13,471,1261,344,7729,127
21483,4,122,1303,74,5874,48
70031,10,230,153,196,4622,34
22365,121,1161,1291,735,9356,426
46050,72,1136,846,793,16100,343
22816,2293,66623,1283,44183,362978,22440
51835,84,1512,721,1244,21259,268
25499,415,14276,1229,9343,76517,4933
4115,41,936,1529,699,24901,237
53450,38,352,670,280,5961,72
40467,13,365,922,304,7029,61
97,22,522,1565,381,12836,141
3111,918,125531,1539,62640,296716,62891
57231,82,1088,555,863,10949,225
19268,457,10174,1342,7201,77066,2973
65565,33,567,296,484,7082,83
69621,24,418,166,324,5745,94
23262,13,301,1275,264,18007,37
23374,35,1134,1273,836,24644,298
59621,57,1565,479,934,20955,631
28442,98,1835,1166,1252,39376,583
9862,172,7585,1470,4357,53125,3228
15159,1,107,1412,78,9211,29
6420,20,795,1500,516,24736,279
10364,6,273,1467,173,6351,100
28708,16,1283,1160,694,11366,589
54729,92,1077,626,748,17117,329
8680,15,582,1476,407,11816,175
38409,2842,55093,954,43108,468593,11985
18225,204,11416,1360,7268,42052,4148
33980,23,435,1065,258,9021,177
4680,182,9248,1521,5706,71761,3542
38046,4,101,963,77,9931,24
20649,43,1640,1318,1133,40906,507
60293,5,75,456,41,1405,34
27473,132,2349,1185,1412,12150,937
22753,1320,35633,1284,25489,147651,10144
21471,8,385,1303,266,13992,119
54310,39,374,642,318,8658,56
41838,335,5016,900,3914,97428,1102
33914,24492,606799,1067,313429,1754949,293370
54450,129,1388,637,1101,13417,287
14137,1354,42944,1425,28138,394457,14806
16135,33,551,1397,382,6905,169
21026,88,3701,1311,2827,25685,874
67960,22,240,222,201,7582,39
31108,6,58,1114,44,2596,14
20740,438,9982,1317,7073,83298,2909
16211,10,343,1395,221,41647,122
61696,15,108,407,92,6232,16
50626,9,131,754,109,7751,22
10591,508,10878,1466,6887,44770,3991
61089,165,2199,426,1732,9253,467
19533,27,1139,1337,827,25772,312
23168,118,1228,1277,868,14553,360
16105,1,47,1397,34,5292,13
9522,15,459,1472,277,12878,182
23603,285,6580,1270,4327,90484,2253
14702,9,280,1418,190,13989,90
69685,4,48,164,39,2974,9
5442,143,5038,1511,3077,50850,1961
55799,147,1595,596,1239,14683,356
12157,410,31294,1452,18113,167849,13181
3879,175,10250,1531,6581,99843,3669
17245,98,3090,1378,2143,31086,947
26462,2,234,1208,144,5784,90
19015,74,3007,1347,2082,67262,925
29691,9,211,1142,115,6581,96
37698,45,1007,972,811,15351,196
38060,109,2057,963,1603,28108,454
37218,47,1074,986,880,26464,194
37206,23,989,986,856,12614,133
3604,18,553,1535,421,9440,132
59637,41,501,479,356,14255,145
63653,16,135,351,110,5591,25
29118,165,4365,1152,3060,54391,1305
60139,4,31,461,29,4354,2
25786,157,1663,1223,1130,9972,533
18878,71,1809,1349,1250,18603,559
25578,166,6590,1227,3862,29034,2728
70476,24,304,138,273,2897,31
64000,32,625,340,528,9756,97
162,147,4914,1564,3415,56610,1499
41715,39,350,902,241,10620,109
29749,88,2017,1141,1322,54509,695
10406,17,505,1467,308,6738,197
52385,1,73,703,40,2389,33
66179,8,53,278,41,1433,12
69094,117,1973,184,1762,18631,211
35154,6475,144065,1038,92023,486066,52042
52845,168,1860,686,1449,18230,411
12389,10,206,1449,104,7210,102
14641,65,2016,1418,1387,20960,629
8454,146,7626,1477,4598,171356,3028
28876,82,1712,1157,1028,10362,684
60270,95,1320,457,937,9376,383
20291,43,1199,1324,900,39330,299
57132,16,370,558,286,4879,84
40564,30402,903660,921,661839,1823287,241821
13198,43,1810,1439,1057,16260,753
30190,168,4077,1131,2550,28338,1527
34552,2,78,1053,49,8648,29
66130,2649,53621,280,44070,222981,9551
22350,192,7052,1291,4858,54647,2194
17810,315,9486,1368,6154,67130,3332
50637,594,11938,753,8033,93649,3905
34433,2542,80544,1056,55600,338837,24944
5881,22,603,1507,457,15276,146
1322,492,12983,1554,8475,144338,4508
26620,221,5340,1204,3535,80066,1805
55250,91,2520,611,1870,20263,650
50575,31,301,755,239,5381,62
18194,13,215,1361,159,11924,56
33999,13,228,1065,204,10240,24
15411,9736,465109,1408,275521,934622,189588
34977,94,4062,1042,2580,30200,1482
3446,8,329,1536,225,8174,104
25798,20,953,1222,606,18829,347
35381,4,115,1032,75,3323,40
10198,754,28362,1468,17675,147684,10687
20801,7992,237873,1315,173511,1807600,64362
2195,10,385,1547,284,17457,101
39271,126,1580,939,1211,18435,369
50105,95,1346,766,1081,10226,265
20959,98,1834,1312,1195,23744,639
12669,316,10527,1446,6030,36499,4497
42910,172,2786,883,1767,22716,1019
29549,158,4557,1145,2984,68642,1573
17033,16,346,1382,259,11067,87
30689,143,3190,1121,2719,27675,471
1687,5,201,1551,150,9841,51
31148,156,2502,1113,1756,23999,746
29945,14,441,1136,259,7406,182
26058,115,2645,1216,2292,46046,353
59277,927,16585,491,13388,72024,3197
68813,14,261,193,231,4510,30
9307,351,6215,1473,4128,31776,2087
5419,11,434,1512,306,20564,128
34403,37,800,1056,545,11082,255
49329,51,726,787,640,26260,86
31594,156,6011,1107,4203,38894,1808
63722,5,306,349,142,3596,164
37388,25,423,981,309,14131,114
15264,278,6469,1410,4430,71963,2039
7826,303,8058,1481,4613,94292,3445
8323,256,13067,1478,7638,60498,5429
25476,10367,207072,1229,124961,1008185,82111
59785,113,1547,473,1308,26892,239
1568,4,150,1552,100,8602,50
1034,12,460,1556,301,17758,159
27381,531,13475,1187,9929,27190,3546
40953,1403,24404,914,18591,179646,5813
60567,107,1372,419,1085,13594,287
67099,46,616,249,513,7246,103
34379,54,1163,1057,723,35592,440
39517,51,471,936,367,10215,104
64155,8,143,335,110,3580,33
10653,22,1137,1465,730,15784,407
36845,161,3425,997,2997,58122,428
68204,24,246,214,195,3512,51
68093,7,130,217,95,4049,35
40310,119,1845,925,1421,29967,424
54518,29,427,634,356,13596,71
69028,3,68,185,56,2837,12
45533,1123,25534,852,20290,163381,5244
66532,2,42,268,26,2882,16
35510,148,2152,1029,1634,15462,518
13757,53,1240,1431,702,21703,538
20642,29,652,1318,476,9651,176
45621,12,190,852,150,5358,40
61533,20,328,412,238,7592,90
37048,217,5886,978,4791,48673,1095
35769,197,3778,1024,2849,27910,929
19861,142,1964,1331,1563,20551,401
17079,183,3864,1381,2874,34001,990
14514,133,2144,1420,1389,21351,755
2785,179,5099,1543,3016,33609,2083
19732,30,642,1334,435,10260,207
17864,42,1467,1366,1058,24967,409
22299,188,5405,1292,3778,40801,1627
348,1683,52272,1562,30309,146439,21963
3307,7,233,1537,168,15195,65
65835,50,1104,288,866,18266,238
18048,4,254,1363,120,7748,134
4674,238,4951,1521,3348,27215,1603
21245,47,2763,1307,1412,18918,1351
11676,28,1064,1457,608,27361,456
68611,8,82,200,61,4717,21
11078,9,291,1462,182,14317,109
50581,10,132,754,101,4044,31
63333,39,291,359,234,4276,57
53930,28,277,656,208,5409,69
69585,50,363,168,280,5056,83
50492,6,128,757,105,12171,23
47819,51,858,824,604,8524,254
57152,13,146,557,114,6020,32
51295,85,853,736,676,8099,177
27870,79,1704,1176,1121,34030,583
65094,9,323,306,235,4400,88
13535,180,2138,1434,1435,11497,703
53192,419,3207,676,2682,43042,525
69098,7,92,183,77,5680,15
36844,15,174,997,135,5430,39
10122,722,45583,1469,29773,173604,15810
24810,3896,93172,1243,62766,230858,30406
26548,41,1122,1206,733,24036,389
6982,8,479,1493,357,26778,122
23279,69,3011,1275,2205,121259,806
23141,48,1158,1277,811,26145,347
59599,46,778,480,605,18917,173
65519,122,1544,296,1214,13325,330
3082,14,1257,1540,851,20649,406
10901,6521,208740,1463,121784,829973,86956
17995,12,1018,1364,734,22687,284
4929,190157,5818378,1518,3033905,11066995,2784473
69401,60,576,173,463,5080,113
47599,6,123,827,95,17807,28
18997,3903,263144,1347,152757,864834,110387
56482,32,416,576,313,9201,103
63597,22,265,352,212,4741,53
31686,4367,138831,1105,92024,363665,46807
27729,11,277,1180,161,9197,116
58837,12,171,506,122,2981,49
47688,127,1968,825,1572,13257,396
64401,678,7585,327,6546,44911,1039
33667,8,273,1071,180,7709,93
824,399,20486,1558,13014,123459,7472
62679,113,1472,375,1170,13666,302
16494,118,2548,1391,1959,43320,589
61165,28,715,423,532,7240,183
29450,413,8195,1146,5342,42237,2853
22211,177,2397,1293,1405,12667,992
62751,29,376,373,251,9961,125
2372,6,274,1546,194,29316,80
37436,5,85,979,65,6276,20
44278,197,1888,866,1419,17131,469
8865,346,6965,1475,4310,37128,2655
57227,17,304,555,244,7451,60
70207,3,54,147,44,1661,10
54319,24,161,640,127,9275,34
43436,34,783,875,582,11785,201
27589,19,865,1182,511,11014,354
24990,42,1304,1239,862,7650,442
11009,326,10397,1462,6635,38868,3762
64818,18,245,315,188,5531,57
30130,63,1337,1132,924,13375,413
50104,1,46,767,38,3032,8
16452,192,3996,1391,2735,22481,1261
58020,7,88,533,81,6300,7
53802,699,7676,660,6048,91687,1628
8879,964,26894,1475,16675,116054,10219
7202,279,11413,1489,7310,52798,4103
29659,51,2571,1143,1459,19083,1112
55212,31,438,612,328,9056,110
23222,485,11091,1276,7032,40344,4059
37753,41,595,971,399,8558,196
49103,35,701,794,609,17195,92
67078,101,1578,248,1297,10048,281
3952,120,3023,1531,2297,44563,726
17798,372,11534,1368,8557,83424,2977
13048,3,132,1441,71,3778,61
45599,29,580,852,485,6213,95
57102,10,164,558,65,3649,99
68028,1239,29118,220,24268,195667,4850
38040,170,3838,963,2202,68066,1636
19795,15,941,1333,653,20402,288
12757,46,2416,1445,1333,18488,1083
69103,630,14462,182,12516,89023,1946
28914,25,540,1156,307,4840,233
30360,24,851,1128,537,10538,314
54891,54,238,620,194,4604,44
52923,56,864,684,644,13859,220
23846,11,263,1265,225,6089,38
61092,33,575,425,411,14479,164
60902,5,71,432,57,3759,14
56576,14,164,573,141,6907,23
3818,2,267,1532,205,21648,62
64225,109,1171,333,989,7529,182
7787,37,1526,1482,1014,21962,512
47086,1641,35084,834,27181,159922,7903
60606,142,2103,444,1657,15966,446
27563,81807,2007981,1183,1349256,4753676,658725
55851,10,202,594,146,9534,56
12572,35,2370,1447,1346,32165,1024
22745,43735,1448361,1284,838047,2243234,610314
20188,186,4128,1326,3021,40130,1107
70571,2,19,134,17,1955,2
56185,10,104,584,81,2869,23
2246,35,1327,1547,959,22006,368
30134,192,3848,1132,2891,26094,957
43877,32,775,871,631,11006,144
70194,79,1473,147,1366,20331,107
38392,3539,45762,941,34972,253692,10790
61463,42,409,414,299,7742,110
54484,100,1123,636,888,9856,235
5646,63,2297,1509,1638,13600,659
25368,90,1379,1231,1080,22225,299
48806,84,1138,803,848,14239,290
32641,311,11953,1090,8042,79194,3911
39493,22,507,936,347,5061,160
8750,78,3174,1476,1993,21979,1181
55745,8,182,597,168,5879,14
18425,259,4577,1357,3148,52935,1429
12900,66,1968,1443,1158,25751,810
20220,13,510,1325,346,8389,164
7740,112,2596,1482,1653,20552,943
51357,48,761,734,615,12220,146
14158,176,5546,1425,3265,22593,2281
50748,3,94,751,77,2035,17
10953,56,2114,1463,1159,19035,955
12355,9,337,1450,195,16402,142
26409,46,816,1209,681,15662,135
58272,217,4777,524,3904,26947,873
36059,1220,14323,1016,10572,50291,3751
21057,29,833,1310,571,17188,262
25822,97,3862,1222,2562,37210,1300
24600,2386,76905,1248,44156,247684,32749
6407,31,743,1500,515,25815,228
50672,28,371,753,301,3770,70
63549,2,79,354,59,6312,20
64032,43,1562,339,860,16563,702
30735,66,1148,1121,784,6906,364
62578,63,818,378,548,8936,270
61631,15,211,408,176,5184,35
27038,7893,144204,1194,92464,367949,51740
56762,11,179,568,149,4389,30
27149,10,219,1192,147,5383,72
68014,312,5399,220,4533,29120,866
47765,119,1942,825,1412,20371,530
5990,130,2886,1505,1856,57837,1030
52127,231,2048,711,1699,34605,349
63552,1749,26044,354,20987,170400,5057
69007,1735,41579,186,34759,172398,6820
21701,2230,54105,1299,34985,348248,19120
30557,240,4279,1124,2837,20979,1442
37586,174,2799,975,2340,21963,459
62098,99,1325,392,1108,19352,217
32881,45,1258,1086,931,15175,327
49897,11,135,772,106,5297,29
53576,25,342,667,288,4561,54
32315,1,34,1096,21,2427,13
61660,12,92,408,67,2140,25
65607,279,3405,294,2790,26173,615
52087,19,429,713,272,15762,157
44259,190,3804,866,3089,36746,715
36550,2,122,1001,90,7402,32
50271,73,879,762,679,11433,200
16023,7,230,1398,167,9310,63
58412,23,181,519,145,5330,36
28693,20,520,1160,287,7225,233
5353,11,881,1512,584,23339,297
67682,9,98,231,86,1627,12
21716,6,251,1299,178,13588,73
63041,214,2108,367,1849,31793,259
14485,69,1894,1420,1371,14338,523
48736,5,110,806,95,5029,15
48341,28,2375,817,1656,8597,719
33124,322,5689,1081,4069,56457,1620
34805,1,32,1047,24,2250,8
70000,250,3307,152,2902,38537,405
8434,791,19030,1477,11969,67807,7061
20707,135,2483,1317,1948,33417,535
36785,17,470,998,385,7755,85
27646,511,12936,1181,9712,72704,3224
67260,7,126,244,79,6649,47
63423,375,17828,357,14445,54820,3383
40655,268,5336,920,4328,80769,1008
6031,939,49395,1504,30054,188987,19341
5952,21,938,1506,658,14697,280
29047,182,5554,1154,3615,68358,1939
27751,41,851,1179,552,16051,299
17215,34,629,1379,498,24329,131
66941,82,861,254,686,13228,175
3985,40,857,1530,554,15414,303
17084,1069,47092,1381,28757,304253,18335
65624,41,708,294,598,13220,110
16020,264,7641,1398,5453,79163,2188
31378,0,0,1110,0,5777,0
10208,269,4987,1468,3350,38760,1637
10692,31,1206,1465,753,13564,453
2484,34,1478,1545,971,43231,507
46932,608,4135,835,3435,31666,700
33878,7,127,1068,93,5648,34
67551,4,74,235,60,2640,14
13964,36,497,1428,375,19296,122
61375,16,213,416,124,3791,89
62102,12,76,392,71,6321,5
62450,804,9566,382,7923,68701,1643
56549,0,118,573,110,3879,8
36280,5,65,1010,60,6450,5
55760,84,836,597,721,8846,115
37444,124,2947,979,2593,38092,354
20348,65,1638,1323,1077,35371,561
69722,3,34,163,29,1575,5
1416,253,7785,1553,5463,74043,2322
13076,3346,165139,1440,101845,389247,63294
43789,14,394,872,313,7920,81
49344,11769,420735,786,308973,1003288,111762
68198,18,248,215,206,11234,42
33821,661,8652,1068,7300,101742,1352
3325,4759,155277,1537,91501,389713,63776
54904,23,306,620,200,6444,106
27647,287,7776,1181,5182,32722,2594
24479,88,2238,1251,1449,15112,789
34197,1,140,1061,92,2953,48
33663,73,1068,1071,699,10045,369
29528,38,1932,1145,1242,18100,690
66389,257,2534,272,2145,15648,389
63123,10,343,365,252,8426,91
37771,1798,34621,970,29824,179879,4797
37194,0,0,986,0,1694,0
5766,16,478,1508,330,23007,148
59352,52,717,489,528,17996,189
62861,19,248,371,181,4798,67
26775,67,1047,1201,716,12001,331
24555,52,1760,1249,1126,19472,634
19423,10,476,1339,328,15141,148
51498,4,31,730,26,3987,5
16444,54,1570,1392,1121,29490,449
13162,71,2187,1439,1152,25391,1035
16086,8,373,1397,235,14458,138
61802,39,449,403,373,2477,76
67469,7,121,237,93,6780,28
12304,87,3229,1451,2046,49252,1183
17439,8,346,1375,266,14850,80
61856,49,493,401,361,5717,132
60638,15,145,442,126,6586,19
23799,197,3449,1266,2430,37083,1019
53887,138,1994,656,1642,12857,352
16607,11,176,1389,115,6364,61
3222,64199,1512861,1538,972492,3978306,540369
1667,14,501,1552,367,16695,134
22759,22,455,1284,327,11765,128
67040,725,15764,251,13131,100737,2633
63497,10,194,355,131,6260,63
26465,139,2958,1208,2191,46530,767
56522,3,51,574,43,5449,8
28555,1616,52118,1163,36239,220064,15879
65762,21,310,290,238,7365,72
40574,188,2254,921,1660,29610,594
9147,21,370,1474,228,10341,142
27591,36,760,1182,429,7245,331
1635,18,444,1552,311,20113,133
17712,188,9473,1370,6394,54364,3079
5727,23788,780138,1508,458391,2165834,321747
67857,19,230,225,194,10179,36
58366,1277,20799,519,16791,70753,4008
4530,25,587,1523,443,18192,144
17852,15,657,1367,499,14242,158
62841,17,150,372,127,3248,23
7190,11,523,1489,313,19551,210
56673,124,2798,570,1961,33004,837
13161,5,198,1439,130,7072,68
67114,4,59,249,47,5338,12
19508,10,408,1338,333,34264,75
20255,45,1332,1325,906,8654,426
8998,33,777,1475,549,9555,228
1462,29,1400,1553,983,23892,417
382,192,9962,1561,6941,72646,3021
28253,6,123,1169,81,8184,42
61522,36,373,412,268,4021,105
46257,60,1265,844,940,11206,325
8383,137,5587,1477,3679,39554,1908
69244,16,220,178,208,6345,12
53599,8,75,666,61,4633,14
23340,88,1340,1274,1011,11962,329
22599,72,1917,1287,1412,30740,505
33888,1939,23220,1067,16114,110684,7106
9552,33,1141,1472,815,40071,326
52421,5,102,702,68,10518,34
237,138,3796,1563,2483,28251,1313
20273,19,737,1324,592,18336,145
32417,16,636,1094,371,4765,265
11983,661,14723,1454,10470,111845,4253
19807,10,558,1332,401,22378,157
32558,699,11505,1091,9022,64336,2483
28883,5,131,1157,63,15436,68
29687,1050,33555,1142,20263,253604,13292
44623,1831,26012,863,20120,113333,5892
30831,5,256,1119,163,9589,93
23709,17,511,1267,351,7166,160
58571,10,221,514,180,5044,41
55470,74,1204,604,1033,14373,171
13298,4283,86351,1437,52031,239380,34320
20323,50,1044,1324,713,44605,331
37921,37,868,967,662,11610,206
55894,18,263,593,217,18524,46
54527,40159,572338,634,427191,2381401,145147
24830,80,2101,1243,1572,17726,529
52102,571,7188,712,5924,94226,1264
50383,20,215,760,178,5290,37
24709,1934,60250,1245,35046,504449,25204
49379,18,200,785,150,6352,50
38211,118,1445,959,1157,21609,288
26843,757,13770,1199,9037,56329,4733
63969,87,1092,341,885,21160,207
70299,2,30,144,29,1608,1
61367,94,1500,416,1262,16901,238
4000,17,557,1530,411,15160,146
44429,22,319,864,231,5072,88
7625,2461,168565,1484,91979,409854,76586
51084,23,543,741,383,19017,160
17685,183,6883,1370,4554,54930,2329
36441,8,462,1005,369,12743,93
7327,1464,71572,1488,47608,637176,23964
70355,17,370,142,359,3661,11
5908,13,1051,1506,732,17104,319
52086,41,588,713,379,20410,209
4038,40,492,1530,360,14422,132
195,1175,31119,1564,19583,123423,11536
30649,587,10478,1120,6945,125407,3533
7160,41,1622,1490,1030,40454,592
32762,4,283,1088,223,10347,60
69144,3,42,181,32,3333,10
31474,55,900,1109,567,25618,333
69906,35,243,156,213,5987,30
28798,18,423,1159,261,15173,162
49576,102,1570,781,1345,20842,225
50847,717,10957,748,9203,56018,1754
16112,280,7183,1397,5123,68461,2060
49758,19,460,775,371,10189,89
52190,396,2955,709,2577,25313,378
57103,7,68,558,59,2713,9
55950,197,2393,592,1943,26041,450
526,965,77768,1560,45913,253206,31855
63352,4,50,358,42,1635,8
66696,2,23,263,12,1747,11
63477,138,1751,355,1500,16866,251
1236,92,7180,1555,4796,88866,2384
6309,6,57,1502,46,6810,11
68467,32,584,205,447,6982,137
55,233,8436,1566,4846,64376,3590
19550,3,196,1337,131,5724,65
6589,47,974,1497,669,10463,305
35985,31,641,1018,526,12310,115
12183,114,9684,1452,4800,100753,4884
27798,11,484,1178,306,14665,178
50712,128,1677,752,1388,16524,289
37336,138,3736,982,2880,63046,856
47288,4,38,831,29,4930,9
2401,74,3833,1546,2478,55177,1355
67774,20,262,228,218,12780,44
68740,10,97,195,81,1576,16
52576,803,8504,696,6784,49984,1720
12965,53,2636,1442,1423,12165,1213
8769,88,3202,1476,2179,54751,1023
28922,249,8047,1156,6003,68315,2044
54815,14,563,623,148,18393,415
4817,28865,713985,1519,444622,1568291,269363
48973,1,48,798,34,7141,14
4760,11,278,1520,183,15953,95
5410,21,1118,1512,768,14284,350
28234,2,95,1169,64,7101,31
49869,129,2136,773,1821,24893,315
24430,21,576,1252,371,10668,205
56142,10,181,586,150,5603,31
56220,12,135,584,135,8114,0
24241,9,535,1256,370,8686,165
28518,493,6025,1164,3720,27701,2305
37965,0,0,965,0,3369,0
31860,96,3892,1103,2624,39460,1268
57847,5,53,538,46,3819,7
35994,39,601,1018,457,9929,144
9812,2,67,1471,51,5179,16
130,149,5451,1565,2870,41196,2581
64200,302,4531,322,3387,27011,1144
4688,539,15258,1521,11522,100979,3736
18833,26,1001,1350,726,14711,275
2003,67,4129,1549,2661,46107,1468
25257,10,301,1234,225,13432,76
10496,39,642,1466,400,6296,242
35460,50,519,1030,385,7520,134
7712,1510,33625,1483,22369,190236,11256
61978,294,4432,397,3582,32089,850
15139,111,2031,1412,1343,16218,688
3433,82,2420,1536,1774,22955,646
21976,117,2373,1296,1590,20146,783
56711,78,1039,569,861,13862,178
11416,187,6124,1459,3821,44856,2303
15092,11,214,1413,147,6641,67
4756,58,2509,1520,1819,45669,690
60137,0,16,462,14,1430,2
11413,211,8133,1459,5023,70577,3110
60885,22,454,433,356,12846,98
6637,834,28293,1497,17902,71401,10391
53539,37,590,668,507,14585,83
51991,10,240,716,177,19217,63
22190,300,21033,1293,14271,212963,6762
6525,15,331,1498,259,22200,72
68243,15,106,213,90,2680,16
62308,5,137,386,108,4571,29
61140,6753,117949,424,89083,527207,28866
9730,51,1653,1471,1110,41151,543
29554,430,4286,1145,3137,24727,1149
5603,2739,81037,1510,54019,265659,27018
67707,25,377,230,310,2977,67
36767,3,69,991,57,4827,12
6093,903,25040,1504,16365,85147,8675
39959,10215,224406,930,168498,897204,55908
61873,21,299,401,236,3671,63
19093,14,443,1345,318,10578,125
24986,20,580,1239,429,18596,151
5068,4,225,1516,160,17625,65
65492,8,75,297,65,1807,10
49187,153,1833,791,1479,30876,354
66429,51,1406,271,980,15540,426
15911,269,7600,1400,5227,89976,2373
14059,7,117,1426,83,3436,34
44389,43,833,865,662,9160,171
34493,693,12780,1055,10647,152917,2133
16530,11,426,1390,296,13491,130
18931,53,1199,1348,983,30820,216
62235,25,282,388,246,16562,36
3378,166,4388,1537,3139,49394,1249
1968,127,3480,1549,2349,46384,1131
19139,8,608,1344,444,14904,164
22572,347,20194,1287,13922,45847,6272
17426,358,9534,1375,6770,55265,2764
26296,30,840,1212,570,16761,270
57457,57,901,550,735,10502,166
7234,142,4148,1489,3008,30113,1140
35559,49,687,1028,492,10170,195
61269,3,76,419,62,1577,14
12328,5,230,1450,129,27703,101
5124,228,4208,1515,2848,40623,1360
32555,25,1065,1091,748,7949,317
6253,287,14946,1502,10063,113730,4883
301,114,3047,1562,2139,17928,908
45739,49,759,850,553,6728,206
34051,1901,41883,1063,29344,278197,12539
38351,22,334,956,265,6002,69
18230,134,3716,1360,2580,41531,1136
40391,63,869,923,648,13484,221
1001,14,926,1556,635,42187,291
58108,3,180,530,111,3193,69
55621,11,168,600,124,5925,44
65406,32,548,299,462,11300,86
21639,231,9992,1300,6285,133683,3707
63265,75,1206,361,994,12492,212
16560,6,129,1390,70,2869,59
52662,0,17,693,10,1187,7
52022,626,6131,715,4878,58620,1253
1460,167,5122,1553,3374,84328,1748
7471,24,634,1486,462,22959,172
17149,54,1439,1380,874,8379,565
1605,31,1040,1552,777,5848,263
64341,2,19,329,15,1280,4
60954,659,9290,431,7368,37214,1922
31747,34,805,1104,530,17919,275
57779,12,72,540,64,5498,8
60563,50,1176,446,807,18294,369
24642,25,812,1247,541,11866,271
34291,45,1310,1059,857,10035,453
9733,1684,41904,1471,28591,170230,13313
51780,406,3996,722,2854,18963,1142
32336,95,3640,1096,2462,11449,1178
27897,1,90,1176,62,13776,28
37013,8,421,991,305,8815,116
5830,346,17380,1507,10106,82943,7274
3525,65,1534,1535,1076,22925,458
32999,168,3654,1083,2217,24314,1437
18222,2,79,1360,70,20266,9
38479,2759,41713,952,29685,120033,12028
61962,233,8588,398,7029,44042,1559
20229,132,4436,1325,2964,23113,1472
1136,59,4740,1555,3124,42205,1616
32942,27,466,1085,271,3893,195
12068,1322,30413,1453,20547,202990,9866
54337,298,4423,641,3018,23824,1405
22450,594,10500,1289,7765,62011,2735
19582,1,89,1336,72,7755,17
50358,2,31,760,22,5228,9
6972,22,681,1493,437,19281,244
22622,585,12493,1286,8940,50506,3553
49267,29,380,789,274,4383,106
29472,89,2202,1146,1313,20415,889
16935,161,7911,1384,5953,67958,1958
21505,48,1284,1302,875,14636,409
15456,58,3373,1408,2264,52740,1109
63228,68,1233,362,779,12201,454
31740,6,200,1104,126,7206,74
61903,36,287,399,221,4331,66
7142,54,1523,1490,1019,18794,504
57777,34,409,540,308,8157,101
40316,981,14251,925,10993,171452,3258
16516,71,1851,1391,1210,32740,641
58209,84,1593,526,994,28549,599
6207,140,6470,1502,4147,80280,2323
68234,52,627,214,525,6339,102
5189,189,9950,1514,6225,101008,3725
37574,5,85,975,67,4806,18
20177,1,133,1326,90,2691,43
51523,251,3827,730,3074,59650,753
14680,3,143,1418,102,15387,41
10374,37,2088,1467,1347,25855,741
2725,2,94,1543,64,8383,30
4729,2100,25660,1520,15732,64022,9928
46933,32,340,835,240,8366,100
66998,81,810,252,576,7399,234
56511,9,188,575,126,8334,62
56050,57,570,588,435,11844,135
20625,15,1019,1318,738,25828,281
3000,15,844,1540,579,22101,265
54002,27,307,653,248,7842,59
31168,613,12515,1113,8182,120271,4333
7412,4,176,1487,108,8044,68
5341,72,1834,1513,1488,19772,346
68449,21,166,206,120,2849,46
29151,20,648,1152,388,14191,260
64935,154,2160,311,1735,41010,425
63834,234,3740,346,2957,23502,783
33385,714,13328,1068,9376,109278,3952
11283,453,10095,1460,5598,99129,4497
4476,542,12411,1524,8755,78586,3656
35355,25,582,1033,481,15513,101
58949,13,133,502,113,4260,20
14482,50,963,1420,691,39077,272
41711,4,152,902,122,7116,30
52976,276,4629,682,3479,63135,1150
48541,88,1535,811,1202,29174,333
8325,523,12486,1478,8087,48963,4399
62504,16,239,380,172,4966,67
67636,24,183,232,173,3134,10
1903,17,428,1550,299,9676,129
1536,33,1605,1553,1172,36550,433
55882,6,131,593,91,6532,40
56174,563,8599,585,7258,78903,1341
49056,708,7759,795,6058,34503,1701
62832,18,227,372,183,2827,44
35571,10,227,1028,141,2981,86
26612,0,0,1204,0,3109,0
13451,99,3572,1435,2099,56733,1473
50788,5,155,750,117,10331,38
18319,98,5370,1359,3591,43396,1779
59056,2783,53735,498,42319,234326,11416
18396,5,102,1357,80,7896,22
66563,24,250,267,203,6212,47
10062,21,1148,1469,750,32969,398
49516,248,4404,782,3438,19463,966
3271,340,11855,1538,6802,44972,5053
59499,159,2760,483,2086,28226,674
58630,284,3709,512,3049,29453,660
9193,46,2428,1474,1408,15449,1020
22807,89,1265,1283,850,21530,415
40241,33,478,926,378,17165,100
55164,26,173,613,160,7716,13
11532,0,121,1458,62,5990,59
9224,295,4966,1474,3292,29634,1674
41702,257,3285,902,2471,20037,814
63941,18,225,342,189,5148,36
60093,9,246,463,177,8828,69
64139,21,306,335,223,3896,83
50893,158,2034,747,1611,21156,423
50427,45,654,759,521,8017,133
65402,11,167,299,110,4383,57
35226,16,304,1036,206,11624,98
54189,5,51,647,36,2715,15
17502,11,294,1374,242,7175,52
54390,173,2489,639,2184,34431,305
8569,155,3481,1477,2221,26861,1260
53886,1,34,656,30,5515,4
68452,13,233,206,183,5583,50
21900,95,1895,1297,1082,11796,813
45952,6,332,847,188,6475,144
4620,61,1167,1522,887,15979,280
36502,3,150,991,108,4659,42
62475,33,469,381,344,6088,125
70209,388,4746,147,4327,19946,419
54278,70,382,643,302,3972,80
36953,552,14344,993,11808,111570,2536
23568,339,6525,1270,4885,75581,1640
19436,71,2334,1339,1392,31686,942
7859,34,755,1481,537,11495,218
3768,3,61,1533,47,6261,14
32039,26,745,1100,462,5627,283
31196,4,121,1113,92,8150,29
57179,6730,132735,556,96341,586660,36394
31848,59,1329,1103,836,15737,493
35146,43,934,1038,646,24717,288
16724,568,16954,1387,8796,72352,8158
56819,17,215,566,176,5386,39
31363,0,34,1110,20,2283,14
18766,14,737,1351,548,21960,189
41087,13498,274816,912,199301,1563109,75515
14136,331,2910,1425,2019,28027,891
16861,8,230,1385,162,22216,68
29273,113,3740,1149,2469,32804,1271
64959,71,1075,310,962,20716,113
27687,50,1905,1180,1137,23461,768
39025,13,190,942,135,5459,55
14687,282,9619,1418,6746,63847,2873
21391,14,242,1304,188,15528,54
386,187,7371,1561,5055,73911,2316
50046,57,794,768,646,10891,148
27107,74,2557,1193,1545,32627,1012
9712,32,2441,1471,1553,45271,888
1426,39,702,1553,484,25372,218
22815,0,19,1283,17,3274,2
29586,128,1949,1144,1291,21655,658
23129,198,4227,1277,2828,49250,1399
30554,1577,32391,1124,21107,147630,11284
32660,87,2425,1090,1696,17399,729
16238,2023,56569,1395,36911,493496,19658
21834,408,4735,1298,2652,20871,2083
61532,10,106,412,63,4499,43
57192,56,626,556,518,18078,108
8655,111574,4723747,1476,2762178,9260071,1961569
41665,38,642,903,432,3305,210
48547,21,526,811,411,9203,115
16016,38,1533,1398,1062,19530,471
23977,398,15000,1262,10590,142748,4410
24666,13584,283062,1246,184874,1279097,98188
15876,337,6389,1401,4427,32861,1962
9705,517,9796,1471,6481,53037,3315
26421,31,1908,1209,1039,24581,869
31911,45,1012,1102,645,8811,367
8243,1218,30048,1478,18054,77547,11994
27205,64,2156,1191,1352,20963,804
5180,73,2931,1514,2009,27054,922
13415,9,886,1436,508,12696,378
60345,13,160,454,109,3572,51
41637,613,13625,903,10664,66917,2961
62884,643,12041,370,9336,103442,2705
29384,4,213,1148,151,8058,62
68543,16,180,202,148,3463,32
26482,1,66,1208,39,4990,27
19716,131,2622,1334,2037,19802,585
33298,21,381,1078,312,19947,69
56545,452,3630,574,2867,26108,763
14807,2,236,1416,151,4158,85
1737,113,2516,1551,1683,39766,833
31483,19,609,1109,383,15215,226
26744,717,33751,1201,22839,135628,10912
22842,208,4787,1282,3204,49242,1583
13391,189,8617,1436,5396,49131,3221
4725,39,1189,1521,739,16464,450
12431,56,2168,1449,1249,23941,919
24252,10,389,1256,279,18202,110
30962,110,3370,1112,2395,42730,975
7103,285,7594,1491,5275,40618,2319
54084,100,1615,650,1220,18334,395
14353,10073,184738,1422,120214,519642,64524
58779,35,349,507,300,9991,49
24170,66,2288,1258,1487,71470,801
49940,42,566,771,439,10958,127
47751,45,361,825,274,6460,87
8945,10,502,1475,339,6661,163
723,73,1897,1559,1403,33408,494
30118,7,444,1133,267,15424,177
70120,9,85,150,74,3198,11
65625,1,3,294,3,781,0
47957,172,3403,823,2558,50596,845
1502,8,361,1553,262,10051,99
35008,4632,86185,1042,63645,379844,22540
3865,1025,38412,1531,23626,251892,14786
32928,51,1851,1085,1255,35159,596
57957,17,201,535,164,17613,37
12547,19,583,1447,358,4879,225
1293,87,4532,1554,3371,41501,1161
11329,206,4728,1460,2724,32307,2004
5485,10221,332276,1511,201687,1281912,130589
67542,4,55,235,34,2466,21
34229,275,3540,1060,2489,24892,1051
39925,139,2937,931,2102,29620,835
64074,57,1455,337,1111,21867,344
6817,44,2846,1495,1791,31070,1055
50477,1064,8035,625,6596,103126,1439
10583,14,857,1466,571,9684,286
59939,17,202,468,144,6782,58
63878,71,422,344,325,6571,97
53815,18,321,659,208,8464,113
55726,27,375,598,305,6086,70
40259,123,1459,921,1156,14773,303
31585,68,1246,1107,813,21188,433
57985,3,49,534,40,5557,9
24845,56,1422,1242,1030,29346,392
36788,70,1401,998,1136,26592,265
31117,47,1164,1114,715,12375,449
52267,6,63,707,37,4494,26
29967,53,933,1136,665,14392,268
68331,19,271,210,191,5144,80
63016,84,792,368,663,12511,129
36807,19,449,998,379,11300,70
13887,52,1737,1429,1123,41254,614
5111,94,3573,1515,2431,113248,1142
38405,18,521,953,370,13879,151
16253,245,11515,1395,8240,92545,3275
40223,127,2923,926,2210,36739,713
120,1451,79540,1565,53421,374236,26119
50056,17,167,768,143,2642,24
25634,117,4523,1226,2863,61045,1660
17684,0,0,1370,0,19169,0
47347,24,398,830,310,9596,88
24277,8,134,1256,120,19359,14
70003,5,64,154,54,2000,10
53046,43,784,680,624,19133,160
48943,291,4937,799,3620,23439,1317
24410,114,5946,1252,3829,33462,2117
24228,93,2268,1257,1633,46565,635
38327,8,187,956,133,5817,54
30061,47,1469,1134,974,19862,495
7709,16,624,1483,369,35005,255
36699,35,619,1000,501,9108,118
8467,278,11470,1477,7123,145092,4347
31030,434,8935,1115,6266,41929,2669
23928,346,8504,1263,5111,59901,3393
12216,4,327,1452,177,9727,150
60097,218,3231,463,2339,15160,892
9430,39,1163,1473,644,15971,519
15624,15,985,1405,601,13733,384
69846,74,707,159,640,9025,67
29771,2,39,1140,38,2951,1
21256,3876,118965,1307,85494,486574,33471
29109,105,2332,1153,1410,19029,922
60,139176,5660747,1566,3705395,9111182,1955352
60601,74,1411,444,1138,26493,273
56800,275,6655,566,5029,58121,1626
32327,81,2484,1096,1507,20017,977
63813,144,1719,346,1328,12232,391
67306,53,752,242,583,10308,169
25455,35,815,1230,564,9138,251
61482,100,1252,413,1010,12892,242
64029,1385,14552,339,11978,52269,2574
17542,2298,52536,1373,37495,255469,15041
26515,17,790,1207,480,7820,310
3268,29,986,1538,673,9221,313
68525,3,32,203,25,2353,7
13450,804,14847,1435,8918,76710,5929
57977,12,118,534,93,19978,25
6087,8,212,1504,138,7599,74
68316,1,12,210,8,4557,4
67358,657,14421,239,11131,78657,3290
34541,16,723,1054,412,7677,311
8835,854,31081,1475,18291,117565,12790
9782,31159,1144859,1471,688792,2961893,456067
40383,19,226,923,157,4641,69
68744,7,90,195,78,3641,12
6029,49,1808,1504,1124,39564,684
25908,129,1856,1220,1078,13609,778
68570,31,337,201,254,3512,83
32653,55,1076,1090,662,9450,414
17298,1303,27189,1377,18511,257743,8678
35592,113,2733,1027,2156,37059,577
68802,23,397,193,356,10280,41
22839,40,906,1282,643,9937,263
41561,2101,23033,905,16662,149906,6371
60564,9,99,446,81,3654,18
50211,340,3616,764,2784,31637,832
28078,573,8428,1172,4979,52772,3449
21539,0,903,1302,595,12887,308
19317,33,1080,1341,728,12046,352
63136,370,4165,364,3128,46957,1037
9815,81,2415,1471,1467,24347,948
38129,984,15041,960,10878,47067,4163
23725,21,708,1267,478,6303,230
5911,33,769,1506,616,18356,153
61560,3,58,411,44,3286,14
28962,48,1011,1155,646,35464,365
6450,419,20372,1499,12703,86762,7669
64036,11,161,339,129,3322,32
23354,1183,31547,1274,22032,170779,9515
22066,101,2861,1295,1977,36410,884
2335,212,4481,1546,3201,56525,1280
12928,5036,116313,1443,65860,312525,50453
35405,216,3709,1032,2251,29996,1458
65634,31,320,294,252,6465,68
45155,372,3691,856,2857,44743,834
4868,211,7963,1519,5225,78256,2738
38312,142,1806,957,1391,19918,415
3374,1550,33398,1537,21332,172804,12066
36894,23,356,995,265,16125,91
19282,0,0,1342,0,6326,0
31437,10,228,1109,168,5000,60
15989,10,467,1399,343,10206,124
54475,388,5262,636,4052,49840,1210
44649,32,987,862,710,16533,277
20376,13,900,1323,645,15596,255
24763,4,156,1244,112,11859,44
61265,349,6389,419,4982,63865,1407
44526,22,328,863,253,7156,75
4758,194,6698,1520,4700,204142,1998
24955,193,3603,1240,2496,35504,1107
20942,229,7641,1313,5539,61862,2102
41794,79,1631,901,1336,31818,295
24442,28,614,1252,417,9067,197
13602,96,3185,1433,2100,27325,1085
28794,32,932,1159,687,27915,245
43653,58,723,873,523,9495,200
7101,7,322,1491,195,11722,127
31587,449,8649,1107,5904,52511,2745
25300,2625,43700,1233,29660,117883,14040
11221,5,324,1461,177,5893,147
51924,305,3462,718,2554,20066,908
10165,3741,189980,1469,112125,572007,77855
40190,4950,106189,926,86204,298791,19985
55112,5,46,614,37,2931,9
36877,22,493,996,400,9309,93
11804,189,3770,1456,2117,23064,1653
10475,1,143,1466,90,6639,53
62986,42,343,368,255,6004,88
63414,45,558,357,477,11709,81
1797,866,22719,1551,15823,91168,6896
9503,323,8971,1472,5592,69773,3379
51135,101,1545,740,1263,17309,282
69422,3,31,173,25,1737,6
40840,140,2080,916,1651,14915,429
32908,40,933,1085,793,19426,140
31660,9,309,1106,231,5413,78
33653,64,1497,1071,1137,16713,360
20035,18,197,1328,166,8290,31
2794,102,2212,1542,1362,54378,850
34677,42,675,1050,458,9220,217
62118,135,1411,391,1193,13490,218
58658,25,392,511,303,5797,89
2224,1860,60498,1547,37040,259797,23458
64131,395,6953,335,5409,19326,1544
28864,13,365,1158,228,4162,137
6350,31,785,1501,550,18838,235
6033,2,116,1504,81,8323,35
30680,1,177,1122,104,5461,73
68287,5,31,211,28,2606,3
47315,1404,12924,830,10567,78991,2357
63536,577,11642,353,9358,61541,2284
18960,56,603,1348,464,18977,139
17458,88,5278,1375,3379,74735,1899
12704,13,493,1446,255,12925,238
50588,93,863,754,664,9578,199
65544,52,722,296,608,8370,114
7747,10,595,1482,379,30178,216
20730,7,285,1317,207,8449,78
16249,220,6409,1395,4676,54509,1733
12535,255,5296,1448,3583,35510,1713
70193,2,56,147,54,3371,2
70168,3,34,148,31,3993,3
34454,68,2484,1055,1751,32592,733
35998,24,353,1018,256,5504,97
35956,90,2202,1019,1692,33200,510
50689,3,122,752,82,12776,40
69512,34,361,170,318,4515,43
11555,8770,327511,1458,207491,604037,120020
65335,100,473,301,420,5187,53
55629,1,10,600,8,2090,2
20626,8,225,1318,170,10480,55
29939,25,1131,1137,580,9802,551
14698,305,10062,1418,7134,122746,2928
22193,11,267,1293,132,7055,135
30979,329,4712,1116,3512,24843,1200
60700,5,177,440,123,10205,54
53931,85,705,656,593,9698,112
32042,8,197,1100,120,6123,77
52352,3230,45294,704,35036,222291,10258
26014,111,2444,1217,1634,24218,810
20605,69,950,1319,648,14638,302
64555,0,11,323,9,3609,2
12122,21,606,1453,311,10319,295
10689,10,796,1465,539,14169,257
1857,16,376,1550,260,9151,116
68648,277,3199,198,2540,16069,659
419,809,39538,1561,25720,146578,13818
12964,77,2044,1442,1033,23160,1011
12468,813,17910,1448,11271,110207,6639
9561,11,1299,1472,861,13350,438
3304,229,8167,1537,5295,28699,2872
49528,138,2730,782,1877,32767,853
27428,9,143,1186,108,6929,35
55879,71,980,593,810,13684,170
22928,56,1019,1281,829,25096,190
48357,2,154,817,117,10046,37
25474,45,1577,1229,1017,34363,560
62506,2045,27937,380,20984,71921,6953
65621,19,277,294,231,6147,46
13349,48,1526,1437,864,10502,662
22207,99,2946,1293,2032,28602,914
54063,35,344,651,286,8987,58
52120,7,85,711,68,4720,17
64704,24,314,319,275,9327,39
30535,48,852,1124,572,12315,280
48526,1149,163616,811,111482,228584,52134
11440,15,263,1459,158,6250,105
9022,360,12035,1475,7884,61152,4151
19955,40,1417,1330,1069,26849,348
69446,82,774,172,649,5941,125
54060,18,187,651,138,9982,49
27824,13,201,1177,171,15527,30
27443,4631,97401,1186,77629,249794,19772
29138,51,1413,1152,900,33988,513
51981,26,475,717,341,11847,134
64066,24,194,337,157,3014,37
499,271,15175,1561,10649,95512,4526
18537,16,837,1355,649,10724,188
56767,14,145,567,101,7886,44
43797,43,699,872,571,22679,128
59871,5208,119188,470,92008,342095,27180
62507,5,79,380,51,2164,28
19834,290,4668,1332,2877,56980,1791
8635,1450,33642,1476,21346,188973,12296
1286,40,1733,1554,1274,44946,459
52199,7,115,709,90,4600,25
52105,24,284,712,212,6742,72
28225,175,5001,1170,3285,35476,1716
11366,35,1770,1460,944,11411,826
29938,14,509,1137,299,11236,210
52904,97,1281,684,1007,8682,274
24349,0,0,1254,0,18914,0
43934,68,1773,870,1245,32955,528
16252,11,443,1395,305,17689,138
32531,388,7371,1092,5398,35375,1973
68379,7,129,209,101,4106,28
64410,2,152,327,91,5072,61
60547,13,133,446,90,2712,43
4648,12,758,1522,577,13509,181
25419,388,11462,1231,7851,92981,3611
66642,31,422,265,312,8325,110
12660,36,1038,1446,623,21139,415
59837,13,167,472,107,7716,60
38836,39,796,944,607,8809,189
50979,14,168,745,142,6931,26
17429,310,18955,1375,13401,115814,5554
50200,163,1744,764,1450,19759,294
15030,151,4548,1414,2640,23059,1908
21855,50,1340,1297,946,23953,394
28367,28,600,1167,400,19046,200
24661,26,837,1246,564,24402,273
141,85873,4861309,1565,3145607,9678126,1715702
53678,115,906,663,727,10171,179
58384,6,40,520,25,5639,15
21266,68,2916,1307,1984,38117,932
28501,339,9262,1164,6747,90893,2515
62007,22,425,396,338,3984,87
2440,82,4002,1545,2675,75869,1327
36202,4,63,1012,44,3430,19
21559,78,1978,1301,1395,33050,583
20428,70,2745,1322,1861,19509,884
57341,48,671,552,586,10780,85
9395,0,166,1473,109,9164,57
48029,50,688,822,532,9823,156
25443,121,1918,1230,1240,31590,678
6726,52,2618,1496,1693,41345,925
66631,48,546,265,476,9437,70
67871,830,11228,223,8912,52498,2316
11465,930,31265,1459,20532,93810,10733
1808,10,349,1550,256,10356,93
22646,251,5778,1286,3720,137626,2058
65031,1,59,307,50,5489,9
20678,0,67,1318,67,4188,0
18251,1,100,1360,78,7338,22
65056,169,2358,306,1868,10908,490
10784,227,4068,1464,2815,43711,1253
56361,79,1583,579,1227,10464,356
13829,181,10099,1430,5947,47544,4152
5627,13,589,1509,395,37423,194
40077,24,287,928,159,3366,128
22274,18300,356953,1292,191305,987301,165648
49349,164,1985,786,1537,29190,448
1717,15,788,1551,493,12345,295
30242,1,80,1130,56,10029,24
58311,673,14034,499,9727,69342,4307
35307,524,7017,1034,5829,34610,1188
69615,7,82,167,70,1455,12
37460,9116,127936,978,104801,567733,23135
30476,5,235,1126,146,11758,89
52890,12,101,685,75,4209,26
6745,1970,47938,1495,30291,335062,17647
19544,31,1582,1337,1097,37028,485
52442,21,381,701,307,5559,74
28967,3,183,1155,112,5453,71
51236,18,218,738,178,7934,40
31738,52,1749,1104,1109,30381,640
13789,73,2396,1430,1384,23869,1012
21132,631,9296,1309,6151,33206,3145
19162,4,101,1344,87,8669,14
67429,174,3333,239,2775,32775,558
42492,8632,233728,890,179198,557993,54530
2659,6,330,1544,205,21403,125
37750,2,41,971,32,4450,9
924,24,1008,1557,736,16037,272
49016,41,313,796,222,6583,91
31221,2452,53466,1112,37594,172567,15872
19665,7054,260041,1335,161447,968185,98594
60357,18,204,453,157,5518,47
13090,124,4693,1440,2876,99939,1817
8314,39,1763,1478,1167,29075,596
8556,296,8124,1477,4939,75282,3185
33727,42,954,1070,695,23416,259
69345,68,604,175,516,7754,88
65200,14,197,304,155,2281,42
23965,2019,87265,1262,52158,277369,35107
12252,138,4112,1451,2767,80044,1345
50832,6,67,749,53,2640,14
29521,477,19831,1145,12038,191207,7793
52266,6283,103185,707,77264,266102,25921
32634,173,3872,1090,2459,44366,1413
8862,52,2813,1475,1827,27008,986
8226,39,1026,1478,676,15278,350
27584,0,0,1182,0,30806,0
49094,49,451,794,353,4413,98
35496,1116,24109,1030,18932,156173,5177
15152,4226,151669,1412,98662,256841,53007
26116,1767,26563,1215,17918,70776,8645
53019,29,264,681,190,6893,74
9613,5,217,1472,151,5460,66
16179,376,10645,1396,6394,73650,4251
43137,509,7041,879,5704,44820,1337
58198,49,731,527,612,12390,119
21027,34,1268,1311,976,18020,292
45073,13,274,857,226,9614,48
3386,82,4523,1537,3296,96696,1227
9357,18,326,1473,193,3746,133
7172,6,431,1489,279,11275,152
25651,25,672,1225,409,9832,263
12156,39,767,1452,486,10641,281
51936,398,5705,718,4404,30258,1301
15693,146,3231,1404,2290,26961,941
19199,66,1158,1343,837,8603,321
14392,1623,66861,1421,41387,380953,25474
15842,814,27363,1402,18477,119378,8886
12185,233,10455,1452,6002,55243,4453
60212,338,5116,459,4085,53822,1031
25539,258,5587,1228,3964,26252,1623
54303,3,55,642,41,4466,14
30175,7360,186014,1131,127979,786754,58035
46247,56,884,844,750,14531,134
13237,16,1063,1438,533,12477,530
8645,6,751,1476,486,22590,265
14915,7555,174313,1415,100385,505926,73928
38579,74,1818,949,1317,15757,501
8935,1,129,1475,81,9350,48
67338,29,567,241,422,5040,145
2033,5,351,1549,288,29877,63
70569,16,302,134,263,7044,39
11752,24,1281,1456,637,26235,644
24938,251,4388,1240,2061,29834,2327
29399,181,3593,1147,2517,49601,1076
39229,121,1628,940,1338,47781,290
7501,341,18017,1486,12551,64179,5466
5732,22,1155,1508,655,29701,500
60282,35,686,456,427,12587,259
60822,101,1723,436,1358,7438,365
23302,117,2358,1275,1781,17627,577
817,365,28190,1558,17134,260984,11056
57492,12,194,549,127,6711,67
28393,3,112,1166,93,13859,19
24077,22,523,1260,372,9766,151
43039,12,116,881,93,4773,23
25713,1972,66102,1224,45390,235606,20712
3542,1404,70362,1535,40442,305429,29920
6218,111,4590,1502,3054,48334,1536
8601,37218,1178087,1476,729475,1909568,448612
31827,3,82,1103,55,4287,27
11173,6158,443191,1461,221805,942098,221386
67301,0,15,242,10,3008,5
26729,167,2075,1201,1435,54519,640
55947,14,143,592,122,5015,21
51595,32,349,727,249,3506,100
37788,15,327,970,233,12853,94
35993,35,884,1018,624,31844,260
1009,6141,210637,1556,123011,559937,87626
36556,26,701,1001,591,13598,110
56301,3,70,581,52,4233,18
12011,237,5220,1454,3243,31178,1977
24639,30,544,1247,360,5126,184
70274,4,45,145,38,2031,7
64067,2499,40626,337,32313,220428,8313
62347,96,2355,385,1686,23423,669
22533,10,411,1288,275,6705,136
48908,2,36,800,31,1721,5
61771,14,185,404,163,5797,22
55093,122,1115,615,859,13593,256
63736,0,0,348,0,8482,0
2371,30,1522,1546,1129,19184,393
35825,5,127,1022,98,4055,29
16860,53,1949,1385,1384,53019,565
6245,414,11594,1502,7615,50777,3979
7561,18,520,1485,344,26428,176
52181,11,162,710,121,6196,41
52670,2,41,692,29,2874,12
53707,222,3210,662,2625,26126,585
62731,0,29,374,26,2353,3
17965,282,7019,1365,5000,50241,2019
21059,1492,32272,1310,26449,255606,5823
70264,16,314,145,290,6387,24
22442,40,1648,1289,1197,24684,451
44333,1347,21100,865,16714,86171,4386
19224,17,1277,1343,821,16149,456
13678,18,595,1432,364,32389,231
26711,10,218,1202,140,5204,78
42620,165,2805,887,2263,26471,542
34209,80,1637,1060,1255,34112,382
51555,21,325,729,237,9879,88
37257,175,1867,984,1444,21464,423
36428,87,1655,1005,1223,29208,432
3154,38,944,1539,699,19986,245
28802,68,2033,1159,1195,9210,838
16916,520,15530,1384,9893,68269,5637
20566,84,3420,1320,2270,85373,1150
33857,0,100,1068,84,8409,16
10087,248,7653,1469,5130,58300,2523
64879,100,1082,313,684,11266,398
27098,14,180,1193,113,3735,67
26789,52,2384,1200,1389,20654,995
68035,172,3248,219,2683,10353,565
25678,565,8493,1225,5278,83151,3215
56059,131,1376,588,1083,20740,293
831,4,152,1558,109,9536,43
17406,4901,142515,1376,85445,386826,57070
15285,5,290,1410,215,12001,75
64511,4,77,324,61,2913,16
4492,339,6262,1524,4323,58887,1939
28031,53,1145,1173,783,16909,362
6781,20,1304,1495,885,34609,419
22579,32,799,1287,557,23068,242
15181,168,3909,1411,2740,39506,1169
36274,40,1007,1010,864,24075,143
53925,50,1309,655,985,52124,324
60201,9,78,459,54,7116,24
37951,424,8765,966,7252,49046,1513
56246,168,2888,583,2288,27120,600
64871,25,495,313,317,7919,178
22422,117,3019,1290,1950,13484,1069
851,61,2125,1558,1428,34182,697
53943,9,102,655,91,6513,11
12266,7,814,1451,376,10708,438
66202,12,132,277,98,3732,34
63849,27,277,345,209,5226,68
69180,0,0,180,0,613,0
12476,465,28801,1448,15660,115967,13141
57221,350,4154,556,3209,23799,945
61085,354,5295,426,4391,63070,904
41086,41,511,912,390,11395,121
58546,0,14,515,11,1748,3
22143,0,0,1294,0,5843,0
38515,51,919,950,628,9583,291
12254,7020,122366,1451,75317,271610,47049
8807,137,3038,1475,1871,19930,1167
2855,66,1501,1542,953,22649,548
33558,42,926,1073,717,27519,209
20729,673,11681,1317,8239,100486,3442
18834,4,135,1350,96,8628,39
30187,67,1246,1131,877,24687,369
44746,1,90,861,75,5542,15
53566,84,743,667,598,21778,145
12422,141,2929,1449,1851,34298,1078
56074,84,1162,588,859,22386,303
68637,14,789,196,671,15749,118
24258,68,2530,1256,1713,28525,817
35117,9021,241302,1039,162894,780910,78408
19122,550,25293,1344,17792,221782,7501
6181,2,105,1503,72,6532,33
53368,1,66,672,45,7411,21
50192,14,193,765,147,8413,46
69654,67,1148,165,1041,10493,107
7824,3056,138535,1481,92044,325236,46491
69397,104,860,173,750,9142,110
57602,4,40,546,37,2645,3
32179,9,477,1098,301,6330,176
23717,296,7569,1267,5106,33687,2463
57435,163,1112,550,835,24573,277
40633,68,2039,920,1710,26120,329
38011,122,2083,964,1591,14208,492
34224,2568,36526,1060,26617,83314,9909
27777,40,1318,1179,858,13613,460
3557,639,15597,1535,9834,111303,5763
14887,845,22802,1416,15088,92008,7714
4625,15,406,1522,283,15488,123
14898,192,4466,1415,2998,22979,1468
1899,145,6824,1550,4323,43955,2501
61113,410,3378,421,2847,22563,531
22035,3,52,1295,39,5595,13
58930,352,4236,502,3403,14357,833
34956,102,2309,1043,1470,20470,839
53042,116,1035,680,876,14257,159
20303,85,2077,1324,1478,32344,599
15116,74,3132,1412,2160,35453,972
19571,145,2285,1337,1562,15511,723
30820,102,2474,1119,1630,21713,844
15883,27,749,1401,481,9792,268
2427,14,669,1545,490,20842,179
22395,30,1520,1290,1041,17910,479
9516,321,19579,1472,10639,82814,8940
22289,134,1745,1292,1205,13586,540
19347,236,5217,1341,3093,36107,2124
29576,188,3249,1144,1687,13465,1562
18358,40,1585,1358,1104,10369,481
3354,17,394,1537,233,12724,161
30816,2672,63233,1119,41968,224252,21265
6005,14,1205,1505,727,12111,478
2677,65,1632,1543,1024,20454,608
67291,78,944,243,742,5883,202
65830,127,1354,289,1065,14542,289
35320,61,905,1033,596,94345,309
60500,20,134,448,111,4082,23
41662,678,9709,903,7280,38659,2429
28458,1,134,1165,49,8943,85
10605,43,2356,1466,1514,48356,842
4336,82,2552,1526,1884,19545,668
18465,31118,521133,1356,350293,1224264,170840
63935,32,558,342,446,6254,112
69230,119,7101,179,6150,12295,951
32288,450,10783,1096,7536,68458,3247
8312,18,1075,1478,699,27864,376
1281,130,1823,1554,1289,13451,534
13645,8,682,1432,468,21613,214
49102,811,18228,793,11433,290765,6795
19968,49,2472,1330,1565,17278,907
36426,15,352,1005,277,6820,75
24444,3178,86758,1252,59017,458698,27741
64045,59,623,338,498,14796,125
3555,18,556,1535,361,8158,195
11944,259,6511,1454,3736,53193,2775
67525,773,9347,235,7152,61812,2195
23265,16,794,1275,574,34801,220
42204,142,3221,895,2582,53925,639
9652,25,1196,1472,746,14447,450
54841,939,10271,622,8300,90802,1971
34401,2,110,1056,80,5588,30
29866,135,5340,1138,2698,29759,2642
45295,129,2253,855,1929,24323,324
35464,92,1186,1030,888,14479,298
31091,139,2756,1114,1771,19607,985
22384,112,2488,1290,1753,41970,735
17179,139,3910,1379,2729,55307,1181
28273,9,205,1169,142,3761,63
65412,84,967,298,820,12462,147
66323,20,306,275,245,6681,61
59200,51,409,494,322,9998,87
60222,729,17028,458,12008,56643,5020
24847,16,482,1242,338,6699,144
12074,200,3802,1453,2360,20821,1442
40842,50,683,916,562,13801,121
21674,14,634,1300,396,5951,238
1096,771,35855,1556,24137,162881,11718
41447,1558,24191,872,17517,154851,6674
27961,57,929,1174,603,12579,326
17812,12,508,1368,407,11463,101
13469,1136,26601,1435,15798,187865,10803
50685,815,11580,752,9605,88119,1975
12029,27,915,1453,534,13569,381
68068,73,1506,218,1200,6780,306
9065,78,2611,1474,1918,42901,693
35409,11,304,1032,187,7920,117
68824,95,1611,192,1330,14584,281
25113,5457,118634,1237,74865,575550,43769
4829,3,146,1519,98,11274,48
19932,3,107,1330,94,6805,13
5596,8,1166,1510,805,23074,361
23847,323,11059,1265,8065,72951,2994
29840,478,7357,1139,5270,29604,2087
49727,466,4947,775,4006,42480,941
67128,0,11,249,7,2051,4
54476,4,56,636,50,3697,6
54232,14,186,645,145,6583,41
3454,307,11684,1536,7620,66999,4064
39299,120,2865,939,2440,25855,425
29457,970,24143,1146,19816,83843,4327
25719,4,83,1224,66,6684,17
60650,23,473,442,396,8931,77
37179,29,408,987,307,17179,101
69680,17,200,164,178,4504,22
25453,37,1089,1230,728,11170,361
2727,910,63959,1543,41507,241316,22452
34226,58,721,1060,525,7988,196
11624,25,2105,1457,1148,20726,957
12925,523,14794,1443,8502,44676,6292
56735,103,1001,568,708,9316,293
11895,41,1656,1455,803,24726,853
67041,21,840,251,609,9568,231
9679,1,8,1472,8,5579,0
6941,30,1185,1493,835,20747,350
53015,106,1224,681,972,21103,252
23273,15,619,1275,491,24172,128
46648,108,983,839,726,7371,257
34863,68,856,1045,505,7518,351
9957,858,18909,1470,11381,117089,7528
18923,127,1889,1348,1239,19288,650
5653,33,1894,1509,1194,10646,700
65480,102,1485,297,1229,7213,256
17376,6,76,1376,64,6419,12
42093,745,20315,895,16291,149279,4024
64683,8,68,319,56,3569,12
62011,5,108,396,88,3194,20
20889,7852,189201,1314,119807,607196,69394
7446,140,5876,1486,3393,20626,2483
49212,36,1707,790,1369,12770,338
16994,20,246,1383,170,8656,76
67159,44,497,247,396,10821,101
4509,9,214,1524,165,10571,49
21748,16,360,1299,241,16311,119
56944,7,70,562,41,6611,29
69564,19,402,169,340,10032,62
1749,109,3869,1551,2550,62978,1319
40246,27,444,926,356,32203,88
11052,1025,29099,1462,18050,114705,11049
35296,14,756,1033,455,10796,301
12040,431,12811,1453,8354,66388,4457
62068,125,1099,394,867,15142,232
39374,75,1421,938,980,12893,441
52526,264,2600,697,2145,70755,455
64766,23,491,317,341,8520,150
40986,90,8070,912,6610,38248,1460
2073,182,3319,1548,2521,20867,798
6900,16,292,1494,188,6137,104
40950,198,3127,914,2350,24498,777
32586,440,7788,1091,5508,44516,2280
64777,50,893,316,721,13098,172
10541,170,3659,1466,2513,19762,1146
22868,70,1052,1282,714,11908,338
26080,139,4824,1216,4092,39869,732
52868,15,185,685,145,9578,40
56956,43,335,562,263,4079,72
22602,1140,28624,1287,19617,198937,9007
57125,54,1212,558,944,13376,268
8113,2,313,1478,218,5496,95
64905,4463,90027,312,70240,330917,19787
44166,324,5663,867,4607,61374,1056
6162,734,22988,1503,14156,60428,8832
24925,190,2070,1241,1428,22582,642
8372,25,1362,1477,892,17353,470
70171,21,182,147,149,1903,33
6569,78,2821,1498,1700,50692,1121
31897,133,3867,1102,2805,37934,1062
43245,8,100,877,78,2786,22
55386,119,1450,606,1183,16855,267
37265,341,12513,984,9262,29242,3251
50910,116,1671,747,1307,13861,364
63206,5,82,362,61,4234,21
28413,72,2163,1166,1430,31915,733
41450,52,903,907,673,11626,230
6220,188,5813,1502,3994,48372,1819
12523,97,3340,1448,1901,28578,1439
42772,39,891,885,750,17382,141
66691,44,524,263,406,3884,118
31641,59,1152,1106,718,13984,434
52093,646,9868,712,8151,91598,1717
3483,967,31535,1536,21217,71318,10318
3490,165,2628,1536,1854,19314,774
228,210,6707,1563,4393,76147,2314
29021,3,155,1154,97,5631,58
66877,33,507,257,413,14193,94
61417,92,901,415,803,20480,98
41659,88,5217,903,3358,15798,1859
64207,29,361,333,302,7753,59
19131,51,1523,1344,1204,21893,319
22417,62,2960,1290,2391,32477,569
20537,176,7352,1320,5167,47345,2185
3546,65,1811,1535,1166,13755,645
66573,0,6,266,3,663,3
48935,10,284,799,224,4756,60
69870,389,8395,158,7204,59698,1191
63304,124,1835,360,1400,16235,435
56726,71,569,569,453,6150,116
10180,429,23523,1468,16204,135873,7319
44274,25,295,866,235,8083,60
49256,142,1215,789,943,18583,272
55215,1384,15753,612,12214,121920,3539
61922,68,1034,399,807,9869,227
48530,7,90,812,62,10185,28
29259,452,9199,1150,6744,66667,2455
2545,26,568,1544,365,27629,203
27606,20,1269,1182,839,30150,430
65663,1253,15572,293,12531,66046,3041
56157,34,418,585,367,8662,51
62191,34,407,389,340,8527,67
2151,2,163,1548,121,11572,42
48552,0,30,811,24,2365,6
49833,38,663,774,528,13028,135
51041,66,1477,743,919,11005,558
19075,45,1967,1345,1386,41807,581
3518,461,9382,1535,6282,63397,3100
29133,194,7404,1152,4908,50189,2496
55839,42,312,595,289,17539,23
52165,23,364,710,231,6823,133
62757,19,196,373,162,11226,34
61262,69,1241,419,998,5245,243
68677,1,56,197,35,3792,21
54188,5,71,646,39,6326,32
57590,12,109,546,82,5426,27
40479,53,1127,922,914,13549,213
3831,26,748,1532,544,19131,204
15934,23,693,1400,473,12825,220
24949,7,223,1240,141,12650,82
47303,66,1092,830,836,21841,256
31469,170,3022,1107,2269,65601,753
49664,8,148,778,102,7883,46
9127,253,6607,1474,4638,35901,1969
27346,79,1873,1188,1209,25119,664
65221,42,522,303,401,7817,121
18937,17,1331,1348,919,31430,412
11148,180,6693,1461,3691,46262,3002
59451,9477,244573,476,182229,866732,62344
14781,14,442,1417,320,10492,122
1936,885,25360,1550,16909,120824,8451
60273,2,49,457,41,4968,8
29514,52,1169,1145,780,18775,389
66629,118,1836,265,1427,10965,409
34494,304,3170,1054,2549,21571,621
16331,7,129,1394,81,7969,48
26996,274,8367,1195,5031,50212,3336
69498,184,2943,171,2696,15661,247
54231,14,169,645,117,4041,52
50327,5592,71517,761,48049,218711,23468
33023,29,848,1083,599,9709,249
37072,2,48,990,38,2898,10
13235,134,4900,1438,3060,57235,1840
27305,31,1311,1189,752,11526,559
21584,31,1697,1301,1142,16339,555
64659,30,420,320,322,3264,98
6348,8105,468089,1501,287717,1226222,180372
16715,380,11604,1387,7914,106620,3690
16956,27,1867,1383,1323,13881,544
51603,571,15715,727,12388,66413,3327
41684,8,252,902,209,19064,43
33569,4,65,1073,46,1766,19
60691,18,230,440,186,5827,44
9083,740,13088,1474,8343,42718,4745
624,159,2343,1559,1618,10710,725
5525,39,1019,1510,659,16312,360
25590,145,7109,1227,4453,66760,2656
65771,3,58,290,49,3995,9
36442,29,566,1005,444,15011,122
47364,46,1001,830,873,45682,128
2217,13,665,1547,483,22692,182
8148,2,249,1478,172,9962,77
6305,5,115,1502,72,5100,43
31134,25,909,1114,603,6493,306
12083,17,832,1453,428,15272,404
62863,2031,37695,371,30563,190961,7132
41255,207,3177,910,2502,31558,675
3545,310,19523,1535,11549,97937,7974
14170,179,6068,1425,4152,37685,1916
54868,1396,19078,621,14729,73780,4349
23513,28,1163,1271,662,16772,501
4393,14,168,1525,94,5261,74
37022,3972,94540,991,69473,292339,25067
436,12735,336316,1561,198601,621534,137715
24831,44,902,1243,625,11566,277
37700,6,171,972,144,14679,27
37522,30,897,977,689,26337,208
66641,0,54,265,39,9634,15
17315,2,142,1377,127,14940,15
68041,8,85,219,68,4257,17
8271,42,1229,1478,839,16404,390
29338,3,88,1148,61,7198,27
14656,163,5786,1418,3971,26137,1815
58647,5,65,511,46,6220,19
13501,62,2641,1434,1547,20800,1094
9884,395,13994,1470,8914,64986,5080
57046,5419,122528,560,85083,312370,37445
26689,931,20662,1202,15363,212689,5299
35252,1295,30026,1036,20484,182970,9542
5122,9,132,1515,95,20724,37
60166,29,298,460,218,8170,80
50293,5,70,762,60,2747,10
14370,1,152,1422,81,3456,71
39634,0,0,934,0,19159,0
52778,77,1384,689,1145,17149,239
20310,89,4434,1324,3251,34538,1183
14743,1,39,1417,31,9069,8
6962,115,1889,1493,1334,31454,555
35031,91,1947,1041,1501,22621,446
38139,161,2686,961,1957,14548,729
1996,69,2802,1549,1904,34242,898
15269,51,1552,1410,1012,26530,540
30403,5,374,1127,232,17330,142
64534,140,2093,324,1627,9496,466
64670,2,50,305,46,2672,4
8596,49,1386,1476,847,31974,539
8276,101,6313,1478,3723,57681,2590
18731,173,4066,1352,2839,67709,1227
60706,193,3466,440,2569,15591,897
31481,55,2498,1108,1316,16648,1182
37279,16,570,983,451,13572,119
7642,47,1274,1484,831,38380,443
10401,3,225,1467,97,6627,128
11165,1024,20050,1461,13080,75244,6970
54158,8,73,648,59,5251,14
30767,16,534,1120,340,4698,194
52139,27,251,711,217,5776,34
31724,8752,180983,1105,111096,665474,69887
49705,170,2159,777,1736,33796,423
60371,8,185,453,160,8485,25
10893,31,1464,1463,964,35248,500
7417,272,5175,1487,3546,30422,1629
16631,8,190,1389,108,3675,82
45589,65,790,852,634,28489,156
33596,104,2777,1073,1918,22243,859
19127,3,422,1344,322,18714,100
35491,29,293,1030,216,4686,77
21668,10,349,1300,237,4613,112
47021,154,1857,835,1292,11609,565
55712,25,281,598,230,8074,51
31359,89,1685,1110,1062,21972,623
20841,105,1655,1315,1166,17306,489
59488,28,184,484,147,4911,37
34916,51,782,1044,484,11213,298
24393,111,8400,1253,5444,41301,2956
63684,12,162,350,127,5053,35
56561,53,912,573,647,19887,265
65878,8,58,287,48,1438,10
67607,5,129,233,97,5320,32
1045,69,1694,1556,1221,21058,473
9056,54,1277,1474,804,14139,473
6573,54,792,1498,512,7353,280
50321,6,75,761,60,2187,15
55305,1,22,609,21,3029,1
62049,6,60,394,47,2545,13
27992,12,169,1174,109,2871,60
30188,3,224,1131,133,5094,91
28369,53,1630,1167,1115,24209,515
7603,15,338,1484,247,7888,91
14969,53,813,1414,574,12381,239
58979,27,300,501,227,9059,73
63120,75,793,365,641,12800,152
52914,79,889,684,743,17259,146
25994,230,8001,1218,5223,42133,2778
15110,17,407,1412,290,6432,117
47488,1044,14147,828,10280,41066,3867
18905,52,557,1348,431,11440,126
2016,45,1635,1549,1239,21364,396
65482,9,165,298,143,4964,22
36086,14,249,1015,172,15898,77
40415,3,48,923,22,1744,26
36436,149,3816,1005,3325,33986,491
22042,7,274,1295,163,8788,111
31682,34,870,1105,691,11688,179
64497,0,8,325,8,1930,0
51680,19,381,725,303,10393,78
58813,778,14414,506,10892,81231,3522
845,223,6971,1558,4860,45533,2111
15085,0,0,1413,0,6211,0
46851,525,11246,836,7963,67990,3283
6894,26,697,1494,453,28051,244
29309,137,2202,1149,1531,24979,671
18403,5,373,1357,255,13608,118
17728,54,1864,1369,1357,17683,507
21997,189,3736,1295,2129,28197,1607
40858,23,571,916,420,18599,151
3878,109,3086,1531,1688,22767,1398
33074,16,377,1082,243,10573,134
37459,54,857,979,683,13410,174
49078,31,482,795,437,18568,45
38343,16,303,955,238,23695,65
7507,91,2085,1486,1471,15083,614
49996,345,3756,760,2908,29133,848
19125,285,4521,1344,3137,45416,1384
10450,94,1992,1467,1324,19131,668
69810,15,108,160,86,3744,22
5542,30,1894,1510,1376,18993,518
33588,135,3917,1073,2390,17321,1527
30612,3417,67493,1123,42279,319886,25214
69604,43,303,166,264,3690,39
35372,15,474,1033,387,11769,87
17501,74,2846,1374,1945,26965,901
56334,5,60,580,42,2503,18
39290,30,498,939,408,8476,90
24762,29,591,1244,465,13034,126
25037,172,8332,1238,5375,51310,2957
17445,33,1117,1375,823,15723,294
61029,13,231,428,155,6076,76
46828,2,133,837,94,4574,39
52596,48,754,695,596,8123,158
69423,102,1481,173,1268,11373,213
17344,59,1041,1377,800,23996,241
29307,132,4999,1149,4047,26622,952
52612,18710,464319,694,357680,1298579,106639
70285,45,296,144,279,2238,17
2433,26,541,1545,414,12363,127
2698,364,9224,1543,6488,135243,2736
45940,17,301,848,239,6206,62
35100,90,1572,1040,1075,13251,497
59561,4,57,482,47,2753,10
8741,3417,137878,1476,72291,333530,65587
57155,66,752,557,616,20882,136
60098,109,875,460,660,9952,215
70204,210,3860,147,3445,22270,415
65864,8,99,288,83,6451,16
53619,6,55,665,45,2241,10
64805,30,277,316,243,5356,34
53778,14,362,661,238,10189,124
9154,6,300,1474,191,14865,109
25325,126,3231,1232,1975,32275,1256
32656,583,10317,1090,7666,88268,2651
1750,99,2490,1551,1767,26190,723
69910,9,207,156,164,4653,43
1165,33,1686,1555,1138,25570,548
8803,7,259,1475,158,7661,101
21941,198,4076,1296,2978,43963,1098
64170,19,303,334,244,10256,59
15465,12,567,1407,388,10446,179
21960,101,3894,1296,2115,50125,1779
21125,6934,236043,1309,152035,1184045,84008
36854,60,829,997,638,12091,191
5130,538,13057,1515,8161,102015,4896
59493,22,301,484,234,5196,67
9069,59,2491,1474,1567,36189,924
29392,170,4730,1147,3134,67712,1596
23297,15,358,1275,230,3662,128
23964,151,3013,1263,2080,27494,933
30544,274,9300,1124,6391,54085,2909
52347,15,317,704,232,10191,85
52634,125,1787,693,1476,19108,311
49873,17,357,773,259,4888,98
27638,103,3579,1181,1984,20274,1595
8504,49,1720,1477,1019,26940,701
21816,19,774,1298,451,15570,323
22468,80,3891,1289,2675,50814,1216
25941,9450,258001,1219,160957,894679,97044
16422,23,455,1392,302,9272,153
26304,33,1499,1211,950,18891,549
45100,2,107,857,48,2607,59
57867,126,5600,537,3556,23051,2044
66330,3,35,274,25,1098,10
4412,283,9647,1525,6549,47295,3098
52546,51,827,697,699,10653,128
18637,2,70,1353,60,5457,10
34833,101,3167,1046,2181,90851,986
28850,1794,39083,1158,27523,143283,11560
35957,225,6265,1019,4694,35343,1571
35711,40,1022,1025,725,14540,297
59809,2245,45782,473,35741,142681,10041
31855,9,375,1103,230,10202,145
41625,49,718,904,543,21718,175
9362,92,2037,1473,1442,33982,595
69917,245,4752,156,4229,33216,523
2770,883,23538,1543,16349,106311,7189
44866,112,1623,860,1313,16128,310
52907,5430,109463,684,83463,478344,26000
66855,12,73,257,58,2867,15
21117,1156,26789,1309,17575,199193,9214
56550,63,593,573,476,6021,117
68210,14,149,214,121,3537,28
21310,14,299,1306,218,14268,81
61625,801,15549,406,12133,123833,3416
58560,477,4733,514,3521,17914,1212
50118,40,390,766,317,8570,73
67349,6,78,241,62,3257,16
33418,2,83,1076,52,7316,31
25936,3,181,1219,151,10245,30
7458,95,9928,1486,6555,73479,3373
4276,30,841,1527,629,56497,212
69828,10,69,159,65,5918,4
31715,19,429,1105,276,4063,153
8197,589,36828,1478,20492,146104,16336
60852,142,1448,434,1153,16213,295
26845,20,476,1199,401,32083,75
30233,17,938,1131,710,33826,228
39928,2994,39047,648,30693,221381,8354
67266,3,30,244,27,4601,3
28392,272,4709,1166,3236,23376,1473
66309,20,155,275,124,3625,31
4012,12,197,1530,138,5782,59
33200,951,16832,1080,10613,73378,6219
34959,809,16245,1043,12781,134660,3464
22673,7,68,1285,53,3102,15
13097,25,847,1440,470,67039,377
52555,10,227,697,167,4050,60
17118,3,204,1381,149,15504,55
10933,33,1828,1463,997,13043,831
25090,217,3729,1237,2310,20727,1419
11751,4,467,1456,241,14884,226
34377,2,169,1057,109,8681,60
13422,25,1623,1436,1020,27512,603
21870,88,1251,1297,786,15719,465
29977,6030,121562,1136,70840,401624,50722
9865,48,3306,1470,2241,31421,1065
69656,85,1431,165,1344,12522,87
1558,1487,53638,1552,28542,109427,25096
9457,238,8750,1473,4785,39392,3965
48571,30,361,810,295,8833,66
28132,8,562,1171,372,20933,190
52816,30,432,687,336,13638,96
9287,73,5005,1474,3178,25619,1827
15687,28,1970,1404,1405,21672,565
45894,13989,325589,848,231062,1101793,94527
49311,53,582,787,410,17897,172
22821,3604,104647,1283,69668,290237,34979
34559,1,33,1053,32,2808,1
64815,21,255,315,225,7923,30
31237,73,1629,1112,1186,15946,443
9668,38,1180,1472,827,55560,353
5332,11,775,1513,465,17884,310
30448,13,254,1126,155,7499,99
50237,68,1572,763,1208,27102,364
55301,6,120,609,57,4521,63
44268,21,377,866,282,5472,95
20860,6,594,1314,422,13802,172
7710,65,2262,1483,1571,42976,691
27213,131,2383,1191,1574,12343,809
6445,5,168,1499,130,16934,38
27875,75,1203,1176,1015,14425,188
61010,9,75,429,63,5735,12
8566,542,23763,1477,14506,159801,9257
56690,25,280,570,238,5968,42
37361,20,537,981,477,15101,60
34033,61,781,1064,474,5577,307
21384,366,8221,1304,5184,50484,3037
25254,4,135,1234,107,7627,28
32554,2364,54046,1092,34432,310176,19614
27801,0,0,1178,0,19766,0
3808,9,142,1532,111,21375,31
28977,27,748,1155,482,3819,266
20561,697,12759,1320,9328,86994,3431
4664,64,1771,1521,1213,37569,558
33695,11,263,1070,205,9578,58
23529,76,2806,1271,1609,22827,1197
54097,137,1529,647,1249,23345,280
41535,44,1278,906,1064,18261,214
23748,413,6440,1267,4514,62872,1926
28432,129,4347,1166,2871,46383,1476
47516,21,406,828,287,8415,119
31263,201,5409,1112,3623,43501,1786
2512,32,1007,1545,669,24344,338
33792,64,1883,1069,1215,28998,668
48430,149,2460,816,1851,32593,609
11435,97,2050,1459,1330,11713,720
25550,19,323,1228,213,10172,110
69390,19,221,174,166,4565,55
26407,42,550,1209,465,19062,85
64621,7,318,321,249,7265,69
24291,7,136,1255,84,3826,52
12299,100,3045,1451,1728,29741,1317
18043,583,13818,1363,9467,126855,4351
63168,741,8451,363,6812,75940,1639
35596,43,1110,1027,797,20471,313
53060,632,9074,680,6953,75929,2121
10338,14,1229,1467,735,16092,494
58308,28,258,523,207,6546,51
19226,130,4348,1343,3014,48595,1334
22817,1,145,1283,110,10809,35
57736,3,39,542,33,1575,6
50136,33,360,766,291,4112,69
18149,8,236,1362,186,13465,50
66737,4,69,261,54,5829,15
152,498,5319,1564,3744,29478,1575
22993,178,5343,1280,3900,27047,1443
55064,23,159,615,138,8169,21
61090,3,65,426,48,2826,17
60568,172,2122,445,1701,15294,421
54236,68,553,645,425,6039,128
33887,10,401,1067,286,10775,115
4490,31,3169,1524,2137,24809,1032
46499,11,419,841,335,18229,84
35390,484,8063,1032,6078,36525,1985
18421,368,15382,1357,10490,97891,4892
59666,57,460,478,354,5988,106
54689,310,2674,628,2214,36473,460
52400,208,2365,702,1837,10959,528
15390,318,7998,1409,5529,107550,2469
65244,19,283,303,236,3309,47
60787,73,815,434,664,12292,151
57357,48,386,551,303,8046,83
59611,118,1653,480,1297,30542,356
25790,1257,24266,1222,16022,110857,8244
30822,21,440,1119,310,10601,130
59528,38,363,479,267,7778,96
51400,19,341,733,220,8570,121
61974,36,511,396,415,5325,96
16371,12,275,1393,185,4660,90
10373,141,4909,1467,2933,56415,1976
69020,0,10,186,8,781,2
66277,35,449,276,355,5767,94
53185,26,421,676,344,7381,77
9569,122,3471,1472,2296,22762,1175
16645,87,3283,1389,2246,67902,1037
40941,27,403,914,235,25077,168
13692,1329,35265,1432,21889,183835,13376
35557,130,2936,1028,2262,25830,674
30338,63,1287,1128,801,10617,486
67895,62,585,224,419,10434,166
22882,47,1300,1282,924,18347,376
59585,29,312,481,257,8058,55
63918,390,5706,342,4932,44804,774
23474,9,295,1272,219,10426,76
34023,104,1690,1064,1200,24153,490
65896,744,8486,287,6912,69790,1574
42001,343,5973,897,4722,99435,1251
9966,67,3917,1470,2122,18054,1795
33379,409,11728,1076,8176,74078,3552
47499,514,6691,828,4989,51676,1702
20316,44,843,1324,564,10466,279
50695,2,32,752,28,3875,4
17293,16,835,1377,587,17280,248
43155,357,5632,879,4574,44770,1058
314,8,221,1562,173,14402,48
32749,18,671,1088,443,7580,228
36066,19,420,1016,324,9814,96
22880,8,240,1282,176,9810,64
16069,2974,293926,1397,193736,610153,100190
22343,215,5383,1291,3685,26937,1698
29123,4427,164366,1152,122124,646292,42242
44922,2477,64818,858,47550,324708,17268
27788,51,2348,1178,1376,38057,972
23586,0,118,1270,84,5619,34
69668,1,21,165,18,2172,3
36833,100,1899,997,1650,24933,249
5735,46,1236,1508,807,41092,429
2739,9,544,1543,371,23560,173
68922,26,474,189,396,7805,78
30933,362,9978,1117,6923,70296,3055
33473,1522,26545,1075,19836,150232,6709
34547,7,191,1053,139,3478,52
26709,3,283,1202,182,11786,101
21943,1,126,1296,103,5167,23
22720,3,214,1284,158,5911,56
6556,1,55,1498,37,6178,18
17105,174,5940,1381,3431,19644,2509
47691,192,2273,825,1782,21918,491
55248,167,2201,611,1708,30149,493
55241,5,64,611,44,3045,20
15118,40,730,1412,527,9892,203
50439,188,3064,758,2533,28375,531
54755,209,1734,623,1254,15147,480
58984,40,407,501,315,8296,92
9360,0,1,1473,1,9930,0
788,21,1160,1558,761,16855,399
28715,286,7492,1160,6191,32018,1301
113,715,61057,1565,40167,258148,20890
1195,41,1685,1555,1140,15625,545
51749,120,1263,723,939,9290,324
26551,91,1237,1206,692,8129,545
6383,3150,124939,1500,78883,498550,46056
11142,50,2692,1461,1613,24252,1079
9843,1087,30733,1471,20720,118844,10013
58191,963,15720,527,12761,119765,2959
57337,80,1367,553,970,16850,397
55474,684,4716,604,3521,25684,1195
27709,204,13309,1180,7971,46449,5338
18155,640,17532,1362,11763,94870,5769
5630,157,4573,1509,2930,31991,1643
43085,192,2513,880,2044,38449,469
26184,86,1922,1214,1208,16457,714
12000,27,678,1454,377,8186,301
54070,6050,64752,650,50184,228959,14568
22831,2,282,1282,191,20170,91
23903,733,41120,1264,27152,299467,13968
36377,30,482,1007,381,23762,101
49486,84,1123,783,778,6854,345
3909,80,3183,1531,2238,21528,945
50170,332,6778,765,5403,35148,1375
3097,189,4128,1539,2666,34766,1462
32832,23,417,1087,301,11291,116
33577,292,9977,1073,7199,59710,2778
27755,1484,38275,1179,23567,114659,14708
12814,169,5838,1444,3878,52567,1960
59231,1395,29004,493,23174,149981,5830
17973,3,162,1364,128,6482,34
56219,465,10350,584,8414,154600,1936
59422,72,6602,484,3988,8927,2614
54700,126,1117,627,956,13505,161
9216,11,340,1474,220,7131,120
53083,550,17958,679,11631,70201,6327
42590,203,1865,888,1444,18348,421
32474,14,411,1093,284,11376,127
26706,3566,89608,1202,60218,315493,29390
13590,49,1712,1433,983,14432,729
26696,4,217,1202,140,16434,77
4260,5915,191056,1527,110353,302417,80703
25511,190,6401,1229,5618,82415,783
5280,79,2449,1513,1683,53357,766
10844,15,685,1464,419,34852,266
7199,24,1854,1489,1154,15149,700
16500,46,942,1391,741,24120,201
53793,10,177,660,125,13107,52
53880,77,553,657,363,7049,190
29046,18,922,1154,498,7294,424
53439,5,74,670,49,5437,25
67478,1268,31552,237,25017,115261,6535
62860,18,277,371,199,7065,78
61768,117,1746,404,1386,10759,360
61590,334,5755,410,4136,23528,1619
36753,5,82,999,59,2191,23
52336,25,287,705,228,5872,59
65898,9,135,287,106,3866,29
30882,61,2353,1118,1861,18722,492
33655,121,3426,1071,2494,35841,932
53630,0,69,665,61,4419,8
23176,37,952,1277,710,11908,242
64424,47,819,326,591,22945,228
68419,206,3565,207,2954,24906,611
49653,2,57,778,39,5697,18
21545,31,554,1302,408,5628,146
13797,239,9342,1430,6164,109359,3178
70296,11,157,144,151,7436,6
9274,59,2983,1474,1878,19689,1105
59515,20,350,483,272,11091,78
18881,4,137,1349,114,9592,23
12035,315,6860,1453,4392,50430,2468
53946,30,400,655,298,10812,102
53381,71,1235,671,1005,11515,230
12450,2550,85880,1449,54148,403764,31732
64183,2,42,334,36,2618,6
57389,129,2305,551,1894,28522,411
15333,76,2663,1409,1739,35417,924
59179,23,249,495,187,5524,62
58015,188,1746,533,1331,16806,415
7541,106,3788,1485,2466,59873,1322
29171,372,10873,1151,7794,99964,3079
3323,26,608,1537,429,19755,179
27184,33,608,1192,405,13756,203
68758,11,164,195,119,3130,45
61302,77,748,418,649,7748,99
8690,1,261,1476,139,11182,122
70011,4,122,153,120,3896,2
8330,8,384,1478,256,9952,128
69587,34,378,166,296,12458,82
48415,172,2211,816,1559,30838,652
33796,181,5178,1069,3707,44227,1471
37706,18,728,972,555,12551,173
62268,9,82,387,62,3111,20
58071,40,381,531,287,8051,94
24438,71,2388,1252,1670,64600,718
30635,21,704,1123,396,6819,308
69464,8,61,172,55,2137,6
31552,70,2384,1108,1647,41411,737
34669,55,962,1050,649,6471,313
49813,29,547,774,409,15371,138
10981,2,236,1463,128,6604,108
43633,13,537,873,409,17129,128
21455,9,348,1303,258,11698,90
40100,3,141,928,94,4773,47
63076,17,178,366,142,12527,36
56836,25,237,566,172,3735,65
7359,20,665,1487,479,13752,186
8059,31,601,1479,393,13138,208
18961,82,4316,1348,2497,63082,1819
69829,11,156,159,131,4394,25
31527,172,2506,1108,1567,13925,939
33245,87,2643,1079,1729,29502,914
69322,3,120,176,88,3752,32
29810,845,16735,1139,11477,115291,5258
30142,67,2857,1132,1730,19423,1127
33022,60,1703,1083,1040,11539,663
52368,70,498,703,389,5316,109
56778,26,186,567,160,5571,26
17256,323,8974,1378,6046,62469,2928
35836,15,524,1022,390,16172,134
59779,37,495,474,400,17602,95
50677,101,1151,748,967,15177,184
919,75,2391,1557,1698,40138,693
57095,9,70,558,65,4969,5
28500,24,1135,1164,745,11406,390
26657,79,1087,1203,878,18863,209
17405,96,4334,1376,3116,29170,1218
34155,42653,2061335,1061,1236817,4792351,824518
26223,40,858,1213,545,12215,313
18006,85,2476,1364,1692,66178,784
14126,218,5262,1425,3012,27515,2250
65964,7,103,285,73,3399,30
13673,20,429,1432,278,6091,151
68306,21,221,211,172,4419,49
33994,791,13579,1065,9630,50820,3949
20622,87,2973,1319,2186,27574,787
23939,47,1695,1263,1137,10459,558
12452,6134,227601,1449,163118,1274815,64483
25059,0,58,1237,42,6641,16
54947,31,386,619,303,9630,83
26850,18,463,1199,283,7530,180
16544,62,2031,1390,1365,28827,666
51226,245,2480,730,1963,20893,517
31306,18,817,1111,415,10685,402
9227,514,21271,1474,12823,109877,8448
5792,19,523,1507,365,27933,158
68613,2,22,200,19,2616,3
62804,4,22,372,18,2249,4
70169,20,228,148,227,3111,1
54759,154,1701,625,1358,12201,343
23523,77,4596,1271,2940,54743,1656
35341,36,967,1033,626,9742,341
2520,59,1899,1545,1224,12354,675
17525,13,537,1373,390,12555,147
9,28,1539,1568,849,57322,690
18592,14,339,1354,219,16492,120
20150,22,592,1326,453,6321,139
27946,23,595,1175,358,9134,237
55576,654,10157,601,8083,143181,2074
57407,99,1238,551,986,10386,252
61049,27,234,428,197,4502,37
64980,630,6853,309,5455,21057,1398
54330,35,371,642,300,5608,71
53955,25,242,655,195,7567,47
61207,86,1097,314,910,9306,187
45717,3,86,850,60,4647,26
63767,3,61,347,49,2299,12
36438,72,777,1005,610,16303,167
60872,9,50,434,48,3548,2
43413,549,8483,876,6524,62711,1959
66088,3,86,281,68,1550,18
16167,380,6622,1396,4662,69699,1960
53993,19,257,653,189,8058,68
69859,0,0,158,0,2619,0
8288,228,14503,1478,8834,89205,5669
17969,2946,80056,1365,48442,227226,31614
50114,34,646,766,411,11145,235
23395,618,12569,1273,8890,95763,3679
50273,0,15,762,12,3507,3
68162,49,1210,215,970,11261,240
10939,65,5530,1463,3281,30697,2249
51930,6,103,718,81,8039,22
67904,29,479,224,394,10671,85
29408,12094,389502,1147,222354,1346096,167148
32989,34,371,1084,256,3317,115
15415,7,127,1408,84,12328,43
23317,157,4766,1275,3285,30307,1481
23912,56,1305,1264,1047,67948,258
58959,355,3686,502,2767,19052,919
65125,68,1140,305,912,13936,228
49186,3,68,791,49,6616,19
68302,13,154,211,132,4905,22
56679,146,1845,570,1516,12974,329
34655,100,2699,1050,1751,18964,948
18163,4,173,1362,144,7011,29
54816,172,2109,623,1737,23145,372
20533,56,934,1320,717,20994,217
22644,1343,27240,1286,18760,102013,8480
57576,23,344,534,266,19627,78
60214,16,174,458,141,3946,33
31810,33,790,1103,488,12403,302
18197,21,676,1361,552,20441,124
32994,14,320,1084,201,3019,119
12529,52,1312,1448,762,18950,550
38997,21,528,942,434,30071,94
16311,1983,42153,1394,26195,255350,15958
13107,15,1509,1440,854,12487,655
21549,7,303,1302,211,5738,92
65161,7,50,305,43,1830,7
11140,671,13721,1461,9219,61971,4502
67869,6,43,224,34,2077,9
38016,33,768,964,662,17095,106
37879,128,1819,967,1485,19622,334
58187,445,5943,527,4209,18310,1734
25480,170,2265,1229,1533,23956,732
55570,32,275,602,260,8544,15
49640,35,360,779,286,3092,74
19540,2,39,1337,29,37186,10
24237,102,1468,1257,1040,18980,428
51495,362,3476,727,2657,38162,819
55234,10,242,611,166,7344,76
9432,28,978,1473,675,20817,303
29207,188,4467,1151,2957,26125,1510
50141,92,638,766,448,10823,190
7005,35,1089,1492,730,17123,359
35013,3,28,1042,22,3330,6
15297,2,268,1410,176,11099,92
58050,1078,19322,532,15295,69535,4027
49739,17,266,776,239,5805,27
26388,39,3031,1209,2000,37892,1031
49958,83,1211,770,987,24368,224
7046,140,5947,1492,4171,49970,1776
59109,9,65,497,49,3287,16
18778,7,466,1351,373,35790,93
32525,60,1478,1092,1128,26240,350
29975,330,11830,1136,9003,93222,2827
7137,75,2807,1490,1848,49608,959
52920,11,184,684,145,7807,39
65810,8,91,289,72,6592,19
31339,20,537,1110,310,6496,227
389,2177,81962,1561,51209,356917,30753
66924,107,1799,255,1420,19810,379
8664,10,645,1476,454,11458,191
29781,12,172,1140,128,7091,44
30870,7,274,1118,188,5909,86
8415,341,11620,1477,7556,61699,4064
3174,12395,482165,1539,270165,1482009,212000
19397,31,660,1340,483,6226,177
45707,76,1144,851,834,12477,310
4118,21,681,1529,460,19372,221
2590,131,3465,1544,2230,13102,1235
24381,58,1566,1253,1057,45018,509
53975,2048,34044,654,25155,160861,8889
33217,165,3426,1080,2302,12383,1124
28830,28,713,1158,441,13059,272
2702,5,219,1543,146,11970,73
67564,15,329,234,252,3591,77
61765,31,403,404,314,4301,89
54229,496,5475,645,4660,42872,815
27430,622,26218,1186,16861,115442,9357
913,81,2003,1557,1449,40061,554
5201,34,836,1514,545,16530,291
32238,128,1674,1097,1200,16773,474
42714,577,9399,886,7358,64579,2041
57675,15,211,544,178,9133,33
33198,78,888,1080,586,7738,302
18635,26,821,1353,574,28204,247
22296,319,8989,1292,6542,82303,2447
69449,2,40,172,32,886,8
58396,237,4789,520,3791,27457,998
20108,31,339,1327,263,25640,76
67612,20,194,233,171,3257,23
16140,412,5078,1396,3275,18969,1803
59695,9,117,477,86,3812,31
24425,46,1888,1252,1243,22451,645
44079,193,2164,868,1674,39532,490
10995,341,10835,1463,6545,133880,4290
63469,1,41,355,30,3713,11
31647,69,1694,1106,1156,23191,538
63486,23,186,355,147,2619,39
67888,8,59,224,55,4854,4
37714,15,134,972,85,19261,49
61363,87,1011,417,761,6491,250
25996,0,58,1218,41,3352,17
21679,73,1369,1300,862,43078,507
51484,91,1541,731,1239,11568,302
4746,116,6254,1520,4435,63029,1819
51377,14,247,733,185,9085,62
49272,51,510,789,387,20703,123
8184,13,832,1478,600,27396,232
51997,32,464,716,361,7277,103
292,72,2971,1562,2091,29212,880
68834,10,153,192,127,3260,26
39705,1,41,934,23,1661,18
17316,3,239,1377,181,22054,58
29368,132,3687,1148,2574,30086,1113
147,18,1055,1564,616,23680,439
1972,24,1005,1549,649,20195,356
63406,3,23,357,17,2320,6
39929,18,332,931,255,9189,77
19378,37,833,1340,631,8103,202
31636,37,1013,1106,561,16404,452
8985,31,1788,1475,1113,25879,675
31948,38,1188,1102,757,13135,431
18741,105,2264,1351,1608,33681,656
13807,12,325,1430,173,13706,152
16480,62,3198,1391,1865,43723,1333
48271,486,7289,818,5958,46410,1331
59961,73,1601,468,1250,27820,351
2951,233,4870,1541,3338,54529,1532
3246,0,290,1538,223,24394,67
10676,19,570,1465,358,10469,212
17159,26,496,1380,300,9265,196
33968,1052,23953,1066,18541,111506,5412
6405,491,13023,1500,9457,71028,3566
64645,52,818,320,689,10543,129
4699,41,1622,1521,1105,12700,517
32883,27,267,1085,207,5761,60
13410,102,3567,1436,2204,60256,1363
34058,46,589,1063,374,17906,215
25733,10,215,1224,154,12735,61
8932,12,630,1475,413,18092,217
63125,12,359,364,262,7538,97
45063,29,225,857,187,6029,38
6706,239,9004,1496,5576,47764,3428
15155,678,18504,1412,12724,194043,5780
14454,3,151,1420,91,8563,60
33693,21,898,1071,590,9173,308
14585,38,1294,1419,960,36260,334
17935,3,63,1365,50,3337,13
20773,358,5882,1316,3836,40015,2046
25853,953,18194,1221,11741,66810,6453
69988,12,147,155,120,5251,27
13545,5,414,1434,213,25552,201
69495,13,370,171,315,3214,55
30936,73713,3075863,1117,2182907,16614172,892956
62896,2,35,370,26,2269,9
25219,5,92,1235,77,19233,15
68023,70,733,220,680,10232,53
1062,13,908,1556,707,13968,201
8417,0,54,1477,39,4422,15
28047,41,1039,1173,831,17071,208
63788,289,6058,347,3606,37996,2452
41460,400,5224,907,4083,39443,1141
33998,109,1924,1065,1038,10384,886
68142,57,481,216,380,6693,101
9829,286,5900,1471,3795,22697,2105
34241,91,2421,1060,1657,25425,764
21394,321,4823,1304,3295,37795,1528
63717,1,75,349,45,2176,30
63805,35,910,346,757,7656,153
37175,291,3256,987,2636,46744,620
38108,53,521,961,461,16497,60
601,88149,2346191,1560,1286631,4818185,1059560
23492,40,896,1271,606,17095,290
9495,8,218,1472,167,12572,51
1137,59,1546,1555,1152,22901,394
37616,29,494,974,393,6923,101
45322,169,3230,855,2543,49163,687
60023,19,372,466,276,7853,96
26176,17,686,1214,446,14946,240
22569,67,1186,1287,802,15234,384
29037,8,554,1154,330,10170,224
30552,19,618,1124,370,9566,248
69135,13,224,182,207,2219,17
32151,433,6709,1098,4371,52005,2338
3620,402,26440,1534,17671,295790,8769
53821,7,112,659,82,3908,30
22516,8,144,1288,99,5274,45
16983,1130,40597,1383,28593,274056,12004
69426,17,274,173,205,6260,69
19291,1305,39561,1342,27372,247123,12189
58510,3644,56001,515,43884,156624,12117
51020,10,109,743,77,5173,32
6804,68,3020,1495,1950,33579,1070
35379,23,494,1032,338,6814,156
36195,578,7152,1011,5612,69464,1540
55705,480,7167,598,5263,100867,1904
7517,138,3963,1485,2650,85900,1313
21890,9,691,1297,442,12460,249
17470,4,135,1375,113,11547,22
12188,118,3497,1452,2147,39662,1350
63627,27,358,351,278,7025,80
35262,203,7515,1035,4842,54460,2673
23383,78,1364,1273,938,17205,426
19484,20,286,1338,226,6588,60
27518,32,701,1184,560,24396,141
37538,981,13509,976,10725,83807,2784
11866,25,1165,1455,566,16922,599
4420,479,19245,1525,12383,88077,6862
57384,3,164,551,121,2437,43
17979,27,892,1364,621,17322,271
15643,7,193,1405,140,15503,53
30549,16,818,1124,476,21932,342
5399,7,273,1512,206,32178,67
64930,100,2125,311,1637,22490,488
18401,3,244,1357,167,7844,77
36360,71,703,1008,607,16385,96
926,149,5171,1557,3334,24204,1837
5912,18,451,1506,318,24520,133
48498,329,4216,813,3314,44304,902
30080,185,2878,1133,2127,16890,751
20517,519,10628,1320,7220,116027,3408
66735,24,328,261,246,5756,82
23661,22,699,1268,537,27996,162
11473,618,14391,1459,8172,85765,6219
57583,13,134,547,107,8708,27
68624,4,72,199,51,4548,21
12958,25,1645,1442,995,32434,650
4248,7,339,1527,248,20586,91
5047,5,305,1516,97,321035,208
52521,54,1020,697,805,31385,215
8717,90,2644,1476,1711,26186,933
11362,79,1785,1460,1024,17441,761
69690,20,156,164,137,6145,19
8258,3935,192412,1478,113753,602182,78659
24456,596,18649,1251,13249,85833,5400
1594,23,417,1552,281,11439,136
52509,322,4118,698,3205,34873,913
66192,22,293,278,242,4057,51
21535,576,13650,1302,8943,83470,4707
31633,203,5956,1106,4055,41068,1901
27447,187,7385,1186,4307,31344,3078
36906,245,4198,995,3250,27286,948
16571,67,968,1390,658,20697,310
7208,33,1041,1489,772,54069,269
21998,130,8415,1295,5186,58903,3229
40471,36,581,922,473,13079,108
21875,82,5041,1297,2493,30856,2548
7659,63,2093,1483,1138,10871,955
5972,30,688,1505,479,6957,209
50785,57,774,750,564,11172,210
30092,154,2414,1133,1642,19616,772
15599,419,6701,1405,5033,52956,1668
48802,134,2000,803,1641,16615,359
13227,52,1722,1438,1138,21930,584
32835,134,2981,1087,1839,23732,1142
4025,19,526,1530,332,27350,194
51902,91,1699,562,1328,13630,371
16121,12,339,1397,223,9675,116
60645,5,110,442,69,4418,41
5827,1429,36715,1507,21438,99073,15277
61797,66,501,403,396,6689,105
68216,3,39,214,34,3165,5
18487,62,1204,1356,981,17144,223
27864,22,1047,1177,655,6769,392
18578,31,596,1354,443,16231,153
51501,89,1309,730,1047,19802,262
27262,119,2648,1190,1897,16219,751
27645,99,2971,1181,1903,17236,1068
37754,121,3407,970,2227,32461,1180
24124,499,18972,1259,14781,122423,4191
67161,5,136,247,121,6750,15
41144,3,64,911,55,14952,9
5164,4681,176110,1515,111708,397749,64402
40980,57,821,914,683,15741,138
54261,38,448,644,396,16763,52
2945,22,1838,1541,1363,65233,475
32897,34,1114,1086,712,13629,402
1779,1062,45243,1551,28135,293978,17108
17814,400,18263,1368,12282,100590,5981
44557,1873,26991,863,20414,230301,6577
29807,43,785,1139,703,9652,82
29139,44,1963,1152,1238,12354,725
64770,15,57,317,51,1309,6
49142,19,336,793,243,7190,93
3827,9,165,1532,115,5706,50
1604,33,1576,1552,1095,29623,481
3593,54,1359,1535,929,26528,430
1614,91,3894,1552,2706,27699,1188
44286,92,1667,866,1287,24810,380
18634,1,107,1353,91,14614,16
53490,13,286,669,218,6787,68
22226,104,4238,1292,3477,24928,761
20905,5,71,1313,62,15731,9
49837,45,568,774,379,4714,189
66515,9,107,269,102,6915,5
68665,57,588,198,532,12063,56
39404,719,7477,938,6046,85474,1431
14444,68,1097,1420,793,17234,304
4189,75,1963,1528,1366,17321,597
54529,86,828,634,687,25258,141
15309,645,24558,1410,17036,89581,7522
3148,67,1710,1539,1338,39117,372
15951,49,1063,1400,676,33541,387
62056,5,34,394,29,2657,5
69435,23,210,173,183,4861,27
66116,12,193,281,153,4677,40
31227,242,6228,1112,4123,144578,2105
65692,12,116,292,87,4264,29
42506,728,8089,890,6217,84545,1872
67326,76,1162,241,876,14821,286
9346,35,980,1473,626,12247,354
63502,16,135,354,115,3342,20
21714,242,8617,1299,5893,75119,2724
45505,15,256,851,206,12547,50
48329,520,6382,817,4469,166799,1913
52303,41,473,705,354,9440,119
12399,198,8915,1449,4579,53001,4336
62722,686,13043,370,10029,82042,3014
26700,41,822,1202,533,8449,289
3589,16171,523482,1535,335843,1063559,187639
39837,13,302,932,246,9768,56
35203,61,1079,1036,901,15334,178
57225,92,1285,556,1138,28795,147
52364,396,4722,672,4060,30460,662
51378,5,38,733,35,3913,3
62297,69,873,386,686,5657,187
50736,54,791,751,608,20104,183
52136,62,699,711,523,15358,176
12730,145,3912,1445,2268,45955,1644
1753,103,2488,1551,1753,20625,735
14199,15,305,1424,234,7258,71
64786,7,69,316,50,2374,19
6173,3357,249798,1503,145882,814280,103916
29696,23,305,1142,252,7356,53
33934,18,350,1064,251,5534,99
60225,23,462,457,336,14336,126
28734,4,474,1160,262,10868,212
9382,41,1201,1473,732,7835,469
50530,216,2176,756,1775,29684,401
17190,262,8896,1379,6277,50733,2619
6907,413,20769,1494,12459,64711,8310
39761,10,273,933,227,5731,46
7339,26,527,1488,377,22243,150
67532,2,17,235,16,866,1
39033,90,3125,942,2386,27919,739
37982,1735,34350,965,28276,229150,6074
29223,383,5865,1150,4108,22740,1757
45314,3516,74217,855,56477,214807,17740
21541,96,5839,1302,4788,96544,1051
7079,186,7320,1491,4501,37836,2819
9562,199,6833,1472,4158,28132,2675
21402,321,9202,1304,5712,44832,3490
44382,10,353,865,281,8470,72
39196,397,5304,940,3952,39962,1352
16410,438,11632,1392,7725,126147,3907
17565,7,432,1372,331,10849,101
22948,21,457,1280,337,15853,120
67031,4,60,252,49,1827,11
11132,26,602,1461,366,7990,236
59713,14,125,476,90,4338,35
55007,2,21,617,18,2772,3
60060,60,1297,464,1058,25749,239
31414,100,2327,1110,1416,9439,911
32186,120,3963,1091,2486,43898,1477
56383,69,1184,579,904,6908,280
67416,13,109,239,87,5892,22
23819,4,194,1265,138,8863,56
67222,97,1456,245,1245,21973,211
25032,8,384,1238,275,7139,109
49719,48,667,777,547,12464,120
7486,171,11150,1486,7060,38361,4090
1004,23,1368,1556,946,63136,422
21201,89,2022,1308,1451,38886,571
63394,535,5463,357,4245,46191,1218
3168,27,368,1539,258,5713,110
26774,35,2218,1201,1325,24229,893
38656,16,322,947,248,9793,74
53493,6,53,669,43,3038,10
11563,18,860,1458,573,16283,287
7833,95,4010,1481,2596,31215,1414
4570,3,158,1523,112,8938,46
21294,161,9615,1306,6080,111650,3535
60569,2916,38042,445,31782,120736,6260
2150,23,2451,1548,1583,101577,868
55818,25,178,595,147,4674,31
54722,6,63,627,54,3847,9
58476,6,111,517,89,3832,22
63276,264,5351,360,3785,54597,1566
38643,19,111,947,94,6193,17
69442,5,47,172,40,3618,7
65694,11,123,290,101,2841,22
57993,75,695,534,587,11182,108
67504,259,8530,236,6946,23443,1584
35609,1384,21317,1027,15565,65017,5752
66824,22,371,258,283,6360,88
22208,4,169,1293,89,4731,80
9238,4,91,1474,52,5112,39
61042,6,76,428,57,5248,19
32364,104,1970,1095,1239,10707,731
11154,0,12,1461,11,343,1
19041,20,832,1346,585,15617,247
59539,548,6135,482,4934,34653,1201
39445,24,604,937,480,13844,124
61807,1018,16366,402,13252,87377,3114
38935,57,847,943,664,9046,183
19079,45,1663,1345,1090,16839,573
70499,14,147,136,134,2839,13
31836,11,670,1103,337,12400,333
29314,0,0,1149,0,3255,0
28091,96,884,1172,637,13373,247
9580,67,1815,1472,1244,17997,571
34231,393,4821,1060,3443,34467,1378
63223,245,2520,362,2065,30676,455
49445,27,414,784,341,10188,73
15489,3806,82039,1407,49158,281797,32881
63418,5,37,357,30,3132,7
67588,15,271,233,245,8090,26
3779,18,1055,1532,699,13029,356
23350,421,6788,1274,4736,52132,2052
27690,6,491,1180,301,16652,190
26669,59,1753,1202,1101,25618,652
17401,1426,44272,1376,30558,203304,13714
7518,8,541,1485,331,4550,210
61672,110,1543,407,1194,15944,349
66709,8,181,262,146,3098,35
39274,9,218,938,166,7779,52
33253,1008,14827,1079,10278,53088,4549
34182,18,1086,1061,751,22116,335
2403,39,1242,1546,819,14305,423
20631,25,521,1318,407,8503,114
46624,15,472,839,312,8550,160
41832,218,5269,900,4274,27353,995
62798,20,332,372,245,5002,87
26425,2,99,1209,61,4660,38
59144,32,476,496,350,8138,126
4971,11,465,1517,345,8593,120
16030,16,531,1398,375,8842,156
10599,145,5411,1466,3607,56329,1804
43289,17,412,877,297,15957,115
35290,71,1054,1035,801,14856,253
24389,134,4177,1253,2634,29289,1543
9757,18,693,1471,486,14820,207
64051,6,139,338,104,2973,35
63121,17,249,365,186,3020,63
8987,1709,56112,1475,34925,148238,21187
40748,6,209,918,195,10603,14
21706,55,1294,1299,830,14287,464
8123,84,1587,1478,1127,22039,460
21166,271,8692,1308,5996,36778,2696
63555,14,260,354,219,7263,41
61490,262,2790,413,2218,22738,572
28342,14,510,1167,321,25129,189
50998,669,11208,744,8819,125716,2389
51502,25,349,730,274,9943,75
17042,13,220,1382,170,16634,50
52024,14,341,715,227,11249,114
18665,620,32049,1353,19618,225533,12431
28690,63,1096,1161,691,9567,405
13556,2,149,1433,76,14802,73
3696,1,131,1533,94,6244,37
11159,1815,60938,1461,36618,160983,24320
37642,192,3952,974,2825,74633,1127
69672,26,423,165,381,8553,42
25029,10233,252091,1238,159388,732744,92703
28580,2216,49959,1163,34367,312386,15592
12635,140,14365,1446,7782,94826,6583
29161,4,94,1151,79,6925,15
17104,42,1973,1381,1614,23883,359
39152,147,2161,940,1566,17249,595
45911,11,383,848,306,8777,77
63198,98,1445,363,1161,6413,284
1358,61,1709,1554,1230,48721,479
65792,27,371,241,320,12795,51
60018,233,3801,466,2916,24347,885
20329,23,967,1323,626,24419,341
860,6,177,1557,116,10355,61
26778,32,1283,1200,672,10573,611
32102,10,246,1099,166,14040,80
960,213,6641,1557,4169,44563,2472
61846,12,190,402,143,7812,47
17151,131,4130,1380,2679,43616,1451
59386,861,19727,487,16212,121646,3515
1287,10,777,1554,554,24114,223
750,60,2665,1558,1936,30849,729
35097,4,110,1040,64,4342,46
61217,98,1885,421,1431,31643,454
59088,30,476,498,380,4866,96
7174,150,7821,1489,5458,77745,2363
33504,1569,39003,1074,26520,217107,12483
12558,1280,17182,1447,10397,66171,6785
52114,174,2886,712,2450,16982,436
22961,52,1133,1280,834,33195,299
14318,138,4760,1422,3333,109853,1427
555,67,2904,1560,1946,22226,958
51720,3,45,724,39,9721,6
58344,70,606,522,491,11523,115
6975,174,3616,1493,2257,58651,1359
65881,11,94,287,71,5127,23
2308,70,3033,1546,2114,27735,919
64973,105,1435,309,1162,15378,273
26023,52,1100,1217,665,16462,435
58238,85,1259,525,1046,31239,213
61801,376,5039,403,4128,47936,911
32293,24,245,1096,156,5257,89
24486,39,1199,1251,825,18711,374
48965,406,6664,798,5359,71171,1305
26402,902,20009,1209,12656,89505,7353
38755,24,394,946,321,12907,73
6857,5,123,1494,78,12446,45
64248,3,75,332,46,8511,29
53025,3,42,681,29,2095,13
15545,703,12978,1406,8350,123066,4628
38869,92,1351,944,1072,7519,279
43976,15,371,870,297,7226,74
30416,1995,49662,1127,31393,242695,18269
19690,309,5688,1335,3530,67137,2158
16161,106,2263,1396,1547,27262,716
5309,196,5746,1513,4014,96242,1732
18059,746,18480,1363,12778,152090,5702
38556,5,58,950,57,5271,1
31155,12,179,1113,128,10850,51
27010,97,4435,1195,3788,38799,647
15635,0,0,1405,0,8334,0
9981,6,369,1470,247,9003,122
34089,25,400,1063,259,10197,141
54859,28,284,621,216,4610,68
27718,9,135,1180,98,3210,37
29818,47,599,1139,369,11239,230
61844,27,336,402,271,12364,65
28383,15,364,1167,226,4313,138
6720,493,49634,1496,28047,241379,21587
53182,115,1288,676,916,17291,372
33444,237,4118,1075,3076,52364,1042
59570,302,7727,481,6339,62509,1388
21888,6,366,1297,273,8525,93
6538,905,32320,1498,18611,82942,13709
42770,1,33,885,24,4684,9
22804,7,360,1283,228,10303,132
14173,530,14283,1425,10361,109110,3922
27060,8933,233704,1194,149593,1021467,84111
14039,1725,79801,1426,42155,287054,37646
34610,147,3831,1052,2460,23927,1371
10800,4,200,1464,113,11900,87
29836,201,3944,1139,2394,33034,1550
51733,2436,33286,724,25914,128439,7372
61028,231,3461,428,2805,26577,656
61843,59,610,402,440,12220,170
55134,164,3430,614,2447,25805,983
31582,1842,24198,1107,16467,110766,7731
27088,7,333,1194,214,12856,119
67676,58,974,231,732,11647,242
15760,0,0,1403,0,16704,0
49734,152,3644,776,2562,20067,1082
2099,6,377,1548,259,18915,118
24126,29,768,1259,572,9080,196
52865,8,115,685,96,7105,19
42782,21,399,885,306,12670,93
68725,10,146,196,111,3159,35
24993,31,1157,1239,812,15918,345
13586,1025,20446,1433,14098,173048,6348
37196,146,4231,986,3370,41428,861
53735,85,2872,662,2144,21138,728
12769,57,1222,1445,744,10981,478
29419,4659,119836,1147,80098,694274,39738
2101,6079,125688,1548,78283,406277,47405
42084,2257,39185,892,31221,221345,7964
35459,91,1574,1030,1060,20411,514
24424,18,834,1252,566,9368,268
52712,305,2748,691,2255,19776,493
65926,92,1073,286,985,19808,88
69204,19,394,179,308,7391,86
4541,429,10676,1523,6854,38542,3822
3236,37,1968,1538,1224,45640,744
3835,53,3107,1532,2120,21117,987
59788,118,1947,473,1701,14015,246
58088,50,1377,530,1078,22423,299
542,212,8175,1560,5973,50998,2202
27964,1349,29271,1174,19495,219798,9776
60303,37,560,455,425,5773,135
18723,52,1081,1352,762,27256,319
51094,1344,12416,741,9699,82549,2717
53827,28,465,659,386,11046,79
66534,34,395,268,314,6692,81
37223,284,4430,985,3627,85304,803
37036,143,2620,985,2184,32482,436
4083,33,1162,1529,712,13984,450
63659,75,957,350,794,18102,163
9623,418,15770,1472,9720,68292,6050
32924,39,486,1085,327,8052,159
22927,634,18731,1281,14541,173893,4190
61796,78,877,397,768,14100,109
49575,806,16063,781,13086,164941,2977
2061,1033,29316,1548,18850,266057,10466
56109,144,1341,587,1101,10772,240
51964,9,127,717,100,8007,27
12234,4753,68767,1451,43337,303252,25430
67935,5,78,223,51,5890,27
9860,3,203,1470,115,4111,88
69935,3,31,156,28,1118,3
11546,1102,54439,1458,33097,266986,21342
48984,139,1747,798,1388,23715,359
20920,311,9660,1313,6352,97146,3308
34472,62,1991,1055,1345,27848,646
59014,371,7957,500,6516,37648,1441
60581,24,573,445,429,3843,144
10652,8199,221010,1465,135162,581764,85848
61157,83,1344,423,1115,10713,229
14407,0,0,1421,0,11422,0
51045,270,3977,743,3192,70998,785
3776,1226,23422,1532,15691,152820,7731
61436,216,1714,415,1444,44850,270
68224,346,7287,214,6116,68650,1171
4456,65,3023,1525,2151,41340,872
30928,173,2141,1117,1394,13448,747
4279,4,92,1527,61,17295,31
42576,9,303,889,205,10745,98
26874,1064,38823,1198,24261,288262,14562
33457,3,138,1075,86,6226,52
1355,112,3996,1554,2986,34467,1010
20907,18,480,1313,353,11673,127
69934,93,1154,156,1005,7452,149
35821,70,2360,1023,1958,32778,402
949,62,3771,1557,2529,23238,1242
33219,5805,116851,1080,84567,503154,32284
10985,6,222,1463,127,5947,95
4822,487,20434,1519,14325,210054,6109
54226,73,434,645,372,4100,62
64378,291,4529,299,3037,18873,1492
18117,8,722,1362,503,14653,219
54459,18,170,634,129,7690,41
41788,5,126,901,90,2826,36
68355,32,719,209,547,8667,172
8404,49,2202,1477,1431,71741,771
68488,17,150,204,125,5711,25
59615,5,52,479,39,3016,13
52112,17,227,712,198,14904,29
26297,28,468,1212,396,14691,72
40445,8,208,922,148,7525,60
15158,10,449,1412,323,12174,126
14258,131,3079,1423,2321,43702,758
61971,30,363,396,327,5927,36
46166,56,1102,845,866,11517,236
16824,5,141,1386,114,13303,27
45042,1173,24841,857,19539,141346,5302
21231,49,1659,1307,1188,28037,471
52837,49,915,685,726,12571,189
21297,73,4346,1306,1524,34950,2822
39416,19,294,937,198,3968,96
24776,16,166,1244,132,11537,34
17687,43,988,1370,733,14607,255
57597,8,104,546,84,9805,20
16187,273,15096,1396,8940,145406,6156
2589,84,2062,1544,1358,19819,704
23606,56,1925,1270,1553,84800,372
22177,57,2744,1293,1725,33537,1019
37437,29,633,979,504,14820,129
57945,16,213,535,159,5669,54
33387,1,79,1076,71,4671,8
16506,3906,141060,1391,85551,318749,55509
29055,55,5501,1154,3678,36058,1823
8402,19,1097,1477,723,9195,374
14504,2001,78928,1420,41593,244658,37335
53649,137,1918,664,1496,24724,422
61898,10,51,400,42,3240,9
11034,39,1107,1462,782,12452,325
16884,71,2528,1385,1703,33701,825
4614,6,194,1522,144,18310,50
56858,31,417,565,322,6012,95
10448,23,988,1467,662,34989,326
29817,0,157,1139,88,4880,69
34357,15,265,1057,194,7583,71
16542,168,3009,1390,2235,31246,774
63885,4,88,343,65,4320,23
56083,1386,16173,587,13240,64943,2933
39419,3,82,937,64,6857,18
56593,15,182,572,137,10317,45
420,34,1647,1561,1077,40066,570
61418,33,645,415,527,12577,118
14624,73,2239,1418,1542,28967,697
45003,6,178,858,127,9062,51
56092,10,124,587,105,8094,19
20094,123,3003,1327,2160,39059,843
42774,8,200,885,157,12937,43
32173,7,153,1098,93,5395,60
60586,8,130,445,95,4140,35
39552,13,194,936,163,6950,31
5469,61,1699,1511,1141,19586,558
68773,38,514,194,406,4917,108
69739,16,214,163,157,4498,57
31416,65,872,1110,603,14982,269
2331,83,5870,1546,4122,87899,1748
66568,135,1360,266,1047,17747,313
70202,19,271,146,264,7466,7
30984,127,3389,1116,2078,19235,1311
53286,35,312,674,251,10455,61
2205,14,1286,1547,829,101513,457
8412,221,4139,1477,2680,32658,1459
27832,92,1621,1177,1115,28146,506
20366,286,11574,1323,7673,82472,3901
52143,32,319,711,253,2897,66
29299,10,384,1149,246,9426,138
56994,32,418,561,337,9223,81
12701,4,476,1446,218,5518,258
21318,26,462,1306,224,12519,238
31892,112,1507,1085,1081,19083,426
1562,50,1567,1552,1192,39283,375
27685,96,2449,1180,1664,22040,785
33684,67,1323,1071,966,21113,357
33759,7,149,1069,121,6412,28
53152,6305,103582,677,74824,586482,28758
37,30,1612,1567,1140,26131,472
11968,23,1032,1454,496,12084,536
43617,62,714,873,561,12928,153
2632,1022,28739,1544,20474,63847,8265
63561,46,426,354,339,6242,87
35541,21,434,1029,312,3859,122
60652,454,5001,442,4011,35747,990
23859,3,119,1265,87,10943,32
60224,115,1789,458,1385,22091,404
11756,3608,187462,1456,92701,772550,94761
16405,192,7726,1392,4767,38879,2959
19418,96,2728,1339,2188,19466,540
7094,918,20142,1491,13307,77521,6835
61981,22,673,397,333,15089,340
67121,0,15,249,11,5411,4
10121,0,0,1469,0,5025,0
46024,22,307,847,225,14104,82
30321,4,250,1129,216,9488,34
17557,10,288,1373,214,7321,74
66815,6,52,259,49,3441,3
55004,14,338,617,249,6975,89
26821,5,206,1199,121,17617,85
34414,4,99,1056,78,5605,21
2889,5460,355807,1541,195633,572778,160174
66727,5,72,262,58,4408,14
21435,1499,28677,1304,18976,88350,9701
18925,62,2254,1348,1242,15683,1012
39855,23,764,932,617,17849,147
31087,3458,65523,1114,45551,151605,19972
32203,11,237,1098,143,6999,94
63430,65,864,356,654,14473,210
70347,9,108,143,96,2582,12
1471,109,2360,1553,1409,37413,951
69826,117,1738,159,1587,14505,151
1480,16,531,1553,402,8644,129
15342,31,1359,1409,946,20800,413
66497,7,200,269,145,3637,55
22019,581,11042,1295,7711,65189,3331
68178,9,84,215,64,3492,20
30325,9,351,1129,218,15319,133
4720,113,4577,1521,3087,28178,1490
26577,144,3825,1205,2374,45163,1451
44136,213,3451,868,2780,29645,671
14906,816,39797,1415,26981,248449,12816
10459,57,1666,1467,1070,25370,596
35608,1787,34155,1027,24839,102883,9316
56639,10967,222840,571,171225,630697,51615
9650,283,7038,1472,4841,39180,2197
55618,148,2800,600,2037,52596,763
25253,53,1654,1234,1062,56239,592
6526,50,2316,1498,1543,37729,773
65261,14,72,303,58,7778,14
49660,95,1181,778,987,18571,194
34091,3,82,1063,62,2788,20
42364,340,4495,889,3751,54666,744
25207,61,2968,1235,1986,42756,982
69523,24,334,170,283,7867,51
58391,1254,32250,520,24599,136055,7651
57577,18,440,547,274,23831,166
14767,1755,63202,1417,41176,298863,22026
12910,0,0,1443,0,7830,0
42736,2901,60147,886,47875,376076,12272
56293,9,196,581,132,4855,64
30363,19,290,1128,215,5986,75
10367,378,14188,1467,8671,65852,5517
2971,2188,135104,1540,87356,839388,47748
69983,0,81,155,70,1787,11
27318,40,609,1189,388,14814,221
62519,20,293,380,228,4799,65
59850,22,383,472,324,14867,59
27624,37,1076,1181,624,15269,452
45065,49,651,857,544,14903,107
30819,965,20877,1119,13707,57993,7170
31017,47,1896,1115,1173,15397,723
12226,55,4118,1452,2098,19496,2020
7114,23,2533,1491,1608,77464,925
53691,0,277,663,214,6649,63
28494,226,4487,1165,3171,64705,1316
8010,433,12621,1479,8505,92244,4116
14586,72,2995,1419,2165,21447,830
68057,17,162,219,152,5947,10
22040,23,682,1295,435,13699,247
66545,33,388,266,314,5599,74
65066,2,12,306,12,2075,0
57411,18,213,551,163,5925,50
41210,2980,58618,910,42439,262185,16179
4033,288,13404,1530,9140,48314,4264
60946,10,52,431,39,6914,13
61294,70,887,418,734,15217,153
69772,16,203,161,196,5713,7
65343,9,92,301,68,4483,24
26201,248,5871,1214,3727,35890,2144
26336,447,15637,1211,10284,67144,5353
50195,20,202,765,145,11306,57
25685,847,14493,1225,9420,57110,5073
22630,14,663,1286,458,12676,205
40370,4,47,924,40,2801,7
1632,660,16058,1552,11590,91443,4468
22826,4,223,1283,160,14487,63
577,93,4472,1560,3294,50528,1178
14438,73,1943,1420,1496,28640,447
69261,17,244,178,211,2877,33
31646,5,134,1106,94,5640,40
13133,6025,147358,1439,96317,623363,51041
69824,190,3425,159,3042,24779,383
40802,8,269,917,194,8261,75
8100,25,505,1478,338,10545,167
69,252,13441,1566,7034,147014,6407
24215,97,2384,1257,1576,9800,808
66630,231,3741,265,3322,17439,419
30645,24,854,1123,569,28060,285
54655,36,594,629,397,5734,197
60948,179,3373,431,2455,15282,918
59729,40,763,476,460,11158,303
28089,18,322,1172,240,8294,82
8784,339,12648,1476,6565,81811,6083
67727,166,3703,229,3157,25715,546
58304,5,32,523,28,5026,4
21198,103,3367,1308,2273,23429,1094
67001,11,127,252,95,4308,32
1332,254,9767,1554,7088,56174,2679
16797,7,414,1386,282,49973,132
10970,24,981,1463,622,12005,359
24331,12,273,1254,162,3805,111
31260,545,6762,1112,4856,44130,1906
53681,341,4528,663,3765,41176,763
12997,62,3351,1441,1876,32338,1475
13305,239,7677,1437,4608,55436,3069
19135,92,3170,1344,2162,28594,1008
27958,58,2307,1174,1378,22840,929
61835,109,1697,401,1302,13209,395
13433,83,1940,1435,1093,13701,847
62697,11,94,375,67,2788,27
66965,9,205,253,183,4646,22
69478,1,55,171,24,1623,31
5221,14,421,1514,296,8421,125
33372,193,7366,1077,5253,50048,2113
9937,253,5041,1470,3364,27332,1677
30389,52,1462,1127,911,15716,551
54293,85,2198,643,1805,14282,393
7105,8,238,1491,156,9176,82
28045,12,409,1173,319,6805,90
6292,108,2370,1502,1515,17036,855
37184,20,399,986,337,7988,62
944,9999,328322,1557,196381,1172287,131941
12441,1042,35805,1449,21786,118734,14019
31673,483,15128,1106,10213,112142,4915
1784,52,1987,1551,1357,30327,630
48533,76,1786,812,1480,15806,306
5999,113,3563,1505,2509,21741,1054
27895,17,434,1176,270,6002,164
4204,10,335,1528,222,15968,113
36525,129,1987,1002,1518,26271,469
33284,34,589,1078,461,8140,128
37385,361,8689,981,7294,136437,1395
36834,109,1333,997,1033,15791,300
57393,35,585,551,451,15215,134
26103,8,310,1215,204,4858,106
64689,35,478,319,337,19325,141
25387,534,9780,1231,5051,34705,4729
26866,39,1198,1198,778,12712,420
33613,94,3433,1072,2203,22936,1230
29361,6,330,1148,259,7577,71
27212,2060,58989,1191,40059,252710,18930
22758,154,3931,1284,2905,28929,1026
62109,70,662,392,525,6379,137
7071,155,10497,1491,7033,56149,3464
52580,20,403,696,318,9860,85
37489,1584,21810,978,16107,79605,5703
6609,60,2093,1497,1526,30510,567
43903,18,380,871,288,12849,92
56048,84,899,588,675,12881,224
51007,192,2829,744,2166,58239,663
56450,4,66,577,52,3390,14
40540,20,456,921,348,7188,108
19413,11,357,1339,300,20261,57
23142,32,1220,1277,914,47414,306
34822,59,886,1046,641,17606,245
57412,65,382,551,288,3761,94
3016,23,710,1540,497,31789,213
37495,763,8792,978,6432,35792,2360
17960,178,3084,1365,2159,40553,925
68136,35,481,216,383,9188,98
42183,514,6549,895,5686,45233,863
50849,17,120,748,94,2944,26
6472,19,2016,1499,1321,20558,695
21922,2879,116354,1296,68426,181118,47928
14598,255,4044,1419,2981,29554,1063
16278,3,397,1395,246,11856,151
31903,18,509,1102,290,7555,219
1117,5855,157509,1556,96079,336212,61430
9726,386,6852,1471,4349,53507,2503
26010,35,1951,1217,1011,17779,940
17753,129,7814,1369,5628,32376,2186
30604,99,764,1123,569,13051,195
35248,256,2405,1036,1851,18037,554
1870,64,2602,1550,1884,31455,718
49407,108,1034,785,888,29004,146
20831,62,1688,1315,1235,36061,453
64284,44,274,330,227,5943,47
28025,339,10342,1173,7307,54503,3035
49893,12,105,772,82,6859,23
28426,201,3667,1166,2009,18903,1658
56122,57,782,586,569,11789,213
23617,19,509,1269,433,16279,76
3377,1147,27658,1537,18429,239009,9229
3142,2250,198030,1539,101299,689978,96731
8677,103,3474,1476,1831,22207,1643
12456,24,789,1449,486,8423,303
4474,88,2023,1524,1429,28064,594
63490,8,110,355,90,5041,20
25192,210,5768,1235,3884,49279,1884
39338,26,354,938,304,15575,50
24094,218,3606,1259,2488,32502,1118
588,17,1123,1560,642,37786,481
39027,38,781,942,560,10313,221
17474,79,5827,1374,3901,38654,1926
57756,657,6654,541,5379,40467,1275
33974,201,3180,1066,2105,26028,1075
33537,24,505,1074,338,12618,167
29987,21,512,1136,338,13324,174
7355,32,4411,1487,3089,27716,1322
34517,58,981,1054,643,16733,338
33961,95,2539,1066,1726,22761,813
36186,19,230,1013,196,5500,34
12632,23,823,1446,501,9464,322
17928,39,951,1365,695,12595,256
16615,1781,27786,1389,18882,108142,8904
34762,8,316,1047,178,6617,138
9036,36,872,1475,557,8958,315
24618,213,4645,1248,3418,26750,1227
35299,43,1978,1034,1301,13544,677
60966,60,958,430,783,9091,175
16338,3,205,1394,134,7152,71
48872,15,360,801,293,5869,67
37902,818,16772,967,13336,127067,3436
38142,14,179,960,137,5501,42
67447,744,9953,238,7373,43979,2580
9889,168,3582,1470,2402,22816,1180
60160,294,3975,461,3097,28277,878
55914,433,10265,592,8218,98474,2047
17331,4,342,1377,244,20720,98
33582,15890,501204,1073,371259,1482294,129945
55837,2,44,595,31,3988,13
31348,29,1161,1110,644,6910,517
67546,2,64,235,43,1821,21
11825,55,1832,1456,862,13370,970
58239,163,1676,525,1376,13091,300
32046,38,1744,1100,1152,24585,592
69428,3,48,173,35,1330,13
64355,15,160,328,147,9803,13
13149,68,3554,1439,1997,33108,1557
6650,53,2027,1497,1260,42942,767
4290,62,1302,1527,861,15990,441
4169,1,196,1528,109,12965,87
52463,44,912,699,732,16173,180
15972,1395,37801,1399,22803,147075,14998
54362,1709,47531,640,37456,271878,10075
9001,88,2684,1475,1625,29235,1059
68565,9,197,201,152,4206,45
12038,41,1666,1453,851,49348,815
47544,17,246,828,197,14069,49
56098,191,4348,587,3647,83567,701
43229,7,107,877,67,5958,40
29674,312,13396,1143,9358,100381,4038
10974,58,2602,1463,1702,53408,900
30332,425,5599,1129,3492,23370,2107
55033,45,548,616,458,5516,90
21682,45,983,1300,695,41268,288
26105,9,444,1215,265,8273,179
46717,14,220,838,181,26171,39
51479,17,212,731,164,6705,48
17694,466,22862,1370,15095,168536,7767
22472,18,561,1289,362,11076,199
69311,17,194,176,175,3107,19
50201,102,1790,764,1333,30781,457
22770,189,4302,1284,2735,16229,1567
22493,38,790,1289,585,15729,205
11846,38,2880,1455,1450,21719,1430
67316,25,324,242,251,4776,73
67721,23,171,230,129,2501,42
55415,0,0,606,0,4463,0
57683,62,727,544,553,7879,174
23413,774,19466,1273,13779,148309,5687
29174,8,255,1151,176,10679,79
17216,34,2091,1379,1162,29593,929
57717,69,712,543,577,7391,135
65079,44,852,306,695,6051,157
76,307,12590,1566,8098,89843,4492
19615,6,290,1336,202,8453,88
5855,32,1085,1507,790,15616,295
68323,117,736,210,683,6556,53
21325,57,667,1306,480,17374,187
65630,7,66,294,48,3392,18
21079,73,3590,1310,2282,49191,1308
35696,8,255,1026,174,14333,81
55610,56,382,600,272,5944,110
22938,74,2068,1280,1467,21213,601
13772,11,265,1431,161,10497,104
27570,92,2926,1182,1842,41037,1084
54029,119,1392,650,1249,18209,143
67150,14,397,247,284,8155,113
65613,1511,19633,294,15382,136070,4251
13841,211,3077,1430,2088,19956,989
70188,11,42,147,38,2815,4
33317,47,1504,1078,1126,9327,378
42842,102,1191,884,896,12256,295
17250,1318,33608,1378,24457,208238,9151
39156,101,1032,940,916,20372,116
11905,53,2076,1455,1027,15120,1049
18996,283,15163,1347,8264,66154,6899
2241,144,8736,1547,5448,50832,3288
16258,61,1511,1395,1003,23706,508
58867,1464,24483,505,17558,114717,6925
1148,1417,39605,1555,26159,302940,13446
16751,3241,66361,1387,44221,369305,22140
17137,1335,69880,1380,22558,675437,47322
9688,310,8433,1471,5066,31068,3367
5265,919,21364,1513,13928,81821,7436
184,235,13096,1564,9400,110067,3696
65490,63,891,297,768,7386,123
11585,10,541,1458,297,7953,244
8223,416,8702,1478,5297,32309,3405
2900,282,10570,1541,6196,57634,4374
37274,23,447,984,338,6273,109
58874,27,296,504,216,3171,80
40736,166,3632,918,2829,13089,803
38634,672,7926,947,5217,42118,2709
58358,84,1400,521,1109,13074,291
33624,1,77,1072,67,3865,10
58502,174,1748,516,1378,16121,370
68246,14,264,213,203,5858,61
60205,1474,41064,459,31052,130977,10012
22160,36,1309,1293,918,37816,391
3514,23,659,1535,455,22414,204
16742,10,136,1387,102,7497,34
44592,1725,23528,850,19383,190706,4145
53602,1458,30969,666,22947,106269,8022
1620,418,14855,1552,9744,122741,5111
53980,13,122,654,104,5155,18
33100,9,466,1082,286,8785,180
22656,88,1574,1286,1058,35880,516
37842,134,1918,969,1536,20963,382
27526,9,228,1184,127,5051,101
6615,79,2617,1497,1685,25357,932
54656,100,1236,629,859,9788,377
67801,8,91,227,65,1975,26
6845,11,257,1494,197,11232,60
33223,143,2642,1079,1926,32065,716
8804,36,2405,1475,1507,52344,898
55667,6,108,599,82,3973,26
15209,828,20112,1411,13820,83970,6292
51557,24,211,729,181,6095,30
65481,12,332,298,232,7158,100
22727,1632,25553,1284,14850,107406,10703
29030,4,120,1154,106,5637,14
13138,49,1467,1439,840,39734,627
21281,40,1642,1306,1208,19068,434
57386,5,33,551,23,4979,10
26061,30,1770,1216,1259,6237,511
4853,3,104,1519,89,6393,15
31450,2393,40187,1109,23777,187189,16410
33327,57,1117,1077,766,23954,351
23498,38,2068,1271,1719,12874,349
69366,3,96,174,91,4882,5
8723,1362,58807,1476,38575,299670,20232
14901,57,2713,1415,1873,36845,840
33831,18,328,1068,210,9309,118
15747,1,74,1403,47,5895,27
60584,2549,34358,444,23728,169392,10630
49560,42,370,781,277,7832,93
59087,7,114,498,86,5746,28
48746,32,1018,805,589,12556,429
47919,8,218,823,175,2881,43
17739,16,357,1369,273,12675,84
4347,8,418,1526,299,29924,119
59824,31,292,472,198,3785,94
28948,10,638,1156,335,6323,303
43333,90,1042,877,859,36376,183
56200,591,4980,584,4425,47019,555
12233,166,3687,1451,2287,27914,1400
24286,2923,135324,1256,84835,383924,50489
19098,79,1223,1345,864,14305,359
8245,81,1678,1478,1092,13118,586
17441,2,212,1375,165,10565,47
11047,0,7025,1462,4917,33962,2108
17495,7,443,1374,368,17762,75
55655,2,15,599,11,2072,4
29406,92,2886,1147,2228,96375,658
61452,312,12285,414,9392,56922,2893
15544,2,92,1406,64,6086,28
1542,278,5835,1553,3842,43614,1993
52499,25,237,699,217,6054,20
44019,82,1099,869,922,17396,177
14692,11179,442947,1418,274594,771474,168353
50348,3,67,761,55,5033,12
19898,19,808,1331,608,24836,200
15733,101,2883,1403,1876,29420,1007
64369,38,623,328,547,11923,76
34949,4,90,1043,55,5685,35
3966,26,474,1530,379,8939,95
42036,12,394,897,297,10052,97
3163,8,187,1539,94,5501,93
25799,798,12400,1222,10639,248019,1761
54090,4280,49925,650,39106,222290,10819
15387,326,8251,1409,5991,109286,2260
58000,43,449,533,340,8615,109
35300,8,182,1034,142,5127,40
1622,3313,94697,1552,59447,296350,35250
63219,36,657,362,560,19983,97
3530,30,887,1535,659,22360,228
65210,200,3171,304,2661,22173,510
26656,14,528,1203,342,21622,186
16322,45,2536,1394,1730,33782,806
26303,2,189,1211,122,6686,67
7300,371,14643,1488,9645,83168,4998
4879,6,261,1519,202,14719,59
27327,3,115,1188,74,15937,41
69648,36,297,166,233,3192,64
13783,6,377,1430,212,8751,165
61864,82,1045,401,898,15022,147
1734,24,3262,1551,2298,20008,964
17244,21,650,1378,490,9587,160
33963,244,1882,1066,1162,18629,720
4788,62,919,1520,642,13037,277
27896,65,1916,1176,1298,19782,618
70192,13,344,147,329,5964,15
17793,6,345,1368,257,25992,88
6832,5,178,1495,125,17562,53
57193,66,1425,556,934,8711,491
4252,530,17574,1527,12262,58406,5312
63943,7,119,342,90,2007,29
14162,690,36916,1425,24608,146256,12308
69535,3,147,169,114,8372,33
21797,32,1566,1298,989,18836,577
52486,24,393,699,260,13526,133
15252,13,536,1411,398,6760,138
26715,71,2680,1202,1765,49843,915
41180,602,18076,911,11974,115120,6102
62618,34,570,377,378,18972,192
20783,10,233,1316,184,11234,49
21836,135,3637,1298,2388,30433,1249
58367,115,769,521,598,10908,171
4814,49,3959,1519,2733,23220,1226
61331,50,685,417,468,9560,217
4837,9,329,1519,226,10172,103
64697,288,3121,319,2549,14054,572
66701,7,81,263,63,4375,18
1718,190,10447,1551,6938,72896,3509
21039,4,147,1311,110,16467,37
29158,45,1974,1151,1190,11320,784
64773,10,169,317,133,2576,36
6582,66,1882,1498,1286,32769,596
63630,19,313,351,203,5074,110
31006,33,1586,1115,1019,20151,567
15664,2244,99145,1404,63520,225325,35625
57205,120,1077,556,910,14313,167
6640,31,371,1497,229,27965,142
15009,13,348,1414,262,11093,86
63812,5,53,346,42,9843,11
40696,235,2117,919,1777,33453,340
50034,19,165,768,130,18057,35
50323,16,190,761,138,4536,52
36265,141,3319,1010,2839,35109,480
69000,11,97,186,96,6311,1
5049,104,3786,1516,2425,14996,1361
48691,178,1781,807,1377,19990,404
10242,7,187,1468,115,4840,72
32352,16,667,1096,381,7251,286
55637,3,111,600,53,5454,58
52320,2,29,705,23,3046,6
37025,10,399,991,307,6445,92
23749,20,736,1267,621,9786,115
23520,3,193,1271,128,23057,65
40607,15779,290218,920,190947,1421906,99271
17365,136,2775,1376,1954,15142,821
15517,202,9742,1406,6243,66280,3499
53397,26,440,671,345,6511,95
60782,3,46,437,33,2556,13
39917,723,10176,931,8617,122791,1559
64808,6,196,315,138,3910,58
8849,522,8916,1475,6075,36001,2841
62630,15,349,376,244,6140,105
51610,217,2279,727,1870,37539,409
34829,161,4416,1046,3349,81747,1067
1593,259,11664,1552,7283,58600,4381
41651,4,232,903,163,4219,69
30736,11,218,1121,168,10334,50
54955,573,6503,619,5439,45876,1064
64103,20,478,336,362,6857,116
15978,4,437,1399,263,8376,174
82,279,17938,1566,10227,155414,7711
3884,20,478,1531,323,14744,155
28170,31022,553562,1171,286731,1037516,266831
28512,11,256,1164,157,9528,99
51285,168,1930,736,1680,27485,250
11081,3,163,1462,104,19422,59
69559,5,103,169,72,2458,31
59011,45,990,395,814,24475,176
28344,24,394,1167,271,5527,123
36385,167,2171,1007,1857,23682,314
30074,12,478,1134,324,17450,154
17745,180,9275,1369,6361,76149,2914
29157,60,1191,1151,747,17131,444
4850,184,2700,1519,2108,24573,592
59689,7,178,477,138,3853,40
53503,32,315,669,264,7125,51
63733,19,356,348,273,12627,83
28821,99,2222,1159,1463,11097,759
15995,13,386,1399,269,12501,117
12425,575,24994,1449,13760,109176,11234
20698,50,1663,1317,1194,15280,469
9837,73,1988,1471,1424,56512,564
22130,377,7658,1294,5369,62462,2289
15008,90,3035,1414,2358,39952,677
3402,7,1071,1536,728,11942,343
53415,17,146,670,131,4238,15
19467,71,3540,1339,2889,31214,651
13627,40,1285,1432,781,54674,504
61408,90,1607,415,1184,13030,423
12436,311,10035,1449,6328,101596,3707
68576,19,396,201,337,6699,59
3586,13,462,1535,331,19033,131
20665,84,5675,1318,3107,35117,2568
22983,214,2772,1280,1733,25771,1039
20280,136,2964,1324,1974,31533,990
59127,15,238,496,170,4159,68
66158,3,45,279,38,2832,7
51666,139,1760,725,1455,24005,305
38749,20,487,946,388,33501,99
27873,154,3310,1176,2212,37659,1098
55666,23,557,599,411,12039,146
69320,11,284,176,276,6291,8
50370,522,9044,760,7415,53870,1629
29226,110,2464,1150,1823,14456,641
9336,646,9735,1473,5783,76042,3952
11655,69,4054,1457,1617,14858,2437
56393,15,283,578,245,11048,38
30411,24329,670765,1127,429021,1226301,241744
9542,20,408,1472,249,9822,159
7844,1,136,1481,105,12141,31
18883,89,2041,1349,1494,18253,547
24963,17,160,1240,114,2787,46
23611,11,725,1269,498,13861,227
22812,177,4319,1283,2736,81925,1583
24694,17,278,1246,187,13220,91
22400,0,0,1290,0,4057,0
43553,18,764,874,569,17190,195
2919,14,848,1541,605,47241,243
7497,90,2588,1486,1819,35775,769
3025,52,3161,1540,2121,54048,1040
59718,2,25,476,23,2702,2
58767,66,1925,508,1407,17936,518
17390,0,33,1376,26,5023,7
12152,6,255,1452,128,10534,127
22939,11,573,1280,448,14787,125
15774,182,5565,1403,4076,24264,1489
5909,65,2848,1506,1807,50142,1041
38715,60,1060,946,883,15037,177
24837,240,5056,1243,3438,43478,1618
4918,622,25417,1518,15939,107797,9478
52437,405,4425,701,3399,32101,1026
57290,156,1893,553,1434,13713,459
42063,1,16,896,12,11587,4
41689,23,520,903,387,12934,133
3967,97,3813,1530,2624,26118,1189
57044,2881,37296,560,31150,172254,6146
61315,34,428,418,346,8191,82
65779,7,81,290,53,5970,28
29573,221,7324,1144,5138,102405,2186
56087,92,746,587,579,5658,167
61929,926,174688,394,125137,148201,49551
66468,276,4859,259,3690,34031,1169
33001,405,13915,1083,9732,82004,4183
32125,49,627,1099,428,14846,199
26770,5030,85371,1201,52778,282260,32593
15429,50,1421,1408,1115,30932,306
1252,504,25015,1555,15507,99925,9508
59522,89,931,483,710,8308,221
355,82,2508,1562,1867,24420,641
9595,111,2201,1472,1416,20059,785
40668,2,33,920,16,1503,17
21013,602,13403,1311,9992,151916,3411
51847,112,2038,720,1590,33104,448
31820,602,6061,1103,4205,30774,1856
24026,9,514,1261,427,22452,87
29821,134,3585,1139,2643,38542,942
14427,53,1213,1421,813,9679,400
56770,37,288,567,204,4794,84
11705,10,508,1457,276,4418,232
22760,63,1331,1284,1014,33026,317
21289,379,5058,1306,3003,47107,2055
19082,13,544,1345,419,7373,125
12526,67,3843,1448,2210,53716,1633
51904,216,2762,719,2235,24347,527
64863,20,437,313,227,4401,210
28643,71,1300,1162,849,19980,451
69989,30,270,155,256,14735,14
52639,16,137,693,114,5622,23
30786,104,2005,1119,1301,20626,704
7306,151,4241,1488,2820,55469,1421
60864,2,20,434,13,4882,7
7495,1403,79627,1486,44580,272998,35047
2170,49,1906,1548,1363,23628,543
55812,413,7462,595,5438,40442,2024
22808,351,11547,1283,8339,109505,3208
57563,468,9390,524,7312,57009,2078
47181,101,1609,832,1346,33963,263
60647,120,3764,442,3113,25165,651
14833,7,710,1416,506,18803,204
41160,45,1281,911,1093,16731,188
24183,53,646,1257,524,54904,122
62572,69,1089,378,939,14328,150
6943,133,3053,1493,1919,44252,1134
20452,9,216,1321,142,11952,74
43531,1,91,874,80,10552,11
46555,370,13627,840,10953,74041,2674
58970,100,1614,501,1230,13058,384
6585,134,3201,1497,1942,50274,1259
47685,25,495,826,383,6926,112
66678,15,335,263,258,7027,77
65013,8502,213988,237,168551,801556,45437
68446,37,702,206,569,11472,133
19345,35,1373,1341,948,16598,425
14903,32,831,1415,645,17423,186
3184,26,550,1538,413,9797,137
66129,73,654,244,463,6834,191
56623,1110,30310,572,23327,143722,6983
63341,1,38,359,22,1762,16
65164,37,689,305,565,10046,124
35620,6,240,1027,176,8711,64
22692,85,1046,1285,688,7903,358
66526,9,75,268,71,4223,4
5897,12,487,1506,380,15776,107
3749,163,5327,1533,3657,25164,1670
6946,43,610,1493,452,10572,158
68641,6,94,198,64,5260,30
23639,152,3922,1269,2424,44177,1498
28577,9,91,1163,86,5064,5
26832,28,417,1199,340,9038,77
25280,4664,79338,1233,54695,181251,24643
17829,292,4962,1367,3435,35256,1527
32553,152,4068,1092,2691,21093,1377
60600,10,97,444,81,5990,16
11181,3,265,1461,151,39410,114
56809,4,60,566,45,2740,15
30733,468,11649,1121,7925,131966,3724
69902,10,171,157,171,2218,0
31564,142,3257,1108,2082,11346,1175
3614,34,2039,1535,1495,60161,544
6437,4,116,1500,84,6523,32
11811,127186,8445609,1456,4651809,15751104,3793800
62423,17,233,383,194,13440,39
54917,233,4357,620,3494,24973,863
1573,131,5118,1552,3716,58846,1402
50030,13,162,769,127,9394,35
18514,15,478,1355,372,13379,106
56286,65,864,581,636,15394,228
37062,366,7318,990,4870,51492,2448
5738,21,504,1508,348,23673,156
2089,158,3588,1548,2515,88603,1073
40785,384,3677,917,2917,21205,760
20414,79,1029,1322,768,10317,261
9479,25,769,1473,522,14492,247
65702,10,116,291,97,4269,19
8425,73,2265,1477,1396,18076,869
10177,156,6286,1468,4518,53965,1768
23600,26749,673828,1270,393892,1809996,279936
55997,613,8027,590,6297,51654,1730
30538,23,530,1124,442,36069,88
23000,26,1052,1280,707,40016,345
22261,9,246,1292,181,7526,65
29397,5,397,1147,334,21031,63
33910,3,161,1067,136,12245,25
21116,14,266,1309,214,13617,52
39185,18,656,940,542,10472,114
49412,2,27,785,23,2982,4
69904,7,101,157,95,2801,6
6007,137,6045,1505,3346,36315,2699
24576,55,644,1249,571,41719,73
12209,19,1413,1452,677,24101,736
39289,494,9871,939,6459,49318,3412
35273,35,625,1035,443,10436,182
45224,6,110,856,78,2670,32
23392,100,2778,1273,2040,18688,738
50206,68,3373,757,2599,28233,774
29458,31,801,1146,527,12264,274
56610,60,541,572,388,6661,153
19518,59,810,1338,603,11358,207
24879,39,755,1242,484,10164,271
57906,67,899,536,712,7486,187
29479,625,10456,1146,7203,104231,3253
63330,294,4291,359,3596,17927,695
2268,214,5281,1547,3809,40872,1472
4650,447,18086,1522,11463,95361,6623
38748,217,3904,946,3248,57899,656
10535,42,2290,1466,1473,39237,817
18773,17,543,1351,401,11148,142
57622,21,298,545,244,5765,54
21509,22,693,1302,523,12408,170
66811,0,12,259,9,2531,3
8685,141,6962,1476,4399,40653,2563
19163,228,5800,1344,4119,51006,1681
68184,102,1165,215,999,8976,166
14884,27335,620522,1416,329610,1574081,290912
50800,189,2572,749,1919,16397,653
16472,151,5932,1391,3949,71739,1983
8749,33,1078,1476,661,6850,417
64848,4,63,314,53,2499,10
23793,5103,113389,1266,59490,267778,53899
39807,447,7506,932,5664,37956,1842
32563,220,3920,1091,2588,18842,1332
64570,8,166,322,136,8460,30
22889,20,258,1281,193,23939,65
16816,158,3662,1386,2576,29315,1086
1583,5,399,1552,233,11426,166
27944,35,1280,1175,753,13981,527
25420,34,595,1230,391,11100,204
43301,41,906,877,678,9347,228
38731,502,6403,946,4918,43293,1485
21782,26,724,1298,509,8967,215
31332,984,24153,1108,17527,116651,6626
4306,434,15799,1527,11521,68214,4278
22529,9,365,1288,219,7561,146
2026,3446,164808,1549,110521,459585,54287
1304,58,1630,1554,1159,26648,471
14326,67,1905,1422,1372,28495,533
11584,20,1196,1458,679,14061,517
4972,10,219,1517,160,10149,59
1835,28,968,1550,688,16206,280
4589,11,498,1522,285,23508,213
29061,291,7621,1154,4865,72670,2756
29982,6,163,1136,95,3719,68
37009,11,191,992,151,3972,40
14926,31,818,1415,612,36043,206
16505,2,255,1391,186,11170,69
34420,4,69,1056,57,6608,12
67430,236,10083,239,8084,41582,1999
10358,107,2933,1467,1653,25995,1280
11831,0,0,1456,0,9713,0
25662,93,1603,1225,1329,27592,274
30436,10,423,1126,357,13722,66
48993,79,1695,797,1490,16742,205
35121,58,1099,1039,891,32041,208
58557,62,731,514,596,8263,135
37905,316,6079,967,3758,19892,2321
38713,44,573,946,397,18413,176
69011,17,448,186,383,2852,65
58075,6,67,531,52,6487,15
63706,597,9125,349,7323,66790,1802
22366,37,841,1291,545,13652,296
18068,8,712,1363,538,14797,174
67302,13,212,242,163,2312,49
70606,6,141,133,114,2005,27
65117,163,2002,306,1566,10817,436
8334,44,999,1478,730,35053,269
30568,435,9419,1124,6451,75062,2968
69389,13,146,174,108,6417,38
9517,37,1217,1472,805,34789,412
55327,15,131,608,107,5454,24
60130,47,854,462,631,8254,223
35231,39,1482,1036,1020,19293,462
5940,950,33835,1506,22138,317911,11697
53632,2128,25258,665,21878,169748,3380
55456,27,466,605,416,12006,50
21534,7,502,1302,329,9249,173
6530,9,398,1498,302,21792,96
10395,0,0,1467,0,7903,0
39475,72,1792,936,1423,36949,369
11777,150,5400,1456,3043,66712,2357
70447,261,6755,138,6644,46995,111
4809,93,2477,1519,1784,34423,693
15698,890,15788,1404,12169,127428,3619
1459,214,6870,1553,4314,66095,2556
37962,421,6996,965,5410,95959,1586
705,2610,99371,1559,68958,211714,30413
23246,1178,33248,1276,23598,233140,9650
41239,9,184,910,147,2339,37
68701,15,218,197,156,4706,62
47437,9,166,829,112,5139,54
51162,143,1240,739,1051,27967,189
11144,7,427,1461,275,6215,152
3548,189,21592,1535,12321,88782,9271
17678,96,2640,1370,1921,52506,719
64268,82,565,331,491,6335,74
67135,8,155,248,121,7257,34
56065,87,1238,588,1079,23160,159
56604,14,117,572,92,2995,25
57962,197,2509,535,2071,24972,438
14583,4,168,1419,120,10625,48
34537,37,475,1054,295,6724,180
25428,83,1590,1230,990,21503,600
36772,9,309,987,231,14518,78
35444,18,284,1031,183,3845,101
39108,12,451,941,328,5548,123
57283,409,9148,554,6301,28474,2847
63728,6,69,348,58,4550,11
2338,109,3460,1546,2238,50044,1222
28781,199,3200,1159,1791,21246,1409
19113,27,610,1345,534,6607,76
17519,1729,78303,1373,56933,365563,21370
60505,13,138,447,98,5316,40
58016,251,15074,533,11092,74820,3982
37862,777,13437,955,10450,118114,2987
51228,14,125,738,109,3026,16
39850,2,106,932,67,3311,39
42424,49,454,891,338,4324,116
19454,141,6292,1339,4098,34708,2194
23502,3,372,1271,267,11162,105
23983,369,9298,1262,6603,129527,2695
15583,259,8443,1405,5750,62189,2693
50658,187,2275,753,1860,18366,415
1320,225,16901,1554,11463,57055,5438
3506,447,11195,1535,8254,32169,2941
65401,68,1134,299,951,16832,183
35032,82,1126,1038,867,35753,259
27018,127,3631,1195,2558,125314,1073
33982,149,2572,1065,1839,37053,733
27481,24,315,1185,219,4545,96
7801,6905,125028,1481,76838,288300,48190
23249,225,6212,1276,4296,45263,1916
24550,17,358,1249,252,4812,106
35195,65,1952,1034,1577,28674,375
65170,43,552,304,431,4732,121
36122,86,1153,1015,957,20648,196
48529,29,510,812,413,10971,97
37856,132,3434,968,2192,35688,1242
69417,52,567,173,495,10901,72
10093,1685,40381,1469,24888,182138,15493
55753,92,1419,597,1103,16367,316
17166,3,119,1380,90,4904,29
67761,8,108,228,75,2425,33
28059,15,518,1173,350,13441,168
11206,3274,105793,1461,64148,446256,41645
34390,68,1128,1057,824,22140,304
5942,220,7127,1506,4919,97083,2208
16329,2,101,1394,64,15299,37
10588,2,60,1466,28,4146,32
49341,484,8450,786,6992,48170,1458
52451,62,1186,700,880,13597,306
290,882,36343,1562,22390,86465,13953
21635,0,36,1300,27,2699,9
32471,74,890,1093,558,14712,332
57039,5,135,560,76,4149,59
37980,38,843,965,741,38220,102
1316,14,232,1554,165,13444,67
67598,8,81,233,47,6722,34
54894,12,36,620,28,4131,8
1325,25,755,1554,524,26830,231
49984,83,1809,770,1435,16185,374
52806,80,1409,688,1056,17828,353
606,29,1109,1559,815,36966,294
26748,126,3137,1201,1976,33812,1161
9949,10,620,1470,393,10848,227
28370,39,1383,1167,847,13432,536
11276,22,1175,1460,678,18325,497
59424,11,163,486,123,11153,40
67140,4,53,248,48,2758,5
26251,19,1179,1213,671,11475,508
67278,8,97,243,82,5948,15
58547,71,801,515,546,9423,255
38452,74,1057,952,840,9183,217
37346,167,2238,982,1714,19844,524
10674,9,271,1465,173,13996,98
15602,44,2520,1405,1699,27017,821
5073,20,508,1516,370,9307,138
46454,79,572,842,433,8478,139
70489,3,30,137,28,4227,2
41513,2,56,906,41,5580,15
65781,17,198,290,150,4426,48
32197,81,1293,1098,891,10444,402
57938,829,8240,535,6828,36566,1412
9745,186,4040,1471,2550,24863,1490
18218,2,120,1360,97,9308,23
60912,9,103,432,92,2409,11
64788,39,593,316,453,9233,140
22905,8,469,1281,329,15527,140
1197,1392,72937,1555,44952,195630,27985
19108,76,2182,1345,1431,18753,751
4462,101,4660,1525,3175,99194,1485
24627,2211,55043,1247,35243,226899,19800
13120,75,2346,1440,1262,21305,1084
68434,21,286,207,254,9610,32
64486,48,724,325,595,15718,129
19793,204,5030,1333,3655,17611,1375
36005,29,469,1018,391,18179,78
26224,69,759,1213,521,7772,238
48636,25,308,809,247,10734,61
53282,58,842,674,681,17553,161
60163,3,64,461,36,3302,28
5961,229,7846,1506,4869,26581,2977
39308,4,116,939,93,3036,23
57059,50,1097,559,718,20219,379
41854,324,3147,900,2226,32622,921
13470,16,587,1435,326,17363,261
55923,14,305,592,236,8321,69
47521,832,11032,826,8450,65091,2582
64539,34,377,324,302,6085,75
64421,2,18,327,9,2446,9
59688,24,308,477,224,9113,84
60156,20,361,461,283,6987,78
61218,2988,86914,421,65035,403259,21879
15504,26,1017,1407,724,54362,293
37373,4,84,981,70,6050,14
51019,245,3290,743,2877,31301,413
51229,175,3538,738,2732,27709,806
19338,3,132,1341,102,5466,30
27780,907,16083,1179,10517,81421,5566
38518,4,43,951,40,7283,3
50418,1681,23926,758,18011,87951,5915
26865,30,459,1198,309,10372,150
2872,19,389,1541,295,27409,94
40353,10,152,924,128,6911,24
57879,5722,83753,536,61979,287924,21774
31076,96,3342,1114,2201,40116,1141
15750,20,774,1403,570,15979,204
5213,13,355,1514,297,18407,58
65357,46,856,300,614,6085,242
5105,37,2065,1516,1417,29162,648
828,9,727,1558,481,11712,246
55992,137,2270,590,1710,19510,560
49485,40,619,783,567,13969,52
56627,20,207,571,173,6671,34
1826,2083,42070,1550,26739,78933,15331
22124,1227,11577,1294,8350,47135,3227
28786,109,2492,1159,1563,29830,929
16502,1,97,1391,68,24597,29
62428,6,100,382,86,3818,14
25646,50,1301,1225,743,17776,558
48710,104,1350,806,886,11526,464
5610,154,4240,1510,2417,15804,1823
12324,36,3684,1450,1950,27290,1734
1200,1533,77705,1555,55837,294981,21868
68881,232,8447,190,6934,43868,1513
70526,9,80,136,71,2511,9
15612,55,757,1405,490,11749,267
31816,93,3177,1103,1979,22173,1198
15165,4,234,1412,181,11300,53
35689,50,1609,1024,1204,23183,405
25625,127,3149,1226,1950,17560,1199
3645,22,819,1534,626,10066,193
41758,13,294,901,249,10302,45
40610,526,8838,920,6467,94935,2371
47773,142,1502,824,1292,32048,210
40689,21,916,919,696,36224,220
60336,25,243,454,195,7343,48
51241,26,314,737,260,12284,54
57421,7,162,551,124,8521,38
17858,110,2169,1367,1518,69707,651
35722,16,471,1025,364,7580,107
30986,2475,38027,1116,28491,200225,9536
2586,15,485,1544,331,12103,154
52351,67,710,704,542,9996,168
49100,11,219,794,170,5242,49
66860,67,1379,257,1026,13703,353
37992,18,290,964,231,8221,59
44212,1215,23056,866,17727,167655,5329
26592,3,364,1205,227,7671,137
49162,334,3501,792,2825,26742,676
62958,28,474,369,350,18665,124
34974,8,405,1042,252,11047,153
11419,24,534,1459,336,12967,198
24342,6496,160723,1254,106077,805360,54646
28709,45,1017,1160,647,9470,370
18713,2,210,1352,137,18777,73
29983,6,222,1136,147,13694,75
56432,23,319,577,228,5715,91
12325,349,11874,1450,7046,65654,4828
28227,19,310,1170,233,4824,77
60467,1,25,449,14,3027,11
15050,545,18040,1413,12618,128737,5422
66896,95,1726,256,1418,17200,308
33052,162,5480,1083,3628,28386,1852
49185,5,61,791,52,2333,9
1370,3239,97961,1554,63744,415293,34217
41372,19,448,908,347,19881,101
10454,48,2814,1467,1763,19932,1051
30801,16,654,1119,446,21332,208
26668,451,15205,1202,10331,88517,4874
22293,40,862,1292,587,51070,275
26338,90,7612,1211,4368,28941,3244
20700,4365,78419,1317,59736,353158,18683
67039,33,475,251,392,7770,83
20633,15,570,1318,426,25141,144
34032,874,21096,1064,15551,123663,5545
14196,41,2110,1424,1571,24542,539
19869,629,19418,1331,13429,158827,5989
10026,3,98,1469,54,3409,44
69285,1,27,177,22,4435,5
59646,9,84,479,68,5016,16
67561,493,9460,234,7443,64854,2017
39128,1778,36928,940,29479,120164,7449
35059,17,374,1041,270,10729,104
32927,21,662,1085,443,10265,219
67709,40,479,230,385,5737,94
33592,54,1056,1073,655,6644,401
24376,92,2656,1253,1938,34248,718
61991,75,723,396,566,8262,157
70102,58,828,150,779,9773,49
462,3,297,1561,212,14359,85
58252,4,75,525,61,3911,14
29822,223,4062,1139,2471,20512,1591
68713,48,488,196,385,3274,103
11711,123,4822,1457,3109,39691,1713
46672,1968,27289,839,21840,230965,5449
17310,18,389,1377,287,7520,102
4240,1214,24159,1527,16168,110397,7991
66575,5,27,266,19,3226,8
13201,6,307,1439,163,8742,144
30205,67,1904,1131,1497,62729,407
66804,14,302,259,220,8410,82
416,16,467,1561,325,38056,142
52622,14,269,694,208,28198,61
24934,28,577,1240,446,10857,131
20749,72,2787,1316,1961,16194,826
44962,10,133,858,111,6889,22
19985,4,266,1329,190,12485,76
31824,51,922,1103,681,4859,241
65345,8,76,301,64,2299,12
843,76,1901,1558,1310,35217,591
20754,19,776,1316,607,17402,169
29376,15,431,1148,348,24671,83
8176,58,2050,1478,1367,37591,683
69487,8,271,171,199,4826,72
23804,38,517,1265,358,15362,159
58141,648,41988,529,31454,126575,10534
14792,108,3355,1417,2236,143523,1119
37354,82,2891,981,2229,41888,662
18269,35,2043,1360,1065,12070,978
4475,26,653,1524,507,10708,146
34005,707,13601,1065,9568,71829,4033
41545,36,566,905,451,8213,115
911,25,1562,1557,1186,58438,376
19230,1,158,1343,96,4121,62
13562,194,9648,1433,6023,97202,3625
2062,122,8714,1548,5967,96695,2747
70097,24,450,151,381,4811,69
6880,69,7092,1494,4381,64031,2711
1455,59,2144,1553,1537,20232,607
53789,52,497,660,390,8686,107
52911,437,4891,684,3744,24939,1147
18948,49,971,1348,734,16415,237
30696,24,715,1121,553,13390,162
23898,297,7799,1264,5332,29878,2467
1392,5,190,1554,145,19307,45
48257,389,8251,819,6413,49473,1838
6751,33,1065,1495,684,19152,381
16817,8,442,1386,294,13506,148
67654,39,408,232,347,9100,61
11098,72,2110,1462,1460,17151,650
67619,3,38,233,37,2293,1
9175,93,2513,1474,1731,42780,782
23445,0,24,1272,18,2204,6
10465,114,5464,1467,2858,50428,2606
15361,24,521,1409,355,24153,166
22992,20,662,1280,481,17946,181
62187,27,145,389,124,4794,21
38287,19,271,957,227,7256,44
21858,2,62,1297,51,3979,11
35702,136,1967,1026,1552,37441,415
30806,7,494,1119,308,11361,186
51292,5,130,736,84,7675,46
35147,44,1339,1038,895,27937,444
30031,282,6291,1135,3819,56700,2472
67105,13,175,249,133,2606,42
8170,587,17735,1478,11301,68922,6434
57956,11,240,535,189,4440,51
2072,82,3405,1548,2402,29413,1003
63809,27,553,346,439,6203,114
51677,8,82,725,60,2582,22
69059,4,64,184,51,1564,13
13936,21,2829,1428,1490,40079,1339
53056,55,921,680,744,13321,177
59205,7,148,494,119,23295,29
56154,28,342,585,283,5274,59
13856,1,111,1429,70,7936,41
25472,16,484,1230,350,7935,134
8600,24,1077,1476,718,15513,359
37625,36,819,974,641,10829,178
4309,12,384,1526,290,5505,94
70400,415,9280,140,9010,71069,270
56731,1080,19300,568,15865,92994,3435
25886,134,2446,1221,1631,28531,815
4722,41,1381,1521,957,19156,424
59301,26,279,490,192,6404,87
54577,70,683,632,534,18912,149
61693,223,2594,407,2173,28437,421
19695,48,793,1334,542,15118,251
5657,67,2190,1509,1414,34825,776
5314,86,3480,1513,2488,48658,992
5254,10,459,1514,308,18296,151
10851,10,292,1464,202,24014,90
69890,6,81,157,63,4192,18
35684,326,6791,1026,4789,26584,2002
32219,73,2340,1097,1429,17468,911
3165,578,13625,1539,9348,86612,4277
17788,3,177,1368,120,8374,57
2950,66,2008,1541,1275,21097,733
27953,120,1788,1174,1126,19045,662
9654,95,2586,1472,1718,38388,868
51520,4,84,730,63,5418,21
56879,16,321,564,285,8772,36
9273,11,468,1474,279,6642,189
33325,40,492,1077,341,6163,151
49357,23,234,786,183,6469,51
2803,1350,47814,1542,28779,116643,19035
25361,348,6283,1231,4810,51511,1473
4871,37,1785,1519,1176,36389,609
36531,213,1791,1002,1412,17090,379
9732,29,882,1471,554,6717,328
474,36,2564,1561,1557,49640,1007
56303,21,376,581,301,9944,75
39653,9,385,934,298,8833,87
58171,90,1985,527,1619,18459,366
47153,37,487,833,421,32639,66
10116,3,121,1469,70,2435,51
34177,26,968,1061,628,17614,340
37786,6,168,970,120,2305,48
59217,0,3,493,1,1621,2
3115,25,926,1539,729,9766,197
48391,12,66,816,53,3038,13
52672,13,126,692,113,14059,13
62066,20,318,394,295,13949,23
23170,2772,121920,1277,82264,584905,39656
26713,1240,24061,1202,16516,276075,7545
1162,33,911,1555,639,38870,272
32246,2796,113766,1097,79799,350397,33967
36986,6,211,992,174,4191,37
27304,363,7499,1189,4699,116154,2800
9637,59,4438,1472,3016,61272,1422
27635,417,4614,1181,4031,52961,583
62460,18,175,382,136,4180,39
38157,18,381,960,307,9770,74
32864,190,2294,1083,1752,31496,542
13340,15,549,1437,321,14886,228
8772,1775,39389,1476,24712,218120,14677
66008,1002,13019,284,10642,39141,2377
25079,203,3329,1237,2113,18749,1216
31799,5358,164788,1103,113994,216249,50794
30790,575,7852,1118,5246,25236,2606
620,6,356,1559,218,46595,138
29868,476,16046,1138,11804,74249,4242
44452,12,95,864,79,10581,16
65679,27,238,292,198,3118,40
17083,4,105,1381,83,4225,22
12691,12,839,1446,448,10001,391
35872,4,112,1021,61,3905,51
5679,83,2245,1509,1489,22261,756
42414,23,386,891,323,21323,63
35383,172,2288,1032,1745,15279,543
62616,6,88,377,63,3168,25
53375,19,226,672,183,7434,43
32811,61,1122,1087,849,13648,273
55849,116,1142,594,980,23910,162
11929,132,7401,1454,4837,84038,2564
64168,8,129,334,99,4858,30
70177,2,28,148,22,961,6
37047,7,122,987,97,3364,25
15741,9,168,1403,109,9063,59
9596,96,2644,1472,1672,13644,972
46052,11,176,846,149,6942,27
10862,140,3852,1464,2528,24308,1324
14980,24,816,1414,597,17899,219
67236,0,19,245,17,1145,2
58117,71,457,529,388,9406,69
31371,782,11685,1110,7803,37781,3882
27055,113,2522,1194,1632,20023,890
16085,210,5674,1397,3774,60309,1900
32317,37,384,1096,246,3070,138
55102,61,671,614,515,10631,156
57695,13,269,543,218,10862,51
69087,19,322,184,281,11586,41
7276,5,289,1488,208,13471,81
57899,33,516,536,420,16883,96
41982,261,3847,891,2721,37640,1126
63401,411,8598,357,7207,31476,1391
32545,283,7413,1091,4169,30356,3244
24150,3,101,1258,79,5641,22
38805,297,7368,944,5759,81065,1609
66695,38,539,263,459,7639,80
56014,30,243,589,189,9106,54
51064,73,1412,742,1034,23278,378
15930,869,43236,1400,27557,213567,15679
29764,2,48,1140,32,6941,16
56700,118,1136,569,960,15951,176
63675,18,336,350,250,6256,86
55418,13,192,606,146,4460,46
54423,3595,50028,636,34907,342907,15121
62556,521,7919,379,6577,49942,1342
4502,3442,90337,1524,49568,207653,40769
35857,505,5194,1021,3884,27704,1310
51006,18,177,744,156,6245,21
7020,26,932,1492,673,41234,259
42376,884,13223,892,10390,106093,2833
15060,8,350,1413,239,16533,111
38235,5,126,958,82,2066,44
59447,18,199,485,162,6432,37
52443,17,384,701,240,19002,144
32255,24,711,1097,489,5241,222
56242,11,143,583,78,3990,65
36038,15,315,1017,266,6164,49
25835,185,3262,1222,2171,27431,1091
65671,41,616,292,485,14246,131
67137,4,49,248,38,3432,11
1770,247,5660,1551,3960,42683,1700
16962,27,878,1383,600,15210,278
63919,32,541,342,403,3528,138
59223,27,503,226,386,6230,117
6300,73,2477,1502,1617,22817,860
12501,705,22410,1448,14058,165793,8352
51802,22,188,721,160,10402,28
16372,203,5506,1393,2975,21438,2531
29767,18,256,1140,175,14056,81
36383,264,5665,1007,3816,26458,1849
66012,30,201,284,174,5464,27
48858,2189,40666,802,28489,140603,12177
52274,6,118,706,103,7317,15
62515,9,68,380,46,4723,22
7543,3,114,1485,83,7479,31
33008,177,3204,1083,2282,33649,922
8196,844,16085,1478,10261,59513,5824
68914,8,106,189,68,2868,38
17613,132,3036,1372,1952,15489,1084
23029,1239,46859,1279,34531,327773,12328
64301,22,223,330,201,8576,22
11079,56,1278,1462,836,18879,442
5511,110,4907,1511,2876,33349,2031
28713,15,549,1160,311,5113,238
37120,25,404,988,262,12774,142
67340,5,65,241,53,3076,12
54639,147,2310,616,1841,19872,469
28991,1727,50282,1155,30215,210989,20067
43175,18,304,878,219,5034,85
6057,116,10929,1504,6776,66982,4153
23756,24,433,1266,297,21659,136
56273,10,322,582,270,12240,52
52978,17,355,682,325,9972,30
7697,3,200,1483,126,16938,74
2052,260,4836,1549,3370,70389,1466
18118,1,55,1362,41,2910,14
14397,139,4894,1421,3527,43689,1367
35958,14,591,1019,432,6687,159
25330,229,3531,1232,2370,36608,1161
38497,9170,370135,951,296106,660815,74029
20386,118,2555,1323,1776,21133,779
42034,59,1244,897,965,14087,279
20618,1947,79167,1319,49746,463309,29421
41268,34,710,910,517,8605,193
64694,25,213,319,189,8611,24
25022,13601,312743,1238,200308,711018,112435
36497,9428,206746,1003,153127,1093771,53619
9097,11,1108,1474,683,10983,425
26697,9,247,1202,159,5339,88
30614,126,3224,1123,2205,37248,1019
13745,341,11441,1431,6803,25972,4638
59000,2,35,500,24,3271,11
47541,12,286,828,203,5533,83
49613,19,419,780,362,10437,57
19426,42,1248,1339,863,9249,385
52633,1055,23736,694,19018,181015,4718
55422,8,138,606,102,8523,36
16466,13,471,1391,361,24799,110
52121,68,1218,711,941,20899,277
53009,41,468,681,391,6688,77
9699,11,301,1471,223,4317,78
26780,54,1583,1200,972,14053,611
68850,39,629,191,480,5238,149
39523,28,478,936,350,10538,128
53771,261,8489,661,6122,29900,2367
54829,149,1919,623,1444,20617,475
69023,25,489,185,379,6757,110
24895,9,513,1241,376,11346,137
8453,37,896,1477,589,36157,307
9784,19,638,1471,326,5929,312
12942,41,1124,1442,698,19637,426
42079,43,670,896,570,12116,100
19704,59,1228,1334,985,21610,243
37091,282,6401,989,5355,39980,1046
59453,14,104,485,82,3611,22
17399,132,2350,1376,1553,9145,797
15022,27,747,1414,583,11095,164
56856,321,6769,565,5738,36526,1031
67728,8,261,229,202,3375,59
17225,14,394,1379,301,16446,93
19685,11,257,1335,221,21386,36
16089,438,9023,1397,6297,45183,2726
48176,35,207,820,188,8556,19
62130,46,1751,391,1289,11891,462
19714,0,0,1334,0,18850,0
17052,92,2177,1382,1563,29139,614
11536,234,16678,1458,8399,74820,8279
4801,16,984,1520,621,26412,363
11972,25,2557,1454,1242,25881,1315
34347,16,461,1058,370,24599,91
16481,2306,84387,1391,54040,401774,30347
52543,51,962,697,763,12774,199
8023,2142,31215,1479,19735,89727,11480
35582,275,8841,1028,7219,74149,1622
4448,23,2085,1525,1035,40342,1050
29778,4,700,1140,398,17804,302
69663,251,5404,165,4605,34790,799
31114,546,9510,1114,6898,44075,2612
25270,118,2273,1234,1536,37817,737
64116,52,341,336,260,4413,81
44207,459,14106,866,11387,90644,2719
30598,52,1741,1123,1222,21252,519
61847,15,183,402,140,6006,43
22213,41,906,1293,535,34563,371
44317,65,1112,865,823,14007,289
26956,391,7255,1196,4427,28945,2828
3332,19,885,1537,573,18087,312
64218,24,202,333,168,1934,34
54244,1144,15236,645,11253,80864,3983
26133,9,197,1215,130,5242,67
9682,32,1150,1472,780,20142,370
58092,31,383,530,287,7426,96
13680,30,449,1432,288,9759,161
56076,14,152,588,131,6064,21
56078,52,769,588,677,14481,92
55137,33,608,614,466,6010,142
16268,2,375,1395,128,14383,247
20689,5,133,1317,94,7686,39
14749,114,3747,1417,2660,30209,1087
20034,12,326,1328,235,19755,91
50311,60,987,761,743,24896,244
67566,46,1042,234,851,10480,191
33449,17,268,1075,180,3891,88
977,794,42485,1557,29385,144756,13100
21600,16,549,1301,411,12270,138
178,73,6882,1564,4559,19579,2323
56112,263,4597,587,3280,23308,1317
64425,14,230,326,174,6394,56
59694,6,52,477,45,3973,7
58859,84,699,505,586,8500,113
37088,6,121,989,100,4347,21
19606,130,2639,1336,1611,13674,1028
50846,86,1354,748,967,14190,387
67310,25,474,242,367,7556,107
32180,45,1329,1098,902,20360,427
69025,31,548,185,480,6810,68
41764,53,707,901,599,29007,108
33551,14,174,1073,156,11955,18
61317,215,5211,418,4265,36963,946
55718,1182,16825,598,14065,104686,2760
23569,85,3005,1270,2124,26462,881
50861,320,5678,748,4439,30110,1239
28162,1,35,1171,32,1733,3
56033,9,281,589,183,5973,98
66421,1,36,272,30,4553,6
8544,532,11336,1477,7865,60102,3471
33075,160,2660,1082,1704,17517,956
31901,7,193,1102,138,9778,55
15762,17,758,1403,517,19390,241
35767,315,8389,1024,6525,68213,1864
8792,39,1798,1476,1235,45633,563
8666,182,11086,1476,7415,102111,3671
37498,152,4112,978,3356,42995,756
26746,43,1549,1201,1016,22417,533
53620,974,18451,665,14575,120924,3876
57048,51,782,556,599,9559,183
10781,134,4084,1464,2761,59404,1323
32564,177,1937,1091,1282,28039,655
26263,18,481,1212,334,9281,147
22295,12,184,1292,118,12102,66
64647,1089,18518,320,14568,94666,3950
31095,39,755,1114,482,11343,273
3635,171,3793,1534,2537,23739,1256
18457,16,970,1356,621,13473,349
54355,14,143,640,102,4216,41
136,899,35786,1565,23304,239598,12482
6548,219,7101,1498,4439,34425,2662
62234,17,195,388,146,7691,49
61274,8,76,419,60,1921,16
29949,36,671,1136,586,12687,85
61854,11,222,401,180,5793,42
57773,47,675,540,485,11872,190
30710,277,4335,1121,3021,28752,1314
3121,780,16403,1539,10890,127084,5513
17186,12,778,1379,531,8745,247
49954,1,98,771,66,8137,32
12481,513,20154,1448,13301,83310,6853
55142,4,46,613,36,4482,10
25753,52,1377,1223,896,13283,481
8439,49,1224,1477,798,16880,426
54736,19,849,626,505,4014,344
42193,26,440,895,347,14138,93
52447,72,691,701,527,8935,164
26476,14,417,1208,272,5720,145
2660,1,148,1544,92,6844,56
11498,140,3843,1459,1908,21417,1935
36710,1,53,999,39,3408,14
37391,9,217,980,168,11349,49
29276,50,1964,1149,1204,25261,760
51219,8,163,738,132,7325,31
63234,33,518,362,462,10586,56
64567,3,39,323,25,2328,14
65909,29,190,286,166,8201,24
37216,22747,464363,986,364553,2513780,99810
69082,43,451,184,375,6719,76
45013,70,1433,858,1104,8858,329
7754,163,8947,1482,5663,74487,3284
62931,65,523,369,411,11032,112
62092,128,1570,393,1339,23960,231
26396,15,1057,1209,698,16832,359
21100,52,1963,1309,1451,18816,512
4205,21,395,1528,283,16789,112
9441,13,746,1473,504,26175,242
54136,7,34,648,32,4226,2
45509,1786,24777,852,19764,208758,5013
6737,31,695,1496,519,15998,176
13962,134,5868,1428,3609,33992,2259
61397,35,591,416,499,10497,92
30546,207,5025,1124,3145,58264,1880
28623,67,2990,1162,1874,33312,1116
30966,38,654,1116,469,16279,185
1198,22,740,1555,587,20644,153
34447,18,994,1054,652,8866,342
64914,19,237,312,196,3180,41
27485,48,1033,1185,648,13352,385
30796,14,469,1119,329,7436,140
15324,191,10723,1410,5814,60230,4909
15439,604,15976,1408,10949,121716,5027
51579,298,3932,728,3106,54975,826
1725,25,943,1551,633,21798,310
52841,5535,76946,685,56599,433243,20347
24128,35,1256,1259,858,29168,398
68465,22,425,205,333,6699,92
57014,127,1231,561,1033,15463,198
11279,93,4439,1460,2708,29606,1731
55917,95,1128,592,925,11538,203
64315,36,349,330,285,5385,64
527,5,171,1560,126,9367,45
60714,5,89,440,63,4061,26
40352,6,136,924,97,2022,39
52834,259,2406,687,1943,17652,463
5418,251,7880,1512,5534,33429,2346
37296,18,425,983,331,4456,94
7273,27,1854,1488,1155,23370,699
70462,8,94,138,92,1052,2
5089,63,1105,1516,729,30334,376
58720,54,638,509,490,13468,148
1538,653,16208,1553,10506,58572,5702
10191,47,1737,1468,1107,32892,630
32918,137,1417,1085,926,16697,491
11695,11,478,1457,175,10508,303
16977,1763,58224,1383,41185,400459,17039
22025,49,833,1295,562,16855,271
38974,52,1004,943,796,28601,208
3959,36,2129,1530,1408,41680,721
51076,33,426,742,371,14061,55
37710,839,9588,965,7438,69684,2150
40435,47,1045,923,839,18386,206
17576,4,274,1372,209,6439,65
3036,2,268,1540,201,25131,67
11556,21,789,1458,529,30820,260
53874,292,2521,643,2241,24678,280
49471,183,3763,783,2589,43827,1174
70323,5,92,143,84,5684,8
7548,740,20095,1485,13336,106049,6759
46829,447,7198,836,6186,75248,1012
56764,46,465,559,381,5100,84
34277,29,722,1058,489,6607,233
68695,1,33,197,24,2173,9
756,23,774,1558,539,16529,235
56516,24,241,574,187,5169,54
63267,7,56,361,47,2292,9
67563,93,1553,234,1248,24113,305
22352,39,971,1291,627,12057,344
55437,5,61,605,45,4591,16
50641,61,360,753,258,6230,102
1765,96,2983,1551,2022,66759,961
31876,15,267,1102,182,4664,85
42965,46,467,882,350,8308,117
32594,371,24385,1091,16293,84077,8092
37075,43,1102,990,872,21064,230
3724,35,808,1533,578,40975,230
10097,113,4088,1469,2468,36105,1620
37932,1,13,967,13,6193,0
56382,108,1061,579,851,14719,210
6927,19,1006,1493,800,16397,206
32303,213,3065,1096,2230,21518,835
37360,13,300,981,261,10006,39
24721,15,515,1245,364,10484,151
31304,64,2318,1111,1594,22975,724
9906,26,317,1470,213,13778,104
8072,89,4045,1479,2596,21772,1449
40,2,293,1566,151,15786,142
52025,21,199,715,148,2724,51
67549,12,208,235,164,8355,44
55123,52,659,614,575,10087,84
45782,1327,19312,850,14564,75121,4748
58123,56,934,525,734,13326,200
59520,5,37,483,29,2363,8
43167,62,1198,878,956,11853,242
6345,150,3368,1501,2218,103498,1150
65213,73,1766,303,1628,16239,138
58348,156,1169,522,917,8185,252
57927,9,177,536,146,8099,31
11273,85,2813,1460,1822,19149,991
13639,137,6923,1432,4425,85591,2498
37431,0,17,979,16,6471,1
58758,0,143,508,99,2702,44
28607,209,4915,1163,3232,14414,1683
24843,193,5723,1243,3794,91779,1929
26497,495,8051,1207,6176,58565,1875
65875,8,148,287,94,4185,54
25787,14,363,1223,248,13889,115
60287,126,3105,456,2196,26169,909
7767,29,1981,1482,1280,20469,701
19679,11,611,1335,449,8687,162
64889,59,1001,313,914,18761,87
34583,4246,119418,1053,86897,421586,32521
29628,14,499,1143,329,10658,170
6015,152,12231,1505,7921,85299,4310
35982,11,230,1019,177,6611,53
24044,5,208,1261,176,2928,32
17651,238,6652,1371,4750,63391,1902
28723,17,566,1160,361,7793,205
17646,60,2820,1371,2123,16012,697
698,5,212,1559,165,9569,47
26283,3,97,1212,76,6569,21
30764,1830,50644,1120,32723,195104,17921
32376,50,851,1095,544,7519,307
1402,174,7600,1554,5841,62216,1759
30603,143,1008,1123,756,13239,252
60381,284,2238,453,1836,12999,402
25182,93,734,1236,539,12407,195
10029,15,504,1469,366,13273,138
19506,141,2128,1338,1376,14738,752
23484,4,167,1272,114,6529,53
15331,110,3384,1409,2380,41382,1004
70051,12,171,152,138,3166,33
37066,6,144,990,108,2787,36
16406,3,108,1392,69,5178,39
30773,16,588,1120,363,10742,225
15454,172,4069,1408,2695,48800,1374
18502,5359,125651,1355,78186,451984,47465
22806,87,2723,1283,1904,22380,819
25714,6,492,1224,327,11700,165
27062,66,3331,1194,2247,45179,1084
24629,0,16,1247,11,5116,5
12064,9,359,1453,189,23910,170
13883,0,162,1429,77,7094,85
34211,181,2551,1060,1909,16543,642
10929,176,7798,1463,4464,46813,3334
29800,282,6860,1139,5419,67711,1441
52410,8,109,702,85,4448,24
48081,126,2592,821,2110,25068,482
5471,68,1879,1511,1255,15977,624
56317,134,1655,580,1341,13160,314
29349,0,0,1148,0,11652,0
51451,6,64,732,55,3378,9
33656,855,11144,1071,8032,98746,3112
14843,19,422,1416,280,12783,142
49473,7,297,783,204,16546,93
5690,32,675,1509,404,12177,271
54669,118,2491,628,2010,15085,481
34842,5408,79695,1046,49102,215601,30593
8358,1228,34009,1478,23292,216067,10717
60669,45,587,441,453,7757,134
50236,12,170,763,130,2523,40
59303,82,947,490,811,21436,136
55552,401,6081,602,4937,41050,1144
47320,59,765,830,581,9991,184
10412,12,219,1467,135,5091,84
69529,8,256,169,179,6514,77
67133,2,19,248,16,2770,3
48838,8,293,802,208,2625,85
29874,76,1816,1138,1155,70786,661
58233,61,801,525,694,18926,107
64,16,1003,1566,649,18871,354
3790,1054,34411,1532,23637,177498,10774
62660,15,158,376,129,11577,29
65049,2,36,307,24,4071,12
23003,33,559,1280,425,20311,134
59955,0,42,468,33,1890,9
17407,34,1736,1376,1278,30237,458
49968,9,131,770,105,4392,26
12907,26,1493,1443,721,18434,772
8507,651,10664,1477,7146,44125,3518
14047,28,1360,1426,844,10148,516
5072,1281,84603,1516,40557,198382,44046
12403,56,2091,1449,1248,12697,843
37880,34,595,968,516,12080,79
65942,34,290,286,242,3546,48
40403,15,203,923,166,6328,37
32857,72,1114,1086,913,18835,201
34054,59,1384,1063,911,8337,473
38463,13,294,952,266,11996,28
19000,0,0,1347,0,6277,0
36870,58,1768,996,1354,50233,414
11347,31,1051,1460,619,14213,432
29668,48,2026,1143,1213,49722,813
32891,77,1004,1086,686,10557,318
25969,385,7856,1218,5179,44346,2677
3109,3,93,1539,73,9386,20
444,69,2201,1561,1556,49841,645
65958,5,49,285,42,3869,7
36422,8,160,1006,137,6741,23
57809,5,22,539,19,3728,3
41846,34,560,900,434,7835,126
55483,1,97,604,67,3691,30
7696,2408,39502,1483,22966,154319,16536
40494,535,9895,922,7294,49082,2601
51836,29,297,721,265,10441,32
22713,106,2615,1285,1845,23129,770
60963,1394,13129,430,9837,38194,3292
61040,147,1613,428,1241,18196,372
37001,21,318,992,279,8593,39
69872,8,171,158,152,3366,19
66808,3,40,259,29,2778,11
62416,247,3676,383,3115,33441,561
7060,67,1432,1491,1035,21645,397
34817,118,1836,1046,1420,26199,416
43513,8,257,874,218,12703,39
32082,9,210,1099,139,4439,71
14037,87596,4580251,1426,2390793,8525460,2189458
54104,45,398,648,322,7345,76
30981,9,487,1116,283,10711,204
21127,111,2902,1309,2043,25728,859
64884,15,239,313,207,2982,32
32528,23,600,1092,441,13156,159
65906,6,63,287,47,5677,16
4994,935,67419,1517,40413,236212,27006
29835,10,436,1139,233,4159,203
12948,60,1592,1442,908,21132,684
11941,15717,428450,1454,283318,1365299,145132
21515,14,1447,1302,948,17109,499
47579,13,150,827,116,5297,34
19738,38,603,1334,499,21201,104
20911,1942,53014,1313,37805,400659,15209
4872,5,144,1519,91,4351,53
69862,17,171,158,141,8792,30
21296,5,147,1306,106,5652,41
62351,1,28,385,14,5120,14
65590,7,101,295,83,7694,18
33666,17,586,1071,368,9519,218
28181,40,632,1171,492,13405,140
48859,3,63,802,47,3321,16
9920,138,3121,1470,1995,22148,1126
16388,14,692,1392,415,10223,277
61186,19,276,422,193,11805,83
46867,5,74,836,66,8414,8
55296,10,130,609,100,9778,30
9711,40,763,1471,493,10910,270
43071,118,1604,880,1375,18044,229
11543,3454,140963,1458,80285,504169,60678
61730,55,473,405,399,8040,74
32616,9,658,1091,510,35677,148
30828,7,304,1119,179,3958,125
28806,82,1497,1159,1177,31193,320
20840,403,10103,1315,6562,44178,3541
19541,139,3085,1337,2195,36111,890
1918,18,575,1550,410,20684,165
64515,111,853,323,729,10756,124
48843,36,563,802,395,12485,168
30408,2777,58840,1127,33358,180981,25482
62622,28,142,377,114,4921,28
14224,21,783,1424,576,10992,207
3887,3,204,1531,129,13842,75
5607,65,2882,1510,2112,33770,770
43153,238,2185,879,1713,14402,472
35894,7,409,1021,276,9231,133
63606,27,656,352,382,8857,274
54276,109,1207,643,962,15850,245
58175,7,64,528,52,4926,12
59292,805,13430,490,9469,71265,3961
57721,203,4265,542,3344,39151,921
55516,2,17,603,15,5713,2
47831,157,3929,824,3365,36416,564
53269,9,161,674,123,7500,38
62920,24,362,369,278,5345,84
51969,859,9515,717,7875,56983,1640
28793,1225,31563,1159,22905,210585,8658
24933,1673,39589,1240,28987,173789,10602
2977,35,996,1540,704,50581,292
61038,6,78,428,56,2152,22
12937,660,17507,1442,8914,47030,8593
58856,22,246,505,198,7787,48
35250,42,534,1036,393,17842,141
51918,39,677,719,426,6112,251
66865,41,433,257,380,6932,53
2580,193,5155,1544,3819,26695,1336
51158,22,426,739,323,30104,103
36940,48,918,994,730,16032,188
56560,5,86,573,76,9703,10
236,85,5037,1563,3752,55380,1285
20591,32,1427,1319,888,9651,539
4219,84,2017,1528,1615,33705,402
28112,15,372,1172,229,14719,143
28127,160,7604,1171,4814,45204,2790
50212,49,597,764,521,9422,76
70538,2,40,136,37,4127,3
42249,14,269,894,192,8993,77
32615,326,8243,1091,6223,72789,2020
41999,17,144,897,117,3442,27
38955,57,738,935,585,20663,153
51309,4,79,736,64,3508,15
461,348,9447,1561,6424,126128,3023
40400,5941,70272,923,47931,203059,22341
69314,37,569,176,498,5882,71
65790,16,281,290,218,2977,63
8237,5,413,1478,278,21065,135
53483,2,63,669,55,4482,8
38386,10119,244056,954,179026,948089,65030
56894,2006,22730,564,11783,459034,10947
15830,45,1280,1402,901,19371,379
43173,433,5853,878,4591,78735,1262
7177,34,1861,1489,1026,12599,835
19977,84,1260,1329,907,11710,353
17833,18,646,1367,477,12974,169
12926,5,602,1443,279,25096,323
29831,4077,71276,1139,46023,345122,25253
44154,110,2921,867,2493,34452,428
40465,56,761,922,587,12307,174
7533,47,3199,1485,1865,68960,1334
35570,15,249,1028,184,5262,65
16478,127,2562,1391,1707,31678,855
59335,929,28890,489,24509,107281,4381
62104,33,472,392,368,12337,104
23188,39,834,1276,374,12535,460
18265,2,84,1360,62,7886,22
16780,29,1230,1386,846,24755,384
5801,37,1158,1507,775,14547,383
12909,103,3173,1443,1818,29622,1355
32692,3,240,1090,136,5835,104
15121,72,3632,1412,2295,35871,1337
23626,3327,79093,1269,49092,427918,30001
23157,35,2315,1277,1382,16254,933
45520,171,2792,852,2233,15603,559
31447,189,4914,1109,3194,35892,1720
54439,18,134,637,108,6436,26
33382,51,776,1077,580,17012,196
67672,10,147,231,122,2994,25
66113,765,9792,281,7953,50897,1839
20060,8,564,1328,444,24712,120
26166,223,2728,1215,1773,21387,955
50914,992,15970,746,13202,121881,2768
34455,199,4576,1055,3127,22074,1449
49137,152,2037,793,1771,19250,266
1994,3030,68938,1549,47890,333805,21048
20025,4,166,1329,113,4756,53
10994,94,2637,1463,1673,32486,964
68809,26,409,193,400,14639,9
29899,71,1744,1137,1118,16814,626
66683,18,157,263,122,3945,35
18177,16,499,1361,379,12207,120
23782,13,91,1266,75,5012,16
8758,192,4630,1476,2607,27855,2023
46389,58,819,843,641,9233,178
16644,145,7030,1389,4140,18451,2890
15668,33,2024,1404,1328,16677,696
51972,182,2204,715,1744,30154,460
68672,138,2137,197,1858,18357,279
55380,80,737,607,626,11855,111
30253,158,3752,1130,2876,62941,876
64338,7,115,329,92,6153,23
28301,629,13427,1168,8092,71175,5335
21813,39,1079,1298,755,24424,324
15941,22,797,1400,557,8803,240
32093,25,557,1099,387,26162,170
21312,47,1144,1306,732,31279,412
64299,14,172,330,144,7754,28
55864,2,36,594,23,2906,13
37453,53,1149,979,821,43269,328
169,22,775,1564,519,6681,256
21538,15,391,1302,275,13652,116
28103,308,5971,1172,4492,52951,1479
34067,159,2713,1063,1965,37586,748
57038,37,695,560,543,11880,152
34147,10365,214998,1062,143230,776693,71768
23919,240,8560,1263,6105,69708,2455
51774,53,690,722,590,10519,100
26767,63,2527,1201,1435,44888,1092
12248,49,1896,1451,1155,20690,741
14642,3576,113087,1418,76079,604712,37008
41440,32,263,907,205,4876,58
27978,14,297,1174,250,11521,47
8189,44,1174,1478,779,25690,395
33832,273,6134,1068,4652,104384,1482
54675,16,143,628,133,6424,10
49493,26,394,783,268,4279,126
60368,75,842,453,689,5312,153
7464,72,3227,1486,2342,63017,885
64542,0,4,324,4,1362,0
32645,106,2400,1090,1758,29558,642
67865,13,132,224,113,1910,19
65662,15,294,293,224,9763,70
60839,17,154,435,128,2306,26
56181,11,133,584,79,5298,54
34706,4,84,1048,53,4963,31
58523,342,5337,515,3901,70255,1436
57790,49,670,540,565,10902,105
25698,823,27865,1224,15739,124661,12126
47272,69,660,831,514,10153,146
21104,25,1287,1309,984,18564,303
67334,6,192,241,144,6115,48
10951,19,634,1463,426,14386,208
55001,14,124,617,117,8983,7
30738,38,823,1121,718,37725,105
28084,5,145,1172,68,6574,77
11399,57,5694,1459,2876,18058,2818
65141,518,6718,304,5876,47025,842
59373,149,4071,488,3289,14895,782
37408,102,1986,980,1493,15500,493
30770,1591,59264,1120,38603,355539,20661
21340,10,744,1305,498,38056,246
42875,142,1330,883,1153,17177,177
53330,292,3013,673,2304,24895,709
10279,9,451,1468,275,6770,176
44613,83,686,863,542,8555,144
12465,52,1916,1448,950,23448,966
13065,14,496,1440,299,25722,197
8247,61,1613,1478,1068,22815,545
61231,1781,31733,420,25032,169533,6701
64823,10,124,315,89,5790,35
18415,40,816,1357,600,7565,216
67157,3,83,247,53,2831,30
26645,5,256,1203,164,8283,92
46518,9547,265859,841,195792,559437,70067
6264,11,736,1502,521,21868,215
30697,491,9701,1121,7094,43829,2607
28942,33,1485,1156,1040,27440,445
54401,97,702,639,541,10510,161
60824,2,99,436,76,5763,23
4735,978,40339,1520,23384,170932,16955
54640,36,471,629,432,11746,39
5676,19,1427,1509,998,20201,429
10428,314,5894,1467,4059,35223,1835
59848,88,1188,469,1003,11703,185
66755,61,468,261,406,10824,62
17146,36,906,1380,696,21816,210
24064,0,19,1260,11,4322,8
62402,12,122,383,90,7351,32
37249,23,450,984,265,13144,185
49191,47,762,791,669,22524,93
30474,4,211,1126,183,11948,28
56299,2,78,581,63,6714,15
21927,10,805,1296,498,14811,307
12251,95,3337,1451,2009,41176,1328
14257,38,7604,1423,5184,39269,2420
7540,140,4153,1485,2894,28532,1259
10133,7,216,1469,132,20506,84
60686,22,217,441,133,18780,84
24703,14,1187,1245,762,33995,425
31373,146,3203,1110,2826,39213,377
28236,726,21096,1169,13930,130208,7166
14736,3,95,1417,68,9057,27
54081,56,600,650,448,12216,152
37526,168,2427,977,1900,40167,527
50501,3389,141096,750,111613,637746,29483
64388,350,6752,327,5559,52270,1193
67162,22,285,247,252,6340,33
69197,3,25,180,20,593,5
12595,1585,68307,1447,39214,394499,29093
5388,15707,588495,1512,360328,1216879,228167
63104,2,62,365,38,3670,24
21096,11,604,1310,444,10743,160
28269,69,1164,1169,763,22562,401
53626,71,987,665,758,32032,229
51873,8,108,720,66,6858,42
12579,8,1065,1447,551,29830,514
55095,98,1207,615,1052,16799,155
43273,30,457,877,361,14339,96
51196,5,111,738,86,5739,25
32054,27,920,1100,607,6463,313
61173,14,137,423,133,7731,4
11000,12,142,1462,97,10494,45
6859,109,5231,1494,2708,30956,2523
48492,54,894,813,737,20740,157
210,1184,36752,1564,17351,74809,19401
9512,41,2202,1472,1427,24743,775
36557,5,81,999,62,6161,19
19901,6,215,1331,168,11950,47
1731,1999,47189,1551,30196,117342,16993
52886,91,920,685,728,13407,192
28123,20,662,1172,413,10736,249
13009,19,866,1441,526,31391,340
59473,83,743,484,567,6495,176
15753,24,934,1403,572,20301,362
56780,15,303,567,248,4449,55
39612,8,374,935,274,11425,100
50943,44,567,746,434,9223,133
21123,3533,147385,1309,109958,820846,37427
57530,2495,47080,548,36654,293952,10426
23821,10,328,1265,238,8005,90
506,11,349,1561,244,15265,105
731,4,251,1558,172,20089,79
34540,4,108,1054,62,5633,46
16503,6,754,1391,447,8202,307
20500,12,256,1321,196,10595,60
37981,6385,89099,965,62723,438393,26376
35936,43,737,1020,524,11922,213
17719,9,261,1370,217,12165,44
32024,58,974,1099,724,32944,250
16039,158,3982,1398,2942,57216,1040
8362,41,1129,1477,735,23639,394
43971,1401,35232,870,25097,210273,10135
20995,26,1250,1312,884,16658,366
28326,106,2368,1167,1418,30863,950
55453,2,31,605,25,2411,6
69280,46,749,177,685,10302,64
7049,13,396,1492,237,16731,159
24797,3,91,1244,77,6109,14
68724,4,45,196,25,2580,20
51635,233,2761,726,2307,21372,454
22618,428,11297,1286,8313,59349,2984
56763,14,269,567,220,10858,49
9219,32,966,1474,546,12154,420
20243,19,654,1325,419,16667,235
55873,5,40,594,30,3180,10
2708,24,892,1543,616,19533,276
60013,38,569,466,409,6334,160
18119,6,419,1362,298,17841,121
59420,37,403,486,336,7098,67
56368,537,7923,579,6891,90113,1032
70098,87,1428,151,1271,20622,157
4018,97,3411,1530,2523,43418,888
1771,93,6478,1551,3740,25026,2738
7337,299,23299,1488,13978,76159,9321
8859,1359,57001,1475,32436,316423,24565
1285,19,823,1554,560,10391,263
27950,12,237,1175,175,5708,62
37273,7,140,984,102,8421,38
31051,33,480,1115,300,5795,180
12471,23,1400,1448,799,14267,601
33768,1020,20071,1069,12844,113145,7227
19972,105,2360,1330,1720,37370,640
18233,88,5763,1360,2525,62202,3238
7201,275,14606,1489,8210,99340,6396
125,4,189,1565,121,5309,68
22246,333,9402,1292,6716,104707,2686
13671,33,1118,1432,657,7066,461
67852,134,3928,225,2951,27677,977
56436,62,817,577,498,8199,319
19774,18,315,1333,219,11358,96
31075,222,9506,1114,6360,95899,3146
1754,12221,576437,1551,342891,1820805,233546
69813,35,484,159,471,9853,13
10631,356,14715,1465,8312,76441,6403
1341,1,213,1554,110,4102,103
66740,9,127,261,88,4563,39
40269,354,6228,925,4645,49353,1583
13864,237,7993,1429,5577,46217,2416
13597,33,1591,1433,839,14368,752
8965,31,1427,1475,929,30363,498
43409,249,3896,876,2935,24914,961
39789,450,6864,933,5283,32126,1581
2810,2690,64454,1542,46583,133054,17871
56826,410,3958,566,3240,44894,718
31605,21,794,1107,518,12047,276
20377,8,494,1323,382,12081,112
35672,4,183,1026,101,4589,82
10490,2,194,1466,126,12051,68
58386,6,116,520,96,3617,20
58135,11,198,529,125,3522,73
30036,18,353,1134,274,12499,79
4663,166,3732,1521,2562,30281,1170
25804,138,2747,1222,1811,25777,936
62741,27,429,373,335,9868,94
40835,18,279,916,242,9635,37
36049,952,11115,1016,8989,85718,2126
26108,273,6045,1215,3977,30095,2068
2980,30,731,1540,551,8666,180
16043,233,4294,1398,3451,87632,843
56412,119,1344,578,1146,13071,198
22751,89,1759,1284,1354,15255,405
32847,1278,30519,1086,21284,137828,9235
48869,3088,59210,801,44908,199038,14302
36544,28,537,1002,387,13200,150
17295,28,560,1377,414,20519,146
6535,355,9514,1498,6663,145339,2851
20812,1516,73537,1315,43624,243988,29913
25160,19,532,1236,343,11728,189
30850,84,1987,1118,1320,16614,667
18552,52,1277,1355,916,15035,361
26203,51,640,1214,387,7956,253
6274,2,63,1502,47,5767,16
50282,147,1667,762,1329,24322,338
15884,1101,20943,1401,13747,74462,7196
35474,13473,439352,1030,250436,2145495,188916
5705,1533,35674,1509,21514,102689,14160
38009,1118,16912,964,14068,109521,2844
60258,92,1663,457,1170,19177,493
16152,2,134,1396,89,24572,45
60198,19,490,459,391,13919,99
13008,89,2116,1441,1335,18314,781
11598,7,864,1458,459,17553,405
14733,152,3929,1417,2640,32038,1289
32433,715,16807,1094,11063,192109,5744
486,19,736,1561,515,19658,221
14329,59,1441,1422,1028,24650,413
29279,38,789,1149,557,14558,232
4192,867,29404,1528,14834,218539,14570
6272,232,24108,1502,12938,84079,11170
67206,10,74,245,57,2815,17
2778,5,247,1543,147,18693,100
68505,6,77,204,61,3247,16
28454,403,10582,1165,6712,67729,3870
3704,29,938,1533,667,14581,271
20387,7,246,1323,176,6751,70
55978,71,868,591,726,14109,142
4895,169,15393,1518,9219,63063,6174
51335,172,2537,735,2029,19152,508
70228,51,655,146,620,5764,35
1184,29,1396,1555,927,15581,469
68456,83,1309,205,1037,22600,272
55977,6,159,591,110,6517,49
32245,225,3294,1097,2447,30924,847
221,37,1709,1563,1294,33659,415
17385,83,2378,1376,1904,22749,474
58087,36,528,530,451,8832,77
18061,4,225,1363,142,7790,83
3507,397,10544,1535,7173,52489,3371
19173,675,18889,1344,13023,208413,5866
62742,20,261,374,210,5430,51
4063,25,1415,1529,978,14852,437
34285,15,435,1058,315,10212,120
17853,58,2099,1367,1681,61514,418
18660,28,646,1353,475,11654,171
19987,16,567,1329,431,49608,136
8278,35,1278,1478,751,10669,527
49607,22,321,780,227,15431,94
41431,22,349,907,270,12536,79
14213,180,3440,1424,2473,42102,967
55776,99,1809,596,1557,17349,252
4217,1425,65213,1528,39426,230806,25787
48601,312,4160,809,3308,31763,852
29187,18,924,1151,495,16590,429
61944,45,546,398,436,16211,110
24392,110,5561,1253,3517,72964,2044
31071,8,148,1114,97,4853,51
63893,10,141,343,123,3963,18
41710,21,471,902,372,17319,99
69484,37,273,171,251,8369,22
69627,28,217,166,204,10089,13
51344,84,1120,734,909,12994,211
25665,57,1522,1225,899,12767,623
34684,26,660,1049,430,34411,230
19737,1,68,1334,48,4305,20
69501,174,4783,161,4424,18462,359
22517,2349,34580,1288,23251,83237,11329
2119,808,21930,1548,13245,833446,8685
49396,21,812,785,642,24149,170
39964,3172,49903,930,37455,357364,12448
19322,0,0,1341,0,7777,0
45725,46,550,850,455,10491,95
28198,6,172,1170,141,8469,31
65852,135,2950,288,2425,21845,525
18207,59,1217,1361,953,22295,264
10912,116,5542,1463,3440,123591,2102
61733,204,1983,405,1502,16106,481
46687,41,561,838,456,8378,105
56625,96,1131,572,894,18317,237
485,3,159,1561,99,9064,60
56413,36,361,578,273,8482,88
66930,154,4453,255,3462,28836,991
13940,186,5956,1428,4026,55459,1930
26906,159,3036,1198,1879,51290,1157
53437,19,187,670,148,4805,39
27520,68,1693,1184,1110,17872,583
53512,12,133,669,111,6901,22
26968,81,3515,1196,2202,22022,1313
67332,10,79,242,66,5402,13
54119,27,398,649,295,11061,103
51104,101,2395,741,1819,35208,576
60041,25,256,465,184,10159,72
50226,59,873,764,682,16865,191
27495,43,955,1185,596,6521,359
37661,56,671,973,477,6979,194
53969,74,1449,654,1206,17140,243
38439,34,1059,953,839,22517,220
65383,163,2420,299,1876,22524,544
67616,10,192,233,166,5909,26
20701,221,7363,1317,5117,121471,2246
51533,85,1000,729,790,14595,210
56499,78,1687,575,1038,14687,649
4210,595,21569,1528,13858,155950,7711
13119,1,83,1440,51,7777,32
27501,221,4312,1184,2625,34608,1687
11500,114,11058,1459,6573,67172,4485
70005,37,502,153,440,9971,62
7530,20,664,1485,416,12740,248
58410,7,117,520,67,3822,50
65160,4,55,305,39,3965,16
11295,105,5176,1460,3199,39378,1977
62169,24,266,390,224,6810,42
53794,24,185,660,141,9237,44
63493,15,264,355,234,6493,30
53926,150,1776,656,1577,17987,199
65992,9,69,284,52,3069,17
59497,5,70,483,63,4556,7
6683,125,2184,1496,1371,17700,813
68948,99,1655,188,1295,13464,360
56887,1,7,564,7,1459,0
19912,92,1577,1331,1313,34837,264
14751,296,10060,1417,6743,98243,3317
48065,26,239,821,207,8505,32
49617,909,12528,780,10115,59880,2413
50240,277,4727,763,3927,41674,800
28449,65,1784,1166,1225,34660,559
58061,772,20737,531,15172,52977,5565
2652,4,164,1544,115,33999,49
30442,25,1909,1126,1086,15871,823
3578,21,578,1535,377,30513,201
62199,13,235,389,149,8039,86
142,11,732,1565,515,17539,217
41717,19,640,902,474,11960,166
27843,40,2065,1177,1234,28802,831
56341,0,24,580,17,2855,7
32366,9,421,1095,282,6516,139
33697,124,3738,1070,2489,22153,1249
52350,695,18500,704,14552,90566,3948
50673,2,47,753,36,2792,11
34818,6,176,1046,124,4824,52
6360,5,134,1501,91,5864,43
8050,27,726,1479,484,9519,242
5510,342,10581,1511,7149,79348,3432
5403,8,199,1512,145,10137,54
69064,3,38,184,25,4057,13
18271,11,470,1360,351,13818,119
58776,92,1280,507,790,16347,490
52006,332,4623,716,3786,26814,837
38648,32,867,947,640,18136,227
55789,26,232,595,187,7508,45
70381,12,82,141,76,5154,6
13622,6,311,1433,175,11404,136
60061,138,1672,464,1370,17377,302
32316,3,91,1096,54,6913,37
6964,0,102,1493,66,14193,36
26638,344,7464,1203,4909,54649,2555
7260,63,2180,1488,1448,17252,732
11226,20,1289,1461,627,18780,662
9926,72,4361,1470,2818,92697,1543
8249,22,1288,1478,842,22233,446
30956,17,756,1117,460,6584,296
59797,38,1036,473,731,5964,305
57217,6,34,556,28,1864,6
30971,13682,414064,1116,304557,736928,109507
30229,5,156,1131,108,3812,48
65444,23,440,298,375,13116,65
6311,958,30292,1502,19706,160518,10586
67360,74,788,241,638,11603,150
6014,75,4296,1505,2976,28256,1320
9240,84,1987,1474,1189,21853,798
29856,2,111,1138,56,4585,55
29394,67,3253,1147,1831,17575,1422
48395,81,1988,816,1691,39843,297
48099,53,1661,821,1238,19343,423
12681,7,1185,1446,623,10812,562
60776,6,52,435,42,2831,10
53609,92,1078,666,925,24856,153
22325,135,5717,1291,3809,51969,1908
29085,3747,76111,1153,48897,509873,27214
40740,444,7193,918,5800,92969,1393
5782,35,1726,1508,1140,10093,586
1878,960,31119,1550,23353,62487,7766
37593,83,2020,975,1821,16965,199
41275,88,1938,909,1574,22500,364
23497,0,0,1271,0,22585,0
25963,721,12754,1219,8578,116606,4176
68708,27,443,196,340,7574,103
63474,42,402,355,308,4316,94
21681,196,13641,1300,8404,105149,5237
3761,0,813,1533,479,11882,334
43133,0,0,879,0,13763,0
36796,33,944,998,764,12358,180
22671,11,531,1285,360,6163,171
70068,2,22,151,20,1976,2
70465,4,64,138,52,2019,12
37839,47,631,969,468,12453,163
52258,607,7410,707,6129,52215,1281
19927,34,1693,1330,1168,22255,525
13694,8,306,1432,174,13682,132
22874,643,19770,1282,13000,58067,6770
58042,7,102,532,83,4671,19
5500,29,685,1511,441,19663,244
2092,607,24299,1548,15991,138548,8308
59836,33,390,472,344,9085,46
10422,20,1017,1467,617,24881,400
65187,48,636,304,500,11421,136
41784,2011,37161,901,22662,200503,14499
67626,19,175,232,156,7158,19
63649,33,691,351,560,7649,131
57925,132,5399,536,1137,29288,4262
6801,29,601,1495,407,15740,194
56266,16,251,582,211,3462,40
35340,44,875,1033,675,16278,200
37735,10,125,971,106,4877,19
2505,76,3003,1545,1905,42580,1098
35845,89,3483,1022,2418,32532,1065
65465,7,144,298,137,2785,7
64154,269,4692,334,3079,34870,1613
22824,2,52,1283,45,3995,7
3946,35,1107,1531,793,13427,314
55921,596,6262,592,4563,146714,1699
68071,27,464,218,340,13072,124
2091,15,675,1548,445,22318,230
37566,25,490,975,405,18236,85
34107,499,18599,1062,11743,46028,6856
32053,43,794,1100,493,6809,301
33404,19,272,1076,216,6680,56
19632,234,5411,1336,4205,64894,1206
18345,583,12876,1358,8871,133791,4005
69182,13,159,180,135,7994,24
21080,169,3549,1310,2401,30983,1148
59596,123,1123,480,869,13913,254
19053,54,1075,1346,795,24934,280
29216,39,972,1151,658,44453,314
28845,39,1384,1158,915,10515,469
62218,81,1732,389,1432,20650,300
20459,12,1265,1321,863,8357,402
16641,7,179,1389,141,9917,38
36783,32,288,998,221,6490,67
52679,26,333,692,199,10261,134
58805,59,531,507,464,9445,67
26412,540,31704,1209,19486,145989,12218
49806,64,716,774,582,13642,134
25703,136,3861,1224,2343,26862,1518
34501,6,56,1054,38,2094,18
54819,308,12041,623,6178,41228,5863
9586,37,418,1472,227,9570,191
51946,58,873,718,800,13493,73
50344,5,77,761,65,2856,12
16196,42,916,1396,684,22694,232
41612,9013,130776,904,107277,662703,23499
40720,35,542,919,452,6499,90
38856,69,1229,944,1001,19481,228
49694,96,1301,777,981,11099,320
88,2040,88320,1565,49182,396772,39138
63212,41,530,362,421,7325,109
25319,113,3675,1232,2614,74827,1061
58293,6,49,523,40,3937,9
66058,8,139,282,120,10507,19
68545,11,111,202,92,5578,19
48905,0,25,800,21,2003,4
45,768,24815,1566,14857,369950,9958
14414,166,2400,1421,1711,27871,689
53014,260,3249,681,2362,20521,887
49868,46,626,773,499,6111,127
62080,16,197,393,151,7575,46
728,5,433,1559,238,24486,195
15637,51,1689,1405,1079,22035,610
8279,65,2844,1478,2045,30383,799
8430,550,10225,1477,6305,40256,3920
25559,5,322,1228,215,8190,107
64048,89,896,329,705,16035,191
67177,3,78,246,65,5632,13
510,31,892,1560,680,21913,212
2009,1405,131288,1549,79563,406468,51725
44177,2,75,867,62,6256,13
5582,4,152,1510,109,7222,43
63506,42,454,354,349,8013,105
69777,11,140,161,124,3458,16
15577,356,10411,1406,6069,38417,4342
22823,101,2150,1283,1259,13802,891
34663,11,350,1050,236,6477,114
5724,354,13081,1508,8644,58592,4437
36964,62,2502,993,1663,36601,839
38561,22,430,949,328,13566,102
1466,127,3317,1553,2361,20948,956
47300,109,2407,831,1756,26557,651
46025,64,788,847,639,9449,149
54296,140,2020,643,1635,52218,385
57515,40,446,549,339,8286,107
58160,52,574,528,471,5360,103
20215,64,1611,1325,1201,41047,410
8974,32,844,1475,531,8749,313
61258,3,62,419,46,3189,16
16298,55,1039,1394,770,34447,269
30262,22,527,1130,370,6072,157
23649,181,6265,1269,4453,107337,1812
11853,7,582,1455,227,8191,355
63681,59,1176,350,955,11601,221
22525,60,3028,1288,2159,57922,869
661,373,17870,1559,11113,199857,6757
41815,61,1420,900,1053,15388,367
18094,27,633,1363,452,8924,181
25418,69,1895,1231,1266,22513,629
25008,1383,38298,1239,22697,237302,15601
9563,356,11394,1472,7019,55075,4375
15819,40,1282,1402,917,38246,365
28215,35,1036,1170,662,18726,374
4544,12,352,1523,239,11123,113
52160,40,444,710,343,35796,101
33225,4,121,1079,74,3861,47
20245,6,666,1325,462,22815,204
35727,67,1023,1025,747,18976,276
22170,0,0,1293,0,743,0
18847,7,311,1349,221,17337,90
15931,27,1227,1400,911,54629,316
52077,265,3321,713,2843,53068,478
2232,67,1219,1547,800,16392,419
35428,569,6311,1031,5364,39235,947
34739,69,911,1048,644,15664,267
22154,3,135,1293,105,10655,30
16690,35,823,1388,606,42064,217
9547,10,663,1472,420,12536,243
10859,21,848,1464,475,7294,373
59774,1785,51560,471,38042,157759,13518
62188,545,13228,389,8576,30632,4652
24050,96,2926,1260,1838,13860,1088
2134,7,329,1548,242,19259,87
19115,27,1073,1345,683,26859,390
60933,33,440,431,316,5629,124
54179,19,205,647,141,7545,64
63208,24,225,362,183,7256,42
23268,10,322,1275,247,9518,75
21403,13,333,1304,251,13559,82
19052,67,2403,1346,1954,35677,449
43609,4296,77605,873,56995,569814,20610
2899,74,1522,1541,1157,47834,365
38829,14090,316666,944,216229,1001865,100437
22427,40,761,1290,667,15255,94
14086,14,508,1426,319,12120,189
30594,447,15385,1123,9578,90869,5807
27435,24,943,1186,670,11523,273
13723,117,5817,1431,3406,61195,2411
14670,3868,149024,1418,99729,696877,49295
7897,9202,913300,1480,432282,2018492,481018
18985,75,4005,1347,2874,23557,1131
16328,0,73,1394,47,6682,26
63764,153,1906,348,1596,11070,310
23147,56,1824,1277,1170,41160,654
17454,79,1350,1375,1007,18391,343
17621,12,485,1371,403,11031,82
41556,33,846,905,605,19028,241
68771,39,477,194,427,7085,50
33244,61,1790,1079,1205,21861,585
49411,30,311,785,200,5614,111
60118,1060,27720,462,21913,152731,5807
23934,113,6295,1263,3909,44127,2386
12059,14,760,1453,375,20618,385
22586,124,3561,1287,2417,50915,1144
65061,985,16945,301,13737,97567,3208
60759,22,392,438,261,8814,131
44224,45,852,866,625,9559,227
5944,73,1075,1506,739,13762,336
56652,191,2398,571,1889,26572,509
16102,9,499,1397,324,12452,175
1223,39,1360,1555,849,39340,511
59638,31,447,479,374,5790,73
7807,1875,78310,1481,46271,575659,32039
35663,134,3737,1026,2728,23460,1009
5138,473,27724,1515,17303,152494,10421
24275,4,109,1256,89,11646,20
50390,631,8206,760,6999,57382,1207
58404,8,85,520,59,6086,26
2743,42,1139,1543,778,40680,361
19016,75,1980,1347,1453,56255,527
64439,170,1910,326,1625,10816,285
8368,18,639,1477,420,8812,219
63281,15,184,361,143,7967,41
36092,11,487,1015,424,12475,63
14713,1871,65995,1417,40638,187376,25357
12429,123,4698,1449,3091,50960,1607
65183,7,69,304,62,5501,7
32385,3,166,1095,111,11435,55
2661,7,391,1544,275,19011,116
65388,123,2249,299,1780,18239,469
64097,417,8359,336,6643,52111,1716
65111,2,25,306,16,5002,9
47311,74,2300,830,2053,14239,247
65637,14,200,294,142,2841,58
5695,6263,204522,1509,120853,652283,83669
11224,3,168,1461,128,8169,40
34284,10,324,1059,219,7557,105
58500,244,2677,516,2054,13607,623
15839,8,168,1402,114,5558,54
62076,107,1718,393,1397,25926,321
3851,65,2337,1532,1653,32617,684
14066,355,8602,1426,5564,81463,3038
50342,140,2450,760,2036,19473,414
26782,92,3420,1200,2292,85849,1128
632,28,2159,1559,1546,15495,613
3317,80,4164,1537,2529,19644,1635
12394,177,1697,1449,1069,25020,628
23974,1444,29954,1262,20414,156161,9540
66299,837,10124,275,7890,71694,2234
28349,4,189,1167,119,5817,70
55593,117,1523,601,1058,13172,465
22755,73,1052,1284,815,29594,237
32821,1076,13876,1087,9975,63330,3901
2997,24,919,1540,613,19310,306
58001,172,3763,533,2712,23326,1051
61347,57,1682,417,857,23681,825
32784,0,35,1088,25,3222,10
25711,5,238,1224,131,14517,107
63768,11,86,347,62,1301,24
63348,21,366,359,304,10591,62
23028,18,656,1279,462,11239,194
34821,77,2423,1046,1637,25133,786
23885,33,619,1264,407,13364,212
39788,63,826,933,678,7214,148
19442,14,678,1339,544,20711,134
10114,18,879,1469,561,8097,318
61943,7,47,398,38,3069,9
4957,33,1729,1517,1138,28388,591
33662,21,320,1071,278,11939,42
66902,35,775,256,596,6294,179
61742,13,187,405,146,3032,41
1429,120,4276,1553,2921,96038,1355
51729,30,237,724,188,4909,49
42710,69,1227,886,933,11781,294
56064,134,2617,588,2227,25810,390
51129,115,1159,740,888,17810,271
33824,53,1143,1068,771,9917,372
1186,16,440,1555,332,21657,108
29106,72,1418,1153,915,34253,503
54358,63,597,641,524,19704,73
12662,3,336,1446,163,11969,173
9390,43,1119,1473,695,15229,424
39362,20,365,938,301,6190,64
18762,125,6546,1351,4355,46363,2191
64790,245,4297,316,3852,18014,445
45445,41,715,853,548,18278,167
32065,236,7150,1100,5262,26603,1888
427,146,17893,1561,12255,184595,5638
64960,21,413,310,310,9553,103
36804,338,5849,998,4496,70921,1353
35174,950,16632,1037,10769,234736,5863
65579,120,1589,295,1334,14348,255
38074,13,359,961,324,14384,35
529,18,1087,1560,721,8069,366
21204,48,1709,1308,1241,22543,468
36033,2061,43268,1017,33771,187857,9497
58722,22,217,509,159,6312,58
4141,11595,439090,1529,243796,1266700,195294
13708,4,377,1431,231,14065,146
69466,127,2040,171,1835,20439,205
41959,165,2635,898,2151,23455,484
38967,6,108,943,82,4371,26
3049,64,1405,1540,824,18146,581
50960,134,2522,745,1934,29318,588
31167,1162,14746,1113,9905,70557,4841
42762,47,549,885,438,8163,111
25028,126,2309,1238,1771,47973,538
1799,57,1387,1551,1008,13885,379
9245,78,2240,1474,1449,23687,791
11474,66,3670,1459,2096,30985,1574
26949,167,3067,1196,1916,31292,1151
49404,25,383,785,343,12419,40
63454,248,6001,355,2540,28070,3461
62021,14,325,395,252,5146,73
29485,68,1280,1146,1170,14924,110
63666,6,80,350,58,3093,22
60848,12,202,435,165,2498,37
31569,38,600,1107,401,8882,199
12082,375,16396,1453,8733,110776,7663
12670,560,21068,1446,11869,90005,9199
67535,6,103,235,77,4260,26
53495,108,1164,669,883,11908,281
8033,17,640,1479,392,8448,248
11376,19,734,1460,418,15620,316
25562,395,6569,1228,4489,46491,2080
4307,10747,393675,1527,233348,1405885,160327
3469,34,764,1536,602,18235,162
50920,164,2900,746,2011,28235,889
29918,7,245,1137,181,10399,64
20001,308,13921,1329,10467,128786,3454
28846,209,2580,1158,2213,29922,367
28921,413,10171,1156,6218,57626,3953
55933,61,953,592,680,12753,273
44486,55,499,864,426,14653,73
1521,49,840,1553,582,14676,258
21319,13,5252,1306,4191,32104,1061
55930,34,593,592,450,11029,143
39690,12,362,934,279,21670,83
33098,43,722,1082,506,8782,216
22696,175,7908,1285,5446,32832,2462
27797,51,1067,1178,710,17097,357
21868,3,74,1297,60,9682,14
40945,2,56,914,36,3588,20
14498,3,167,1420,122,7907,45
70547,573,13357,135,13279,118555,78
11499,28,1272,1459,773,34145,499
56206,76,935,584,737,10296,198
64747,21,326,317,212,10662,114
36800,39,533,998,399,7159,134
18575,4110,109917,1354,69400,698111,40517
51427,16,434,732,365,10013,69
54620,29,244,630,218,5966,26
13326,25,736,1437,466,12964,270
26354,4770,150722,1210,94519,497821,56203
16291,291,4956,1394,3464,28151,1492
32328,4,82,1096,46,4639,36
57410,8,153,551,117,6617,36
30914,60,1326,1117,1004,33442,322
56744,2568,48165,566,35771,152149,12394
38085,180,2490,962,2077,30629,413
33497,2,246,1074,177,4578,69
5566,8,231,1510,156,11557,75
59241,44,466,493,377,5534,89
57506,204,3243,549,2624,23568,619
29774,37,2272,1140,1337,11008,935
6959,77,5573,1493,3664,36867,1909
13382,302,9136,1436,6163,75987,2973
58860,57,475,505,403,14051,72
7846,34,2031,1481,1302,59764,729
37939,27,445,966,336,12453,109
46872,16,290,836,200,10817,90
37040,26,543,991,456,9114,87
36517,657,26872,1002,21741,134288,5131
27240,1,62,1191,50,10145,12
37390,28,730,980,583,17230,147
63558,1,41,354,29,1156,12
21749,175,5280,1299,3134,47895,2146
49455,80,922,784,710,17146,212
44434,101,785,864,620,14039,165
58616,7,71,512,55,3601,16
29578,123,2999,1144,1899,35534,1100
63060,65,565,366,436,7170,129
26636,140,5805,1203,3810,86248,1995
22031,59,2865,1295,1941,32835,924
16970,157,6268,1383,3131,37769,3137
14174,43,1254,1425,822,9182,432
11217,13,295,1461,161,6000,134
38132,128,2830,961,2064,26315,766
58363,2009,38721,518,27914,162621,10807
48528,15,168,812,132,4092,36
19669,48,1044,1335,694,28575,350
35605,101,2561,1027,1989,37841,572
69730,14,128,163,107,4601,21
19342,52,2605,1341,1408,12908,1197
24849,42,1568,1242,1000,18267,568
37761,28,336,970,291,11388,45
65971,76,1398,285,1120,5342,278
4428,394,8304,1525,5015,46717,3289
64779,46,568,316,447,5836,121
13287,148,6751,1438,3986,59735,2765
34421,47,754,1054,493,12853,261
51551,78,1739,729,1336,18757,403
54765,7,103,625,75,8876,28
30534,70,1415,1124,1196,28203,219
7522,233,5345,1485,3547,34684,1798
63400,61,838,357,746,10266,92
46683,67,1016,838,712,20246,304
31286,112,3528,1111,1844,15784,1684
58096,14,105,530,73,5197,32
46141,49,551,843,396,13452,155
67991,78,817,221,682,12257,135
13570,11,436,1433,265,20152,171
28960,105,3714,1155,2176,28927,1538
51656,380,5258,725,4364,65106,894
59627,1052,22894,479,16851,117772,6043
52038,0,49,715,37,2586,12
70290,2,86,144,74,2750,12
16474,6471,244505,1391,128568,846498,115937
49824,53,1006,774,789,18666,217
3556,146,4994,1535,3356,94022,1638
6310,7,342,1502,236,8553,106
259,876,33175,1563,18206,125635,14969
54821,177,1125,623,841,11370,284
54491,51,380,635,288,9410,92
69879,0,25,158,21,1880,4
60443,44,649,450,548,10379,101
26147,10,324,1215,207,9173,117
49754,25,450,775,379,10898,71
28144,9,106,1171,85,3680,21
67961,4,67,222,55,2336,12
17851,131,2255,1367,1574,16787,681
8817,40,1326,1475,836,14312,490
36791,18,338,998,208,15478,130
65294,21,278,302,200,6388,78
13759,283,8521,1431,5429,84221,3092
53559,48,549,667,398,7512,151
36555,81,1322,1001,1062,15055,260
37141,407,6026,988,4143,42793,1883
34104,33,1473,1062,922,11458,551
24207,73,3903,1257,2630,40473,1273
30909,39,1417,1117,793,17320,624
15627,146,3996,1405,2776,37042,1220
33709,641,14326,1070,10645,36722,3681
35346,21,318,1033,227,10353,91
21621,179,5280,1301,3489,51032,1791
57359,68,1052,552,836,23589,216
28423,6,453,1166,255,14228,198
63687,50,774,349,550,9709,224
46769,168,2212,837,1831,41834,381
58747,18,128,508,105,3358,23
7434,41,1369,1487,897,26808,472
14840,2,157,1416,105,6143,52
11900,37,2648,1455,1227,63461,1421
33949,75,2049,1066,1347,22872,702
10792,47,991,1464,598,16051,393
14618,30,816,1418,562,18396,254
6004,51,994,1505,665,12228,329
60893,229,4171,433,3539,57635,632
65100,5,255,306,107,3759,148
65654,1,29,293,20,2881,9
62665,2228,33623,376,26511,105534,7112
21143,293,6508,1309,4411,27558,2097
20650,13,401,1318,280,12726,121
64429,30,374,326,297,6909,77
5339,146,9464,1513,6076,54788,3388
26651,322,6964,1203,4657,58378,2307
13796,77,1354,1430,861,11547,493
6328,85,4312,1501,2534,25661,1778
27510,43,909,1184,617,16353,292
19382,5,230,1340,168,8994,62
12628,57,2750,1446,1621,26927,1129
36931,148,1358,994,1014,13504,344
19068,1909,63246,1346,44210,204858,19036
61256,10,163,419,132,6054,31
19061,10,275,1346,205,15021,70
736,4497,118815,1558,64114,317007,54701
11714,139,2427,1457,1541,17871,886
18990,37,1583,1347,1098,15261,485
9064,716,22564,1474,13267,159686,9297
56490,79,632,575,546,5832,86
35665,3021,77825,1025,54309,391366,23516
57484,21,239,549,157,3967,82
15737,9,540,1403,374,17266,166
24624,38,1782,1247,1105,12723,677
62565,110,1402,378,1072,12304,330
16304,41,1729,1394,1241,79561,488
2128,21,318,1548,223,11888,95
53497,5,90,669,79,4669,11
15556,8,783,1406,566,67029,217
18746,22,565,1351,479,8164,86
22847,1763,51821,1282,33171,222780,18650
64695,53,587,319,478,5618,109
11457,2,115,1459,58,10225,57
10193,22,682,1468,401,8724,281
66211,13,169,277,143,10058,26
63710,27,201,349,181,8511,20
31084,144,2338,1114,1585,24960,753
19046,0,0,1346,0,8663,0
23814,220,4266,1265,3072,37453,1194
8390,9,502,1477,309,12204,193
69407,8,120,173,107,3241,13
17843,51,1374,1367,972,39034,402
10983,300,5852,1463,4184,40092,1668
60918,56,1195,432,1017,20580,178
65403,24,309,299,226,3658,83
8684,426,18328,1476,10734,86594,7594
7809,37,1398,1481,905,40540,493
15875,61,833,1401,660,25434,173
508,33,1427,1560,975,34988,452
17032,10,182,1382,149,11780,33
70052,14,163,152,138,4989,25
23130,190,5458,1277,4056,59726,1402
38432,58,1099,953,818,17430,281
7692,544,11494,1483,7486,71624,4008
6127,5,211,1503,145,11680,66
58368,29,370,521,308,3770,62
39391,63,1449,938,1280,24844,169
16590,11,176,1390,129,7026,47
20457,18,659,1321,538,14448,121
58258,29,570,524,443,10448,127
31054,79,2059,1115,1372,25827,687
57948,20,228,535,177,5346,51
2077,41,1033,1548,661,18960,372
11369,205,4129,1460,2028,33094,2101
27713,28,846,1180,632,12474,214
12294,0,0,1451,0,7639,0
69272,11,361,177,285,3941,76
1783,53,2156,1551,1625,80661,531
32117,78,1109,1099,711,10432,398
65215,250,8000,304,6842,44246,1158
69051,13,140,185,118,4809,22
59341,1026,47859,489,34636,210722,13223
37352,15,500,981,390,12245,110
63778,152,3260,347,2747,23596,513
11177,413,18352,1461,10978,44083,7374
41603,3477,51633,904,41407,209186,10226
16145,0,67,1396,40,7666,27
2572,56,1821,1544,1317,13806,504
3334,21,577,1537,419,45755,158
61627,1,23,409,17,2895,6
37318,4,38,983,33,2807,5
35546,5,147,1028,102,4232,45
12724,0,0,1445,0,3501,0
22136,26,1585,1294,971,22366,614
58045,238,2214,531,1767,24484,447
30707,33,816,1121,559,7707,257
23231,1948,70916,1276,41516,500252,29400
57214,8,107,556,86,7248,21
24187,274,3771,1257,2493,23610,1278
725,66,3788,1559,2643,28339,1145
95,11368,360573,1565,215748,902826,144825
70118,127,2602,149,2578,24873,24
64938,62,710,311,608,4805,102
52297,124,1369,705,1187,26604,182
53294,237,5350,674,4261,44565,1089
16655,85,2989,1389,1951,60392,1038
68924,36,588,189,514,12410,74
23624,6,154,1269,115,8719,39
48612,9,156,809,125,6364,31
56473,45,669,576,545,10402,124
64107,1,17,336,13,1477,4
30977,913,34024,1116,24489,254533,9535
20159,330,10664,1326,7357,92445,3307
58544,71,762,512,627,14990,135
29693,748,14687,1142,12769,102526,1918
53810,111,1426,660,1289,8130,137
14529,21,720,1419,540,10688,180
29545,135,4418,1145,2864,23456,1554
66756,8,78,261,66,2741,12
54925,1804,42450,619,33356,197999,9094
44118,6,105,868,90,4898,15
54187,132,2019,647,1599,18765,420
13619,10,657,1433,372,21485,285
64981,1097,10099,309,8239,57860,1860
17835,2124,52982,1367,31718,233291,21264
65601,0,15,295,9,1170,6
10512,10,273,1466,175,10128,98
1821,36,1568,1550,1098,56281,470
8795,17,790,1476,520,8640,270
3258,120,5986,1538,4049,51574,1937
40110,84,1626,927,1305,21935,321
58633,30,387,512,291,6154,96
20516,77,3861,1320,2746,46055,1115
62469,181,3520,381,2748,66512,772
37476,62,874,978,648,9224,226
33247,473,12444,1079,9233,92745,3211
54260,0,629,644,304,5164,325
47759,10,183,825,148,2695,35
8682,29,1131,1476,738,11432,393
4480,143,5548,1524,3694,53523,1854
46523,105,2286,841,1785,27423,501
22086,11,399,1294,303,20740,96
48867,338,3579,801,2782,32540,797
29063,473,13188,1154,7800,83942,5388
22032,65,2066,1295,1238,17674,828
9741,17,900,1471,493,11774,407
62937,14,206,369,153,3943,53
31793,405,7656,1104,6247,45833,1409
49830,344,5488,774,4349,47116,1139
10323,64,1734,1467,1076,16977,658
36805,18,437,998,360,6426,77
15293,3,68,1410,42,2809,26
15629,143,3952,1405,2522,38779,1430
15222,24,767,1411,518,18492,249
1181,63,1066,1555,821,18117,245
37860,14,256,968,213,12607,43
52502,115,2757,698,2232,52787,525
61806,79,1429,403,1283,19013,146
34331,797,11686,1058,8615,53738,3071
11213,59,1092,1461,677,12413,415
34353,21,325,1058,219,5552,106
34179,13,483,1061,306,5997,177
45877,133,1786,849,1485,20914,301
62621,10,105,377,94,3750,11
57851,1,26,538,21,5633,5
19020,40,1155,1346,869,25707,286
42784,10,134,885,104,5530,30
4765,174,7673,1520,5105,44971,2568
23505,5,354,1271,256,10994,98
64791,72,1576,316,1240,14810,336
51191,44,528,738,413,7233,115
3131,136,5418,1539,3950,72191,1468
48804,40,511,803,402,10549,109
27643,2629,63354,1181,37868,130940,25486
46852,6,127,836,102,11757,25
16004,25,683,1399,464,26097,219
26849,90,2939,1199,2055,37122,884
42684,24,415,886,316,8034,99
5833,216,3608,1507,2666,21685,942
13858,5,240,1429,142,19324,98
62417,5,93,383,57,6678,36
17326,146,4574,1377,3470,56685,1104
18801,17,420,1350,294,10201,126
58932,42,459,502,356,9606,103
60483,1,11,448,9,2774,2
20515,2,171,1320,129,7635,42
69767,15,174,161,144,1313,30
67217,24,413,245,315,7006,98
50676,0,16,753,13,3152,3
17601,114,1653,1372,1388,13308,265
34693,231,3227,1049,2387,16298,840
21809,4235,69942,1298,43774,148173,26168
30359,8,598,1128,352,8115,246
6758,24,570,1495,402,9295,168
15852,30,1205,1401,847,18967,358
67979,25,325,221,247,3624,78
33199,863,10296,1080,7950,82175,2346
32797,6,184,1088,147,11297,37
50188,328,6316,765,5531,62279,785
22822,30,905,1283,727,28020,178
5160,8,1230,1515,845,18145,385
27808,430,7744,1178,4920,55440,2824
35747,56,1677,1024,1212,8748,465
64011,103,1247,339,902,9670,345
48652,5903,98867,808,74443,680263,24424
1503,20,709,1553,533,25454,176
49919,10,262,771,188,10759,74
2136,99,3139,1548,2178,56360,961
60983,157,3670,430,2824,35442,846
7297,15,525,1488,327,13278,198
55297,2,45,609,37,4514,8
11649,42,2816,1457,1405,24817,1411
21605,73,1992,1301,1281,34026,711
32609,50,1259,1091,861,27557,398
18702,25,804,1352,580,14672,224
52276,13,195,707,159,5311,36
9221,84,1897,1474,1359,69195,538
18132,13,380,1362,330,37774,50
50843,5,43,748,30,3301,13
65990,25,433,285,345,6012,88
65833,0,25,289,19,1803,6
36247,42,516,1011,393,12625,123
12826,12,890,1444,491,24357,399
24364,4973,132741,1253,95734,399268,37007
5549,3,236,1510,162,28450,74
20369,506,13422,1323,9459,99891,3963
24749,126,3792,1244,2649,35122,1143
18103,120,3722,1362,2485,105863,1237
21907,16,522,1297,348,24909,174
31151,66,1153,1113,731,7832,422
3883,26,2260,1531,1649,23686,611
35475,35,952,1030,733,16524,219
253,248,5443,1563,3780,64285,1663
25824,106,1789,1222,1180,19584,609
49208,37,336,790,254,7909,82
28200,214,7647,1170,4423,47623,3224
27855,303,2153,1177,1375,22228,778
17,3454,162884,1567,86302,449291,76582
19271,19,749,1342,518,9816,231
5076,351,7226,1516,5344,37645,1882
66121,49,449,280,387,5255,62
68146,7,116,216,90,3895,26
28228,34,845,1170,670,16733,175
22930,1574,52369,1281,37602,221792,14767
6559,66,1612,1498,1105,13195,507
12808,798,16511,1444,10571,77279,5940
9888,137,2562,1470,1695,33391,867
5142,244,7023,1515,4596,28729,2427
13509,34,1113,1434,693,12662,420
2257,16,435,1547,311,11695,124
32678,129,4375,1090,2855,23997,1520
23178,18,642,1277,439,14099,203
10387,82,1435,1467,886,12662,549
15927,9308,377065,1400,248337,646610,128728
24711,34,359,1245,292,12449,67
48538,2039,38020,812,28142,123584,9878
2738,1474,78337,1543,54292,483839,24045
41224,17,429,910,371,11561,58
12801,13431,379081,1444,206557,1332704,172524
27984,0,0,1174,0,11055,0
49373,925,7995,772,6503,60713,1492
50798,493,9989,750,7520,76648,2469
29708,428,5855,1142,3937,43954,1918
8458,114,4699,1477,3030,18137,1669
7256,35,740,1488,487,6922,253
49165,236,3824,792,2399,21721,1425
3440,8,270,1536,200,14613,70
5203,279,5398,1514,3677,28761,1721
65423,13,77,299,62,2717,15
9183,55,2287,1474,1465,22256,822
69143,18,209,181,192,8027,17
65588,4,63,295,32,2549,31
21002,28,666,1312,468,13856,198
51112,982,16834,741,13049,133584,3785
7847,1355,100733,1481,57255,354006,43478
26528,75,1509,1206,783,16459,726
58828,134,3196,505,1972,28180,1224
60806,28,312,436,225,11027,87
3799,7126,143536,1532,96102,316786,47434
19343,4,83,1341,66,4085,17
11833,20,605,1455,320,26977,285
1339,392,13431,1554,8409,45586,5022
2804,426,15763,1542,10174,104409,5589
29022,3,123,1154,81,4510,42
5357,27,716,1512,485,11179,231
22186,383,5205,1293,3041,33776,2164
35413,84,1641,1032,1339,11900,302
22746,4,208,1284,157,9725,51
54174,168,2238,647,1745,22460,493
8630,8,775,1476,526,16887,249
40943,9,297,914,220,8407,77
32865,897,21367,1086,14735,139378,6632
26605,4137,178056,1204,109549,732077,68507
13353,166,5605,1436,3670,45443,1935
39762,468,8319,933,7023,75263,1296
27778,30,675,1179,470,18406,205
11893,8,422,1455,190,7640,232
16703,579,17359,1388,11319,111926,6040
12303,14,836,1451,488,17652,348
35440,22,1060,1031,751,16158,309
14769,8,270,1417,173,5444,97
42700,140,3019,886,2280,29357,739
23459,195,5159,1272,3569,64494,1590
33665,27,713,1071,562,11046,151
2987,0,76,1540,51,7105,25
56223,18,173,584,136,11086,37
5008,211,5619,1517,3600,90378,2019
43525,528,7069,874,5325,40328,1744
36022,31,495,1017,400,8823,95
64333,0,49,329,32,2754,17
11936,47,1242,1454,770,21215,472
51913,19,293,719,240,6216,53
12056,33,1488,1453,838,21101,650
33115,31,771,1082,540,14997,231
26753,15,454,1201,367,9638,87
35712,114,1245,1025,1016,13604,229
52380,6,65,703,64,3164,1
5977,151,5937,1505,4325,78353,1612
53194,17,198,676,157,7363,41
47114,53,1489,833,1023,18869,466
33995,4162,87458,1065,54401,391734,33057
10694,606,16480,1465,11513,104164,4967
5467,5,160,1511,100,26499,60
33543,12,279,1074,202,5612,77
29620,494,10021,1144,7024,47722,2997
20863,76,1248,1314,779,13727,469
17077,3676,151722,1381,88893,765297,62829
44837,41,913,860,764,19156,149
8597,65,1940,1476,1218,20900,722
28932,23,2991,1156,2467,14341,524
5753,17,754,1508,512,28941,242
5315,3171,79087,1513,50864,392086,28223
10032,39,2216,1469,1313,21095,903
67318,21,488,242,303,5967,185
20838,17,377,1315,280,14513,97
8289,56,1354,1478,869,18033,485
9799,764,27067,1471,17734,112157,9333
55427,11,140,606,88,5827,52
21287,7,147,1306,117,5775,30
12344,24,2350,1450,1148,24016,1202
34335,60,1178,1058,775,30380,403
6125,7,459,1503,288,22122,171
17202,4254,84013,1379,46630,230744,37383
33505,27,559,1074,364,6919,195
64219,18,183,333,145,4449,38
20032,44,1297,1328,914,24486,383
32805,247,6176,1087,4210,45759,1966
1607,2,115,1552,82,18716,33
16521,625,15446,1391,11427,72089,4019
16159,415,3198,1396,2719,77071,479
4919,5,224,1518,156,9411,68
9086,83,2805,1474,1858,30406,947
45692,5508,91946,851,61590,275208,30356
23754,51,854,1266,597,29400,257
41515,46,952,905,745,10386,207
26220,11,162,1213,118,24048,44
49683,34,548,762,452,8441,96
40274,672,10746,925,8691,108622,2055
17050,89,2275,1382,1644,35808,631
14631,206,8787,1418,5840,34857,2947
25481,33,655,1229,441,8609,214
10361,249,5949,1467,3949,77530,2000
25696,3489,109452,1224,66652,463994,42800
6682,65,2042,1496,1561,21453,481
34983,211,2827,1042,2095,68096,732
9212,31,1782,1474,1159,63145,623
58891,12,299,504,211,4823,88
31377,1140,22267,1110,16660,104910,5607
44749,10,98,861,78,3418,20
14336,6,132,1422,89,3210,43
33942,61,2253,1066,1636,14479,617
17515,394,9092,1373,6739,76541,2353
25364,107,1479,1231,918,15311,561
66055,36,457,282,363,6015,94
8545,28,982,1477,612,13133,370
52544,32,277,697,216,4734,61
16448,98,2953,1392,1985,48147,968
21543,87,2443,1302,1901,31900,542
23203,5,134,1276,98,5118,36
22467,18,927,1289,691,17091,236
34726,49,949,1048,784,12507,165
17457,97,1841,1375,1493,59860,348
3415,55,2436,1536,1530,30948,906
24446,452,8601,1252,5288,29510,3313
51491,30,233,731,165,8487,68
41700,16,524,902,410,8235,114
14055,280,20142,1426,13678,134998,6464
895,46,1177,1557,808,39704,369
30055,93,1485,1134,951,23871,534
36333,221,6702,1008,5076,23659,1626
23001,74,1289,1280,842,15234,447
32810,81,1935,1087,1306,9469,629
48823,41,446,803,336,8146,110
6103,27,469,1504,392,9597,77
5229,118,2509,1514,1838,24168,671
67927,64,810,223,666,8383,144
5286,13,352,1513,254,9761,98
58200,68,1377,527,1083,13178,294
4361,28,509,1526,292,17883,217
11013,29,1121,1462,685,15343,436
29080,8,600,1153,394,44777,206
53436,20,245,670,202,7372,43
56102,68,798,587,630,16436,168
50098,105,1045,767,855,36652,190
64829,35,262,314,216,13056,46
41677,17,257,903,218,11233,39
66205,50,810,277,672,13640,138
17368,338,10455,1376,7286,116160,3169
69339,4,64,175,48,1252,16
65535,26,581,296,508,8687,73
18419,84,2535,1357,1880,43399,655
50618,10,200,754,140,5318,60
61264,22,160,419,131,2526,29
3100,259,14051,1539,9292,80189,4759
20397,34,1252,1322,836,19246,416
23179,6539,132564,1277,88579,386674,43985
62208,118,1016,389,813,10303,203
64101,7,59,336,49,3931,10
48892,31,303,801,243,5448,60
18327,7,307,1359,203,10279,104
52727,21,323,690,274,5728,49
23839,17,338,1265,263,10713,75
63484,42,351,355,287,5240,64
39296,15,155,939,111,3893,44
2753,110,4647,1543,2896,29603,1751
21488,1189,29043,1303,19285,183944,9758
32343,6,186,1096,127,2635,59
28679,8,288,1161,187,12655,101
69355,8,126,172,112,3454,14
63232,54,1103,362,912,12228,191
54687,18,239,628,201,5847,38
56340,2,47,580,36,2797,11
31842,9,752,1103,458,10261,294
1810,401,8384,1550,5131,48046,3253
9752,13448,475704,1471,281388,1838576,194316
25954,9,415,1219,225,9840,190
39991,30,847,930,650,8981,197
3494,5,138,1536,87,14433,51
19276,43,1384,1342,890,8321,494
57574,28,360,547,277,6954,83
10491,12,596,1466,391,7945,205
1690,2580,81014,1551,52196,346991,28818
11845,248,10317,1455,5937,50345,4380
41617,43,537,904,445,13006,92
6688,42,1514,1496,951,50217,563
36266,63,1390,1010,1241,21824,149
2560,90,4479,1544,2986,44367,1493
22206,12,369,1293,234,7466,135
53215,21,282,675,258,24526,24
14812,74,1115,1416,884,15311,231
29437,23,680,1146,434,32833,246
38797,2,23,944,20,1717,3
3765,908,21514,1533,14330,128122,7184
13971,260,7889,1428,5286,45141,2603
68409,13,209,208,187,5346,22
40531,125,2327,921,1524,19278,803
1092,29,1435,1556,928,32289,507
26671,1768,27194,1202,17567,144549,9627
3134,23,657,1539,465,8464,192
48860,30,719,802,550,15336,169
35505,18,622,1030,416,6187,206
48587,288,3514,810,2690,36758,824
64296,174,2447,330,1841,26777,606
66164,7,101,278,72,2129,29
53966,18,103,654,88,5055,15
64120,21,227,336,179,8899,48
21954,4,267,1296,176,5966,91
49891,27,315,772,225,3783,90
17307,372,10599,1377,7517,80224,3082
6435,6,196,1500,133,16595,63
30815,109,1824,1119,1208,36327,616
8044,25,536,1479,348,9807,188
23121,435,6478,1278,4656,40327,1822
39319,37,682,938,524,9858,158
17708,3,99,1370,69,2963,30
12244,68,2214,1451,1126,62845,1088
8922,2263,84162,1475,50123,304993,34039
22010,130,5133,1295,3494,127009,1639
8078,6206,174700,1479,110649,342818,64051
15509,7,349,1407,250,12792,99
61166,9,65,423,50,4646,15
20659,10,347,1318,246,11163,101
27103,53,1789,1193,1069,30482,720
68371,4,54,209,41,5842,13
23843,173,1861,1265,1229,22445,632
54415,521,4859,638,3589,32959,1270
65466,80,1133,298,911,8800,222
48670,53,995,807,701,17976,294
59432,687,11061,486,8906,60341,2155
47427,160,1425,829,1081,10824,344
52740,42,785,689,596,21577,189
14525,2471,30142,1419,18350,126544,11792
32235,853,23537,1097,14646,159060,8891
47170,85,1200,832,909,24229,291
63977,6,108,340,76,4876,32
52356,96,1399,704,1116,36623,283
36467,14,278,1004,227,9359,51
14632,68,1650,1418,1431,24370,219
26460,60,1252,1208,824,31339,428
8269,72,875,1478,601,9236,274
65858,12,141,288,109,2136,32
501,22,935,1561,714,26929,221
7329,1105,23095,1488,14856,150210,8239
53745,1299,17378,660,13399,125191,3979
35547,14,384,1028,292,15245,92
13414,82,3524,1436,2115,44604,1409
3512,78,1897,1535,1339,76868,558
33417,23,346,1076,237,5850,109
39275,0,49,939,28,8926,21
32759,105,2277,1088,1309,13250,968
39745,154,2838,933,2257,26903,581
22109,40,958,1294,602,32237,356
62987,55,411,368,356,8574,55
64055,80,1833,338,1299,21161,534
29777,17,704,1140,458,16017,246
24046,6,151,1261,127,4273,24
38272,7,174,957,150,10430,24
70009,30,275,154,227,5424,48
55359,39,513,607,409,4859,104
23136,37,1281,1277,897,11781,384
17325,32,598,1377,481,8048,117
69221,22,326,179,258,7003,68
59331,2166,31475,489,26193,166453,5282
8236,5805,279127,1478,147792,861931,131335
54740,398,4607,626,3855,74021,752
60778,26,233,437,201,5310,32
27226,6,178,1191,118,4066,60
6398,98,2747,1500,1910,31133,837
13559,292,8685,1433,5665,31995,3020
20351,846,33463,1323,27294,241813,6169
19667,10,444,1335,358,15960,86
53405,2,36,671,30,2304,6
31126,51,1283,1114,851,15013,432
15991,121,1559,1399,1084,32551,475
15300,545,8921,1410,5856,75116,3065
30777,204,6037,1120,3593,18609,2444
20131,240,5359,1327,3777,54446,1582
17476,7,65,1374,49,7208,16
55432,261,3756,598,3025,53094,731
49459,217,2988,784,2526,30509,462
38174,6,209,960,144,10510,65
13352,197,6109,1436,3779,47353,2330
10493,1235,37214,1466,24364,215062,12850
5935,9,331,1506,238,20264,93
49969,310,4943,770,3680,24656,1263
29443,1263,31237,1146,22058,163976,9179
29921,12,375,1137,240,9892,135
18040,109,4181,1363,3029,42030,1152
42646,56,758,887,617,22927,141
23005,0,24,1279,19,3609,5
29193,19,1393,1151,782,19124,611
12375,79,2952,1450,1770,26276,1182
69802,10,126,160,104,3874,22
68712,414,9033,196,7687,49079,1346
48019,37,421,822,283,4851,138
56695,8,152,570,122,3524,30
1820,21,359,1550,269,33866,90
6621,118,2734,1497,1940,36078,794
62717,5,109,374,81,3392,28
26652,24,1863,1203,1213,17298,650
62125,1697,32305,391,24915,167839,7390
56072,4,279,588,84,5649,195
41231,10,359,910,267,6853,92
7051,10,246,1492,169,6818,77
48193,117,1269,820,941,15874,328
68001,16,172,221,148,10131,24
29194,66,1049,1151,708,8437,341
40533,4,157,921,121,7887,36
2532,5886,179049,1545,111292,404554,67757
20450,3,104,1321,67,4208,37
25990,11,351,1218,303,10935,48
4641,0,116,1522,85,8920,31
3457,236,7670,1536,5224,55144,2446
66258,8,97,276,64,4140,33
28681,73,1489,1161,933,12088,556
59480,62,1607,484,1310,11328,297
1989,118,3289,1549,2284,45417,1005
61648,131,1725,408,1371,22235,354
57935,197,3165,535,2190,27143,975
17795,3,185,1368,133,9061,52
49555,460,17923,781,13664,100315,4259
16569,915,29873,1390,16730,114186,13143
512,18,745,1560,472,12704,273
32672,2,98,1090,57,3374,41
14393,136,4305,1421,2856,24097,1449
66746,105,2018,261,1779,22895,239
57352,49,289,552,231,15646,58
65098,376,6096,306,5059,35492,1037
13566,2,259,1433,132,21729,127
56291,38,676,581,514,13975,162
19775,13,376,1333,273,29290,103
69413,14,137,173,137,6817,0
12530,141,4339,1448,2653,34394,1686
59260,871,12359,489,9953,45286,2406
54998,39,321,615,252,10709,69
21375,3,199,1305,137,8501,62
35127,330,6255,1039,4839,37734,1416
42698,23,390,886,331,12907,59
49334,22,341,787,276,8177,65
28291,8,272,1168,168,8092,104
23728,28,467,1267,295,5433,172
63362,19,226,358,185,9152,41
58354,52,750,521,566,41360,184
3745,502,21463,1533,13599,136156,7864
48665,0,92,807,53,4027,39
64862,74,1448,313,904,12128,544
11533,166,3171,1458,1613,28343,1558
50930,2439,53832,746,42202,350803,11630
55244,9,124,611,90,6439,34
41748,9,184,901,123,6875,61
9850,300,11858,1471,8042,93106,3816
8001,15,441,1480,271,12996,170
52049,554,6966,714,4903,81302,2063
67818,627,9440,226,7691,67529,1749
9743,1,79,1471,30,6723,49
54665,22,190,628,160,5321,30
4034,905,37953,1530,24688,191099,13265
20791,117,1908,1316,1258,20553,650
25357,5,295,1232,219,5468,76
54761,69,1086,625,820,10769,266
28396,17,397,1166,263,12113,134
69326,0,8,175,4,2046,4
66759,11,170,261,110,2463,60
7399,2,111,1487,84,17196,27
64792,0,43,316,27,3895,16
24819,17,216,1243,160,7249,56
22767,16,714,1284,503,18674,211
13200,65,2361,1439,1242,34747,1119
26811,669,16621,1200,10515,154964,6106
25030,31,1696,1238,1094,9930,602
49877,622,7177,772,6050,65136,1127
51369,141,1315,734,1053,19948,262
16775,128,3175,1386,2155,32137,1020
11604,112,3978,1458,2393,27008,1585
33900,8,279,1067,183,7158,96
4017,21,278,1530,198,9213,80
68212,62,1211,214,995,11379,216
66838,64,1007,258,764,14256,243
65488,61,1755,297,1349,7560,406
69651,28,308,165,252,8953,56
61954,10,108,398,78,6494,30
62903,2776,48151,369,34616,303662,13535
67909,62,590,223,482,8146,108
65843,4,105,288,88,3522,17
12830,8,507,1444,277,34012,230
20957,1,71,1312,63,6373,8
55951,25,272,591,224,8688,48
27450,202,4703,1186,3224,29831,1479
48824,39,703,803,573,27611,130
46831,259,3879,818,3012,34471,867
69146,6,61,181,52,2775,9
60067,10,163,464,135,10613,28
64830,2711,63536,313,45352,142227,18184
15524,59465,1226527,1406,719022,3391230,507505
11123,86,2250,1461,1433,19684,817
58554,344,3541,514,2221,17376,1320
57415,10,157,551,121,3707,36
69190,4,27,180,21,6325,6
54853,37,478,621,317,9620,161
35896,29,1145,1021,875,20672,270
30100,1502,22519,1133,14515,135198,8004
19422,25,400,1339,318,17926,82
47110,49,1088,833,910,16765,178
30901,9,440,1118,276,5283,164
63982,32,222,340,194,4177,28
5520,92,4435,1510,2844,20950,1591
58256,11,119,525,81,7993,38
38055,357,5425,963,3995,31135,1430
66265,7,84,276,65,3741,19
70527,1,24,136,20,1531,4
23467,10,573,1272,402,9962,171
12282,29,1606,1451,763,31577,843
63239,1,18,361,12,3504,6
70256,11,139,145,124,4145,15
22805,37,2297,1283,1506,48931,791
30209,26,350,1131,195,4018,155
67234,8,219,245,154,6117,65
22811,16,429,1283,267,4622,162
40167,88,1565,927,997,28802,568
67699,92,1251,230,1002,11714,249
13234,1332,27339,1438,17385,179414,9954
57560,26,204,547,156,4454,48
3358,196,10826,1537,7117,105920,3709
20148,1,135,1326,97,3479,38
69945,0,24,155,21,1886,3
57292,16,341,552,253,7839,88
18137,14,800,1362,575,12952,225
4080,36,1300,1529,842,19741,458
68810,3,125,193,64,4993,61
6644,35,771,1497,538,22764,233
17871,29,789,1366,527,11985,262
56019,34,416,589,331,7544,85
4425,27,608,1525,441,23608,167
29592,39,1668,1144,930,13723,738
67534,41,320,235,268,5590,52
39742,1201,21537,933,18515,132407,3022
64728,40,561,318,479,12941,82
6430,12,185,1500,136,9526,49
47787,97,1686,824,1342,27650,344
38175,44,901,960,646,19949,255
28015,86,6584,1173,3957,26900,2627
26691,160,4670,1202,3317,34253,1353
2820,92,5437,1542,3781,30708,1656
20097,12,355,1327,256,11005,99
64042,18,414,338,336,15897,78
5768,4,154,1508,81,10796,73
41554,35,634,905,518,13572,116
63107,84,2029,365,1376,19870,653
11354,0,0,1460,0,6981,0
53774,492,4728,661,3867,36425,861
65062,85,544,306,442,9852,102
58190,80,2928,527,2414,35077,514
51233,74,867,737,627,15163,240
34096,406,8204,1060,5268,63527,2936
21369,352,7774,1305,4972,63978,2802
37251,25,710,984,583,10749,127
66807,1,29,259,22,2198,7
19263,929,46555,1342,33071,214017,13484
38528,22,432,950,320,5557,112
8014,40,815,1479,544,32250,271
29543,24,793,1145,506,9320,287
31467,20,394,1109,251,6616,143
68780,137,1943,194,1583,14244,360
28319,21,407,1168,248,9544,159
34299,141,10887,1059,6950,27627,3937
19441,38,1388,1339,886,9128,502
34236,17,376,1060,293,6675,83
34857,12,250,1045,159,9664,91
29295,64,1365,1149,855,19623,510
49847,685,9614,774,7527,53390,2087
58337,32,441,522,384,4938,57
57973,36,418,534,334,13771,84
53173,14,107,676,77,3690,30
4869,15073,619734,1519,380123,1250937,239611
14543,17,577,1419,439,12769,138
70111,26,396,150,346,6152,50
59512,42,539,483,423,9024,116
48137,41,647,820,528,9503,119
40961,58,885,914,666,19434,219
8355,129,2592,1478,1712,21170,880
22145,19,772,1294,544,15195,228
26327,53,891,1211,714,52675,177
6692,2359,105969,1496,68006,222908,37963
34752,120,1754,1048,1352,8354,402
49322,75,884,787,727,15093,157
15623,13,501,1405,348,12950,153
3802,41,520,1532,335,11896,185
36818,323,8317,997,6647,77066,1670
53079,22,327,679,259,11254,68
69213,4,51,178,50,4176,1
19740,10,327,1334,259,13507,68
55400,422,5168,606,4081,31556,1087
1451,337,20172,1553,12135,94561,8037
27803,91,2289,1178,1373,21866,916
62236,3,20,388,18,2841,2
63820,72,861,346,697,8176,164
60958,18,394,430,298,8397,96
52810,159,1848,687,1546,15594,302
9092,9,193,1474,138,9329,55
24203,3,336,1257,248,18829,88
7521,0,0,1485,0,37436,0
36021,532,7432,1017,6190,51706,1242
18022,324,12064,1364,8010,88053,4054
9265,61,3276,1474,1989,25721,1287
15740,192,3632,1403,2538,47371,1094
47621,1935,21922,826,17795,97366,4127
48774,51,1269,804,835,25218,434
59017,28,341,500,268,13085,73
70012,22,243,153,212,2845,31
57120,2799,43656,558,30394,196600,13262
62969,2,21,368,10,2269,11
38671,49,736,947,554,19603,182
29004,19,257,1155,201,7279,56
792,3,301,1558,237,9681,64
17999,11,279,1364,201,4629,78
8560,195,4979,1477,3171,17803,1808
66336,43,811,274,578,8619,233
31832,48,753,1103,540,16305,213
36285,49,771,1010,476,9979,295
29616,390,8701,1144,6049,104816,2652
14120,10,557,1425,402,17589,155
9600,27,1010,1472,594,11264,416
66559,304,6936,265,5467,40319,1469
50396,893,15677,759,12151,106071,3526
4324,3,80,1526,57,12681,23
12780,8,163,1445,91,5704,72
55568,2755,38413,602,30598,201221,7815
32702,5,214,1089,140,10518,74
42606,19,219,888,180,5712,39
69114,19,458,183,276,4355,182
30918,744,15590,1117,10667,136810,4923
64114,9,135,336,101,3427,34
37688,135,1850,972,1548,10990,302
56687,0,6,570,6,1814,0
41141,83,2282,911,1856,50079,426
38381,631,9409,955,7604,105088,1805
48632,50,612,808,491,36370,121
60027,10,152,466,126,8924,26
58317,16,237,523,219,7661,18
60615,34,824,444,641,7910,183
14058,101,2778,1426,1784,23833,994
10958,1302,38614,1463,24466,174222,14148
69391,5,82,174,61,4645,21
64648,1043,14151,320,11668,56816,2483
66816,12,136,259,106,5164,30
68588,16,214,200,159,5660,55
68025,5,100,218,88,2556,12
13037,8,527,1441,286,8238,241
52342,2,37,704,22,3033,15
18001,7,620,1364,509,41444,111
54237,112,1645,645,1342,36062,303
50449,6,50,758,40,4038,10
8886,81,2565,1475,1650,16842,915
46301,54,473,844,366,9822,107
19033,810,13009,1346,9195,54691,3814
57480,75,1020,549,758,8013,262
48537,21,294,812,203,5369,91
19478,46,1446,1338,1023,15260,423
62401,4,23,383,17,4829,6
19958,20,998,1330,736,19480,262
59669,6,124,478,97,7860,27
43967,197,2741,870,2192,29953,549
3989,58,1842,1530,1375,24910,467
61376,9,213,416,156,6185,57
65712,0,0,291,0,1456,0
69799,38,560,160,450,7734,110
66791,8,152,260,114,4220,38
3341,170,4084,1537,2622,29944,1462
34416,278,4968,1056,4206,54640,762
2289,19,625,1547,440,9308,185
26300,113,1880,1211,1187,29946,693
38089,1,14,962,12,8416,2
55727,11,244,598,162,12110,82
30157,62,1317,1132,848,8868,469
26829,19,544,1199,336,13763,208
57293,8,78,554,58,4186,20
18241,12,862,1360,607,36675,255
55832,5,55,595,48,4611,7
23436,0,0,1272,0,4972,0
29091,49,1053,1153,719,21823,334
37219,110,2046,985,1708,45152,338
59874,41,494,471,385,8040,109
68884,751,9030,190,7299,43561,1731
8232,459,49756,1478,29459,264659,20297
36069,128,2702,1015,2252,38173,450
37176,178,1157,987,890,14648,267
35310,11,431,1034,209,6529,222
64224,10,90,333,73,3943,17
23128,37,795,1277,555,11012,240
50699,8,57,752,36,3381,21
64821,232,3854,315,3175,44157,679
38649,24077,626782,947,357539,2595202,269243
15063,2,390,1413,285,25675,105
56306,13,156,581,118,3393,38
50708,328,5889,752,4616,85825,1273
9961,58,2019,1470,1111,20030,908
34662,229,4634,1050,3091,24636,1543
23480,16,485,1272,335,7404,150
7104,563,32804,1491,18536,185018,14268
16385,25,1478,1392,885,13714,593
62954,43,259,369,222,4016,37
54963,89,1540,618,1165,18656,375
9258,11,811,1474,558,10813,253
13186,246,3487,1439,2395,24688,1092
30291,1088,19351,1129,12595,232276,6756
37712,83,1932,972,1406,23040,526
56597,69,1387,572,1240,12394,147
24239,6823,145023,1256,87659,314785,57364
50374,0,44,760,35,4238,9
36434,8,118,1005,85,3466,33
17909,20,238,1365,154,3811,84
36895,21,301,995,245,6195,56
39843,164,3089,932,2623,48322,466
20466,3,139,1321,113,11762,26
26950,63,1780,1196,1312,68288,468
41052,2715,44923,913,33332,143870,11591
38393,739,26811,954,19396,109099,7415
6337,41,1222,1501,858,28316,364
3404,10,352,1536,265,15728,87
49189,24,435,791,293,12538,142
49121,50,726,793,596,10573,130
66225,10,147,277,107,5037,40
48703,94,1171,806,950,14924,221
12924,98,5229,1443,3391,26000,1838
46855,3,47,836,39,8091,8
10101,56,915,1469,609,19229,306
28559,70,2769,1163,1739,24877,1030
58054,39,460,531,332,11244,128
50402,167,1648,759,1237,13922,411
13036,1662,43525,1441,28822,134001,14703
59631,43,474,479,381,9677,93
49980,12,280,770,206,4995,74
55126,51,487,614,377,9772,110
58270,585,10151,524,8371,51410,1780
11471,159,2795,1459,1849,14480,946
25441,166,2614,1230,1920,27343,694
61392,28,632,416,487,5299,145
26639,21,442,1203,275,12389,167
2083,58,1849,1548,1214,43485,635
32047,63,1553,1100,978,21687,575
37077,9,100,990,83,4351,17
24265,20,1217,1256,762,43769,455
1464,22,934,1553,648,18072,286
17883,31,331,1366,235,7025,96
5375,34,679,1512,494,18183,185
33789,3,66,1069,43,8286,23
13638,3795,181916,1432,105759,663944,76157
26441,74,1190,1208,977,38480,213
64741,26,244,318,192,4535,52
36539,13,361,1002,267,7159,94
21224,872,26467,1307,15800,142191,10667
50149,13,288,766,263,19082,25
19253,210,8221,1342,5268,100941,2953
41198,8939,308325,911,233407,592429,74918
58424,140,2355,519,1679,11745,676
26195,25,615,1214,407,17036,208
12736,54,1452,1445,745,15887,707
8324,542,34255,1478,22910,95031,11345
41804,25,468,901,387,15280,81
42386,15,405,892,266,7092,139
44467,107,1426,860,1153,49975,273
57467,1830,28427,550,22190,187064,6237
46209,77,1622,845,1245,23446,377
3090,145,5105,1539,3814,45281,1291
10766,64,536,1464,392,9876,144
25227,32,1621,1235,1332,44147,289
62782,58,509,373,413,11196,96
7106,5,225,1491,157,10343,68
6326,82,2934,1501,1905,15414,1029
32863,29,822,1086,525,7740,297
31821,212,5555,1103,4102,31249,1453
16002,385,6367,1399,4389,63259,1978
5854,5,268,1507,191,22707,77
57942,39,517,535,431,9483,86
16465,455,11337,1391,7895,96146,3442
53569,56,1051,667,791,14078,260
13286,3480,175941,1438,109672,433002,66269
26100,7,96,1215,79,8453,17
613,3,478,1559,369,11549,109
11738,11,425,1456,162,10473,263
37011,15,467,992,350,9806,117
458,15,1341,1561,969,26626,372
5545,8,248,1510,174,3972,74
62323,48,1274,386,870,14472,404
17799,4,150,1368,126,7436,24
70498,1,26,137,22,2479,4
57971,53,1009,534,794,30292,215
28363,24657,599769,1167,359762,1308603,240007
21573,36,866,1301,599,8102,267
32638,13,318,1090,200,4733,118
36216,7,167,1010,131,8645,36
51606,336,4996,727,4172,35824,824
68101,13,318,217,267,5007,51
66386,65,999,272,762,16130,237
4882,65,1421,1519,1102,32705,319
10181,24,2581,1468,1712,29177,869
45641,2020,58778,851,44113,170439,14665
19402,34,661,1340,476,19289,185
10825,157,6214,1464,3659,44051,2555
1624,94,972,1552,601,8844,371
4011,34,1113,1530,812,22234,301
23658,1,159,1268,102,15361,57
43233,41,525,877,435,17368,90
27043,81249,3705799,1194,2293531,5605184,1412268
13718,56,1522,1431,955,27254,567
32622,34,916,1091,683,19141,233
17025,310,7306,1382,5053,48166,2253
14051,6,691,1426,445,35653,246
19202,7,299,1343,225,8964,74
54005,2,16,653,14,3091,2
57890,1,46,537,25,1460,21
54528,24,220,634,148,4224,72
43004,34,510,882,405,11412,105
36794,211,3517,998,2895,37276,622
61875,3632,165737,400,121142,371753,44595
37007,343,3639,992,2849,33359,790
6925,28,1448,1493,1073,28969,375
40630,22,317,920,246,17232,71
4923,66,1865,1518,1199,50566,666
15679,24,644,1404,424,8740,220
70337,484,9233,143,9039,60569,194
14815,225,4439,1416,3390,30833,1049
8659,8,363,1476,237,8180,126
1528,6,224,1553,155,23382,69
36017,952,11764,1018,9119,72926,2645
40834,37,543,917,464,13607,79
40087,431,10708,928,8212,28561,2496
30872,23,713,1118,483,4382,230
6145,2,141,1503,96,4933,45
5574,119,3094,1510,2126,24811,968
70455,10,147,138,143,4414,4
41582,75,1731,905,1363,18816,368
25788,13,294,1223,208,5961,86
29585,6,288,1144,200,9549,88
34405,30,824,1056,601,8532,223
7685,26,1215,1483,778,49476,437
53107,79,1332,678,1046,12003,286
15920,42,801,1400,601,7001,200
12310,11,789,1450,420,12231,369
42043,3871,95830,897,62756,316102,33074
34282,8,448,1059,278,8717,170
61190,39,1347,413,809,21997,538
52669,556,7406,692,5523,55552,1883
26140,86,2129,1215,1317,13032,812
15598,15,519,1405,380,10374,139
38320,26,389,956,284,7473,105
6868,3,96,1494,69,4830,27
63087,11,96,365,77,3800,19
8121,289,4620,1478,3007,53037,1613
28206,10,268,1170,169,9488,99
13521,391,16333,1434,9427,159812,6906
35930,40,579,1020,399,17729,180
3893,12,465,1531,323,7752,142
57990,12,170,534,151,5455,19
69561,13,219,168,206,5465,13
22884,129,7095,1282,4765,68415,2330
58563,122,1461,514,1073,14407,388
20360,104,2896,1323,1962,40695,934
63654,15,155,350,119,2663,36
177,13,349,1564,265,16073,84
21219,52,1337,1307,890,45020,447
11669,1076,44391,1457,22242,202540,22149
60641,25,244,442,188,5920,56
9791,35,1555,1471,962,25715,593
63806,28,349,346,292,8542,57
28996,574,13591,1155,8829,61189,4762
46339,48,762,844,611,17648,151
10780,1520,22611,1464,14894,102387,7717
70221,2,95,146,63,3911,32
54834,19,128,622,99,7239,29
52871,9657,150897,685,120039,757936,30858
62345,6,87,385,69,7207,18
47445,71,1409,829,1104,12719,305
26126,6201,173827,1215,109702,401404,64125
21254,341,6964,1307,4546,47423,2418
50283,41,672,762,523,9183,149
43369,12,329,876,241,6506,88
55725,383,8276,598,6731,44838,1545
35363,39,920,1033,632,6417,288
9079,185,6983,1474,4715,80443,2268
27660,225,4136,1181,2716,14886,1420
9891,2607,72716,1470,47660,199136,25056
61679,30,277,407,229,4915,48
63288,2,46,360,38,2442,8
30578,821,18402,1124,13761,164331,4641
24691,0,0,1246,0,2352,0
37449,41,854,979,714,15671,140
30133,296,8894,1132,6335,53811,2559
28164,28,483,1171,326,7132,157
55206,5942,97924,612,77392,363174,20532
14824,76,1470,1416,1051,47033,419
51284,523,7887,736,3810,66639,4077
13977,32,484,1428,284,6305,200
10926,1,28,1463,23,12159,5
68843,65,1152,192,935,13196,217
39140,165,3185,940,2376,17214,809
28373,34,256,1167,203,6540,53
15542,2431,63480,1406,48752,357646,14728
25579,104,3281,1227,2039,20353,1242
7117,84,1943,1490,1563,20729,380
6743,10,412,1495,292,9170,120
1639,100,2931,1552,2037,60872,894
21863,3,378,1297,173,4364,205
55279,54,745,609,536,15006,209
14181,317,8139,1425,5737,46919,2402
5889,5,242,1507,177,18738,65
22085,27,690,1294,482,38836,208
37100,321,5871,989,4153,33466,1718
11004,100,3754,1462,2264,53728,1490
17533,22,305,1373,192,6812,113
27167,25,931,1192,547,6342,384
52491,499,9480,699,7098,82765,2382
66347,29,375,274,284,6280,91
50103,20,334,767,286,5114,48
3632,282,10609,1534,7221,106806,3388
3229,25,1167,1538,856,13649,311
4092,559,8465,1529,6245,47479,2220
22976,88,2228,1280,1456,21557,772
24256,51,1577,1256,1121,26884,456
49156,20,279,793,208,5268,71
66171,58,1988,278,1456,14753,532
31931,51,2574,1102,1620,8560,954
3058,5,413,1540,295,18992,118
28547,170,3145,1164,2305,21693,840
60644,68,1196,442,989,38327,207
20008,14,569,1329,423,7428,146
67043,80,2011,251,1606,15045,405
17695,322,3025,1370,1984,25578,1041
887,19,840,1557,656,21925,184
62229,1,86,388,58,1440,28
37104,739,9845,989,7528,34172,2317
58542,8,104,515,44,3203,60
8049,76,2550,1479,1626,13368,924
13005,1136,37783,1441,23966,108634,13817
20241,462,9473,1325,6973,74905,2500
61325,53,551,418,483,9874,68
28497,16,465,1164,279,4624,186
70366,27,274,142,249,3202,25
10550,26,1193,1466,724,24858,469
70108,338,6954,150,6482,53867,472
64562,12,125,323,106,4843,19
37684,163,2152,972,1641,18487,511
69156,5,62,181,44,1840,18
29933,85,932,1137,493,11764,439
53747,2,33,662,24,2313,9
69297,14,173,177,153,2831,20
17336,185,6857,1377,4487,36466,2370
23342,39,965,1274,771,38726,194
5325,6,198,1513,151,7728,47
1248,1632,60257,1555,37103,138272,23154
9164,74,2121,1474,1458,26297,663
61719,1023,31044,406,24949,129762,6095
12274,175,7985,1451,4643,60095,3342
10463,52,1969,1467,1305,19805,664
11862,745,14237,1455,9290,48031,4947
13875,332,11085,1429,7456,87988,3629
31694,1,147,1105,98,14278,49
26632,14,236,1203,213,11337,23
13536,20,1155,1434,767,43616,388
69655,34,296,165,252,3465,44
49728,5,35,776,31,4256,4
17183,0,279,1379,224,8928,55
9194,140,2103,1474,1194,13051,909
29488,14,985,1146,585,9638,400
50850,16,385,748,236,10044,149
62433,77,1113,382,876,10641,237
31929,10,261,1102,178,8878,83
32481,433,14225,1093,8455,55660,5770
8705,66,2645,1476,1649,24258,996
24915,35,1162,1241,734,9852,428
39656,192,4480,934,3643,51154,837
60685,161,3846,441,3290,22739,556
37130,334,8995,988,7374,44515,1621
40213,222,3911,926,3313,38117,598
7461,171,6108,1486,3938,52741,2170
68255,132,2328,213,1965,24661,363
23201,857,29802,1276,18113,150959,11689
23805,490,6894,1265,4754,58816,2140
11016,81,2609,1462,1669,33727,940
19613,137,5748,1336,4188,67263,1560
29266,117,3003,1150,1934,16999,1069
50218,342,4220,764,3236,43899,984
12792,479,26660,1444,17344,202308,9316
35797,49,988,1023,746,10714,242
59657,53,651,478,566,7521,85
64217,36,531,333,412,8646,119
2907,527,15048,1541,9687,50815,5361
48641,291,6899,808,5774,48251,1125
37594,30,858,975,674,14617,184
31825,15,440,1103,325,5653,115
14962,25,906,1414,581,5773,325
5372,33,568,1512,385,17306,183
29166,71,1244,1151,722,18785,522
12709,705,19203,1446,13178,81876,6025
24263,336,8743,1256,6180,64070,2563
6770,3644,154038,1495,87792,467503,66246
8267,2,193,1478,135,3762,58
34086,98,2239,1063,1756,44821,483
49196,26,562,791,471,20504,91
59361,293,4832,488,3351,34103,1481
41067,3,63,912,42,4311,21
23902,2,110,1264,77,3973,33
65264,9,114,302,65,4736,49
15315,0,0,1410,0,19768,0
6477,7,388,1499,222,4798,166
62479,3,45,381,27,4317,18
3891,54,1932,1531,1422,34665,510
36490,278,5066,1002,3954,21892,1112
16583,23,585,1390,439,33559,146
6489,22,890,1499,560,20131,330
3308,6,567,1537,391,41185,176
67453,78,969,238,778,10921,191
41547,26,411,905,300,10666,111
14409,0,0,1421,0,8514,0
67777,53,782,228,643,13351,139
27756,0,1961,1179,1373,96484,588
3688,21,716,1533,524,16795,192
35472,135,3033,1030,2280,40150,753
19280,0,0,1342,0,24333,0
7633,21,510,1484,335,12072,175
62938,115,2204,369,1893,20818,311
49619,85,1412,780,1076,19047,336
67719,39,465,230,374,3195,91
13116,2677,75380,1440,50635,157574,24745
39073,826,38602,941,31609,294615,6993
14793,273,14670,1417,8734,53690,5936
48350,58,741,817,544,9459,197
42588,21,246,888,188,6503,58
67420,250,4952,239,4257,36207,695
38357,5,144,955,119,5527,25
62608,13,280,377,169,9222,111
26828,101,2306,1199,1415,14256,891
67186,2,113,246,74,2389,39
32519,14,606,1092,403,16527,203
21114,735,22988,1309,15511,126943,7477
31986,139,2025,1101,1473,9504,552
22244,339,18559,1292,9938,104605,8621
18715,56,1419,1352,1099,37507,320
29168,241,3571,1151,2380,36955,1191
5649,77,1814,1509,1222,12500,592
24141,52,1151,1258,765,14393,386
12611,183,3818,1447,2253,51645,1565
22542,322,5905,1288,4289,69973,1616
43113,24,429,879,310,9576,119
5278,246,7523,1513,5127,132166,2396
55831,26,313,595,242,9281,71
54098,11,104,649,90,8130,14
10237,7,196,1468,126,7939,70
4681,98,5333,1521,3570,59472,1763
33874,11,94,1068,71,4703,23
3397,4239,133408,1537,70785,546621,62623
60035,27,413,465,312,9836,101
17701,55,2084,1370,1545,23846,539
35114,102,1526,1039,1090,17556,436
11337,61,1732,1460,1100,32913,632
29417,19,550,1147,318,7521,232
25498,8,223,1229,125,7608,98
12908,179,11650,1443,7131,49885,4519
56971,12,152,562,125,4002,27
62709,4,30,375,26,4282,4
49782,9,243,775,190,6975,53
16820,81,3372,1386,2349,45897,1023
65839,1687,24446,288,20097,145576,4349
5474,12,636,1511,450,25315,186
7127,5818,630655,1490,318277,1361922,312378
16887,4029,75643,1385,41329,163072,34314
27649,12,988,1181,566,30482,422
56732,89,2333,568,1791,22498,542
61955,47,395,398,318,9357,77
33715,16,548,1070,359,17314,189
11335,19,446,1460,296,13294,150
54199,459,5118,642,3890,36636,1228
13530,1070,33217,1434,20953,148247,12264
15464,57,2075,1407,1438,21198,637
61004,346,9289,429,7016,32975,2273
15083,104,2709,1413,1814,35354,895
35163,134,2744,1038,2041,45061,703
63355,8,164,359,115,5375,49
4798,12,473,1520,357,12391,116
21964,49,1779,1296,889,57321,890
56742,21,433,568,271,10322,162
10335,116,4682,1467,2815,32436,1867
25234,124,4850,1234,3286,44173,1564
17781,109,5743,1368,4237,74479,1506
32114,138,6778,1099,4561,18559,2217
5250,462,13081,1514,7114,159982,5967
11996,18,526,1454,290,16950,236
55775,17,200,596,149,4160,51
39582,13,349,935,269,9359,80
26947,3,122,1197,92,8797,30
40577,5,140,921,103,5345,37
38509,29,862,951,654,14585,208
54973,1395,20624,618,15653,129399,4971
37300,2,35,982,31,2945,4
35563,29,579,1028,447,12654,132
25547,14,133,1228,111,16918,22
14286,48,1320,1423,966,29943,354
40604,559,9241,921,7580,89879,1661
25424,390,6208,1230,3922,19420,2286
35811,97,2005,1023,1233,14490,772
14619,19,907,1418,643,21775,264
8737,8,378,1476,259,58638,119
15537,16,1529,1406,939,20025,590
46030,31,527,847,413,18332,114
19888,35,468,1331,356,14478,112
20686,0,0,1318,0,12890,0
15786,2695,57621,1403,38655,175967,18966
33292,31793,750360,1078,501149,2108212,249211
31365,411,10806,1110,6526,48747,4280
6668,62,1879,1496,1224,34988,655
33627,33,1869,1072,1037,15809,832
14487,47,1033,1420,797,9114,236
40605,30,412,921,307,8798,105
48370,12,613,817,375,9594,238
22134,6226,126421,1294,86163,405655,40258
47292,54,937,831,701,28206,236
36717,15,515,999,414,15323,101
49886,46,1119,772,865,21911,254
4435,22,1361,1525,911,32785,450
31996,11,285,1101,180,7172,105
54635,32,271,630,237,6638,34
21246,2,156,1307,101,6104,55
60583,19,146,445,116,2024,30
20903,1413,36978,1313,24667,154295,12311
27409,248,3505,1187,2623,21898,882
57939,174,1620,533,1255,21296,365
21151,90,3542,1308,2413,60718,1129
14177,7,145,1425,104,4852,41
49625,19,300,779,224,13007,76
68327,71,1122,210,941,20428,181
27571,661,19586,1182,13360,116983,6226
11723,0,0,1457,0,8274,0
27866,6585,199673,1176,129413,522009,70260
34727,627,15211,1045,11537,118904,3674
41958,3,119,898,102,6304,17
62327,59,745,385,676,10491,69
21051,6,190,1311,139,8859,51
24450,206,1638,1252,1243,20880,395
25875,52,1177,1221,1053,22033,124
17049,0,146,1382,114,6244,32
24130,43,724,1259,524,10154,200
38567,24,763,949,484,5816,279
57475,4,105,550,84,3028,21
60693,21,242,440,193,6013,49
62492,9,139,381,88,3397,51
32876,196,3441,1086,2428,28421,1013
48931,27,450,799,356,10655,94
24151,111,1631,1258,1241,13672,390
7655,428,10288,1483,6593,33999,3695
27550,4,47,1183,42,5626,5
54118,2465,45540,649,35803,175082,9737
9556,79,2076,1472,1290,24149,786
8255,17,687,1478,444,28723,243
65920,10,223,286,143,7201,80
58924,27,248,502,174,3004,74
2189,85,3907,1547,2901,28091,1006
32798,280,4545,1088,3244,26606,1301
5163,8,165,1515,113,8448,52
40832,11,152,914,140,18120,12
42104,117,1398,896,1035,14065,363
31300,145,3187,1111,2378,27796,809
24846,779,23211,1242,13540,93940,9671
7270,1509,73546,1488,42180,374075,31366
48839,25,239,802,189,5804,50
4905,4,166,1518,100,5936,66
49965,19,410,770,332,26279,78
34707,15,550,1049,386,14642,164
16386,41,1441,1392,907,38570,534
49554,41,708,781,554,8579,154
68133,8,102,216,77,4352,25
51272,995,8766,736,6490,33497,2276
29353,193,4980,1148,3005,31051,1975
13944,23,1241,1428,819,21031,422
11803,9923,502071,1456,271667,1884281,230404
22029,10,157,1295,104,6357,53
33454,9,238,1075,156,3322,82
51227,13,199,738,165,4409,34
28136,13,239,1171,161,4887,78
11793,95,2327,1456,1385,10908,942
13174,95,7170,1439,3532,33594,3638
52343,13,314,704,284,10559,30
13587,13,624,1433,430,12776,194
17115,14,937,1381,637,19817,300
60705,10,122,440,85,6393,37
20937,253,15437,1313,7991,75197,7446
38492,40,483,951,363,3755,120
47936,87,1016,822,815,7200,201
21520,34,796,1302,608,15528,188
58671,11,153,510,118,5003,35
56970,224,4743,562,3535,64754,1208
5966,3,181,1505,125,6669,56
14576,2,225,1419,140,7087,85
26613,24,113,1204,84,100823,29
3078,138,3828,1540,2351,16734,1477
35244,89,945,1036,688,32476,257
10564,3,141,1466,84,4751,57
64148,18,303,335,275,8693,28
31817,165,2552,1102,1647,46569,905
50270,23,320,762,243,4731,77
145,2207,164660,1565,106293,949766,58367
69031,27,494,185,403,7203,91
35673,584,9009,1026,7488,78975,1521
62759,6,49,373,35,2490,14
8911,62,1818,1475,1237,14889,581
70027,1,33,153,25,972,8
738,143,6513,1558,4484,31844,2029
24178,6,290,1258,206,4450,84
16906,152,4356,1384,2881,57752,1475
17757,69,2741,1369,1977,51896,764
69556,12,141,169,140,7515,1
34113,267,6233,1062,4513,68385,1720
37968,16,199,965,172,7846,27
5277,8,157,1513,112,8304,45
17977,156,4245,1364,3179,24159,1066
58583,5,100,513,73,3634,27
19671,86,2829,1335,1954,43896,875
31977,46,1090,1101,709,10720,381
65576,2,28,295,18,2891,10
18867,94,4833,1349,3368,37296,1465
34309,25,542,1059,360,9630,182
39865,102,1103,932,888,7742,215
15076,10,605,1413,422,10667,183
30758,75,2726,1120,1252,29791,1474
60522,12,89,447,82,6266,7
67601,453,8242,233,6950,71956,1292
37836,0,23,969,21,7382,2
4831,112,4213,1519,2527,17434,1686
21037,917,37461,1311,29020,173494,8441
69583,6,141,168,126,7243,15
23791,440,11634,1266,7996,62543,3638
32087,19,1166,1099,717,8962,449
33353,232,4730,1077,2725,19351,2005
1399,3,190,1554,127,13286,63
11602,8,450,1458,227,11019,223
27224,13,555,1191,407,6564,148
11269,0,0,1461,0,32099,0
56536,72,652,574,529,11992,123
70546,10,103,135,98,2493,5
64445,75,880,317,757,7573,123
29068,18,476,1153,291,10918,185
49116,124,1776,794,1517,11250,259
17443,0,0,1375,0,3548,0
9040,12,2451,1475,1463,15581,988
4288,79,2170,1527,1530,40056,640
2260,3228,126550,1547,79151,525177,47399
32136,302,4792,1099,3367,40605,1425
38219,76,1386,958,1064,18294,322
4678,58,2052,1521,1482,23233,570
6790,23,774,1495,589,38995,185
69104,16,188,183,160,5633,28
62008,62,942,396,708,15071,234
27270,109,2079,1190,1353,13765,726
63457,6,98,356,75,4480,23
7393,30,1110,1487,748,24620,362
68741,32,246,195,217,5910,29
1683,7,112,1551,65,12610,47
15208,315,11341,1411,7886,46644,3455
2486,2,185,1545,113,13870,72
69494,21,375,171,342,9468,33
60858,2,9,434,8,3290,1
35481,0,49,1030,32,2953,17
66982,42,1005,253,513,8550,492
40051,190,2910,928,2390,19494,520
54101,13,74,649,56,3221,18
50096,1662,32466,767,23934,220090,8532
17650,15,432,1371,309,18445,123
31620,107,5288,1106,3588,19058,1700
17604,67,1545,1372,1208,21038,337
35774,2773,51860,1022,39992,341046,11868
69843,46,488,159,449,3896,39
51116,8,147,741,115,6313,32
28046,53,1236,1173,769,6242,467
35525,321,5822,1029,4315,36006,1507
66144,34,508,279,427,27306,81
59053,737,18455,498,14423,95654,4032
55608,10,289,600,236,9440,53
68542,2,17,202,14,3179,3
63704,101,1404,349,1094,15992,310
63405,47,624,357,487,8464,137
15162,26,1603,1412,1017,48703,586
32893,507,18585,1086,13271,121456,5314
27388,104,3696,1187,2626,39227,1070
44133,104,967,868,811,22935,156
27145,407,13093,1192,7345,38521,5748
51758,15,198,723,134,4493,64
23337,2859,179429,1274,104770,705864,74659
27771,20,317,1179,217,7171,100
20641,297,5962,1318,4138,55313,1824
51753,81,889,723,677,15321,212
57765,1215,20453,541,15901,73987,4552
18789,41,2032,1350,1508,20119,524
42905,127,3017,882,2210,22810,807
64129,12,109,335,87,1929,22
6203,33,740,1503,508,17328,232
11735,40,1056,1456,610,18261,446
48535,33,698,812,500,19504,198
22857,37,616,1282,392,4933,224
55639,0,65,600,57,2790,8
47380,213,2900,829,2435,29615,465
46156,2719,68334,845,49542,184468,18792
56229,11,356,583,229,8173,127
35572,240,3311,1027,2509,24547,802
2662,78,5512,1544,4539,37243,973
11130,3734,61727,1461,35186,265823,26541
29718,203,5644,1142,4145,42479,1499
16848,56,1135,1385,798,28075,337
32826,12,684,1087,396,8814,288
56565,113,2007,570,1767,35519,240
29887,220,6247,1138,4674,56275,1573
34342,237,8755,1057,6049,67993,2706
39595,111,1767,935,1325,26124,442
58643,55,1959,511,1493,11440,466
42390,12,198,892,123,8775,75
21276,37,1424,1306,952,10112,472
16928,24,562,1384,369,10703,193
19899,30,842,1331,718,11803,124
2587,75,3055,1544,1876,23910,1179
70346,4,44,143,33,2603,11
29016,11,351,1154,267,10646,84
54871,44,648,621,528,10260,120
49132,12,152,793,122,2937,30
53913,61,827,656,703,11427,124
2715,476,17924,1543,12249,164395,5675
34728,33,709,1048,500,15886,209
32748,31,882,1088,598,8903,284
10596,43,877,1466,543,12145,334
41928,61,1616,898,1247,42835,369
12735,22,1230,1445,777,17950,453
10744,82,3623,1465,2264,38490,1359
21078,1,131,1310,89,8642,42
59025,3,56,499,36,2106,20
33414,19,490,1076,323,9768,167
70258,11,197,145,172,4829,25
2144,606,25016,1548,15698,64002,9318
51268,9,121,737,92,7014,29
54073,248,3055,650,2505,63744,550
6557,339,17574,1498,10876,245909,6698
9157,641,31954,1474,20924,181791,11030
54698,0,258,628,197,5141,61
27789,4427,64664,1178,45544,253420,19120
1986,44,1261,1549,930,32889,331
63192,8,49,363,41,3065,8
54466,678,13950,636,10105,53868,3845
54172,1975,53618,647,38890,157523,14728
24470,8,208,1251,154,11286,54
58130,22,278,529,240,10660,38
19047,9,199,1346,147,8833,52
15665,23,772,1404,588,16231,184
17699,2387,63762,1370,44136,365415,19626
26509,174,2912,1207,1734,16429,1178
380,32,1332,1561,931,35863,401
31052,196,5045,1115,3659,34356,1386
12290,18,618,1451,362,10328,256
8213,529,6796,1478,4623,25183,2173
42796,2193,58929,875,47327,399827,11602
37711,38,899,972,697,21276,202
9809,134,2528,1471,1559,23813,969
67086,24,427,250,339,3700,88
33206,142,4721,1080,3211,29230,1510
24695,15,455,1246,274,8523,181
67724,11,68,230,60,1506,8
65318,68,1107,301,902,12437,205
54968,11,329,618,183,5504,146
27816,62,1476,1178,947,21422,529
17131,0,0,1381,0,6843,0
28364,20,1157,1167,655,8349,502
11608,201,13148,1458,7862,103755,5286
2163,5,577,1548,401,6711,176
19341,83,2113,1341,1376,32832,737
33129,45,1435,1081,887,11629,548
13150,141,5872,1439,3743,85273,2129
20796,53,1401,1316,1036,27841,365
23493,1,58,1271,50,7103,8
24142,120,1579,1258,1158,11485,421
49026,20,456,796,373,7197,83
2936,98,1792,1541,1151,23476,641
7557,0,16490,1485,10753,141917,5737
31764,70,2103,1104,1566,19105,537
9962,2203,42827,1470,24325,97799,18502
17972,27,899,1364,714,17073,185
15644,1,160,1405,76,16153,84
66483,45,532,270,425,7612,107
68937,22,559,189,426,11444,133
22865,4,492,1282,325,9710,167
35884,10,440,1021,330,8724,110
20203,124,4057,1326,2723,17343,1334
41279,312,5383,909,4393,53126,990
62274,9,183,387,132,5399,51
19198,63,1381,1343,989,18464,392
36156,65,978,1013,754,18560,224
41303,34,430,909,350,10855,80
13436,63,2793,1435,1553,15770,1240
4562,34,2888,1523,1838,66642,1050
19983,219,9110,1329,5716,62941,3394
21315,186,5503,1306,3017,50334,2486
29322,27,423,1149,322,6184,101
54169,187,3294,647,2602,29684,692
6455,17,417,1499,307,20604,110
56708,92,1019,569,806,9417,213
30576,27,1075,1124,675,23511,400
8496,30,1037,1477,710,37454,327
59244,135,2605,492,1915,13735,690
24085,100,2894,1259,2007,30564,887
54411,23,189,638,150,10119,39
18753,481,12773,1351,9144,158328,3629
32663,20,278,1090,194,7263,84
26692,17,776,1202,459,11405,317
35500,133,2366,1030,1668,12247,698
55199,14,227,612,142,7076,85
31415,35,939,1110,607,14958,332
27287,52,1198,1189,889,26872,309
11675,12,858,1457,431,11706,427
17499,560,12407,1374,8178,52718,4229
10864,2136,79756,1464,47477,478263,32279
66731,53,687,261,573,8387,114
48289,840,18144,818,14718,87527,3426
4144,19,772,1529,585,27140,187
6384,143,3318,1500,2318,66496,1000
18958,569,29960,1348,18202,81878,11758
16477,13,276,1391,224,19315,52
12637,2689,91633,1446,58355,239015,33278
35997,109,1558,1018,1230,21642,328
13866,72,3686,1429,2054,44664,1632
5384,403,10052,1512,6916,46384,3136
29116,13,1289,1153,778,13808,511
18035,13,549,1363,429,11124,120
69809,33,572,160,502,4492,70
33335,3108,75611,1077,52030,150191,23581
7478,1027,57956,1486,33876,299108,24080
62972,4,30,368,25,1809,5
62627,41,371,376,292,4966,79
39939,155,2096,931,1708,23144,388
44000,282,6525,869,5166,40058,1359
58735,17,255,508,197,7148,58
13101,385,28730,1440,15547,152955,13183
8254,92,2586,1478,1386,18760,1200
49540,1,63,782,48,3140,15
12472,0,0,1448,0,6712,0
28717,9,391,1160,251,10768,140
19272,19,307,1342,210,12606,97
62828,17,172,371,146,3283,26
28406,300,5097,1166,3391,35308,1706
51755,383,5389,723,4479,68813,910
8472,95,2977,1477,2213,23726,764
50146,178,2990,763,2285,40522,705
28522,1496,103628,1164,73056,338089,30572
18199,21,1021,1361,730,15109,291
14042,618,8131,1426,5510,39363,2621
47413,31,506,829,376,14936,130
43649,2828,56643,873,39594,369075,17049
11776,9,210,1456,108,14259,102
61942,42,480,398,394,6724,86
24734,27,453,1245,327,4421,126
30904,311,5268,1117,3715,58817,1553
36433,87,3447,1005,2799,25768,648
4303,11,496,1527,374,13972,122
10241,151,5770,1468,3344,80023,2426
15284,15,1210,1410,772,13018,438
17147,15,498,1380,373,10981,125
64201,1808,34011,333,26757,220810,7254
5708,9,237,1509,154,8554,83
58865,219,5175,505,4242,27984,933
69340,17,215,175,183,1688,32
16103,3476,75047,1397,54270,449050,20777
11785,0,0,1456,0,10335,0
3999,1,161,1530,99,16898,62
1950,2,87,1549,53,17681,34
7224,100,3075,1489,2046,25762,1029
4359,141,4387,1526,3157,25882,1230
23853,50,2190,1265,1459,17724,731
19267,123,6307,1342,4384,60318,1923
52285,10,175,706,115,13572,60
31791,299,8311,1104,6087,32020,2224
28784,29,914,1159,565,17563,349
7701,20,667,1483,449,27450,218
28250,3,243,1169,147,16173,96
18382,19,709,1358,507,8273,202
13341,31,1341,1437,817,33722,524
51865,47,641,720,493,12143,148
29267,56,2222,1150,1489,26598,733
8535,2919,97533,1477,66792,361834,30741
57664,20,132,544,120,5844,12
21089,236,5600,1310,4019,86247,1581
2334,6,399,1546,266,29990,133
46685,350,6515,838,4531,40728,1984
2097,309,5000,1548,3226,27199,1774
10707,45,2415,1465,1434,43370,981
10801,75,2336,1464,1463,10157,873
4202,45,2105,1528,1440,31617,665
23978,22,914,1262,603,18372,311
57067,469,5062,559,4099,37592,963
367,529,26477,1562,16425,88106,10052
64799,21,150,316,129,2871,21
13809,0,0,1430,0,20667,0
20461,92,2947,1321,2179,20861,768
34654,25,1160,1050,751,17409,409
52793,7,168,688,129,12343,39
49239,39,659,787,507,7788,152
22229,19,790,1292,543,13353,247
39764,135,2015,933,1622,20168,393
3463,18,311,1536,215,16766,96
40551,337,2935,921,1954,17945,981
32801,88,1548,1088,995,43355,553
37849,70,634,968,485,6882,149
58211,906,20155,526,14610,126576,5545
28399,18,367,1166,224,8318,143
63720,8,159,349,121,2594,38
34718,493,10949,1048,8612,75613,2337
8182,1371,42741,1478,26132,139157,16609
38306,76,1252,957,1128,18091,124
12103,52,1118,1453,644,14863,474
51693,58,1517,725,1134,11721,383
12539,298,17819,1448,10158,55872,7661
30226,14,336,1131,256,10277,80
65816,1085,28775,289,19887,123177,8888
22477,1352,53613,1289,31967,218994,21646
9700,949,83652,1471,46917,297639,36735
2181,3,95,1547,62,7790,33
11001,16,729,1462,428,10491,301
43329,426,7380,877,5873,87251,1507
54109,310,2388,649,1921,13417,467
29493,18,435,1146,259,10111,176
6892,9,550,1494,402,24449,148
15776,2630,102452,1403,63020,481992,39432
33654,13,356,1071,221,4110,135
53511,61,1290,669,1016,13535,274
20155,50,1393,1326,962,18047,431
65648,85,1090,293,921,23416,169
23193,27,580,1276,483,40803,97
38694,28,283,947,218,2438,65
13849,172,7587,1429,5229,56415,2358
66208,912,17476,277,13829,104331,3647
636,9,477,1559,358,13251,119
7526,0,79,1485,59,16643,20
2935,254,14145,1541,9151,92207,4994
64737,35,353,318,295,8715,58
12253,1242,35718,1451,24365,159715,11353
15696,69,1487,1404,874,17455,613
57598,69,621,546,483,10550,138
42608,17,349,888,189,5628,160
55596,30,309,601,236,12196,73
70361,53,602,142,563,9901,39
40695,931,12036,919,9656,125685,2380
49328,24,319,787,244,4036,75
68571,5,61,201,46,1522,15
61893,11,82,395,67,4858,15
16898,6,452,1384,311,9302,141
15437,259,8113,1408,5860,73506,2253
15444,270,32187,1408,23914,114295,8273
62034,51,462,351,349,8539,113
49498,200,3210,783,2511,30019,699
14182,38,747,1425,512,23324,235
40608,67,1060,920,822,8809,238
7774,119,4782,1482,3374,51478,1408
69276,0,52,177,41,4393,11
55107,46,991,614,769,16543,222
23077,39,1865,1278,1200,29107,665
16927,522,10654,1384,7073,66436,3581
58617,154,2717,510,2087,21754,630
58090,6,157,530,124,6437,33
7835,18,926,1481,563,11780,363
56637,14,217,571,168,11308,49
22522,7339,160517,1288,87800,496283,72717
50376,7228,109436,760,82202,322692,27234
66263,163,2916,276,2515,8180,401
55302,46,1011,608,826,14395,185
65487,10,576,297,464,9783,112
56011,10,116,590,81,8432,35
23391,10,547,1273,407,25981,140
18838,0,0,1349,0,5292,0
25470,0,0,1230,0,23879,0
59651,43,378,478,292,5401,86
61941,60,580,398,448,6583,132
37267,30,1088,984,668,12545,420
2555,5,226,1544,131,7804,95
38262,33,593,958,446,9658,147
28404,48,891,1166,645,32949,246
2209,165,4127,1547,2857,31396,1270
19698,7,331,1334,260,9622,71
62605,19,279,377,234,7443,45
40909,52,922,915,727,13250,195
37733,2,92,971,72,4536,20
28372,8,318,1167,198,6982,120
56706,21,326,569,258,7153,68
1603,2629,84227,1552,52596,248439,31631
13435,23,1039,1435,534,10359,505
69239,18,126,178,113,4067,13
10035,607,9536,1469,6823,38730,2713
47605,27,435,827,394,6053,41
26653,5474,227187,1203,141995,666450,85192
60888,179,3746,433,3014,48169,732
3175,32,1548,1538,1098,14596,450
31069,13,564,1114,406,14130,158
37622,644,11771,974,9301,73774,2470
46972,136,4156,831,3299,52455,857
67477,12,127,237,96,3545,31
484,35,1187,1561,849,42845,338
24848,38,568,1242,503,7901,65
32775,256,7522,1088,5233,56157,2289
23905,8,221,1264,163,7685,58
5770,470,16982,1508,9621,67264,7361
33160,187,4227,1081,3091,40689,1136
70139,34,643,149,625,8832,18
22198,67,1908,1293,1233,36100,675
16748,43,875,1387,598,16671,277
44151,38,1157,867,917,46307,240
63773,48,365,347,297,7522,68
63667,8,81,350,64,3822,17
13844,111,1560,1430,1012,22407,548
17479,6,324,1374,233,14722,91
59478,21,246,484,177,9017,69
3663,5,118,1534,92,10568,26
49656,20,296,778,232,12413,64
62038,53,678,395,494,9755,184
26742,151,4132,1201,2468,28674,1664
64841,49,428,314,323,5873,105
29625,18,849,1143,669,6668,180
53527,67,570,668,497,9682,73
35576,467,5821,1028,4457,54339,1364
48764,81,1440,804,1173,19660,267
68226,9,157,214,124,5175,33
65439,7,69,298,55,2118,14
30162,179,2807,1132,1996,27162,811
13114,6,348,1440,202,14981,146
68123,10,183,217,130,7252,53
39799,32639,888120,933,588773,2362635,299347
30974,42,525,1116,331,5344,194
22155,1168,35692,1293,22185,183951,13507
54333,139,3708,641,2876,31768,832
66367,4,33,273,26,3344,7
27189,1153,19007,1192,14346,101412,4661
69150,5,92,181,68,5070,24
59186,24,443,494,347,9636,96
6744,1,160,1495,126,32851,34
16708,74,4435,1388,2795,26648,1640
23711,0,46,1267,37,4867,9
60800,111,1536,437,1201,14741,335
52314,11,116,705,101,3417,15
34636,23,894,1051,671,15608,223
59256,57,590,492,485,10115,105
11281,46,2468,1460,1421,36341,1047
24070,16,416,1260,294,10519,122
68438,4,39,206,23,4101,16
22964,65,1185,1280,837,12231,348
25965,13,684,1219,396,7416,288
68080,37,473,218,330,10765,143
1383,15,353,1554,259,28307,94
43955,16,105,870,80,7288,25
35125,2153,40168,1039,30514,318009,9654
61558,38,372,411,310,9421,62
67175,1,20,246,13,2043,7
3083,221,5814,1540,4013,35881,1801
988,26,1522,1556,1129,12846,393
108,8,442,1565,276,15403,166
32156,3008,48098,1098,35875,128908,12223
6027,42,2511,1505,1567,35418,944
1628,1317,63997,1552,39642,122601,24355
68703,13,122,196,112,3418,10
2508,90,2050,1545,1335,22886,715
29466,15,622,1146,392,22210,230
30378,97,2630,1128,1524,13455,1106
24958,46,715,1240,604,28444,111
65860,11,318,288,230,4664,88
62307,326,4257,386,3290,32524,967
34754,69,1198,1048,794,8840,404
34440,7,228,1055,162,7636,66
39979,32,476,930,393,21384,83
65417,53,452,299,359,5398,93
26053,287,11239,1216,8066,67900,3173
59501,173,2328,481,1893,18507,435
34451,196,3104,1055,2162,16201,942
68183,11,103,215,91,5784,12
5720,121,5660,1508,3452,59496,2208
16080,6,279,1397,197,10909,82
20030,3,217,1328,171,11766,46
38448,1037,13511,952,10570,77039,2941
62298,153,2699,386,2276,36434,423
2601,47,2397,1544,1650,55657,747
20027,108,3858,1329,2797,29348,1061
27566,15,174,1183,112,3857,62
712,499,13283,1559,9127,108568,4156
53055,24,199,680,162,3336,37
15054,684,11552,1413,8588,62512,2964
25924,481,17730,1220,11499,83793,6231
70219,1933,33182,145,33034,218770,148
37452,1296,20684,979,15235,82677,5449
29288,4,98,1149,75,10970,23
36345,55,763,1008,619,12005,144
64838,49,754,314,537,11926,217
53521,585,6756,668,5174,51631,1582
26471,14,373,1208,246,9725,127
24707,112,4916,1245,2999,23805,1917
14765,33,895,1417,671,17289,224
58589,20,456,513,297,11512,159
63017,100,1006,367,863,19817,143
5493,480,6574,1511,4719,32016,1855
54185,615,6006,647,4348,46358,1658
995,72,4661,1556,3137,29967,1524
456,199,6010,1561,3361,47206,2649
64631,10,103,321,81,7347,22
34951,227,2960,1043,1950,48205,1010
62639,813,10005,376,8241,66450,1764
20469,91,2617,1321,1825,33212,792
4341,171,3997,1526,2704,47077,1293
16719,10,351,1387,228,14859,123
63446,164,1159,356,909,9553,250
52311,69,1395,705,1112,12882,283
18517,8,147,1355,111,9014,36
26335,1278,34566,1211,22039,199512,12527
39059,27,326,941,240,5564,86
18237,146,6630,1360,5164,45706,1466
33476,12,246,1075,161,21990,85
49513,108,1145,782,996,14774,149
58884,33,408,504,254,8905,154
51237,8,164,737,143,10073,21
70017,16,59,153,59,1585,0
57855,49,479,537,368,3074,111
40474,62,1323,922,1068,54735,255
51796,19,398,722,330,6499,68
63303,112,3563,360,2599,21468,964
52237,21,427,708,335,10915,92
16242,13,1462,1395,815,20369,647
37581,5,84,975,73,6139,11
3536,13,240,1535,169,14138,71
37724,205,5614,971,4450,82124,1164
31797,15681,334605,1103,220359,882228,114246
33111,3,148,1082,93,3390,55
22890,9,200,1281,146,10009,54
21087,41,1103,1310,706,28832,397
15213,538,20031,1411,12744,95760,7287
31854,165,2765,1103,1896,30083,869
5033,8,119,1516,63,8037,56
64337,34,540,329,437,5795,103
5953,30,749,1506,543,14433,206
23982,180,5621,1262,3639,26249,1982
15939,0,121,1400,93,12260,28
23069,9,332,1278,227,8936,105
17968,163,2081,1365,1401,19555,680
53571,711,8704,667,7270,65772,1434
51281,54,713,734,587,10190,126
57554,16,571,548,455,6011,116
52938,8,79,683,55,5270,24
53832,7,71,659,51,9004,20
11795,320,15291,1456,9814,98196,5477
57883,3,49,537,36,4672,13
52007,70,849,716,685,10226,164
24320,159,2517,1255,1631,19551,886
28597,11,262,1163,174,3835,88
12409,24,725,1449,426,14293,299
20938,33,603,1313,384,34012,219
16760,26,687,1387,476,14010,211
32390,27,805,1095,546,5587,259
14442,4,160,1420,117,14816,43
36199,7,140,1013,124,7450,16
31364,8,293,1110,203,18856,90
11386,65,2635,1460,1415,23113,1220
11744,1262,42550,1456,25642,159520,16908
32443,23,389,1094,274,7031,115
21755,238,5876,1299,3367,32645,2509
14712,2,119,1417,84,15264,35
29388,71,2524,1147,2009,81658,515
63620,23,520,352,439,6191,81
40686,86,1485,919,1321,22827,164
32930,1342,25510,1085,16200,163589,9310
9199,35,1708,1474,1153,17976,555
13219,238,5784,1439,3814,33416,1970
2030,12,448,1549,326,20766,122
57277,65,689,554,596,9784,93
7866,85,954,1480,644,11402,310
10027,11,606,1469,400,26339,206
311,9407,171751,1562,142545,635350,29206
54019,66,1123,652,921,24115,202
65470,122,1404,298,1049,8721,355
19697,21,397,1334,280,13822,117
14716,14,572,1417,420,44886,152
27357,3190,90842,1188,65198,325333,25644
49319,642,7738,787,6305,109555,1433
26995,80,2628,1195,2155,27573,473
41304,3057,77961,909,58549,217253,19412
31279,76,1222,1111,820,18477,402
921,53,2210,1557,1521,31411,689
6392,31,1205,1500,872,17908,333
34375,111,3094,1057,2402,32100,692
9296,31,1454,1474,957,15415,497
63066,54,472,366,423,5041,49
6842,145,5171,1494,3517,34026,1654
20226,149,2484,1325,1700,31184,784
13978,50,1928,1428,1300,58604,628
11417,6,852,1459,467,9939,385
66214,1,41,277,33,2445,8
18435,48,1882,1357,1405,60666,477
22895,202,4048,1281,2377,37169,1671
33208,10,358,1080,238,8556,120
21365,312,12944,1305,7904,27149,5040
43433,43,439,875,342,4557,97
10648,120,4684,1465,2606,29094,2078
17462,39,804,1375,582,14142,222
29179,118,3011,1151,1799,23613,1212
14145,31,757,1425,537,12987,220
10023,115,1750,1469,1075,19766,675
27234,2,120,1191,82,144558,38
50119,323,5022,766,4129,109901,893
42980,35,741,882,565,16589,176
6685,1113,29758,1496,20028,233006,9730
20118,501,9467,1327,6383,56207,3084
27969,18,606,1174,420,16571,186
56984,65,1272,561,984,46172,288
24978,19,1083,1239,650,11462,433
29051,0,37,1154,35,5553,2
5916,1217,37012,1506,25388,138071,11624
35275,92,2007,1034,1403,22468,604
34052,33,518,1063,319,4505,199
70441,20,190,139,187,3570,3
62676,802,23852,375,19151,80734,4701
29147,22,475,1152,322,11020,153
60361,29,395,453,326,7935,69
5446,4,394,1511,289,7191,105
52931,21,283,684,224,10344,59
60126,463,10713,461,8527,50359,2186
20402,109,2231,1322,1666,17248,565
30925,126,2640,1117,1652,29988,988
69593,3,80,167,60,3633,20
59603,261,4946,480,3623,19053,1323
54291,216,2094,643,1748,16131,346
58334,997,25161,522,18829,86825,6332
66665,11,73,264,50,10436,23
18788,150,4477,1351,3262,23435,1215
51703,2136,36224,724,29661,165383,6563
21121,302,5983,1309,4679,72500,1304
15529,4021,117172,1406,79452,744773,37720
29409,25,766,1147,460,20107,306
34862,133,2464,1045,1800,24111,664
18000,136,4879,1364,3115,36984,1764
65266,8,170,302,131,5585,39
68261,7,86,212,60,2473,26
53546,369,3405,668,2740,17745,665
35282,22,683,1035,481,10104,202
51867,11,129,720,88,3035,41
48514,5,173,813,118,3512,55
32091,246,4282,1099,2775,19076,1507
31751,132,3313,1104,2400,35829,913
46088,672,21554,846,15742,103671,5812
19862,3,153,1331,135,20982,18
55441,14,157,605,133,7621,24
20904,135,2791,1313,1674,20508,1117
20506,37,1222,1320,736,9483,486
3008,58,3391,1540,2398,46741,993
41474,57,934,906,801,24985,133
51992,227,3276,716,2881,25295,395
52844,11,131,686,90,5084,41
57247,61,614,555,525,11970,89
7290,24,752,1488,584,8721,168
48759,145,1851,805,1411,30758,440
67384,175,8575,240,7273,19161,1302
68038,68,1169,219,865,8425,304
30647,275,6252,1122,4217,73249,2035
54864,22,416,621,279,8202,137
57918,10,267,536,168,8442,99
65922,127,1846,286,1561,24154,285
2436,24,836,1545,629,19884,207
43641,1549,26937,873,20173,177882,6764
23022,4,105,1279,73,4424,32
24718,87,1504,1245,987,8205,517
49769,5,131,775,101,3563,30
59245,18,198,492,165,7106,33
51627,62,909,726,741,14324,168
58479,5,82,517,51,6784,31
2046,351,7891,1549,4519,85513,3372
12641,204,6518,1446,3611,48267,2907
12905,0,0,1443,0,22868,0
49773,66,1189,775,989,31465,200
12358,416,8295,1450,4863,35508,3432
63605,35,540,352,451,12983,89
3992,3,182,1530,126,9060,56
10509,654,22908,1466,14860,114465,8048
67375,18,134,240,103,3424,31
69416,29,326,173,288,6207,38
29425,70,1694,1147,1193,16030,501
13311,67,2066,1437,1215,17372,851
68404,6,94,208,68,4874,26
14987,12,300,1414,234,18866,66
35892,337,5504,1021,4322,69824,1182
2623,5,247,1544,148,16670,99
8625,8,258,1476,169,4161,89
55647,17,178,599,131,9736,47
7864,12,498,1480,297,7901,201
59273,1511,33450,491,26731,151157,6719
22303,2446,62111,1292,42642,255917,19469
12781,46,1213,1445,669,13692,544
17045,613,17708,1382,12206,193979,5502
48776,1207,14949,804,10831,100214,4118
61237,1040,13069,418,10218,71428,2851
31417,35,1125,1110,752,21937,373
46693,3486,43390,838,32874,152972,10516
12795,122,3772,1444,2570,68128,1202
66693,26,230,263,158,5305,72
21053,86,2001,1311,1263,37621,738
5983,15,345,1505,267,12815,78
31438,5,232,1109,167,5820,65
28197,29,950,1170,557,6074,393
27394,15,438,1187,271,9844,167
37727,24,622,971,478,9899,144
18294,13,454,1359,334,26606,120
38301,3549,74687,957,58064,298625,16623
32681,201,2506,1090,1661,17158,845
24704,4152,101985,1245,72679,501819,29306
19394,82,2912,1340,2201,37609,711
22329,436,9922,1291,7410,87383,2512
18946,36,510,1348,365,8634,145
30369,6,124,1128,100,3921,24
22126,276,9225,1294,6613,54349,2612
3897,10,622,1531,447,13777,175
15963,2605,65718,1399,44108,361631,21610
41088,22,297,912,222,8640,75
9350,37,422,1473,306,12579,116
52211,8,78,709,56,2326,22
69265,4,60,178,53,1301,7
59618,9,109,479,78,2352,31
32983,58,2337,1084,1608,19841,729
24153,13,459,1258,323,15188,136
57494,12,236,549,158,6652,78
18729,102,2784,1352,2022,45448,762
54257,23,138,644,105,7373,33
37426,1,56,980,43,2769,13
25654,4927,100372,1225,63531,405764,36841
56592,6,77,572,65,4910,12
29611,438,18207,1144,12157,51685,6050
60382,157,1984,453,1689,36567,295
6510,0,74,1498,44,7607,30
7742,288,14622,1482,9251,183906,5371
38440,2602,49061,953,34315,93012,14746
35309,80,1226,1034,1039,18368,187
41432,13,335,907,276,18271,59
68296,2,33,211,25,1961,8
13281,1576,69308,1438,45783,344799,23525
49852,168,2120,773,1584,19065,536
10799,42,1327,1464,840,41634,487
19283,1829,37138,1342,21460,189555,15678
15245,82,1499,1411,1077,34939,422
13454,661,14244,1435,8764,47037,5480
62122,68,1251,391,1053,15232,198
19392,6,178,1340,115,8517,63
57711,23,274,543,187,9518,87
3247,439,18349,1538,12294,99872,6055
37242,35,680,984,534,8666,146
8500,23,888,1477,539,9968,349
65666,17,160,293,136,5068,24
61561,26,609,411,464,10062,145
63073,16,164,366,124,4691,40
61567,10,66,410,55,1673,11
3759,0,90,1533,52,8770,38
48817,22,352,803,244,4791,108
61318,147,3425,418,2837,17299,588
17191,10,1079,1379,754,15482,325
13429,9396,174329,1435,105799,414747,68530
8450,40,794,1477,489,7465,305
64549,47,332,323,292,7733,40
65923,47,391,286,335,11455,56
434,11,246,1561,163,29811,83
43992,7,131,870,104,9676,27
13449,73,3332,1435,2016,16574,1316
1437,31,718,1553,536,12151,182
18732,542,5532,1352,4262,34714,1270
25283,189,2205,1233,1371,14348,834
32721,44,1893,1089,1182,23479,711
32608,124,1420,1091,942,9758,478
23051,2,84,1279,66,30640,18
35647,1027,21517,1027,16555,145096,4962
17210,10,593,1379,392,6581,201
37400,366,17317,980,12989,75517,4328
49174,3,60,792,50,7988,10
13136,232,9660,1439,5917,71433,3743
14310,1,78,1423,50,18556,28
41135,83,1544,911,1266,30344,278
24679,64,3493,1246,1940,32452,1553
902,28,951,1557,662,33897,289
39075,16,344,941,260,12463,84
18072,203,7872,1363,5802,78765,2070
6072,50,1100,1504,732,45629,368
9084,31,1660,1474,1073,19803,587
63407,152,2799,357,2361,16541,438
64569,34,399,322,330,5030,69
50778,69,1030,750,797,12448,233
26681,13,242,1202,147,12847,95
5504,2749,109884,1511,74925,253615,34959
16300,3,326,1394,191,8233,135
32932,29,1087,1085,763,11517,324
30459,207,6917,1126,4178,25514,2739
27073,416,12054,1194,7676,116797,4378
47635,1268,14488,827,10341,61173,4147
26891,39,1289,1198,810,18317,479
40320,20,301,925,227,14144,74
12293,303,14680,1451,8530,59848,6150
23321,93,1149,1275,775,11235,374
17950,59,3261,1365,2377,40354,884
32815,324,7166,1087,4988,47081,2178
64444,65,1864,326,1511,19357,353
51039,13,222,743,209,20664,13
37777,51,869,970,533,9559,336
57799,6,89,540,70,1634,19
952,1089,19998,1557,12789,80165,7209
23118,7,121,1278,82,6620,39
34256,91,2012,1060,1264,9445,748
45159,28,329,856,255,7771,74
63740,52,524,348,440,11214,84
22747,62,1068,1284,730,12567,338
66176,437,5949,278,4992,57226,957
36204,4,138,1012,118,4952,20
17537,16,570,1373,379,21430,191
1106,31,2296,1556,1674,53135,622
51957,542,7667,718,6358,48093,1309
66779,9,211,260,103,9567,108
690,640,10456,1559,6433,70598,4023
19010,34,3327,1347,1949,18062,1378
53520,4,98,669,79,10862,19
30666,830,25843,1122,17154,200784,8689
19301,11,367,1341,275,12312,92
7116,3,172,1490,110,18480,62
35036,94,1879,1041,1219,21794,660
57826,3,57,539,42,3382,15
57512,131,1530,549,1273,19109,257
18798,55,2136,1350,1379,10870,757
2642,60,2589,1544,1744,31343,845
31137,60,2643,1114,1659,17699,984
40323,14,196,925,153,16856,43
5335,220,4628,1513,3127,45092,1501
61552,1434,21874,411,18265,137723,3609
58931,42,725,502,459,23720,266
2142,54,3265,1548,2258,30585,1007
27872,172,4822,1176,3420,46207,1402
1493,7,393,1553,284,14802,109
10307,22,934,1468,528,17228,406
66543,61,559,268,489,10738,70
24201,30,760,1257,541,14865,219
21241,1,111,1307,91,6343,20
26343,97,2247,1210,1416,19523,831
69188,33,212,180,171,4917,41
32178,129,4547,1098,2951,28581,1596
70392,43,358,140,357,3513,1
20956,3,267,1312,210,9240,57
61491,111,2532,413,1200,20792,1332
31992,57,1026,1101,749,14960,277
23397,289,5721,1273,4194,42617,1527
32808,164,4905,1087,3352,32642,1553
65536,20,319,296,275,4557,44
54000,41,834,653,611,12319,223
21487,13,810,1303,569,17140,241
2194,566,10307,1547,6471,42546,3836
33313,0,123,1078,71,3263,52
22898,5,249,1281,181,10605,68
51415,3,60,733,47,3017,13
13315,185,4015,1437,2330,24731,1685
3126,135,4787,1539,3124,27061,1663
35929,1317,24723,1020,18184,153805,6539
30434,9,221,1126,145,6702,76
4322,314,12677,1526,7405,62365,5272
7542,43,1338,1485,924,20953,414
1305,81,3086,1554,2231,34890,855
5291,11,267,1513,179,11235,88
45811,180,2912,847,2432,55490,480
5067,50,1222,1516,844,19246,378
21882,20,721,1297,507,14894,214
53872,7492,124581,657,92468,396885,32113
55511,32,288,603,230,10141,58
8744,333,9593,1476,5982,47310,3611
64967,31,421,309,320,3729,101
10854,0,1828,1464,1085,48747,743
12295,1689,46483,1451,29416,214909,17067
69619,9,111,166,94,2929,17
9875,16,905,1470,591,10144,314
28656,18,611,1161,383,9543,228
7032,51,1179,1492,758,38198,421
12089,28,1096,1453,624,9197,472
6188,41,939,1503,623,13519,316
2611,6,220,1544,149,18737,71
26890,38,1335,1198,850,13696,485
51024,1549,27516,743,22223,104204,5293
38488,184,3637,951,3007,47678,630
17213,2,708,1379,287,29694,421
32941,0,39,1085,28,3636,11
61115,9,219,425,160,4466,59
68616,1,120,199,87,8189,33
38189,12,361,959,301,11036,60
46785,166,1049,837,815,10721,234
65114,13,265,306,150,4784,115
57967,74,1243,534,1013,16606,230
5447,10,1060,1511,718,15698,342
68848,8,103,190,84,1926,19
48592,2,71,809,55,6429,16
67467,90,1348,237,953,11031,395
17777,113,1865,1368,1386,35336,479
27092,6517,197910,1194,109291,557842,88619
23381,17,373,1273,232,3305,141
50458,39,554,758,385,4113,169
61593,526,6669,410,5479,53294,1190
25648,165,4246,1225,2179,56763,2067
36750,81,1387,999,1103,12065,284
14030,870,35895,1427,23842,192932,12053
43677,554,11015,873,8961,65398,2054
53435,817,11425,670,9196,105693,2229
50067,1013,13929,767,11091,136391,2838
10322,73,1520,1468,1037,25614,483
58188,32,491,527,372,13349,119
26690,8,109,1202,96,5132,13
11982,26,900,1454,441,8693,459
4504,52,3261,1524,2124,63194,1137
62942,35,241,369,191,4128,50
57612,4512,60236,546,45775,201318,14461
60153,76,1475,461,1160,20273,315
4820,23,469,1519,368,26984,101
22741,2088,47916,1284,32625,243781,15291
41549,257,5574,905,3048,48992,2526
65150,31,899,305,831,4048,68
57130,201,2867,558,2300,23314,567
8780,34,1431,1476,977,12705,454
58306,0,0,523,0,4922,0
20787,15413,446788,1316,266292,1686019,180496
10607,72,2280,1466,1438,24810,842
57382,23,324,551,258,4435,66
6136,232,5599,1503,3704,67095,1895
59115,77,1214,497,940,10299,274
64655,92,554,320,458,6045,96
31735,87,1187,1104,1001,44247,186
33977,730,14982,1066,11589,83259,3393
25586,37,776,1227,414,8445,362
15081,5,136,1413,85,5842,51
14574,4,298,1419,211,19948,87
8995,165,7723,1475,4993,27235,2730
29686,324,9417,1142,6431,62521,2986
51926,27,442,718,299,6317,143
34435,42,1261,1056,857,20481,404
21969,130,2206,1296,1468,16097,738
63246,154,2426,361,1913,23938,513
64153,16,249,335,207,7514,42
42004,21,313,897,257,9645,56
67015,3,72,252,49,5287,23
10334,10,521,1467,368,8749,153
6479,33,1109,1499,832,25607,277
22106,105,4614,1294,2623,27325,1991
32101,43,824,1099,619,16791,205
55848,261,8171,594,6512,51275,1659
27935,33,1062,1175,760,13967,302
26426,54,1521,1209,1131,29369,390
66365,12,227,274,154,9502,73
69792,37,1243,160,1051,8981,192
51881,43,437,719,353,10562,84
49246,947,39903,789,30972,216335,8931
39200,0,169,940,140,7621,29
63790,53,805,347,684,18843,121
26686,30,717,1202,442,11690,275
31957,76,2038,1101,1281,13255,757
20685,25,744,1318,529,12100,215
8251,5,493,1478,260,4630,233
22762,4,495,1284,353,8935,142
25637,14,300,1226,266,10738,34
13441,167,5024,1435,3172,80879,1852
33044,10,746,1083,479,13190,267
4329,52,1601,1526,1144,33262,457
6250,179,7290,1502,4948,52199,2342
26383,115,1689,1209,1152,14910,537
20011,46,2231,1329,1715,32471,516
9788,26,751,1471,531,22313,220
37236,89,1121,985,869,10677,252
63603,7,140,352,96,7541,44
46107,15,322,846,268,10411,54
48848,38,547,802,408,7666,139
68259,78,2158,212,1439,20648,719
8536,16,1030,1477,622,14275,408
56431,74,1126,577,959,21329,167
13701,6,112,1432,67,4470,45
60176,76,1068,460,645,9099,423
27353,143,4169,1188,2674,32524,1495
5202,21,691,1514,500,25993,191
64353,11,150,329,111,4809,39
69696,6,101,164,90,3720,11
27455,203,4746,1186,3330,24783,1416
11988,24,735,1454,331,10000,404
50996,65,828,744,602,19934,226
25592,31,1216,1227,749,16205,467
70024,209,2834,153,2553,15306,281
27642,44,834,1181,539,9554,295
17450,121,2329,1375,1890,38330,439
35160,23,513,1038,357,11056,156
41995,21,292,897,241,7152,51
10054,13,732,1469,487,18705,245
12163,1327,64481,1452,34763,269624,29718
55707,684,8764,598,6910,57059,1854
52951,6,136,683,104,3506,32
6301,686,27173,1502,17203,158313,9970
52065,636,10020,713,7951,72323,2069
17751,339,10757,1369,6883,30472,3874
41191,18,219,911,152,9831,67
46410,544,10766,843,7990,81455,2776
65904,25,387,287,326,13217,61
11485,408,28312,1459,13836,150571,14476
41629,473,5958,903,4600,54005,1358
23937,65,1268,1263,885,26735,383
60762,220,2577,438,2175,27720,402
37467,52,813,978,664,10652,149
23173,267,8384,1277,5797,68052,2587
20016,101,4611,1329,3237,110920,1374
6802,807,18484,1495,12160,79765,6324
13824,40,1317,1430,726,31657,591
18863,560,14838,1349,10113,123619,4725
50989,11,225,744,173,7998,52
19097,7,357,1345,224,18364,133
36080,2,53,1016,44,4499,9
53158,9,193,677,152,3070,41
1039,304,16654,1556,10861,98110,5793
20647,13,933,1318,584,14866,349
21629,82,1379,1300,887,25786,492
4137,10,122,1529,83,5935,39
31882,861,22891,1102,15554,106723,7337
53421,26,206,670,176,8684,30
16564,13,392,1390,254,16303,138
50281,1068,21076,762,16259,100089,4817
20585,0,105,1319,63,9971,42
67878,16,291,224,243,5181,48
8563,533,13663,1477,9779,72791,3884
60314,1110,11917,455,9614,60295,2303
54121,152,1475,649,1169,22946,306
2526,6,238,1545,151,6701,87
59619,187,1768,479,1520,12761,248
21320,5,146,1306,98,6040,48
1202,21,642,1555,498,15398,144
17550,114,2477,1373,1796,24879,681
1239,137,2951,1555,2183,68596,768
26908,24,721,1197,604,24873,117
42273,657,16293,894,12796,110211,3497
13997,322,10945,1427,6922,127180,4023
19265,259,5742,1342,3862,41917,1880
58192,61,1438,527,1188,13003,250
32160,6,346,1098,199,4658,147
68040,45,346,219,279,4641,67
33492,39,1006,1074,642,11882,364
26097,53,4068,1215,2878,9335,1190
65975,333,4007,285,3187,16039,820
36771,3,37,998,20,5500,17
4745,44,833,1520,617,19303,216
34153,14,243,1061,206,7964,37
329,1509,119582,1562,78798,412215,40784
7283,39,1387,1488,1048,8569,339
1174,19,541,1555,377,23329,164
39731,12,114,933,108,4592,6
24936,367,6388,1240,5363,161826,1025
18361,68,1446,1358,1020,23819,426
19034,254,4836,1346,3638,37411,1198
7423,3,132,1487,85,32568,47
26228,47848,1234288,1213,725926,3315838,508362
39840,7,269,932,167,10618,102
53547,10,147,668,107,6673,40
66371,14,293,273,234,8596,59
31180,796,17094,1066,13160,86913,3934
57877,33,444,537,310,18168,134
175,143,6200,1564,3974,56439,2226
13077,3,242,1440,100,11793,142
51454,113,977,732,772,15185,205
8344,28,1280,1478,759,14868,521
14001,46,1335,1427,868,44809,467
56927,22,442,563,349,13798,93
67475,0,0,237,0,1512,0
38141,301,6840,961,5340,51051,1500
51206,25,310,738,244,5871,66
26752,84,2603,1201,1716,54766,887
8735,24,1226,1476,751,13341,475
14449,1872,53673,1420,34345,174624,19328
46211,80,1047,845,843,9065,204
41053,210,2406,912,1930,16413,476
19240,52,2821,1343,1971,31754,850
35177,104,1388,1037,990,16588,398
22768,63,2481,1284,1805,29690,676
66428,994,12068,267,9418,54087,2650
69408,186,3422,173,2747,33257,675
15366,393,14550,1409,8556,69562,5994
2469,33,897,1545,587,15612,310
3345,199,9603,1537,6565,110379,3038
25112,82,3666,1237,2551,30066,1115
36891,1969,31683,989,26570,176936,5113
46458,3286,62178,841,47440,325885,14738
37450,2497,56000,979,47168,304690,8832
51841,123,1517,721,1207,15577,310
52933,74,1117,684,864,18292,253
34394,28,579,1057,449,8812,130
10853,74,4243,1464,2210,29101,2033
11605,5,167,1458,92,3985,75
6291,81,1617,1502,1095,11686,522
9565,10,243,1472,147,5292,96
37220,21,397,986,358,16506,39
69445,4,44,172,34,1355,10
69748,2,18,162,16,4658,2
27218,5,270,1191,180,5335,90
15985,38,1034,1399,749,16588,285
50951,53,460,745,386,5533,74
32274,25,1062,1097,720,20538,342
21884,661,18853,1297,12566,86435,6287
2339,20,768,1546,555,30651,213
35667,45,784,1026,548,14374,236
57097,7,62,558,40,5002,22
48216,26,257,819,197,3683,60
28194,44,845,1170,689,7956,156
51300,461,16733,736,12444,81138,4289
14303,43,2613,1423,1496,25632,1117
17279,46,1521,1378,1105,29197,416
36302,183,2184,1009,1861,23255,323
56415,4,107,578,79,11050,28
1483,68,2852,1553,2148,50264,704
8328,2556,69662,1478,42635,195563,27027
18622,3,225,1354,183,4296,42
9179,8,436,1474,285,8114,151
16066,64,1187,1397,817,42943,370
67940,56,763,222,608,6141,155
12021,790,29373,1454,17352,165545,12021
25697,8,86,1224,70,8375,16
3839,107,4045,1532,2909,116761,1136
24226,248,4784,1257,3454,45373,1330
4274,6,245,1527,181,10805,64
60764,24,305,438,239,4069,66
30153,48,1577,1132,1085,28853,492
24950,617,17880,1240,12144,142941,5736
34532,30,985,1054,659,10617,326
54794,14,162,624,115,7951,47
34595,17,441,1052,338,8539,103
65981,142,3040,285,2372,8505,668
303,21,1678,1562,1108,41517,570
4142,4752,275599,1529,146588,1069767,129011
53610,199,2712,666,2044,14406,668
14741,42,1315,1417,850,21799,465
58796,36,398,507,326,5647,72
40632,129,1909,920,1526,22752,383
4157,104,2730,1528,1919,57630,811
25600,25,514,1227,288,3611,226
62141,3,40,390,28,1832,12
464,81,2753,1561,1665,26185,1088
15850,32,755,1401,550,17743,205
33264,17,463,1078,311,12566,152
67330,8,215,242,155,7425,60
30884,42,763,1118,481,6279,282
30317,4,204,1129,128,5124,76
21146,21,432,1309,256,8360,176
27374,108,2372,1188,1587,26285,785
26035,123,974,1217,799,10737,175
3699,33,633,1533,483,19242,150
31132,37,1572,1114,1235,16389,337
33048,67,855,1083,551,7230,304
38154,9,183,960,151,8406,32
24725,68,2216,1245,1737,25880,479
49821,0,1639,774,1036,7646,603
17889,54,1398,1366,1055,22587,343
68678,26,316,197,250,9489,66
47152,220,1600,833,1272,25427,328
36313,23,716,1009,604,12221,112
47513,334,4890,828,3749,59892,1141
3143,3202,204147,1539,118545,628573,85602
37111,137,3027,988,2595,77954,432
47467,26,349,829,288,7536,61
3796,12,375,1532,261,24195,114
12288,6,217,1451,117,7794,100
65039,81,1451,307,1228,20395,223
14537,10,188,1419,127,18121,61
22851,15,396,1282,270,7708,126
9424,2226,61889,1473,38437,188158,23452
11792,753,19468,1456,11055,96736,8413
58201,134,1893,525,1628,19199,265
21334,39,876,1305,586,15234,290
3073,20,958,1540,673,19814,285
32007,883,20668,1101,13871,71831,6797
11609,14790,292583,1458,178657,501291,113926
22054,244,8335,1295,5030,94936,3305
60786,2350,39488,437,30368,232889,9120
26961,62,976,1196,623,8495,353
59919,13,149,469,119,9373,30
25095,1766,59316,1237,38220,341747,21096
41408,13,228,908,197,7513,31
8929,13,448,1475,307,6178,141
57486,45,293,549,236,6249,57
10746,1222,20374,1465,12796,109122,7578
66577,15,186,266,152,5641,34
39643,46,624,934,481,13655,143
15317,2411,50594,1410,36455,208875,14139
49036,25942,567693,796,437664,2155180,130029
70307,18,150,143,136,2879,14
17430,55,937,1375,776,17506,161
23511,50,2077,1271,1477,40310,600
32685,692,22211,1090,16352,162759,5859
30906,156,3425,1117,1940,27559,1485
573,489,15225,1560,10050,100438,5175
5563,126,2575,1510,1837,115280,738
65205,3,119,304,93,13548,26
29035,68,2229,1154,1249,14162,980
68575,3,62,201,46,2300,16
51639,61,610,726,461,8352,149
10980,124,1615,1463,1147,26937,468
14577,4,291,1419,190,11419,101
45905,40,1166,848,847,8728,319
8899,19,1131,1475,680,20898,451
17597,57,1025,1372,760,14391,265
29879,1685,26261,1138,18126,77326,8135
28138,26,377,1171,260,9525,117
9402,138,3015,1473,2038,12853,977
67220,36,615,245,480,7353,135
9942,29,1024,1470,637,7948,387
11432,98,5618,1459,3420,60369,2198
58519,1107,24998,515,18611,161663,6387
26589,143,2946,1205,2086,39846,860
31077,5,269,1114,185,6022,84
13253,28,790,1438,567,10960,223
4988,68,2991,1517,2070,51142,921
55631,7,74,600,60,4941,14
6796,79,4108,1495,2822,37629,1286
61289,1070,15354,418,11260,44937,4094
49501,42,590,783,438,23409,152
67576,4,101,234,81,3111,20
61449,18,184,414,157,5104,27
83,667,24984,1566,12764,68497,12220
53172,605,6604,676,5409,34028,1195
36119,18,540,1015,404,8673,136
56915,5,72,563,57,6859,15
53481,7,184,669,151,12447,33
60558,61,725,446,539,20883,186
10679,0,81,1465,53,2797,28
8812,77,3866,1475,2483,54467,1383
33330,2065,33866,1077,22462,75325,11404
13793,18,962,1430,606,49255,356
33085,71,1016,1082,700,7807,316
31890,160,3866,1102,2612,23245,1254
13226,46,753,1438,477,14752,276
9098,62,2165,1474,1368,24966,797
26298,47,961,1211,637,13205,324
15648,498,13671,1405,9092,62870,4579
13168,0,151,1439,78,6200,73
4940,22,559,1518,393,16135,166
27862,13,804,1177,502,12911,302
33367,485,12464,1077,8728,66729,3736
55325,9,138,608,89,10794,49
60071,96,1213,464,911,16046,302
2927,47,1504,1541,928,72948,576
62567,5,131,379,87,5682,44
25465,83,1783,1230,1340,27898,443
64866,8,125,313,88,6344,37
11460,70,3541,1459,1680,32735,1861
13606,4159,112204,1433,73623,393245,38581
60142,315,4881,461,3553,31177,1328
37665,3493,62019,973,48956,397404,13063
60442,27,175,450,138,5455,37
51296,11,206,736,151,5359,55
19810,14,215,1332,157,18620,58
35274,16,445,1035,312,12631,133
65277,154,1486,302,1205,13618,281
64115,6,49,336,34,4036,15
357,41,1767,1562,1145,94103,622
17425,58,1198,1376,941,21150,257
58102,38,433,530,372,14715,61
22742,151,3713,1284,2539,31423,1174
15964,60,1347,1399,907,21426,440
64329,73,1329,330,1074,12675,255
64950,18,244,310,197,6822,47
813,79,1706,1558,1319,25701,387
57266,7,68,554,48,3631,20
3805,11,199,1532,135,17943,64
23410,4,210,1273,159,11299,51
5264,91,2844,1513,1896,24433,948
51387,9139,131802,733,105605,660504,26197
5337,2,87,1513,72,14216,15
7819,303,12869,1481,8033,90713,4836
29389,18,1136,1147,870,32100,266
29953,405,7461,1136,5506,98350,1955
23993,291,12295,1262,8436,86085,3859
50436,152,2104,758,1672,16591,432
34558,26,542,1053,425,13171,117
16240,159,8291,1395,5460,68870,2831
66093,12,96,281,79,4204,17
55070,1070,15035,612,12887,129190,2148
1507,8,934,1553,539,23058,395
41889,196,1954,899,1386,25598,568
26822,2083,63054,1199,40443,167506,22611
11588,75,3235,1458,2066,24237,1169
23087,3757,76906,1278,52724,321249,24182
5066,110,2707,1516,1900,21925,807
40124,41,441,927,353,18949,88
30354,41,1118,1128,948,17161,170
42648,150,2952,887,2532,32056,420
38844,5,164,944,127,7147,37
35228,122,1989,1036,1533,24818,456
22095,16,441,1294,308,7253,133
53892,88,2212,656,1809,14802,403
59893,223,3207,470,2572,17779,635
59001,8,44,500,36,1995,8
52999,15,353,682,258,17325,95
63702,1942,34930,349,28324,130242,6606
28697,398,9062,1160,6201,34135,2861
49862,15,178,773,131,6826,47
48261,3,187,818,107,7236,80
5578,61,1290,1510,861,34778,429
28419,119,4255,1166,2601,20124,1654
10760,12,215,1464,130,4868,85
28933,25,370,1156,308,25307,62
48646,17,194,808,139,7538,55
51547,22,123,729,100,6459,23
50305,24989,501387,762,273567,1726591,227820
30443,25,968,1126,663,14320,305
28062,173,2015,1173,1475,19304,540
51526,68,898,730,701,27908,197
56881,17,477,564,409,6698,68
25355,7,270,1232,172,7583,98
31917,17,292,1102,229,8790,63
57379,277,4094,551,3123,35920,971
5476,54,4289,1511,2929,39485,1360
68285,17,364,212,260,3523,104
68487,10,145,204,121,5088,24
59012,197,3440,500,2431,13817,1009
54926,27,193,619,158,5459,35
611,1060,46447,1559,29295,250776,17152
29595,0,0,1144,0,7571,0
45790,100,1695,850,1267,13492,428
48518,167,1816,813,1424,16454,392
56110,20,245,587,175,13445,70
20444,23,1703,1321,1130,27559,573
62478,11,115,381,97,2601,18
52564,54,834,696,714,25415,120
24137,373,17858,1258,11560,128330,6298
67377,186,2993,240,2579,21480,414
37966,3,112,965,93,6169,19
26213,3,88,1214,58,2841,30
34567,17,367,1053,253,14411,114
8179,276,10201,1478,5356,34416,4845
56580,38,654,573,507,18306,147
70619,9,81,132,68,2943,13
408,171,5878,1561,4049,32799,1829
56485,5,92,575,75,4668,17
14149,256,4478,1425,3096,19272,1382
51538,4,31,729,19,1474,12
1839,98,3633,1550,2248,24576,1385
49104,54,708,794,510,8673,198
18697,329,12931,1352,9108,115634,3823
28954,111,1485,1156,1173,23617,312
21695,635,17781,1299,10264,79553,7517
20967,24,722,1312,537,13910,185
6327,8,669,1501,241,10620,428
15048,34,657,1413,490,14695,167
41290,5,413,909,302,12901,111
12118,92,1157,1453,596,11134,561
29662,1005,23897,1143,14649,165294,9248
49606,43,1247,780,966,15306,281
2886,20,1149,1541,898,49736,251
42498,54,1220,890,947,13415,273
57832,71,993,539,776,10104,217
10202,133,3493,1468,2137,44442,1356
5988,5270,127042,1505,77092,226330,49950
4930,14,556,1518,386,15809,170
23363,108,1849,1274,1156,24354,693
32035,44,624,1100,400,15530,224
67783,17,444,227,310,8845,134
15866,6,487,1401,333,9025,154
69543,427,4656,169,3843,31668,813
3905,19,659,1531,436,37435,223
27472,6,363,1185,225,8779,138
21766,15,356,1299,229,3758,127
66133,30,386,280,313,8206,73
6268,6,388,1502,274,13280,114
64576,71,1353,322,1143,25260,210
50395,189,2639,759,1923,33442,716
67411,6,100,239,82,5275,18
26926,38,963,1197,863,24650,100
6932,44,1713,1493,1135,32084,578
45315,108,3108,855,2237,18116,871
10430,20,906,1467,532,12235,374
32072,84,1861,1099,1305,30858,556
66195,4,41,278,33,1052,8
62889,33,405,370,318,8687,87
62020,76,1114,395,954,16402,160
34402,415,6906,1056,4788,48184,2118
56636,70,1226,571,948,29044,278
66509,54,738,269,573,6199,165
20137,126,3833,1326,2722,50207,1111
3306,4335,123650,1537,78352,306721,45298
32319,5,305,1096,196,5344,109
16612,81,1524,1389,1004,31743,520
16554,42,3568,1390,2273,40818,1295
68275,37,572,212,476,9208,96
53418,6,86,670,68,4452,18
51876,7,168,720,127,7238,41
68125,1236,24479,217,19626,81725,4853
39397,63,657,938,498,7873,159
31969,23,462,1101,362,10624,100
5803,4277,138626,1507,83980,557239,54646
40095,612,7853,928,6373,48560,1480
27517,2,118,1184,67,3412,51
52327,57,618,705,513,6983,105
23114,554,9770,1278,6967,80188,2803
34131,335,6933,1062,5036,50485,1897
20271,52,1309,1324,966,22105,343
38793,132,2726,945,2126,20133,600
593,244,11707,1560,7694,57519,4013
19942,3,162,1330,114,9236,48
5182,8,345,1514,237,26863,108
29569,37,1177,1144,658,10341,519
885,1331,29639,1557,19257,90187,10382
38201,399,6061,959,4550,25114,1511
68926,19,297,189,260,6342,37
36381,168,2128,938,1773,16025,355
10442,1904,56587,1467,34536,289103,22051
68738,37,345,195,281,8680,64
33704,4262,90841,1070,63554,323411,27287
21576,837,18979,1301,10628,176507,8351
57834,30,467,538,411,10498,56
53190,6,54,676,39,4150,15
23962,945,32073,1263,20321,182794,11752
16415,52,906,1392,659,13162,247
14087,1707,45395,1426,32567,149357,12828
33248,50,1424,1079,941,11531,483
53792,192,2696,660,2234,28153,462
14544,227,11466,1419,8159,64846,3307
59085,386,8635,497,6654,47053,1981
36973,45,667,993,499,12250,168
68938,17,196,188,178,6059,18
55436,76,1024,605,821,19189,203
17339,1997,38910,1377,23533,186118,15377
56551,300,3950,573,2815,30322,1135
54387,14009,200108,630,137882,552157,62226
10457,19,702,1467,454,16004,248
3829,50474,2396202,1532,1231292,5248084,1164910
8187,72,1613,1478,1059,15317,554
24827,225,1806,1243,1287,21712,519
64417,46,971,327,761,18744,210
13132,89,3390,1439,1760,23340,1630
11551,328,8447,1458,4830,36122,3617
69102,6,70,183,61,2329,9
57175,7,110,557,92,5596,18
15235,24,746,1411,472,11226,274
65163,1060,3619,305,3262,241228,357
1365,7,378,1554,284,20500,94
22634,8,394,1286,296,18724,98
17916,721,15700,1365,9876,130353,5824
66103,6,100,281,83,2088,17
15105,21002,1353992,1413,745034,3942251,608958
29386,49,1453,1147,1162,62600,291
3509,9,874,1535,598,17911,276
64920,3,33,312,27,1028,6
54403,84,1437,639,1179,17850,258
17641,159,1693,1371,1180,13849,513
5533,75,2364,1510,1627,55538,737
11421,43,2928,1459,1687,22228,1241
5710,26,606,1509,400,16947,206
33626,21,334,1072,209,6824,125
55688,9,128,599,110,9084,18
51779,35,485,722,349,4458,136
32043,32,849,1100,607,5876,242
58801,8,46,507,38,2894,8
51741,4,70,723,50,5015,20
47609,31,247,827,209,8278,38
65552,10,73,296,59,1435,14
29730,3845,82798,1141,53420,293841,29378
23876,10189,260273,1264,178149,803106,82124
65035,168,2054,307,1829,17361,225
37201,52,720,986,593,7109,127
54134,189,2013,648,1591,14939,422
14639,0,131,1418,98,7169,33
64978,164,2346,302,1858,24265,488
10609,68,3899,1466,2281,47896,1618
28119,125,3331,1172,2200,20414,1131
36244,15,154,1011,139,8646,15
9658,17,621,1472,431,10219,190
8085,7,183,1479,126,6355,57
61993,8,92,396,70,5333,22
10017,37,1201,1469,818,16153,383
5406,38,829,1512,607,18922,222
12473,107,3310,1448,1851,35430,1459
13716,64,5579,1431,2990,18811,2589
42203,12,274,895,214,8016,60
26113,11412,418206,1215,291782,1184461,126424
12018,3,237,1454,118,14823,119
1073,102,3443,1556,2320,46844,1123
32673,33,1517,1090,924,12156,593
51966,18,270,717,223,7113,47
63889,38,376,343,281,5106,95
5989,54,1716,1505,1218,72662,498
33850,147,2323,1068,1616,21090,707
6177,1,68,1503,55,4470,13
30869,143,4830,1118,3481,43329,1349
58584,32,502,513,400,8994,102
57236,1280,30742,555,24617,89880,6125
62464,6,73,382,53,4467,20
30499,163,5531,1125,3813,82345,1718
63749,0,0,348,0,3145,0
5271,232,4220,1513,3018,27227,1202
51124,90,1316,740,1138,12598,178
48825,9,199,803,163,5927,36
24741,37,1452,1245,944,34167,508
65512,20,104,297,90,2560,14
21904,12,368,1297,250,18701,118
20757,24,760,1316,532,19505,228
30149,63,1966,1132,1603,26457,363
68993,17,239,186,187,3732,52
38217,502,7413,959,6107,84654,1306
39819,8,153,932,114,5734,39
58827,4,65,506,55,3329,10
31909,1551,24309,1102,16937,73329,7372
56300,13,178,581,150,9860,28
62232,31,536,388,379,9614,157
4753,470,18699,1520,12271,138659,6428
12816,6,596,1444,260,5665,336
22683,189,3751,1285,2567,124234,1184
29432,1160,21786,1147,14859,117359,6927
31812,3,78,1103,55,6199,23
65463,12,131,298,110,3611,21
68468,13,175,205,135,2673,40
11275,8,686,1460,406,25949,280
28570,26,317,1163,205,5775,112
58688,43,487,510,340,8234,147
3496,152,6902,1536,4774,77535,2128
64384,12,68,328,61,2163,7
27298,43,1536,1189,918,31304,618
1886,13,684,1550,454,15983,230
3630,13,436,1534,314,19610,122
22184,1175,17479,1293,10145,76451,7334
36841,14,179,997,164,4609,15
48267,4,69,819,48,1943,21
48750,0,0,805,0,16852,0
42674,104,1985,886,1623,41621,362
31200,8,171,1112,100,5074,71
61344,5,97,417,87,5433,10
29772,34,419,1140,285,9042,134
68380,99,1653,209,1423,17830,230
23570,51,1626,1270,1257,24523,369
302,78,6042,1562,4448,32175,1594
20190,65,5131,1326,3610,63879,1521
41019,24,364,913,260,7151,104
32048,23,1155,1100,812,13626,343
19768,134,4835,1333,3492,44683,1343
49354,24,445,786,354,8577,91
15011,600,34951,1414,22971,218279,11980
5029,5,411,1516,339,36239,72
62139,2,75,391,44,3200,31
41856,9,220,899,158,11248,62
61278,144,2070,419,1508,7647,562
3843,3,222,1532,136,9418,86
4105,7,197,1529,140,11356,57
22866,36,985,1282,734,24517,251
2173,62,2586,1548,1739,44231,847
56624,9,112,572,86,5747,26
49464,21,234,784,181,5328,53
7882,215,11098,1480,6855,110065,4243
24302,63,2654,1255,1715,48154,939
31060,21,612,1114,342,6052,270
5186,3021,93220,1514,58281,301827,34939
4364,28,1678,1526,1239,28023,439
61989,4,42,396,35,6886,7
30328,96,2385,1129,2064,47014,321
58068,8,61,531,51,4669,10
69118,5,65,182,58,1517,7
13859,23,1151,1429,670,12153,481
50241,198,2810,763,2238,24704,572
32181,247,5486,1098,3857,34736,1629
59055,46,500,499,397,3795,103
10699,0,3014,1465,2020,16275,994
59148,38,808,496,444,6329,364
49079,14,177,795,134,6774,43
37729,155,2195,971,1746,19354,449
20488,26,1025,1321,718,9180,307
61310,26,306,412,239,3911,67
34125,21,640,1062,418,10007,222
21292,14,478,1306,323,18216,155
25394,56,3225,1231,2125,37335,1100
58170,114,2625,527,2085,17103,540
38369,8,92,955,62,3249,30
28930,31,748,1156,538,7119,210
2328,7,186,1546,138,19321,48
14420,27,877,1421,597,27613,280
43151,9,255,879,209,4787,46
48041,15,404,822,323,18210,81
27033,80,2735,1195,2321,29474,414
70181,37,237,148,232,6196,5
8810,158,7763,1475,4450,43239,3313
31887,26,1740,1102,1154,7885,586
65176,76,1968,304,1341,24253,627
40439,7,141,923,127,5829,14
21314,216,7411,1306,5177,73490,2234
60256,4,67,457,57,1961,10
62222,3,115,389,84,1810,31
32412,158,2248,1094,1672,15819,576
12914,24,1053,1443,696,18100,357
3701,5,469,1533,294,32276,175
20472,24,1271,1321,872,16623,399
10437,234,6431,1467,4172,60686,2259
54267,29,427,644,354,5529,73
37946,1108,89886,966,64076,232127,25810
4911,208,12026,1518,7263,107870,4763
54219,340,8201,645,6386,58125,1815
60135,188,12874,461,9155,34896,3719
18951,2,99,1348,78,7661,21
55240,5311,80828,611,56434,222882,24394
20779,267,4219,1316,2969,24473,1250
68387,746,8044,208,6244,24553,1800
12225,0,0,1452,0,19718,0
50042,78,739,768,602,16491,137
66308,9,107,275,86,4562,21
51781,3,103,722,91,5684,12
194,788,32039,1564,21800,143219,10239
14106,19,1352,1425,893,66101,459
70191,2,61,147,57,3458,4
60804,1137,24504,436,18173,92626,6331
23840,46,1060,1265,757,11256,303
47126,1,90,833,72,6177,18
7727,30,1660,1482,1083,18744,577
452,2,137,1561,88,4275,49
57644,188,2170,545,1671,23927,499
40211,6,335,926,247,6618,88
33166,21,540,1081,276,5647,264
34544,4,57,1054,50,2285,7
11965,843,19495,1454,11741,68244,7754
58434,3,25,519,20,2411,5
49420,17,239,784,170,9362,69
53156,15,200,677,164,7797,36
4574,15,529,1523,368,15148,161
41550,357,9270,905,8056,86821,1214
19887,164,4217,1331,3179,219155,1038
60730,2812,47696,439,37317,247686,10379
16220,3,139,1395,86,5823,53
3918,84,5940,1531,3899,58293,2041
6597,42,1913,1497,1390,33318,523
28817,74,3035,1159,1827,19420,1208
15377,0,0,1409,0,12756,0
27752,20,483,1179,335,23382,148
43577,48,499,873,386,5979,113
12129,170,3185,1453,2205,42427,980
55724,16,185,598,137,7885,48
18112,1705,51976,1362,35606,255781,16370
21614,9,482,1301,313,4811,169
58815,320,3219,506,2257,26833,962
23254,126,1658,1275,1085,23074,573
59935,619,16280,468,12667,66233,3613
50702,30,1218,752,931,8811,287
48997,150,2395,797,1894,40949,501
10510,428,14667,1466,10045,107808,4622
48891,16,177,801,117,3971,60
43873,128,1761,871,1272,14194,489
41585,170,1502,904,1153,22577,349
5284,1084,42668,1513,27459,203397,15209
22820,83,3511,1283,2515,38093,996
22918,32,625,1281,467,15646,158
57914,11,183,536,155,7674,28
70238,14,147,146,138,11509,9
13437,185,2591,1435,1529,19561,1062
53387,32,627,671,493,6346,134
70444,62,334,139,328,3077,6
61210,6,120,421,73,9407,47
3106,62,2339,1539,1713,17053,626
61116,11,234,425,96,3558,138
57238,48,436,555,332,6614,104
15622,132,3493,1405,2672,110067,821
20149,5,212,1326,164,6643,48
3202,2,76,1538,48,9931,28
30054,106,3829,1134,2380,21444,1449
36420,50,1428,1006,1106,17073,322
30703,131,2414,1121,1597,13844,817
85,39556,2317546,1565,1333630,4961148,983916
15922,12,148,1400,99,8186,49
51383,291,9120,733,6461,25602,2659
7665,222,7422,1483,5121,66275,2301
50683,84,1081,752,842,16744,239
364,25,956,1562,609,6332,347
31395,14,415,1110,253,6914,162
17632,161,4621,1371,3211,33095,1410
28602,57,1403,1163,893,24621,510
33192,137,2973,1080,1930,27687,1043
2349,34,1304,1546,913,11173,391
12992,187,7015,1441,4279,44439,2736
4744,471,37794,1520,22213,238972,15581
36337,168,1924,1008,1330,11382,594
40192,13,137,926,118,5644,19
18337,18,464,1359,329,8550,135
23263,255,4579,1275,3524,61566,1055
31204,702,11228,1112,8750,82403,2478
49460,42,557,784,453,13616,104
68788,84,1612,194,1263,15882,349
20999,6,173,1312,115,12400,58
33462,1638,42455,1075,30600,220009,11855
63766,2365,30272,347,24004,79454,6268
62329,24,159,385,116,6148,43
8753,102,4139,1476,2502,22675,1637
64027,11,149,339,96,3940,53
4048,13,829,1530,572,40058,257
11950,14,209,1454,125,13178,84
37645,4912,78637,974,62970,382617,15667
36298,51,1469,1010,1278,20536,191
2041,560,22176,1549,11972,110537,10204
57974,21,247,534,192,9627,55
55784,6,49,596,40,2487,9
35152,13,378,1038,241,20297,137
58845,47,637,505,542,22510,95
30858,12,229,1118,150,23247,79
21765,3095,53541,1299,34332,119212,19209
25091,311,14080,1237,7701,151706,6379
32061,9,211,1100,152,6058,59
586,634,15709,1560,10865,131434,4844
24028,18,438,1261,292,8123,146
51553,47,594,729,484,11757,110
59198,1,23,494,17,1727,6
14638,42,969,1418,669,51781,300
33426,15,532,1076,364,32568,168
68498,55,1967,204,1169,16793,798
69349,3,24,175,19,1752,5
700,0,67,1559,48,5335,19
20401,32,599,1322,420,11993,179
63006,18,271,368,202,13942,69
34810,16,262,1046,178,10016,84
67930,7,117,223,95,4497,22
49738,22,312,775,202,8594,110
11942,648,19530,1454,12218,188227,7312
37926,70,1396,967,1199,35455,197
60195,12375,351663,455,244282,1302357,107381
30871,22,731,1118,505,4738,226
21779,44,1763,1298,976,19747,787
49320,18,487,787,394,3092,93
1948,33,589,1549,411,12146,178
29542,64,535,1145,365,5126,170
29381,2452,57847,1148,38016,247720,19831
69742,44,544,162,449,5547,95
51655,566,7743,711,6157,36396,1586
50929,42,503,746,363,11494,140
70255,4,48,145,32,2113,16
12683,1184,58695,1446,37086,273103,21609
3677,215,5600,1534,3388,48965,2212
54111,64,859,649,663,9546,196
54474,225,4489,636,3477,21176,1012
33139,3,31,1081,26,1861,5
60127,223,4205,462,3334,36784,871
22621,502,23481,1286,15947,269850,7534
36462,28,760,1004,601,9068,159
12386,2,127,1450,79,7373,48
8295,121,2975,1478,1816,20861,1159
1809,483,15751,1550,10755,38504,4996
53455,642,10135,670,8004,108821,2131
64561,113,2131,322,1324,18938,807
18011,238,6666,1364,5007,52932,1659
6660,255,4672,1497,3339,86986,1333
63669,62,1693,350,1440,17957,253
45891,19,247,848,199,9194,48
21491,24,938,1302,680,16198,258
27400,11,215,1187,147,9726,68
63679,3,65,350,36,4383,29
62966,13,72,368,57,8386,15
62610,63,731,377,574,10595,157
38647,116,2136,947,1736,28612,400
32618,2,74,1091,48,4041,26
69172,16,187,180,166,3500,21
34290,239,7097,1058,4896,59083,2201
12453,85,3779,1449,1778,15080,2001
38462,37,889,952,682,11832,207
7445,161,10886,1486,6620,93041,4266
45954,14,351,847,293,13048,58
2646,62,2450,1544,1572,46929,878
34172,17,1070,1061,647,12445,423
49785,80,811,775,686,7808,125
49150,182,2978,793,2265,26245,713
36823,78,1369,997,1091,12266,278
29398,306,7718,1147,5246,35676,2472
7565,8,597,1485,427,14961,170
57278,30,614,554,440,9347,174
55846,282,4723,594,3773,29187,950
53145,7,118,677,77,9170,41
59146,487,7136,496,5671,28018,1465
47739,25,295,825,226,7378,69
13209,134,4757,1439,3369,54263,1388
14098,32,1307,1426,804,13448,503
30596,3,43,1123,31,3165,12
55903,10,289,593,185,4881,104
37954,31,1134,966,890,13037,244
52782,2,84,689,48,3022,36
32658,46,1969,1090,1301,24076,668
32448,6516,97543,1094,62277,303704,35266
32976,4,88,1084,56,7888,32
23970,8,153,1262,115,4493,38
41093,48,1400,912,924,26680,476
6776,7,111,1495,85,11970,26
67817,1,120,226,46,1990,74
61080,190,2578,426,2076,11166,502
67315,19,315,242,255,11879,60
53641,749,7123,664,5430,42284,1693
29986,18,564,1136,358,7843,206
30005,11,250,1135,147,12367,103
8501,720,25693,1477,16968,84545,8725
49059,45,674,795,569,12012,105
11985,133,2138,1454,1178,13924,960
51151,20,252,740,188,5829,64
58426,130,1683,519,1311,29019,372
52966,60,1031,683,856,9117,175
12,29,1112,1567,667,64174,445
59793,19,307,473,239,5728,68
64690,128,1556,319,1128,17835,428
53775,30,644,661,355,8178,289
247,6710,157378,1563,94899,433963,62479
70014,6,105,153,86,3517,19
37571,11,231,975,187,11094,44
3112,73,1321,1539,969,10765,352
11527,120,3869,1458,2420,23293,1449
34825,22,360,1046,266,5991,94
43465,2,50,875,39,5683,11
40631,38,951,920,663,20304,288
14355,116,2993,1422,2122,66827,871
10880,115,4771,1463,3137,32834,1634
51082,81,579,741,536,12583,43
29478,103,4092,1146,2629,37560,1463
48582,191,1364,809,1007,21059,357
64133,16,134,335,108,3826,26
10281,2086,43319,1468,28968,177405,14351
29704,16,605,1142,343,6787,262
842,40,1521,1558,1062,29626,459
19100,54,2530,1345,1536,15877,994
14873,30,1530,1416,882,12162,648
60063,179,3181,463,2434,54075,747
29797,66,1812,1140,1560,26052,252
6457,18,1414,1499,921,13916,493
53155,43,588,677,461,5214,127
5615,81,1837,1509,1258,16865,579
8375,35,2475,1477,1530,51197,945
2120,5,106,1548,65,14307,41
38256,16,443,958,337,6225,106
35494,113,1853,1028,1336,17011,517
38002,11,156,964,107,12733,49
49657,101,1635,778,1338,48311,297
29511,19,733,1145,438,14279,295
862,538,27363,1557,18558,133043,8805
43921,4330,74165,866,53013,276597,21152
36095,35,672,1015,555,14185,117
32602,315,7244,1091,5372,32726,1872
17002,189,4207,1383,2529,31513,1678
66480,38,459,270,360,4052,99
35057,81,1523,1041,977,27709,546
6474,15,454,1499,332,12337,122
1112,16,550,1556,405,42367,145
5039,10,208,1516,132,10342,76
48561,54,470,811,355,6326,115
9939,8,396,1470,242,12600,154
64613,26,620,321,467,16923,153
58118,262,5120,529,3944,14873,1176
51790,12,564,722,381,6252,183
536,17,684,1560,444,19645,240
12130,27,1769,1453,964,14115,805
16024,24,668,1398,464,12527,204
53758,43,732,661,555,6821,177
21721,203,3206,1299,1985,40122,1221
44517,75,1164,863,943,12513,221
11322,244,3607,1460,2595,29923,1012
68932,4,50,189,36,2496,14
9540,533,8568,1472,5479,41477,3089
68004,11,73,220,62,3108,11
66400,45,997,221,684,8797,313
56247,14,191,583,148,5811,43
15408,14,449,1408,330,10819,119
17667,4,161,1370,127,7242,34
28970,74,2265,1155,1472,52510,793
64582,29,443,322,320,4911,123
10969,2,248,1463,128,8883,120
50148,140,1371,766,1136,10157,235
40978,31,417,914,288,20499,129
36257,17,331,1011,305,13646,26
60510,28,328,448,250,4153,78
41859,33,371,899,263,9464,108
37177,843,15891,987,10919,100877,4972
16675,7,178,1388,139,8300,39
59559,686,12615,482,10155,53976,2460
18783,8,197,1351,161,5350,36
14921,29,1363,1415,991,27003,372
18484,45,1887,1356,1300,15937,587
22685,14,575,1285,399,23696,176
58378,587,15059,520,12486,62450,2573
4416,15,399,1525,257,6698,142
26852,118,1760,1199,1230,33750,530
11333,33,1056,1460,595,14052,461
37402,207,506,980,408,15485,98
68433,11,100,207,87,5807,13
64749,2,27,317,16,2924,11
39774,14,223,933,185,5551,38
61327,19,241,417,192,5407,49
64988,52,451,308,361,8307,90
46245,88,1063,844,887,10278,176
67263,108,1956,243,1699,23299,257
8841,169,6753,1475,4422,52657,2331
39754,12,201,933,157,13349,44
20724,42,1197,1317,908,37979,289
15683,0,86,1404,61,4405,25
31066,60,1480,1114,961,20644,519
60965,70,997,430,737,7982,260
49802,33,809,774,643,15280,166
33522,69,2061,1074,1418,13682,643
59997,210,3406,466,2323,20621,1083
6171,7,221,1503,143,14971,78
57596,9,52,546,46,7041,6
37162,44,823,987,692,15003,131
4596,3,561,1522,357,12841,204
62167,53,1868,390,1485,15524,383
67962,13,117,215,89,1991,28
29286,191,5086,1149,3146,40241,1940
3901,151,7183,1531,4455,30014,2728
4976,4,190,1517,142,11957,48
2561,38,1246,1544,872,33199,374
8511,38,1232,1477,864,14259,368
46787,127,708,837,564,8463,144
51996,11,218,716,183,7219,35
58318,13,93,522,75,4846,18
21562,293,7793,1301,5133,42113,2660
36403,53,873,1006,733,24963,140
28909,7,415,1157,246,11737,169
10025,15,272,1469,183,5464,89
63466,52,600,355,411,5795,189
42406,249,4008,891,3128,69894,880
21768,49,1343,1299,900,14709,443
67678,23,235,231,190,7604,45
9748,29,718,1471,511,13743,207
6342,31,679,1501,447,7743,232
35815,758,10544,1023,8512,38002,2032
60150,201,4274,342,3532,39016,742
58976,36,490,501,364,10778,126
30246,18,407,1130,232,6623,175
48617,16,208,809,151,5246,57
50949,3,98,735,58,3844,40
56427,2,104,578,74,4876,30
68054,14,295,219,219,5022,76
60856,113,1049,434,872,9039,177
32124,85,1876,1099,1183,24950,693
53695,19,205,663,163,8640,42
32095,27,396,1099,288,17746,108
66984,85,1404,253,1071,27986,333
47616,12,178,827,138,6547,40
69773,47,592,161,530,8300,62
43139,2,108,879,84,5517,24
21005,21,983,1311,700,12298,283
61123,291,3557,424,2816,34136,741
68805,178,4028,193,3332,24792,696
6704,43,977,1496,596,9827,381
21233,21,342,1307,226,7452,116
34622,19,448,1051,306,9541,142
7573,18,753,1485,441,14881,312
7788,5,206,1482,146,12820,60
24798,171,3640,1243,2346,29165,1294
59533,182,3661,482,2896,25576,765
38549,1012,19400,949,14936,160652,4464
22748,5,147,1284,89,6099,58
11074,1262,61214,1462,34417,256135,26797
956,556,24644,1557,16596,123318,8048
52677,2475,48715,692,34461,137458,14254
9519,12,750,1472,487,7271,263
57477,27,221,550,174,10376,47
17594,416,15463,1372,11385,131679,4078
57908,167,2131,536,1778,31178,353
522,4042,154616,1560,91860,397055,62756
15257,28,857,1411,608,13291,249
59547,1887,68341,482,46695,121124,21646
13233,257,9085,1438,5482,57947,3603
36508,75,1517,1003,1112,20053,405
25639,9,237,1226,165,6301,72
30940,20,505,1117,328,17858,177
36304,9,168,1009,118,9234,50
15223,1136,39683,1411,29570,186278,10113
18034,20,466,1363,304,9655,162
471,228,2939,1561,1857,18198,1082
23274,13,352,1275,289,23637,63
14040,19,967,1426,585,21122,382
67931,112,1841,223,1515,27760,326
69367,4,27,174,26,1018,1
12818,49,1350,1444,804,17690,546
13274,862,13588,1438,9751,78053,3837
6838,17,339,1495,227,9352,112
21122,185,2739,1309,1949,34184,790
23464,1083,37092,1272,25439,220296,11653
34994,50,1260,1042,841,14441,419
50296,9,103,762,95,14946,8
1832,53,878,1550,645,11075,233
26888,319,9898,1198,7121,82050,2777
70512,249,3135,137,3070,16127,65
69095,26,209,183,176,3845,33
3858,40,995,1532,638,51379,357
3081,71,1992,1540,1262,20916,730
22058,20,513,1295,355,8681,158
28220,67,1781,1170,1037,22211,744
12236,90,3175,1451,1618,33069,1557
44352,27,592,865,480,14400,112
9670,87,1666,1472,1006,10556,660
49907,12,205,772,155,2711,50
62477,8,87,381,69,7064,18
30457,77,1918,1126,1195,16133,723
40634,621,11002,919,8708,91639,2294
21493,17,535,1302,402,11144,133
56935,150,2867,563,2246,14437,621
64583,71,1126,322,896,21230,230
9713,25,1135,1471,756,8416,379
15469,11,171,1407,121,5459,50
32852,37,1508,1086,999,13667,509
37635,178,3575,958,2732,39075,843
56665,1376,18363,570,14800,94127,3563
24757,43,860,1244,538,8898,322
48220,33,562,819,435,15308,127
54913,31,214,620,201,6075,13
67172,9,196,246,137,4430,59
40463,77,1313,922,1144,16132,169
9744,40,793,1471,540,9403,253
60456,20,303,450,218,8277,85
28947,1,51,1156,38,3245,13
69930,6,26,156,22,2312,4
30621,9,182,1123,118,5492,64
5618,42,1392,1509,854,15465,538
13427,184,5159,1435,2963,58068,2196
3488,1292,39131,1536,25498,176756,13633
36163,105,2792,1013,2032,75537,760
67881,8,201,224,164,2826,37
69279,10,58,177,48,4304,10
28281,15,229,1169,156,4474,73
42530,5,64,890,53,4523,11
69120,79,816,182,663,6635,153
9416,39,1682,1473,1053,23259,629
3693,2523,77253,1533,41767,140443,35486
5173,36,1410,1515,873,15359,537
16912,47,2551,1384,2115,28616,436
51234,968,21857,737,18246,138338,3611
8710,367,10834,1476,6588,59439,4246
50755,46,1168,751,638,20091,530
63003,13,381,368,267,8887,114
45862,8451,243495,849,191702,963521,51793
20129,5,263,1327,208,13953,55
61373,36,327,416,287,3230,40
22413,19,761,1290,561,16229,200
65695,3,110,292,81,5832,29
27442,50,924,1186,578,12634,346
58904,37,692,503,492,12730,200
42258,181,2297,893,1854,25723,443
49992,4,60,770,51,4034,9
69273,1,15,177,14,1437,1
66724,8,116,262,94,5258,22
61471,1725,27964,406,21416,159784,6548
14459,130,7710,1420,5153,43833,2557
14264,2,72,1423,63,4385,9
44966,234,2123,858,1665,16802,458
60242,68,747,457,557,11681,190
21631,3603,104572,1300,65229,294512,39343
10702,46,1655,1465,1095,26854,560
11160,4,158,1461,85,6151,73
27152,51,1043,1192,607,22325,436
2865,12,379,1542,273,21357,106
68844,16,417,192,404,8177,13
24858,129,2891,1242,1827,28648,1064
10568,12,481,1466,312,11742,169
22119,7213,114720,1294,64730,303148,49990
45175,22,373,856,299,12021,74
21619,11,539,1301,397,6431,142
4527,120,6930,1523,3993,36872,2937
66910,31,421,255,337,7399,84
42754,612,6409,885,4550,77173,1859
57995,53,618,532,446,11579,172
41750,29,440,901,361,10843,79
13396,175,3906,1436,2300,27033,1606
34652,4,128,1050,94,2963,34
28256,8,121,1169,84,6815,37
33578,33,637,1073,455,3811,182
62054,8,174,394,147,8297,27
32250,37,910,1097,598,16553,312
55364,2080,51518,607,38510,204649,13008
50480,3134,36186,757,28593,219397,7593
51554,7791,152849,729,122813,535263,30036
51670,4,80,725,68,5421,12
5050,312,7477,1516,4845,75406,2632
53788,115,681,660,516,5487,165
10803,13,659,1464,348,4743,311
27308,723,24605,1189,15719,161955,8886
22012,33,1061,1295,696,24315,365
31008,160,3234,1116,2135,29388,1099
62905,29,382,370,351,4016,31
58580,20,568,513,436,9755,132
53488,18,240,669,187,4451,53
59370,65,1390,488,829,15621,561
48025,285,8058,822,6122,26782,1936
21507,31,517,1302,420,12089,97
21557,8,340,1301,255,6620,85
66314,4,44,275,32,2102,12
65086,19,431,306,326,10579,105
8654,348,20822,1476,12857,79676,7965
11418,43,1212,1459,735,16365,477
31786,27,779,1104,510,11966,269
56009,11,153,590,117,5665,36
3015,51,2636,1540,1682,46133,954
56840,85,1102,564,952,20835,150
25014,282,4151,1238,2610,30753,1541
32632,41,709,1090,483,9163,226
60932,15,203,432,171,9264,32
25162,356,8051,1236,6092,133425,1959
10834,456,14147,1464,9090,131876,5057
63947,1127,17767,341,14325,109090,3442
31092,46,1243,1114,859,19825,384
62952,12,169,369,128,1214,41
31431,430,9220,1109,6206,74829,3014
52588,0,289,696,230,5091,59
20026,13,432,1329,290,6195,142
58810,165,2569,506,1990,16208,579
61346,44,1057,417,668,14610,389
69519,6,140,170,123,3855,17
20349,15,642,1323,426,7162,216
5359,14,903,1512,585,11246,318
18786,34,760,1351,452,8498,308
24471,2,226,1251,159,7144,67
349,14,578,1562,341,15742,237
60217,14,245,458,205,7405,40
9103,56,1464,1474,917,18830,547
10368,0,10,1467,5,13017,5
70226,0,27,146,19,1322,8
55099,46,981,612,761,23579,220
38292,11,213,957,191,10562,22
16572,385,7870,1390,5233,50319,2637
8996,11,365,1475,243,21992,122
44195,11,232,867,193,5821,39
11790,225,8308,1456,5360,56445,2948
33862,180,3484,1067,2595,28366,889
18904,53,1468,1348,1070,19129,398
59812,22,213,473,175,6758,38
18120,21,898,1362,554,8319,344
24087,79,2583,1259,1707,17471,876
335,32,1613,1562,1248,34340,365
66931,42,441,255,321,8448,120
56063,188,2123,588,1487,10296,636
22462,50,952,1289,662,9180,290
10118,1173,46927,1469,28252,162634,18675
34634,20,640,1051,429,13291,211
19138,3,99,1344,83,8510,16
38267,15,249,958,161,4245,88
7119,94,2013,1490,1115,43791,898
48918,935,9323,783,7864,126117,1459
28686,494,7994,1161,5344,28418,2650
50940,23,352,746,289,12666,63
39235,6,152,939,116,4930,36
59297,76,1148,490,961,10084,187
36155,2,126,1014,103,6851,23
69629,82,1668,166,1600,16307,68
51230,733,9300,738,7880,69180,1420
65698,22,185,291,142,5334,43
3357,14,329,1537,226,13116,103
30865,102,933,1118,539,13218,394
3813,162,2204,1532,1529,16463,675
42133,31,708,895,507,12223,201
61949,22,196,398,152,7021,44
65106,4,37,306,23,2393,14
19012,2,362,1347,248,13991,114
8870,48,2081,1475,1294,18402,787
13098,1703,82791,1440,44043,420289,38748
4138,58,3257,1529,2298,68705,959
65279,23,308,302,260,3978,48
1871,1,158,1550,116,8629,42
67966,344,2999,221,2284,15579,715
37427,26,313,980,260,6623,53
15143,4653,240244,1412,148726,835832,91518
56614,6481,108080,571,83465,456551,24615
57239,1209,14819,555,11999,82582,2820
50080,174,3538,767,2825,73503,713
35860,5,116,1022,82,2223,34
26078,15,411,1216,251,9381,160
40245,5782,192080,925,141732,422255,50348
31366,59,966,1110,758,6455,208
34922,17,512,1044,342,11179,170
7267,18,458,1488,287,19251,171
21817,25,850,1298,558,10466,292
6280,77,2102,1502,1465,33555,637
44248,41,704,866,531,37249,173
17438,409,9028,1375,6323,58387,2705
69202,31,205,179,165,6011,40
32939,15,128,1085,76,3198,52
20834,508,6668,1315,3652,24734,3016
23810,6,211,1265,132,9806,79
31460,44,837,1081,551,11669,286
22504,25,435,1289,300,8624,135
28527,451,19652,1164,14728,47182,4924
31345,131,4049,1110,2389,35107,1660
32226,63,1280,1097,1132,29058,148
35573,70,1929,1028,1452,14137,477
61183,19,410,422,321,7667,89
1131,104,3850,1555,2413,75073,1437
8115,22,782,1478,485,6512,297
58987,18,255,501,208,6417,47
66438,16,117,271,92,2915,25
53501,2253,25117,669,19888,165140,5229
257,9,348,1563,222,15371,126
3191,16,1217,1538,761,24870,456
34149,81,998,1062,732,30182,266
65761,729,10684,290,8780,96360,1904
18915,104,3799,1348,2551,70038,1248
39190,17818,473089,940,314562,962015,158527
3122,20,777,1539,580,27514,197
31713,11,617,1105,366,12880,251
35614,146,5035,1027,3851,65265,1184
14077,63,1953,1426,1345,22770,608
33058,22,609,1082,417,13240,192
65577,85,868,295,779,10110,89
8480,112,1726,1477,1098,18719,628
26435,10,383,1208,227,7325,156
16078,99,2702,1397,1838,18106,864
20563,17,756,1320,556,20881,200
37440,6268,229999,976,172155,853707,57844
11290,31,897,1460,526,18134,371
31718,44,1315,1105,681,13355,634
61543,88,1278,411,1075,13639,203
32475,71,1702,1092,1152,13310,550
3157,20,335,1539,249,10168,86
64146,2,39,335,27,8322,12
49410,344,6685,785,5531,44821,1154
24926,66,3443,1241,2180,30236,1263
8757,27,781,1476,495,11197,286
14095,24,1794,1426,1390,22653,404
30516,15,259,1125,167,2343,92
19989,174,3762,1329,2515,18255,1247
11650,581,52552,1457,25333,199675,27219
15568,163,3119,1406,2088,56020,1031
8373,58,1292,1477,893,10761,399
743,5760,153616,1558,103128,395711,50488
14658,8,243,1418,189,19920,54
27504,111,2362,1184,1537,33954,825
20571,167,8413,1320,5741,77825,2672
37055,51,870,990,690,12703,180
5282,125,6260,1513,4389,40296,1871
35530,57,1141,1029,778,14654,363
11243,34,1479,1461,813,25065,666
30384,5,241,1127,144,7590,97
19281,16460,515845,1342,298965,3671050,216880
43521,237,4484,874,3832,41263,652
69775,6,98,161,85,2991,13
43625,76,1433,873,1096,16657,337
63098,114,1701,365,1394,13510,307
55503,62,1033,604,848,11803,185
30018,28,675,1135,379,15412,296
777,5,362,1558,237,23389,125
2779,10,481,1543,333,21671,148
33002,2590,120877,1083,93747,344103,27130
43601,9,111,873,98,6086,13
18169,10,411,1362,305,23869,106
55152,95,692,613,518,6534,174
52683,510,6502,691,5007,49338,1495
61427,26,284,415,226,6106,58
8332,283,6919,1478,4406,31488,2513
11904,259,12519,1455,7493,109525,5026
37738,709,9542,971,6791,35593,2751
20586,1915,32145,1319,23427,172493,8718
24586,2,174,1248,150,7102,24
7014,11,323,1492,195,8107,128
25130,17,554,1236,423,27094,131
59768,7,180,474,144,4901,36
36405,52,1028,1006,779,14068,249
65002,1,22,308,15,3310,7
26815,45,729,1199,499,10594,230
49829,211,2349,774,1845,12321,504
67985,4,148,221,139,3229,9
14924,2,338,1415,259,9854,79
60083,22,185,464,151,10717,34
15832,9,270,1402,189,11245,81
50898,207,3858,747,3203,49738,655
31100,120,3574,1114,2742,68536,832
13129,146,5059,1439,2861,30332,2198
10230,60,2304,1468,1460,24207,844
63589,21,483,353,323,8034,160
45791,10,194,850,158,4850,36
64151,34,358,335,299,6999,59
9983,50,810,1470,519,14130,291
40018,34,868,929,665,36409,203
52620,5,96,694,57,7160,39
19505,115,3402,1338,2182,30799,1220
11540,127,1588,1458,916,10598,672
53092,16,112,678,83,3056,29
53923,8,66,656,54,2686,12
35846,48,1101,1022,863,19204,238
13404,185,6405,1436,3540,33146,2865
40250,26,454,925,337,7902,117
28155,77,1606,1171,1113,13591,493
22794,16,784,1283,565,15108,219
54045,89,725,652,605,6544,120
50620,15,143,754,130,7184,13
13531,9242,347603,1434,219226,1139630,128377
57896,5,50,536,42,2211,8
56369,118,1567,579,1192,17170,375
35841,44918,738439,1019,508315,2711972,230124
23076,14,530,1278,459,21674,71
52581,55,726,696,561,13628,165
20430,10,362,1322,278,11613,84
31658,16,899,1106,565,8449,334
68471,2,32,205,26,2597,6
67629,57,521,232,449,8423,72
39065,43,839,941,730,13607,109
26157,32,962,1215,615,13744,347
34930,675,15300,1044,11422,61426,3878
32601,12,723,1091,474,34960,249
36079,857,13819,1016,10901,194812,2918
4626,54,1768,1522,1225,28693,543
17610,16,1021,1372,761,30009,260
52487,5100,84663,699,64526,844412,20137
5647,24,1143,1509,629,8416,514
30000,119,2362,1135,2113,36387,249
49076,62,669,795,535,8164,134
15567,401,5259,1406,3233,51730,2026
53108,493,6956,678,5211,40315,1745
56336,2,41,580,29,2609,12
19654,3,128,1335,109,12414,19
38568,42,563,949,437,17821,126
584,109,2801,1560,2086,32358,715
30123,141,4434,1133,2816,34500,1618
49757,39,403,775,328,10048,75
27147,46,1954,1192,1235,32673,719
20075,15,438,1328,322,11182,116
2230,16,453,1547,321,13358,132
5438,5,88,1511,77,4417,11
55336,8,35,608,32,4709,3
23175,73,2428,1277,1693,53947,735
23344,3,54,1274,39,8513,15
32119,90,2947,1099,1993,35983,954
53430,12,115,670,95,4007,20
66033,554,9299,283,7284,74457,2015
19278,56,1225,1342,845,11490,380
68999,9,167,186,148,3383,19
46915,3675,62838,836,47745,231607,15093
22870,1098,30300,1282,21740,209143,8560
65987,16,330,285,254,2792,76
24078,18,544,1260,331,19578,213
32139,34,839,1099,531,20188,308
29857,45,839,1138,535,7741,304
14387,1289,29621,1421,22914,225207,6707
53652,10,124,664,87,9262,37
18738,3318,101996,1351,70398,245107,31598
29328,227,7838,1148,5473,29551,2365
24384,26,610,1253,460,20368,150
18350,141,3946,1358,2826,42053,1120
65102,10,345,306,244,9707,101
27840,303,6579,1177,4628,35660,1951
29220,33,1254,1150,769,10213,485
54314,656,7496,642,5475,27093,2021
17718,4,625,1370,311,10227,314
70598,3,63,133,58,3132,5
50391,19,208,760,169,5407,39
44572,30,585,863,362,12571,223
40308,70,1396,925,1079,22702,317
35123,413,8375,1039,5935,47026,2440
31106,10,353,1114,207,11981,146
8389,223,7305,1477,4898,76522,2407
46568,8,94,840,66,4644,28
27096,20,436,1193,270,12390,166
20182,17,488,1326,339,21046,149
4836,33,730,1519,513,29954,217
47795,2429,38286,802,30421,243675,7865
63349,645,8227,358,5951,66555,2276
28797,67,967,1159,631,14335,336
56846,61,685,564,602,17588,83
37541,6,213,976,173,17217,40
30227,3,64,1131,39,3739,25
11613,245,6980,1457,4511,29432,2469
22015,164,3361,1295,2120,31309,1241
34387,3,390,1050,220,10616,170
52170,1,17,710,17,2675,0
79,160,7361,1566,4319,75343,3042
22607,2155,49863,1287,33598,307913,16265
57216,15,162,556,119,2883,43
37171,54,1423,987,1191,37162,232
37532,25,516,976,482,15196,34
15768,216,4642,1403,3232,37112,1410
41975,37,602,898,517,14535,85
2481,13,358,1545,238,4805,120
8034,33,1039,1479,570,7169,469
38653,204,3212,947,2816,21328,396
29371,72,1050,1148,925,48143,125
62336,0,5,385,3,1872,2
44698,70,1366,862,1113,9166,253
10600,18,962,1466,614,24056,348
59886,31,442,470,340,12506,102
56,91,4212,1566,2496,23828,1716
16431,953,19238,1392,11647,90154,7591
23689,34,900,1268,627,9126,273
55398,1992,25750,606,19162,110634,6588
34838,21,406,1046,296,10039,110
15263,36,1137,1410,788,28425,349
1877,31,1460,1550,1072,36545,388
52345,10,132,704,102,4363,30
20355,47,1952,1323,1253,19367,699
31863,2,72,1103,55,3451,17
2110,52,2890,1548,1916,77964,974
9400,569,19475,1473,11731,126857,7744
34280,28,573,1058,445,4098,128
69610,140,1346,167,1224,13034,122
45440,4,108,854,84,1489,24
50770,23,365,750,299,8722,66
24856,7,236,1242,206,6813,30
68063,4,31,218,25,2286,6
7714,21,609,1483,453,23609,156
54935,72,1560,619,1120,13722,440
24035,11,532,1261,384,9247,148
58850,63,757,505,635,10671,122
65119,97,1597,305,1216,24092,381
31632,195,4008,1106,2848,34043,1160
52675,71,1256,692,977,26532,279
23477,329,4981,1272,3421,22428,1560
6787,82,3011,1495,1983,58330,1028
20935,112,2739,1313,1912,26048,827
39451,125,2571,937,1970,29086,601
59235,152,1172,493,853,7537,319
32299,27,925,1096,613,6297,312
28023,303,9422,1173,6145,77631,3277
39679,109,1676,933,1347,23974,329
35089,2018,28841,1040,20974,139155,7867
28330,20,738,1167,507,11467,231
64883,27,222,313,197,4741,25
63135,5,113,364,75,4766,38
50878,107,1470,747,1083,21692,387
18601,678,31068,1354,20929,197379,10139
16114,3,266,1397,173,12540,93
55973,155,2651,591,2383,27377,268
51070,24,185,725,152,5454,33
45851,15,284,849,178,3709,106
15699,8842,299281,1404,182541,1202076,116740
60573,15,85,445,76,3891,9
31118,564,14869,1114,9604,71704,5265
52548,376,4895,697,3819,30301,1076
67606,8,563,233,205,5163,358
2192,129,3785,1547,2643,20372,1142
4862,37630,1634481,1519,882774,3342634,751707
18982,67,1323,1347,1038,31776,285
61154,44,531,423,464,9966,67
49232,112,1447,790,1218,36195,229
50670,25,450,753,372,10773,78
58972,28,212,501,165,4177,47
28800,82,4876,1159,3006,29027,1870
32324,10,235,1096,165,7817,70
23149,128,1664,1277,1165,14624,499
27661,96,1518,1181,769,18198,749
22053,30,808,1295,500,8199,308
9754,3,426,1471,278,9064,148
27424,6,232,1186,118,14179,114
19567,22,598,1337,483,19694,115
58104,16,145,530,106,5217,39
35598,810,12914,1027,9700,82556,3214
26492,15,557,1208,359,8601,198
69251,249,5779,178,4938,33303,841
870,66,3190,1557,2262,50186,928
24952,51,1363,1240,988,17302,375
1049,43,1755,1556,1185,24349,570
22494,6,138,1289,88,8726,50
54482,52,582,636,436,5396,146
66889,19,190,256,148,3741,42
24351,2051,47909,1254,32367,217098,15542
25147,12,620,1236,372,11186,248
16761,156,3843,1387,2489,30376,1354
67024,3,81,252,28,3303,53
42917,88,1549,882,1353,33104,196
34474,102,1478,1055,1117,11042,361
7793,118,4532,1482,2610,20238,1922
8827,10,489,1475,346,13171,143
17114,2,224,1381,180,34729,44
1033,4,579,1556,375,11676,204
33511,0,0,779,0,2038,0
5379,241,11066,1512,7815,80049,3251
25429,1088,17231,1230,12393,86508,4838
39748,73,765,933,603,17591,162
68393,39,529,208,417,5977,112
46944,174,2571,835,2067,26498,504
61096,42,1131,425,840,7362,291
28594,10,253,1163,167,9286,86
22067,798,21274,1295,15061,143876,6213
61910,579,14640,399,11179,102664,3461
20708,165,2559,1317,1744,25297,815
20212,102,1996,1325,1449,21378,547
31563,42,1321,1108,856,7874,465
35159,10,186,1038,142,14632,44
14267,1081,26241,1423,17119,84223,9122
8211,10,909,1478,602,21434,307
57880,21,436,537,373,4485,63
11,12432,492622,1567,325781,4399130,166841
8679,11,400,1476,247,11989,153
52493,4,79,699,48,5070,31
54325,596,13816,642,10862,37055,2954
2748,6,206,1543,138,14850,68
64994,118,2368,309,1962,26259,406
5754,36,3834,1508,2402,35411,1432
25926,9,557,1220,334,8275,223
45756,91,2469,850,1588,11121,881
36379,6,209,1007,150,5594,59
14925,8,253,1415,164,3985,89
5573,12,430,1510,294,10266,136
56022,570,10023,589,7643,35281,2380
56515,446,4520,575,4056,42978,464
23223,14,196,1276,143,7795,53
47781,10,370,824,129,3224,241
39955,298,3901,930,3045,35353,856
16344,6,139,1393,102,11889,37
29244,31,813,1150,523,7993,290
68153,49,567,216,499,7196,68
42945,133,2771,882,2082,28203,689
59033,73,1335,499,1113,14575,222
409,675,29554,1561,17158,86130,12396
14671,29,1227,1418,894,33449,333
15466,5,128,1407,88,9531,40
4792,47,1004,1520,627,9489,377
65356,769,10886,300,8754,83049,2132
27382,64,1682,1187,1017,21377,665
10845,28,1380,1464,819,22924,561
43569,108,1645,874,1370,21250,275
20185,5470,153443,1326,94079,326035,59364
66212,17,210,277,185,14122,25
30948,1957,42844,1117,32479,248173,10365
69650,9,142,164,126,2003,16
60144,198,3031,461,2333,29092,698
61423,1,27,415,22,4365,5
3910,183,3815,1531,2741,103421,1074
2471,300,7316,1545,5141,83906,2175
36739,1,173,999,133,19381,40
63482,1,29,355,19,4028,10
37949,53,776,966,538,10187,238
1477,1,52,1553,37,3695,15
40693,25,441,919,389,18004,52
66504,11,157,269,115,4065,42
30800,31,1035,1119,592,11413,443
10425,44,1830,1467,1062,14854,768
44636,329,3927,862,3443,70131,484
29657,104,1821,1143,1124,12749,697
4548,458,7003,1523,3966,29553,3037
6193,33,1112,1503,729,12233,383
65912,87,1314,286,1140,10184,174
58880,37,645,504,512,10760,133
58352,23,374,522,269,6718,105
49494,67,565,782,421,12049,144
19136,12,297,1344,219,18527,78
19924,988,22577,1330,14101,100846,8476
350,53,2004,1562,1485,33413,519
8490,9,327,1477,200,6089,127
23429,2,32,1272,22,2319,10
6375,48,1410,1501,884,21901,526
39760,22,1225,933,836,13317,389
28604,7,167,1163,149,24056,18
44627,12,268,863,224,5766,44
65293,16,74,301,68,3498,6
29202,19,740,1151,437,9110,303
24875,706,25231,1242,15263,173277,9968
43949,32,460,870,330,10547,130
26556,3437,91259,1205,49311,245378,41948
57187,5,41,556,36,4604,5
20926,2031,32946,1313,20426,93475,12520
58896,43,610,503,451,7101,159
49292,3160,68162,788,53655,403952,14507
4945,28,1077,1518,768,19898,309
51539,97,1139,727,992,21892,147
54078,4587,54019,649,37598,153313,16421
32005,44,1209,1100,780,5459,429
34496,1748,30867,1054,24694,131759,6173
6940,232,3718,1493,2496,46202,1222
21642,365,9366,1300,5962,43880,3404
14611,30,1370,1419,896,29180,474
12923,10721,241362,1443,152719,711139,88643
40365,80,633,924,500,3645,133
7313,12,388,1488,265,12537,123
25913,5,275,1220,132,5628,143
15020,598,13898,1414,9662,66966,4236
63685,504,15491,349,11759,64382,3732
21056,43,1379,1310,864,29659,515
18470,166,4381,1356,2872,47650,1509
66969,25,191,253,158,2341,33
52685,25,311,691,223,3344,88
4333,3264,120987,1526,76068,452197,44919
65824,22,204,289,162,3050,42
4769,149,7603,1520,5181,27353,2422
64004,6,76,340,58,1609,18
6187,451,11135,1503,7614,121193,3521
40741,81,2001,918,1527,19474,474
32166,10,314,1098,203,5561,111
6152,268,3912,1503,2961,27836,951
17730,0,1238,1369,982,21699,256
65674,10,66,292,52,1828,14
32206,33,1446,1097,858,16466,588
50991,20,200,744,160,8464,40
60846,1094,23822,419,16934,205476,6888
8131,583,9317,1478,5834,44628,3483
58967,20,195,501,174,10542,21
39682,26,607,934,491,21580,116
12630,72,1272,1446,776,13170,496
5436,26,789,1512,561,10993,228
58465,175,2074,517,1672,26235,402
4818,1434,62706,1519,38391,394882,24315
60868,2378,49240,432,36891,187435,12349
29305,180,3020,1149,1940,19163,1080
36211,2,130,1012,103,4347,27
20487,21,1474,1321,1110,26068,364
691,94,1338,1559,884,10136,454
66430,0,12,271,7,1484,5
34789,226,1621,1047,1187,20233,434
99,249,15731,1565,10656,97760,5075
21502,24,1006,1302,832,16558,174
52602,406,4428,695,3443,32956,985
15282,38,1059,1410,819,10921,240
23745,46,1755,1267,1187,25626,568
45532,55,932,852,673,21439,259
32514,4,171,1092,135,8379,36
49995,178,2497,770,1943,19818,554
10740,2322,75637,1465,44737,538728,30900
51307,48,831,736,734,21772,97
34080,384,9454,1063,7030,65534,2424
51182,28,395,739,252,7134,143
36798,147,4255,994,3258,22162,997
17378,0,116,1376,80,3874,36
52461,3,71,700,57,4512,14
15124,9,548,1412,394,36673,154
58151,2140,34844,528,28330,112836,6514
67928,75,1236,223,1006,7387,230
14760,5,184,1417,138,7277,46
7391,106,5194,1487,3716,75862,1478
61803,19,291,403,234,5248,57
27734,6,214,1180,127,7200,87
24894,582,11594,1241,7736,88762,3858
12932,90,1818,1442,936,18785,882
66903,11,124,256,93,3069,31
7120,86,2464,1490,1884,44969,580
11682,63,1054,1457,620,21905,434
50007,43,477,769,373,9124,104
61973,143,1761,397,1345,12107,416
17355,91,2247,1376,1725,61426,522
65491,237,3873,297,3211,13361,662
18650,71,2417,1353,1637,49832,780
51786,28,389,722,295,12013,94
59430,1,59,486,43,2022,16
18725,1,271,1352,199,8330,72
11378,95,3061,1460,1943,34655,1118
68150,148,4001,216,3325,23038,676
38449,151,2537,952,2111,38027,426
30152,51,1025,1132,621,13374,404
8651,1189,36009,1476,22712,196095,13297
19653,48,3477,1335,1918,29369,1559
3522,64,1606,1535,1252,23614,354
58496,164,1283,516,981,14241,302
26399,20,2095,1209,1277,24047,818
66243,125,1501,276,1259,23601,242
49054,47,576,795,456,6139,120
47268,27,231,543,207,5135,24
16694,7,199,1388,147,18063,52
24060,28,568,1260,405,15921,163
35412,0,0,607,0,7447,0
60761,26,390,438,290,5676,100
3467,2735,84202,1536,54470,219744,29732
18305,4,47,1359,40,2690,7
25324,171,3987,1232,2951,55878,1036
68174,6,126,215,107,3428,19
6672,4,344,1496,253,16108,91
10275,9,701,1468,444,17736,257
53904,36,230,656,189,6210,41
25241,8,333,1234,208,8047,125
5964,81,2513,1505,1676,59935,837
14982,36,1396,1414,974,19093,422
19002,127,6668,1347,3036,27944,3632
35215,22,402,1036,308,9094,94
8943,3194,63801,1475,46641,217992,17160
9379,0,0,1473,0,5512,0
50598,2408,37735,754,25640,227189,12095
24971,66,1955,1240,1117,17622,838
34059,36,786,1063,449,8666,337
24811,8,185,1243,139,11178,46
15148,74,1825,1412,1387,19497,438
1028,132,3412,1556,2416,68570,996
45308,4,62,855,47,5907,15
68854,5,122,191,89,3368,33
26659,21,631,1203,360,9050,271
69191,14,205,180,187,5563,18
48487,1350,15441,808,11530,146465,3911
63183,230,4703,363,3579,23374,1124
30276,3,75,1130,63,2575,12
40851,35,518,916,429,9029,89
27555,77,2494,1183,1622,24588,872
50162,17,183,765,138,6735,45
45616,1,34,852,31,3180,3
60845,51,615,435,501,10302,114
12439,78,1401,1449,813,16029,588
51486,536,6658,731,5384,32065,1274
15809,121,1986,1402,1266,32000,720
34411,36,1045,1056,670,18356,375
55065,443,5274,615,4176,32603,1098
61063,4,106,426,83,4509,23
29379,11,214,1148,126,7271,88
10873,222,8090,1463,4342,37308,3748
15960,3,164,1399,99,5813,65
35041,128,2960,1041,2004,17772,956
55311,19,156,608,116,5343,40
23304,109,2923,1275,1630,26272,1293
24747,429,12281,1244,8963,115218,3318
11847,140,17517,1455,8408,165564,9109
67407,1,54,239,36,5700,18
1407,33,1331,1553,945,22003,386
31405,4,114,1110,91,4580,23
70195,4,47,147,31,1884,16
40657,57,853,920,608,33796,245
33755,52,1456,1069,895,9518,561
51287,152,1520,736,1178,16341,342
8265,18,481,1478,320,8930,161
18877,17,597,1349,446,7652,151
54886,251,2083,621,1606,22446,477
21796,21,644,1298,450,12062,194
4799,165,4361,1520,3087,21462,1274
3671,15,618,1534,524,15158,94
49510,9,156,782,144,7528,12
10144,576,24710,1469,16253,126847,8457
51562,77,846,728,686,11483,160
34259,17,1103,1059,705,30408,398
15348,136,3840,1409,2518,18369,1322
51155,42,570,739,455,11763,115
64109,31,336,336,281,6245,55
59384,95,1772,486,1417,14532,355
35281,264,4412,1032,3462,37550,950
9122,17,502,1474,347,14987,155
1589,25,1337,1552,979,19303,358
67029,33,452,252,427,13807,25
8675,3,240,1476,161,8553,79
52201,29,384,709,311,10862,73
31959,24,443,1101,273,8732,170
50262,5,106,761,67,5053,39
36053,222,2949,1016,2339,25109,610
34406,62,941,1056,634,7251,307
18674,27,482,1353,341,9170,141
16647,0,0,1389,0,5290,0
25169,17,267,1236,218,5575,49
62784,131,4650,373,3669,32196,981
7772,46,1717,1482,1173,46156,544
61621,925,25645,409,19746,143408,5899
23678,1,131,1268,93,5967,38
25020,836,56054,1238,38617,196714,17437
42460,4,144,890,95,3597,49
35169,13,150,1038,120,5652,30
49989,158,3647,770,2701,36004,946
3123,15,527,1539,358,21332,169
13279,338,8018,1438,5301,53100,2717
58072,21,170,531,144,9624,26
306,220,9683,1562,7369,90388,2314
69554,10,174,169,152,5055,22
56465,198,3461,576,2824,52454,637
9243,24,787,1474,505,16563,282
20338,107,3573,1323,2331,67783,1242
9498,37,733,1472,486,15578,247
19300,38,257,1341,212,15703,45
20394,13080,304902,1322,185914,788980,118988
66148,56,583,279,463,4423,120
13471,0,0,1435,0,6959,0
67900,20,365,224,290,8309,75
1676,12,680,1551,539,16421,141
18825,12,152,1350,123,4467,29
7158,3,161,1490,100,8522,61
14146,3621,96356,1425,63821,696632,32535
60322,14,223,455,178,1952,45
45907,15,165,848,129,4743,36
58877,11,114,504,91,5985,23
63920,1202,23189,342,19324,103022,3865
32987,83,2003,1083,1369,16688,634
40409,7,157,923,141,6935,16
3225,76,1891,1538,1249,13906,642
40050,493,9591,929,7970,99382,1621
51269,38,616,736,546,29615,70
31618,68,2105,1107,1129,6822,976
69601,40,523,167,481,7364,42
69653,45,457,165,401,5247,56
14132,49,1210,1425,786,16163,424
23027,237,6090,1279,4086,141856,2004
11991,4,261,1454,136,12355,125
70522,5,80,136,80,3672,0
1909,982,29905,1550,20066,158287,9839
27070,1254,108144,1194,59147,301442,48997
21569,176,2934,1301,2505,40521,429
14184,0,0,1425,0,12723,0
58727,338,4732,509,3559,24162,1173
29969,5,233,1136,152,17244,81
12624,988,31929,1446,21487,195645,10442
5846,18,596,1507,462,20579,134
23247,190,9080,1276,6146,55604,2934
27279,30,640,1190,467,11605,173
3921,83,2403,1531,1732,37292,671
45001,49,592,857,469,18954,123
55460,3217,76284,605,62289,350329,13995
15270,25,884,1410,621,31134,263
33277,33,1085,1078,717,18571,368
38559,165,3338,949,2766,29059,572
45036,26,510,858,380,7102,130
4338,132,2646,1526,1862,81193,784
3634,1731,40743,1534,28843,84086,11900
36431,2435,54329,1005,41913,292351,12416
46538,75,1758,840,1334,30464,424
9276,48,1405,1474,902,18066,503
32505,30355,852963,1092,544542,1900118,308421
24160,2133,38063,1258,25900,110641,12163
17272,633,17147,1378,12155,157996,4992
42070,35,399,896,311,3549,88
49178,2872,37381,792,29031,295277,8350
20640,46,1267,1318,930,20525,337
66818,71,1986,253,1504,24740,482
51134,41,638,740,485,5742,153
30104,3,193,1133,117,6747,76
65525,37,626,297,456,10374,170
64519,7,64,324,55,5955,9
4601,20,1137,1522,735,21427,402
28716,4,428,1160,240,11756,188
58014,16,157,533,126,6887,31
63302,13,116,360,94,1877,22
53392,8,143,671,125,6823,18
12398,14,343,1449,222,10682,121
15187,11,835,1411,476,13984,359
30070,196,6292,1134,4071,25686,2221
14774,6,246,1417,186,29869,60
4234,9,170,1528,130,17844,40
22209,38,1522,1293,1030,20826,492
22165,604,12243,1293,8127,72123,4116
35045,210,3333,1041,2323,19333,1010
27609,41,995,1182,550,9477,445
8626,45,1358,1476,818,15869,540
58082,25,498,531,360,12670,138
60184,98,1553,460,1394,16255,159
65404,6,66,299,45,2237,21
69109,10,118,183,103,3672,15
7344,50,1584,1488,1031,24718,553
60967,31,226,430,181,6099,45
36173,530,5570,1013,4685,50640,885
53585,38,496,667,430,8736,66
33233,259,5733,1079,4473,57003,1260
107,94,1787,1565,1010,18067,777
11789,792,21546,1456,12279,91904,9267
589,67,3209,1560,2212,56727,997
8733,98,6043,1476,3612,31835,2431
1470,25,1076,1553,788,31211,288
33092,3,76,1082,58,6525,18
13697,91,2967,1432,2043,28191,924
22528,62,2492,1288,1607,46389,885
14892,29,1156,1415,814,17414,342
66415,15,156,272,125,4312,31
53595,28,292,667,223,5425,69
10250,3,330,1468,241,9802,89
53240,23,298,675,225,7105,73
55559,243,5222,602,3735,35982,1487
1347,54,4797,1554,3128,81344,1669
25675,6668,167951,1225,109648,355253,58303
5745,375,29122,1508,16584,166786,12538
1203,24,972,1555,700,27827,272
37841,17,330,969,270,8977,60
7252,706,19959,1488,13975,127912,5984
54742,10,98,626,72,2807,26
61404,35,493,415,448,13161,45
31728,12,368,1105,231,8153,137
63560,56,550,354,488,10396,62
16165,7,186,1396,109,4629,77
11612,22,1135,1457,672,21866,463
56031,188,2726,589,2197,36142,529
50767,54,529,750,423,9399,106
54133,18,246,648,190,8893,56
27716,73,1617,1180,844,10370,773
32036,53,1001,1099,637,10081,364
16685,41,817,1388,545,14318,272
12113,27,1162,1453,635,10583,527
10397,95,2810,1467,1766,27098,1044
63102,60,561,365,494,8622,67
28753,2,86,1160,75,6533,11
34841,12,172,1046,131,8474,41
22672,21,654,1285,469,9723,185
15075,10,286,1413,196,6915,90
27142,128,1908,1192,1136,14123,772
25239,575,7301,1234,5050,50821,2251
21996,235,4804,1296,3135,41649,1669
37637,266,3634,974,2859,43095,775
11891,183,8204,1455,4532,55809,3672
61772,1,19,404,14,3369,5
67570,55,1024,234,816,11013,208
65996,8,77,284,56,6017,21
19246,62,1391,1342,1077,16956,314
6143,44,1257,1503,839,29621,418
8388,42,754,1477,496,11044,258
54113,44,493,649,376,9305,117
69681,708,14212,165,12243,98172,1969
3277,103,6962,1538,4529,39712,2433
21542,2148,191934,1302,102887,193162,89047
67995,3,24,221,16,1780,8
55970,13,172,591,125,6446,47
17930,457,8250,1365,5563,57337,2687
28880,2338,49145,1157,32402,292849,16743
60051,90,1161,465,928,12543,233
40960,25493,345264,914,233571,1802404,111693
33566,400,7469,1073,5475,29495,1994
56746,76,998,568,650,10980,348
50868,289,5277,748,3959,29378,1318
14970,51,1130,1414,849,14430,281
46619,6,121,839,78,5896,43
5482,104,2560,1511,1754,27445,806
40440,761,8465,923,6045,52529,2420
60321,20,244,455,214,10004,30
17807,10,500,1368,388,17513,112
28018,18,178,1173,137,7666,41
37061,122,2377,990,1698,21120,679
24901,378,13190,1241,8391,125452,4799
56116,17,132,586,84,7822,48
10236,22,816,1468,537,13683,279
33919,2049,59453,1067,39345,209422,20108
13399,1331,69121,1436,40407,219958,28714
16348,2,71,1393,49,6125,22
32252,128,2816,1097,2036,28566,780
65300,64,1365,302,1116,11498,249
56478,12,248,576,189,8887,59
35765,22,1825,1024,1099,7684,726
63621,146,6700,352,4977,22284,1723
28365,47,528,1167,473,6466,55
65311,0,5,301,5,1749,0
62304,50,796,386,616,9434,180
27283,87,2295,1190,1599,26635,696
14019,2176,90526,1427,57509,220751,33017
27987,21,636,1174,397,18932,239
69574,901,20797,168,16839,97863,3958
3265,1559,70142,1538,39876,227104,30266
57673,312,3018,544,2344,30787,674
5165,21,909,1515,554,14095,355
60695,62,1192,440,917,13466,275
33083,12,533,1082,371,13789,162
62135,24,591,391,421,8561,170
4068,42,1024,1529,715,14771,309
7242,36,1579,1489,1029,20967,550
22416,17,772,1290,566,13360,206
66161,232,2480,279,1999,12138,481
13262,16,346,1438,192,7402,154
11694,0,0,1457,0,13613,0
66857,8,179,257,140,6021,39
11068,1453,65053,1462,35407,332235,29646
64875,543,7519,276,5523,108903,1996
29469,1174,29396,1146,17956,269065,11440
51671,1,54,725,39,5598,15
35654,15,513,1027,334,3806,179
12106,893,27007,1453,15096,260758,11911
55094,90,1391,615,1070,14003,321
6952,199,11176,1493,7298,89842,3878
58156,79,960,528,758,12052,202
28415,52,1126,1166,760,10071,366
35855,23,519,1022,379,14591,140
43753,566,9682,872,7961,72478,1721
53344,36,506,672,424,14199,82
21715,99,3378,1299,2170,66394,1208
37228,64,832,985,678,8329,154
66257,50,658,276,500,4664,158
4561,102,5214,1523,3675,40381,1539
19746,1,35,1334,29,2291,6
22474,7,381,1289,274,20595,107
53594,43,682,667,601,24099,81
49943,101,1689,771,1303,50366,386
13771,4,132,1431,84,14361,48
15304,37,1002,1410,683,9816,319
3574,1608,33585,1535,20365,176612,13220
29074,3,125,1153,81,6572,44
63460,5,70,355,58,4552,12
56528,4,43,574,39,4995,4
63869,229,2082,344,1531,10458,551
56965,139,2422,562,2008,12788,414
63990,53,622,340,417,5642,205
56343,9,125,580,84,3325,41
19957,8,159,1330,136,19017,23
22862,18,735,1282,515,10867,220
63857,38,416,345,341,7143,75
50516,12,191,756,136,6185,55
40272,651,8780,925,6839,62081,1941
7589,18,1031,1484,676,30013,355
31404,40,788,1110,530,21919,258
24512,182,6719,1250,4386,47426,2333
62168,0,38,390,23,2521,15
49218,33,427,790,254,8737,173
19658,19,363,1335,289,10335,74
38118,231,4432,961,3733,29497,699
19051,63,1884,1346,1410,28959,474
37071,7,120,990,96,4987,24
7776,11,747,1482,468,17004,279
57941,70,749,530,619,11203,130
57545,53,551,548,464,8891,87
49479,34,562,783,453,19647,109
26106,63,1227,1215,737,18518,490
9814,31,1082,1471,735,18340,347
23466,16,999,1272,823,24295,176
56454,42,632,577,482,29856,150
24113,1,111,1259,93,4943,18
19117,0,0,1345,0,22514,0
39502,7,126,936,113,8856,13
10863,63,2383,1464,1447,32255,936
6217,14,472,1502,332,4253,140
69468,15,237,172,195,5321,42
32310,89,3044,1096,1902,22331,1142
14699,24,979,1418,733,12437,246
18791,4,90,1350,64,14185,26
23579,66,921,1270,653,29403,268
25098,580,7944,1237,5011,46874,2933
65249,43,317,303,275,4066,42
40678,431,7078,920,5654,39595,1424
21317,10,292,1306,195,9219,97
2746,779,16654,1543,10677,51416,5977
54348,14,122,641,109,10401,13
12426,3345,86346,1449,52899,327888,33447
67853,22,804,225,661,14715,143
26033,783,20425,1217,12932,144919,7493
67767,4,80,228,64,3316,16
28961,32,1708,1155,994,27158,714
67499,12,203,236,167,3246,36
17543,46,3299,1373,2416,30506,883
49075,121,1417,795,1269,21144,148
7080,940,64486,1491,38684,335245,25802
16224,155,3086,1395,1717,13924,1369
56890,21,421,564,341,9291,80
43741,2028,50863,872,39034,218200,11829
49428,66,524,784,355,9536,169
1689,180,7748,1551,5226,142422,2522
55557,2,62,602,56,3654,6
38779,98,2755,944,2234,20862,521
23298,16,534,1275,385,5906,149
4131,788,15718,1529,9999,131652,5719
62295,2,64,247,45,2249,19
45273,318,3449,855,2633,49672,816
9042,11,613,1475,417,32835,196
14508,1,74,1420,49,4231,25
59114,1678,42593,497,34270,160161,8323
14100,32,1321,1426,953,28406,368
32454,42,732,1093,452,13637,280
50766,1,58,751,48,2700,10
33128,115,2032,1081,1296,18413,736
45059,10,282,857,205,8220,77
6508,805,17907,1498,11733,117483,6174
29009,36,416,1155,249,4177,167
36009,1,30,534,20,2471,10
32741,1318,36167,1089,25630,78356,10537
6275,39,573,1502,425,11194,148
5600,4776,239526,1510,141061,1325009,98465
54131,12,96,648,82,2435,14
66553,0,87,267,72,4218,15
6710,2,68,1496,43,8220,25
60611,7,92,444,62,4202,30
24474,2874,57081,1251,38011,382844,19070
36107,62,544,1015,394,6309,150
29637,2,171,1143,89,6061,82
31921,10,461,1102,277,10948,184
69318,10,105,176,87,5150,18
9359,2087,77484,1473,44222,305889,33262
64661,10,198,320,168,4370,30
2208,65,2382,1547,1752,35798,630
19177,84,2172,1344,1521,38813,651
1569,13,423,1552,300,31247,123
50231,13,243,764,187,4578,56
59462,136,2070,485,1581,55519,489
35490,197,5156,1030,3529,90374,1627
34627,59,887,1051,611,15317,276
63961,27,370,341,268,8923,102
65764,36,642,290,498,10212,144
31147,153,3722,1113,2490,14541,1232
41296,50,656,909,556,29628,100
66937,48,728,254,525,10753,203
24859,54,1788,1242,1457,27293,331
35988,95,2377,1018,1647,23662,730
35679,12,419,1026,291,5572,128
15902,6,270,1400,183,23851,87
38853,183,3689,944,3205,43466,484
53965,38,468,654,366,6145,102
6701,1323,33370,1496,22416,180951,10954
22041,823,15472,1295,10045,136251,5427
23808,78,2930,1265,2055,22183,875
18175,83,799,1361,641,9015,158
52373,73,941,703,736,19205,205
370,146,3080,1562,2230,27313,850
22575,316,5694,1287,3990,37598,1704
19965,7,266,1330,191,6190,75
64913,104,1576,312,1231,17446,345
36283,3,60,1010,46,4074,14
68105,18,350,217,326,9792,24
17392,6,289,1376,251,23173,38
37423,3,179,980,86,2698,93
61737,53,553,405,430,4372,123
59662,11,88,478,67,9328,21
33692,261,4726,1071,3525,21345,1201
8700,84,3869,1476,2354,35227,1515
33218,186,2478,1078,1781,27118,697
60626,104,1713,443,1219,14128,494
42194,10,202,895,162,11696,40
11250,6,634,1461,340,10768,294
14777,4,146,1417,106,20399,40
54027,63,873,652,687,11665,186
24065,3871,137340,1260,88798,571732,48542
35065,21,564,1041,408,5535,156
36130,149,1911,1014,1553,23211,358
21525,1070,33764,1302,23735,146244,10029
64243,45,566,332,395,4599,171
18395,6268,143611,1357,91157,349368,52454
51705,131,3718,724,2850,26684,868
27880,15,770,1176,494,7145,276
12104,103,1811,1453,1284,18671,527
33668,7,237,1071,195,15008,42
26463,68,2402,1208,1508,23389,894
3747,14,451,1533,330,8723,121
49270,145,2868,789,2308,29056,560
14573,3,303,1419,209,13767,94
19815,180,9448,1332,6701,73648,2747
53128,33,572,677,438,34224,134
22242,14,697,1292,469,5518,228
53077,173,1664,679,1319,32062,345
21355,8,119,1305,84,13783,35
37487,7542,135275,978,107789,508778,27486
53858,22,267,658,178,9076,89
53905,15,192,656,163,9320,29
6167,3,337,1503,179,14055,158
28811,20,1150,1159,664,15928,486
31568,780,18246,1107,12918,245443,5328
15549,109,2931,1406,1962,28503,969
24165,46,1845,1258,1189,19820,656
50521,340,6664,756,5027,67681,1637
29552,49,989,1145,598,13377,391
30189,1321,45910,1131,32702,340783,13208
26271,2786,67960,1212,43899,273949,24061
64366,31,552,328,470,15789,82
58841,6,47,505,28,6673,19
70252,4,43,146,32,1797,11
26719,3,237,1202,143,8187,94
16990,2,125,1383,103,11318,22
30278,88,2673,1130,1897,43623,776
14747,165,2410,1417,1480,21737,930
58446,10,250,518,177,5360,73
44882,61,1040,860,749,16163,291
62001,4,99,396,81,9415,18
11240,116,6052,1461,3506,64348,2546
39400,2610,39398,938,31614,270005,7784
64436,43,1032,326,833,11670,199
20166,0,0,1326,0,8311,0
31232,44,2282,1112,1416,33122,866
60789,1454,28506,437,22894,142483,5612
6441,3,115,1500,81,15346,34
66745,56,954,261,841,9901,113
54402,22,205,638,171,7484,34
67661,26,432,229,306,10448,126
20485,15,386,1321,289,11171,97
39177,19,321,940,279,6824,42
50555,2,76,755,58,3166,18
26188,14,485,1214,318,13746,167
23169,60,1322,1277,1054,18830,268
28035,9,129,1173,94,2743,35
19788,379,9952,1333,7075,114502,2877
5439,58,2101,1511,1485,58833,616
9783,129,6615,1471,4349,40745,2266
30007,69,1897,1135,1179,57896,718
20388,7,404,1322,329,28031,75
2675,133,5500,1543,3656,45021,1844
2399,16,236,1546,143,28867,93
12322,1177,48679,1450,30727,220671,17952
62786,382,7313,372,5772,48917,1541
50221,71,1637,764,957,19121,680
614,4,430,1559,312,43740,118
30430,20,624,1127,391,14199,233
45550,3,84,852,72,3931,12
15592,168,5198,1405,3640,68633,1558
18795,468,17268,1350,11638,278892,5630
59381,25,335,487,265,7005,70
22248,10,267,1292,177,4103,90
32793,48,1449,1088,905,8940,544
60507,13,189,448,145,2313,44
11444,920,40244,1459,23276,164830,16968
25136,246,4458,1236,2999,40360,1459
35753,9,329,1024,246,8140,83
15626,64,1412,1405,944,41882,468
24420,29,355,1252,277,26747,78
33474,32,996,1075,639,9592,357
56590,28,346,572,263,7335,83
28013,118,2702,1173,1992,23991,710
23531,26,1273,1271,1017,16784,256
45438,136,2441,854,1866,29034,575
17779,4187,112958,1368,78056,645259,34902
2565,31,640,1544,414,5748,226
22959,1656,51014,1280,33144,225765,17870
59433,88,1565,486,1343,22986,222
59519,1001,14314,483,11382,64803,2932
39898,12,365,931,250,6670,115
13756,0,0,1431,0,7748,0
36938,637,12454,994,8100,112499,4354
58325,52,311,522,241,5585,70
3477,3,147,1536,107,13468,40
26258,246,4964,1213,3344,74263,1620
27235,48,1677,1191,964,35836,713
35577,1784,49534,1028,35142,304220,14392
25925,13,741,1220,454,17848,287
4516,3,82,1524,65,3503,17
33952,155,2562,1066,1934,10964,628
26550,45,1358,1206,744,13265,614
61878,112,1041,400,898,12724,143
58634,14,96,512,84,3449,12
56164,254,4789,585,3621,24840,1168
4892,24,816,1518,558,26507,258
13166,2093,88140,1439,57511,286281,30629
23627,57,964,1269,660,11591,304
32959,65,3208,1084,2178,23100,1030
37779,218,3507,970,2912,43458,595
8443,75,2287,1477,1566,77038,721
1793,22,1248,1551,893,24651,355
30551,233,9413,1124,5479,20568,3934
55317,0,24,608,19,1733,5
29604,16,858,1144,541,18573,317
16489,24,1064,1391,718,9025,346
38318,20,225,956,168,5415,57
30053,95,2682,1134,1897,21180,785
4767,43,1218,1520,859,15277,359
35006,287,6992,1042,5272,71917,1720
37910,145,2298,967,2009,23253,289
22052,7,135,1295,94,4327,41
6357,3,52,1501,28,5504,24
12171,121,3324,1452,2079,22160,1245
61409,25,316,396,254,8060,62
55822,41,595,185,455,6265,140
23125,6261,140585,1277,94112,480383,46473
63888,4,102,343,88,3238,14
35552,216,3998,1027,3125,25591,873
22864,42,1145,1282,891,19669,254
36010,5,316,1018,243,14622,73
35499,4,408,1030,260,19093,148
48259,254,4448,819,3492,96282,956
8272,32,699,1478,436,8075,263
66687,601,9922,263,8565,61076,1357
20266,24,1292,1324,989,17660,303
5975,129,6617,1505,3868,27253,2749
52735,63,1059,690,667,18049,392
2893,111,2851,1541,2059,30016,792
57954,31,441,528,285,3908,156
59814,27,436,473,279,7672,157
67648,21,317,232,252,12794,65
69080,24,461,184,383,9621,78
31753,31,569,1104,391,10051,178
781,92,6098,1558,4287,115079,1811
6150,787,37699,1503,22916,234438,14783
17388,2,122,1376,91,7086,31
31068,19,967,1114,643,9015,324
8809,22,763,1475,517,13159,246
684,34,2789,1559,1941,24471,848
42372,86,1705,892,1395,23873,310
61132,50,979,424,755,15895,224
7523,635,22951,1485,13204,152309,9747
9282,532,9166,1474,5811,57433,3355
34997,24,444,1042,303,10541,141
23694,411,6404,1268,3918,32714,2486
50364,17,154,760,109,2811,45
60095,1547,20251,463,16542,151741,3709
68585,16,150,200,118,2537,32
8485,435,5764,1477,3888,33174,1876
41265,76,1320,910,1152,24071,168
16098,119,1727,1397,1100,28586,627
23946,17,347,1263,208,13196,139
2822,1359,81972,1542,51376,367246,30596
30182,0,0,1131,0,4724,0
22543,41,1908,1288,1385,30266,523
22941,39,1983,1280,1357,23126,626
27956,24,810,1174,526,11164,284
60410,121,2287,452,1762,25050,525
23647,136,2847,1269,1779,14442,1068
37087,20,295,990,254,8032,41
15692,1966,67694,1404,47160,343645,20534
60351,28,431,454,359,4698,72
27292,126,3112,1189,2159,27131,953
26736,1612,33163,1201,23074,115844,10089
16594,0,0,1390,0,9570,0
14870,31,1088,1416,787,15976,301
4693,19,457,1521,328,27674,129
8917,94,2999,1475,2119,35582,880
31739,5,198,1104,168,12389,30
12208,16,2522,1452,1221,19458,1301
17284,7,129,1378,99,11208,30
63425,54,816,356,475,8806,341
39792,6,246,933,164,10994,82
791,45,1940,1558,1347,31094,593
15262,58,2135,1410,1437,32917,698
30741,263,10037,1120,7244,58438,2793
20489,24,658,1321,470,9922,188
44179,8541,252584,867,177201,723429,75383
36392,81,1283,1006,1120,18290,163
59103,42,479,497,349,13534,130
47123,140,2600,833,1743,16709,857
475,301,14697,1561,10008,131260,4689
61659,10,213,408,136,2456,77
32720,7,176,1089,125,5618,51
30814,112,2018,1119,1267,13197,751
31985,584,9180,1101,6663,110252,2517
17967,128,3776,1365,2772,108260,1004
64226,4,53,333,35,1488,18
62064,19,306,394,243,7852,63
38031,18,315,963,253,15139,62
62385,32,314,384,247,4792,67
37963,432,23160,965,16501,70408,6659
61762,93,2262,404,1671,55412,591
2525,958,15163,1545,10674,105079,4489
33211,87,2745,1080,1965,52302,780
19028,23,374,1346,259,13657,115
17638,73,1556,1371,1114,12484,442
41810,105,995,900,850,11273,145
51048,14,192,743,152,9557,40
15783,6,382,1403,251,25037,131
14389,14,491,1421,327,6051,164
16319,11,775,1394,516,9307,259
42940,82,1941,882,1354,30789,587
12095,0,0,1453,0,2999,0
53446,0,598,670,289,3857,309
10700,24,288,1465,228,8377,60
46663,50,685,839,495,23895,190
33003,17,373,1083,270,12216,103
33088,242,3098,1082,2104,18118,994
13285,2,161,1438,112,6156,49
34795,2309,28728,1046,20804,101166,7924
20272,2,91,1324,76,4825,15
15345,31,587,1409,362,6058,225
60527,7,109,447,88,2741,21
9605,2148,33866,1472,23897,86713,9969
59178,9,62,495,48,3729,14
64256,3,54,331,32,15647,22
47047,17,228,834,179,9717,49
44601,63,1761,863,1430,19026,331
28761,1263,31551,1160,18625,271492,12926
15554,1,129,1406,79,20257,50
70416,6,52,140,49,1518,3
18203,32,1095,1361,803,15637,292
48971,66,576,798,448,21570,128
64044,115,1164,338,953,7388,211
14315,4,51,1423,32,6115,19
32956,2,117,1084,72,2412,45
33647,401,7523,1071,5290,60309,2233
61394,21,117,416,84,4396,33
33018,3194,54636,1083,34531,276877,20105
29192,0,4,1151,3,11296,1
37585,52,739,975,345,9192,394
15442,644,11275,1408,6746,62738,4529
33189,6,191,1080,136,10008,55
12363,47,1310,1450,795,27363,515
21655,246,6494,1300,4166,40848,2328
3886,7,445,1531,318,18922,127
51050,61,485,743,408,5694,77
56709,33,293,569,225,3881,68
62392,25,242,383,198,6211,44
32051,57,1123,1100,780,10655,343
52586,63,941,696,682,13328,259
992,92,2783,1556,1859,49360,924
11048,56,1600,1462,933,16594,667
19055,184,3016,1346,2032,17622,984
19856,68,2071,1332,1525,20196,546
46192,23,294,845,210,11191,84
23987,1355,35004,1262,24307,170418,10697
68775,0,4,194,3,708,1
14102,11,527,1425,380,14697,147
55431,199,2915,605,2248,42117,667
35865,10,156,1021,125,4968,31
45684,2,102,851,78,6815,24
28094,6,388,1172,248,6832,140
62888,71,1913,370,1160,22062,753
10860,80,1734,1464,1117,13043,617
30108,10,153,1133,108,4195,45
30216,40,1839,1131,1248,15392,591
60791,11,141,437,87,4362,54
4841,7,400,1519,211,6803,189
49983,8298,140023,770,108925,434127,31098
37552,351,5960,976,4728,43646,1232
390,2,222,1561,167,9673,55
56662,31,522,571,341,11730,181
48923,52,499,799,380,9655,119
10918,6,222,1463,130,20233,92
54854,3,34,622,26,2999,8
50228,15,180,764,142,6977,38
15470,14,505,1407,383,10962,122
45769,12,149,850,114,3066,35
32644,1533,85433,1090,61824,199791,23609
24809,0,52,1243,43,3768,9
57986,4,41,533,33,2619,8
15551,1891,78539,1406,56123,410248,22416
67627,26,303,232,244,3293,59
16721,23,902,1387,641,21136,261
54139,34,306,648,246,6623,60
1245,254,9360,1555,6428,90382,2932
63356,13,257,358,199,5072,58
49080,12,115,795,104,10959,11
12237,46,850,1451,571,9605,279
50160,21,297,765,223,14082,74
50459,7749,214742,758,156684,848374,58058
18195,6,363,1361,212,9725,151
29710,65,1182,1142,712,6216,470
7631,81,1338,1484,824,24783,514
4980,15,391,1517,252,18669,139
18037,314,4945,1363,3372,28439,1573
56958,10,150,562,108,3840,42
2388,46,1389,1546,992,26083,397
33043,13,358,1083,147,6844,211
19758,53,1477,1333,1031,19455,446
36099,496,6745,1015,5100,55473,1645
24488,31,1370,1251,846,18029,524
36997,26,781,992,603,7910,178
18628,7,417,1353,337,12921,80
3450,2,75,1536,60,5863,15
21065,189,2328,1310,1885,21566,443
11639,150,6064,1457,4045,42185,2019
40414,122,2204,923,1854,70470,350
1852,250,4108,1550,2484,29355,1624
49266,338,4519,789,3999,62127,520
32854,125,2282,1086,1659,16595,623
68469,7,142,205,108,3284,34
66551,4,88,267,61,3960,27
50622,1161,14536,754,11545,144382,2991
57519,43,473,549,362,3649,111
61770,31,376,404,307,4634,69
2639,41,1164,1544,631,19338,533
29676,297,5854,1143,4031,60989,1823
5656,13,344,1509,238,16321,106
48827,262,3755,802,3012,40490,743
33347,315,6861,1077,5012,73131,1849
60308,27,340,455,257,4927,83
29850,34,1574,1138,843,12938,731
18818,4907,121745,1350,78910,325570,42835
5491,462,31052,1511,20168,73920,10884
29859,30,1218,1138,726,32058,492
8527,126,5246,1477,2990,42951,2256
18463,356,25064,1356,15967,120693,9097
49695,16,248,777,202,6144,46
12714,39,1659,1445,826,14655,833
42388,45,304,892,249,9087,55
34151,165,4742,1061,3569,77761,1173
17818,31,964,1367,747,17896,217
35566,18,426,1028,323,15781,103
3054,149,6403,1540,4507,48164,1896
59777,8,113,474,81,10635,32
55854,8,154,594,101,7125,53
21282,63,1002,1306,740,14738,262
64986,27,891,309,669,7771,222
8320,321,10881,1478,6738,39501,4143
369,1081,26213,1562,17609,114746,8604
35873,21,559,1021,437,13563,122
69725,43,584,163,561,8248,23
3088,79,2608,1539,1583,13933,1025
35120,130,1597,1039,1235,42723,362
62959,0,41,369,20,1707,21
41263,18,81,910,66,5686,15
10545,70,2156,1466,1590,52087,566
25128,4,36,1236,32,5699,4
34242,3,30,1060,23,2202,7
33657,21,310,1071,257,6726,53
10606,8,163,1466,111,8425,52
52449,41,266,700,189,8399,77
32848,35,1522,1086,943,36474,579
57833,487,9543,539,7673,55647,1870
45254,128,1419,855,1077,12120,342
24684,2984,146809,1246,96581,454072,50228
47989,5667,103834,822,74836,603619,28998
8548,116,2031,1477,1337,10974,694
30913,620,15989,1117,8909,73352,7080
12180,2480,104888,1452,66337,453162,38551
61180,19,366,422,265,4499,101
64668,11,215,319,149,6654,66
37554,64,1075,974,836,15032,239
19964,125,4663,1330,3133,34978,1530
20528,212,8169,1320,5827,56583,2342
34643,46,791,1051,576,12117,215
55084,30,359,615,302,9671,57
52789,11,189,688,145,7027,44
39765,474,9099,933,6553,44985,2546
877,21,961,1557,706,19871,255
22157,7,668,1293,437,8417,231
36959,177,4858,993,3822,69106,1036
18545,135,3746,1355,2619,43667,1127
52403,2049,37763,702,29115,117631,8648
5385,22,921,1512,646,14702,275
1401,48,1534,1554,1134,22309,400
21429,67,1665,1304,871,26084,794
20917,34,1475,1313,930,16677,545
64008,30,297,339,234,5263,63
13963,3044,121489,1428,75136,792609,46353
47512,13,180,828,135,7422,45
57072,40,381,559,257,3461,124
64086,2,61,337,38,1679,23
47150,2,30,833,21,3612,9
13806,31,1719,1430,1031,19020,688
51132,30,277,740,236,2710,41
67725,6,134,229,111,8147,23
37741,16,303,971,269,6570,34
7330,137,3672,1488,2725,21722,947
54537,31,607,634,409,19607,198
66327,19,275,274,201,7432,74
22250,12,825,1292,588,23844,237
15671,45,1035,1404,738,17905,297
15654,20,459,1404,285,9206,174
18029,35,1346,1364,757,9427,589
64189,113,2247,334,1737,12309,510
30622,55,1632,1123,1138,13942,494
23009,31,1031,1279,703,18861,328
36139,106,1351,1014,1135,19659,216
918,24,1325,1557,882,31836,443
30301,19,761,1129,464,14312,297
37687,5,69,972,50,2923,19
38249,19,264,958,216,4501,48
35433,11,87,1031,56,2665,31
20560,12,608,1320,480,8425,128
4472,56,2385,1524,1484,16101,901
30834,43,868,1119,519,7774,349
21664,95,1524,1300,999,23741,525
28014,2992,82943,1173,53420,323282,29523
1544,10,687,1552,438,44623,249
5796,50,1073,1507,719,31043,354
21688,87,1954,1300,1122,26010,832
43761,63,764,872,609,7659,155
56044,29,281,589,231,4079,50
17428,26,434,1375,290,16267,144
25502,57,3632,1229,2246,28216,1386
45962,131,1984,847,1679,28342,305
67083,27,600,250,455,8681,145
10920,0,17,1463,13,7282,4
16741,4163,140661,1387,95581,632879,45080
36406,1376,19214,1006,15642,145514,3572
7438,33,1788,1487,1278,34184,510
64708,15,130,319,106,6339,24
24220,28,1322,1257,933,27020,389
24981,14,304,1239,256,8187,48
69608,10,185,165,181,8900,4
17668,261,9230,1370,6342,54801,2888
28847,125,2202,1158,1708,34744,494
2845,3255,92647,1542,54067,250312,38580
35306,40,658,1034,456,9847,202
44582,81,1912,863,1237,10616,675
7636,38,1998,1484,1356,26699,642
9014,5,275,1475,183,12050,92
26238,90,1683,1213,1055,17675,628
54511,3,30,635,22,4233,8
52880,14,299,685,209,9155,90
38203,8,76,959,67,2660,9
49461,79,1460,784,1208,23741,252
14523,197,6734,1419,4355,38387,2379
31317,89,1376,1111,892,13943,484
58940,6,68,502,44,3671,24
57065,110,1940,559,1493,54193,447
66675,26,226,263,202,4646,24
38923,382,8178,943,5848,120831,2330
66780,3,13,260,11,1398,2
504,44,3691,1561,2734,28355,957
366,17,1207,1562,790,30935,417
69241,2,22,178,19,2235,3
2956,6,356,1541,214,10754,142
10815,60,2111,1464,1391,31514,720
22421,289,6728,1290,4819,64699,1909
40442,2,26,923,20,1247,6
57825,177,2481,539,1936,34300,545
67763,755,11205,228,8986,76130,2219
50786,9,73,750,60,3688,13
15575,44,1425,1406,1005,19912,420
70414,26,339,140,320,5654,19
32915,186,3009,1085,1997,29122,1012
39556,46,1370,936,1075,26858,295
58887,9,180,504,147,4242,33
37395,8,215,980,172,7416,43
60663,1640,23724,441,18443,82862,5281
41062,108,2838,912,2226,43643,612
3155,229,12634,1539,8675,44993,3959
12111,340,16855,1453,8780,167835,8075
5879,259,8819,1507,5834,41318,2985
67939,61,967,222,787,5615,180
50008,74,915,769,754,8680,161
1393,213,4881,1554,3777,167995,1104
30173,337,5471,1132,4142,28422,1329
66623,15,410,265,317,6652,93
11762,7,477,1456,224,21844,253
10900,48,1663,1463,1040,11058,623
34828,20,297,1046,246,12516,51
16153,36,1035,1396,723,37587,312
7763,2,66,1482,39,3286,27
13329,67,1539,1437,1025,25818,514
10856,1083,46777,1464,29602,243385,17175
40589,23,367,921,277,9052,90
3626,12,268,1534,197,10976,71
37052,156,2046,990,1496,29283,550
5812,609,30737,1507,19534,91302,11203
17334,51,1223,1377,899,18966,324
61691,401,6562,407,5243,42985,1319
3216,1133,53654,1538,31934,312461,21720
44098,221,4591,868,3601,50304,990
48080,78,996,821,806,17340,190
34135,21,299,1062,204,4002,95
65468,123,2048,298,1720,21886,328
8084,21,624,1479,415,18104,209
30506,2138,39633,1125,26366,127814,13267
20756,773,29245,1316,21159,152241,8086
30757,25,654,1120,507,9711,147
30299,406,9739,1129,6756,108625,2983
56021,96,1391,589,993,30272,398
69560,2,58,169,35,1272,23
12783,4,364,1444,204,6669,160
57351,26,425,552,328,12925,97
28992,270,5287,1155,4051,26248,1236
60278,0,81,456,62,3048,19
30658,187,7480,1122,4609,22479,2871
39881,28,935,931,686,11235,249
41791,42,1243,901,830,10582,413
54180,9,119,647,97,4649,22
65549,114,2531,296,2083,9356,448
8532,48,1926,1477,1271,20260,655
10742,45,1392,1465,906,18300,486
6459,128,3717,1499,2274,64361,1443
29329,2211,36362,1148,24991,201871,11371
27497,354,5894,1185,4344,39577,1550
59969,87,2079,467,1768,16978,311
20497,435,12125,1321,8396,152651,3729
53977,83,3649,654,2790,32985,859
65527,939,19614,297,14801,67019,4813
29761,24,664,1140,384,26591,280
46481,61,696,842,467,12704,229
25388,6,207,1231,133,11684,74
15486,385,6719,1407,3998,47606,2721
65303,25,179,302,152,3827,27
26677,956,29420,1202,20190,199027,9230
14929,111,5085,1415,3332,78211,1753
28193,24,990,1170,626,10617,364
2418,221,7728,1545,5795,35270,1933
28659,61,1889,1161,1170,27522,719
52070,434,5467,712,4595,34270,872
5396,16,1227,1512,934,8991,293
324,27,1200,1562,934,24116,266
15987,61,1783,1399,1358,18004,425
2843,26,1012,1542,745,14179,267
23765,4258,136208,1266,102620,983901,33588
70574,3,34,134,28,1540,6
30737,3136,57798,1121,45121,179136,12677
22743,227,7881,1284,5285,91188,2596
66875,6,90,257,68,2992,22
29208,2,193,1151,130,5152,63
21274,402,10979,1306,7629,56783,3350
50554,47,625,755,509,11780,116
9948,121,4289,1470,2715,36273,1574
39214,8,315,940,236,8592,79
233,107,3550,1563,2166,28633,1384
26020,26,839,1217,576,15800,263
7755,239,9885,1482,6728,139941,3157
25449,11,574,1230,323,5716,251
38991,4,41,942,35,11141,6
13217,18,921,1439,498,15566,423
397,232,14853,1561,10188,190830,4665
19346,141,3413,1341,2296,30924,1117
31004,32,1059,1116,718,17782,341
61749,4,63,405,48,2933,15
43149,17,279,879,241,9658,38
58622,300,4956,512,3853,11038,1103
6317,75,3468,1501,2232,34528,1236
63207,67,802,362,625,10143,177
49661,1939,761137,778,465689,431002,295448
13974,51,1670,1428,1046,33424,624
29976,18,368,1136,222,7875,146
18926,29,1407,1348,934,20770,473
2206,46,1611,1547,1193,17467,418
63689,34,357,349,296,5151,61
52288,5,36,706,29,2493,7
30022,61,1945,1135,1270,29802,675
28229,3,62,1169,43,3988,19
5433,48,3958,1512,2490,48099,1468
5605,27,932,1510,724,19965,208
11909,14,589,1455,303,7524,286
24766,2362,68520,1244,41604,218887,26916
18673,29,610,1353,429,8360,181
3060,101,2046,1540,1490,22384,556
14009,381,15467,1427,10672,89243,4795
9777,17,1178,1471,770,14994,408
65096,313,5056,306,4257,57324,799
7038,36,1036,1492,686,26280,350
23109,10,380,1278,281,7014,99
23999,146,3929,1262,2541,25198,1388
43461,49,1305,875,900,15811,405
2384,901,43749,1546,29353,375696,14396
50234,16,260,763,199,9006,61
55597,154,2224,601,1789,14938,435
47036,694,8234,834,6586,45167,1648
17573,28,733,1372,605,20587,128
8775,60,1731,1476,1067,13613,664
8048,305,6204,1479,3788,30167,2416
50964,247,2300,745,1855,32372,445
35365,52,1969,1033,1583,25837,386
34565,52,990,1053,677,12365,313
56967,155,5693,562,4074,42532,1619
70492,2,86,137,66,5398,20
34088,46,1007,1063,646,6716,361
10655,69,2624,1465,1683,31781,941
37340,407,9588,982,7448,86081,2140
57587,320,7613,546,5786,38976,1827
53496,38,692,669,526,6941,166
4501,10,171,1524,123,11757,48
9339,32,1531,1473,1039,38270,492
65605,36,259,295,224,3935,35
17834,55,1852,1367,1328,14041,524
14034,491,19387,1427,12178,149302,7209
3260,13,842,1538,574,19451,268
207,41,2019,1564,1326,33356,693
11008,1414,46666,1462,28471,121251,18195
23271,11,290,1275,199,6067,91
59634,12,96,479,79,4548,17
58566,271,5431,514,3807,53559,1624
37804,28,460,969,356,7065,104
69823,49,639,159,636,7960,3
64454,15,227,326,183,3386,44
16049,164,3716,1398,2690,62546,1026
59864,80,450,471,352,6292,98
53954,24,196,655,178,4148,18
5509,75,1513,1511,946,10042,567
26349,69,1848,1210,1098,19367,750
19554,69,1485,1337,1078,21961,407
62667,400,8866,376,7183,66652,1683
65099,199,2934,306,2321,16371,613
25781,18,626,1223,372,11109,254
28801,9,577,1159,341,13103,236
3748,141,6025,1533,4078,99052,1947
2605,3,166,1544,118,11497,48
56289,27,392,581,308,10040,84
14216,1388,43277,1424,29324,270184,13953
26265,88,2784,1212,1578,18456,1206
60283,4,43,456,33,3857,10
33307,372,6141,1078,4323,17841,1818
20128,2,270,1327,210,9816,60
17530,1145,35401,1373,24659,172863,10742
67804,11,173,226,148,4285,25
1382,3791,205254,1554,124165,363800,81089
32719,16,598,1089,368,10583,230
48454,15,204,815,147,6995,57
37999,471,11250,959,8645,77254,2605
24399,436,19371,1253,11156,81788,8215
69133,7,140,181,95,6789,45
58051,520,8285,532,6614,121762,1671
33239,140,4655,1078,3176,79784,1479
7510,76,1054,1486,694,18181,360
34908,4,154,1044,120,20179,34
1110,511,10891,1556,7043,89524,3848
62891,26,508,370,408,10079,100
38000,261,3785,964,3031,33533,754
49126,164,4303,793,2212,34078,2091
21383,21,1533,1304,1022,14838,511
23012,0,62,1279,42,8282,20
48373,40,524,816,388,10436,136
2018,147,3776,1549,2502,26214,1274
62577,25,239,378,149,6543,90
22140,45,1112,1294,740,15097,372
21090,395,13429,1310,8683,42623,4746
27743,63,1386,1179,871,16875,515
11544,40,1088,1458,660,12676,428
7577,137,4152,1485,2725,121223,1427
13577,4,207,1433,116,7483,91
69399,11,96,173,86,1727,10
53937,405,11467,655,8406,86855,3061
16056,21,337,1398,229,7463,108
48674,14,340,807,218,9571,122
21770,577,12079,1299,8760,63827,3319
10579,4000,183468,1466,98999,589881,84469
69212,22,229,179,182,5239,47
1027,83,3752,1556,2647,43184,1105
18478,28,419,1356,283,8195,136
38167,453,6332,960,4995,28076,1337
52409,96,1327,702,1110,14297,217
33439,104,1268,1075,896,38537,372
19741,286,8156,1334,6115,84338,2041
66287,12,215,276,182,6199,33
49858,2,18,773,14,2361,4
13474,9,755,1435,518,12685,237
46548,50,585,840,496,12934,89
41574,6,122,905,90,4307,32
19261,500,11499,1342,7362,37818,4137
34079,1030,23886,1063,18441,133334,5445
9935,3564,110557,1470,71842,419681,38715
2926,76,4495,1541,2978,33292,1517
4496,79,2202,1524,1557,81561,645
3943,92,2401,1531,1669,16203,732
6085,7575,435318,1504,276299,1121292,159019
8377,20,969,1477,518,10830,451
30357,29,715,1128,491,9379,224
20613,0,33,1319,26,4179,7
46925,10483,363061,829,257701,1288484,105360
23043,465,8596,1279,6121,36776,2475
5045,168,8395,1516,5121,54302,3274
31698,5,188,1105,101,4833,87
929,88,3420,1557,2340,90059,1080
8567,5,194,1477,144,8513,50
4898,28,1094,1518,760,19032,334
49300,33,559,788,482,13813,77
61094,15,194,425,155,8295,39
29476,12428,221043,1146,123436,848704,97607
23331,14,458,1274,324,12070,134
43829,26,602,871,501,17349,101
56449,5,77,577,54,5638,23
2251,213,5042,1547,3784,40734,1258
9959,1401,55794,1470,32944,283428,22850
5933,92,2734,1506,2162,57225,572
16101,459,14233,1397,9583,79911,4650
12012,13,797,1454,425,16571,372
35511,112,2881,1029,2247,86856,634
39825,284,9159,932,7519,50534,1640
64900,27,278,312,200,4205,78
19222,6,428,1343,296,18955,132
30954,310,5880,1117,3929,36880,1951
32569,25,331,1091,205,5937,126
67450,15,211,238,161,3358,50
43265,121,3159,877,2280,17077,879
64021,1709,25795,339,20210,101265,5585
66030,16,201,283,180,4565,21
24096,32,1324,1259,879,18687,445
15102,28,1451,1413,806,13489,645
15952,34,934,1400,756,10162,178
22216,10,219,1293,149,6597,70
25789,11,578,1223,385,23033,193
61171,19,616,423,487,13019,129
13646,4788,130143,1432,77968,655502,52175
12173,27,1127,1452,614,14037,513
51692,188,1824,725,1422,7596,402
64480,19,221,153,188,3696,33
12949,29,1165,1442,663,11976,502
14065,533,14490,1426,10218,126177,4272
67229,2,43,245,39,4974,4
56946,92,883,562,700,9702,183
51871,919,20260,719,15415,76491,4845
17123,8,200,1381,150,6962,50
29582,92,1465,1144,972,13277,493
60520,147,1001,447,962,11097,39
35133,33,613,1039,452,15721,161
17452,49,1348,1375,981,40849,367
24919,0,18,1241,14,936,4
28632,177,5708,1162,3739,71019,1969
4612,12,472,1522,326,14908,146
40348,435,7038,924,5394,66210,1644
67965,7,252,221,223,2419,29
15236,1035,34213,1411,22169,98898,12044
3252,499,9462,1538,6788,99509,2674
15540,14,877,1406,680,23132,197
26834,1222,30929,1199,18462,99703,12467
28888,207,3791,1157,2499,15280,1292
22559,4,172,1288,132,16024,40
49776,1093,14742,775,11326,132452,3416
49113,235,4603,794,2426,103760,2177
53844,77,1362,658,1071,14485,291
5730,983,35969,1508,22799,117480,13170
14902,28,643,1415,522,11515,121
25256,839,37034,1234,25518,77334,11516
61402,14,260,416,198,6941,62
67736,14,58,229,54,5139,4
44221,11,202,866,144,7354,58
32684,46,1370,1089,937,16004,433
34686,37,1123,1049,562,10991,561
8751,37,997,1476,653,12073,344
59590,9,65,481,54,3974,11
16012,313,8894,1398,6186,108863,2708
2937,150,11901,1541,7580,84611,4321
9497,22,791,1472,492,15675,299
68928,167,2676,189,2340,26038,336
61799,36,642,403,545,12545,97
23398,213,5073,1273,3589,55293,1484
40331,305,4407,924,3311,47901,1096
35636,17,301,1027,223,8371,78
13633,283,11620,1432,7023,102317,4597
66162,6,85,279,67,5686,18
11674,366,12507,1457,6804,53508,5703
6753,0,88,1495,59,12822,29
6809,12,397,1495,253,39024,144
16027,28,372,1398,275,22926,97
6442,227,10367,1500,6175,98243,4192
32566,61,1073,1091,652,15215,421
33151,75,1568,1081,1135,13377,433
63551,891,12165,354,8856,31579,3309
57566,17,211,547,175,6597,36
32195,19,458,1098,309,16862,149
58398,18,183,520,147,5083,36
61566,4,46,410,31,2762,15
11696,52,3862,1457,1432,13202,2430
35738,35,899,1025,605,8544,294
900,0,70,1557,52,10382,18
5091,51,2203,1516,1461,32468,742
29453,324,12806,1146,8965,125783,3841
40206,106,1674,926,1448,28319,226
13183,64,2815,1439,1518,16472,1297
60330,17,367,454,266,9754,101
54076,81,689,650,543,21847,146
36315,33,339,1009,292,10474,47
10944,1,41,1463,21,15417,20
17577,353,11043,1372,6666,39354,4377
1025,61,3100,1556,2138,44572,962
28154,256,4212,1171,2923,38125,1289
64691,126,1773,319,1509,12123,264
18606,9,466,1354,303,7774,163
32003,268,9297,1100,6607,64706,2690
50107,104,1179,766,897,23061,282
28472,76,1545,1165,1025,23921,520
9570,209,5326,1472,3296,28653,2030
14722,23,672,1417,539,6857,133
15188,57,2755,1411,1891,60290,864
42990,56,982,882,767,15086,215
2873,615,18792,1541,12561,72688,6231
54522,43,434,634,346,5085,88
50121,4767,64329,766,48172,355844,16157
58535,17,103,515,88,5895,15
64423,20,183,326,145,5863,38
38315,41,414,957,321,5380,93
25475,183,2927,1229,1824,27494,1103
25702,76,2209,1224,1342,17399,867
20161,115,6293,1326,4294,67198,1999
9461,15,418,1473,268,14775,150
26118,40,1181,1215,782,22146,399
65369,11,226,300,160,4263,66
29360,37,914,1148,599,22977,315
37944,3,70,966,38,5804,32
10235,1952,67489,1468,43279,368332,24210
56616,48,810,572,674,19464,136
1517,3,235,1553,156,18066,79
67771,19,186,228,145,3215,41
2395,141,3428,1546,2488,21559,940
3442,26,726,1536,584,11016,142
69336,1,6,175,6,4205,0
65612,9,125,294,110,4732,15
11267,5,205,1461,108,3315,97
6588,175,5316,1497,3533,40779,1783
49127,42,415,793,350,4854,65
62069,9,91,394,77,4946,14
22635,11,300,1286,197,3227,103
58559,120,728,514,597,11280,131
61852,1,10,401,7,1754,3
42977,326,35054,882,26243,31068,8811
17265,15,333,1378,250,6157,83
3552,97,3397,1535,2564,44585,833
25119,116,2564,1237,1643,27107,921
34935,1360,45393,1044,31760,211120,13633
65959,903,14138,285,10251,84828,3887
24585,2125,51165,1248,34395,277073,16770
25946,827,17725,1219,10284,133989,7441
17944,16,599,1365,486,8662,113
31915,377,6483,1102,4630,28732,1853
3034,195,4425,1540,3364,29002,1061
21719,85,1627,1299,1165,27048,462
11783,10,590,1456,209,8815,381
8591,45,2108,1477,1379,17117,729
8169,375,17100,1478,10634,68949,6466
16366,152,2508,1393,1796,30181,712
69898,65,672,157,636,17180,36
33130,576,12951,1081,9124,67063,3827
4261,21,1204,1527,743,16387,461
57852,373,7201,537,5552,48876,1649
61007,41,360,429,275,10026,85
26945,55,1079,1197,827,14794,252
15068,25,981,1413,694,40106,287
23557,3433,61399,1270,41149,197769,20250
34571,31,513,1052,355,9611,158
32760,24,322,1088,298,6356,24
2023,6,282,1549,211,20825,71
37102,16,414,989,309,11464,105
9507,5,199,1472,121,14534,78
52433,2,68,701,51,15899,17
60121,6,194,462,153,5419,41
15674,11916,476227,1404,320462,1303164,155765
62238,1446,24940,387,17012,86394,7928
1634,31,1344,1552,860,43619,484
60886,106,1112,433,977,12439,135
1646,13,370,1552,271,18491,99
23124,7,350,1278,262,8062,88
20076,18,1060,1328,703,10239,357
2507,425,20212,1545,12586,72500,7626
5749,9,952,1508,730,18339,222
67536,6,109,235,82,2046,27
44704,7,104,862,81,3962,23
18274,9,172,1360,136,10031,36
21426,3,271,1304,205,7398,66
18520,7,413,1355,329,11280,84
55039,31,350,616,280,21621,70
22164,21,1729,1293,1313,21636,416
27739,79,966,1179,610,13925,356
23710,198,4173,1267,2818,18802,1355
49163,7,109,792,79,3811,30
23592,48,934,1270,668,17083,266
56496,2,28,575,22,6472,6
48780,315,9126,804,6896,86664,2230
37014,13,312,991,253,6801,59
14827,130,2170,1416,1494,65658,676
26470,491,12331,1208,8698,65838,3633
52282,168,2730,706,1997,19173,733
8399,403,11178,1477,8022,130361,3156
15134,12,232,1412,167,17714,65
9389,15,1046,1473,662,23082,384
820,1273,50250,1558,30962,273680,19288
20824,5,159,1315,125,5643,34
3249,118,5445,1538,3852,78708,1593
66915,1216,24506,255,20023,137962,4483
67003,7,68,252,58,1989,10
2946,27,690,1541,471,22819,219
38092,19,516,962,455,13654,61
13915,5,504,1429,289,9174,215
11069,43,1694,1462,946,25385,748
63417,27,861,357,683,11455,178
11455,36,1507,1459,939,19903,568
35107,121,2492,1039,1837,19621,655
66954,6,97,254,66,4901,31
32717,31,389,1089,321,11963,68
1512,147,5931,1553,4104,77290,1827
2040,15,681,1549,469,15997,212
35947,1,87,1019,63,7448,24
28775,3,121,1159,105,5450,16
53509,349,5983,669,4461,62464,1522
64164,33,828,334,682,8923,146
32529,39,626,1092,413,8699,213
27867,566,12908,1176,8580,96916,4328
32279,5,133,1097,99,4736,34
29751,47,1384,1141,757,13005,627
62584,17,240,378,144,3179,96
34395,748,14549,1056,11312,85917,3237
5962,78,3641,1506,2379,39799,1262
19275,27,1330,1342,989,23737,341
68043,111,1481,219,1153,11863,328
61738,301,5976,405,4212,50736,1764
49960,4,43,771,36,4786,7
66538,10,68,268,50,4060,18
67296,21,276,242,214,3247,62
68618,20,163,199,125,3251,38
23284,41,1312,1275,1034,29672,278
19717,440,10949,1334,7621,134788,3328
58487,104,654,516,506,7065,148
29497,34,1074,1146,692,12720,382
31610,42,1720,1107,1275,13517,445
49814,340,3657,774,2701,48919,956
45796,368,4908,849,3773,34988,1135
65834,2,64,289,55,1996,9
36189,1499,15877,1013,13190,127237,2687
50987,11,118,744,94,5247,24
13492,66,1940,1434,1180,27100,760
9170,12,423,1474,241,8211,182
56153,53,677,585,579,11877,98
3224,56,1148,1538,864,74925,284
37940,82,1098,966,844,16648,254
30784,11,376,1119,229,15167,147
13204,33,959,1439,667,22869,292
61686,11,165,407,117,4711,48
51534,46,569,729,447,6457,122
65259,733,13606,303,10807,81853,2799
50990,36,776,744,613,8264,163
7802,19,738,1481,518,43582,220
36816,138,1871,997,1418,27050,453
29688,1533,85690,1142,59576,186814,26114
51901,17,437,719,342,6905,95
67884,4,122,224,94,2243,28
22707,598,20553,1285,15099,41875,5454
35486,466,5973,1030,4565,106331,1408
52885,52,456,685,353,6595,103
11741,12,253,1456,141,12100,112
48244,1180,21025,819,16134,210108,4891
59541,2257,49439,482,37217,253738,12222
19754,15,389,1333,239,11071,150
69134,64,841,181,738,11980,103
7618,332,12231,1484,7622,144951,4609
3072,457,10679,1540,7583,128569,3096
39863,174,2109,932,1738,15884,371
31908,86,3478,1102,2509,49627,969
18252,5,104,1360,78,16479,26
54227,136,2070,645,1616,19939,454
63671,244,3881,350,3133,20553,748
61833,46,658,402,545,11370,113
14411,1,126,1421,66,4926,60
20720,40,1123,1317,845,23117,278
60942,159,2194,431,1658,11630,536
66284,172,2120,276,1655,19716,465
60737,14,451,439,315,3795,136
10168,172561,8244160,1468,4254059,15045145,3990101
61388,6,127,306,85,3808,42
62239,51,567,388,490,9158,77
29997,10,454,1135,264,9125,190
57547,179,2849,548,2369,17092,480
2827,25,1341,1542,812,14507,529
19006,35,1508,1347,1062,19618,446
9446,103,5119,1473,3068,19447,2051
5100,332,8077,1516,5225,111535,2852
62,2052,114380,1566,70381,404014,43999
66196,19,278,277,231,4368,47
68211,193,7004,214,5456,40814,1548
51509,12,124,730,106,3928,18
23416,3764,118406,1272,68196,376511,50210
64954,35,1109,309,760,13942,349
3242,6,256,1538,197,7072,59
24396,43,1135,1253,757,16401,378
49596,5,120,780,77,11050,43
9929,412,11953,1470,6663,68911,5290
33174,305,4205,1080,2707,44692,1498
6433,7,246,1500,155,7343,91
49787,62,1131,696,996,21459,135
57234,49,503,555,402,6856,101
45672,130,2202,851,1679,18564,523
64718,447,7721,318,6280,37793,1441
7700,517,10367,1483,6791,86979,3576
67560,3,40,234,32,3344,8
4377,46,1781,1525,1295,47852,486
36726,11,285,999,226,13066,59
56156,5,82,585,68,4288,14
60133,34,262,462,245,6577,17
64942,6,85,311,65,4299,20
10890,206,4942,1463,3273,55317,1669
14122,401,13405,1425,9466,96233,3939
38754,680,7918,946,6064,76518,1854
12071,136,8498,1453,4034,52837,4464
68595,31,429,200,311,6469,118
66989,32,362,252,254,15151,108
18007,5,399,1364,262,10912,137
29624,127312,3735954,1143,2613280,8739773,1122674
20257,316,3496,1325,2911,33167,585
42950,7,172,882,132,4734,40
22496,3355,77753,1289,57765,416799,19988
59093,6,167,497,129,2695,38
37942,1355,22337,966,17874,184003,4463
34641,144,1146,1051,881,11257,265
65704,7,31,291,26,1623,5
11411,46,1975,1459,985,18824,990
29431,250,10095,1147,5671,45510,4424
60034,27,168,465,128,4813,40
54573,105,1553,632,1202,9303,351
55308,117,2155,608,1836,27148,319
4987,49,1491,1517,1006,46809,485
26814,182,2590,1199,1531,19360,1059
17259,409,7881,1378,5350,81131,2531
17736,4724,189776,1369,119110,449851,70666
31644,66,2756,1095,2331,31096,425
33374,6,262,1077,157,8628,105
10319,544,14788,1468,9624,105011,5164
31053,52,1429,1115,1162,10033,267
6903,40,990,1494,676,32189,314
10273,0,47,1468,37,7356,10
19720,4,152,1334,127,11780,25
31274,4385,90712,1111,55327,191798,35385
13167,29,489,1439,256,9011,233
18549,99,1465,1355,1200,19611,265
62296,28,382,386,289,3994,93
1452,5,236,1553,170,9944,66
5441,167,20698,1511,13770,69924,6928
6012,18,346,1505,227,9792,119
20588,93,1948,1319,1261,33689,687
18027,455,8638,1364,5195,43175,3443
18096,1162,22829,1363,15465,78957,7364
50853,0,30,748,23,2695,7
59504,220,2758,483,2224,17969,534
59024,14,171,500,118,6315,53
2745,30,638,1543,483,20078,155
5824,15,414,1507,256,6321,158
57827,8,81,539,69,2103,12
3707,226,5045,1533,3621,60681,1424
27656,40,2168,1181,1282,15473,886
22691,3506,99254,1285,67073,405032,32181
18886,2,86,1349,72,7834,14
46092,132,2031,846,1606,46716,425
20088,6,507,1327,380,11074,127
212,152,3569,1563,2490,36091,1079
56370,6,92,579,76,5801,16
38757,38,792,946,627,12820,165
31975,57,909,1101,572,12273,337
58491,1310,14451,516,11326,62440,3125
27475,7,463,1185,267,8158,196
21215,2112,52462,1307,33674,237639,18788
31424,1105,31492,1089,22519,123132,8973
55236,324,4120,611,3480,61108,640
18369,77,2033,1358,1566,17493,467
54489,463,5750,635,4421,45102,1329
62119,4,24,391,22,2427,2
55798,767,6827,596,6298,46828,529
56870,12,125,564,85,3262,40
15018,87,2710,1414,1647,29037,1063
23261,14,603,1275,446,15284,157
52293,1,39,706,28,4980,11
64230,180,2133,332,1568,29022,565
3412,20,766,1536,532,20050,234
28176,664,20955,1171,14933,131444,6022
49643,9,183,779,131,4408,52
54138,265,4150,648,3275,21874,875
28929,12,308,1156,184,11586,124
36154,179,4976,1014,3653,41235,1323
14645,25,1052,1418,715,24521,337
15184,4,1050,1411,692,11601,358
23200,455,14610,1276,10323,87006,4287
29076,12,478,1153,306,6178,172
17857,146,3271,1367,2154,119418,1117
56136,44,944,586,684,8634,260
49299,115,1497,787,1201,15920,296
39908,25,236,931,177,3373,59
56096,45,575,587,435,6015,140
52019,25006,312079,699,226302,965197,85777
26395,67,4660,1209,2887,28922,1773
32747,270,6873,1089,4653,44008,2220
11242,4,94,1461,57,11388,37
1267,66,3093,1554,2275,79215,818
15432,74,1506,1408,1040,9973,466
60259,103,1014,457,829,14467,185
69836,33,392,159,343,4194,49
15926,104,2202,1400,1609,16034,593
19677,14,821,1335,571,21764,250
15467,359,8600,1407,5634,52780,2966
66852,14,283,257,197,5925,86
66297,25,357,275,266,6034,91
62595,90,1265,378,960,14931,305
28702,6,132,1160,80,10525,52
22942,11,352,1280,231,5519,121
25477,33,726,1229,525,9230,201
31264,21776,664432,1111,452996,1590177,211436
7615,193,16596,1484,11289,95979,5307
49944,34,569,771,319,9387,250
14953,18,819,1415,535,15447,284
20726,40,1019,1317,722,12435,297
50947,102,1763,745,1379,21529,384
63259,68,884,361,700,13296,184
56374,7,89,579,81,4196,8
28362,361,8021,1167,4953,57864,3068
65184,1,62,304,38,3805,24
49553,23,398,781,329,9745,69
15755,28,1316,1403,968,43359,348
15277,153,3069,1410,2172,31894,897
8056,116,6042,1479,3219,51444,2823
31554,102,3259,1108,2017,23099,1242
4603,77,1210,1522,879,10897,331
12522,87,1971,1448,1160,24813,811
8418,20,258,1477,171,6855,87
2473,37,1624,1545,1151,33786,473
25426,780,23686,1230,15461,175509,8225
65154,8,49,305,33,4339,16
65376,0,4678,300,3777,48414,901
29452,993,19751,1146,12723,142930,7028
7422,208,3888,1487,2525,39991,1363
18609,4,134,1354,110,12060,24
31472,188,2429,1109,1633,15035,796
37833,70,1671,969,1297,18039,374
5401,109,4369,1512,2894,32330,1475
60805,41,780,436,498,24649,282
53618,15,202,665,150,14981,52
18939,6,274,1348,208,9235,66
32321,7,219,1096,132,9200,87
33877,448,6964,1068,4975,28341,1989
19104,17,1221,1345,717,40820,504
26017,4209,120876,1217,73165,293779,47711
19239,164,3062,1343,2229,29512,833
2798,22,1179,1542,814,30058,365
59733,2478,60498,475,42136,226045,18362
3991,16,704,1530,490,41236,214
17095,106,4075,1381,2586,49444,1489
32223,30,475,1097,315,10241,160
56725,62,1041,569,906,15340,135
3011,306,7176,1540,4634,65923,2542
58261,132,1691,524,1247,14999,444
21412,34,1311,1304,954,26213,357
27139,97,3537,1193,2146,75425,1391
63873,11,129,344,91,2266,38
38280,142,1448,957,991,11072,457
35965,1335,16222,1019,11659,159845,4563
34087,111,2158,1063,1377,17130,781
9131,4385,162805,1474,97168,382022,65637
21251,14,628,1307,404,4524,224
61788,1710,33545,396,24754,197485,8791
1774,6,331,1551,228,19424,103
59167,12,174,495,146,7040,28
21349,111,1183,1305,835,19073,348
49612,663,8893,780,6915,37341,1978
37160,9,128,987,112,8870,16
23476,568,10650,1272,7433,106275,3217
41874,151,1659,899,1244,16792,415
38073,477,13242,963,9851,138152,3391
25479,18,596,1229,502,28587,94
19161,449,8746,1344,6667,104801,2079
29609,8,240,1144,145,18071,95
33827,5,121,1068,97,14201,24
44501,11,197,864,150,7278,47
66549,32,651,267,545,11210,106
7852,45,2474,1481,1781,65213,693
29045,107,2876,1154,1856,28465,1020
25522,0,0,1229,0,14559,0
67597,28,291,233,253,8790,38
16136,68,2423,1397,1807,32469,616
9383,17,215,1473,156,8303,59
3023,842,12097,1540,7863,39804,4234
37334,231,3207,982,2089,45738,1118
6051,119,1798,1504,1280,38241,518
18049,58,1257,1363,922,32153,335
35204,23,687,1036,513,20217,174
52396,20,454,703,322,13654,132
51689,22,232,725,193,13905,39
12617,17,1266,1447,678,41028,588
51767,12,145,723,121,8753,24
13093,1769,108103,1440,61494,362242,46609
13679,239,8093,1432,4401,53687,3692
1371,244,7324,1554,5148,57537,2176
18338,593,29433,1359,19810,152454,9623
34800,133,1846,1046,1256,21942,590
68936,26,156,189,135,5386,21
8691,23,1132,1476,710,13602,422
5945,69,4191,1506,2797,67562,1394
13961,4531,139558,1428,91100,935516,48458
39018,2177,43753,942,34613,239843,9140
63033,123,1882,367,1580,23750,302
33902,564,10140,1067,7475,68957,2665
41297,444,7342,909,6094,70905,1248
36365,797,18127,1007,13704,98701,4423
33039,531,12091,1083,8855,61953,3236
53279,4,85,674,73,6615,12
14643,157,4997,1418,3225,18671,1772
61209,138,1325,421,955,9659,370
38407,129,1655,953,1469,25282,186
21135,42,1052,1309,690,11124,362
30980,636,17825,1116,12075,151386,5750
23653,357,8500,1269,5870,34900,2630
26194,286,5030,1214,2960,27190,2070
57138,10,322,558,148,8168,174
40387,24,821,923,647,27179,174
17453,75,1127,1375,926,26687,201
18922,0,0,1348,0,17534,0
33929,266,6126,1066,4329,59116,1797
14876,47,949,1416,599,7734,350
20307,5,142,1324,117,7303,25
59763,192,2565,474,2266,28082,299
22079,35,812,1294,542,11049,270
56741,373,6156,568,4597,42314,1559
28001,1257,11998,1173,8714,83514,3284
29175,2299,35156,1151,26345,310304,8811
35966,3168,53469,1019,43956,288889,9513
46445,107,1528,842,1291,18099,237
28774,13,425,1159,310,8897,115
63904,64,948,343,793,18715,155
21033,83,2496,1311,1884,43038,612
36341,19,342,1008,296,7875,46
29841,21,701,1139,408,10307,293
59592,65,1504,480,1270,12474,234
18805,85,1794,1350,1470,16580,324
10296,6,386,1468,272,11145,114
58766,9,121,508,93,4882,28
34753,0,5213,1048,3715,38762,1498
13060,319,12133,1440,8577,80825,3556
9557,115612,3010861,1472,2167278,7007584,843583
64796,3,54,316,44,2275,10
8495,17,440,1477,291,9042,149
7637,94,3514,1484,2284,50221,1230
376,37,1465,1562,1062,54583,403
51648,21,186,726,150,3434,36
36328,1364,26823,1007,21555,134910,5268
50781,124,2984,750,2036,13638,948
35016,13,528,1041,312,9037,216
50784,265,3273,750,2437,20852,836
26813,36,1120,1199,671,28441,449
61606,5,43,410,35,4133,8
62326,109,1277,385,1025,11720,252
8634,764,14748,1476,9590,85284,5158
33273,111,1634,1078,1374,21748,260
54274,4646,49740,643,35201,178923,14539
63525,14,101,354,71,6668,30
27772,26,827,1179,465,10160,362
51810,45,492,721,424,16695,68
1855,25,2165,1550,1001,16627,1164
10320,12,415,1468,262,36456,153
34871,6,343,1045,210,8032,133
8574,27,1572,1477,941,13868,631
18066,27,1107,1363,842,26008,265
21864,163,4757,1297,2934,42853,1823
28208,9,200,1170,160,10700,40
24820,37,849,1243,560,19578,289
15982,139,3999,1399,2595,71247,1404
8287,23,568,1478,357,23087,211
49713,375,4358,767,3633,39881,725
13774,21,1293,1431,726,15821,567
26783,130,2997,1200,1908,46645,1089
34756,1215,18160,1048,13497,89652,4663
67422,23,372,239,295,5247,77
31327,4,227,1111,193,23398,34
63237,3,62,362,38,2755,24
57224,33,220,556,188,3640,32
34738,12,236,1048,171,8278,65
35002,4965,151420,1042,108973,684007,42447
64844,13,86,314,64,5550,22
54840,27,437,622,344,3903,93
9207,794,19103,1474,13605,47500,5498
64007,15,136,340,109,4509,27
68961,6,72,188,57,2478,15
22043,859,17487,1295,11982,92117,5505
28444,52,1598,1166,889,8751,709
14169,54,1164,1425,813,13613,351
38299,0,0,816,0,2237,0
52209,55,484,709,384,5122,100
19982,7,303,1329,199,15367,104
50199,0,9,764,7,1481,2
5946,101,4326,1506,2995,60311,1331
15202,51,1186,1411,855,13074,331
2529,16,482,1545,320,45926,162
10426,126,4955,1467,3119,26795,1836
20486,0,111,1321,64,7735,47
13571,908,22817,1433,13940,85203,8877
37215,91,3023,986,1984,30798,1039
19894,343,17682,1331,11395,53629,6287
57528,116,1568,548,1141,19652,427
24475,1014,17820,1251,11997,100588,5823
41955,29,327,898,238,3687,89
22651,157,1801,1286,1148,21785,653
15298,555,15676,1410,10807,99689,4869
61622,99,1715,409,1403,19911,312
23365,16,210,1274,150,4898,60
23281,14,600,1275,438,18651,162
53417,10,99,670,84,9816,15
50728,7,177,751,140,8780,37
9096,26,960,1474,581,11679,379
2958,134,3285,1541,1980,24867,1305
29077,45,1272,1153,796,14773,476
26732,9,430,1201,247,7495,183
25255,255,9535,1234,6209,43125,3326
25410,5,153,1231,92,6390,61
40852,38,765,916,618,21579,147
69830,5,140,159,121,2425,19
8068,44,983,1479,615,13582,368
19747,53,1292,1334,860,9692,432
24176,74,2839,1258,1793,37312,1046
26452,270,13373,1208,6630,82089,6743
58375,24,384,521,324,4110,60
15272,1257,37196,1410,23000,155457,14196
11611,5,500,1457,259,21039,241
10453,125,1816,1467,1273,16683,543
62196,293,9665,389,7674,54140,1991
3116,333,19210,1539,13356,79199,5854
23665,50,832,1268,570,20954,262
60756,425,6376,438,4855,20101,1521
61667,16,203,408,153,3346,50
28310,11,356,1168,218,19781,138
28503,245,3762,1164,2011,29390,1751
36742,367,8495,999,6460,45723,2035
22221,32,659,1293,447,7626,212
56876,0,0,564,0,7604,0
57863,7,119,537,97,6171,22
60816,0,0,260,0,3886,0
3146,27,676,1539,460,61332,216
40906,32,522,915,399,12509,123
58802,6,97,507,66,3648,31
1259,73,3493,1554,2525,39077,968
69928,21,299,156,290,5657,9
61884,728,8412,400,6854,37188,1558
10394,2947,85189,1467,53846,180143,31343
69511,2,72,170,53,5605,19
1640,41,879,1552,609,22940,270
35880,2369,38556,1021,29620,230925,8936
39069,203,1712,941,1343,11793,369
26749,35,687,1201,538,30307,149
69548,26,312,165,273,3256,39
10188,4,91,1468,59,8121,32
5818,13,167,1507,115,4581,52
10594,2147,32079,1466,21353,140429,10726
66521,2,65,268,46,3100,19
41704,205,3538,902,2693,35912,845
25493,1621,47750,1229,30801,211318,16949
54007,2339,25825,653,20447,170204,5378
66189,44,580,278,459,8905,121
3733,663,37835,1533,23678,258106,14157
25506,97,2240,1229,1569,37534,671
33618,272,4786,1072,3526,44127,1260
40006,18,331,929,229,6418,102
6566,294,6324,1498,4759,48473,1565
62509,42,667,379,557,13878,110
34888,2,499,1044,262,17187,237
20311,38,1895,1324,1291,10849,604
10938,352,17803,1463,10137,94245,7666
59240,28,429,493,359,11686,70
38282,53,735,957,592,19566,143
23783,53,1729,1266,1184,20054,545
34796,47,762,1047,591,17107,171
57069,158,1756,559,1310,14305,446
38163,0,30,960,28,2915,2
32592,2041,22845,1091,15774,71815,7071
2362,57,2171,1546,1507,16970,664
48497,256,4121,808,3371,37940,750
68913,13,220,189,185,8066,35
42039,14,177,897,140,11592,37
29330,42,465,1148,374,10120,91
5939,18,908,1506,563,8638,345
20468,17,1049,1321,701,21414,348
20458,5,168,1321,138,5049,30
35305,4002,82436,1034,56932,327351,25504
38123,62,1948,961,1178,36836,770
19539,7,284,1337,217,7869,67
10128,6,495,1469,341,15239,154
28034,44,833,1173,550,9778,283
66477,25,222,270,177,4183,45
48701,342,5903,806,4353,36279,1550
47259,808,8212,831,6273,44871,1939
32901,87,1754,1086,1236,21550,518
63156,14,183,363,137,3274,46
61712,360,3687,406,2892,17550,795
29119,27,282,1152,255,11587,27
11823,20,668,1456,393,9356,275
3207,16,790,1538,539,28469,251
37404,1286,41323,980,32272,190340,9051
32221,22,902,1097,532,12401,370
8958,165,5641,1475,3388,33164,2253
20403,2,190,1322,140,6307,50
6960,107,4207,1493,2662,39887,1545
21210,8,374,1307,260,11639,114
68693,11,130,197,91,3952,39
36529,263,3812,1002,3062,37356,750
59239,38,637,493,510,8881,127
61371,5,91,416,61,4639,30
52441,3,72,701,50,5791,22
17688,26,355,1370,268,8687,87
26553,140,4813,1205,2746,38856,2067
13343,91,4654,1437,2200,81424,2454
61271,146,2097,419,1801,40204,296
52044,483,7253,714,5818,79507,1435
29383,41,886,1148,540,14136,346
51578,7,70,728,57,10779,13
47176,1083,16082,832,13006,74653,3076
37045,46,723,991,576,9458,147
29474,129,1883,1146,1207,15935,676
16450,19,257,1391,199,13554,58
7488,390,7938,1486,5081,48835,2857
24754,4,192,1244,143,6551,49
10947,66,2830,1463,1889,26840,941
3682,169,9772,1534,6578,64639,3194
14817,5,274,1416,185,7331,89
26149,19,776,1215,468,11129,308
51187,24,276,739,258,7618,18
67389,5,21,240,13,16803,8
59920,97,2085,469,1392,21597,693
4955,16375,437732,1517,257268,976714,180464
66535,1,8,268,6,1108,2
21399,25,522,1304,369,11349,153
46474,35,492,842,405,6864,87
43440,304,3881,875,2949,20590,932
24073,143,1553,1260,1140,98553,413
45882,122,2204,848,1684,26200,520
13900,4,558,1429,318,6621,240
16000,2007,30773,1399,17081,283274,13692
64037,11,124,339,105,3632,19
26363,16,488,1210,307,5331,181
587,227,7705,1560,5243,89552,2462
8343,194,6830,1478,4251,43269,2579
56704,15,319,569,232,13725,87
55785,100,851,596,686,11938,165
46453,40,655,842,518,22006,137
1450,438,12891,1553,7094,72649,5797
32693,11,345,1090,234,25094,111
4099,308,13293,1529,8786,128102,4507
50978,1214,23434,745,17411,92055,6023
10109,70,6740,1469,4200,43851,2540
58552,167,4220,514,3145,26401,1075
27488,43,1823,1185,1238,22863,585
50902,953,11196,747,7905,39024,3291
36136,33,775,1013,684,10334,91
30356,47,1272,1128,739,7326,533
31703,116,2084,1105,1309,22070,775
15704,147,2996,1404,2017,30985,979
8736,16,830,1476,586,12120,244
29393,8,310,1147,179,20056,131
5622,2071,73514,1509,34631,199315,38883
51548,98,1206,729,884,17298,322
16418,1,150,1392,107,15387,43
27989,51,767,1174,580,6488,187
2105,1,150,1548,101,19799,49
13867,74,1342,1429,782,9808,560
38538,1,23,950,14,1666,9
9200,66,2450,1474,1617,16326,833
32464,77,2128,1093,1348,15030,780
52164,71,711,710,527,17904,184
69645,1,35,166,29,2869,6
37573,70,1628,975,1345,13361,283
69577,1,47,168,41,2428,6
7086,45,1772,1491,1172,40572,600
34115,333,21695,1062,13181,46509,8514
26983,2671,90808,1196,60656,402236,30152
32260,2,218,1097,135,6244,83
14927,0,0,1415,0,8026,0
69622,5,50,167,41,2839,9
56104,17,161,587,149,13293,12
35629,37,979,1027,627,11769,352
69517,14,169,170,141,2447,28
49790,18,384,775,333,15185,51
27615,598,11988,1181,7618,77031,4370
48706,82,1085,806,915,17775,170
50000,13,116,769,107,10213,9
65178,54,1036,304,838,13200,198
51748,52,989,723,832,16135,157
14502,75,4297,1420,2946,26184,1351
5191,11,569,1514,446,12821,123
14090,37,1846,1426,1254,16152,592
10636,124,5093,1465,3461,36461,1632
22769,69,2047,1284,1491,21111,556
53143,11,167,677,135,5427,32
64614,15,136,321,122,5309,14
3600,88,2640,1535,1809,15865,831
1395,4790,198654,1554,99242,455582,99412
14172,66,3134,1425,2091,40644,1043
29667,62,1889,1143,1315,26502,574
45538,925,22907,852,19018,152017,3889
57377,7,73,552,66,14724,7
29860,650,25535,1138,18169,131691,7366
9163,43,3475,1474,2440,44142,1035
34893,16,463,1044,341,6007,122
69984,5,48,155,40,2299,8
13533,17,875,1434,519,8986,356
53051,3,143,680,113,2587,30
65678,119,1808,292,1422,27210,386
38901,2113,36893,943,26677,104204,10216
1265,6,273,1554,157,28027,116
9472,483,17715,1473,11443,118195,6272
14839,9,406,1416,307,13093,99
56020,1882,56907,588,44268,297793,12639
25626,87,1709,1226,922,8199,787
23515,189,6551,1271,4778,53123,1773
36858,92,2101,997,1577,18355,524
59233,43,687,493,553,27830,134
13419,69,2000,1436,1281,41087,719
25851,49,586,1221,338,10309,248
4414,9,392,1525,286,11870,106
64070,18,153,337,102,5901,51
33348,155,3535,1077,2467,30415,1068
61272,4,99,419,82,2366,17
10517,1131,66240,1466,39137,222402,27103
20036,145,4483,1328,2954,57495,1529
46216,24,573,845,410,12231,163
22737,6,341,1284,237,16200,104
24467,447,14766,1251,10387,101540,4379
11003,11,364,1462,213,9590,151
18564,5,112,1355,70,7165,42
35373,306,6340,1033,4797,36259,1543
58509,102,1767,516,1341,16517,426
65587,29,217,295,154,2323,63
33987,81,1860,1065,1261,26974,599
55046,49,426,616,325,4878,101
34301,15,437,1059,312,6261,125
38841,86,1284,944,1030,19980,254
28465,277,5013,1165,3563,27779,1450
28648,15,503,1161,340,9454,163
12220,16,435,1452,238,7484,197
66463,81,944,270,797,14727,147
61025,10,103,428,82,5524,21
163,3,234,1564,153,10829,81
39143,204,2911,940,2335,29697,576
15838,4,211,1402,141,9475,70
61122,10,259,424,217,8318,42
23257,3,225,1275,178,14265,47
8193,460,18414,1478,11525,76182,6889
32649,13,364,1075,255,11600,109
35879,29,1084,1021,803,15364,281
27457,36,894,1186,585,9660,309
3819,400,6347,1532,4539,29503,1808
40349,8,94,924,75,5794,19
20440,12,331,1322,258,6948,73
27399,429,6862,1187,4841,34768,2021
63858,20,425,345,352,5796,73
63839,1753,34555,345,22016,220483,12539
7328,972,29567,1488,18182,147219,11385
24685,63,1001,1246,706,12885,295
31796,26,674,1103,435,21121,239
15391,132,3256,1409,2102,39873,1154
22266,17,285,1292,223,5163,62
55918,17,521,592,394,13534,127
29594,3,99,1144,81,3571,18
28548,8,282,1164,162,7918,120
41914,6,125,899,81,3299,44
64925,202,3946,311,3121,34537,825
11570,0,0,1458,0,9984,0
29430,4,307,1147,267,5905,40
6238,108,4326,1502,2581,42346,1745
61391,8,83,416,57,2037,26
53386,183,1732,671,1394,10396,338
55348,235,2566,608,2019,24098,547
59252,86,744,492,602,6637,142
51899,35,425,719,346,5206,79
12575,219,5000,1447,2900,37056,2100
17145,118,2379,1380,1613,27706,766
28763,32,944,1160,664,20125,280
29775,678,27383,1140,17252,137680,10131
23217,10,751,1276,485,9404,266
5147,7,369,1515,246,23606,123
12235,1702,27667,1451,17271,100707,10396
55911,247,2555,593,2116,23608,439
16286,23,651,1394,402,14361,249
28416,172,2468,1166,1596,42431,872
8557,27,534,1477,340,8577,194
21047,38,1377,1311,1130,24476,247
11749,35,958,1456,425,13343,533
19348,2154,36222,1341,20782,264495,15440
30089,156,4578,1133,2983,55469,1595
37749,267,3782,971,2918,22390,864
67795,35,406,227,319,4327,87
45232,7,216,856,180,3051,36
64508,17,344,324,256,9250,88
21532,10,415,1302,300,11363,115
35752,1,22,1024,14,2275,8
53800,84,730,660,583,11884,147
7274,485,8643,1488,5729,39309,2914
3594,119,3386,1535,2284,46176,1102
6225,170,5589,1502,3897,33834,1692
15905,133,3459,1400,2128,51119,1331
63650,10,69,351,58,2468,11
23402,45,1303,1273,862,13170,441
16907,2807,66295,1384,44471,181565,21824
63403,870,11466,357,9114,77340,2352
18275,34,1128,1360,798,10252,330
28048,6,299,1173,177,13476,122
21326,51,2525,1306,1647,18675,878
3079,146,3332,1540,2053,23398,1279
70457,8,89,138,87,3482,2
67487,24,355,237,277,7890,78
11660,53,3061,1457,1550,25663,1511
39182,5,103,940,75,3891,28
20599,303,10670,1319,7339,90871,3331
866,3461,130597,1557,84097,328928,46500
47092,16,199,834,120,11233,79
26851,4661,53875,1199,38392,190662,15483
39879,4,202,931,167,11589,35
68264,9,255,212,183,5966,72
62701,2180,28562,375,20788,73123,7774
35648,207,2724,1026,2027,16532,697
19592,9,341,1336,271,8750,70
8357,35,626,1478,403,5835,223
17362,62,2371,1376,1630,31818,741
44014,1853,38545,869,28750,166470,9795
31315,17,334,1111,224,12369,110
42138,26,544,895,362,9617,182
50284,88,1348,762,1087,16837,261
22670,26,533,1285,447,15077,86
26836,26,764,1199,463,3614,301
32572,44,496,1091,345,7639,151
34906,13,392,1044,262,3522,130
2992,652,29976,1540,21769,100846,8207
12868,66,5034,1443,2781,38684,2253
42664,88,1282,887,960,31116,322
5560,66,1424,1510,960,26783,464
36466,169,3608,1004,2623,30242,985
24015,1180,30144,1261,20013,153826,10131
17490,26,604,1374,440,22448,164
28747,7,380,1160,309,5589,71
11864,61,6561,1455,2883,59406,3678
16081,948,18835,1397,15018,167807,3817
23399,6,189,1273,141,9585,48
50410,150,3734,759,2858,29583,876
13762,297,6542,1431,3924,75610,2618
8260,4,202,1478,132,14769,70
26393,32660,1346710,1209,828020,3853056,518690
63976,9,104,340,79,3114,25
68055,14,191,219,158,8053,33
38150,9,170,960,148,11497,22
52242,28,551,708,465,9976,86
53148,3588,69654,677,55641,271024,14013
4546,20,657,1523,484,14718,173
1714,7,278,1551,188,17683,90
8676,609,42748,1476,25077,302133,17671
32966,31,653,1084,407,6967,246
60639,11,151,442,110,8637,41
38090,177,1667,962,1305,10646,362
66294,11,189,275,159,14669,30
12963,248,6707,1442,4108,74018,2599
4487,20,600,1524,402,20020,198
11706,36,1612,1457,892,13904,720
55265,23,124,610,87,3188,37
40328,25,456,925,348,9383,108
69458,9,143,172,130,4221,13
33312,15,696,1078,369,9937,327
23486,7,261,1271,195,6421,66
38458,1464,23753,952,18459,155634,5294
3167,500,14764,1539,9104,52869,5660
62046,591,13930,395,11544,59699,2386
25727,71,3089,1224,2149,36145,940
7220,160,4044,1489,2726,27126,1318
60331,145,1176,454,948,30591,228
20856,8,292,1314,227,13146,65
25064,37,1372,1237,910,32088,462
1823,47,889,1550,623,31061,266
52954,7,83,683,43,3005,40
23645,111,1807,1269,1212,40310,595
34570,892,28379,1053,19754,102612,8625
12867,7,255,1443,151,4115,104
14794,107,1466,1417,1033,10170,433
29940,140,3531,1137,2080,14490,1451
1394,7,334,1554,248,20605,86
31157,50,1038,1113,662,18935,376
26931,174,6941,1197,4197,38052,2744
65057,4,96,306,80,3553,16
20263,0,14,1325,13,2641,1
65501,104,1411,297,1241,17499,170
6362,590,16361,1501,9628,119883,6733
49436,71,858,784,692,16391,166
37874,1068,18471,968,15441,110896,3030
17168,8128,250998,1380,169109,655025,81889
35050,835,14735,1040,11049,106037,3686
34034,123,1756,1064,1350,26754,406
3501,87,2379,1535,1595,58071,784
16262,41,1221,1395,828,10744,393
2294,210,11738,1546,5404,81494,6334
58695,2268,36374,510,29234,122097,7140
45831,239,2579,849,2212,25172,367
67153,137,2116,247,1659,29843,457
19514,1072,40910,1338,28218,252924,12692
42580,306,7067,889,5714,63740,1353
7845,122,3205,1481,2149,41141,1056
11550,1553,71080,1458,39803,386546,31277
68821,79,1505,193,1267,6955,238
64903,7,68,312,52,5241,16
30143,62,1383,1132,876,16620,507
58800,6,48,507,39,3179,9
56824,98,1843,566,1378,9023,465
834,823,22568,1558,14534,138681,8034
47184,113,2475,832,1821,29418,654
32723,1976,58918,1089,37020,188038,21898
16462,5,188,1391,133,13841,55
35718,2930,38281,1025,28446,105520,9835
9410,23,1161,1473,814,14664,347
38419,7,302,953,235,17162,67
49900,12,107,772,91,4895,16
19525,189,2558,1337,1654,13547,904
42035,91,2378,897,1638,15111,740
3597,29,898,1535,651,13930,247
24395,33,1020,1253,717,12518,303
48566,874,15811,810,11831,81564,3980
41919,592,11317,898,8362,100689,2955
51861,5,194,720,131,5749,63
18360,123,3764,1358,2474,41675,1290
15677,2,188,1404,145,7706,43
54165,5,107,647,80,4227,27
17904,230,8953,1366,6136,59617,2817
21058,33,756,1310,616,12780,140
16792,11,323,1386,235,14339,88
10751,370,13410,1464,8379,102270,5031
51844,269,3003,720,2417,20658,586
21586,56,2465,1301,1569,12358,896
19060,62,1759,1346,1198,72600,561
58279,6,122,524,100,3792,22
64861,1,23,314,17,2172,6
32399,562,10881,1095,6881,90978,4000
35335,23,610,1033,466,20051,144
38338,4,183,956,128,8193,55
33392,65,459,1076,382,8283,77
56342,59,745,580,537,12183,208
24374,29,956,1253,680,16070,276
38279,24,485,957,322,12574,163
4390,778,16921,1525,9799,80103,7122
37580,3,32,975,26,2018,6
3203,69,1614,1538,1157,100539,457
58168,157,2186,528,1702,24437,484
15142,135,12378,1412,7920,43688,4458
9453,42,1527,1473,905,15099,622
62152,33,276,390,222,9646,54
551,95,3136,1560,2171,52710,965
34492,951,16789,1055,12623,90687,4166
40154,301,6906,927,5639,47725,1267
49948,15,235,771,178,4102,57
57371,4449,73997,552,58026,321135,15971
65222,124,5378,303,1581,13953,3797
13347,45,753,1437,457,7954,296
58289,23,268,523,200,13509,68
52381,12,178,703,157,16768,21
50486,25,539,757,431,10392,108
6748,119,5147,1495,3346,104608,1801
60114,68,1205,462,966,27223,239
37769,66,629,970,514,12006,115
61201,6,66,422,51,4169,15
9145,11,903,1474,550,17425,353
22681,34,1009,1285,733,24140,276
49505,67,885,782,730,23497,155
11678,234,11042,1457,6186,74026,4856
61995,4454,201672,391,120253,621826,81419
3503,19,531,1535,364,20388,167
33424,1,66,1076,41,3050,25
40891,9,247,915,174,7176,73
36912,4,191,995,152,14603,39
66505,1,50,269,34,2665,16
24125,721,14199,1259,9853,33116,4346
30250,5089,89256,1130,60083,387262,29173
20651,62,969,1318,727,16962,242
3690,21,794,1533,485,19050,309
12606,9,579,1447,268,4512,311
53731,107,1833,662,1408,31108,425
14085,758,15838,1426,10018,122771,5820
23967,28,1081,1262,693,18479,388
48439,94,2681,815,2090,61602,591
52264,27,455,707,366,14034,89
38063,0,11,963,9,5017,2
61576,36,374,410,305,7786,69
63760,158,1788,348,1436,7812,352
32573,507,7737,1091,5692,26407,2045
52235,1507,21921,708,16516,93947,5405
10527,2843,112225,1466,69650,305108,42575
55131,21,227,614,194,7905,33
65821,85,1391,289,1150,12261,241
55633,25,472,600,308,16403,164
35669,84,2230,1026,1783,28334,447
51764,65,594,723,473,6388,121
951,631,19100,1557,12420,81344,6680
3783,58,1358,1532,857,18994,501
68554,10,112,202,80,1968,32
58148,38,1385,529,778,16528,607
55965,88,667,591,537,14165,130
39580,61,867,935,694,19904,173
18547,1,65,1355,57,7390,8
18128,44,1286,1362,858,22702,428
36424,317,3981,1006,3290,37069,691
51205,49,1038,738,718,10524,320
51869,1792,20552,719,15377,71327,5175
37660,2642,42368,973,31028,161689,11340
54807,28,470,623,327,11064,143
29950,1998,49353,1136,36393,276087,12960
17526,62,1754,1373,1285,33256,469
28859,2,211,1158,139,13202,72
31565,21,932,1108,608,11903,324
60488,6,23,448,19,2551,4
31913,7,172,1042,114,5637,58
23628,330,8852,1269,5874,33846,2978
54579,42,709,632,527,28843,182
9344,94,4061,1473,2250,20409,1811
28828,17,316,1158,214,14582,102
47221,26,311,683,242,8203,69
26270,259,6198,1212,4230,96203,1968
49674,40,590,778,471,18353,119
18379,67,2235,1358,1648,42434,587
30808,211,4310,1119,2521,26498,1789
5872,6,551,1507,333,15786,218
66778,395,6824,260,5365,55170,1459
58627,176,1186,512,890,8430,296
57703,1404,30017,538,20245,109938,9772
37195,91,2281,986,1968,53669,313
24974,308,8279,1239,5526,66907,2753
70157,7,114,148,98,2234,16
34464,11,507,1055,315,14923,192
63075,12,112,366,91,6026,21
48861,617,10363,802,8078,23938,2285
33171,1,36,1080,23,13086,13
54252,113,990,644,757,36150,233
19449,11,359,1339,272,8753,87
39600,230,6118,934,4957,52163,1161
24067,93,2450,1260,1740,19590,710
18680,5,616,1353,407,13879,209
51005,22,208,744,185,12592,23
24587,1067,27311,1248,19078,169009,8233
27369,1048,30534,1188,22476,179819,8058
11031,0,125,1462,82,4953,43
25070,1585,44177,1237,27166,236968,17011
19689,66,1178,1335,717,12404,461
10167,3,221,1469,136,7948,85
35094,10283,216258,1040,143448,1353344,72810
40735,39,694,918,523,20540,171
28328,50,1387,1167,888,9221,499
65859,18,678,288,523,10241,155
12851,683,24318,1444,15987,101824,8331
20727,67,1390,1317,868,21056,522
28647,28,567,1162,326,11059,241
52206,41,362,709,316,11497,46
67830,135,2681,226,1875,36489,806
38317,41,940,955,800,24991,140
18686,14,466,1352,343,15127,123
70249,5,39,146,36,4420,3
16166,57,1391,1396,1089,8477,302
35642,6,169,1027,131,7408,38
10484,53,1554,1466,1003,14090,551
47469,131,1939,829,1629,20410,310
56041,74,953,589,784,22316,169
35939,70,1252,1019,977,9603,275
54205,1206,12222,646,9942,85494,2280
28157,2,48,1171,34,4131,14
17107,49,1832,1381,1318,27659,514
19314,0,0,1341,0,13869,0
42025,0,106,897,80,4245,26
50444,45,746,758,540,9104,206
19956,103,1418,1330,955,45980,463
40964,50,664,914,436,7057,228
62585,48,820,378,726,16395,94
8777,15,503,1476,294,20021,209
58389,722,18931,520,14600,94067,4331
55500,125,2044,604,1010,16554,1034
49184,7,90,791,59,3745,31
6061,40,2443,1504,1579,55169,864
15865,2086,175534,1401,115614,611459,59920
64474,38,534,325,442,3952,92
24316,9,183,1255,145,6013,38
45470,20,868,851,662,9676,206
65371,324,5062,300,4349,38527,713
15688,21,438,1404,340,9441,98
28271,105,3158,1169,2242,19848,916
28433,13,169,1166,120,2736,49
11334,1,120,1460,79,5172,41
17246,75,1911,1378,1408,20277,503
14194,1039,44106,1424,30639,158749,13467
27116,206,4504,1193,3120,29433,1384
68859,16,244,191,212,3636,32
3102,595,16838,1539,11849,50624,4989
22657,0,0,1286,0,6800,0
30028,19,626,1135,364,8235,262
19313,99,4101,1341,3088,45478,1013
1992,784,19443,1549,12877,149116,6566
54398,180,1437,639,1186,15173,251
30740,41,696,1121,578,28157,118
57497,14,264,549,181,3610,83
21018,95,1566,1311,1038,15857,528
47156,5,66,833,54,2347,12
38311,5,124,957,101,3142,23
2688,374,39464,1543,26464,111187,13000
41411,712,15901,908,10528,49583,5373
61939,77,1036,398,774,14086,262
65302,3,42,302,36,5060,6
45746,316,4391,850,3345,30747,1046
18709,7,331,1352,220,11076,111
3816,61,2002,1532,1425,38203,577
3890,123,4781,1531,2927,137796,1854
64143,8,120,335,62,2103,58
21360,21,977,1305,591,7314,386
1312,34,1189,1554,862,52786,327
28705,20,429,1160,269,18881,160
16784,35,2349,1386,1718,20382,631
59183,450,6999,495,5588,61800,1411
65157,32,90,305,74,6402,16
69250,1,17,178,15,2178,2
21841,18,735,1298,485,30709,250
23743,14,372,1267,281,14630,91
69171,81,954,180,841,11620,113
19953,10,554,1330,399,10219,155
37293,148,10196,983,6548,43714,3648
40430,34,435,923,329,7739,106
34057,36,533,1063,348,9178,185
50024,22,381,769,268,6833,113
57904,166,1838,536,1304,25925,534
27372,497,9707,1188,5974,56958,3733
29025,1635,50485,1154,36072,198273,14413
25212,3,172,1235,127,6733,45
21392,3054,80087,1304,58705,376080,21382
31116,596,9424,1114,6238,65005,3186
46941,108,1536,835,1247,27718,289
53719,239,2371,662,2053,30519,318
37989,415,3746,964,3139,26067,607
35575,24,170,1028,160,11426,10
2243,49,1622,1547,1174,26331,448
40145,241,2221,927,1783,9695,438
43093,4260,102195,880,79894,491886,22301
60471,33,315,449,281,6097,34
27811,55,897,1178,651,8797,246
70056,1,23,152,21,2816,2
68345,24,329,210,261,4503,68
52949,195,3873,683,3159,22722,714
3771,91,9537,1533,6049,46376,3488
30774,18,487,1120,287,7835,200
730,96,3691,1558,2390,23106,1301
3037,3,382,1540,286,27885,96
42612,76,1674,888,1095,13579,579
66232,19,1028,277,748,5514,280
37245,87,1143,984,955,24860,188
40024,47,933,929,703,14449,230
12789,16,945,1444,456,16765,489
14737,90,1919,1417,1459,22811,460
15176,46,1078,1411,746,16697,332
7771,6,234,1482,151,7741,83
48015,20,951,822,839,19368,112
46310,5,70,844,50,4042,20
12944,1044,92914,1442,51416,304696,41498
14335,123,2290,1422,1653,27040,637
22381,43,664,1290,492,12592,172
25605,19,1792,1227,1050,20703,742
64904,15,108,312,102,5220,6
60577,20,273,445,225,4767,48
50513,62,1004,756,757,13408,247
61492,5,34,413,26,2800,8
51346,76,877,734,762,16931,115
9291,5,173,1474,117,4100,56
20313,27,1641,1324,1233,58787,408
68769,3,127,194,55,4458,72
68189,49,669,215,506,20790,163
11932,1576,41574,1454,26866,145172,14708
25189,55,1835,1235,1244,43181,591
22449,20,1055,1289,726,33300,329
21168,1309,38103,1308,24683,279993,13420
61280,20,243,419,176,3794,67
9759,983,45178,1471,27275,138311,17903
12114,4,234,1453,114,6262,120
65766,64,918,290,793,14622,125
40315,124,3124,925,2388,26820,736
61057,7,92,427,77,6807,15
33336,26,705,1077,448,18533,257
8594,176,5487,1476,3979,29836,1508
32547,85,1601,1092,1118,28010,483
20893,93,1402,1314,1029,30629,373
35329,747,13281,1033,9707,78481,3574
37810,73,2895,969,1629,20654,1266
57928,9,211,536,159,4273,52
56768,0,359,567,269,11366,90
70624,25,267,132,253,3216,14
61773,40,427,403,356,48282,71
3986,48,914,1530,640,19080,274
68822,51,594,192,472,4270,122
6540,43,3020,1498,2104,51369,916
70306,546,16033,143,14965,95579,1068
12076,172,7316,1453,3847,42154,3469
52141,2,112,711,77,2485,35
37672,26,908,973,801,28173,107
65334,195,4479,301,3904,23168,575
16870,1145,43051,1385,27972,397427,15079
57999,466,5948,533,5036,39769,912
30392,28,736,1127,647,12368,89
8222,410,11939,1478,8276,93385,3663
17403,8,296,1376,254,18803,42
12553,7221,293843,1447,138250,949242,155593
67964,184,3178,222,2602,17092,576
10048,8,263,1469,181,19954,82
51731,0,0,724,0,3227,0
18454,58,2378,1356,1650,17991,728
8395,2079,91708,1477,57005,223603,34703
18116,180,8022,1362,5325,49858,2697
64293,5,28,330,22,2238,6
18264,697,12929,1360,9076,51640,3853
14592,33,1385,1419,986,36508,399
56987,72,795,561,616,7291,179
35336,31,789,1033,552,9972,237
6166,2005,103467,1503,66633,472580,36834
24388,13,319,1253,241,12637,78
32495,152,2360,1093,1402,12789,958
54018,14,91,652,79,5542,12
23088,16,603,1278,467,12841,136
49574,15,171,781,148,4852,23
61763,5,74,404,50,6521,24
53534,6,66,668,53,2922,13
38883,1,46,944,37,2272,9
22744,52,1257,1284,773,9213,484
55628,2494,35304,595,26408,144804,8896
29739,31,2290,1141,1406,13685,884
57392,5,118,551,97,6477,21
32786,20,467,1083,303,6482,164
60001,1958,34997,461,26823,175133,8174
10313,222,3284,1468,2423,32346,861
29429,88,1325,1147,894,10852,431
22002,68,1771,1295,1145,17759,626
69255,33,448,178,325,3775,123
34045,64,2080,1064,1363,32480,717
35327,14349,397893,1033,218151,810543,179742
62773,56,1200,373,899,13814,301
36040,1,128,1017,98,1943,30
10427,14,750,1467,472,12254,278
67593,23,230,233,176,5667,54
59870,32,771,471,493,20243,278
17340,14,292,1377,217,19359,75
24224,908,11420,1257,7195,68245,4225
38147,4,148,960,117,34173,31
54592,217,2191,631,1852,22188,339
40725,188,5194,919,3899,64921,1295
56159,4,43,585,34,4187,9
36999,114,1886,992,1576,19195,310
32229,4643,85899,1097,57284,224639,28615
70201,5,98,147,79,7869,19
10345,716,16712,1467,9839,84525,6873
53787,64,647,660,508,9250,139
61019,6,126,428,98,4535,28
8616,38,3388,1476,2036,31811,1352
57861,1503,50682,537,40159,188354,10523
49025,53,555,796,512,11820,43
23292,16,407,1275,275,6558,132
40256,20,467,925,318,22510,149
56598,7,103,572,86,4684,17
27179,11,454,1192,230,10255,224
15508,10714,236008,1407,156870,649928,79138
14200,7,285,1424,189,15503,96
2168,22,525,1548,407,18719,118
64611,1840,20909,321,16920,85821,3989
66929,3,51,255,44,1252,7
24093,51,1107,1259,774,20451,333
26901,67,1626,1198,1024,10002,602
41634,7690,132191,901,86775,669186,45416
10807,92,3765,1464,2107,13326,1658
58405,194,4535,520,3069,19093,1466
32473,40,1497,1093,938,24829,559
54346,2358,49443,636,41067,350149,8376
47769,26,353,824,299,22137,54
35691,183,4672,1026,3183,61331,1489
21815,320,10244,1298,6909,55522,3335
36808,46,1280,998,837,21279,443
30881,17,932,1118,604,10433,328
32742,30,714,1089,449,14160,265
6161,2030,69980,1503,45377,211746,24603
11355,140,2526,1460,1653,40436,873
27468,119,2102,1186,1360,25717,742
8210,21,600,1478,385,19632,215
26189,106,1437,1214,934,8978,503
16611,832,12047,1389,8392,43967,3655
70198,1,59,147,46,1698,13
12459,30,680,1449,365,8304,315
30413,22,471,1127,295,4215,176
68946,0,11,188,7,740,4
26693,1512,30615,1202,20187,109518,10428
52591,39,528,695,440,10911,88
50667,58,808,753,650,10719,158
6255,205,5167,1502,3552,31650,1615
54884,6,53,621,39,9748,14
42360,4545,85181,890,60217,321033,24964
5374,62,2850,1512,2148,27207,702
50503,1,42,756,34,2664,8
29129,17,488,1152,391,8740,97
56980,18909,314271,561,248005,868762,66266
28776,84,2546,1159,1685,51438,861
28574,32,832,1163,643,8378,189
59567,63,840,481,660,8441,180
55883,55,964,593,723,17954,241
37545,421,9749,976,7811,63854,1938
27999,87,2675,1173,1786,20081,889
20244,404,17642,1325,9905,68952,7737
2591,421,12187,1544,8428,117288,3759
28508,71,1059,1164,734,12498,325
24118,22,450,1259,331,10454,119
58482,240,2790,516,2075,41158,715
48733,7,98,806,84,2186,14
34263,13,273,1058,195,3612,78
66632,32,208,265,178,6563,30
51079,0,153,742,102,6856,51
8612,12,569,1476,349,8369,220
51824,24,393,666,334,15836,59
63470,29,375,355,292,5281,83
30484,31,1463,1125,982,21812,481
17212,171,4235,1379,3109,71817,1126
54890,375,6106,620,5292,41532,814
39874,10682,635442,931,449357,990674,186085
52064,9,82,713,73,5507,9
47216,6,120,832,85,5414,35
63611,10,226,352,195,10138,31
35805,58,1706,1023,1279,17560,427
70146,83,814,147,742,11217,72
63810,13,272,346,205,7273,67
29812,0,0,1139,0,12295,0
65425,12,143,299,101,6296,42
63157,23,185,363,138,7748,47
49032,3667,56895,778,47792,352480,9103
54553,262,6157,633,4064,34404,2093
8063,5,820,1479,498,9893,322
56359,949,13425,579,10850,85823,2575
49492,65,963,783,735,16051,228
55836,13,315,595,122,9463,193
64778,148,1271,316,1013,17053,258
27101,70,1883,1193,1475,38077,408
55113,45,840,613,631,22786,209
60851,6,62,435,50,1470,12
5227,5,279,1514,208,6767,71
42520,11,347,890,249,11973,98
69081,4,36,184,33,5675,3
54137,24,357,648,250,55325,107
20208,100,4190,1325,2877,22497,1313
18114,833,19914,1362,12769,189054,7145
2056,175,9599,1549,6711,49142,2888
67798,36,388,227,355,5013,33
30946,119,3747,1117,2281,31454,1466
31533,1588,37716,1108,23935,212637,13781
69779,226,2733,161,2473,10999,260
28033,23,483,1173,323,11272,160
45860,30,419,849,338,8947,81
69838,3,53,159,48,3457,5
34876,42,756,1045,669,12292,87
64227,8,146,332,97,6264,49
62748,15,483,374,212,3606,271
5554,196,2931,1510,1924,26426,1007
2674,28098,1335764,1543,746237,2748417,589527
50918,55,721,746,540,13502,181
45420,12,208,854,147,5356,61
53441,209,2738,670,2200,67877,538
20143,327,10800,1326,7196,85782,3604
34836,561,17226,1046,13249,101714,3977
27042,100,1116,1194,650,9556,466
3872,4,254,1531,174,10251,80
24780,149,2014,1244,1366,20863,648
66979,56,659,253,575,11971,84
46171,132,1581,845,1244,10813,337
34584,56,859,1053,593,12586,266
5006,39,1729,1517,1137,24031,592
21993,45,1141,1296,624,9124,517
49040,5338,88393,796,60307,242622,28086
36209,19,391,1012,318,16588,73
45199,43,841,856,600,12926,241
15109,466,9693,1412,6198,89329,3495
65047,39,502,307,405,4967,97
12666,18,676,1446,289,10284,387
62613,48,548,351,408,9991,140
22319,7,499,1291,348,8417,151
47491,102,940,828,755,14813,185
32097,20,517,1099,319,7641,198
18595,32,1140,1354,827,55330,313
28219,21,424,1170,280,14511,144
48835,81,833,802,596,17328,237
65617,12,129,294,99,5749,30
32858,10,201,1086,138,9853,63
24779,239,5350,1244,3357,52042,1993
48933,1610,24968,799,19658,108997,5310
19476,23,523,1338,371,6351,152
3319,34,1826,1537,1260,16000,566
29249,18410,298096,1150,206815,1156088,91281
64769,2440,86649,300,65148,299482,21501
24855,10,215,1242,198,6808,17
37283,33,1019,983,828,27961,191
49682,133,1409,777,1064,42142,345
4409,448,22012,1525,14407,114922,7605
56384,14,202,579,160,5969,42
56802,5,34,566,29,8932,5
56909,27,439,563,284,8904,155
9914,18,562,1470,340,8637,222
13366,7137,249870,1436,148451,1155478,101419
51592,844,11005,727,8311,63954,2694
67590,26,326,233,251,9418,75
53780,6313,117278,661,89648,466784,27630
10857,53,2326,1464,1175,18695,1151
30949,27,949,1117,512,8412,437
27144,177,4893,1192,3293,66229,1600
3448,18,701,1536,503,18022,198
50585,9,121,754,82,8696,39
64931,13,105,311,76,2663,29
33680,156,2783,1071,2049,21644,734
18676,1,95,1353,54,7941,41
58872,33,740,504,517,18774,223
26903,666,10406,1198,6125,70514,4281
32657,1667,25958,1090,17212,122669,8746
56995,24,375,558,257,15314,118
55463,1,39,605,31,2915,8
27754,94,1189,1179,834,15075,355
67517,2,68,236,53,1814,15
36479,34,812,1004,640,22952,172
29263,25,726,1150,480,9214,246
31800,133,2107,1103,1467,18502,640
50592,0,8,754,6,1309,2
3774,390,21886,1533,14512,172573,7374
42486,41,779,890,629,19913,150
22254,47,690,1292,456,9856,234
41479,11,247,906,198,8821,49
40488,8,231,922,170,6845,61
34776,376,5970,1047,4372,47933,1598
171,387,9126,1564,5412,265106,3714
13056,455,14896,1440,9456,73601,5440
26037,16,446,1217,276,5129,170
60154,32,463,461,390,8587,73
32258,263,8619,1095,6066,67685,2553
25397,29,668,1231,473,9040,195
50562,3,48,755,43,2630,5
69551,17,216,169,162,2401,54
60129,29,715,462,463,16413,252
28414,99,4132,1166,2616,36241,1516
61493,24,341,403,267,7607,74
20270,5,198,1324,166,8117,32
69066,29,416,184,350,7861,66
50014,68,1181,769,919,31149,262
12849,22,926,1444,523,31831,403
53942,65,1494,655,1270,12178,224
9567,34,1844,1472,971,15024,873
56530,381,8984,574,6857,70916,2127
18827,134,5549,1350,3870,115943,1679
53209,10,83,675,73,3644,10
24031,87,3442,1261,2323,31272,1119
17816,45,1231,1368,858,15828,373
64755,2,69,317,46,2942,23
29670,29,927,1143,560,20353,367
47423,41,1392,829,1011,29291,381
51091,41,436,741,396,8360,40
11415,14,511,1459,293,4779,218
64108,1,40,336,34,2467,6
47667,21,548,826,421,5289,127
14236,5,361,1424,292,10608,69
51591,19,232,727,195,3567,37
63034,26,401,366,270,4618,131
66078,9,100,282,73,2834,27
8039,302,4892,1479,3685,42838,1207
33393,12314,235338,1076,169210,460248,66128
9435,37,1438,1473,926,22190,512
10390,133,5972,1467,3971,32331,2001
44567,1180,20177,863,16947,168335,3230
56777,5,74,567,64,51395,10
58230,34,530,525,373,15095,157
55496,181,3352,604,2841,16592,511
50173,163,1969,765,1573,19610,396
12758,34,1008,1445,560,10881,448
23797,11,351,1266,245,10360,106
6624,5,215,1497,146,20685,69
10363,300,7013,1467,4425,99607,2588
11495,176,11311,1459,5298,72400,6013
13103,114,5071,1440,3027,41234,2044
71,769,31775,1566,20885,197376,10890
16026,23,1176,1398,794,19324,382
47699,49,1072,825,816,23572,256
28589,7,313,1163,193,4991,120
3789,52,1116,1532,788,27269,328
19214,63,3195,1343,2253,39689,942
940,255,13529,1557,9179,72468,4350
3473,499,11940,1536,7579,44257,4361
19946,39,1157,1330,869,57714,288
62177,38,384,389,299,7080,85
36213,37780,847227,1012,457388,2352023,389839
5936,487,15761,1506,9175,60512,6586
17937,21,440,1365,301,7916,139
66105,383,9406,281,7105,64246,2301
45458,6,159,853,122,9297,37
29743,48,796,1141,502,9619,294
3407,51,1261,1536,915,17465,346
44414,2,19,864,15,2275,4
65705,133,2176,291,1805,11825,371
48926,58,954,799,715,25558,239
59222,3009,45523,493,37084,210922,8439
34661,82,908,1050,644,20073,264
63209,63,804,362,677,9850,127
8020,43,1472,1479,962,33467,510
65211,42,454,304,326,9411,128
56141,13,128,586,97,3987,31
5587,870,42769,1510,26092,240195,16677
22891,6,118,1281,81,6710,37
10667,117,4512,1465,2724,22150,1788
3581,58,1500,1535,948,16481,552
17386,6,263,1376,217,8348,46
65153,16,208,305,163,3123,45
9135,16,300,1474,205,6805,95
51690,233,2962,725,2454,29160,508
57819,48,706,539,580,10866,126
32057,947,18650,1100,14294,158902,4356
26895,39,672,1198,585,12217,87
25399,67,1849,1231,1216,27329,633
20565,19,878,1320,626,10755,252
55253,23,237,610,188,9052,49
60842,84,2052,435,1637,14615,415
34037,98,2768,1064,1859,14324,909
49772,5,149,775,99,9235,50
2490,174,6129,1545,4386,24961,1743
8424,51,652,1477,422,10232,230
22,80,2885,1567,2310,33507,575
22809,0,0,1283,0,4858,0
42550,11,147,889,112,7596,35
10213,499,16879,1468,10645,82654,6234
29303,66,1725,1149,1162,9414,563
54885,3,56,621,44,5148,12
7632,19,897,1484,664,13643,233
4631,19,409,1522,306,10972,103
49001,11,130,797,86,4697,44
57838,11,118,538,93,3839,25
65604,214,6011,295,4977,58307,1034
62473,19,197,381,157,4560,40
16364,114,2192,1393,1454,24280,738
4639,19,972,1522,591,11034,381
32294,115,3156,1096,2063,19747,1093
57320,26,429,553,340,7907,89
41587,190,4322,904,2711,27684,1611
64710,6,105,319,83,3745,22
30705,137,4631,1121,2891,27696,1740
16830,3,173,1386,122,10781,51
31486,3,65,1109,50,5757,15
65227,153,1983,303,1694,13442,289
30911,221,2711,1117,1846,31196,865
9377,5,247,1473,150,9295,97
15777,15,444,1403,298,22825,146
65772,5,108,290,84,2644,24
58234,21,203,525,139,11670,64
3972,34,1299,1530,924,33517,375
54611,33,320,631,270,18166,50
62939,1,16,369,9,2787,7
52462,231,2550,699,2003,21935,547
59928,43,679,469,561,8841,118
9021,211,6127,1475,3854,88283,2273
27746,120,2596,1179,1893,26109,703
30266,93,1595,1130,1260,18825,335
67072,61,1070,250,816,19915,254
37685,5,225,972,173,4245,52
6120,22,693,1503,475,16947,218
14356,21,872,1422,598,15050,274
8091,14,731,1479,476,7796,255
66960,2,120,254,46,1402,74
47807,387,4316,824,3403,29872,913
1527,6,294,1553,189,8919,105
28993,12,319,1155,246,13152,73
39063,34,1103,941,792,9135,311
69015,3,23,186,15,3002,8
21088,23,457,1310,309,21688,148
15337,56,1924,1409,1230,12744,694
32476,70,1834,1093,1248,20255,586
3064,51,3052,1540,2446,35784,606
60767,366,3879,438,3010,21102,869
12684,675,17120,1446,10261,107587,6859
49093,4,111,779,83,2092,28
3939,70,1464,1531,1060,38945,404
38296,50,529,957,422,4507,107
62439,1,8,382,7,1521,1
20090,24,949,1327,625,27129,324
18893,172,3487,1349,2303,15061,1184
27153,881,14114,1192,10403,64349,3711
12112,318,15611,1453,8444,211902,7167
67987,978,19814,221,16339,109893,3475
11885,19,592,1455,273,14757,319
69333,87,1568,175,1320,12471,248
9720,4952,172231,1471,89911,349517,82320
12720,1722,69365,1445,42541,286975,26824
20823,11,196,1315,155,10037,41
52281,24,395,706,278,5574,117
56114,8,193,586,124,14921,69
32631,64,1513,1090,1041,50266,472
29826,81,1817,1139,1146,22151,671
61198,48,833,422,698,24541,135
20494,84,2713,1321,1918,20015,795
20194,23,643,1326,521,23880,122
9869,11,570,1470,342,9167,228
55495,17,253,604,182,4714,71
2892,3,188,1541,123,8114,65
26827,35,795,1199,527,16494,268
2680,29,1041,1543,703,34860,338
22327,495,20680,1291,12855,126749,7825
39809,45,775,932,662,13170,113
64498,9,131,325,98,5507,33
32457,38,857,1093,512,18311,345
19808,269,12860,1332,8950,54778,3910
38072,97,2653,963,2105,42299,548
61260,119,1859,419,1493,17503,366
32332,142,2285,1096,1699,23971,586
27414,67,1584,1187,983,9265,601
52719,5,82,690,59,3879,23
51598,6,236,727,187,9670,49
14306,25,766,1423,451,10218,315
9763,866,36437,1471,21548,127130,14889
56420,316,6696,578,5595,57156,1101
12462,9,826,1448,465,10833,361
45841,39,1327,849,989,17788,338
17236,99,2130,1379,1543,39137,587
70137,0,40,149,33,2365,7
69827,20,377,159,303,3812,74
47158,93,988,832,800,11769,188
439,11,214,1561,153,15560,61
59982,88,1150,467,913,9281,237
50825,164,5560,749,4183,33936,1377
18906,12,559,1348,359,26155,200
7175,5,429,1489,260,10048,169
26253,496,11057,1213,6892,77693,4165
28907,175,2295,1157,1548,13818,747
7112,73,2119,1491,1269,33147,850
1405,4,228,1553,183,4901,45
3348,9,298,1537,224,29024,74
26670,23,605,1202,383,23665,222
27812,266,6403,1178,4381,65829,2022
6191,14,365,1503,219,9372,146
27556,4,94,1183,63,9624,31
59500,12,198,483,171,13926,27
9660,37,2779,1472,1637,17285,1142
32413,46,489,1094,303,3926,186
13764,573,11777,1431,8187,99644,3590
49124,95,784,793,599,9740,185
57275,3,88,554,74,2990,14
26459,53,761,1208,598,22256,163
34239,168,3318,1059,2439,27146,879
45140,247,6333,857,4924,57692,1409
66292,9,76,275,60,2812,16
11707,23,1259,1457,637,6203,622
1786,22,638,1551,426,17496,212
52854,3,63,686,49,3999,14
35062,2,75,1039,47,2618,28
31737,3106,71053,1104,41172,213521,29881
2608,38,1502,1544,1015,21328,487
50189,35,563,764,381,6640,182
33829,126,3276,1068,2116,19467,1160
64983,125,3510,309,2810,17515,700
16407,28,1453,1392,982,51912,471
55526,12,125,603,104,6625,21
34561,44,1862,1053,1138,11762,724
50944,15,161,746,136,2972,25
57462,9,108,550,70,2985,38
24805,5634,137458,1243,86444,238091,51014
1421,336,11677,1553,7887,65337,3790
61824,97,771,402,599,6690,172
8839,4,210,1475,135,8703,75
27820,93,1574,1178,1307,48814,267
66146,286,3137,279,2311,13229,826
69312,5,96,176,87,5993,9
45280,438,7861,855,5789,38565,2072
46581,20,552,840,284,8274,268
41607,15,393,904,287,9212,106
50291,4,64,762,52,3085,12
57845,164,2210,538,1828,17395,382
51038,6840,117877,743,82174,408359,35703
25827,28,353,1222,242,42788,111
57616,11,187,546,153,6017,34
56445,47,707,577,586,16116,121
16107,294,6671,1397,4996,55049,1675
56171,32,367,585,284,5899,83
61713,51,619,406,511,9619,108
22423,286,4165,1290,2820,17198,1345
23980,21,354,1262,293,31013,61
49101,321,4901,794,3741,48305,1160
38385,58,1014,954,903,20871,111
23795,204,2881,1266,2087,29667,794
52219,10,221,708,178,5947,43
2947,20175,712583,1541,439748,1563767,272835
52626,25,271,694,228,7828,43
6380,64,6946,1500,4325,24789,2621
51489,146,2072,731,1687,21198,385
67581,36,408,234,353,5061,55
52703,405,4192,691,3355,52751,837
55200,4,65,612,43,3155,22
15227,48,2303,1411,1753,60664,550
40676,149,1091,920,784,12356,307
8599,29,862,1476,544,7879,318
2910,91,3048,1541,2383,18036,665
25279,170,1603,1233,1206,27715,397
36797,23,336,998,273,8915,63
34199,7,202,1060,141,3952,61
1104,282,10366,1556,7150,63522,3216
58257,512,8066,524,6694,49664,1372
65676,1,50,292,13,2993,37
68550,6,67,202,48,4936,19
34574,30,816,1053,548,23052,268
737,211,13472,1558,9091,122227,4381
15356,58,1258,1409,884,26337,374
17475,7,123,1374,86,24452,37
70213,4,58,147,58,3533,0
60616,3,12,444,8,2501,4
18182,41,1224,1361,820,20358,404
66198,10,297,277,241,4718,56
999,32,878,1556,649,30414,229
17879,815,15443,1366,10458,83448,4985
8475,24,1139,1477,681,14542,458
69317,31,567,176,464,8602,103
51599,24,323,727,261,30392,62
64899,11,69,312,65,11003,4
55110,3,140,614,102,5432,38
63692,12,164,349,128,5813,36
40899,2817,71881,915,44688,335499,27193
51868,74,769,720,607,6542,162
8191,23,713,1478,479,7468,234
40181,57,939,927,744,6646,195
38919,235,2510,943,1965,19340,545
19430,10,731,1339,537,16910,194
33021,36,1018,1083,651,9926,367
29342,21,245,1148,146,2765,99
19646,26,771,1335,579,11797,192
42915,28,738,882,581,19738,157
30270,39,1421,1130,1011,12890,410
61320,61,500,418,431,11169,69
62628,106,1493,376,1029,11385,464
47160,51,698,832,633,12585,65
3356,7,148,1537,108,7022,40
54504,650,5737,635,4833,49285,904
33258,8,265,1079,189,9429,76
49366,879,11849,786,9958,123401,1891
70083,12,396,151,388,2349,8
70161,18,248,148,211,2382,37
51815,1,89,721,58,5210,31
44562,292,4976,863,3896,35279,1080
24864,70,1480,1242,1005,15366,475
55261,55,1040,610,826,13296,214
65649,26,444,293,370,6395,74
11272,72,2439,1460,1468,33309,971
68561,897,10198,201,7996,33136,2202
32905,781,13760,1085,9621,108511,4139
493,534,20686,1561,13903,170864,6783
59752,20,364,474,286,19592,78
28727,73,1468,1160,929,35657,539
278,14,488,1562,314,31326,174
21839,4975,139138,1298,73274,404235,65864
65614,1,11,294,6,1212,5
58806,386,6392,506,5386,42892,1006
28587,65,1080,1163,790,11564,290
34839,19,397,1046,261,10425,136
18685,275,5924,1352,4007,61232,1917
23463,44,1176,1272,821,18414,355
58290,102,2323,521,1730,21263,593
54409,16,177,639,111,5089,66
12482,135,6382,1448,3556,131603,2826
2063,2645,136045,1548,76833,531828,59212
10557,159,4841,1466,3025,81190,1816
58466,233,2881,517,2478,26792,403
9090,1440,42207,1474,25834,227075,16373
59160,0,11,495,9,1850,2
70117,0,0,150,0,718,0
11022,100,2008,1462,1197,29988,811
9148,36,1476,1474,922,25804,554
13409,26,456,1436,296,21336,160
54079,9,80,650,70,3440,10
19891,7,170,1331,125,27936,45
51998,112,998,716,771,15317,227
29613,6,169,1144,111,3997,58
13473,95,7125,1435,4137,29780,2988
12664,7,287,1446,159,7748,128
31623,49,1720,1106,1341,9577,379
52556,664,13139,696,10210,78966,2929
20453,3846,136750,1321,92538,706993,44212
38402,1288,21146,954,16940,183181,4206
34090,9,400,1063,232,6037,168
20653,4,195,1318,156,21921,39
58250,14,136,525,92,9678,44
4638,25,810,1522,589,14844,221
686,1728,48459,1559,33033,153744,15426
49330,784,17510,787,13313,132014,4197
25251,1934,50639,1234,28335,146358,22304
33215,136,4196,1080,2736,26491,1460
35099,51,706,1040,468,6508,238
20293,73,4711,1324,3164,55415,1547
50833,4,287,749,146,10832,141
12580,1319,22866,1447,16066,74412,6800
17748,17,126,1369,82,5502,44
63478,8524,196434,348,151146,454910,45288
62162,9,148,390,113,7400,35
25377,132,4250,1231,2617,62319,1633
14206,3,396,1424,300,16688,96
32527,39,1399,1092,958,28502,441
46348,59,1390,843,1207,32331,183
65494,45,452,297,380,5784,72
60768,44,723,438,573,15777,150
42692,11,319,886,247,7874,72
51679,384,5252,725,4254,36696,998
43821,58,1024,872,788,28957,236
69376,31,398,174,322,3465,76
11038,9,362,1462,228,7996,134
21961,172,4015,1296,2453,78448,1562
33056,3,119,1083,72,22236,47
53147,61,538,677,460,7678,78
63012,4,82,368,68,3942,14
37083,23,458,990,343,14826,115
33141,1171,22938,1081,17214,83593,5724
27920,26,1479,1175,918,29698,561
10147,530,22999,1469,14007,81243,8992
65146,901,14618,305,12905,94568,1713
45530,974,11472,852,9854,159536,1618
37662,59,666,973,463,17394,203
24273,30387,827689,1256,450915,2353501,376774
17800,18,492,1368,382,9381,110
36182,104,998,1013,759,8825,239
62699,93,1574,375,1413,20948,161
58669,1144,18798,510,14837,92453,3961
12051,10,352,1453,201,7490,151
43721,92,799,872,573,10555,226
66342,5,58,274,44,9644,14
68832,15,171,192,155,6550,16
29319,100,8444,1149,4988,30577,3456
17532,47,1660,1373,1250,33585,410
943,18,521,1557,351,21712,170
26674,25,597,1202,418,11916,179
3810,31,1147,1532,829,14672,318
30921,27,519,1117,317,4447,202
2511,127,3000,1545,1974,50109,1026
58355,23,457,521,350,7823,107
809,596,17232,1558,11124,73030,6108
51812,112,1526,721,1237,17134,289
19225,23,668,1343,476,25960,192
49145,7,85,793,66,2673,19
30876,18,851,1118,572,6967,279
49770,1678,14315,775,10421,72818,3894
38304,4,101,957,63,2430,38
36706,0,40,1000,32,5869,8
69177,0,10,180,10,1130,0
21473,57,1778,1303,1213,11145,565
516,2,90,1560,54,14361,36
13780,6,260,1431,157,12500,103
733,91,3023,1558,2090,76316,933
68385,12,356,208,270,9735,86
26469,93,1857,1208,1159,18233,698
56736,145,3044,568,2232,18651,812
59274,112,1206,491,869,8274,337
36746,399,5138,999,3699,23099,1439
59465,97,2176,429,1801,28508,375
35895,358,7672,1020,5887,38583,1785
39057,21,451,941,396,15676,55
7765,19,966,1482,603,19329,363
56345,9,224,580,154,7196,70
26688,108,2924,1202,1950,17658,974
15440,14,544,1408,364,8702,180
30617,82,3658,1123,2173,19692,1485
21300,14,314,1306,226,12819,88
8069,28,725,1479,424,9797,301
40218,487,7138,926,5661,42948,1477
68558,204,3459,202,2855,34457,604
9392,70,3688,1473,2397,36006,1291
68898,17,243,190,191,6808,52
32141,175,4050,1099,2068,26395,1982
35216,188,3544,1036,2638,14808,906
11970,105,2056,1454,1307,15767,749
48830,32,533,753,355,4837,178
12850,175,4690,1444,3048,28178,1642
11515,70,1775,1458,1146,28427,629
2551,154,8115,1544,5364,62189,2751
17514,40,756,1373,497,6379,259
30004,43,1351,1135,823,32172,528
51589,51,598,727,508,10731,90
57599,176,2311,546,1835,19122,476
32868,42,1071,1086,702,17530,369
30754,262,4722,1120,3530,51717,1192
51315,337,4998,735,3998,26896,1000
18047,41,1430,1363,1004,19700,426
4953,42,1284,1517,919,19866,365
17231,8,311,1379,227,12263,84
13099,140,5290,1440,2767,40736,2523
5928,7,504,1506,356,19118,148
58441,36,354,518,281,7178,73
23820,155,4495,1265,3176,63403,1319
431,3,197,1561,114,14041,83
53768,5,85,661,72,5233,13
32174,6,425,1098,213,7453,212
57640,336,4994,545,4076,75182,918
56457,189,4683,577,3592,21433,1091
53870,0,11,657,8,2772,3
26617,1356,25052,1204,16339,153385,8713
4789,141,6879,1520,4690,34815,2189
40592,2819,39507,920,28361,210982,11146
64588,201,2800,322,2085,11572,715
45514,18,225,852,175,15536,50
52097,102,2024,712,1325,9368,699
65748,21,277,291,243,6466,34
14325,166,7525,1422,5386,94803,2139
16419,45,1639,1392,1112,20374,527
55943,121,2570,591,1850,16748,720
63840,33,558,345,426,10165,132
62028,65,589,395,479,3731,110
28641,10,734,1162,438,9933,296
55988,1487,19937,565,15418,123562,4519
36715,71,776,999,647,8301,129
23834,65,5579,1265,3744,48240,1835
30120,359,11061,1133,7728,40907,3333
37503,46,792,978,565,10197,227
61720,17,191,406,151,4897,40
25172,4,90,1236,64,5627,26
53941,6,50,655,39,3992,11
50164,30,714,765,485,18409,229
61620,125,1565,408,1219,14977,346
18277,288,12264,1360,8277,76207,3987
11323,5,416,1460,217,7167,199
34476,0,0,1055,0,2888,0
53772,58,589,661,499,14411,90
45358,88,967,854,757,21710,210
34874,14,714,1045,444,16179,270
10110,74,1513,1469,901,10895,612
56773,33,377,567,304,8073,73
32880,90,1865,1086,1288,14382,577
23737,223,2693,1267,1891,16827,802
19780,35,833,1333,672,39540,161
69839,9,103,159,82,2438,21
26873,611,14890,1198,10604,31873,4286
17352,16,642,1376,456,26360,186
67262,3,60,244,50,1131,10
50931,115,2010,746,1502,30560,508
48809,20,301,803,276,17852,25
15748,7,525,1403,366,32944,159
37263,15,299,984,237,5360,62
24699,202,5380,1245,3792,115678,1588
27016,609,17325,1195,10450,85671,6875
29184,33,757,1151,482,17868,275
62442,25,459,382,369,4368,90
33031,22,376,1083,259,3649,117
21382,68,2616,1305,1704,40615,912
46132,15,162,846,120,6226,42
65951,10,91,286,77,6976,14
12904,3,145,1443,79,7876,66
13891,80,2738,1429,1672,44767,1066
14675,19,605,1418,396,7915,209
55912,44,559,593,438,14458,121
25686,674,17805,1225,11336,119227,6469
50583,7,50,754,40,3607,10
21811,6,176,1298,125,3484,51
37308,6,111,983,84,4566,27
34573,62,1285,1053,898,25239,387
5700,9,251,1509,176,10983,75
33159,7,204,1081,146,8681,58
57126,26,463,558,346,7026,117
4319,33,846,1526,635,18645,211
6387,16047,1438693,1500,801169,1616275,637524
64738,22,417,318,296,6714,121
66187,8,178,278,130,4928,48
35651,22,530,1024,373,10031,157
50628,116,2506,754,2096,19664,410
8562,3589,101604,1477,60694,245661,40910
25856,32,636,1221,387,4338,249
7544,48,801,1485,516,10672,285
69338,6,77,170,62,2879,15
56601,69,1364,572,1023,10494,341
5786,69,1990,1508,1318,27373,672
67501,8,113,235,87,3457,26
28739,64,2050,1160,1191,23001,859
49192,78,1207,791,990,11333,217
68602,217,5079,200,4139,18489,940
67249,348,18534,239,13747,52704,4787
62535,63,961,379,813,19744,148
68149,46,532,216,484,9285,48
10166,1093,26911,1469,17684,99211,9227
43941,12,191,870,150,6676,41
25078,77,3025,1237,2133,23184,892
35019,25,793,1041,521,21651,272
61664,15,227,408,187,8061,40
19380,44,1089,1340,737,24563,352
64538,57,1059,324,819,11699,240
18065,4,460,1363,354,34317,106
5381,38,1639,1512,1113,30086,526
19389,6713,129268,1340,71853,262408,57415
4081,1367,45014,1529,29494,280418,15520
27220,233,3004,1191,1986,16525,1018
21673,63,2116,1300,1203,18468,913
70010,49,544,153,513,5808,31
18941,3783,141932,1348,98948,866545,42984
24634,6,190,1247,144,5531,46
16959,7,126,1383,97,13426,29
7353,72,1581,1488,1046,28469,535
70060,46,659,151,626,16692,33
35612,134,2262,1027,1603,25216,659
57870,9092,150587,537,108205,630899,42382
13588,51,749,1433,474,16678,275
59700,2676,50618,476,40528,277436,10090
2115,34,2947,1548,2190,27485,757
67178,31,560,246,461,4288,99
11960,0,0,1454,0,8351,0
67722,18,243,230,181,2593,62
34457,57,1394,1055,1013,24701,381
49592,45,524,780,413,11451,111
68470,11,331,205,253,5005,78
53759,28,378,564,316,15859,62
47715,538,7075,825,5497,59653,1578
31521,389,8305,1108,5630,124634,2675
24545,348,9930,1249,7119,104435,2811
54636,35,251,630,203,7538,48
10907,3,123,1463,77,5415,46
14121,83,2531,1425,1762,19392,769
54901,41,635,620,489,13530,146
56688,58,1741,570,1396,10323,345
14673,56,7657,1418,5055,63574,2602
64383,66,1120,328,908,27186,212
69078,386,8433,184,7030,75338,1403
55182,243,3767,613,3039,46636,728
35785,128,1921,1023,1478,32692,443
2207,944,71278,1547,48228,316588,23050
64969,4,47,310,34,6718,13
23164,2790,84575,1277,62508,383863,22067
42328,19,261,893,208,7275,53
14215,327,6075,1424,4204,41398,1871
27378,613,12057,1188,7994,96122,4063
28744,12,163,1160,109,3069,54
14744,11,219,1417,178,9687,41
10691,21,1714,1465,979,12692,735
50982,62,1098,744,838,20098,260
21028,9,399,1311,289,23795,110
49169,142,1834,792,1391,22984,443
12338,80,2997,1450,1986,35722,1011
13395,7,488,1436,283,21709,205
18328,6,351,1359,252,9991,99
32836,50,1136,1087,802,36432,334
59565,103,966,479,742,12258,224
69210,42,142,179,122,6360,20
32659,47,624,1090,406,9352,218
50604,36,643,754,470,16169,173
12008,2,221,1454,151,11181,70
11771,39,1704,1456,697,16511,1007
6040,233,7733,1504,5870,85655,1863
22902,6,416,1281,313,12866,103
4242,3,318,1527,231,27532,87
5736,33,1416,1508,1020,19392,396
59086,34,804,497,562,12691,242
69819,28,823,159,732,10828,91
66316,4,63,275,48,2007,15
6402,97,1495,1500,1036,24456,459
63626,21,397,351,347,4911,50
29126,1,197,1152,120,6818,77
48743,19,549,805,502,28589,47
27932,59,1383,1175,902,18613,481
25044,11,476,1238,307,18512,169
13665,1334,45791,1432,27085,219714,18706
11648,75,2379,1457,1388,22580,991
18260,141,2265,1360,1664,26931,601
57408,7302,188171,551,146125,656300,42046
7887,26145,1556059,1480,930835,3034411,625224
29169,233,10444,1151,7221,48787,3223
57716,12,270,543,215,7500,55
28710,25,221,1160,141,3032,80
40758,311,4932,918,4027,68489,905
62971,177,3234,368,2386,36133,848
66760,19,173,261,150,8058,23
13111,66,1535,1440,863,27997,672
1713,85,4255,1551,2826,57154,1429
37542,226,3613,880,3134,99890,479
57889,178,2840,537,2258,24596,582
30953,345,13930,1116,9329,59455,4601
33677,181,4437,1071,3261,84669,1176
20047,18,405,1328,305,8861,100
18912,1785,53664,1348,35857,341730,17807
305,232,16540,1562,10857,132345,5683
30952,179,4045,1117,3493,67786,552
35023,52,1112,1041,779,12263,333
60524,225,2926,447,2444,39126,482
16324,1,130,1394,77,6528,53
35816,1,32,1023,27,2634,5
23,923,37239,1567,23234,216207,14005
35981,12,314,1019,234,3552,80
67855,7,196,225,119,4005,77
53237,1694,18997,675,15286,102785,3711
24886,62,1050,1241,738,12452,312
17135,14,336,1380,257,7373,79
32690,136,2525,1090,1826,21771,699
11312,205,8441,1460,4969,50509,3472
14497,157,2457,1420,1846,42786,611
60170,112,1608,458,1288,9874,320
63366,8,139,358,99,8117,40
8580,5,81,1477,46,4536,35
4646,418,20009,1522,11498,73110,8511
3366,79,4515,1537,3112,48864,1403
56707,23,282,569,249,7532,33
56385,37,425,579,322,9324,103
2369,22,856,1546,613,23275,243
20624,258,6146,1319,4183,25398,1963
32188,18,504,1097,310,4825,194
69485,11,186,171,131,3116,55
48834,55,512,802,428,13171,84
19293,230,3506,1341,2324,48793,1182
49424,19,434,784,368,10899,66
55488,23,482,604,377,16333,105
362,2149,72144,1562,50221,222071,21923
9892,546,21796,1470,14365,98707,7431
52184,27,304,710,232,5483,72
65375,27,92,300,74,4001,18
69900,25,275,157,235,3424,40
63368,7,158,358,132,6211,26
23869,39,971,1264,739,20046,232
59839,13,114,472,81,4658,33
51240,238,3860,737,3137,17465,723
31546,42,1968,1108,1191,26556,777
66383,6,60,273,53,5146,7
58125,12,55,529,54,3509,1
29000,67,2717,1155,1653,16187,1064
10973,7,639,1463,381,20000,258
23504,9,332,1271,236,8409,96
25979,27,931,1218,579,30701,352
32089,180,2698,1099,2081,14122,617
54248,61,537,644,422,10262,115
14814,27,871,1416,627,25150,244
48077,5232,123578,821,91478,562538,32100
41894,191,3215,899,2552,23429,663
10975,5,259,1463,144,6058,115
34705,48,1469,1049,984,10571,485
49699,51,556,777,488,15553,68
69385,0,3,174,2,2765,1
55757,18,138,597,109,6190,29
32424,338,12921,1094,9235,76752,3686
50109,2007,37948,763,30052,116179,7896
58265,61,992,524,569,10801,423
32098,18,971,1099,593,13694,378
57367,461,6244,552,5104,39257,1140
51775,33,505,655,383,11465,122
11503,186,6197,1459,3316,74353,2881
14594,16,324,1419,239,18884,85
30542,14,197,1124,111,6718,86
61825,13,129,402,101,2008,28
18978,329,7971,1347,5869,56024,2102
14682,34,927,1418,597,8602,330
30895,424,13516,1118,10068,102489,3448
56982,32,822,561,652,8335,170
66181,1,18,278,13,1903,5
59281,45,908,491,460,8394,448
67413,8,91,239,70,2679,21
17520,152,2856,1373,2146,23870,710
61530,342,4166,412,3539,38970,627
19158,153,2618,1344,1828,39094,790
4310,15,379,1526,239,4231,140
53230,10,175,675,139,6621,36
3069,26,1663,1540,1183,81798,480
6423,41,1496,1500,1038,13984,458
48586,445,5864,809,4454,45663,1410
36801,10,91,998,73,10752,18
5948,144,10027,1506,6469,48811,3558
32640,11,609,1090,461,13449,148
12829,1,190,1444,59,7121,131
67785,26,213,227,179,4076,34
14720,43,1780,1417,1271,15982,509
27617,32,683,1181,428,4701,255
29816,70,1322,1139,1151,31805,171
28524,15,404,1164,279,11949,125
62999,12,206,368,163,3515,43
16854,100,1911,1385,1224,16885,687
56556,17,218,573,155,7745,63
26675,47,943,1202,795,7711,148
13568,54,2198,1433,1282,36939,916
49129,112,1389,793,1115,57012,274
52955,30,714,683,543,5231,171
62472,2426,45338,381,34003,234895,11335
22016,273,10429,1295,6915,51771,3514
29501,5,474,1146,297,6716,177
16722,140,3019,1387,2142,62331,877
26448,8,146,1208,113,8385,33
9225,32,1397,1474,923,18947,474
54589,586,15708,632,10142,107224,5566
34576,171,5085,1053,2886,22377,2199
48887,10,117,801,100,5139,17
56833,49,351,566,290,4604,61
55100,1116,17600,614,12450,45234,5150
44049,202,2609,869,1982,13749,627
20393,29,725,1322,529,10714,196
10405,11,308,1467,190,10360,118
50848,143,3288,748,2436,14870,852
41391,4414,70744,908,61252,305761,9492
34369,43,855,1057,542,4085,313
56999,12,200,561,148,6735,52
23835,86,2402,1265,2033,45049,369
37155,39,692,987,471,10432,221
13272,20217,772371,1438,437134,2055492,335237
44668,62,930,862,752,13055,178
56275,799,20742,582,15403,165467,5339
23382,37,940,1273,653,8406,287
54112,0,24,649,17,2508,7
54069,5,49,650,41,2641,8
41175,132,2252,911,1951,44812,301
51909,51,443,719,388,13722,55
3896,1670,49356,1531,27507,288091,21849
29996,110,5040,1135,2855,39889,2185
51250,5,60,737,44,2935,16
66359,12,107,274,100,4025,7
27093,144,2013,1193,1372,27478,641
8022,38,1662,1479,1230,31078,432
33328,57,2085,1077,1512,32944,573
67613,5,83,233,64,4027,19
11829,24,1260,1456,650,12649,610
42169,10323,248131,895,194162,1004136,53969
48117,140,1338,821,1062,11391,276
12685,16,3317,1446,1651,14769,1666
32070,167,3443,1099,2412,40109,1031
25956,596,15690,1219,10179,49836,5511
61382,6,87,416,55,2693,32
23387,296,7066,1273,4646,95978,2420
60417,5,50,452,31,2920,19
37232,14,143,985,108,4018,35
48495,16,352,813,243,16448,109
29333,15,246,1148,228,9325,18
25514,243,4796,1229,3154,28933,1642
66975,14,162,253,132,4100,30
29706,92,3254,1142,2167,42372,1087
55263,173,5881,610,4249,40895,1632
25960,22,244,1219,208,5874,36
11739,120,9181,1456,3852,25697,5329
31857,34,603,1103,373,7085,230
63495,9,63,355,54,4868,9
68110,9,193,217,147,3535,46
2780,17,599,1543,412,22389,187
63084,156,3408,365,2546,32660,862
58609,20,225,513,188,12165,37
24768,25,550,1244,366,9047,184
62266,35,592,387,494,11692,98
64102,3,20,336,19,4438,1
65289,13,221,302,175,6892,46
16413,56,2437,1392,1486,35544,951
26142,86,1367,1215,897,17323,470
38028,7,91,963,74,6826,17
29518,852,16432,1145,9929,66755,6503
52512,161,2022,698,1524,27845,498
51305,4,128,736,116,7579,12
35348,19,444,1033,298,8695,146
66519,5,85,268,64,4788,21
34253,7,116,1060,89,12473,27
63268,227,2850,361,2239,29787,611
16267,20,919,1395,596,15231,323
14130,342,10703,1425,6432,58017,4271
24500,31,611,1250,427,15085,184
21149,7,184,1309,147,10606,37
41962,45,451,898,393,8156,58
19798,16,413,1333,306,9191,107
26513,34,626,1207,388,12230,238
63174,47,792,363,605,7865,187
62508,129,1649,380,1226,13257,423
36015,20,724,1018,502,10667,222
48629,7630,205988,809,135206,800776,70782
1559,23,858,1552,648,11598,210
56150,18,339,585,245,11765,94
39093,126,1127,941,835,9503,292
27311,153,3962,1189,2502,21306,1460
7611,69,2267,1484,1583,34308,684
65112,136,1284,306,1001,9285,283
50790,274,6943,750,5027,33920,1916
69686,3,72,164,59,815,13
28295,9,272,1168,175,12464,97
35682,3789,70423,1026,52577,413096,17846
55590,654,7559,598,6107,50056,1452
56372,43,560,579,450,11240,110
22757,20,408,1284,305,12884,103
18392,240,4755,1357,3159,60732,1596
64162,4,58,334,41,4759,17
36900,28,390,995,286,12675,104
328,93,3044,1562,1912,36608,1132
4956,13,580,1517,388,26659,192
7176,4,107,1489,82,8152,25
66610,3,116,265,87,5763,29
58204,7,140,527,116,7819,24
65763,3,49,290,37,2761,12
32008,33,1082,1100,640,5934,442
21109,65,3225,1309,2012,36226,1213
23723,24,644,1267,453,16855,191
25140,848,14958,1236,10434,92122,4524
34713,13370,292241,1045,165201,1611628,127040
11284,12,555,1460,299,9623,256
35303,32024,759352,1034,476756,2008519,282596
28090,0,0,1172,0,11002,0
4381,3,94,1525,70,10724,24
31210,263,5041,1112,3403,47062,1638
31088,3146,42332,1114,25452,115468,16880
56015,33,484,589,392,7111,92
54860,73,772,621,559,11818,213
12933,20048,689172,1442,407461,2139156,281711
11637,52,1189,1457,758,9543,431
56755,96,1953,568,1427,22298,526
58262,196,1314,524,1013,23625,301
16359,126,1361,1393,864,22855,497
29869,54,1123,1138,773,25161,350
52455,237,3580,700,3075,15711,505
30642,4993,141380,1123,82652,851227,58728
23823,30,822,1265,603,20405,219
4035,5,259,1530,147,14128,112
40492,142,1438,922,1046,9563,392
56395,1249,16199,573,13146,172879,3053
25795,446,10620,1222,6115,41484,4505
70259,4,83,145,67,2968,16
30300,55,1597,1129,1069,16045,528
16614,106,2543,1389,1684,20816,859
22932,8,710,1281,487,10660,223
19297,380,6904,1341,4389,64157,2515
22566,36,1582,1287,1103,15173,479
38277,270,3999,957,3120,64229,879
40642,24,733,920,586,10303,147
48947,171,2244,799,1744,49583,500
52471,1961,21975,699,17948,180401,4027
60196,253,3150,459,2527,26237,623
66773,10,217,260,184,2522,33
24976,5,315,1239,251,7739,64
59125,4,50,496,41,3605,9
64031,55,1071,339,769,28959,302
40602,45,883,921,779,38493,104
4187,9,348,1528,252,12308,96
26314,2,100,1211,62,7697,38
37012,1208,23467,992,19023,228026,4444
10081,1,152,1469,113,6037,39
25699,51,721,1224,482,9507,239
13644,101,3631,1432,2327,42165,1304
38169,88,1451,960,1196,16585,255
60945,8,92,431,77,5443,15
34520,23,303,1054,202,5500,101
70140,4,45,149,38,1755,7
80,736,17353,1566,10661,119440,6692
67915,9,250,223,191,4256,59
49353,2,39,786,28,3436,11
38582,14,177,948,120,13225,57
7686,54,2101,1483,1426,31629,675
69949,27,392,155,330,6771,62
38743,42,760,946,615,10330,145
13303,24,540,1437,270,7961,270
16613,14,795,1389,480,12930,315
66000,2,90,284,67,6739,23
38650,20,315,947,233,3447,82
28521,75,2064,1164,1602,14427,462
58205,718,9907,519,7326,137307,2581
19678,71,3809,1335,2754,32235,1055
26663,244,6209,1202,4205,81480,2004
7760,194,17206,1482,10179,125240,7027
58448,201,2101,518,1709,12063,392
41027,201,4004,913,3296,40327,708
16593,105,1857,1390,1278,21055,579
53474,3,44,670,40,3092,4
25077,441,8248,1237,5454,29118,2794
31429,80,1641,1109,1064,30391,577
56461,7,129,576,90,4420,39
19446,13001,415116,1339,245658,1020533,169458
17903,3514,102243,1366,59559,205637,42684
17204,36,1766,1379,1364,17895,402
21952,209,6136,1296,4161,23664,1975
29290,0,0,1149,0,10073,0
21138,605,14870,1309,10455,96767,4415
13455,16,642,1435,317,13557,325
30306,31,1166,1129,741,32691,425
54202,21,329,646,270,14462,59
24850,8,181,1242,131,5243,50
24924,512,17974,1241,12786,96375,5188
23607,9,212,1270,135,6825,77
38003,25,811,964,594,14419,217
11877,97,4482,1455,2173,38688,2309
10756,137,3583,1464,2171,37139,1412
30919,155,2437,1117,1634,23361,803
65353,6,138,300,92,3932,46
2121,2075,55976,1548,34632,167043,21344
66041,57,916,283,739,18013,177
4696,16,423,1521,308,7169,115
31229,12291,344811,1112,208396,1442782,136415
13579,0,22,1433,11,11577,11
26156,26,1398,1215,869,16027,529
950,450,15199,1557,9852,55898,5347
26905,49,1489,1198,1022,13900,467
20302,25,2654,1324,1917,23800,737
25694,60,1226,1224,707,18351,519
48522,117,1794,805,1323,36058,471
4920,37,1110,1518,831,32286,279
32055,81,1590,1099,1170,14546,420
52986,2288,34395,682,27517,121572,6878
25289,477,8464,1233,5661,41495,2803
23309,101,1347,1275,823,15031,524
32584,22,484,1091,317,13480,167
62411,1011,17731,383,13454,161864,4277
68823,9,219,192,169,6070,50
63590,70,514,353,444,11556,70
7843,10,341,1481,276,9991,65
541,31,899,1560,624,22594,275
1960,37,883,1549,631,27292,252
35362,1036,13800,1033,9238,53800,4562
60578,92,940,372,786,9947,154
19023,2805,56707,1346,41926,162179,14781
11389,20,882,1460,559,10506,323
3063,15,608,1540,436,15001,172
5239,25,1443,1514,1100,12134,343
54043,111,702,652,584,9370,118
49201,131,1521,791,1059,16450,462
56683,81,995,570,816,13808,179
50409,14,271,759,202,2339,69
60094,6,47,463,30,5397,17
11581,35,1126,1458,577,12106,549
29530,7,374,1145,253,8929,121
55877,35,426,594,323,5577,103
52881,72,969,685,831,21262,138
48910,272,4793,800,3796,58193,997
19197,3,262,1343,176,11109,86
37276,19,539,983,377,8933,162
50738,11,182,751,141,5837,41
25689,156,1645,1224,1192,21179,453
64836,58,939,314,702,10068,237
40094,107,1979,928,1576,12727,403
50509,4,136,756,109,8086,27
30202,11,389,1131,279,4718,110
7702,459,14956,1483,10841,46790,4115
11422,127,5452,1459,3520,42436,1932
58032,24,183,532,155,4919,28
53036,33,410,681,310,21201,100
67304,28,568,242,406,7788,162
63244,11,104,361,66,3085,38
6097,40,694,1504,466,18052,228
15661,24,914,1404,580,20955,334
52401,23,443,702,317,9138,126
19744,8,545,1334,434,24344,111
274,35,422,1562,255,24851,167
65020,103,2089,299,1570,22869,519
31761,31,1492,1104,1003,14265,489
1919,127,4669,1550,3102,39950,1567
54331,21,228,642,187,6264,41
13197,2376,106125,1439,61733,597666,44392
104,13,1429,1565,898,13192,531
34137,147,3230,1062,2213,148555,1017
23154,327,10086,1277,5570,33184,4516
61032,340,2587,428,1985,13068,602
58069,317,4378,531,3189,33947,1189
35827,779,14438,1022,10471,156613,3967
1430,375,15325,1553,10460,65073,4865
10014,715,39710,1469,23731,172372,15979
51072,36,549,742,441,10093,108
28684,123,2675,1161,1795,54872,880
22073,164,6398,1295,4357,51611,2041
38866,4,104,944,84,8168,20
30999,22,430,1116,281,11695,149
48640,58,1335,808,893,33513,442
29362,24,633,1148,448,20574,185
23418,2020,32754,1272,22135,130594,10619
14783,31,929,1417,649,19151,280
68792,27,435,193,338,7496,97
29001,92,2586,1155,1731,19386,855
31385,3,95,1110,65,15881,30
55509,39,533,603,400,13609,133
51077,4304,46213,740,38994,196376,7219
46152,71,897,846,722,23693,175
34382,46,1035,1057,733,12426,302
1411,8,316,1553,222,7772,94
62849,83,1081,371,861,9124,220
28131,628,16284,1171,11187,53069,5097
54210,16,204,646,174,9646,30
7790,14,289,1482,177,10666,112
7623,30,1390,1484,986,30187,404
20662,0,0,1318,0,8477,0
2216,61,2079,1547,1535,30519,544
44666,1924,42425,862,33105,188187,9320
65051,10,190,307,147,4482,43
65283,4,50,302,41,3331,9
23290,11,378,1275,240,4888,138
26661,188,3951,1202,2350,14167,1601
19464,149,3103,1339,2157,52330,946
58588,25,434,513,345,10846,89
35837,1776,30611,1021,23378,161302,7233
30319,11,214,1129,191,11470,23
68980,10,65,187,48,2904,17
34279,19,433,1058,326,3168,107
41645,206,1933,902,1547,33358,386
11894,366,13145,1455,7158,118137,5987
8629,51,1392,1476,914,8821,478
25001,628,24546,1239,16252,185870,8294
21153,123,2955,1308,1743,28870,1212
21654,338,5402,1300,3678,49485,1724
65804,86,736,289,584,8420,152
61037,53,413,428,346,6811,67
32239,0,88,1097,61,4845,27
53062,25,259,680,207,3019,52
28989,9,523,1155,283,14902,240
42007,24,217,897,170,4408,47
59711,16,125,476,91,4384,34
5842,315,13441,1507,8906,200210,4535
14988,18,804,1414,549,28211,255
49343,39,334,786,299,8310,35
6669,83,2980,1496,1809,27326,1171
13271,199,3975,1438,2573,36730,1402
16254,0,82,1395,59,2387,23
49018,9,340,796,278,12242,62
50038,22,249,768,196,13136,53
16727,36,2117,1387,1403,40883,714
51626,79,1773,726,1298,18991,475
11237,36,2196,1461,1207,50133,989
36905,42,462,995,388,7141,74
15014,191,5690,1414,4159,47717,1531
36811,7,212,998,172,5162,40
12927,0,0,1443,0,5708,0
25831,15,224,1222,184,9461,40
42570,9,311,889,252,8915,59
68625,11,147,199,101,4071,46
13003,128,5849,1441,3467,61693,2382
59746,12,71,475,43,4754,28
59168,5,228,495,180,5223,48
1564,7,75,1552,50,3958,25
16381,1718,36946,1393,25177,468599,11769
16315,23,289,1394,229,15522,60
32469,45,1011,1086,676,14402,335
58271,14,210,524,162,3269,48
64050,23,628,338,531,13553,97
69371,71,1900,174,1465,16917,435
15594,784,24189,1405,16447,108355,7742
55513,62,595,603,472,13331,123
60837,678,13488,435,10339,56205,3149
28222,64,1505,1170,903,14844,602
39613,35,398,935,345,10562,53
24074,137,3889,1260,2861,39856,1028
5811,927,39507,1507,22354,116704,17153
18286,10,353,1359,238,8314,115
19753,14,849,1333,649,40094,200
7892,142,2491,1480,1574,13267,917
15605,14,859,1405,548,19241,311
66328,16,269,274,195,3197,74
8108,63,3837,1478,2190,18388,1647
9152,44,764,1474,539,8698,225
25631,227,3458,1226,2279,27402,1179
9250,55,1359,1474,837,25114,522
23167,6,148,1277,127,4065,21
31056,64,1843,1115,1238,26500,605
10894,12,806,1463,525,22003,281
40466,215,2821,922,2201,29569,620
14313,6,183,1423,122,7134,61
9387,1270,51536,1473,28816,312124,22720
55429,10,135,548,122,7104,13
3018,6628,165437,1540,93642,301619,71795
928,183,5986,1557,4248,28243,1738
67695,1,79,230,54,3421,25
41376,8848,277164,908,208454,816305,68710
19612,8,145,1336,116,14504,29
34252,111,1593,1060,1242,30513,351
58746,44,670,508,534,10195,136
21708,85,3243,1299,1930,25738,1313
34101,280,5693,1062,4018,101189,1675
6677,200,3158,1496,2430,43611,728
61405,70,1012,416,825,12272,187
15292,7,536,1410,391,20526,145
54723,62,922,627,774,15639,148
56759,6,66,568,46,4361,20
6480,33,929,1499,609,7670,320
53228,915,8395,675,6622,61356,1773
54184,53,754,646,678,12832,76
25608,1095,26014,1227,15851,192377,10163
29884,80,1292,1138,891,11949,401
23285,57,3260,1275,2394,25893,866
10124,10,332,1469,200,5470,132
59524,66,891,483,709,10343,182
45578,6092,149483,852,114256,748967,35227
56088,53,1025,587,871,18011,154
23287,5,216,1275,143,3000,73
34437,159,3406,1056,2506,48346,900
29520,8,611,1145,360,19349,251
37694,1,20,972,19,2896,1
509,88,2024,1560,1389,15601,635
59173,277,2703,495,2176,31377,527
11082,167,4306,1462,2801,25948,1505
55518,3417,87610,603,64056,261321,23554
53024,457,6900,681,5675,27242,1225
11122,11,809,1461,523,31968,286
69149,10,134,181,115,4204,19
22112,9,271,1294,185,14238,86
54784,243,2295,624,1769,34228,526
31619,7,236,1106,171,12797,65
23341,1,158,1274,132,8904,26
19349,83,2629,1341,1917,93732,712
67242,10,138,244,103,3325,35
67058,13,173,251,132,4122,41
965,70,1809,1557,1312,29554,497
62912,3,93,370,59,4043,34
55170,14,160,613,122,2993,38
52254,308,4376,707,3705,30330,671
3804,172,4145,1532,2784,61342,1361
17942,11,408,1365,315,14992,93
2491,91,5016,1545,3455,52866,1561
6708,101,3187,1496,2533,31462,654
61855,50,647,401,500,8535,147
36832,306,6762,997,4742,30816,2020
27525,2894,67625,1184,43848,254768,23777
58668,53,668,511,480,9279,188
18476,14,386,1356,274,12185,112
36976,54,519,993,391,9564,128
57594,48,868,546,704,17796,164
33600,205,4415,1072,2951,42970,1464
58247,202,3627,525,2825,18520,802
59912,738,21710,469,17881,108807,3829
67067,8,150,251,100,4197,50
6904,109,2053,1494,1498,80970,555
21988,569,15520,1296,10850,116718,4670
37409,556,9689,980,7647,65179,2042
63665,8,95,350,65,2401,30
64736,48,582,318,458,4172,124
70329,29,378,143,353,4085,25
9838,92,3976,1471,2048,21710,1928
64058,18,328,338,240,5451,88
51854,190,2548,720,1948,15421,600
21717,210,8500,1299,5801,89102,2699
3417,85,3760,1536,2656,35046,1104
9585,92,1512,1472,949,19105,563
62530,16,219,380,185,5645,34
66283,4,64,276,36,3460,28
57813,50,649,539,536,17300,113
27039,72,1264,1194,850,15014,414
20630,43,1610,1318,1112,17187,498
45642,4174,96138,850,76091,313700,20047
9304,97,2809,1474,1943,43643,866
143,6,297,1565,186,14843,111
8756,19,744,1476,491,9319,253
17611,4,160,1372,138,19215,22
11548,1889,73383,1458,41085,571000,32298
11794,9,283,1456,141,9363,142
31086,3,51,1114,34,3248,17
10772,80,2390,1464,1534,27618,856
23663,311,23543,1268,15187,53829,8356
30282,888,15107,1130,10993,87975,4114
69611,61,1190,167,1176,14887,14
14099,7,475,1426,306,7941,169
65351,12,73,300,60,3429,13
16610,1,47,1389,36,6948,11
68118,74,1857,212,1533,13308,324
46048,48,860,846,567,10110,293
57755,62,957,541,639,30949,318
65710,13,144,291,112,2945,32
24824,143,4059,1243,2683,24970,1376
22501,329,6869,1289,4820,61967,2049
37647,77,897,974,709,16314,188
12984,14,596,1442,292,11271,304
15641,3001,68402,1405,43749,299220,24653
64084,6,127,337,98,2511,29
38811,121,5307,944,3949,40865,1358
1439,536,23824,1553,16445,71241,7379
69151,13,209,181,164,6237,45
68454,639,11652,180,9409,59386,2243
61067,19,282,426,221,6544,61
20346,5,207,1323,151,12523,56
68289,53,840,211,689,13447,151
42512,31,553,890,435,13484,118
24020,30603,626753,1261,333971,1345484,292782
28020,11,651,1173,409,9980,242
66653,18,303,264,244,9540,59
9333,299,12092,1473,6923,61744,5169
18668,21,524,1353,381,19048,143
70621,0,61,132,56,3086,5
23625,4222,120176,1269,74048,658177,46128
19,192492,4907703,1567,3336676,11292152,1571027
12048,9,235,1453,139,7072,96
70542,18,172,135,165,4728,7
11116,39,845,1462,519,41047,326
2102,40,1478,1548,1010,28043,468
59483,265,2910,484,2341,20124,569
56329,263,3404,580,2743,28523,661
11472,14,713,1459,431,11082,282
36400,1,22,1006,20,1769,2
41609,849,11467,904,8871,69921,2596
34593,2330,62572,1052,40976,226226,21596
38171,33,421,960,344,7886,77
20191,55,2684,1326,1902,22361,782
23401,83,2451,1273,1363,58957,1088
27343,8,712,1188,488,22504,224
48957,4188,72658,796,59018,476938,13640
33122,178,5721,1082,4119,96985,1602
45624,3,68,851,54,10802,14
22169,34,781,1293,506,21994,275
57128,12,117,558,94,4831,23
50044,72,827,768,646,7348,181
51432,32,836,732,696,12745,140
18782,9,843,1351,580,14406,263
5342,28,1463,1513,959,20727,504
62655,607,7444,376,5416,30256,2028
15816,45,1081,1402,815,32497,266
3491,16,333,1536,203,14785,130
12677,20,1031,1446,442,8041,589
10037,10698,388529,1469,237874,1616962,150655
21293,14,366,1306,308,18396,58
57589,455,7148,546,5481,48499,1667
40666,99,918,920,720,8429,198
50528,17722,346555,755,258705,1019471,87850
11587,161,7601,1458,4804,161902,2797
58422,21,321,519,236,6477,85
6089,227,8473,1504,5373,81355,3100
51505,231,3553,730,2726,79334,827
37979,487,13687,965,10433,173292,3254
3295,2,49,1537,37,4739,12
55051,82,1052,616,852,9863,200
60380,12,272,453,203,9558,69
11447,27313,1238445,1459,687373,2860444,551072
35384,39,396,1032,307,4933,89
5688,164,5033,1509,3275,29271,1758
19791,9,380,1333,279,26597,101
68244,5,43,213,39,3628,4
24884,39,724,1241,474,13279,250
70215,2,40,147,33,2138,7
60536,251,3515,447,2755,38790,760
49584,19,320,780,235,8404,85
35431,7,63,1031,55,6192,8
19846,48,549,1332,431,29626,118
64117,27,430,336,358,5479,72
56942,14,334,562,244,5517,90
2045,4,337,1549,224,12238,113
65188,8,100,304,88,1530,12
34772,109,2991,1047,2082,34101,909
4790,117,2512,1520,1478,12731,1034
7078,100,2570,1491,1617,22255,953
4645,39,777,1522,555,25378,222
59276,33,427,491,345,9244,82
24047,80,3295,1260,2272,35378,1023
48808,23,784,803,552,20971,232
14351,3577,73477,1422,53824,258139,19653
3375,2130,69660,1537,38211,138583,31449
68895,9,249,190,184,5118,65
31408,80,1723,1110,1074,25825,649
62289,173,2160,387,1773,25266,387
37994,73932,1534622,958,1053386,5979502,481236
55133,161,1866,614,1618,47432,248
51983,255,4089,716,2881,28347,1208
11998,1,103,1454,47,5011,56
39514,3,102,936,96,6555,6
15135,30,522,1412,366,11707,156
40969,103,1720,914,1458,29366,262
9411,185,5314,1473,2921,30928,2393
10001,158,8214,1469,4746,24666,3468
61584,55,756,410,607,10031,149
69538,3,44,167,36,5104,8
60123,109,1625,462,1288,9896,337
62470,386,10797,380,7969,136558,2828
66703,29,325,263,263,2226,62
6333,1550,42613,1501,27338,95668,15275
34036,13,620,1064,356,10898,264
13703,50,2042,1432,1318,18276,724
38931,212,2283,943,1921,32331,362
24324,21,780,1254,522,9798,258
18321,155,3865,1359,3040,47714,825
2791,8,491,1542,305,9587,186
27604,134,3512,1182,2308,26630,1204
34141,18,502,1062,322,16703,180
60032,4,75,465,53,6553,22
53940,79,1342,655,1050,10313,292
66261,3,67,276,50,4733,17
48553,10,124,810,96,3247,28
216,60,2134,1563,1506,19264,628
67981,290,6497,221,5345,36002,1152
65618,18,231,294,185,5219,46
19710,187,4886,1334,3167,48328,1719
27605,19,296,1182,197,4417,99
63441,106,1496,356,1236,10935,260
8610,47,1967,1476,1152,22870,815
14587,12,455,1419,314,18546,141
9876,523,12107,1470,7302,83705,4805
62845,18,522,371,354,17996,168
26927,445,9729,1197,6262,38711,3467
34903,203,3931,1044,2816,78434,1115
35334,69,805,1033,608,4984,197
56622,157,1096,572,945,14614,151
8833,25,1024,1475,679,14419,345
32990,18,301,1084,200,26114,101
12340,145,4229,1450,2658,35635,1571
45606,162,6048,852,4239,39146,1809
1172,20,982,1555,769,27021,213
68764,7,61,194,57,2630,4
45980,16,231,847,195,6968,36
62422,436,4783,382,3710,52885,1073
61399,23,609,416,478,5677,131
540,6,244,1560,166,52860,78
59543,793,18526,481,14878,81967,3648
11089,17,589,1462,346,10236,243
28965,1,103,1155,57,10216,46
29813,121,4661,1139,2826,58218,1835
15579,331,6424,1406,4582,82137,1842
48841,4,50,802,38,1660,12
12897,0,0,1443,0,4526,0
25225,78,1464,1235,958,35990,506
53755,67,668,661,552,17423,116
22597,9,234,1287,164,10067,70
63831,29,290,346,234,6643,56
67850,3,102,225,74,4222,28
69657,23,187,165,167,4322,20
31693,90,3210,1105,2216,32299,994
68461,49,945,205,800,16394,145
679,1772,101456,1559,64213,305325,37243
17984,4203,102440,1364,71537,287869,30903
62570,53,727,378,536,5994,191
69736,48,1110,163,1047,14823,63
4989,302,6644,1517,4386,63852,2258
56310,60,862,581,752,19027,110
23849,26,1339,1265,915,18239,424
37578,111,1773,975,1504,30236,269
36879,284,5876,996,4787,29669,1089
13831,97,4566,1430,2873,29938,1693
34940,265,6662,1041,4810,39819,1852
28654,14,105,1161,60,3112,45
55599,16,150,601,110,4150,40
5028,323,15887,1516,10816,74656,5071
23998,62,1488,1262,1017,14567,471
16484,86,590,1391,401,44985,189
52360,86,1818,704,1420,22417,398
10201,184,5712,1468,3471,62133,2241
57343,75,1246,552,992,9380,254
55347,447,5266,608,4418,50848,848
32683,72,2127,1090,1490,45826,637
38082,40,657,962,489,9380,168
10556,223,6154,1466,3991,50671,2163
10502,95,3755,1466,2326,24839,1429
51289,530,6869,736,5613,54329,1256
38239,21,241,958,219,10921,22
22285,8,232,1292,152,7809,80
3850,0,55,1532,39,7813,16
50315,32,478,761,378,12817,100
58004,348,5959,533,4828,35862,1131
39594,263,4614,935,3157,31688,1457
5541,5,385,1510,297,10108,88
27397,17,922,1187,561,10850,361
5626,2574,101110,1509,66111,640726,34999
22090,35,1457,1294,856,20221,601
7581,119,2225,1485,1440,34087,785
56981,20,214,561,156,5789,58
55069,484,7213,615,5864,33771,1349
8533,2525,157379,1477,96691,485930,60688
19488,19,352,1338,284,15088,68
3541,12,380,1535,250,16158,130
37934,199,5423,966,3448,35778,1975
7863,216,8378,1480,5386,105633,2992
22340,35,297,1291,250,8713,47
35200,1321,30181,1028,22967,175169,7214
49364,9,291,786,200,5284,91
66020,1,37,284,27,4695,10
35746,21,577,1025,419,3648,158
58193,75,538,527,432,17001,106
60223,61,678,458,535,5483,143
49594,14,615,780,407,31517,208
30937,103,2064,1117,1305,22878,759
35024,27,725,1041,605,12776,120
35933,20,328,1020,229,7134,99
15533,153,6083,1406,4184,68457,1899
67759,28,677,228,602,13645,75
51633,8848,207294,726,138567,901264,68727
50307,4454,66875,762,49908,170226,16967
30968,1860,33284,1116,22003,132559,11281
23789,174,2820,1266,1853,13485,967
26637,93,3039,1203,1850,23269,1189
60062,324,7653,464,6527,36154,1126
49065,50,932,795,720,26114,212
4432,238,3883,1525,2802,41801,1081
57737,15,125,542,106,5541,19
36123,41,480,1015,358,19364,122
54574,37,413,632,319,15763,94
32128,79,1190,1099,852,10676,338
34617,259,6125,1050,4103,49758,2022
56814,3,93,566,69,3579,24
62290,4,110,386,95,2158,15
3182,410,16328,1538,9917,48828,6411
17323,2,158,1377,108,4026,50
70472,6,159,138,153,3392,6
59948,9,103,468,86,2736,17
37186,292,7559,986,6189,62953,1370
36784,22,942,998,693,7612,249
10225,33,1710,1468,971,25845,739
54443,264,4577,637,3641,38479,936
2166,9,579,1548,365,36521,214
31376,100,2054,1110,1685,21497,369
23081,114,1996,1278,1304,47364,692
13308,10,462,1437,281,11026,181
68109,31,326,217,226,2620,100
64262,1346,19058,331,15279,121055,3779
5903,50,2129,1506,1355,20591,774
29367,446,14237,1148,9683,113499,4554
17040,972,22404,1382,15213,195929,7191
29882,18,624,1138,410,7066,214
25081,226,7666,1237,5380,55849,2286
51247,928,10713,737,8478,41203,2235
726,30,1708,1559,1153,50010,555
21356,112,2174,1305,1575,36166,599
28691,129,2827,1161,1964,19288,863
27405,19,728,1187,448,12863,280
54242,1,18,592,12,2191,6
11051,26,1078,1462,564,8751,514
22337,499,8826,1291,6121,91962,2705
2700,25589,846279,1543,573938,2785675,272341
3213,23,659,1538,470,10029,189
56618,50,412,572,310,6578,102
67456,3,20,238,18,2137,2
14785,1,69,1417,46,7018,23
57419,52,1024,551,794,15903,230
34081,1235,25005,1063,18855,103206,6150
67093,53,994,250,637,18666,357
3739,551,31175,1533,17532,149494,13643
4775,27,756,1520,584,22740,172
61933,16,131,398,95,3252,36
18098,7,428,1363,299,5231,129
13910,310,10543,1429,6561,115807,3982
12636,23,1765,1446,903,14602,862
33941,26,1046,1066,750,14844,296
42316,131,2916,893,2396,38884,520
23256,74,1603,1275,1300,38485,303
27200,10,457,1191,239,14470,218
44229,6,169,866,140,12258,29
342,69,2925,1562,1769,39784,1156
21785,276,6690,1298,4962,55292,1728
58771,51,1599,507,1146,28981,453
25627,3,69,1226,48,4898,21
55401,97,2260,606,1637,17231,623
22306,22,1363,1292,918,32282,445
9133,61,2736,1474,1617,32732,1119
8725,497,10704,1476,6550,32958,4154
61968,1032,26117,397,22404,177689,3713
43769,105,1539,872,1137,13563,402
5197,53,2657,1514,1949,29030,708
12215,0,0,1452,0,7796,0
8122,9,594,1478,366,11862,228
41112,15,303,912,241,6534,62
60726,24,256,436,211,4546,45
35924,30,1019,1020,706,5442,313
21665,19,424,1300,294,11808,130
18074,15,993,1363,759,24966,234
65520,3,81,297,73,4388,8
20416,38,1573,1322,1211,35455,362
59063,3,44,499,32,1878,12
33585,42,1713,1073,952,8514,761
53715,189,1890,662,1354,12452,536
68916,46,351,189,300,3376,51
66060,20,362,282,299,11731,63
19189,12,621,1343,430,15586,191
45122,0,0,857,0,28809,0
15525,79,1958,1406,1421,17848,537
15796,167,4329,1402,2878,30273,1451
27697,113,3380,1180,1865,11438,1515
24072,149,2715,1260,1961,21162,754
18596,264,4821,1354,3390,60789,1431
24034,198,4443,1261,3157,57383,1286
25645,71,2838,1225,1987,26682,851
25296,15,277,1233,197,6206,80
29855,26,621,1138,374,13177,247
25271,81,1823,1233,1279,37121,544
69052,7,69,185,63,1649,6
58329,1229,39256,522,31549,137910,7707
25691,439,8151,1224,4940,82139,3211
36051,32,374,1016,310,13373,64
37815,100,1560,969,1268,16942,292
65711,31,816,291,641,10986,175
68090,502,11410,153,9793,92401,1617
42644,185,7628,887,5873,39676,1755
2635,7,192,1544,128,24204,64
63171,75,1582,363,1312,21156,270
29125,21,342,1152,197,4060,145
32750,14,355,1088,214,6169,141
69885,1,33,157,29,913,4
22544,16,1108,1288,814,20703,294
45674,12,585,851,390,11353,195
9820,34,1928,1471,1304,21711,624
42688,10,222,886,161,3760,61
23792,14,393,1266,264,5395,129
60753,36,564,438,403,6011,161
10705,77,6541,1465,4399,77429,2142
13790,175,8604,1430,5199,38806,3405
1307,77,3194,1554,1984,110290,1210
46930,23,371,836,282,4492,89
35350,0,45,1033,35,6895,10
65600,98,1870,295,1521,31171,349
68547,17,307,202,210,4362,97
49346,17,201,786,174,4858,27
13017,160,4415,1441,2520,43913,1895
2730,14319,489924,1543,285697,1425930,204227
23530,6116,150786,1271,94592,736952,56194
37472,2,20,978,16,2881,4
15380,582,18312,1409,12958,49777,5354
14519,419,6120,1420,3708,38914,2412
50351,8,161,761,122,2387,39
60364,50,427,453,337,5077,90
38045,23,467,963,344,8743,123
49901,21,305,772,245,6507,60
26480,15,381,1208,240,7716,141
6705,4,164,1496,111,18477,53
64936,17,232,311,179,4767,53
62614,4,138,377,121,5410,17
59439,29,368,486,309,21353,59
61266,1,45,419,26,7872,19
2270,0,200,1547,112,3550,88
55689,57,519,598,430,18429,89
35102,204,4615,1039,3372,22918,1243
63396,9,115,357,91,6741,24
5004,12,816,1517,476,36388,340
2594,409,13894,1544,8328,44795,5566
68180,27,328,215,259,4056,69
63150,42,1085,364,881,17248,204
8297,33,946,1478,646,9983,300
50242,2,39,762,30,3798,9
50360,4,338,760,166,8016,172
14298,0,0,1423,0,22169,0
4139,1503,51552,1529,29192,212679,22360
54535,976,32091,634,25690,140082,6401
64787,43,411,316,364,13561,47
6373,68,912,1501,664,14745,248
23282,17,641,1275,476,25416,165
10185,1131,34294,1468,23419,199372,10875
25966,21,548,1219,369,7946,179
49014,9,193,794,148,10701,45
33876,21,756,1068,512,19633,244
58734,20,384,508,317,9645,67
6989,32,2522,1492,1544,23127,978
530,26,998,1560,776,29337,222
6527,3,65,1498,52,13686,13
55464,27,199,605,157,4475,42
65455,17,314,298,228,8867,86
56538,608,7535,574,5666,25735,1869
59123,10,128,496,92,3282,36
20738,53,2804,1317,1754,24268,1050
65913,40,352,287,290,6335,62
59171,664,11638,495,8912,64513,2726
5125,84,2727,1515,1956,31351,771
14804,37,1837,1416,1231,16494,606
57208,35,461,556,366,10372,95
22484,15,530,1289,298,5539,232
55143,21,382,613,283,6464,99
54937,71,739,619,570,9300,169
29550,199,4581,1145,3207,28201,1374
33612,29,1284,1072,840,23595,444
32297,27,418,1095,352,5705,66
38360,12,251,955,203,10505,48
58067,0,0,497,0,3623,0
61656,114,950,408,780,12287,170
61775,22,270,404,216,8777,54
1668,27,628,1552,433,22399,195
28969,118,3358,1155,2331,32590,1027
39307,1,124,939,102,4026,22
56084,1825,30281,587,24719,127243,5562
56902,343,6795,564,5541,53333,1254
7595,198,6246,1484,3843,20449,2403
8582,0,0,1477,0,7696,0
27627,97,2890,1181,1928,34553,962
16890,77,2344,1385,1624,28064,720
42380,710,10324,892,8505,113109,1819
11580,27,1642,1458,917,19149,725
70134,509,10996,148,9842,72009,1154
3740,737,18302,1533,12274,103467,6028
60777,52,665,437,511,9649,154
26371,0,128,1210,84,5128,44
31458,125,1456,1105,1074,26610,382
21024,52,1262,1311,921,19550,341
19099,664,12723,1345,8540,135229,4183
33389,13,113,1076,90,5741,23
21911,83,1185,1297,821,12825,364
2712,78,1827,1543,1281,21255,546
17567,139,2495,1372,1724,27326,771
59508,4,61,483,41,4512,20
34326,436,5548,1058,4376,63917,1172
61559,52,866,411,769,24984,97
65924,74,773,286,596,5404,177
56910,42,773,563,583,8672,190
21892,310,3369,1297,2010,14977,1359
48594,21,406,809,298,13574,108
2795,107,3864,1542,2698,25757,1166
52520,123,1591,695,1259,85689,332
58210,140,4219,526,3140,32738,1079
62476,6,118,381,104,2535,14
37168,1,53,987,37,6898,16
33205,73,2956,1080,1887,55954,1069
15560,10,483,1406,341,13081,142
256,5841,286501,1563,193284,1348836,93217
66836,257,3459,258,2906,41309,553
58615,43,407,512,317,9654,90
21869,60,2149,1297,1390,22369,759
19642,56,2477,1336,1556,105369,921
67543,31,568,235,503,13607,65
49005,52,785,797,539,5643,246
20518,48,1196,1320,837,20531,359
24329,36,1100,1254,785,13265,315
8728,2035,87762,1476,50613,413741,37149
7684,7,351,1483,229,30959,122
61860,24,467,401,375,6364,92
52366,22,352,704,263,5124,89
3135,216,11261,1539,6471,101282,4790
17786,3,244,1368,177,8128,67
11564,24,744,1458,476,27805,268
832,67,7387,1558,4188,54246,3199
55291,46,635,609,501,15644,134
29863,4,159,1138,92,4798,67
35744,3,129,1023,93,4446,36
49647,538,6741,779,5106,101662,1635
62995,3,69,368,44,3022,25
62051,28,343,394,265,6142,78
5875,628,20081,1507,13302,160927,6779
21784,82,3575,1298,2472,26548,1103
54302,5618,69282,642,55798,194770,13484
19730,6840,194298,1334,142058,413879,52240
66280,10,100,276,81,2677,19
58681,320,5059,510,4173,19322,886
12198,0,0,1452,0,7147,0
15059,3,309,1413,216,22082,93
52503,41,637,698,564,24290,73
37818,1,45,969,37,2902,8
61570,16,184,410,134,5621,50
15278,10,303,1410,241,18311,62
13994,78,1902,1427,1104,16779,798
22495,336,9249,1289,6283,119696,2966
5851,43,978,1507,635,10394,343
37231,37,605,985,448,13145,157
13337,2,95,1437,64,6842,31
18028,12243,498548,1364,294154,1735544,204394
22830,36,1703,1282,1104,30683,599
55091,21,294,615,238,6798,56
14265,326,7077,1423,4608,44198,2469
30505,1315,29788,1125,17998,124937,11790
67053,10,101,251,69,3598,32
6853,14,685,1494,473,32456,212
17836,1284,17955,1367,12702,97847,5253
35400,172,4102,1031,2869,26314,1233
28026,391,11261,1173,7281,108064,3980
20048,40,834,1328,614,28602,220
41875,6452,133779,899,103917,585779,29862
63921,6,148,342,90,5673,58
57198,2100,30231,556,24280,132434,5951
6501,7,225,1499,160,6758,65
66671,346,7861,264,6607,101224,1254
64261,1,8,331,8,1342,0
5366,133,10919,1512,7257,48004,3662
23192,20,609,1276,515,53371,94
53408,20,254,670,200,7561,54
48337,16,390,817,304,6619,86
13931,15621,383870,1428,227262,1052416,156608
31630,20,337,1106,213,4974,124
25314,40,2283,1232,1322,41164,961
50596,0,1,754,1,1543,0
9425,1631,42471,1473,24586,207745,17885
34624,130,3397,1051,2460,30164,937
15249,180,4744,1411,3197,46945,1547
33320,153,2214,1078,1544,16195,670
59526,5,67,483,51,2967,16
24863,115,4141,1242,3001,31611,1140
3544,141,6497,1535,4287,35064,2210
26935,479,11797,1197,8489,361990,3308
9023,42,1006,1475,646,14154,360
34400,261,6180,1056,4702,92512,1478
44338,393,4926,865,3928,61917,998
26272,11,237,1212,142,6752,95
2250,167,4399,1547,3018,46178,1381
28720,5,211,1160,135,9902,76
22593,53,775,1287,537,11201,238
27185,9,340,1192,233,4793,107
21776,409,8366,1298,6552,153738,1814
20107,184,3566,1327,2387,58899,1179
63843,11,110,345,80,2659,30
63616,148,1420,351,1206,15682,214
66124,583,10328,280,8327,63635,2001
18015,120,3432,1364,2526,61328,906
19811,105,2879,1332,1981,40574,898
11288,116,3235,1460,1479,17234,1756
4116,23,771,1529,500,25215,271
41626,829,13863,904,10329,57262,3534
7729,242,3980,1482,2700,18512,1280
56771,14,172,567,116,5908,56
19760,21,994,1333,607,5972,387
63409,26,234,357,174,4073,60
69142,0,25,181,19,1535,6
27583,16,550,1182,345,10685,205
40841,106,2255,916,1881,24423,374
48580,26,351,810,274,10999,77
62320,8,148,386,91,3703,57
41316,32,434,909,334,8295,100
52575,288,2995,696,2435,22366,560
66215,2,69,277,56,3118,13
23056,0,0,1278,0,4714,0
50355,754,12185,760,8868,118472,3317
35067,29,443,1040,329,5061,114
41897,81,1825,899,1468,52812,357
30934,4,81,1117,62,3728,19
25870,37,1187,1221,939,44718,248
15944,48,794,1400,505,10271,289
31600,34,889,1107,601,21389,288
2090,152,3766,1548,2670,40306,1096
23239,50,1018,1276,737,23146,281
27857,1171,19847,1177,13199,69441,6648
16989,132,5742,1383,3519,28065,2223
48262,3213,65843,819,50582,234197,15261
7358,5,166,1487,110,19545,56
229,45,3078,1563,1997,33903,1081
53538,75,540,668,423,14435,117
19299,13,224,1341,142,6565,82
17744,9,415,1369,336,13289,79
16663,38,767,1389,473,16661,294
14664,503,13135,1418,8846,48332,4289
6069,61,914,1504,582,7943,332
28773,14,239,1160,209,6891,30
27528,27,540,1184,317,5063,223
8065,9792,242028,1479,135397,608281,106631
20675,15,931,1318,607,20133,324
12799,11,750,1444,334,28352,416
16435,59,1310,1392,803,12687,507
31413,12,366,1110,239,11610,127
36036,2747,46128,1017,35856,295135,10272
25553,25,1159,1228,728,27439,431
53932,275,2970,656,2559,26460,411
21220,42,721,1307,470,13624,251
66092,0,12,281,5,3256,7
2569,183,7040,1544,4902,49900,2138
15341,161,4314,1409,3023,49371,1291
24127,0,20,1259,11,2515,9
14855,84,2641,1416,1653,13926,988
8855,16,947,1475,616,18176,331
6828,118,5547,1495,2964,32868,2583
32405,6627,124550,1095,80281,566775,44269
14490,63,1822,1420,1534,52758,288
49808,1002,20181,774,14695,52909,5486
31251,13,353,1112,233,13357,120
16537,124,7630,1390,4760,22123,2870
24103,8,138,1259,82,11255,56
14171,25,870,1425,612,21883,258
58454,21,138,518,111,4911,27
41218,677,10536,909,8660,109534,1876
62284,3,76,387,30,4605,46
13369,183,4817,1436,2686,47239,2131
3743,181,4816,1533,3214,38229,1602
19212,5954,176582,1343,124700,900561,51882
30069,490,8033,1134,5035,81397,2998
15833,322,5699,1402,3655,49296,2044
20374,424,8675,1323,6347,71202,2328
57363,865,16150,552,12488,102049,3662
60765,7,117,438,73,3362,44
69927,2,58,156,51,1906,7
57276,56,581,553,443,17348,138
37418,957,17380,980,13928,146642,3452
67239,127,1662,244,1395,8477,267
28471,8,459,1165,351,12645,108
37508,12,255,977,206,6726,49
53165,0,18,676,16,2415,2
15319,23,530,1410,359,12920,171
44741,9,105,861,83,7946,22
9386,21,585,1473,436,12876,149
63891,16,100,343,72,3483,28
8647,1,127,1476,103,7313,24
60366,8,185,453,147,6573,38
36001,3,99,1018,73,7965,26
15104,26,411,1413,274,6170,137
65887,9,471,287,325,13702,146
65907,102,1171,286,882,6097,289
58960,1757,43794,500,31679,126287,12115
37494,57,1576,978,1299,28685,277
61230,19,135,420,114,3493,21
52692,28,427,691,333,14159,94
17868,50,1520,1366,975,26034,545
24040,15,654,1261,453,13570,201
10849,101,7911,1464,4544,41003,3367
9160,64,1671,1474,1048,12863,623
52532,19,334,697,265,9764,69
39757,4,114,933,84,9023,30
18604,19,813,1354,578,27545,235
27232,8,318,1191,211,6878,107
26563,5,422,1205,255,8973,167
2604,483,14234,1544,8852,49303,5382
66679,0,10,263,8,3833,2
1776,12,224,1551,156,8645,68
53459,162,1849,670,1289,12017,560
20356,37,622,1323,416,11550,206
21587,17941,451622,1301,252595,1534508,199027
48962,14,185,798,152,3484,33
8791,366,17003,1476,11243,268471,5760
5483,3,82,1511,63,8476,19
58605,76,1547,513,1113,26475,434
14123,138,1768,1425,1199,17536,569
51313,48,711,735,550,12607,161
65555,30,478,296,394,7738,84
8348,1651,58818,1478,34739,120964,24079
38665,156,7552,947,6057,62606,1495
68807,15,255,193,219,5005,36
61652,136,1615,408,1385,17928,230
26704,4108,64167,1202,41315,266657,22852
2383,2,127,1546,90,9635,37
43055,1265,23474,880,17362,69314,6112
55651,54,484,599,381,8697,103
2292,38,1295,1547,981,27738,314
50476,126,1800,757,1416,37520,384
34287,5,210,1058,151,8063,59
27095,4043,92572,1193,57312,172895,35260
52036,25,468,713,374,14518,94
62220,34,302,389,228,4626,74
52594,13,191,695,143,7422,48
7590,988,27847,1484,17851,138948,9996
2813,140,5019,1542,3037,26836,1982
16880,11,358,1385,272,15359,86
30283,2,130,1130,57,17720,73
66964,69,1418,253,1239,16421,179
61544,38,349,411,262,7994,87
27230,0,0,1191,0,3014,0
25433,31,761,1230,417,6393,344
19365,143,6452,1340,4518,53911,1934
10098,93,5087,1469,3174,36113,1913
3732,43,937,1533,577,19251,360
14202,20,511,1424,336,7528,175
54457,190,1068,637,918,11628,150
58357,2986,58717,511,40404,440488,18313
34138,64,1140,1062,836,26953,304
56184,25,328,584,239,6664,89
6132,50,1759,1503,1207,48749,552
2825,110,6053,1542,4047,57911,2006
65131,69,519,305,430,7638,89
33446,56,1520,1075,1140,11696,380
15351,17,541,1409,433,25939,108
19336,80,1328,1341,847,10568,481
64976,539,5369,309,4480,37872,889
31284,99,1516,1111,1108,13597,408
56757,6,104,568,79,4864,25
2169,12,411,1548,283,15453,128
276,27,739,1562,484,31965,255
50653,10,53,753,49,2238,4
7764,243,7330,1482,5130,47539,2200
27738,37,531,1179,338,12775,193
50950,729,13446,745,10236,84021,3210
1289,66,2660,1554,1830,34723,830
68983,2,63,187,54,3396,9
34466,341,8980,1055,6915,157050,2065
68631,60,521,199,462,5551,59
8155,2,91,1478,69,7905,22
33057,1005,17603,1083,12484,106622,5119
56747,72,892,568,710,7246,182
1458,77,3749,1553,2698,28347,1051
48853,6,155,802,120,2840,35
66812,0,14,259,11,2143,3
56587,29,458,573,364,7053,94
199,27,847,1564,661,24776,186
50455,13,217,758,167,10310,50
27178,4168,128410,1192,88621,292911,39789
69005,6,98,186,82,2992,16
33293,104,2277,1078,1596,17159,681
34816,45,441,1046,301,4859,140
45724,1107,21509,850,16687,83749,4822
51410,69,1113,733,812,18610,301
23648,31,759,1269,543,15261,216
29746,77,1827,1141,1140,17386,687
7480,66,2922,1486,2086,34159,836
7722,180,4682,1483,3377,32085,1305
51556,1640,18627,729,14534,66453,4093
22652,90,2863,1286,1943,32156,920
28264,264,5145,1169,3527,26307,1618
917,250,10008,1557,6791,114732,3217
4577,1047,48166,1523,33373,286625,14793
60742,169,3299,439,2317,17863,982
37527,258,5696,977,4545,21984,1151
548,215,7399,1560,5315,47976,2084
37825,41,1914,969,1391,22595,523
40473,209,3649,922,2968,42046,681
59697,60,632,476,484,15358,148
16967,5,247,1383,200,7320,47
36172,34,711,1013,625,31487,86
26348,26,747,1210,453,7361,294
59513,13,214,483,181,4647,33
43061,156,2297,880,1637,28171,660
15290,1,91,1410,61,4210,30
5057,108,3504,1516,2574,62908,930
67510,32,441,236,320,5905,121
45460,49,940,853,827,21341,113
56472,36,630,576,464,15032,166
48578,683,7724,810,5596,30671,2128
53115,41,703,678,538,10999,165
19187,76,2731,1343,1752,24418,979
17018,902,16783,1382,10750,124255,6033
54994,0,37,618,34,2984,3
11393,14,446,1459,289,8670,157
2146,17829,1141720,1548,697207,2832041,444513
65441,74,657,298,518,5727,139
16131,6,138,1397,105,4902,33
27917,199,3929,1175,2418,34950,1511
34009,11,410,1064,240,12311,170
58564,29,368,514,289,6963,79
21072,43,1706,1310,1177,30092,529
21666,2233,78697,1300,44956,251334,33741
53890,143,1361,656,985,6217,376
32614,293,5193,1091,3755,88215,1438
61804,108,1971,401,1367,20769,604
13304,37,2426,1437,1405,38691,1021
13145,226,13500,1439,7636,67979,5864
2948,60,2139,1541,1494,37751,645
16425,2,137,1392,104,5765,33
26896,36,2058,1198,1144,16578,914
14429,277,4253,1421,2914,57348,1339
11835,7,641,1455,250,14895,391
27487,72,2206,1185,1521,20900,685
25343,252,10687,1232,6725,56734,3962
32844,62,1428,1085,870,9887,558
23770,904,17776,1266,11628,62567,6148
36126,31,351,1015,280,8629,71
65658,172,2863,293,2482,35615,381
45869,229,2664,849,2286,18810,378
19066,219,3732,1346,2585,28477,1147
53702,68,817,663,689,13283,128
23904,850,21065,1264,13255,119394,7810
31127,23,234,1114,154,2581,80
11947,19,1736,1454,810,27928,926
10404,433,15707,1467,8530,52642,7177
34835,112,2468,1030,1850,24505,618
15417,214,4399,1408,3180,52791,1219
2452,21,571,1545,373,13323,198
29503,6,207,1146,126,5370,81
30628,7,115,1123,93,3499,22
6769,60,2122,1495,1304,24309,818
7311,45,2201,1488,1334,23033,867
59614,150,1426,480,1158,11826,268
9421,4075,251833,1473,149056,661403,102777
45430,6,252,854,199,8775,53
4653,13,396,1522,262,16777,134
51087,1064,13828,741,8832,74360,4996
11765,16,711,1456,324,5212,387
67214,3,36,245,28,998,8
67290,15,366,243,328,4778,38
25898,243,5759,1220,4640,74765,1119
11508,56,915,1459,569,8793,346
27827,24,1581,1177,883,37491,698
30337,471,10823,1128,7289,108108,3534
2616,960,35855,1544,23816,122544,12039
20901,49,1811,1313,1233,37240,578
20716,8,214,1317,164,14037,50
69256,6,67,178,50,1264,17
54536,31,270,634,218,9261,52
12716,707,21819,1445,13715,69446,8104
21583,126,4166,1301,2740,52102,1426
23664,680,23348,1268,13684,65531,9664
26913,639,11862,1197,7991,41783,3871
36109,142,2457,1015,2045,34264,412
65027,8,137,307,104,6528,33
50285,99,1782,762,1444,33033,338
59994,6,97,466,86,7593,11
25266,19,328,1234,278,16131,50
38214,2,36,959,32,3398,4
23616,360,11815,1269,8493,143700,3322
49881,48,739,772,532,12596,207
8455,11,414,1477,293,6960,121
7180,5,233,1489,154,34987,79
39046,170,2284,942,1658,28369,626
15891,242,4692,1401,3096,50174,1596
15045,631,34839,1413,20739,193376,14100
58101,249,4707,530,3757,26724,950
18566,105,1209,1354,868,14754,341
11618,635,6328,1457,3358,58013,2970
27829,855,10062,1177,7730,68309,2332
34955,597,9267,1043,6097,39954,3170
2969,14,448,1540,325,11871,123
21131,42,1693,1309,1170,24206,523
54559,192,2086,633,1785,27369,301
60836,758,12837,435,9996,63708,2841
4553,8,226,1523,166,10088,60
36223,32,576,1012,472,4833,104
38674,107,2031,947,1573,18372,458
29517,47,1869,1145,1052,14620,817
35935,33,723,1020,570,10941,153
25692,164,6009,1224,4414,55680,1595
49347,5644,81763,786,60085,365335,21678
1403,4,457,1554,330,10679,127
29331,34,872,1148,597,12378,275
2104,12,652,1548,491,29929,161
17803,15,275,1368,197,11109,78
52177,9,110,710,87,4913,23
33683,25,374,1071,270,6320,104
68580,4,153,201,107,10307,46
28453,44,1307,1165,798,27620,509
32020,10,380,1094,273,31480,107
58043,143,1254,532,1034,8431,220
4041,320,9570,1530,6637,126628,2933
51544,1304,14361,729,10961,96447,3400
20501,656,14045,1321,9513,126301,4532
24075,17,433,1260,311,10496,122
3963,343,9546,1530,6410,53327,3136
2015,40,1294,1549,1099,15864,195
66992,1,43,252,35,2477,8
41147,37,440,911,377,10750,63
53818,11,131,659,99,4969,32
36707,121,2357,999,1847,22446,510
17547,179,4006,1373,2950,63186,1056
52792,13,180,688,157,16695,23
32171,21,621,1098,397,22385,224
33953,23,586,1066,383,13289,203
56305,92,2106,581,1711,14260,395
10329,258,7887,1467,4858,50219,3029
50011,78,1117,769,816,14827,301
69986,6,41,155,37,1062,4
58472,11,119,517,93,7559,26
31672,66,2305,1106,1491,28707,814
61921,41,544,399,428,6084,116
30763,29,988,1120,552,10951,436
10257,9,236,1468,150,7287,86
68453,337,6417,206,5294,55136,1123
70270,33,507,145,451,14422,56
15402,0,0,1408,0,2144,0
64358,4,58,328,37,4142,21
20963,28,500,1312,360,9884,140
3396,19,499,1537,363,14606,136
27065,119,3940,1194,2560,20113,1380
31336,19,734,1110,405,27364,329
56456,475,3946,577,3562,38534,384
60439,4109,55601,450,44856,191143,10745
19290,237,8182,1342,5324,71184,2858
40662,8,109,920,78,3783,31
7872,5,376,1480,214,14134,162
36183,44,1071,1013,854,14257,217
18632,108,3955,1353,2819,47266,1136
24146,381,12311,1258,8548,71205,3763
68303,3,62,211,41,8103,21
58153,45,573,528,435,23541,138
61073,9,90,426,82,9595,8
16720,68,2320,1387,1527,26594,793
48738,11,266,805,217,8345,49
49469,28,299,783,242,10104,57
52299,108,872,705,701,14919,171
62675,24,345,375,263,6187,82
60624,14,167,443,118,9522,49
67529,7,45,235,45,2449,0
57932,251,3679,536,2636,43347,1043
4281,2,131,1527,99,9148,32
58094,39,811,530,650,14198,161
38208,287,3540,959,2814,27499,726
38388,37,657,954,513,10183,144
48667,18,185,807,154,8616,31
63819,231,3209,346,2678,28212,531
18125,80,4790,1362,2207,19651,2583
13868,69,1218,1429,666,19023,552
13885,86,1776,1429,1143,13359,633
11434,26,608,1459,386,13041,222
28778,1094,18668,1159,12857,58525,5811
16130,271,7910,1397,4645,129338,3265
22619,3688,132133,1286,86162,423182,45971
60773,83,1141,438,946,9651,195
35938,6,115,1020,82,3800,33
6788,6,141,1495,114,8523,27
22008,13,825,1295,603,27121,222
13082,1769,64688,1440,37591,316895,27097
53235,16,450,675,348,21783,102
61743,14,191,405,156,13228,35
16920,18,657,1384,457,36449,200
56016,35,388,589,313,5922,75
24662,413,13912,1246,7756,48236,6156
12052,1,223,1453,123,3284,100
22792,9,235,1283,183,12147,52
59272,522,6769,491,5670,48790,1099
63593,212,3249,352,2608,15794,641
66672,30,461,263,353,9127,108
31958,130,1998,1101,1306,24666,692
67079,28,670,250,506,12633,164
13819,0,29,1430,21,3293,8
39111,43,488,941,311,14205,177
61432,4,106,415,81,4410,25
39262,156,2932,939,2184,79084,748
59027,11,182,499,132,5604,50
55888,75,1366,593,1153,13462,213
58962,28,448,502,381,10430,67
53607,93,1115,666,950,20864,165
66099,13,198,281,153,3213,45
1297,337,13780,1554,9988,50520,3792
5074,264,10104,1516,6953,59109,3151
2915,129,3840,1541,2616,42165,1224
29460,107,1927,1146,1613,19664,314
10778,443,12429,1464,7456,100655,4973
26818,106,3359,1199,2190,55613,1169
4486,678,14610,1524,8822,120333,5788
28339,43,1164,1167,694,18026,470
65067,8,96,306,80,5294,16
19709,82,2145,1334,1652,33004,493
33970,29,1027,1066,632,10574,395
25041,6,124,1238,107,5740,17
15823,61,1748,1402,1173,31281,575
7090,2,207,1491,162,10000,45
4832,175,6054,1519,4054,33572,2000
49453,69,805,784,586,9492,219
8793,1251,48723,1476,29650,156625,19073
51157,30,588,739,460,15570,128
13653,22,946,1432,466,4962,480
30892,138,3813,1118,2556,41118,1257
20567,54,1068,1320,853,27735,215
3029,21,948,1540,667,19636,281
16226,3,619,1395,418,14669,201
13886,0,0,1429,0,12628,0
26554,93,2253,1205,1410,55027,843
24219,7,236,1257,181,14823,55
59972,43,797,467,562,12530,235
65427,19,139,298,122,8247,17
39373,24,822,938,608,19603,214
10149,26,469,1469,299,8617,170
67809,6,177,226,115,9250,62
58733,34,505,508,378,7918,127
52339,38,486,704,408,11691,78
67754,42,478,228,370,3799,108
21764,48,1788,1299,1141,31278,647
69897,3,41,157,32,4845,9
827,58,1684,1558,1198,30612,486
387,541,12366,1561,9064,44934,3302
1037,1770,56427,1556,30935,152331,25492
12881,21,746,1443,402,7433,344
54702,39,390,627,301,9533,89
62498,5,88,381,76,4976,12
60332,32,863,454,747,9063,116
43517,839,11820,693,9024,64697,2796
5663,13,541,1509,380,17668,161
24885,16,410,1241,312,9105,98
68030,0,46,219,40,1873,6
16032,7,457,1398,348,10483,109
8482,69,1687,1477,1056,27696,631
61829,8,191,402,150,5304,41
66718,64,1341,262,1195,21514,146
33409,10,525,1076,302,5554,223
2938,69,4551,1541,2904,52837,1647
64196,211,3215,333,2619,11798,596
66971,1581,35103,253,26472,189332,8631
20100,232,4759,1327,3015,21893,1744
30513,28,780,1125,497,6444,283
13283,1,110,1438,62,21408,48
38362,1368,33359,955,25664,236388,7695
32670,105,2456,1090,1668,23107,788
11356,1974,57527,1460,37076,161433,20451
28848,28,1211,1158,789,28029,422
57920,320,5472,536,4276,25904,1196
65233,27,466,303,426,6116,40
55622,25,380,600,302,7492,78
4174,543,10864,1528,7204,60300,3660
30681,117,2278,1122,1476,17762,802
49878,46,509,772,354,12173,155
2155,11,561,1548,361,21789,200
14956,78,678,1415,457,7241,221
26057,8,167,1216,141,11218,26
562,2372,185867,1560,100445,638020,85422
14436,373,11768,1420,7432,107333,4336
7348,61,1279,1488,782,10139,497
39101,6,139,941,119,7838,20
60672,10,113,441,96,7781,17
55026,64,1207,617,939,14812,268
21163,3541,95301,1308,59532,342248,35769
57257,14,123,555,102,7822,21
12778,25,608,1445,350,8532,258
6703,7518,203468,1496,109594,514877,93874
12182,118,2512,1452,1380,25765,1132
15049,10,379,1413,248,16948,131
24756,7,272,1244,177,7146,95
63863,34,514,345,416,11576,98
15607,9,238,1405,189,7153,49
29998,9,363,1135,236,10635,127
33032,2,61,1083,46,7173,15
15746,7,618,1403,468,11627,150
30327,80,2345,1129,1268,15525,1077
4323,4931,269468,1526,170622,1049069,98846
10639,4508,153518,1465,87099,676709,66419
30386,169,2678,1127,1754,34636,924
60149,21,328,461,249,15550,79
67882,2,29,224,21,1409,8
32140,12,350,1099,221,9694,129
31519,17,347,1108,243,12461,104
4802,6,455,1520,309,12626,146
10675,1100,44951,1465,23681,109276,21270
30743,77,2948,1120,2042,33419,906
10903,341,9759,1463,6392,71563,3367
43421,110,1769,876,1382,22098,387
21290,1,91,1306,69,3022,22
19874,14,538,1331,362,13376,176
28380,1166,26592,1167,18189,131683,8403
58788,1,37,507,24,3715,13
28270,71,2195,1169,1367,16735,828
37057,778,10958,990,8149,55017,2809
15350,85,4473,1409,3429,18859,1044
15553,6,412,1406,316,25540,96
24918,11,636,1241,401,9683,235
34852,12,224,1045,147,7913,77
27530,107,1605,1184,920,9732,685
19830,49,773,1332,512,10158,261
33297,75,863,1078,552,8564,311
38113,731,21839,961,15911,120224,5928
20232,76,2824,1325,1843,14056,981
55368,434,6044,607,4690,67928,1354
18661,12,470,1353,345,9102,125
19390,103,2614,1340,1720,27686,894
57009,93,1132,555,853,7316,279
23824,18,543,1265,379,9434,164
55154,558,5530,613,4331,80984,1199
68591,1,86,200,18,1594,68
51437,373,6290,732,4949,49530,1341
1983,2,171,1549,96,12313,75
12945,36,1547,1442,917,84839,630
64255,19,358,331,291,4803,67
60489,100,1057,448,831,17732,226
48777,1221,16075,804,11265,93040,4810
57780,2,36,540,24,6048,12
1210,20,923,1555,680,28777,243
51531,162,2656,730,2092,16286,564
6095,7,393,1504,220,18516,173
4606,38,1416,1522,939,23486,477
16318,5,203,1394,137,9501,66
16801,126,3225,1386,2265,33241,960
8661,15,558,1476,316,8755,242
69414,8,163,173,124,4907,39
26587,35,1066,1205,638,12325,428
26609,28,335,1204,319,6480,16
41419,161,2537,908,1939,17771,598
65548,87,1128,296,798,12030,330
373,339,26497,1562,17351,142908,9146
9169,551,16286,1474,9907,61485,6379
19859,63,1006,1331,659,16311,347
24890,444,8700,1241,5941,50346,2759
65407,126,1859,299,1561,17378,298
60840,250,2801,435,2434,33824,367
12653,24,1041,1446,627,13501,414
34521,15,298,1054,264,3997,34
29260,29,1032,1150,660,16930,372
63557,8,146,354,109,4785,37
2103,159,6268,1548,4313,63835,1955
61304,10,140,418,107,4445,33
22388,77,2322,1290,1663,26362,659
29509,4,262,1145,173,5881,89
20559,30,1204,1320,847,30080,357
66995,43,580,252,421,9139,159
37421,2,107,980,87,4031,20
26209,5,355,1214,225,5844,130
35909,7,303,1020,236,37305,67
65236,16,191,303,178,9008,13
20083,4,164,1327,134,6638,30
55620,7,297,600,215,7003,82
35660,76,1496,1027,894,10101,602
16409,39,489,1392,344,8000,145
3609,8,212,1535,166,10206,46
7547,6,276,1485,166,13273,110
22200,12,585,1293,378,10797,207
70154,4,25,148,22,1527,3
4708,17610,638698,1521,355014,2576766,283684
64975,149,2755,309,2101,16300,654
42308,5,229,893,176,13424,53
23574,2748,60952,1270,42798,190086,18154
60132,4,64,462,42,3641,22
26127,158,4026,1215,2090,15970,1936
69264,112,1757,178,1566,20394,191
10601,25,865,1466,496,9061,369
60745,16,149,439,129,6351,20
9489,22,244,1472,171,7630,73
29654,5,103,1143,67,12216,36
51807,30,445,721,237,10416,208
11822,5,279,1456,149,6969,130
1848,10,801,1550,478,9852,323
35396,7,127,1032,92,6496,35
41744,29,639,901,524,12943,115
32463,97,1570,1093,1120,39116,450
23545,20,556,1271,405,9115,151
31538,183,4835,1108,4157,79236,678
23414,58,1164,1273,830,17723,334
35662,180,2883,1026,2458,39688,425
57111,33,418,558,296,3990,122
20510,6,200,1320,146,10415,54
19211,0,184,1343,135,11849,49
51536,94,1276,729,1017,17484,259
17556,26,1098,1373,888,11008,210
57368,7,184,551,131,3975,53
38021,57,1128,964,932,16131,196
59219,576,11239,493,8339,64589,2900
27079,95,2336,1194,1506,16572,830
64676,50,703,319,546,11472,157
65175,26,418,304,356,8019,62
29786,76,1827,1140,1072,20978,755
14959,30,1934,1415,1256,10907,678
17163,1128,26669,1380,17446,152990,9223
55732,68,812,597,705,37455,107
59351,2,55,489,46,8469,9
28485,91,3229,1165,2120,14956,1109
28452,205,2091,1165,1397,14063,694
24140,109,3046,1258,2111,63813,935
26544,274,6342,1206,4358,83510,1984
63040,165,2166,367,1742,24578,424
20010,27,678,1329,474,9594,204
62132,246,4470,391,3389,57040,1081
67868,13,277,224,176,5354,101
49508,7,165,782,138,12088,27
50932,9,242,745,192,7915,50
49946,22,294,771,255,20247,39
32676,612,8794,1090,6647,44533,2147
9762,699,20979,1471,14719,82344,6260
3564,59,4342,1535,3087,53450,1255
60245,69,1016,457,754,15693,262
52004,953,13930,716,11315,74351,2615
42282,103,1220,894,990,10345,230
20976,13,168,1312,112,5481,56
36762,219,2808,999,2024,73502,784
1534,19,822,1553,587,23515,235
16622,45,1686,1389,1135,26536,551
50198,2,69,764,48,6190,21
34040,112,2199,1064,1633,53477,566
28346,11,684,1167,399,7598,285
13725,941,48756,1431,34214,211716,14542
55111,15,162,614,144,7377,18
14633,23,506,1418,346,14383,160
21802,2,158,1298,121,10365,37
57671,19,357,544,309,5541,48
34297,29,904,1058,726,14323,178
62894,496,4433,370,3446,35072,987
65130,31,254,305,217,3171,37
19381,4167,123162,1340,66328,344734,56834
1338,180,4231,1554,2716,19420,1515
61354,61,964,417,791,14220,173
40849,36,995,916,862,13974,133
56126,1911,20640,586,15994,88771,4646
59977,80,548,467,413,7829,135
3702,2,121,1533,83,17860,38
25400,9,269,1231,216,15982,53
38719,133,1328,946,1003,14982,325
51311,1474,14773,735,12630,61643,2143
34391,73,1509,1057,1012,15756,497
9761,15,476,1471,293,6730,183
64397,15,296,327,209,4746,87
12583,1320,39178,1447,22212,219103,16966
66714,3,77,262,66,4763,11
1152,19,705,1555,562,21853,143
61002,150,1917,429,1503,14452,414
25139,505,10832,1236,6749,33052,4083
28249,21,391,1169,265,4514,126
55800,347,5602,596,4586,20035,1016
22113,6238,226145,1294,151825,567482,74320
11253,66,2811,1461,1651,27863,1160
4401,51,1146,1525,753,30435,393
66182,0,0,278,0,2751,0
6951,450,13213,1493,9102,167473,4111
3888,39,1185,1531,811,10898,374
66083,35,361,282,294,2577,67
43457,125,1388,875,1052,16689,336
26920,92,2007,1197,1092,15470,915
11665,111,3508,1457,1953,27856,1555
7318,206,3079,1488,2089,29804,990
37399,4,125,980,93,6123,32
49130,3157,39531,793,33137,276179,6394
13853,140,4382,1429,2828,58929,1554
3524,1571,32164,1535,19199,759260,12965
6478,83,3242,1499,2235,21436,1007
8143,518,21132,1478,12130,69027,9002
9746,5,128,1471,87,7998,41
34354,119,2036,1058,1456,26171,580
10238,327,10975,1468,7564,73059,3411
66473,13,364,270,307,12104,57
29115,25,882,1153,568,7711,314
56348,58,609,580,504,9281,105
11901,19,1141,1455,489,13436,652
26565,88,1146,1205,709,10553,437
66988,77,946,251,696,15582,250
29732,60,1598,1141,879,17609,719
23018,144,3421,1279,2629,26797,792
58189,37,833,527,653,10117,180
5783,948,40414,1508,20693,128440,19721
62831,27,341,372,282,4815,59
6298,4,120,1502,83,7305,37
28896,14,919,1157,552,25680,367
26373,1,193,1210,131,7530,62
8162,617,12549,1478,8093,39885,4456
63730,20,202,348,159,5338,43
5808,3,183,1507,86,3133,97
50754,126,1520,751,1072,16039,448
20592,19,992,1319,644,7318,348
34528,37,1167,1054,779,15583,388
32208,5,214,1098,144,6122,70
8650,38,1144,1476,724,10668,420
15259,125,2733,1411,2002,22579,731
19589,22,482,1336,412,17542,70
117,0,0,1565,0,12358,0
45113,81,749,857,544,18775,205
20285,32,935,1324,708,11069,227
30566,70,2526,1124,1336,14995,1190
14837,9,347,1416,248,15271,99
54920,84,938,619,827,17746,111
19405,0,0,1340,0,20454,0
10228,77,1999,1468,1358,28166,641
52733,1672,21175,690,16960,82963,4215
53338,26,306,673,241,4003,65
634,179,6065,1559,4409,52103,1656
68131,1094,15844,216,12441,75413,3403
6186,184,6557,1503,3720,43194,2837
30445,18,207,1126,160,6998,47
41790,13,335,901,227,4848,108
10157,22,1003,1469,666,14540,337
50586,45,491,754,358,21211,133
54596,113,1075,631,851,9828,224
59778,52,730,474,587,13643,143
56344,8,73,580,54,6459,19
15729,10,338,1403,227,11723,111
61950,6,58,398,44,1795,14
64517,8,74,324,53,4391,21
27742,9,356,1179,285,18055,71
9938,8,546,1470,354,14480,192
31025,0,48,1115,34,3773,14
52111,22,205,712,171,4598,34
19475,75,1688,1338,1176,33004,512
66145,2,32,279,21,1876,11
63774,1143,25359,347,21085,169869,4274
19945,2,91,1330,73,11487,18
56309,21,289,580,242,11845,47
22249,31,756,1292,486,6641,270
7482,8,531,1486,379,15870,152
38098,16,298,962,266,8891,32
52741,36,624,690,440,10504,184
56323,16,268,580,189,8790,79
17185,116,3407,1379,2456,16811,951
50523,19,290,756,225,10391,65
64734,7,63,318,44,6000,19
19542,21,676,1337,496,14706,180
30329,43,909,1129,631,11447,278
68790,10,99,194,81,2895,18
46825,2,75,837,46,2943,29
56572,29,468,573,399,8563,69
35085,12,174,1040,113,6640,61
29790,89,3087,1140,1974,38622,1113
24240,561,20579,1256,13145,183866,7434
50773,94,2742,750,2440,24786,302
37913,31,704,967,558,9482,146
30857,115,1889,1118,1408,22974,481
37617,7,455,974,273,12674,182
1474,25,1031,1553,731,34579,300
66488,111,1767,270,1439,25608,328
59443,172,2323,486,1917,36163,406
41491,14,149,906,102,4355,47
25984,30,787,1218,498,18510,289
30353,658,15957,1128,10796,120209,5161
68718,5,67,196,54,1693,13
54388,17,207,640,161,4792,46
65665,12,225,293,176,4551,49
67382,11,136,240,119,4521,17
1710,250,5868,1551,3646,56380,2222
9952,155,7910,1470,4513,86543,3397
6645,38,724,1497,469,15388,255
1780,72,1316,1551,983,9858,333
1688,602,12069,1551,8317,48496,3752
44547,901,24898,863,19483,121438,5415
6998,110,2221,1492,1636,25654,585
61300,1863,28776,411,22377,149303,6399
13878,832,44078,1429,28157,244389,15921
35948,94,1409,1019,1083,18951,326
16609,12,340,1389,214,5733,126
57053,24,176,560,143,4345,33
67781,5,168,227,71,7104,97
70370,13,194,141,158,6030,36
35720,24,528,1025,401,11812,127
24112,8,890,1259,630,19168,260
33675,44,530,1071,388,11723,142
49911,6,57,772,45,2199,12
58927,93,2120,502,1620,26672,500
41950,67,2369,898,1865,19098,504
37289,13236,245869,983,171033,1219666,74836
27334,94,4937,1188,3067,28766,1870
15849,1924,53514,1402,36728,296752,16786
65818,28,394,289,320,12808,74
46033,29,646,847,537,8817,109
67746,35,730,229,614,7682,116
63100,0,36,365,25,2108,11
14918,13,985,1415,667,22340,318
59477,1730,41830,484,32251,156137,9579
12070,5644,239296,1453,131350,1035655,107946
58689,681,8179,510,5820,61737,2359
36023,9,221,1017,186,11610,35
5334,16,704,1513,501,11359,203
12533,47,1346,1448,740,34566,606
9858,13,1366,1470,879,14973,487
24817,18,793,1243,608,22245,185
17549,10,941,1373,684,18377,257
61160,71,1471,423,1122,11774,349
33706,160,2477,1070,1769,26646,708
4657,8,259,1522,201,10347,58
25390,115,5804,1231,3678,29143,2126
65365,43,475,300,390,3187,85
62547,3,123,379,91,5907,32
42023,8,140,897,89,6118,51
40422,15,151,923,140,3864,11
1233,962,34245,1555,23312,328403,10933
42044,243,2489,897,1746,28605,743
51722,84,1907,724,1303,19661,604
67711,21,425,230,381,6673,44
59037,87,820,499,592,6631,228
5815,7,538,1507,353,19706,185
52609,18,207,695,149,7415,58
52161,14,142,710,108,9962,34
18210,48,930,1361,706,14904,224
54058,513,5758,651,4555,45766,1203
70345,78,1133,143,1073,9085,60
33142,35,1097,1081,725,27715,372
51472,13920,173886,731,123737,563117,50149
53727,41,408,662,291,23221,117
64945,2,21,311,8,2269,13
57166,28,340,557,255,6568,85
14299,36,667,1423,451,12050,216
63346,231,3122,359,2079,40139,1043
15864,74,2482,1401,1594,36381,888
10724,5,284,1465,152,7681,132
31940,20,441,1102,304,12579,137
66036,53,505,282,443,10084,62
10290,0,0,1468,0,5065,0
55649,82,755,599,636,10722,119
6297,22,355,1502,253,7152,102
23911,190,4923,1264,3426,109154,1497
56519,29,405,574,348,12081,57
56492,629,7621,575,6183,62065,1438
66427,36,472,271,362,14312,110
67018,6,60,252,53,2678,7
64644,3,38,320,34,2409,4
45671,43,643,851,446,10281,197
33453,100,4355,1075,3338,57199,1017
55153,258,2504,613,1959,16537,545
20332,1,102,1323,74,3697,28
25508,421,8198,1229,5796,34694,2402
13278,316,15816,1438,8965,85015,6851
29646,232,7719,1143,5038,92231,2681
43171,49,608,878,463,7574,145
14842,9,446,1416,325,41803,121
35686,97,1419,1026,1050,12609,369
10656,130,5487,1465,3137,57106,2350
29203,80,1654,1151,1076,15888,578
26533,50,1595,1206,1305,23058,290
50435,457,5359,758,4192,47632,1167
14971,35,1651,1414,1088,16433,563
69305,8,55,176,47,1965,8
48896,23,229,800,191,8324,38
52167,928,13899,710,10786,52579,3113
36353,28,587,1008,478,8402,109
559,42,2301,1560,1630,34084,671
60738,1096,16573,439,13990,132315,2583
23581,32,1346,1270,862,6732,484
41436,46,810,907,664,13066,146
9627,78,1589,1472,1057,15098,532
21304,37,1258,1306,970,15512,288
31119,28,547,1114,384,9258,163
37502,1,172,978,127,6198,45
24032,28,590,1261,415,13742,175
23935,109,1899,1263,1430,35189,469
1171,28,1075,1555,793,31915,282
30412,43,1104,1127,632,11160,472
29015,9,354,1154,203,5269,151
33026,84,2226,1083,1471,27137,755
58576,68,1191,514,986,16684,205
19486,235,3558,1338,2264,30508,1294
30183,38,1984,1131,1297,34786,687
10785,16,433,1464,280,6116,153
67572,43,1365,234,1031,18995,334
19900,35,966,1331,533,9287,433
11659,55,3472,1457,1791,64376,1681
45487,210,2582,852,2116,24337,466
40915,2304,89568,915,72494,386422,17074
48642,6,90,808,69,3128,21
20715,1,66,1317,51,5006,15
36733,32,492,999,388,6366,104
4155,20,454,1528,313,8051,141
31898,25,545,1102,313,4554,232
7152,50,1464,1490,992,30918,472
49644,61,707,779,556,14209,151
16376,533,16440,1393,10826,136870,5614
50005,1216,11175,769,9179,99764,1996
57302,263,3016,553,2399,13568,617
35321,451,7841,1034,5948,43240,1893
11782,129,5298,1456,2976,35298,2322
29067,14,469,1153,302,7330,167
13596,202,6356,1433,4215,47880,2141
49557,187,1924,781,1540,8059,384
68299,3,60,211,47,3770,13
17682,5,187,1370,128,10385,59
30103,11,404,1133,229,8521,175
27800,13,367,1178,215,9769,152
710,93,3445,1559,2456,29290,989
35979,99,1184,1018,894,25924,290
18301,15,629,1359,478,15056,151
34514,776,38563,1054,29724,225730,8839
36933,139,2606,994,2056,35637,550
54721,130,2453,627,1611,24544,842
57196,68,1089,556,677,15800,412
22974,58,1521,1280,950,20560,571
61889,1295,29114,400,23247,122355,5867
9895,255,7216,1470,4737,71647,2479
64253,5,97,332,72,1886,25
11987,55,3258,1454,1888,29656,1370
44430,265,3761,864,3157,51518,604
16913,59,1299,1384,792,12599,507
50399,126,1670,757,1322,21015,348
18845,148,2407,1349,1732,36297,675
29014,36,1198,1155,749,8476,449
29930,14,575,1137,329,19047,246
16031,10,327,1398,256,19197,71
19684,130,3824,1335,2591,47124,1233
13986,303,12393,1427,7711,93925,4682
25047,13,614,1238,436,9905,178
54093,15,165,649,129,6155,36
49128,335,3264,793,2304,23589,960
18471,123,4081,1356,2770,40064,1311
4388,783,24121,1525,16699,134566,7422
8161,197,3016,1478,2018,14006,998
20795,35,278,1316,232,12397,46
36363,417,9258,1007,7365,70287,1893
29629,27,830,1143,538,12207,292
28852,68,3762,1158,2020,14289,1742
59714,1295,17293,476,13952,58911,3341
30670,49,1342,1122,800,12653,542
68944,71,1078,188,919,10144,159
54207,28,488,646,329,15477,159
49818,0,5607,774,2695,24593,2912
54162,55,400,647,318,11576,82
60829,92,2359,435,1656,41888,703
59938,26,620,468,433,8194,187
46190,15,229,845,135,2901,94
248,3822,146405,1563,82817,532624,63588
20045,112,1769,1328,1535,37916,234
23695,104,1851,1268,1539,43348,312
21145,327,3903,1309,2309,18672,1594
38065,13,430,963,371,12587,59
28578,33,884,1163,561,11716,323
23516,34,617,1271,475,33625,142
34450,23,658,1055,392,13220,266
53082,2,54,679,46,4551,8
68075,59,643,218,504,15257,139
55370,526,10508,607,8465,68332,2043
68982,602,13458,187,10748,71835,2710
905,671,22716,1557,15089,66472,7627
34346,10867,333767,1058,208007,757561,125760
35649,32,479,1025,346,8131,133
37227,165,2576,985,1955,34722,621
58179,100,1391,523,1138,14220,253
14079,76,4078,1426,2529,29188,1549
54151,165,2461,648,1976,43100,485
34533,10,190,1054,126,7702,64
37840,2,24,969,23,9277,1
29978,6,231,1136,143,6017,88
4430,29,1180,1525,868,19040,312
65048,7,103,306,85,3795,18
57800,52,327,540,270,6487,57
60557,43,584,446,480,9232,104
18092,33,837,1363,574,9023,263
6782,14,519,1495,320,7929,199
62965,60,1047,368,907,18822,140
22598,4172,139470,1287,87225,447169,52245
44410,1184,17875,810,13046,128927,4829
15274,2,132,1410,64,7623,68
8142,52,1958,1478,1189,23102,769
19451,61,1064,1339,719,11048,345
41165,37,734,911,614,5756,120
28274,41,674,1169,554,10530,120
61602,242,3505,410,2799,26618,706
16810,34,1000,1386,739,14110,261
4866,1735,35124,1519,20945,188973,14179
4193,17,320,1528,224,18893,96
7770,63,1507,1482,1013,9481,494
57605,11,161,546,134,8845,27
67953,1,49,222,38,2109,11
67355,5,92,241,74,2261,18
60996,1,20,429,12,3058,8
11390,1304,46974,1460,29586,162895,17388
9100,2,212,1474,153,20282,59
3511,186,8104,1535,5535,116920,2569
52388,18,242,703,192,11162,50
67658,7,64,231,61,2541,3
64793,218,3312,316,2616,25193,696
50483,1652,45047,757,30641,243724,14406
62800,2286,26761,372,19606,67686,7155
25294,118,1871,1233,1361,13284,510
19205,76,1317,1343,890,8644,427
24788,2,280,1244,195,6912,85
15428,2330,28532,1408,20758,207953,7774
59269,415,9742,491,7076,87260,2666
55571,25,185,602,165,10630,20
36174,59,746,1013,581,13858,165
40356,0,0,924,0,9786,0
65087,17,278,306,225,6615,53
4334,121,4139,1526,2659,22446,1480
11529,2,352,1458,190,4517,162
44871,3,46,860,37,2153,9
58983,420,8443,491,6685,75471,1758
9072,103,1642,1474,1107,13307,535
18525,75,2868,1355,2054,26707,814
31246,25,802,1112,511,13499,291
8206,112,3956,1478,2453,13024,1503
54696,12,196,628,150,11263,46
34399,5570,111516,1056,66736,219136,44780
65533,48,402,296,319,6330,83
56058,38,534,588,407,6505,127
64984,21,156,309,128,3481,28
39425,31,610,937,482,12969,128
13022,0,0,1441,0,10713,0
2397,309,17733,1546,11251,75980,6482
68429,16,235,207,182,8912,53
51412,26,522,733,446,11376,76
69816,18,281,159,275,4177,6
32273,41,1248,1097,702,9951,546
48796,284,3118,803,2452,16402,666
28650,216,5603,1161,3339,49949,2264
32403,73,1472,1095,1012,16480,460
37202,2063,98810,986,72477,496734,26333
5762,71,1396,1508,922,15451,474
49582,34,242,781,172,3802,70
32194,127,2838,1098,2147,32642,691
31712,3,98,1105,82,7744,16
9143,21,610,1474,350,11759,260
18526,2891,40919,1355,27837,216032,13082
18880,15,296,1349,175,8651,121
61460,2687,32015,414,27099,122674,4916
33323,5001,88915,1077,58391,276759,30524
50407,561,8972,759,6726,68781,2246
55589,51,929,601,804,11572,125
18033,50,2391,1363,1698,30085,693
3862,11,655,1531,460,10610,195
25168,1,22,1236,21,5614,1
24865,204,3026,1242,1941,28107,1085
35105,145,4221,1039,3304,54723,917
34516,29,613,1054,418,14070,195
8459,2,192,1477,89,8625,103
60430,1428,22078,449,18471,166406,3607
8771,178,4072,1476,2584,29726,1488
52055,9,86,714,71,4753,15
1866,5,165,1550,129,10143,36
7638,454,13511,1484,10672,166543,2839
17141,73,1714,1380,1245,36160,469
11851,42,2224,1455,1085,16528,1139
10354,91,2262,1467,1358,24308,904
43201,4,97,878,42,2091,55
13889,80,3375,1429,2003,20952,1372
10587,31,1194,1466,817,15086,377
57856,299,3564,537,2866,42454,698
55935,22,215,592,183,8146,32
36309,71,1316,1009,1051,23255,265
68394,69,701,208,562,7726,139
44413,133,1496,864,1148,11319,348
15318,116,2748,1410,1857,24632,891
1002,54058,2899030,1556,1346066,6302003,1552964
59706,16,198,476,166,5273,32
5272,12,610,1513,476,14458,134
37873,18659,345336,968,250899,800780,94437
29660,44,655,1143,467,12035,188
6922,33,1011,1493,677,16207,334
53337,7,189,673,129,3037,60
31984,208,5584,1101,3887,31359,1697
32232,785,31811,1097,22765,90283,9046
58139,238,3848,529,2967,24302,881
12075,3,173,1453,89,10557,84
62807,62,493,372,389,4384,104
39988,216,5467,930,3895,45029,1572
63674,99,1145,350,926,16559,219
17379,5,152,1376,93,3330,59
25814,66,1385,1222,950,15127,435
55587,313,6054,601,4774,56857,1280
30311,5,373,1129,257,9085,116
22810,23,1028,1283,696,34429,332
68984,2,23,187,19,4662,4
2321,378,9708,1546,6322,45790,3386
19618,3769,118133,1336,74677,317206,43456
31688,20,569,1105,346,4111,223
17953,18,773,1365,611,11123,162
50559,11,311,753,207,3161,104
50043,996,12103,768,9618,45878,2485
30718,131,4498,1121,3029,39235,1469
859,1112,45222,1557,26496,327377,18726
38368,1051,19755,954,16304,142874,3451
42942,87,1685,882,1217,29116,468
6043,122,5228,1504,3374,52269,1854
35245,113,2045,1036,1447,21451,598
69754,6,84,162,60,6821,24
55813,2,73,595,24,2713,49
61459,84,1360,414,932,22258,428
59412,394,4751,483,3576,24483,1175
37563,106,1344,975,1008,14938,336
7147,63,1098,1490,749,15565,349
1933,3,169,1550,125,20655,44
10015,35,1190,1469,800,20432,390
62870,11,81,371,61,3669,20
31393,36,852,1110,586,9742,266
62053,60,697,394,587,10462,110
39269,8,95,939,84,5373,11
52308,63,891,705,647,10326,244
66617,11,60,265,47,3344,13
63942,17,196,342,148,2652,48
48387,859,10742,816,7941,107226,2801
35650,50,1810,1027,1311,22067,499
1570,30,503,1552,348,12360,155
67710,49,615,230,488,5664,127
34712,11,550,1043,404,9908,146
7228,117,3618,1489,2443,32985,1175
35989,132,2106,1018,1717,23493,389
31769,177,2783,1104,1775,9776,1008
61644,25,305,408,239,5205,66
67267,177,3379,244,2568,28911,811
41643,32,813,903,576,11703,237
5484,45,1539,1511,1098,18083,441
65337,129,1666,301,1314,21919,352
20460,1252,33881,1321,22485,225944,11396
10680,246,6844,1465,4404,64435,2440
36102,35,825,1015,641,7899,184
2539,50,1921,1544,1187,16412,734
22064,4,27,1295,22,7325,5
57279,84,2736,554,1921,20621,815
64134,24,508,335,402,7589,106
66466,4,124,270,93,4236,31
62018,7,75,395,60,3270,15
44121,1,36,868,21,2654,15
23428,374,11685,1272,7077,74716,4608
64948,1838,19118,310,14817,106748,4301
4855,17,711,1519,523,18515,188
5932,2396,41263,1506,29138,224456,12125
34047,734,10213,1063,7450,54590,2763
37697,262,3317,972,2759,21946,558
1170,16,796,1555,611,11116,185
10804,266,5223,1464,3118,18185,2105
33078,154,5208,1082,3783,50733,1425
13318,11,316,1437,185,9925,131
67158,27,536,229,373,20861,163
44988,87,1253,858,1038,16596,215
69283,52,1056,177,929,12855,127
20197,92,2592,1326,1780,35703,812
37830,106,1948,969,1519,13589,429
12762,54,1897,1445,1128,21323,769
11128,1684,76189,1461,46820,183778,29369
27477,11,415,1185,244,23694,171
33133,63,1721,1081,1185,17600,536
19302,19,353,1341,242,13826,111
7609,72,4845,1484,3162,73193,1683
3482,47,1246,1536,921,8981,325
62564,83,847,379,699,12843,148
9459,22,532,1473,351,12349,181
34222,752,12900,1060,8946,87221,3954
51090,98,1384,741,1111,15638,273
61694,80,893,407,632,9491,261
31398,121,1988,1110,1462,21559,526
34708,505,7412,1047,5729,57316,1683
48946,19,174,799,156,8290,18
9881,149,6243,1470,3645,27397,2598
653,3,153,1559,111,15856,42
63236,6,87,362,67,6838,20
3248,5,131,1538,96,26909,35
50132,1973,28942,766,21744,119820,7198
11084,12,1103,1462,642,22274,461
58555,419,3093,514,2328,15468,765
64349,5,74,329,65,5865,9
22046,61,1020,1295,637,12318,383
58912,6,94,503,62,3308,32
24208,6,214,1257,155,8102,59
34049,25,569,1063,417,9981,152
1114,913,44597,1556,24369,187732,20228
35960,101,1615,1019,1239,7672,376
7885,87,2059,1480,1521,29444,538
5177,203,10161,1515,6765,123159,3396
62930,48,568,369,442,11146,126
3014,30,947,1540,722,9387,225
27986,23,529,1174,421,20953,108
57572,24,243,547,208,6722,35
61133,27,360,424,312,5737,48
26214,384,11530,1214,7405,76792,4125
60497,325,6164,448,4784,29246,1380
21853,29,584,1298,355,12851,229
38938,23,431,943,332,7617,99
24043,144,3539,1261,2332,29380,1207
30252,253,10655,1130,6630,63742,4025
55875,55,760,594,596,10452,164
63785,26,177,347,159,6874,18
19925,42,625,1330,424,23455,201
34987,132,2432,1042,1627,30183,805
9356,637,21053,1473,13417,71308,7636
26083,4,209,1216,124,5647,85
23230,209,2574,1276,1755,70587,819
68442,12,220,206,172,5643,48
69600,19,254,167,220,2766,34
20597,33,583,1319,409,7146,174
9506,51,1842,1472,1212,23136,630
52197,171,1462,709,1127,20921,335
49593,626,7583,780,6220,62082,1363
16534,37,562,1390,412,14434,150
64119,13,148,336,113,2206,35
63995,10,263,340,205,7273,58
20043,49,1483,1328,875,10819,608
26667,49,1090,1202,651,10973,439
13573,384,22533,1433,12721,100297,9812
4966,52,3141,1517,2140,30859,1001
20924,286,4750,1313,3136,74931,1614
67361,3,52,241,49,1721,3
32189,82,894,1098,597,7846,297
2445,361,11497,1545,7153,97040,4344
5137,355,16468,1515,9547,117083,6921
67155,15,261,247,218,5915,43
68277,18,159,212,113,2517,46
35108,77,1976,1039,1642,17333,334
49732,215,4484,775,3770,32597,714
285,347,6813,1562,4304,34246,2509
49371,305,4446,786,3490,98784,956
9772,9,781,1471,458,14568,323
49359,169,2958,786,2539,34198,419
29783,26,396,1140,274,8466,122
59676,13,124,477,89,4797,35
19431,13,403,1339,304,18299,99
30583,7,407,1124,289,16718,118
66513,11,106,269,75,8859,31
48771,21,398,804,331,9551,67
54833,10,52,622,43,7468,9
38529,11877,218474,950,180991,706193,37483
29041,37,899,1154,604,23123,295
37146,696,9101,988,7173,78484,1928
59568,168,4447,481,3291,49098,1156
43183,41,513,878,408,6128,105
67899,10,79,224,65,2175,14
56654,76,1122,571,908,11354,214
5859,167,3551,1507,2786,26580,765
64801,223,3578,316,2833,36382,745
39852,65,710,932,573,16588,137
13317,7172,200662,1437,127659,819726,73003
11071,154,4379,1462,2604,28405,1775
69778,2,29,161,24,1470,5
57325,14,214,553,164,5248,50
70151,26,600,147,539,5923,61
55230,508,6359,611,5321,42852,1038
32603,69,2103,1091,1455,9163,648
52089,15,244,713,165,13212,79
21899,107,2841,1297,1563,17982,1278
2593,102,4222,1544,2977,68088,1245
63191,60,1558,361,1198,15270,360
51490,8,164,731,122,8867,42
29652,15,569,1143,353,5985,216
36147,3121,86217,1014,70282,285316,15935
30532,22,625,1124,399,15815,226
7354,829,32936,1487,19470,239289,13466
34919,24,297,1044,201,4790,96
24357,21,507,1254,387,34183,120
35589,15,238,1027,172,2749,66
53757,10,50,661,44,7217,6
40305,985,14811,925,10600,88710,4211
238,3675,223188,1563,153058,505542,70130
10626,1021,78434,1465,47827,343482,30607
68562,13,235,201,201,4195,34
51570,586,12208,728,9560,122632,2648
32423,28,500,1094,322,24804,178
61292,10,143,418,109,5598,34
20940,22,1284,1313,762,10888,522
55499,98,1158,604,1002,10635,156
53996,56432,1158374,653,615291,3208444,543083
64163,12,92,334,72,10009,20
31709,5,115,1105,74,6669,41
3625,74,1194,1534,734,14701,460
6288,52,1926,1502,1361,17503,565
11015,21,616,1462,386,44936,230
50474,823,32074,757,16834,95128,15240
55455,161,2845,605,2256,25537,589
39202,558,13160,939,10641,34104,2519
32148,258,4925,1099,3572,51257,1353
13135,77,4384,1439,2981,64180,1403
13306,466,18137,1437,13734,108429,4403
55940,13,275,592,203,10478,72
4700,144,3585,1521,2371,38164,1214
554,12,379,1560,286,36126,93
57568,273,3544,547,2917,80108,627
46939,2,111,835,87,5334,24
25848,43,1889,1222,1126,17318,763
24292,84,1736,1255,1069,15767,667
34497,49,943,1054,681,11712,262
32361,46,743,1095,399,9787,344
35593,13,214,1027,170,4651,44
12503,56,2400,1448,1521,66423,879
51921,136,2667,715,2035,26654,632
65499,13,375,297,311,14719,64
24528,2,133,1250,104,20498,29
981,3148,103747,1556,62749,594699,40998
49747,475,5328,776,4322,50146,1006
43593,764,14921,873,11734,69116,3187
37776,2,24,970,18,4798,6
4024,248,9038,1530,5454,56698,3584
18316,0,0,1359,0,6462,0
13508,89,4258,1434,1957,40935,2301
45079,124,1386,857,1036,18202,350
35807,32,631,1023,540,21263,91
22001,67,2078,1295,1354,27711,724
59717,148,1628,472,1407,21297,221
25660,11,469,1225,268,8310,201
55779,46,433,596,309,15846,124
67037,25,315,251,245,5464,70
67689,17,291,230,204,5223,87
28707,12,455,1160,284,21416,171
38229,140,3147,958,2699,47899,448
25890,58,710,1220,516,14112,194
1465,16,890,1553,632,21821,258
65557,27,309,296,255,6074,54
66569,7,257,266,175,2581,82
69682,23,166,165,137,3197,29
12996,24,1489,1441,913,36106,576
51908,3,48,719,38,3223,10
13524,81,3938,1434,2472,32529,1466
56869,11,109,564,94,4776,15
4337,22,1073,1526,771,33572,302
27498,105,2976,1185,1951,36522,1025
54038,46,633,652,481,21237,152
56125,10,122,586,90,7649,32
42404,2439,68113,891,44845,170569,23268
60478,4,33,449,23,1378,10
30044,42,750,1134,482,6848,268
46835,26,552,837,422,10187,130
23735,156,3136,1267,2619,33211,517
36924,30,381,994,285,8165,96
13383,8,244,1436,137,11566,107
26434,19,772,1208,501,15726,271
2672,9,362,1544,207,17544,155
19973,53,2109,1330,1450,26283,659
57383,30,488,551,377,16468,111
45702,1,73,851,53,3545,20
43305,32,517,877,362,7242,155
17184,76,1901,1379,1373,37727,528
11595,48,2114,1458,1329,19389,785
26739,13,302,1201,235,8384,67
9349,623,26678,1473,16673,102474,10005
34181,142,2604,1061,1760,20888,844
3431,55,1447,1536,980,17752,467
29221,10,234,1150,152,7931,82
21183,394,6160,1308,4512,31658,1648
2737,123,3242,1543,1907,23611,1335
10481,519,11302,1466,7864,30167,3438
18062,3,131,1363,90,7267,41
67351,9,62,241,47,2266,15
67255,10,276,244,217,2263,59
15127,17,340,1412,233,6216,107
23555,195,5474,1270,3628,48157,1846
21506,42,1157,1302,788,16256,369
12601,122,6408,1447,4184,52148,2224
13236,1467,60843,1438,39729,343821,21114
62129,26,185,391,164,7490,21
65181,35,381,302,329,5329,52
34498,7,132,1054,86,3422,46
55258,10,106,610,84,3994,22
2858,602,23542,1542,15494,151893,8048
19520,82,1679,1338,1356,15770,323
55783,669,6264,596,5062,27972,1202
31853,121,5001,1103,3418,37266,1583
21091,17,412,1310,302,10043,110
51771,151,1267,722,1047,20135,220
51376,110,1129,733,960,20760,169
66112,24,484,278,373,3956,111
4936,228,10169,1518,6394,74851,3775
8294,5,155,1478,94,10681,61
13309,43,709,1437,440,6732,269
55955,179,2482,591,1991,25372,491
41488,150,3686,906,3271,30268,415
33681,12,157,1071,108,5873,49
31368,406,8739,1110,6563,72829,2176
28934,43,1465,1156,991,23955,474
49153,0,206,793,163,8568,43
41852,1528,22959,899,20166,133022,2793
32570,57,677,1091,443,14281,234
22071,360,9051,1295,6243,55591,2808
11558,31,1006,1458,601,14371,405
33808,669,10216,1069,7155,36927,3061
1895,25,604,1550,447,13563,157
10497,96,3797,1466,2365,20161,1432
68836,2,26,192,23,2735,3
59834,17,116,472,89,5191,27
18162,6,355,1362,196,6676,159
67891,314,4889,224,3858,34405,1031
11961,0,0,1454,0,4236,0
32541,72,3441,1091,2269,39896,1172
50202,11,393,764,294,10165,99
3445,30,969,1536,763,12643,206
37852,3,100,968,75,5013,25
52386,6,98,703,83,7493,15
32014,17,556,1100,318,10704,238
69222,268,4339,179,3850,40021,489
22083,93,2179,1294,1619,32780,560
57260,377,11556,554,8635,39885,2921
64089,5,49,337,32,1244,17
49639,180,2117,779,1685,10381,432
35730,90,2540,933,1965,49214,575
49484,33,581,783,474,15229,107
67075,734,8448,249,6339,41661,2109
61011,10,98,429,77,1864,21
32030,114,2341,1100,1393,13863,948
28829,332,7221,1158,4610,60675,2611
45054,689,10025,857,7504,100135,2521
16088,7,91,1397,81,9145,10
9530,14,645,1472,400,8483,245
69581,29,617,168,513,10789,104
36215,128,2602,1012,1998,38507,604
49519,167,2467,782,2061,33790,406
31934,11,375,1102,244,10718,131
2356,33287,1241204,1546,663439,4178312,577765
32722,43,1405,1089,997,30034,408
68872,26,375,190,308,4740,67
15180,60,3276,1411,1984,73930,1292
12982,29,1165,1442,734,35490,431
38980,4,79,943,63,4795,16
44457,101,979,864,686,13342,293
68186,558,6617,215,5447,24452,1170
54307,22,436,642,353,8651,83
38698,38,584,946,430,13802,154
60936,16,145,431,112,3396,33
52362,11,149,704,135,8476,14
6581,6,262,1498,172,19247,90
1915,10,366,1550,272,17067,94
1367,703,33853,1554,19944,133390,13909
19905,703,22971,1331,13827,277698,9144
13108,5,273,1440,139,5569,134
50869,28,200,748,158,3464,42
8506,223,17473,1477,10618,97802,6855
45594,136,1967,851,1793,18633,174
3947,227,4508,1531,2896,45166,1612
34881,739,11929,1045,8488,77788,3441
17564,437,8140,1372,5915,43242,2225
36410,293,5397,1006,4244,41079,1153
54928,106,1279,619,1070,7844,209
69633,4,72,166,58,1172,14
50058,439,8587,767,6515,101940,2072
37918,36,411,967,331,5366,80
1838,3089,92451,1550,57445,187286,35006
31061,891,22261,1114,14947,109339,7314
56985,47,519,561,387,8163,132
59490,118,1554,484,1364,21570,190
55535,378,8801,603,6950,56742,1851
6214,23,636,1502,415,8797,221
13767,2,220,1431,123,7034,97
34214,9,274,1060,183,5833,91
13984,681,24141,1427,17510,229318,6631
52084,362,4515,713,3636,43036,879
67567,248,4254,234,3537,52906,717
40411,10,334,923,266,5723,68
63655,4,22,350,18,1991,4
57476,10,100,550,74,3797,26
40616,23,656,920,506,13362,150
6200,40,1347,1503,1072,22174,275
41213,65,1161,911,840,7352,321
59182,1,25,495,16,1748,9
34804,162,2388,1045,1786,46093,602
32867,30,1225,1086,752,11018,473
10908,162,9240,1463,5237,67110,4003
44757,5,122,861,89,4022,33
8997,147,4074,1475,2883,58486,1191
450,94,11903,1561,8310,53824,3593
19600,16,684,1336,482,13796,202
12663,29,1210,1446,697,37815,513
24619,1384,44227,1247,26765,278349,17462
12162,2,413,1452,200,37570,213
62334,5,37,385,31,2298,6
13802,68,3122,1430,2010,29993,1112
43537,22,407,874,310,8836,97
52079,13,126,713,105,5480,21
25312,57,2137,1232,1451,23732,686
52664,39,401,692,350,11293,51
16394,1910,58744,1392,36620,349424,22124
52700,12533,184628,691,146432,762412,38196
44197,2680,46543,867,36163,163673,10380
19586,64,1604,1336,1117,20730,487
1141,1,253,1555,180,18907,73
8851,30,1072,1475,656,34230,416
4469,38,1277,1524,830,19541,447
54352,12,211,641,160,7428,51
36203,44,1124,1012,937,42516,187
4482,936,48702,1524,31470,309447,17232
31362,172,2861,1110,1845,25929,1016
42572,32,852,889,648,17960,204
28463,166,15835,1165,9320,53276,6515
42474,12,206,890,173,16635,33
63338,6,59,359,41,6716,18
62844,3787,100518,371,72598,443141,27920
57490,36,488,544,377,6301,111
50049,2,41,768,38,2660,3
17488,1188,48274,1374,35744,427357,12530
41692,2988,61894,903,45154,174817,16740
31671,44,1367,1106,1112,14155,255
18610,0,0,1354,0,54974,0
29337,5,131,1148,84,8387,47
27600,64,1659,1182,1134,23995,525
760,53,3066,1558,2161,20784,905
31953,18,181,1101,125,16723,56
61389,2,33,416,29,3496,4
24458,83,1723,1251,1203,16812,520
38442,19,313,953,237,10957,76
2302,35,3039,1546,2083,33171,956
61764,127,2036,404,1731,22115,305
12053,582,14765,1453,9688,69122,5077
5135,0,112009,1515,65949,539997,46060
21247,159,4116,1307,2682,25172,1434
4721,52,1370,1521,1041,23814,329
5343,41,2268,1513,1390,14223,878
53053,288,3035,680,2446,58184,589
29459,114,8441,1146,5584,25827,2857
24537,340,18357,1249,12095,158894,6262
11208,74,3110,1461,1943,23493,1167
54246,1079,11609,644,9597,68518,2012
2025,205,6624,1549,3886,40020,2738
54430,13,260,638,160,7844,100
58908,17,173,503,132,4839,41
37010,249,4268,992,3718,45755,550
17750,47,1184,1369,952,28910,232
33202,126,3824,1080,2831,50067,993
38808,26,281,944,193,5026,88
62656,132,1357,376,1141,10386,216
12590,71,1845,1447,1213,11870,632
33950,52,830,1066,545,12348,285
27411,133,1368,1187,807,15025,561
49115,18,217,794,158,5787,59
6462,188,7723,1499,5624,51249,2099
33432,107,1946,1076,1439,16156,507
18255,534,12183,1360,8805,67258,3378
53016,111,1100,681,893,14951,207
68777,1,48,194,32,2772,16
12203,17,507,1452,330,10424,177
34296,17,302,1059,185,4212,117
57144,6,93,558,72,5557,21
31360,1176,20565,1110,14528,68316,6037
69901,20,302,157,248,10447,54
38469,24,633,952,515,25206,118
24200,75,1789,1257,1096,10813,693
34932,152,2053,1044,1412,12622,641
21552,2655,51984,1302,31771,220992,20213
65703,41,313,291,279,4798,34
58947,167,4534,501,3304,17640,1230
69063,6,126,184,92,3962,34
34453,11,155,1055,115,6319,40
9413,201,10967,1473,5826,71076,5141
1580,431,7528,1552,4881,31575,2647
1388,19,734,1554,533,15944,201
21211,721,19310,1307,12233,106360,7077
34205,61,816,1060,591,15500,225
36351,1005,20097,1008,16521,158246,3576
42850,24,795,883,523,15350,272
30636,3050,66206,1123,43394,124921,22812
13062,135,4217,1440,3048,58385,1169
67312,45,414,242,301,3580,113
22853,34,1045,1282,738,8590,307
38886,84,1948,944,1547,25856,401
17754,1077,52666,1369,35057,119009,17609
65874,20,655,287,563,11371,92
34820,497,9425,1046,7131,121585,2294
23726,142,2746,1267,2013,36506,733
8331,2337,51008,1478,31528,200871,19480
62087,30,334,393,238,4948,96
16416,41,1074,1392,729,31485,345
31477,876,12799,1109,8148,80398,4651
63965,23,415,341,334,9599,81
40537,149,1648,921,1261,15295,387
12161,541,12696,1452,8018,83034,4678
27021,10,396,1195,235,9835,161
20409,29,1120,1322,785,13224,335
62521,30,492,380,393,5684,99
39314,297,3762,938,3017,23824,745
27002,31,852,1195,483,12315,369
25104,72,1611,1237,1146,22173,465
70629,15,169,132,162,2456,7
9488,133,3288,1473,2030,32864,1258
10156,25,972,1469,596,5525,376
20890,11,280,1314,214,7164,66
41802,33,648,901,487,7682,161
26979,51,1059,1196,670,9101,389
19867,121,2914,1331,2115,35524,799
21031,16,421,1311,296,11725,125
60454,462,5984,450,5046,50465,938
21504,40,504,1302,331,10318,173
67348,7,89,241,72,2319,17
3492,164,5711,1536,4000,74445,1711
56037,4363,86443,589,66403,332382,20040
12374,13,457,1450,216,5282,241
7583,8486,223900,1485,126870,738170,97030
70312,9,56,144,53,1927,3
36468,2,58,999,46,6776,12
64396,6,154,327,111,2567,43
29484,17,228,1146,206,6963,22
55417,27,217,606,158,3749,59
33822,437,7727,1068,5782,73159,1945
48342,55,868,817,696,10343,172
13184,385,28133,1439,17092,88074,11041
45235,2512,53718,856,40219,311762,13499
17484,16,322,1374,251,11692,71
35799,0,53,1023,35,3991,18
12207,12,625,1452,301,16546,324
38322,6,160,956,132,5062,28
32887,12,428,1086,305,22852,123
9695,40,2762,1471,1725,18501,1037
19564,12,475,1337,357,32204,118
50292,317,3901,762,3171,26335,730
55982,425,6607,590,5492,70488,1115
21066,92,1173,1310,784,22324,389
13558,246,8716,1433,5588,63123,3128
49241,218,5358,789,4249,30685,1109
13333,3,192,1437,128,11145,64
5728,9,287,1508,195,13956,92
64422,4,48,327,36,2639,12
30912,0,52,1117,33,3923,19
17724,55,5376,1369,3369,33558,2007
66131,6,86,280,66,3530,20
24681,156,3089,1246,1786,11415,1303
16978,22,541,1383,351,20922,190
14462,5,143,1420,105,3015,38
1406,27,1165,1553,850,33538,315
11263,165,3128,1461,2108,30405,1020
65068,3,33,306,23,3239,10
1074,178,12517,1556,8761,119304,3756
52801,59,777,684,611,7681,166
28815,18,577,1159,337,6069,240
32523,587,15542,1092,9511,39291,6031
12284,0,0,1451,0,6469,0
56797,177,1921,567,1524,15854,397
23900,169,3720,1264,2299,44937,1421
51052,256,2122,742,1602,35442,520
28663,17,373,1161,236,10922,137
14912,106,3604,1415,2507,53647,1097
32394,2296,45852,1095,31694,146399,14158
26540,835,28806,1206,20063,124739,8743
13316,65,4232,1437,2206,36583,2026
68267,164,4191,212,3739,36424,452
4849,108,2297,1519,1344,14285,953
68497,234,6881,204,5990,34526,891
64456,7,68,325,59,2808,9
5320,12,571,1513,368,21986,203
16972,104,8992,1383,7453,123813,1539
10966,15,843,1463,507,10817,336
15082,5,89,1413,64,12165,25
11046,193,13695,1462,8577,85398,5118
50453,9,83,758,64,4024,19
31195,543,10066,1113,7290,29489,2776
15141,245,7469,1412,5138,36051,2331
60451,34,1229,450,829,12231,400
24300,7,318,1255,223,12043,95
47733,181,2514,825,1899,13916,615
22458,24,459,1289,371,23750,88
63862,14,207,345,156,5427,51
62886,286,4359,370,3238,25425,1121
27574,3903,92300,1182,68838,229833,23462
46819,0,114,837,77,5026,37
35101,46,1416,1039,1113,28802,303
32295,21,253,1085,193,8209,60
12824,55,1034,1444,577,16361,457
47640,5,93,826,70,9432,23
12798,16242,810016,1444,422863,1668317,387153
66084,71,797,282,613,11980,184
15151,27,1848,1412,1269,24717,579
20998,12,567,1312,406,12693,161
42624,55,1045,887,854,26609,191
69229,2,40,179,34,3494,6
63311,29,176,360,141,4064,35
40670,177,3294,920,2531,19034,763
35639,36,689,1027,503,7739,186
14616,344,10347,1419,7256,92801,3091
3764,5,171,1533,119,15427,52
18373,73,2774,1358,1807,73691,967
53275,41,288,674,234,4030,54
22281,33,731,1292,509,11097,222
60979,40,805,430,621,6333,184
3009,14,385,1540,267,7488,118
57391,304,3036,551,2547,17348,489
61195,9,72,422,57,5126,15
30480,46,1177,1125,736,6699,441
5947,71,2768,1506,1822,26867,946
37953,46,459,966,401,6090,58
24003,72,3393,1262,2153,51628,1240
1955,88,3129,1549,2249,41006,880
50,42,1378,1566,984,45801,394
23044,235,4470,1279,3136,32094,1334
13908,13,679,1429,388,14650,291
67297,162,2890,242,2470,20004,420
20705,33,1083,1317,803,13129,280
4839,5,104,1519,70,3942,34
69721,8,98,163,86,2613,12
16006,128,2401,1399,1366,22006,1035
63865,4,41,344,34,1980,7
10415,6,364,1467,238,7461,126
31614,123,3670,1107,2465,19013,1205
46295,8,153,844,118,6701,35
41902,503,5951,899,5046,51382,905
31745,85,1530,1091,1011,26086,519
25865,102,2169,1221,1401,36726,768
38255,25,304,958,265,6096,39
37259,99,1993,984,1419,24764,574
12970,30,1078,1442,563,15719,515
4211,308,11698,1528,8092,102619,3606
33445,38,887,1075,554,12622,333
13993,534,21422,1427,12438,193676,8984
69734,0,9,163,7,2351,2
30632,16,433,1123,293,7422,140
9541,1411,31012,1472,20078,207794,10934
31872,6,222,1102,160,5103,62
66408,1155,31838,272,25736,148522,6102
60452,218,2185,450,1728,16545,457
31388,237,5433,1110,3646,40317,1787
56138,0,20,586,16,2906,4
3727,127,5718,1533,3691,48228,2027
18266,157,3394,1360,2290,19797,1104
57210,21,243,556,197,9771,46
25967,41,2795,1218,1439,24661,1356
11582,554,21090,1458,13297,98544,7793
17269,12,304,1378,249,24754,55
31125,5,42,1114,25,1254,17
49372,31,529,786,371,6693,158
67840,6,77,225,63,4288,14
11727,411,24927,1457,13285,117949,11642
2986,117,3596,1540,2553,38534,1043
5216,9,168,1514,132,12694,36
21258,20,1023,1307,688,13170,335
46081,381,5832,838,4465,47146,1367
60338,23,170,454,117,2644,53
56895,24,319,564,241,4190,78
12554,10,780,1447,427,9019,353
23060,35,437,1278,360,17146,77
51499,57,599,730,515,10447,84
14203,7,225,1424,160,6347,65
51993,59,810,716,633,10571,177
30274,9,377,1130,245,11563,132
40410,216,3288,923,2137,14942,1151
67679,26,459,231,357,6990,102
9677,15,540,1472,331,33034,209
15052,6255,137713,1413,88612,499315,49101
69504,23,532,170,429,8782,103
67526,17,71,236,65,1803,6
22310,7,384,1292,276,18785,108
8890,117,3087,1475,1840,34174,1247
1269,2892,151381,1554,85312,719749,66069
30947,19948,464987,1117,263407,881285,201580
38636,190,2113,948,1767,23379,346
62103,34,257,392,226,7997,31
17894,73,1958,1366,1231,15649,727
35725,33,313,1025,256,8560,57
10277,10087,476592,1468,268096,2019152,208496
8573,67,2071,1477,1360,16725,711
52888,357,4840,685,3766,33773,1074
21528,37,2644,1302,1701,22257,943
24404,30,1396,1252,931,50426,465
40140,2,57,927,33,4707,24
27330,14,428,1188,259,19367,169
20721,2453,73819,1317,52798,491990,21021
64030,59,366,339,310,5071,56
43905,33,943,871,672,53038,271
35426,0,1,1031,0,10845,1
23758,3,78,1266,62,9333,16
40976,6,72,914,59,8036,13
26316,244,11252,1211,7726,61535,3526
48152,23,322,820,232,8897,90
36279,151,1960,1010,1599,14515,361
57991,110,1022,534,821,21991,201
8686,56,1842,1476,1148,12720,694
54498,1352,29402,635,24213,131995,5189
18707,51,1210,1352,829,17468,381
52843,13,166,686,125,6505,41
22749,66,1561,1284,1240,26156,321
7284,5,257,1488,155,31739,102
8405,44,1588,1477,976,22870,612
23291,79,4578,1275,2813,35489,1765
18524,18,529,1355,384,8308,145
34469,512,9318,1055,5669,47755,3649
31335,14,389,1110,252,20714,137
66406,4,56,272,47,2601,9
31206,282,6828,1112,5195,74660,1633
5495,338,16081,1511,10247,133528,5834
53998,11,180,653,134,6260,46
67877,6,109,224,74,2413,35
61776,965,19068,389,13609,106403,5459
38053,14646,357331,963,264638,1344069,92693
65018,44,295,308,247,3883,48
22833,26,1157,1282,880,20098,277
58895,96,831,504,621,7525,210
57140,96,1075,558,890,14971,185
66768,18,413,260,368,3053,45
32386,794,14438,1095,10259,66170,4179
21759,115,1934,1299,1271,14421,663
34527,202,4509,1054,3108,28839,1401
9776,367,13912,1471,9145,64026,4767
37528,281,2571,977,1876,31344,695
12567,143,2666,1447,1508,11660,1158
25818,12,573,1222,362,9662,211
4119,36,1646,1529,1104,52975,542
38845,16,273,944,234,9701,39
2722,10,313,1543,177,11156,136
37588,275,6883,975,5143,43707,1740
11571,0,0,1458,0,8792,0
14976,8878,191430,1414,120552,504969,70878
48615,18,355,809,305,19610,50
38234,253,6239,958,5276,32470,963
59557,53,394,482,322,5511,72
64485,71,972,325,752,8685,220
68761,9,145,195,108,4386,37
58906,20,262,503,211,6593,51
32155,5294,90709,1098,59349,313684,31360
63984,109,1619,340,1345,11000,274
52150,115,1175,711,951,22403,224
50873,201,2053,748,1633,15836,420
67401,28,654,239,499,14566,155
31685,3551,84353,1105,49495,247678,34858
44916,2362,36855,859,28680,108466,8175
3170,12,345,1539,204,11411,141
19566,7,805,1337,570,9243,235
37097,27,346,989,262,8434,84
8234,1097,60674,1478,39622,234475,21052
27767,6,127,1179,84,2367,43
62328,2474,27826,385,20347,87276,7479
61013,6300,162903,427,115569,617744,47334
54948,7,158,619,101,6015,57
31138,9,242,1114,141,3949,101
23924,386,7137,1263,4829,58055,2308
34194,36,877,1061,618,16667,259
20861,1208,18106,1314,10732,76811,7374
65269,51,816,302,645,10420,171
771,21,324,1558,246,12998,78
45369,59,2023,854,1602,23646,421
35080,334,2899,1040,2172,27088,727
16665,264,8248,1389,5778,82844,2470
12397,36,1203,1449,693,9526,510
64191,53,839,334,640,12495,199
32211,182,3579,1097,2218,22421,1361
12229,29,1550,1452,871,12819,679
63600,15,160,352,124,4981,36
44481,34,610,864,488,18809,122
26375,55,1962,1210,1272,20436,690
18385,11,275,1357,196,9305,79
54014,157,1545,652,1301,24897,244
6651,21,1018,1497,696,45657,322
14552,13,424,1419,313,10869,111
24,462,21654,1567,12578,161286,9076
32254,47,1086,1097,858,29215,228
61454,9,66,414,51,6644,15
4615,2,156,1522,110,10081,46
19277,70,1413,1342,992,19083,421
53623,0,0,665,0,6830,0
14745,46,962,1417,768,24684,194
55969,58,1397,581,949,34351,448
54964,304,3967,618,2714,17783,1253
37356,28,364,981,288,7175,76
14527,4,168,1419,99,20561,69
41494,7,281,906,201,13733,80
34815,227,3206,1046,2227,17402,979
24525,93,2016,1250,1195,22293,821
8565,4556,171951,1477,111476,304983,60475
3381,80,1925,1537,1255,17594,670
17419,18,451,1376,320,10964,131
18340,5185,88178,1359,58855,335706,29323
51013,3,99,744,74,3208,25
50709,14,85,752,70,3507,15
10003,911,19546,1469,14271,86805,5275
14548,0,0,1419,0,11743,0
8887,13,873,1475,547,31320,326
28557,91,2708,1163,1664,27281,1044
64784,4,92,316,75,1957,17
13643,1483,33635,1432,22372,182786,11263
54479,3559,44125,636,34964,222784,9161
67233,355,5873,245,4969,47777,904
14445,14,1703,1420,1140,15388,563
28837,15,490,1158,323,10098,167
38051,45,567,963,503,26912,64
56579,5,81,573,62,6213,19
37984,11,490,965,403,7534,87
701,48,2919,1559,1992,49186,927
24748,151,3837,1244,2554,31134,1283
57375,10,75,552,48,3791,27
12031,44,1092,1453,613,10674,479
4289,944,16350,1527,12332,92773,4018
30217,167,6918,1131,4658,42450,2260
65454,45,314,298,249,2182,65
7498,67,1839,1486,1306,37413,533
57996,2,29,533,24,3870,5
61351,9,102,417,86,3455,16
36840,30,588,997,443,7840,145
27919,52,1741,1175,1145,30085,596
22470,13,1650,1289,1193,36050,457
26093,7,641,1216,331,9782,310
36998,5,91,992,79,5515,12
49714,66,421,777,358,15683,63
54727,18,183,627,111,3725,72
68900,109,1455,190,1333,20191,122
30728,163,5173,1121,3610,35706,1563
69903,39,278,157,243,4347,35
28838,13,426,1158,296,5301,130
15881,16,639,1401,517,15691,122
9638,92,1938,1472,1237,25864,701
24543,4060,116456,1249,81239,650806,35217
21939,139,2077,1296,1382,19839,695
24145,182,3698,1258,2641,39232,1057
31512,158,3167,1108,2179,42240,988
64810,50,720,315,569,16583,151
39154,39,570,940,438,7154,132
34522,115,3952,1054,2670,39027,1282
3424,1117,77932,1536,44388,199165,33544
59802,96,1502,473,1340,13682,162
18280,20,582,1359,386,25607,196
18101,5,290,1362,238,11275,52
64941,4884,70715,311,55996,233346,14719
15516,22,599,1406,400,13261,199
53504,15,264,669,201,3872,63
52684,15,131,691,102,8833,29
45540,164,973,852,722,10561,251
18726,145,5109,1352,3499,76939,1610
63343,11,134,359,102,3884,32
56261,38,519,582,438,17643,81
36954,608,10869,994,7843,60735,3026
52775,8,80,689,58,6353,22
23048,52,1943,1279,1474,26573,469
20751,1054,28218,1316,19298,162464,8920
70665,0,0,131,0,1552,0
11025,1290,15160,1462,9965,46323,5195
54606,120,1086,631,776,6431,310
13870,36,1363,1429,824,13250,539
14907,1,0,1415,0,14352,0
61095,1,33,425,27,3104,6
51874,110,915,720,767,12630,148
25024,580,15099,1238,9588,109278,5511
15501,3555,133807,1407,92891,313464,40916
56758,2577,63106,568,46496,300492,16610
2086,22,1034,1548,784,53408,250
33433,27,364,1076,260,5705,104
69136,15,281,181,231,4702,50
18136,8,513,1362,392,34301,121
58725,31,443,509,321,11423,122
50942,33,411,745,328,10253,83
4251,27,488,1527,365,10352,123
54089,53,749,650,559,34593,190
54350,362,3459,641,2828,66632,631
11672,5,559,1457,246,14023,313
18347,7,419,1358,289,10980,130
64308,97,2353,330,1795,11643,558
5608,20,539,1510,384,8916,155
7064,16,413,1491,291,10224,122
2976,185,9452,1540,6838,93059,2614
54315,19,340,642,238,6571,102
21228,4190,111180,1307,73049,708997,38131
17138,61,3852,1380,2135,16633,1717
66073,234,6484,282,5174,39024,1310
58999,58,598,500,486,8150,112
14511,5,348,1420,243,11405,105
67269,20,610,244,341,9315,269
30482,22,299,1125,193,9273,106
55222,33,515,611,383,3860,132
44016,16,310,869,222,8947,88
63915,76,869,343,676,22675,193
27009,16,688,1195,425,15740,263
5300,98,3510,1513,2465,68132,1045
35776,816,14925,1024,12081,114841,2844
2179,1003,27317,1547,18155,183466,9162
64733,28,222,317,170,4589,52
16624,12,517,1389,378,12528,139
33589,118,2355,1072,1625,87739,730
34061,565,18645,1063,11968,139510,6677
37372,1248,16074,981,12803,150477,3271
15449,242,7261,1408,4626,55235,2635
52971,111,2963,683,2370,28717,593
15061,13,614,1413,447,37482,167
6210,21,754,1502,505,19454,249
62869,47,374,371,331,5171,43
29449,32,1000,1146,599,28441,401
43099,19,420,880,353,11158,67
22070,43,1883,1295,1357,25091,526
20817,5,122,1315,92,5211,30
63584,9,87,353,66,2444,21
57387,8,235,551,168,3788,67
4104,173,2799,1529,2181,26828,618
19745,50,2412,1334,1437,10420,975
62898,5,128,370,112,2174,16
19362,751,10165,1340,8133,130346,2032
3984,7,296,1530,209,36613,87
25669,90,1688,1225,1089,8749,599
2835,135,4543,1542,3174,38359,1369
15940,139,3511,1400,2322,41169,1189
34981,4358,81874,1042,50478,259576,31396
38289,5,164,957,126,9209,38
15515,180,5061,1406,3479,57917,1582
52216,332,2486,709,2073,24953,413
19725,12,822,1334,589,26407,233
32735,100,1518,1088,1084,20078,434
5931,9,268,1506,188,21567,80
44291,133,1519,865,1167,22549,352
70122,28,345,150,323,5451,22
70112,18,106,150,95,3628,11
26529,3,206,1206,130,6156,76
67443,4,101,238,76,3332,25
55205,40,617,612,454,13738,163
64514,55,689,324,559,7464,130
20813,62,1755,1315,1209,21978,546
56933,131,1449,563,1033,17502,416
21019,9,490,1311,402,18925,88
14695,149,3116,1418,2195,51611,921
24736,1343,34649,1245,23964,147707,10685
63922,268,4598,342,3988,36504,610
3452,41,1495,1536,1047,27737,448
39858,51,1098,932,930,12909,168
22560,15,430,1288,306,11165,124
67034,356,6251,251,5055,50025,1196
57634,24,256,545,182,3472,74
2223,318,11260,1547,7487,98527,3773
61932,17,243,398,194,6296,49
27736,187,5464,1179,3595,15617,1869
25288,19,539,1233,357,14946,182
7352,4,110,1488,83,11655,27
67227,60,1611,243,1302,11775,309
65812,35,505,289,411,21095,94
11619,5,424,1457,194,6894,230
14968,65,1298,1414,992,43924,306
10896,62,1374,1463,857,13122,517
28729,63,2570,1160,1564,20010,1006
14044,7,439,1426,277,6673,162
31681,40,1109,1105,836,18505,273
10247,8,246,1468,174,8480,72
29782,12665,405782,1140,279268,962132,126514
13717,85,2096,1431,1355,11475,741
28791,14,281,1159,172,7630,109
65179,16,478,304,397,10961,81
55262,1,20,610,18,3439,2
4086,1438,20087,1529,15315,149134,4772
61781,47,1055,403,766,11454,289
49838,0,8,774,4,1717,4
29902,13,346,1137,220,26112,126
48476,75,1329,814,1001,16018,328
38483,15,269,952,211,6269,58
67123,72,799,249,633,9382,166
7822,58,1545,1481,984,36409,561
12929,231,7665,1443,4735,41873,2930
62462,8,113,382,76,3891,37
53400,61,735,671,557,8204,178
66541,12,138,268,122,1358,16
50330,6,90,761,70,5811,20
50111,81,1061,766,841,14010,220
66085,39,620,282,447,4209,173
68253,9,151,213,111,5767,40
11627,1,200,1457,123,6825,77
37345,73,883,982,612,18274,271
18841,9,184,1349,132,15031,52
51619,118,1785,727,1370,17016,415
28915,45,1110,1156,696,10140,414
5070,108,2373,1516,1695,17133,678
57750,23,172,542,142,2425,30
32963,55,1213,1084,715,20133,498
63804,1,27,347,21,3599,6
33962,16,316,1066,201,11536,115
56953,31,415,562,334,6607,81
26506,111,2131,1207,1385,14784,746
30122,44,1582,1133,1023,15380,559
4933,10,311,1518,228,13586,83
11821,267,7034,1456,3666,28496,3368
1698,7,178,1551,132,16578,46
9571,3064,151306,1472,73911,282133,77395
60392,54,691,452,542,10623,149
2754,51,1791,1543,1275,47110,516
58312,12,345,523,271,6869,74
67008,203,3496,252,2906,34603,590
18229,6,315,1360,222,9664,93
26708,129,3561,1202,2098,23414,1463
15727,14,779,1403,558,37584,221
53151,20,356,677,259,7608,97
13123,0,82,1440,30,3765,52
55394,172,3934,606,2988,25184,946
25970,257,10927,1218,7210,61983,3717
29073,3,104,1153,61,4110,43
20331,14,441,1323,329,5543,112
17102,2,105,1381,83,24672,22
20344,48,1251,1323,956,28535,295
40944,3170,57608,914,36366,124268,21242
54540,2321,32928,632,27040,120612,5888
896,171,2966,1557,1869,22297,1097
53033,4,500,681,360,13084,140
32470,4,113,1093,79,17709,34
57689,46,959,543,769,14126,190
53217,33,360,675,264,11700,96
1751,68,1033,1551,705,8580,328
21011,20,358,1311,239,3875,119
20187,61,2085,1326,1477,30617,608
12823,50,1891,1444,884,17493,1007
52357,19,359,704,297,16088,62
49608,344,5395,780,4242,60468,1153
29097,8,91,1153,66,4729,25
20848,36,541,1315,399,9540,142
28984,142,6394,1155,4044,45289,2350
36878,38,729,996,580,11216,149
16918,27,1000,1384,702,37683,298
20279,53,2087,1324,1180,15817,907
22323,141,1637,1291,1103,10377,534
49476,40,1102,783,726,21210,376
19119,27,767,1344,598,29289,169
4471,480,52132,1524,31010,161285,21122
14052,31,2072,1426,1335,34658,737
25340,5,272,1232,179,24204,93
7138,9,610,1490,383,31430,227
69678,13,152,165,128,2423,24
2961,16,322,1541,219,19012,103
9334,142,5105,1473,3327,57693,1778
26167,10,481,1215,261,6289,220
11907,184,5426,1455,3069,18531,2357
70145,1,21,149,13,1214,8
18362,7,232,1358,187,6893,45
27395,1351,45525,1187,28372,122430,17153
18868,19,1178,1349,741,11482,437
36141,22,983,1013,773,50511,210
70089,5,124,151,88,3141,36
5311,278,5038,1513,3483,54519,1555
33809,34,868,1069,654,16890,214
26345,729,14194,1210,9037,60289,5157
62165,20,214,390,164,5515,50
65504,39,349,297,261,5632,88
30672,10,411,1122,242,8797,169
14721,65,1063,1417,732,12989,331
38042,199,5985,961,4955,52359,1030
66540,33,615,268,514,6567,101
3139,10,610,1539,383,18493,227
4305,16,1005,1527,676,58498,329
18626,146,5757,1353,4541,103133,1216
37178,15,396,987,295,11371,101
61697,52,1039,405,845,11336,194
66197,11,328,277,258,9699,70
57469,93,1787,550,1493,14833,294
69290,258,3935,170,3205,33179,730
66729,171,3508,262,2865,25545,643
66826,47,667,258,570,18312,97
31593,636,10392,1107,6830,57301,3562
3846,72,1527,1532,1082,41407,445
65347,205,2853,300,2196,28304,657
59402,25,327,487,259,10466,68
1010,2704,93922,1556,57283,244430,36639
12689,734,16406,1446,10058,111858,6348
826,5,136,1558,83,15244,53
11364,28,489,1460,283,11100,206
15087,78,1935,1413,1440,16600,495
20421,5,539,1322,394,8837,145
63491,31,315,355,250,8569,65
9167,189,5398,1474,3434,35534,1964
66999,7,178,252,119,4087,59
9323,1321,42808,1473,23608,174242,19200
29728,141,3209,1141,1833,26715,1376
10145,8,240,1469,169,43457,71
4273,86,8751,1527,4880,38042,3871
32921,524,7164,1085,5345,63691,1819
55145,15,164,613,96,4171,68
32411,1785,43735,1021,34149,261511,9586
21794,3,125,1298,90,4798,35
51456,658,6604,732,5177,45206,1427
65242,5981,92500,303,71596,541185,20904
22453,116,4800,1289,3034,38531,1766
60587,18,251,445,194,3975,57
28390,1145,37333,1166,24205,161661,13128
11006,25,1489,1462,896,16042,593
56608,0,17,572,11,3161,6
61076,61,953,426,819,14016,134
22339,67,1714,1291,1060,31325,654
8486,329,19305,1477,11687,118591,7618
32360,61,3362,1095,1926,20928,1436
61477,75,1197,413,950,8173,247
7375,111,3573,1487,2490,47728,1083
15787,10,407,1403,290,13137,117
6834,12,254,1495,174,16109,80
42650,240,2345,887,1806,38352,539
30200,1334,29997,1131,20842,185256,9155
32147,4,156,1099,102,14666,54
18582,13,324,1354,250,12480,74
53332,29,409,673,315,5244,94
8264,46,2002,1478,1368,16669,634
6110,12,472,1504,321,17669,151
41358,18,487,908,368,8240,119
68840,13,139,192,119,3137,20
29096,6,601,1153,401,7176,200
10104,5,453,1469,198,20623,255
4968,21,2447,1517,1702,27969,745
8779,312,16166,1476,10208,76790,5958
4417,615,10831,1525,7154,45650,3677
50256,78,1009,763,839,15223,170
46067,4233,138014,846,99257,234189,38757
4514,1857,143966,1524,92946,675379,51020
34984,22,631,1042,404,7177,227
46365,21,349,843,255,7885,94
67471,24,609,237,488,16203,121
33290,47,1481,1078,860,15701,621
17238,4,87,1379,65,6071,22
1444,21,545,1553,369,24008,176
23527,57,2406,1271,1621,20332,785
35959,0,0,1019,0,3800,0
23787,78,1831,1266,1211,30621,620
63705,8,85,349,54,2328,31
33797,22,419,1069,347,4662,72
20879,26,1213,1314,783,16154,430
19352,10,260,1341,195,22602,65
53164,147,1582,676,1196,11866,386
35113,32,424,1039,288,14240,136
69245,4,101,178,87,5534,14
29957,5,239,1136,150,11821,89
15658,3439,140366,1404,83514,588025,56852
48813,12,233,803,164,10023,69
9582,57,2157,1472,1362,33209,795
17349,99,2460,1377,1823,38938,637
67550,13,169,235,147,4844,22
38376,410,10524,955,7733,83678,2791
25601,0,113,1227,78,8686,35
16786,67,1501,1386,1012,39460,489
13583,31,1215,1433,694,16204,521
51153,9,87,739,64,3770,23
53203,11,140,675,73,3378,67
61101,325,7453,425,6254,67010,1199
65216,1226,28354,304,22607,93481,5747
46823,340,4438,837,3502,67986,936
1029,5,257,1556,196,13053,61
38331,536,8652,956,6865,89021,1787
20546,36,1099,1320,768,51216,331
10161,9,718,1469,403,16273,315
66616,7,90,265,69,3714,21
22120,35,687,1294,515,14841,172
19129,23,739,1344,570,13286,169
3292,41,609,1537,472,10375,137
51251,3,41,736,32,3489,9
39211,220,4167,940,2451,54625,1716
15855,521,12209,1401,8494,142137,3715
7791,97,1565,1482,967,13562,598
53100,2685,82606,678,59805,470573,22801
67127,389,10484,248,8436,73086,2048
23379,6,344,1273,230,20580,114
61984,2,40,397,34,2041,6
41504,146,2602,906,2225,43768,377
16296,104,5341,1394,3112,32233,2229
43621,46,502,873,384,7731,118
40937,583,7562,915,5339,28087,2223
70022,35,412,153,379,5358,33
38501,14,336,951,235,5895,101
41060,24,449,912,374,7592,75
51732,2,135,724,53,3762,82
49356,246,3985,786,3406,51098,579
62185,140,2329,389,1795,10144,534
32158,20,429,1098,392,7957,37
13230,3360,89353,1438,59351,586034,30002
12887,67,1528,1443,980,85100,548
14481,46,1058,1420,876,52389,182
34606,1,71,1052,46,3676,25
49335,9,83,787,73,1903,10
31015,1,47,1115,37,5760,10
34129,103,2484,1062,1751,22566,733
23096,1,117,1278,76,7051,41
62340,304,3672,385,2843,27983,829
6957,30,1070,1493,770,29542,300
33214,252,7733,1080,5574,82896,2159
53582,8,100,667,82,4907,18
34444,299,4531,1055,3484,29510,1047
66771,157,1884,260,1613,8444,271
69100,31,589,183,474,9170,115
37644,86,1263,974,1009,21881,254
6966,5,251,1493,167,13176,84
19614,199,1804,1336,1123,20835,681
40393,20,734,923,521,15331,213
37525,11,268,977,204,11689,64
7145,2,150,1490,101,23237,49
22624,2698,57867,1286,32531,139632,25336
37166,98,1502,987,1275,34538,227
13257,2,623,1438,270,12383,353
63816,11,169,346,125,2187,44
49645,6,161,779,146,9052,15
45309,140,4063,855,2809,37737,1254
38366,91,1126,955,873,13638,253
23333,28,1238,1274,804,18048,434
28664,123,11345,1161,6644,35080,4701
54250,65,611,644,520,30248,91
18404,6,337,1357,224,7173,113
57061,13,153,559,115,10763,38
44846,27,731,860,522,13379,209
37197,18,302,986,257,11862,45
16221,80,2900,1395,1875,23095,1025
1256,28,1067,1554,795,17481,272
2042,524,21941,1549,13118,160247,8823
52866,46,399,685,290,5306,109
11981,1081,45831,1454,28400,198739,17431
52958,33,416,683,298,4913,118
9126,41,1410,1474,884,34341,526
66094,10,132,281,116,12743,16
30114,0,0,1133,0,4915,0
4723,205,6887,1521,4789,57531,2098
29920,10,228,1137,153,11249,75
19991,40,1337,1329,1021,19220,316
53849,11,106,658,80,7093,26
56517,128,2707,570,1964,21041,743
9106,4,146,1474,98,6840,48
51256,390,4248,730,3344,29713,904
1390,26,847,1554,622,24041,225
23323,185,6224,1275,3876,44621,2348
14694,23,670,1418,442,5994,228
11111,65,2054,1462,1117,16333,937
19782,25,300,1333,207,10847,93
30204,68,2343,1131,1381,15098,962
45018,64,769,858,572,19169,197
8099,208,4460,1478,3193,26353,1267
49399,25,351,785,313,6399,38
57248,8,42,555,33,3032,9
28927,19,620,1156,466,12760,154
17177,410,10485,1380,6937,87642,3548
57107,22,236,558,134,4862,102
54958,0,0,619,0,9126,0
31083,130757,2790503,1114,2068426,4545281,722077
9675,59,1760,1472,1256,22625,504
557,8,536,1560,374,22008,162
38379,12,291,955,214,10921,77
41864,91,1350,899,1038,13005,312
39504,14,247,935,221,7303,26
30478,30,443,1125,306,5462,137
15126,15,763,1412,519,17677,244
34845,31,412,1046,291,4773,121
6458,70,2625,1499,1683,30368,942
16097,486,13553,1397,8553,104186,5000
37922,22,213,967,169,63799,44
30826,22,274,1119,195,7930,79
56144,14,178,585,136,7005,42
52220,0,20,708,16,3297,4
62970,2,19,368,16,3466,3
49167,582,11300,792,8699,73338,2601
28685,12895,281419,1161,171182,1076348,110237
4384,66,1802,1525,1236,24115,566
42930,27,481,882,374,8985,107
63204,18,330,362,249,8407,81
61826,3416,105690,402,72428,516679,33262
15066,16,1049,1413,711,47921,338
28105,7,186,1172,156,4484,30
57134,62,563,558,443,6019,120
14549,91,2570,1419,1812,17501,758
25452,84,3318,1230,2179,13419,1139
28457,206,5118,1165,3340,42023,1778
65022,473,1414,308,1213,67486,201
1520,92,2173,1553,1303,55929,870
67617,7,70,233,60,3111,10
9859,106,2702,1470,1616,19429,1086
7115,32,1229,1491,811,34058,418
295,124,8717,1562,5603,177040,3114
14152,15123,1073301,1425,611129,1991636,462172
9270,1,172,1474,100,5650,72
30341,81,1980,1128,1336,46015,644
14614,291,8392,1419,5575,117216,2817
57174,11,232,557,154,2463,78
68654,44,598,198,507,9601,91
994,313,19170,1556,13663,61341,5507
60436,81,1120,451,782,21897,338
19080,0,0,1345,0,9072,0
5699,42,1081,1509,742,26224,339
40951,96,1356,914,1075,12019,281
3409,40,2598,1536,1783,23510,815
22730,863,23024,1284,15267,122368,7757
15447,8,220,1408,144,15870,76
5269,59,973,1513,686,21606,287
32682,37,984,1090,614,9233,370
58938,333,9373,502,5941,27600,3432
69765,1,26,161,23,1790,3
10635,38,1218,1465,765,26916,453
49037,29,339,796,261,7165,78
36149,1,104,1014,77,9129,27
25950,188,4760,1219,2993,44822,1767
55174,25,212,613,167,3293,45
49917,8,161,771,137,4437,24
64210,87,2043,333,1260,28864,783
53106,53,833,678,664,10740,169
22368,5245,144040,1291,100297,559494,43743
69801,24,273,160,222,4459,51
27851,13,393,1177,217,11045,176
37497,34,875,978,750,39241,125
64377,269,3464,328,2795,47037,669
28661,20,758,1161,490,16609,268
5816,3131,86003,1507,49835,281022,36168
63599,20,344,352,263,10043,81
21555,19,563,1302,395,8760,168
12197,182,8284,1452,5009,43340,3275
31129,23,278,1114,168,6296,110
67896,30,662,224,530,13542,132
23359,39,866,1274,558,11129,308
18651,654,24931,1353,15904,147313,9027
32490,45,1911,1092,1245,27828,666
22570,6,189,1287,148,6134,41
20594,48,672,1319,507,9664,165
36528,49,884,1002,745,21052,139
69357,125,1526,175,1378,16348,148
6352,20,788,1501,523,26158,265
21918,3207,83918,1296,58319,504305,25599
3622,82,2539,1534,1756,62934,783
45780,154,2205,850,1699,21699,506
19670,40,902,1335,670,23004,232
61035,11212,213186,427,152627,735269,60559
18249,54,2148,1360,1650,18692,498
67286,23,407,242,284,5289,123
65584,800,15917,295,12916,90300,3001
1849,11,437,1550,331,11865,106
22364,546,69442,1291,41116,160853,28326
8221,1215,55374,1478,36402,274331,18972
17778,107,5133,1368,3668,72456,1465
37709,5,122,972,105,2872,17
35653,1,30,1027,25,3088,5
60720,2857,35414,439,29431,112453,5983
8058,25358,714415,1479,531047,1895424,183368
8530,1426,72730,1477,38328,198610,34402
16737,395,5887,1387,4062,21941,1825
2790,41,3456,1542,2296,23275,1160
35810,40,767,1023,559,7979,208
31556,52,910,1107,555,10353,355
39000,132,2269,942,1830,28991,439
23312,50,1310,1275,810,19345,500
7797,38,1636,1481,1187,35037,449
68596,38,689,197,511,7443,178
1067,12,675,1556,475,21097,200
51688,27,429,725,323,7171,106
7780,29,806,1482,533,7174,273
16259,104,2895,1395,1792,18963,1103
29631,15748,381862,1143,226647,822586,155215
30623,76,2567,1123,1509,19203,1058
22375,14,381,1290,290,16290,91
37814,10,246,969,158,5397,88
67209,12,163,245,131,3486,32
4917,6,369,1518,255,18086,114
21601,3,99,1301,71,8149,28
50958,258,3386,745,2480,14017,906
41672,31,777,903,566,10809,211
24911,44,1191,1241,801,39403,390
34648,19,195,1050,190,7366,5
25783,7,139,1223,106,6561,33
46359,15,245,843,169,8361,76
60620,1405,25590,444,21518,76252,4072
18060,5,412,1363,259,13559,153
60853,19,348,434,287,6010,61
25274,223,2518,1233,1526,20722,992
22561,16,503,1288,369,6926,134
34763,5,67,1047,62,10474,5
32004,95,4670,1101,2632,28263,2038
30290,481,12102,1129,8976,96613,3126
12703,66,1188,1446,722,19084,466
22172,12,396,1293,325,8607,71
11062,660,13982,1462,9132,39266,4850
2853,16,1254,1542,921,52852,333
3624,245,20706,1534,12841,77204,7865
54339,179,2175,641,1529,10525,646
31018,104,3520,1115,3052,112588,468
58099,185,3255,530,2499,35177,756
59013,6,78,500,52,2503,26
16859,5,876,1385,632,27392,244
28351,168,2918,1167,1905,26110,1013
62603,945,11036,377,8511,54941,2525
57161,56,631,557,515,11993,116
21732,155,6342,1299,3605,36006,2737
68084,20,317,218,230,4376,87
60922,36,255,432,211,4349,44
49566,722,12622,781,9717,83919,2905
50295,13,157,762,138,6632,19
32581,17,270,1091,213,9873,57
40627,5,219,920,155,12591,64
21212,83,1978,1307,1319,10013,659
57428,65,1529,551,922,25509,607
49029,139,2173,796,1640,32806,533
12895,145,3386,1443,2007,25765,1379
46881,169,2287,836,1825,25207,462
2466,17,257,1545,203,5053,54
49800,57,1263,774,1049,21876,214
5963,6,144,1505,98,7725,46
48596,14,239,809,180,11106,59
17464,70,2199,1375,1142,15120,1057
22030,268,3431,1295,2388,22292,1043
1579,339,5300,1552,3734,24264,1566
27939,11,475,1175,371,27070,104
27878,247,4956,1176,3186,33596,1770
60252,44,699,457,607,12939,92
3219,58,1290,1538,849,11614,441
63902,2245,29687,343,22964,128524,6723
20943,8,653,1312,445,23076,208
6365,182,8788,1501,5736,53199,3052
38730,4,195,946,144,7152,51
11204,6,84,1461,50,4712,34
14302,8,1355,1423,657,9922,698
23612,208,7967,1269,5495,85883,2472
57269,26,323,554,246,7585,77
23227,53,2680,1276,1550,61326,1130
29974,9,381,1136,237,24007,144
10589,11,444,1466,277,16969,167
18492,15,559,1356,431,25236,128
11662,4074,118859,1457,63125,456366,55734
34616,45,1203,1051,689,18485,514
27157,4,289,1192,182,16177,107
9255,19,885,1474,621,14492,264
1389,15,471,1554,338,18996,133
70047,29,332,152,317,5095,15
14620,3,232,1418,130,4134,102
4172,23,1520,1528,1178,31814,342
18640,21,1027,1353,673,12888,354
64142,214,2563,335,1893,10379,670
62090,1034,17275,393,14153,121253,3122
63373,38,634,358,492,9915,142
28706,26,794,1160,472,7447,322
36192,315,4534,1012,3376,33435,1158
35687,96,1805,1026,1338,13939,467
21454,6141,132836,1303,88244,391982,44592
21991,742,23026,1296,15716,83487,7310
62155,593,5189,390,4272,42807,917
32371,313,7162,1095,5529,74812,1633
62163,4,46,390,37,2588,9
13916,15,319,1429,217,13720,102
28106,345,6553,1172,4245,57757,2308
70490,39,454,137,433,3984,21
24010,41,803,1262,584,12519,219
20089,8,334,1327,261,23181,73
17988,3,152,1364,116,10242,36
68882,4,35,190,27,876,8
66476,2,130,270,104,4634,26
51811,62,735,721,572,11335,163
22291,97,1943,1292,1629,36116,314
50935,28,277,746,229,6638,48
21434,8,157,1304,122,16748,35
29284,13,275,1149,196,5376,79
38679,0,18,947,15,1951,3
2607,179,6362,1544,4378,52325,1984
8421,216,4185,1477,2882,24663,1303
56188,85,815,584,698,12247,117
69724,8,112,163,94,3046,18
62445,5,98,382,73,3108,25
630,23,1513,1559,975,44313,538
19630,312,4802,1336,3557,35994,1245
15406,39,1725,1408,1068,10595,657
65495,36,488,297,366,8489,122
37652,74,1571,973,1103,28137,468
31734,5,112,1104,85,2207,27
63607,118,995,352,783,8368,212
50448,116,3086,757,2548,35869,538
21696,59,1110,1299,712,27146,398
68066,30,302,218,246,6891,56
10773,293,8384,1464,5088,42753,3296
19466,146,4807,1339,3655,42875,1152
23166,239,4843,1277,3618,71867,1225
40386,925,8293,923,6580,74386,1713
63051,166,5403,366,3894,33963,1509
57963,52,1092,534,682,4040,410
52964,171,2501,683,1864,18285,637
51747,39,621,723,555,10989,66
12300,35,1632,1451,1039,112228,593
58897,131,1825,503,1423,31090,402
25850,2,173,1221,117,10126,56
11903,68,1778,1455,781,14471,997
53783,32,281,661,233,3962,48
25413,20,746,1231,477,9473,269
51773,7,167,722,116,11347,51
7023,65,2391,1492,1723,47423,668
10549,18,470,1466,345,23724,125
69033,2787,89811,183,75329,343583,14482
10300,120,7204,1468,4419,41941,2785
18929,401,8840,1348,5613,43211,3227
60874,24,152,434,117,3317,35
5083,39,841,1516,595,14646,246
2552,2433,73627,1544,47327,181419,26300
20690,54,1299,1317,913,21534,386
52640,2,20,693,17,5324,3
41860,70,784,899,547,15633,237
26036,10,994,1217,551,15365,443
21707,14,385,1299,248,6966,137
64088,55,740,336,551,13773,189
58427,1137,13114,519,10271,44659,2843
16558,15,586,1390,418,8259,168
20213,168,3860,1325,2873,27781,987
14798,15,502,1416,329,6986,173
35944,58,1527,1019,1186,13058,341
65317,2408,45756,301,34067,220049,11689
57372,173,2891,552,2214,42600,677
18612,1,152,1354,125,7881,27
34848,14,264,1046,185,8682,79
13299,73,2863,1437,1726,32291,1137
12384,15,707,1450,408,40559,299
8644,96,3139,1476,1966,42255,1173
19208,183,5984,1343,4025,64830,1959
7519,130,3140,1485,2175,33561,965
14515,41,1166,1420,836,27211,330
1621,17,921,1552,606,41905,315
22418,14,391,1290,328,12311,63
33826,181,6903,1068,4649,55901,2254
22018,357,3898,1295,2870,40396,1028
52884,117,1400,685,1134,14312,266
33913,28,428,1067,306,8379,122
48457,99,1060,815,805,12549,255
35287,103,1861,1034,1277,12972,584
33061,3569,77844,1082,62487,278771,15357
23352,4059,73804,1274,54133,191675,19671
22913,14,431,1281,321,4844,110
6888,32,765,1494,585,17059,180
47255,47,515,831,415,10052,100
65366,23,514,300,357,11770,157
57018,511,10386,561,8078,32509,2308
17019,6,190,1382,136,10154,54
15744,5,211,1403,140,19325,71
14838,9,395,1416,256,8368,139
21637,61,1606,1300,1045,62960,561
33855,21,152,1068,100,2722,52
5036,12,404,1516,316,19765,88
32314,17,361,1096,231,6854,130
33945,30,763,1066,528,10663,235
6486,166,8159,1499,5084,81206,3075
64820,3109,49160,314,35254,146372,13906
12784,14,871,1444,435,8188,436
60299,32,772,455,501,12147,271
65381,28,311,300,271,9376,40
5675,94,2984,1509,1894,43002,1090
59849,17390,687502,472,382327,2631012,305175
17510,31,1561,1374,1076,22208,485
38712,5031,174152,946,126048,592350,48104
17468,6,157,1375,109,4447,48
23966,124,3602,1262,2524,35448,1078
16314,0,56,1394,36,6966,20
68557,112,2084,202,1707,11941,377
53593,20,286,667,242,10661,44
12777,11,545,1445,257,8224,288
43425,73,2330,876,1851,35598,479
32802,78,1225,1087,805,9346,420
13933,364,9343,1428,6244,63726,3099
36140,9,63,1014,58,12244,5
48945,274,4356,799,3606,76640,750
58807,9,114,506,102,4699,12
11974,30,1621,1454,931,15018,690
16316,28,507,1394,347,14558,160
66472,567,8534,270,6815,71415,1719
51577,144,1185,728,1027,18556,158
66382,133,1227,273,1041,16169,186
43238,20,439,877,318,15719,121
38688,50,1851,947,1380,25332,471
35685,8,595,1026,376,7441,219
45626,11,151,851,99,11066,52
26443,203,5238,1208,3686,93993,1552
57517,1,25,549,19,2976,6
69866,15,282,158,241,10007,41
9150,54,812,1474,631,8629,181
28920,106,2548,1156,1601,22259,947
68501,10,110,204,81,1883,29
46636,1,25,839,20,2067,5
10790,5779,226928,1464,123383,882431,103545
34381,35,1171,1057,913,14057,258
35261,2,103,1035,77,8718,26
36872,49,502,996,395,7821,107
1649,175,7578,1552,5107,71941,2471
659,4,806,1559,605,28386,201
34109,32,254,1062,204,3801,50
13032,18,819,1441,425,9880,394
57321,47,658,553,474,13451,184
32132,168,3752,1099,2877,26736,875
17063,11,922,1382,674,31940,248
1234,538,47228,1555,32270,186802,14958
53175,16,208,676,161,6843,47
18408,106,2314,1357,1606,23458,708
67205,26,549,245,443,6347,106
35078,234,5011,1040,3489,75639,1522
25137,346,14474,1236,10590,60550,3884
47899,26,564,824,447,11974,117
69038,14,181,185,130,3828,51
17970,145,4124,1365,2971,63050,1153
63233,1,125,362,111,5722,14
51843,220,2546,720,2041,24324,505
19120,45,2426,1344,1652,18054,774
63243,1671,27009,361,20771,88880,6238
67555,91,2374,233,1865,22852,509
50441,2946,40168,758,31659,128293,8509
29090,62,2244,1153,1516,38566,728
34385,107,1982,1057,1430,19878,552
62111,100,1922,392,1425,9446,497
61535,3,23,412,18,2972,5
65291,11,146,302,105,2961,41
4878,27,1048,1519,768,12999,280
34398,18,384,1056,255,8383,129
68894,137,2393,190,2077,17647,316
51923,33,568,719,410,17220,158
4558,45,1119,1523,698,14765,421
22834,2,96,1282,75,35198,21
61805,5,158,403,127,3356,31
50975,23,281,745,176,4909,105
63700,6,60,349,43,4215,17
1425,32,1593,1553,1100,20959,493
49767,3,42,775,40,2558,2
9215,493,9986,1474,6622,38480,3364
15389,7258,206045,1409,128371,693247,77674
22231,14,542,1292,390,12115,152
49565,67,1575,781,1377,59866,198
22716,796,15297,1285,10311,83812,4986
40932,835,36471,915,23680,68005,12791
67926,0,20,223,15,921,5
65238,1186,17186,303,13861,54172,3325
19315,2598,45259,1341,27899,210236,17360
41207,404,14740,911,11109,41166,3631
22876,1050,28180,1282,19676,133030,8504
793,33,761,1558,575,11431,186
32561,666,14935,1092,10893,47958,4042
9584,86,2740,1472,1794,43132,946
39922,4060,77088,928,59847,455629,17241
6971,14975,576486,1493,338735,1324279,237751
69045,3,46,185,30,1513,16
67444,9,216,238,82,6895,134
23421,336,4466,1272,2708,21127,1758
50336,5981,71541,761,57513,263176,14028
19063,309,4743,1346,3366,25017,1377
48650,167,1640,808,1342,27489,298
1941,2,130,1550,101,16080,29
50225,345,6203,764,4907,42089,1296
12591,20,473,1447,257,15768,216
54074,32,390,650,304,5653,86
69429,11,213,173,153,2953,60
23238,64,2310,1276,1563,20984,747
31580,8,199,1107,150,16932,49
28348,355,15905,1167,10189,124543,5716
9428,23,2509,1473,1506,19970,1003
49303,84,1395,787,1052,16231,343
65346,801,16343,300,13886,96721,2457
56988,6,38,561,33,3299,5
23800,29,447,1265,320,11519,127
15735,102,2831,1403,2089,36617,742
13654,41,2224,1432,1379,27872,845
31203,9,120,1112,68,7167,52
29028,32,487,1154,414,22986,73
36028,26,418,1017,335,13995,83
23573,5,312,1270,169,4136,143
61553,60,1021,410,825,15403,196
10902,1389,49703,1463,29558,241810,20145
40905,113,2435,915,2107,25536,328
7681,1697,92047,1483,50811,383332,41236
42586,164,4572,888,3716,75818,856
24636,0,0,1247,0,2361,0
40745,502,8280,918,6524,40230,1756
15861,1950,55664,1401,39373,288827,16291
67050,58,951,251,784,8614,167
19188,52,1330,1343,909,28015,421
26684,9,387,1202,240,7271,147
34830,2,128,1046,108,11251,20
31754,21,527,1104,349,12954,178
38244,26,329,958,250,4591,79
35560,186,4238,1026,2964,19338,1274
34077,13,223,1063,161,12191,62
38109,3,158,961,128,7792,30
26699,5,113,1202,96,6441,17
52851,62,729,681,568,8167,161
16283,96,4291,1394,2732,46991,1559
34999,45,1012,1042,774,23775,238
12524,24,995,1448,591,30784,404
21378,699,15761,1305,9442,97362,6319
34348,51,962,1058,860,19423,102
55383,46,532,607,396,8415,136
23561,35,545,1270,381,12767,164
42434,380,8587,891,5979,98673,2608
56460,73,1485,576,1219,8537,266
43204,107,1859,878,1525,30748,334
29557,49,994,1145,813,18085,181
50693,846,10027,752,7540,48219,2487
7245,1399,45341,1489,26330,253897,19011
7266,77,3674,1488,2571,41502,1103
2771,50,2116,1543,1394,48004,722
55565,230,5602,602,4544,43248,1058
65957,28,364,285,305,9800,59
19784,3,103,1333,72,3256,31
26446,2964,100191,1208,58935,392496,41256
55892,19,216,593,167,5851,49
12899,6,205,1443,114,5313,91
65876,7,48,287,43,1880,5
66748,57,588,261,463,6411,125
19833,500,12349,1332,8017,75139,4332
38536,3,77,950,59,5548,18
12174,117,3596,1452,1972,11801,1624
60803,63,995,436,741,16227,254
68008,221,3795,216,3240,23207,555
9811,165,4250,1471,3003,28568,1247
8934,363,7936,1475,5274,95890,2662
51637,5,83,726,68,7355,15
40990,411,5390,913,3980,49546,1410
54731,29,213,626,198,7359,15
51348,18,608,734,482,11512,126
36809,101,1826,998,1410,13428,416
34445,3,98,1055,66,7486,32
398,434,14324,1561,8512,50795,5812
62794,174,3049,373,2536,39778,513
22688,132,1687,1285,1135,16490,552
58501,151,2097,516,1525,33256,572
61958,990,20487,396,16668,122508,3819
48493,13,255,814,173,9798,82
32016,302,6546,1100,4658,86470,1888
26485,36,706,1208,608,19195,98
67367,172,2704,240,2066,17355,638
67610,6,45,233,36,2977,9
41667,36,622,903,420,2976,202
57481,131,1432,549,1108,11719,324
42803,22,311,884,241,9021,70
67562,6,66,234,50,2898,16
2836,4391,208662,1542,134414,270855,74248
15065,12,798,1413,555,31203,243
41482,899,23327,906,18886,159019,4441
55388,86,1262,606,977,15661,285
50219,489,9114,764,7273,45868,1841
23174,7,321,1277,234,6963,87
61811,79,2493,395,1841,26131,652
8167,11,403,1478,258,27053,145
55050,23,258,616,178,6804,80
19526,48,1063,1337,763,7492,300
50384,322,4371,760,3496,60676,875
32291,41,1001,1096,688,22625,313
15701,926,13333,1404,9254,59380,4079
4861,70,1003,1519,660,25215,343
30902,24,1012,1118,621,9095,391
4263,20,494,1527,357,22595,137
18548,29,735,1355,559,17125,176
43101,117,2573,880,1985,36482,588
39598,28,676,915,484,30422,192
69161,6,70,181,59,1460,11
7554,3322,249065,1485,123264,657549,125801
69708,20,253,164,212,2212,41
17830,102,3065,1367,2266,40560,799
68477,68,1342,205,1111,8110,231
18464,736,49151,1356,31128,88693,18023
24905,10,366,1241,252,9015,114
6354,34,775,1501,525,19099,250
11083,50,1297,1462,858,13486,439
23838,16,302,1265,210,9612,92
66576,2,29,266,18,1619,11
34701,92,1064,1049,775,13903,289
21209,55,1512,1308,1075,16272,437
17823,2658,67137,1367,47269,373422,19868
29803,361,10518,1139,6236,56727,4282
13979,49,2483,1428,1374,30713,1109
4622,24,1431,1522,1048,20788,383
18816,7,605,1350,436,10434,169
26307,56,1551,1211,931,16508,620
23224,8,348,1276,255,9471,93
37610,0,23,974,18,2438,5
55796,6,54,596,52,8560,2
63240,439,9752,361,7849,50069,1903
27910,217,5983,1175,4420,31594,1563
17625,158,2616,1371,1708,12752,908
13506,440,22296,1434,13537,121364,8759
4981,232,8248,1517,5028,50287,3220
17013,196,14237,1382,8963,69594,5274
149,57,3180,1564,2244,25635,936
337,663,29191,1562,20523,160134,8668
41760,126,1321,901,953,18995,368
59372,603,10914,488,8450,70125,2464
37481,9121,225389,978,182877,694655,42512
7257,7,454,1488,261,22410,193
51021,5,97,743,76,4013,21
62801,829,18450,372,14631,68931,3819
55407,886,7205,606,6260,73917,945
52515,52,603,698,508,11307,95
5929,8,184,1506,142,8638,42
54196,1785,25909,646,20666,110413,5243
2818,266,13299,1542,8448,76597,4851
67328,8,299,242,184,5000,115
37877,43,626,968,538,11936,88
5065,37,958,1516,666,31868,292
26161,10,159,1215,108,5712,51
26229,78,2190,1213,1785,57702,405
21957,34,785,1296,530,10971,255
68510,8,291,204,238,3006,53
14550,93,2310,1419,1691,36119,619
35542,10,189,1029,130,12727,59
28743,333,6689,1160,4434,63447,2255
26722,533,10433,1202,6931,47307,3502
45784,26,480,850,394,13257,86
35937,88,1374,1020,1036,15782,338
42805,8,198,878,130,7600,68
56071,32,375,588,296,10211,79
66388,33,357,272,290,4742,67
49369,5287,89017,785,66487,397950,22530
21003,4,154,1312,121,4531,33
66461,20,492,271,368,6281,124
22099,41,1884,1294,1252,30768,632
52474,2675,35375,699,28831,238542,6544
135,278,15418,1565,9673,189078,5745
25402,136,2650,1231,1927,29992,723
20989,120,2814,1312,1912,24727,902
5625,36,2280,1509,1444,34382,836
9062,87,4285,1474,2621,23323,1664
27425,2150,41866,1186,26287,140974,15579
24036,45,1599,1261,1108,31053,491
898,73,1555,1557,1170,77666,385
60365,21,256,453,159,5475,97
15267,27,1319,1410,966,18991,353
41273,539,12079,910,9266,100615,2813
12045,1435,49021,1453,32245,199499,16776
65275,11,141,302,122,4255,19
36970,556,15710,993,13460,89155,2250
39071,205,4838,941,3428,84952,1410
14630,2861,55694,1418,40310,283667,15384
55829,2572,60770,583,47656,444022,13114
14499,55,2196,1420,1633,24646,563
40476,20,715,922,578,10210,137
52107,33,407,712,343,5460,64
65177,27,393,304,324,7510,69
70533,10,106,136,100,2557,6
59659,6,50,478,41,3866,9
10216,958,25035,1468,15490,108171,9545
69919,14,155,156,141,1787,14
30630,185,3454,1123,2566,32095,888
34458,15,504,1055,397,11570,107
66795,64,838,260,659,6062,179
52611,116,998,695,755,7313,243
61840,68,801,402,665,12496,136
35564,2837,50632,1028,40542,323421,10090
21230,8,223,1307,124,4820,99
17839,5,127,1367,101,6773,26
57672,36,394,544,284,8810,110
50031,72,561,769,413,7805,148
36198,27,994,1013,677,27326,317
62671,64,463,376,356,4289,107
44496,2682,32132,864,25555,235668,6577
20441,17,821,1322,628,23071,193
4406,293,15203,1525,8253,72399,6950
53178,16,240,676,195,4671,45
36414,97,1828,997,1552,38498,276
17978,676,10244,1364,7415,54914,2829
35913,71,1512,1019,1127,16031,385
56537,97,1377,574,1199,30784,178
18243,702,15733,1360,11486,51909,4247
37752,28,563,971,504,14739,59
22711,107,1602,1285,1074,12377,528
2833,525,9945,1542,5846,87719,4099
47979,48,774,821,491,10921,283
6084,13,940,1504,619,13672,321
1781,127,4963,1551,3093,34231,1870
24664,5555,348361,1246,204617,1277385,143744
50093,474,5436,767,4424,58181,1012
17489,76,1549,1374,1256,19031,293
28528,24,1446,1164,954,35756,492
43373,20,319,876,242,9476,77
26153,1,88,1215,55,4414,33
55529,19,142,603,127,8358,15
69793,1,21,160,16,1991,5
49693,780,8046,777,6244,33395,1802
55611,379,7706,600,6453,34745,1253
17633,21,962,1371,695,20490,267
22245,12,551,1292,345,7227,206
65517,16,140,297,117,2026,23
59617,33,454,479,362,8333,92
54279,52,450,643,336,8110,114
18594,540,7699,1354,5339,36923,2360
51956,16751,240342,717,171188,581053,69154
17417,246,6922,1376,4795,55884,2127
26466,3,200,1208,124,8023,76
7346,17,564,1488,372,15850,192
63838,5,75,345,63,2403,12
39119,126,1064,941,850,16702,214
49317,14,197,787,166,10168,31
22268,47,884,1292,667,23093,217
53038,40,641,681,470,11584,171
38400,924,16216,954,11611,44537,4605
66250,13,100,276,84,2936,16
52213,2495,37620,709,28124,104861,9496
64604,49,1529,321,1305,16970,224
4154,77,1497,1528,1034,16224,463
35192,574,13193,1037,9230,169129,3963
26915,148,4037,1197,2808,41969,1229
46265,51,1035,844,870,13566,165
32668,38,1443,1090,845,13683,598
27841,22,879,1177,597,20930,282
23524,3,173,1271,118,14431,55
7726,7,689,1482,467,27267,222
49253,409,7109,789,5886,43815,1223
27779,713,16844,1179,12047,43368,4797
50244,3543,38146,763,29761,598735,8385
60152,7,69,461,58,4727,11
52693,25,359,691,311,11974,48
34408,204,5990,1056,4688,52616,1302
4560,227,7766,1523,5199,133638,2567
33401,17,309,1076,207,10142,102
68097,5,105,217,84,2613,21
43701,6564,80667,872,66076,293120,14591
64297,31,405,330,320,6548,85
19611,5182,155025,1336,112044,557670,42981
57741,937,8773,542,7020,70143,1753
14766,114,3373,1417,2146,39359,1227
42284,59,1436,894,1140,12328,296
27253,17,672,1190,411,34559,261
53492,50,791,669,577,7263,214
57413,4209,115817,551,78854,386075,36963
62950,20,317,369,223,4351,94
33865,52,1405,1068,1009,25549,396
12761,190,9155,1445,6052,68199,3103
37063,397,4320,990,3302,39784,1018
28186,4,59,1170,40,5705,19
63063,41,395,366,328,7158,67
40179,202,3739,927,3140,59403,599
36101,191,5320,1015,3868,28156,1452
32168,19,1637,1098,1077,28455,560
69057,3,36,185,27,3766,9
41528,20,298,906,219,13562,79
3360,38,1108,1537,797,23990,311
15314,4,260,1410,192,8625,68
41084,35,597,912,477,9550,120
35813,290,5513,1023,4390,110957,1123
66848,27,305,257,239,5617,66
53694,54,446,663,358,8775,88
38484,277,3639,951,2998,31496,641
9054,31,1170,1474,801,13015,369
62633,33,375,376,314,8978,61
70086,5,107,151,98,1972,9
52537,188,3182,697,2560,58397,622
64213,58,710,333,559,9803,151
3076,11,177,1540,120,15136,57
67681,12,167,231,134,4856,33
2600,167,3563,1544,2455,26703,1108
14950,78210,2113378,1415,1286760,4685483,826618
54508,73,916,635,670,13765,246
37875,152,2136,968,1810,32629,326
68124,6,117,217,94,3704,23
2808,1449,53919,1542,22551,128413,31368
16579,7,345,1390,261,13121,84
21169,11,513,1308,380,15630,133
3639,34,1045,1534,800,13010,245
30502,3,149,1125,102,2454,47
30065,31,487,1134,351,15478,136
35793,1935,38425,1023,27607,313052,10818
16072,3801,212843,1397,117378,304811,95465
55773,22,264,596,219,4881,45
25131,1038,28411,1236,19213,86409,9198
33758,8,454,1069,323,3516,131
21301,12,369,1306,294,10815,75
15163,33,694,1412,479,13196,215
4463,798,53207,1525,34759,301894,18448
61608,2493,28735,409,23224,123075,5511
241,16,1147,1563,829,82993,318
12807,47,2868,1444,1783,31788,1085
61088,30,296,426,262,6934,34
55363,51,833,607,686,20066,147
34251,554,9232,1060,6879,61038,2353
53762,8,129,661,123,5063,6
24008,71,3236,1262,2173,41015,1063
49160,14,210,792,166,14789,44
52200,103,1065,708,797,17494,268
60215,166,2986,458,2394,18865,592
16732,36,655,1387,524,28651,131
56052,33,264,588,222,6630,42
40109,26,406,928,316,5568,90
68650,147,1669,198,1407,10031,262
61108,52,812,425,668,21397,144
51576,98,1578,728,1249,13202,329
14155,6,512,1425,320,9726,192
67387,78,1069,240,775,8447,294
15024,1963,49564,1414,32551,254343,17013
30263,160,4868,1130,3202,54019,1666
14609,1019,22924,1419,14675,88442,8249
1103,70,2385,1556,1682,25576,703
36941,33,856,994,603,22629,253
27672,87,2264,1180,1447,27518,817
15600,88,2236,1405,1478,40561,758
69691,12,72,164,72,4409,0
16256,1183,22347,1395,16380,106050,5967
15638,11,157,1405,112,11584,45
67527,16,69,235,62,1561,7
30111,3,234,1133,120,4238,114
54287,1522,24245,643,19888,127953,4357
9640,16,740,1472,482,10529,258
26564,14,508,1205,327,19887,181
40007,3,48,929,39,2357,9
33329,60,1085,1077,718,25960,367
33463,3,185,1075,122,5818,63
20844,25,679,1315,480,20047,199
17286,38,1356,1378,931,24404,425
34278,15,476,1058,343,5057,133
25246,16,1119,1234,767,19909,352
1561,69,1088,1552,748,15961,340
61110,1140,17558,425,13321,45222,4237
28502,133,2758,1164,1804,64111,954
37650,13,156,974,127,2076,29
18736,37,1921,1351,1333,24723,588
24511,748,14605,1250,11771,105278,2834
27112,25,571,1193,389,29385,182
1306,2486,71670,1554,39577,132381,32093
5954,120,4095,1506,2327,29926,1768
49591,58,1039,780,675,11453,364
37153,34,1103,988,857,21482,246
53198,4,98,676,70,8755,28
51199,1096,17395,738,13996,61462,3399
56471,68,747,576,542,12858,205
48490,70,1753,814,1346,16500,407
26226,75,1302,1213,920,40103,382
14361,80,1363,1422,938,12802,425
12434,13,1122,1449,552,10711,570
20503,35,1529,1321,1018,14525,511
60903,4326,80598,432,62616,382928,17982
33938,27,504,1066,342,9041,162
11260,55,3308,1461,1897,64117,1411
11367,62,1521,1460,884,29288,637
30298,36,1286,1129,788,31372,498
38271,3,64,957,50,2126,14
67424,13,152,239,119,2769,33
25097,9621,226967,1237,143868,717216,83099
51658,68,1133,725,915,13801,218
62045,2260,65384,394,50086,353570,15298
53085,23,275,679,197,8806,78
8166,4,276,1478,192,18058,84
52794,303,2609,688,2060,19884,549
48742,15,253,805,204,4452,49
25992,79,1844,1218,1102,11735,742
14553,1,119,1419,73,6151,46
56541,25,204,574,189,6717,15
12531,5,209,1448,107,9181,102
60658,35,515,442,394,8505,121
36300,91,947,1009,809,23336,138
66335,2,42,274,31,4381,11
7414,16,647,1487,447,16655,200
67934,9,140,223,95,2677,45
59064,24,240,497,192,4169,48
51640,14,147,726,117,6007,30
53557,488,5705,668,4578,51796,1127
5729,618,26272,1508,17641,92629,8631
22686,40,1188,1285,868,24881,320
549,601,22023,1560,14796,131130,7227
55865,78,1183,594,846,8092,337
22594,31,691,1287,581,26236,110
23618,4,110,1269,87,3955,23
52698,4,27,691,22,2399,5
59863,18,208,471,156,4781,52
48635,162,3174,809,2603,33842,571
17383,0,162,1376,140,6497,22
61572,55,773,410,685,7813,88
22480,12,577,1289,368,8588,209
48470,4901,70613,815,50028,408103,20585
35092,17808,642923,1040,440041,1701363,202882
63279,1235,17641,361,14687,90264,2954
32936,28,610,1085,389,6291,221
34038,362,8441,1064,5783,37158,2658
987,88,2336,1556,1726,20807,610
47557,766,10777,827,8565,84564,2212
25591,23,857,1227,566,6602,291
35579,3,40,1028,31,4700,9
27587,182,5018,1182,2977,20596,2041
49834,1808,56354,718,42290,223475,14064
52203,69,703,709,550,15999,153
30255,14,565,1130,345,25637,220
60174,3,52,460,45,2310,7
21062,720,15259,1310,10360,57397,4899
53084,154,1282,679,1121,20535,161
24454,75,2269,1251,1489,25612,780
61215,44,604,421,463,20956,141
25751,21,511,1223,326,10614,185
15094,4048,165549,1413,105140,502492,60409
40186,18,239,926,188,6546,51
30661,33,438,1122,270,5295,168
18615,0,0,1354,0,8251,0
66797,105,1238,259,910,10229,328
22050,709,19991,1295,12606,160423,7385
4647,43,1312,1522,834,32133,478
14786,718,15490,1417,11734,119741,3756
62991,114,1122,368,926,5701,196
14727,857,33321,1417,22313,173455,11008
7108,384,14491,1491,9354,61647,5137
18544,1150,41619,1355,26119,136810,15500
50823,661,7531,749,5487,34865,2044
53999,15,142,653,98,4031,44
67644,9,275,223,189,6118,86
17948,16,296,1365,192,5105,104
1946,881,37744,1549,22259,152533,15485
19637,1,47,1336,33,5972,14
44512,3,36,863,28,2001,8
41343,112,2228,908,1776,31500,452
38156,47,1207,960,879,17859,328
59002,40,405,500,300,8804,105
40508,9,319,922,243,11146,76
27422,183,4430,1186,2703,30165,1727
24418,18,485,1252,331,15981,154
50353,24,355,760,306,7673,49
49749,69,699,776,587,14241,112
45288,37,659,855,502,12235,157
58263,32,277,524,209,2745,68
33514,3,94,1074,63,5247,31
36754,70,1102,999,882,9807,220
61033,204,5703,428,4204,39327,1499
21331,62,1707,1306,1078,23444,629
5788,101,2509,1508,1718,26504,791
37895,112,2006,968,1428,16662,578
70260,1067,19989,145,19096,68933,893
10471,69,1736,1467,1047,16395,689
56501,115,2994,575,2464,51323,530
3478,4,89,1536,58,16821,31
472,697,20732,1561,13775,128565,6957
33395,7599,165520,1076,118450,516252,47070
63582,121,1390,353,1123,19715,267
14975,359,11698,1414,8755,81712,2943
2055,111,6021,1549,3739,37403,2282
32866,292,8082,1086,5834,75961,2248
58585,10,132,513,120,8470,12
57666,31,367,544,278,8968,89
68990,0,12,186,9,2300,3
31696,89,1350,1105,948,22031,402
27303,322,6229,1189,5076,67462,1153
52722,2,15,690,14,2301,1
58829,148,2449,506,1997,25193,452
38668,71,527,947,425,5987,102
50308,29,475,762,388,5185,87
2612,98,1668,1544,1220,18982,448
16883,86,3662,1385,2510,48157,1152
17609,8197,224085,1372,164130,647716,59955
18580,6,376,1354,296,20870,80
24332,14,226,1254,178,4710,48
10304,1171,19579,1468,14716,128606,4863
31562,5,628,1107,405,19364,223
31292,28,416,1103,265,5068,151
10293,80,1707,1468,1123,16376,584
30078,23,1081,1134,657,29280,424
49662,8,120,778,91,6580,29
57454,27,287,550,241,18302,46
29017,826,12064,1154,8413,59098,3651
65825,4,69,289,49,5831,20
63754,46,2052,348,1680,19735,372
27053,2348,47708,1194,28848,152072,18860
58127,78,1533,529,1071,22132,462
58948,8,65,502,55,4848,10
3669,6,578,1534,422,13863,156
52652,72,755,693,651,24806,104
21572,8226,231629,1301,141697,1188687,89932
50895,11,378,747,277,9297,101
5475,29,930,1511,652,32492,278
21316,5,164,1306,118,15303,46
9085,786,13339,1474,8034,73814,5305
65282,112,3124,302,2470,23165,654
53057,6,68,680,52,3300,16
50775,8,278,750,201,6913,77
12687,7583,296145,1446,160334,1038933,135811
6172,4004,114698,1503,64504,407429,50194
41463,13,222,907,170,8170,52
33539,12,284,1074,220,7547,64
10891,14618,262454,1463,147260,587011,115194
32896,54,1878,1085,1247,37839,631
48164,21,226,820,170,10850,56
61857,92,901,401,699,15496,202
36068,311,4097,1016,3233,25569,864
58100,1436,45466,530,35743,111390,9723
57035,106,2640,560,1922,31716,718
59949,38,423,468,314,7990,109
59782,6,60,473,45,3816,15
41387,20,445,908,370,8237,75
37376,14,269,981,216,7324,53
55416,24,251,606,206,5789,45
52657,62,759,693,630,26810,129
27983,200,14899,1174,9682,42565,5217
17882,9,339,1366,222,5691,117
64138,0,19,335,12,1314,7
50719,810,10679,752,8307,66534,2372
57081,54,704,559,596,12028,108
15394,144,5623,1409,3735,48004,1888
39689,232,3468,934,2824,51636,644
60682,88,835,441,574,7016,261
52603,17,107,695,74,3963,33
20837,0,0,1315,0,9027,0
30927,102,3895,1117,2766,46815,1129
40786,80,1408,917,1140,15843,268
50862,102,1244,748,950,20245,294
69330,25,161,175,134,2033,27
68372,21,318,209,267,11183,51
50252,209,2685,763,2058,18641,627
36542,718,14069,1002,10021,112579,4048
9061,12,560,1474,359,20909,201
53068,3310,37325,679,25870,341393,11455
59924,82,681,469,536,7559,145
22614,434,5338,1286,3249,23567,2089
44617,2,128,863,93,8432,35
29932,16,365,1137,249,9927,116
4262,35,1437,1527,987,26024,450
25532,95,2246,1229,1498,13224,748
50600,216,1994,754,1546,30660,448
30729,77,4425,1121,2893,58125,1532
37180,6,122,987,99,6854,23
36865,555,13209,996,8328,101644,4881
56962,860,12865,562,10687,148766,2178
18200,18,400,1361,308,6765,92
34778,72,2282,1047,1526,25971,756
21581,1,95,1301,64,3680,31
5967,27,966,1505,611,12087,355
20668,23,578,1318,418,9726,160
16173,72,1929,1396,1263,13689,666
66676,10,197,263,147,6912,50
10698,428,11286,1465,7263,39660,4023
26590,75,3038,1205,1735,25822,1303
59227,1940,32512,493,25253,172935,7259
8124,474,23958,1478,15110,72400,8848
25693,55,1458,1224,1169,11456,289
61760,134,3565,405,2930,25008,635
34642,238,4419,1051,3428,46282,991
9655,898,34532,1472,19555,122364,14977
5301,13,466,1513,278,13862,188
66868,13,108,257,79,2219,29
18966,13,355,1347,324,9886,31
6124,15,589,1503,411,17665,178
30481,108,1076,1125,853,15215,223
61997,93,748,396,503,6021,245
16643,84,3426,1389,2108,15241,1318
49052,20,569,795,409,25142,160
19660,12188,428786,1335,258619,987858,170167
23576,20,733,1270,603,11774,130
24428,545,16186,1252,10911,94357,5275
64506,34,498,324,413,15895,85
26321,847,20600,1211,13017,182711,7583
36988,83,3192,992,2405,34669,787
70147,2,87,148,66,2078,21
32467,15,527,1093,324,10798,203
29483,27,669,1146,462,12919,207
26196,86,2464,1214,1669,30737,795
2621,83,2511,1544,1793,55928,718
46002,6,210,847,154,6850,56
30131,222,7816,1132,5358,47471,2458
56912,60,1121,563,930,14704,191
23526,23,258,1271,212,18435,46
48231,31,496,819,416,8791,80
4075,15,661,1529,459,12550,202
45936,4,49,848,37,1632,12
35061,1,35,1039,28,3533,7
28612,39,1055,1162,638,17221,417
59903,84,2037,469,1574,22388,463
2806,1,195,1542,125,17150,70
18346,122,4305,1358,3081,40482,1224
57533,43,1219,548,917,22940,302
56379,1033,22131,579,17819,153731,4312
8747,12,398,1476,264,5449,134
18688,140,3466,1352,2477,65929,989
47949,40,685,823,544,11364,141
52514,10,165,698,154,10327,11
56001,5,51,590,39,4533,12
67457,5,79,238,73,3211,6
9257,38,1103,1474,725,13702,378
62663,352,5148,376,3991,55299,1157
36235,59,1118,1011,906,18403,212
26491,2520,41095,1208,27081,105839,14014
4707,2076,65582,1521,40665,251146,24917
36111,503,9800,1015,7968,117078,1832
22791,1856,62586,1283,42689,278426,19897
8075,2508,82749,1479,50569,238845,32180
67782,7,103,227,53,6375,50
2249,61,4081,1547,2724,41611,1357
47440,15,220,828,186,9429,34
57770,31,605,541,532,16132,73
9955,88,2932,1470,2096,14049,836
66140,35,345,279,281,7053,64
49828,316,5003,774,4164,115939,839
4834,8185,295526,1519,173089,725602,122437
25623,10,305,1226,223,15285,82
69286,146,2080,177,1891,17935,189
8201,6,308,1478,208,5252,100
36888,107,1938,996,1525,26215,413
24861,384,6490,1242,4654,24613,1836
27401,512,13295,1187,11078,96631,2217
13928,10,482,1428,311,28141,171
12268,1637,44790,1451,28509,220827,16281
15867,3,157,1401,113,4063,44
30607,11,517,1123,292,11231,225
29553,8,292,1145,201,6249,91
31303,55,1540,1111,928,21960,612
54194,105,1164,646,785,9119,379
32756,460,10737,1088,8010,67117,2727
55270,18,342,610,295,11931,47
9140,47,675,1474,471,25431,204
6086,3545,120209,1504,78617,296635,41592
61581,4,101,410,72,2930,29
27686,16,667,1180,424,15192,243
1868,2,269,1550,193,17298,76
27282,21,300,1190,256,10944,44
10091,22,755,1469,476,5755,279
46460,1696,25660,842,19632,184969,6028
5512,34,1582,1511,1052,20197,530
50375,99,2088,760,1765,29075,323
67762,6,112,228,89,4941,23
21773,36,1648,1298,985,15245,663
48326,7,107,817,85,2959,22
41361,6,100,908,82,6832,18
50957,54,338,745,259,6535,79
34679,728,20517,1050,14645,105349,5872
5206,15,368,1514,257,11845,111
61443,135,1597,414,1151,25825,446
3080,7,240,1540,149,10506,91
18806,12,354,1350,271,13870,83
67790,484,11398,227,9174,89297,2224
31768,17,383,1104,235,5605,148
21194,285,4495,1308,2907,17655,1588
3279,56,1041,1538,746,35020,295
29672,10,519,1143,323,19433,196
57049,29,257,560,229,6728,28
60136,98,1247,462,860,16535,387
54099,56,246,649,209,5954,37
27542,513,9476,1183,6538,73706,2938
54368,412,10835,639,8702,42295,2133
20315,760,18064,1324,11377,54704,6687
48298,8,143,818,111,17748,32
41910,13,307,899,216,7984,91
9856,198,5131,1470,3270,30107,1861
57184,387,7690,556,6314,56004,1376
7657,248,7364,1483,4864,37193,2500
2336,276,10651,1546,7099,40778,3552
52456,171,3884,700,3271,43165,613
2789,46,1321,1542,972,18667,349
21370,34,311,1305,238,24150,73
39555,340,3283,936,2419,24731,864
66922,41,404,255,325,7722,79
31170,1807,36605,1113,26285,482212,10320
4020,14692,401910,1530,240530,768748,161380
61072,34,388,426,289,9355,99
13452,1,94,1435,66,4401,28
56672,11,180,570,130,6649,50
26262,39,1240,1212,764,10747,476
20119,3,269,1327,205,19479,64
26199,20,568,1214,394,25405,174
15591,117,4361,1405,3047,31736,1314
3250,53,1731,1538,1218,31859,513
48906,40,442,800,344,12361,98
37118,12,413,989,273,8135,140
48551,53,1047,804,797,24256,250
50900,113,1717,747,1270,14813,447
39873,54,1525,931,1259,20878,266
61233,786,10582,420,8579,44892,2003
31009,133,5152,1116,3472,23987,1680
42872,15,361,883,293,10693,68
46440,19,316,842,260,11249,56
37726,5,61,971,48,3372,13
9481,2,119,1473,78,11980,41
25706,294,10131,1224,6752,57113,3379
32397,14,180,1095,111,3780,69
18979,7,224,1347,134,8509,90
59327,385,3745,489,3264,25570,481
61752,1368,29147,405,23222,133315,5925
39986,38,456,930,343,12274,113
57229,33,509,555,348,21611,161
27180,13,470,1192,281,7293,189
69101,372,4123,183,3276,29670,847
30090,146,3763,1133,2534,37880,1229
61192,23,287,422,212,4837,75
43449,9,194,875,140,16654,54
38638,550,28527,948,21329,67305,7198
21385,8,306,1304,223,9360,83
17544,2,68,1373,48,3459,20
1278,16,897,1554,589,22935,308
43401,139,3004,876,2534,62048,470
67441,185,5236,238,4026,41356,1210
56532,221,1721,574,1547,29433,174
40082,9,124,928,88,7159,36
2222,83,3044,1547,2115,20325,929
27482,239,6112,1185,3882,41833,2230
21007,14,358,1311,241,11634,117
4545,13,387,1523,248,5756,139
31766,676,6982,1104,4729,33294,2253
23117,411,7303,1278,4032,63069,3271
33012,25,483,1083,267,18649,216
52842,73,721,686,565,10978,156
53917,972,9397,656,7766,46640,1631
29492,501,8098,1146,5011,74081,3087
13803,129,5425,1430,3554,28347,1871
53608,394,4977,666,4229,93702,748
19499,21,921,1338,480,12895,441
43817,8,154,872,127,2984,27
37033,54,1101,991,750,11077,351
61124,221,3835,424,3054,17864,781
66949,9,138,254,99,2597,39
33118,31,543,1082,330,8641,213
5096,13,541,1516,364,18720,177
22457,14,502,1289,369,12171,133
6591,94,2003,1497,1460,15870,543
18254,0,0,1360,0,10154,0
48669,626,10354,807,8748,73031,1606
20031,47,860,1328,529,15713,331
52255,10,97,707,62,3602,35
49792,219,2325,774,1782,25409,543
14991,37,701,1414,507,7566,194
2759,16,626,1543,469,31835,157
29154,18,852,1151,510,15329,342
21887,3102,94763,1297,62667,481783,32096
28804,18,666,1159,357,10113,309
35370,19,573,1033,437,6450,136
69300,0,8,177,7,616,1
70263,10,64,145,60,4461,4
3997,34,1788,1530,1306,20926,482
68205,5,116,214,90,2377,26
58383,41,486,521,408,8594,78
65740,172,3110,291,2489,25316,621
19193,964,32351,1343,22432,249607,9919
14041,11,362,1426,226,13739,136
54730,1420,9080,626,7467,42565,1613
29122,3,301,1152,189,5476,112
1290,8,378,1554,276,17561,102
57866,10,120,537,100,3519,20
31701,590,11068,1105,7325,53070,3743
21042,27,546,1311,360,11748,186
49823,43,433,774,381,6071,52
37046,393,8221,991,6088,47588,2133
29413,31,1236,1147,791,29426,445
55306,193,1781,609,1346,13904,435
63020,62,856,367,669,4824,187
27104,13,996,1193,574,15383,422
27764,151,3800,1179,2139,20705,1661
11344,599,15970,1460,9654,59988,6316
19471,118,2782,1338,2223,61923,559
16576,184,17433,1390,9213,41669,8220
37471,20,791,978,662,8631,129
34250,88,1964,1060,1352,16188,612
50837,16,375,749,312,10138,63
18757,62,926,1351,585,16876,341
15958,378,3920,1399,2884,30392,1036
33598,3121,58318,1069,47793,281784,10525
18952,4936,128020,1348,84631,292682,43389
33917,10,116,1066,102,3446,14
6417,28,1499,1500,1093,21631,406
59169,28,269,495,246,10785,23
46278,27,463,843,372,12626,91
38423,8,176,953,144,7905,32
63956,1,79,341,51,3907,28
2609,27,556,1544,408,25016,148
17038,33,1827,1382,1272,43303,555
11085,4227,69587,1462,38411,133473,31176
20776,14,808,1316,616,22499,192
4054,14,356,1530,245,23212,111
34160,11513,362361,1061,246488,1827038,115873
28187,174,5964,1170,4147,26298,1817
69062,42,598,184,537,11222,61
34313,90,1196,1059,815,16916,381
18315,125,4129,1359,2983,80335,1146
42532,64,657,889,509,15566,148
14109,11,368,1425,233,17433,135
59255,13,169,492,143,7663,26
64286,181,2069,326,1798,17154,271
48141,7,172,820,141,7283,31
44141,6,202,868,146,11215,56
34143,21,628,1062,451,15575,177
3364,38,1806,1537,1197,27254,609
20235,88,1922,1325,1491,25791,431
63751,3,93,348,51,6527,42
10253,26,993,1468,680,16630,313
34055,44,1002,1063,716,30931,286
70292,4,77,144,66,2821,11
17558,8,177,1373,149,14814,28
67118,7,47,249,39,1575,8
57645,101,1368,545,945,10269,423
19118,78,3625,1345,2497,40091,1128
5077,22,1789,1516,1124,19058,665
30821,128,3722,1119,2394,26520,1328
39462,24,393,937,324,27139,69
13012,25,1125,1441,541,7676,584
62736,72,493,374,417,12347,76
8200,1072,39531,1478,23603,133117,15928
27744,42,804,1179,607,7346,197
12827,4,344,1444,136,28151,208
22132,1814,33264,1294,21463,105828,11801
34511,6,263,1054,157,11080,106
64510,1191,20995,324,16694,97394,4301
27747,689,28577,1179,21272,144020,7305
33538,2,114,1074,80,5473,34
17413,78,2536,1376,1905,31110,631
18069,12,758,1363,528,18416,230
67705,11,301,230,192,4174,109
61295,12,61,418,38,3241,23
32282,3186,125282,1097,80002,603067,45280
32387,10,228,1095,171,7580,57
64834,8,65,314,48,1331,17
16197,2005,40776,1396,28953,177413,11823
21448,38,814,1303,607,4614,207
67182,55,745,246,559,10753,186
30507,3,166,1125,112,14893,54
44051,158,3061,869,2659,29683,402
5748,72,1736,1508,1289,19787,447
56439,55,983,577,780,15500,203
5536,45,1654,1510,1027,34126,627
63048,14,172,367,133,5677,39
16412,354,12184,1392,8809,74417,3375
50753,567,8061,751,5796,45357,2265
2869,61,2214,1541,1497,42314,717
49294,597,7287,788,5478,64180,1809
62988,12,218,368,165,7085,53
70243,52,662,146,637,8496,25
1739,188,12439,1551,7637,88661,4802
14031,422,7641,1427,5109,126437,2532
10472,13,1372,1467,759,12593,613
7110,70,3684,1491,2402,33723,1282
63072,5,70,366,46,4578,24
32568,55,631,1091,432,7012,199
19857,2,189,1332,132,9433,57
46546,40,1072,840,911,22059,161
54549,49,331,633,286,7517,45
48894,606,7249,801,5903,85522,1346
66689,35,516,263,416,9869,100
43181,77,983,878,768,13235,215
39206,7,467,940,351,14528,116
54569,1,48,632,31,3478,17
56354,182,1270,580,990,10945,280
42,272,15002,1566,9842,237008,5160
68515,2,54,203,52,3235,2
65543,17,213,296,180,3842,33
60189,101,1027,460,859,8515,168
1424,56,1376,1553,1001,15941,375
62058,9,186,393,154,7629,32
4028,151,5160,1530,3233,64053,1927
12380,14,2004,1450,779,27641,1225
692,435,11804,1559,7496,44968,4308
51473,16488,249437,731,196510,920166,52927
36967,50,1057,993,836,15488,221
46815,62,976,837,767,7870,209
62077,4,42,393,29,1465,13
26720,590,9347,1202,6219,120063,3128
49161,252,2480,792,1993,26690,487
23305,12,344,1275,228,18938,116
21790,965,22574,1298,13482,88764,9092
1595,3,161,1552,110,12412,51
28714,3938,93526,1160,57548,563672,35978
40560,11,156,921,125,8594,31
59604,11,282,479,112,8488,170
67548,53,820,234,610,12390,210
2043,949,23923,1549,16563,82303,7360
68960,4,50,188,39,9160,11
52349,133,2495,697,1961,23468,534
24299,5,358,1255,172,10950,186
23676,13,514,1268,370,8821,144
30575,118,2750,1124,1799,19102,951
66717,147,2356,260,1983,22808,373
4056,425,14919,1530,9549,46936,5370
56892,24,547,564,405,12342,142
34921,8,180,1044,125,2363,55
56893,115,1579,564,1272,12339,307
31628,11,273,1106,179,3850,94
35347,16,280,1033,191,6222,89
63779,8,95,347,71,4314,24
18844,4,125,1349,111,8963,14
67,12,942,1566,711,50744,231
36447,43,788,1004,617,20899,171
51122,44,572,740,464,16343,108
49646,10,127,778,94,4825,33
5075,146,6756,1516,4374,56529,2382
49159,62,1331,792,927,19781,404
58180,0,58,527,35,4473,23
36975,193,2338,993,1906,27030,432
15757,60,1582,1403,1117,21557,465
37117,318,5370,989,4232,29511,1138
37211,107,1690,986,1420,21494,270
60085,690,9670,464,7351,33169,2319
25891,257,4596,1220,3079,36064,1517
69331,40,380,175,342,4555,38
28408,75,1096,1166,722,12924,374
12017,674,23104,1454,13952,87708,9152
58114,21,451,530,339,6395,112
61595,36,359,410,296,6334,63
56272,1,45,582,20,2613,25
16996,58,2215,1383,1615,18134,600
29714,51,1374,1142,759,7594,615
24966,23,470,1240,283,4596,187
31039,5525,113747,1115,79361,216078,34386
67867,83,1247,224,1053,12974,194
51481,22,279,731,232,7807,47
22582,157,7817,1287,5199,53533,2618
27017,43,2273,1195,1417,22596,856
19247,182,2837,1342,2040,22840,797
16392,285,5617,1392,3687,64797,1930
49712,36,589,765,525,14075,64
20661,2,107,1318,88,10204,19
3670,43,725,1534,464,12574,261
59771,9,158,474,133,4107,25
51443,72,990,732,611,8188,379
754,14,850,1558,556,26758,294
4010,161,8127,1530,5169,59351,2958
32129,17,427,1099,328,16463,99
58222,10,135,526,102,9001,33
39570,277,2927,935,2205,22735,722
10622,1089,45627,1466,29446,236138,16181
34432,498,11685,1056,8884,89278,2801
35318,2448,48081,1034,36150,201962,11931
7289,28,1234,1488,949,40339,285
24365,176,3376,1253,2615,30594,761
28210,20,468,1170,285,21704,183
11361,39,962,1460,544,7944,418
67908,6,18,224,18,1449,0
34531,1,30,1054,20,4558,10
35414,3,114,1032,76,12566,38
28634,201,3936,1162,2440,14291,1496
19219,7,245,1343,188,11407,57
55897,823,10601,593,9016,59358,1585
7269,76,3675,1488,2622,36626,1053
61897,60,1689,400,1311,21147,378
15064,6,419,1413,297,24524,122
4249,58,1199,1527,794,30423,405
61400,33,738,416,513,7313,225
31230,215,3420,1112,2409,34029,1011
11687,38,491,1457,252,3583,239
283,994,29800,1562,22836,296512,6964
28655,258,5260,1161,3273,63458,1987
40449,18,659,922,531,13174,128
65581,4,45,295,39,2019,6
23286,23,695,1275,530,21193,165
36185,537,17019,1013,13372,38042,3647
11080,56,2908,1462,1808,18832,1100
54851,145,1248,622,1009,14008,239
31337,16,556,1110,359,7155,197
15736,25,765,1403,533,10984,232
51221,23,343,738,240,3418,103
17043,12,403,1382,319,10645,84
37613,24,611,974,360,16955,251
52908,38,662,684,460,17819,202
62159,93,874,390,742,11324,132
2834,17,175,1542,115,5824,60
7241,9453,249614,1489,143704,695014,105910
36382,8,182,1007,136,17976,46
20184,40,1505,1326,912,22348,593
69612,3,94,157,69,5204,25
63426,44,811,357,751,13532,60
1303,44,1413,1554,969,16194,444
32732,20,491,1089,418,5168,73
64292,11,123,330,103,6345,20
33916,1910,24173,1067,15095,62003,9078
69344,10,159,175,146,2757,13
63713,143,1351,349,1079,18930,272
11554,574,50809,1458,25148,151733,25661
31394,40,459,1110,371,7317,88
16851,447,16762,1385,10666,341961,6096
28841,49,602,1158,373,8618,229
16617,1451,31002,1389,21641,137097,9361
68221,721,10103,213,7761,62551,2342
65917,11,123,286,90,3890,33
68825,23,240,192,200,5642,40
70173,29,460,148,407,3280,53
14679,15,736,1418,557,15140,179
64559,1577,19813,323,15761,104598,4052
27310,77,1664,1189,1047,16436,617
6933,21,752,1493,508,21676,244
3866,85,2080,1531,1505,66538,575
36734,196,3535,999,2686,17015,849
56285,26,480,581,404,9876,76
10205,58,2342,1468,1406,22041,936
69537,1,126,169,76,7086,50
38274,13,204,957,164,3311,40
40688,8,458,919,406,13464,52
59105,40,305,497,236,10906,69
18559,14,546,1355,385,10374,161
34834,9188,207000,1046,135037,793377,71963
36255,55,551,1011,429,6195,122
11153,8,264,1461,140,14708,124
25306,62,2761,1233,1666,17191,1095
39777,50,664,933,506,16615,158
378,506,20077,1561,13139,96768,6938
64413,223,2271,327,1764,12113,507
33726,6,372,1070,235,9802,137
19649,0,43,1335,32,6022,11
51051,23,369,743,289,5528,80
35578,10,241,1028,182,5875,59
55485,311,5620,604,4107,52125,1513
65680,35,328,292,252,4399,76
37790,299,5431,969,4367,42548,1064
60480,9,114,449,90,2501,24
63807,10,214,346,162,9383,52
25589,25,641,1227,433,12377,208
52348,445,4150,704,3323,29025,827
2657,70,2802,1544,1836,103389,966
23826,3347,37039,1265,28796,429542,8243
13011,7,345,1441,197,21680,148
48696,40,252,807,200,6662,52
63420,4,52,357,42,4145,10
56838,43,608,565,493,11940,115
61780,94,1239,403,968,13925,271
5986,32,1444,1505,962,10584,482
4297,43,1711,1527,1146,37227,565
10544,29,1430,1466,902,28281,528
62252,1312,27977,387,22910,140091,5067
49993,17,489,770,389,7875,100
15396,221,4635,1408,3415,70133,1220
13173,1338,103202,1439,55700,263557,47502
15915,132,3770,1400,2721,23734,1049
48572,609,5650,809,4455,36762,1195
37333,45,1579,982,1314,17882,265
8231,49,1803,1478,1117,16769,686
67436,57,2709,239,2178,35173,531
25071,89,1869,1237,1064,8690,805
5415,19,514,1512,387,13027,127
13170,1068,36345,1439,19746,191597,16599
25607,10984,213979,1227,136788,488033,77191
26169,3,120,1215,79,5674,41
23872,22,1207,1264,801,38762,406
1206,22,456,1555,295,29741,161
13649,0,0,1432,0,18912,0
30268,64,1540,1130,1010,27003,530
37870,453,8416,968,6774,94783,1642
21983,170,2815,1296,1782,29470,1033
60265,22,194,457,179,4547,15
12543,35,2772,1448,1538,28642,1234
10716,4,165,1465,98,22247,67
59323,54,719,489,535,19337,184
30581,72,2646,1124,1475,9423,1171
22114,35,1169,1294,864,18270,305
24491,67,1322,1251,821,13432,501
56375,6,59,579,40,2556,19
40912,346,4192,915,3259,25739,933
20866,142,3125,1314,2217,33500,908
64911,45,388,312,317,10854,71
58963,182,1991,501,1566,14114,425
27905,13,504,1176,184,6441,320
27963,0,0,1174,0,5845,0
6690,322,8565,1496,5445,39670,3120
42318,294,4524,893,3381,40002,1143
13748,389,12710,1431,7971,139889,4739
12480,208,4678,1448,3349,44608,1329
42616,1964,31955,887,25830,220453,6125
1988,79,1555,1549,999,29788,556
50354,0,31,760,22,5340,9
9247,14446,444027,1474,294953,1357971,149074
18917,3,315,1348,208,4679,107
58952,13,90,502,74,4183,16
3178,112,6873,1538,4474,47441,2399
19450,10,402,1339,273,10977,129
43057,203,2479,880,1895,32571,584
35149,18,537,1038,352,4839,185
27676,1498,30403,1180,19595,205132,10808
5847,23,680,1507,492,22535,188
60881,14,181,434,139,5374,42
13142,623,28203,1439,17015,168038,11188
48748,231,3819,805,2518,26377,1301
6483,108,2367,1499,1693,62232,674
2556,9,567,1544,364,12082,203
23740,52,1581,1267,1009,12280,572
56407,21,375,578,316,8306,59
40138,5,70,927,55,8703,15
69731,46,513,163,486,8763,27
11899,183,2538,1455,1453,24063,1085
4227,8,155,1528,100,8022,55
59078,444,9722,498,7160,32381,2562
41510,10,213,906,197,17583,16
19379,299,11560,1340,8856,67214,2704
938,68,3861,1557,2816,26567,1045
65262,7,44,303,33,1846,11
11763,12,713,1456,350,5222,363
35708,2405,53922,1025,40204,160809,13718
19200,2,102,1343,71,5064,31
66069,6,71,282,51,1981,20
55654,45,383,599,298,7536,85
38088,31,241,962,162,5105,79
21771,61,1745,1299,1289,39996,456
37530,12,168,977,122,5875,46
9089,23,1007,1474,589,34583,418
32373,28,551,1095,334,6889,217
3735,3,220,1533,162,13783,58
36972,3,64,993,39,5700,25
11921,20,804,1454,481,42510,323
5046,33,1927,1516,1339,57216,588
18376,42,2751,1358,2024,49998,727
9037,3031,71847,1475,39997,118653,31850
18170,38,1348,1362,1046,23379,302
18111,20,749,1362,596,12587,153
3420,87,3202,1536,2383,45075,819
32334,8,485,1096,314,17950,171
39266,0,32,939,26,3231,6
330,158,5551,1562,3251,31527,2300
34607,805,23407,1052,16186,73988,7221
57191,58,633,556,489,9640,144
26957,165,8076,1196,5560,65109,2516
31016,529,6986,1115,4780,20182,2206
1301,13,675,1554,486,16950,189
14372,16,387,1422,298,10140,89
30747,547,9569,1120,6242,48614,3327
69074,11,171,184,136,3765,35
27653,62,1322,1181,815,13669,507
31894,14,261,1102,160,3696,101
60891,15,175,433,113,8009,62
61313,31,281,418,242,5765,39
12752,1070,33868,1445,22742,135611,11126
57965,166,2475,534,2058,32222,417
69295,33,300,177,251,3262,49
31022,4,65,1115,48,8188,17
29111,502,12897,1153,8639,111381,4258
16553,16793,347997,1390,208274,768445,139723
69022,31,259,185,219,2124,40
299,20,1336,1562,795,45635,541
31878,4,257,1102,168,6893,89
14492,96,3067,1420,1817,70902,1250
52397,8700,167320,702,124378,531740,42942
34092,149,3293,1062,2083,17871,1210
65034,1716,5748,307,4713,357297,1035
4467,99,4020,1525,2207,27116,1813
51831,84,2679,721,2054,20651,625
909,5,537,1557,354,21193,183
47747,28,292,825,242,10986,50
26364,9,242,1210,154,9639,88
8074,710,16159,1479,11790,103977,4369
11930,553,40551,1454,21909,190933,18642
9467,6,104,1473,72,7769,32
3983,322,13306,1530,9001,143501,4305
34060,1276,34722,1063,25420,143569,9302
18807,16,228,1350,178,20800,50
60069,2,41,464,26,3205,15
28780,2842,56882,1159,37109,261515,19773
48355,77,2322,817,1703,18262,619
23915,46,853,1264,624,17072,229
16976,1770,33884,1383,21273,267903,12611
24781,28,440,1244,342,16385,98
55932,7,85,592,76,5745,9
31409,11,266,1110,182,7862,84
50004,38,429,769,362,13389,67
30606,31,736,1123,443,11765,293
61424,17,225,415,175,4154,50
10998,54,3133,1463,1988,31420,1145
39872,713,10200,931,8368,128009,1832
16692,53,637,1388,536,5007,101
50735,113,1467,751,1069,10930,398
36831,53,624,997,529,9856,95
50674,698,11770,753,9435,114152,2335
18490,56,1798,1356,1255,13652,543
5090,29,680,1516,459,34711,221
50759,61,814,751,605,10733,209
18935,48,1437,1348,1047,19086,390
37478,389,11205,978,8507,125778,2698
57349,11,206,552,139,4731,67
10297,294,7406,1468,4982,60310,2424
8101,369,13374,1478,8702,44537,4672
43899,1753,27968,871,23860,133437,4108
58705,4008,86064,509,61886,193167,24178
22333,1,44,1291,34,5182,10
7400,528,41274,1487,23645,190804,17629
22977,103,3592,1280,2370,28124,1222
63628,165,1925,351,1497,8902,428
10299,82,1560,1468,935,17703,625
52645,39,501,693,416,7534,85
70180,2,24,148,23,1036,1
10546,161,6975,1466,4988,47416,1987
18747,30,635,1351,451,7552,184
598,37,2167,1560,1461,23031,706
51152,14,173,740,119,7755,54
60128,108,2016,462,1607,15958,409
19457,42,1330,1339,982,22075,348
27785,472,15779,1179,10577,121964,5202
68367,305,7379,209,5541,58324,1838
6699,6,165,1496,117,5257,48
18902,313,7799,1348,5443,55752,2356
14127,0,316,1425,217,15702,99
30425,46,1164,1127,685,16609,479
43924,36,729,871,643,18841,86
55158,230,2722,613,2208,21856,514
59786,43,333,473,253,5754,80
70583,0,5,134,5,798,0
54652,178,4006,629,3211,47235,795
42626,135,1325,887,966,17076,359
1991,0,2642,1549,1699,39484,943
5031,22,760,1516,510,25315,250
7425,8,284,1487,197,20800,87
3840,37,1446,1532,1050,32225,396
30048,83,3118,1134,1706,16522,1412
62005,19,139,396,73,2299,66
20252,19,441,1325,343,12677,98
36909,64,1797,995,1565,33128,232
21599,16,863,1301,609,9121,254
32979,2698,47382,1084,31716,114203,15666
1623,29,965,1552,659,13250,306
48929,201,3275,799,2597,29772,678
19262,116,2248,1342,1616,40194,632
28054,29,840,1173,513,6789,327
30154,903,18456,1132,11121,55544,7335
28593,138,2504,1163,1670,27249,834
68827,16,153,192,145,7054,8
4605,223,5330,1522,3636,43258,1694
39719,181,4320,934,3458,51944,862
37667,8,125,973,111,9726,14
21481,55,2195,1303,1547,23282,648
48938,12976,378642,799,244180,826658,134462
5146,138,5887,1515,3850,18352,2037
33425,74,2440,1076,1602,45470,838
12150,76,3485,1452,2065,17448,1420
54066,228,3030,651,2401,38584,629
30512,0,38,1125,22,4905,16
28851,8,139,1158,130,11505,9
31581,7577,154029,1099,119801,541745,34228
15301,50,1770,1410,1179,19349,591
52132,4,36,711,30,6428,6
12383,780,22826,1450,14928,123747,7898
13348,11372,384665,1437,202931,1074671,181734
12084,71,2658,1453,1425,27186,1233
66606,3,23,266,18,1698,5
766,48,1695,1558,1214,40067,481
23195,9,199,1276,126,8177,73
38355,2,101,956,83,3436,18
69887,5,36,157,29,3393,7
55514,3,50,603,45,3030,5
55531,60,732,603,569,6884,163
26357,478,5735,1210,5033,66412,702
57551,90,901,543,734,11773,167
37191,103,3066,986,2657,31014,409
41669,83,2947,900,1994,27266,953
14844,254,7548,1416,5267,51098,2281
4742,51,2444,1520,1509,18483,935
28545,7631,192471,1164,130175,693435,62296
51142,7,45,740,32,4130,13
41686,19,241,902,188,8640,53
48293,237,4550,818,3705,28972,845
13258,88,2925,1438,1714,32826,1211
10342,2713,75661,1467,55102,364796,20559
25338,22,655,1232,446,10245,209
13486,52532,1497539,1434,822171,3518437,675368
68974,20,256,187,167,6824,89
25993,54,2678,1218,1652,23869,1026
12278,19,1089,1451,585,8961,504
63055,1,20,366,7,5169,13
34784,38,1244,1047,780,16569,464
4196,144,5175,1528,3794,90239,1381
48478,120,1063,814,822,10600,241
15928,19,453,1400,352,22137,101
65323,7,149,301,122,3980,27
37686,106,3495,972,2718,18623,777
30186,47,852,1131,657,26540,195
1123,4716,227181,1555,133133,349431,94048
47888,534,11476,824,8816,109553,2660
63746,64,1075,348,894,16473,181
23409,172,6165,1273,3937,63392,2228
9171,23,821,1474,519,12091,302
20180,32,608,1326,364,6543,244
66881,63,2293,256,1785,18368,508
64643,24,363,320,317,8713,46
21225,713,5329,1307,3638,33395,1691
23532,204,5190,1271,3816,70521,1374
39805,131,3452,932,2351,18485,1101
25382,2231,59486,1231,34089,267064,25397
54703,2523,34797,627,29299,216637,5498
62935,7,61,369,51,1985,10
12819,148,4057,1444,2455,43542,1602
38242,18,363,958,305,10986,58
69499,6,141,171,125,2420,16
37212,27,678,986,536,18356,142
7485,745,63557,1486,34524,395747,29033
48423,7,214,816,170,16161,44
38037,71,1118,963,842,22740,276
16844,183,4656,1385,3301,66589,1355
65743,16,137,291,115,2096,22
67215,7,40,245,30,1060,10
60981,43,285,430,246,6225,39
5725,136,7148,1508,3621,26472,3527
21978,12,310,1296,180,4198,130
35184,30,610,1037,447,10260,163
62154,53,1131,390,961,15113,170
60905,18,222,432,169,6191,53
8525,3,192,1477,117,3561,75
6370,19,607,1501,430,29981,177
52176,44,492,710,387,9163,105
3244,9,349,1538,250,16348,99
11956,85,5306,1454,3271,44103,2035
58339,68,1209,522,999,16098,210
57311,145,1726,342,1393,21303,333
3298,46,1592,1537,1085,9801,507
31935,181,5366,1102,4313,45420,1053
36904,68,1476,995,1194,11484,282
4672,43,2568,1521,1699,31615,869
54487,85,755,636,616,19353,139
38213,7,224,959,175,10861,49
11645,216,15848,1457,8665,51408,7183
47939,22,658,823,520,24029,138
8770,6,229,1476,133,6428,96
33964,2,136,1066,90,8936,46
56891,13,259,564,185,4905,74
21076,4,216,1310,157,6953,59
17734,44,1490,1369,952,29574,538
36918,74,1279,995,1001,10356,278
31173,459,12130,1113,7232,33491,4898
12584,25,669,1447,412,25395,257
65158,22,219,305,191,3165,28
23542,53,1095,1271,795,20053,300
3713,1,143,1533,100,21049,43
54149,1,23,648,20,2281,3
12845,854,15155,1444,9379,46411,5776
59294,149,1594,490,1346,14662,248
59036,342,4601,499,3588,22912,1013
12649,95,8599,1446,4267,33422,4332
54144,160,2136,648,1609,18772,527
42610,5,153,888,120,17711,33
12047,156,5267,1453,3016,26851,2251
17721,13,620,1370,424,21008,196
29897,47,1078,1137,695,8844,383
24158,40,685,1258,546,11299,139
57150,13,205,557,132,6716,73
11033,0,600,1462,352,8035,248
67021,752,10798,252,8279,78705,2519
66220,12,65,277,52,3158,13
5262,85,1453,1513,1041,35061,412
28484,93,2435,1165,1468,28178,967
29968,696,7305,1136,5185,23031,2120
50224,565,8600,764,7070,110384,1530
70042,12,211,151,196,3562,15
26799,23,259,1200,203,10688,56
24267,101,3178,1256,2053,21669,1125
25644,112,4293,1225,2704,69629,1589
27118,41,583,1193,501,20772,82
54892,130,1405,620,1080,12955,325
42073,31,381,896,267,3649,114
26428,34,292,1208,193,4619,99
62164,29,373,390,254,5970,119
68597,370,7850,200,6663,50799,1187
58684,12,102,510,72,2951,30
3711,13,433,1533,273,15010,160
15997,91,1260,1399,958,18208,302
21729,7,285,1299,199,4522,86
62093,115,1631,393,1333,17193,298
30081,8,178,1133,130,8144,48
5731,15,260,1508,163,5718,97
6285,109,7007,1502,4266,50585,2741
16853,9,370,1385,280,10705,90
18398,227,35667,1357,21921,94637,13746
61882,4,88,399,71,11935,17
63836,21,416,345,275,12107,141
26442,1031,34521,1208,21470,89238,13051
31784,21,441,1104,332,4218,109
64970,10,164,309,130,3531,34
22027,15,490,1295,397,9924,93
27678,93,3711,1180,2402,24639,1309
61705,32,519,406,400,6855,119
55116,545,9670,614,7202,65157,2468
11528,44,1886,1458,1158,50343,728
57573,11,157,547,118,3973,39
15027,20,272,1414,225,20286,47
6340,12,299,1501,212,20112,87
37832,74,1261,969,842,11313,419
30867,45,833,1118,544,7702,289
62431,49,716,382,592,10394,124
29489,28,374,1146,316,8250,58
30761,149,3665,1119,2301,26785,1364
2840,213,7843,1542,5705,60603,2138
1244,117,2781,1555,1944,31576,837
7165,9,316,1490,200,8417,116
59371,13,248,488,141,4267,107
29608,20909,618825,1144,381764,964897,237061
30772,7,244,1120,170,3465,74
50671,471,8564,753,6897,31578,1667
35599,14,266,1027,218,9319,48
906,4,230,1557,167,11690,63
33484,169,4204,1075,2729,20545,1475
30939,157,10069,1117,6397,46524,3672
29167,7487,135158,1151,80931,471899,54227
5151,159,4629,1515,3210,39080,1419
20367,408,7252,1323,5031,41867,2221
16627,23,1142,1389,710,16104,432
5853,1016,44354,1507,28134,316218,16220
48429,4,223,816,170,12158,53
9514,5479,100490,1472,64739,310858,35751
53960,0,14,655,14,2432,0
53666,59,907,664,728,11938,179
33760,9,389,1069,252,6661,137
6366,174,4185,1501,2918,120920,1267
29487,25,1141,1146,800,14030,341
59202,8473,226225,490,168929,792442,57296
59172,65,739,495,588,8525,151
22227,28,1018,1292,613,18310,405
70440,3,182,139,173,1195,9
55194,4,64,612,42,6671,22
26484,14,630,1208,372,5638,258
57001,3,59,561,54,2291,5
39104,7,105,941,76,8608,29
31041,151,3001,1115,2153,54281,848
37335,188,2316,982,1816,13220,500
33576,692,16983,1073,12470,76983,4513
17129,26,356,1381,289,8053,67
68619,32,439,199,380,5120,59
4670,1036,28441,1521,18762,100593,9679
49620,676,16390,777,13262,77973,3128
61628,76,1291,408,1012,14667,279
8547,123,2724,1477,1596,20958,1128
42832,51,893,884,640,14071,253
18485,47,1612,1356,1218,20296,394
23097,28,796,1278,527,37696,269
50966,234,2629,745,2159,26123,470
16264,73,2610,1395,1790,75665,820
740,239,5401,1558,3956,41934,1445
58394,923,12364,520,9402,102253,2962
51564,33,637,728,537,16289,100
30265,0,79,1130,62,3291,17
40556,2,166,921,122,5603,44
9544,608,14104,1472,7908,46784,6196
28599,227,3404,1163,2018,22079,1386
14593,34,454,1419,353,16160,101
34847,39,342,1046,258,9531,84
30177,18,427,1131,259,5888,168
37002,16,329,992,258,13034,71
32134,100,2302,1099,1387,15055,915
6691,12,313,1496,237,15173,76
19107,2368,49175,1345,31435,187983,17740
25573,2,71,1228,54,10807,17
44252,39,675,866,497,9401,178
11170,24,1596,1461,947,26049,649
60612,82,1051,444,867,13151,184
49149,7,102,793,76,5011,26
31949,86,2813,1102,1718,25637,1095
35859,63,1639,1022,1114,7319,525
17404,12,395,1376,270,8958,125
16129,86,1586,1397,1074,23884,512
64864,13,192,313,107,5733,85
2376,16,1752,1546,1151,58830,601
23071,5,194,1278,132,8521,62
64246,38,514,332,417,6802,97
1243,126,3994,1555,2458,35509,1536
67337,87,1325,241,1022,13830,303
60438,923,12755,451,9576,51420,3179
25510,69,1912,1229,1217,12639,695
55404,6,84,606,60,5226,24
5097,3,97,1516,64,15660,33
67188,86,1062,246,836,5451,226
5014,619,23061,1517,15748,236396,7313
62494,43,749,381,560,9578,189
33619,7,117,1072,89,2822,28
67656,246,3457,232,2861,39354,596
13042,22,1057,1441,593,46957,464
51477,69,1105,731,910,16109,195
14640,10,308,1418,208,11389,100
59332,10,226,488,183,5889,43
43765,1734,42241,872,32573,415330,9668
12271,31,1235,1451,679,14454,556
70038,5,43,152,41,2682,2
7405,5273,161861,1487,108565,330138,53296
64729,13,147,318,111,3919,36
20853,29,623,1314,442,8639,181
54326,586,19788,532,10627,123349,9161
31919,4,99,1102,69,4465,30
64316,24,107,330,86,20090,21
34371,157,5304,1057,3613,25362,1691
36527,225,3635,1002,2544,15768,1091
9470,16,478,1473,325,13929,153
1822,181,4381,1550,3273,25541,1108
58572,31,344,514,260,5778,84
30730,0,86,1121,66,16698,20
3650,15,728,1534,533,21300,195
23435,8676,197669,1272,133231,556716,64438
32063,59,2033,1100,1386,25933,647
57373,11,187,552,144,3036,43
48563,508,11006,810,9383,143011,1623
2106,3,198,1548,141,15197,57
61748,8,48,405,40,1297,8
44843,47,769,860,625,10060,144
69522,82,1298,170,1087,9334,211
52446,63,1033,701,787,21975,246
39963,4,98,930,84,6048,14
57246,113,1377,555,1150,17731,227
18535,11,182,1355,132,12453,50
55223,20,272,611,208,7848,64
14547,472,18055,1419,11857,103746,6198
62280,25,211,387,183,5044,28
35893,564,7540,1021,5813,75510,1727
513,6,271,1560,186,25610,85
14435,1,131,1420,89,5526,42
46824,16,419,837,313,10513,106
55035,332,12242,616,8962,77205,3280
24813,5,220,1243,148,8996,72
60867,27,287,434,217,6545,70
12090,30,857,1453,431,6541,426
19433,16,1107,1339,907,28052,200
49723,2236,38184,776,29300,134864,8884
45203,113,1432,856,1071,23631,361
42099,96,1055,896,850,8931,205
31968,27817,486469,1098,330908,1020403,155561
48379,168,2293,816,1953,29189,340
62101,68,1494,392,1140,15966,354
36991,259,6398,992,4680,32797,1718
54490,27,425,635,348,6710,77
44106,3534,52371,868,38386,261190,13985
19186,85,1876,1344,1417,55239,459
58143,25,333,529,249,6763,84
51123,49,788,740,614,13530,174
43485,28,310,875,253,7398,57
9181,27,1934,1474,1277,22460,657
27355,8,252,1188,158,9297,94
36510,35779,780776,1002,562831,2201672,217945
61892,10,133,400,92,4463,41
8047,51,1134,1479,704,8039,430
64909,13,183,312,164,8168,19
5462,90,2744,1511,2074,78923,670
45687,52,826,851,647,14189,179
58757,41,448,508,370,8851,78
28893,87,2168,1157,1195,20826,973
51334,54,598,735,511,10838,87
60914,11,133,432,108,5050,25
38377,7,194,955,156,3668,38
1582,17,486,1552,337,34414,149
34760,96,1824,1047,896,9732,928
569,289,8390,1560,5991,58297,2399
40022,12,388,929,345,9126,43
60078,12,138,464,117,8307,21
514,476,11846,1560,8219,77382,3627
21205,1119,36955,1308,28017,159833,8938
70519,35,323,136,317,9379,6
18109,10,316,1362,244,12193,72
14417,38,717,1421,533,12561,184
17555,22,621,1373,539,12950,82
51139,6,97,740,76,2629,21
63132,25,367,364,274,3916,93
14489,10,548,1420,391,10507,157
63803,53,831,347,692,6573,139
41307,27,488,909,363,8885,125
30559,0,67,1124,19,3321,48
60653,25,336,442,265,16575,71
47196,82,1090,832,857,9301,233
3010,144,3688,1540,2451,35285,1237
1057,141,3336,1556,2310,44705,1026
29690,1599,67968,1142,54792,204315,13176
962,66,1463,1557,1121,49118,342
46416,377,9670,843,7464,91787,2206
37358,5221,121383,981,90103,282039,31280
4473,2185,62169,1524,34738,161001,27431
2744,247,11428,1543,7537,35307,3891
1956,683,34342,1549,14945,93474,19397
50542,6,199,755,157,3894,42
48851,8,104,802,71,2657,33
29922,602,6242,1137,4123,40428,2119
20816,3,163,1315,124,9954,39
25074,23,697,1237,507,12161,190
16346,22,705,1393,464,30803,241
15420,10,394,1408,292,15995,102
60977,69,1177,430,885,13696,292
51149,2214,27744,727,22418,103968,5326
22057,1130,20941,1295,15644,69511,5297
65028,36,506,305,427,7827,79
15042,64,1403,1413,1086,71595,317
68798,2,10,193,9,2464,1
3322,33,1579,1537,1071,20015,508
23163,10,427,1277,300,10309,127
32313,27,809,1095,500,6333,309
50001,34,358,769,277,5732,81
69834,5,112,154,86,1312,26
11490,64,5322,1459,2739,20824,2583
33641,124,1663,1072,1079,32454,584
67520,13,481,236,339,8330,142
38335,28,895,956,620,11344,275
21379,9,859,1305,730,40977,129
42824,80,1279,884,1000,22394,279
12055,19,713,1453,427,13863,286
11559,0,122,1458,41,3972,81
20141,97,2250,1326,1529,30234,721
67726,8,172,229,109,7539,63
11143,2730,64615,1461,38383,379027,26232
11541,5,188,1458,109,6642,79
511,30,1398,1560,975,54507,423
30466,7018,238845,1126,147188,899305,91657
11698,42,1975,1457,1100,12729,875
5136,26,1352,1515,809,28903,543
59660,116,1451,478,1113,13596,338
50361,48,557,760,411,6958,146
53829,58,1134,659,885,23123,249
25482,3,169,1229,134,10879,35
45975,2,25,847,21,3047,4
32154,137,4258,1098,2887,65192,1371
59811,83,1078,473,910,14443,168
61050,83,1173,427,853,12730,320
27740,4,153,1179,80,4653,73
62041,94,842,395,707,14160,135
70318,22,426,144,419,11113,7
62255,9,96,388,71,4488,25
7054,379,6967,1492,5005,48183,1962
23595,1012,29798,1270,21562,152167,8236
28863,7,129,1158,94,6060,35
66178,210,5958,278,5253,28007,705
49663,18,98,778,75,6131,23
17504,32,1333,1374,1019,22775,314
48850,90,832,802,659,12664,173
52781,13,350,689,252,25064,98
26679,1787,55051,1202,34654,325210,20397
11336,2584,92506,1460,57104,168631,35402
3192,294,16936,1538,11101,139845,5835
48568,141,3005,810,2029,44040,976
63623,2565,63047,352,52420,237568,10627
26784,237,4313,1200,2936,45681,1377
40886,418,8534,916,5573,73803,2961
7357,8,314,1487,233,4397,81
61516,22,338,412,293,12438,45
39870,26116,501257,931,404456,1593739,96801
17527,26,1146,1373,867,13806,279
31910,160,2906,1102,2300,57196,606
34159,629,61283,1061,48469,89185,12814
63397,4,37,357,33,2594,4
51375,56,581,733,448,8959,133
68185,213,4454,214,3884,23434,570
5507,162,4572,1511,3139,59265,1433
8027,4251,111702,1479,63382,216050,48320
23461,52,1150,1272,830,17544,320
28534,11,236,1164,170,6770,66
40277,54,552,925,422,6379,130
59841,330,4026,419,3157,37966,869
11219,912,25952,1461,16855,83315,9097
35970,139,1952,1019,1556,16138,396
18821,41,1220,1350,814,9820,406
26701,43,1574,1202,892,15086,682
9663,3,227,1472,139,8101,88
18735,4,123,1352,89,23812,34
30208,51,3681,1131,1614,13822,2067
21633,562,11960,1300,8100,76354,3860
31723,44,936,1105,637,10800,299
4793,1311,45337,1520,26505,262046,18832
59598,10,106,480,69,5035,37
26005,10,723,1218,448,14108,275
41471,2,69,906,50,8734,19
52140,126,2622,711,2229,16243,393
63010,30,205,368,162,7671,43
11385,535,21191,1460,13752,154748,7439
8102,60,1772,1478,1165,13201,607
6613,53,2781,1497,1952,35294,829
35328,63,1185,1033,888,16508,297
30396,260,5505,1127,4740,64789,765
65596,127,1560,295,1221,6283,339
51962,36,785,717,630,9708,155
7620,25,743,1484,494,20885,249
13871,45,2648,1429,1831,36442,817
40878,48,1264,916,1099,39894,165
26879,15,405,1198,261,5691,144
47551,84,806,827,566,6654,240
51351,160,2030,731,1495,31481,535
7312,5,285,1488,192,12035,93
20534,154,21399,1320,12505,72365,8894
5910,1597,31422,1506,18584,181397,12838
26859,14,438,1198,342,18972,96
42089,3014,69377,896,55098,207665,14279
7360,77,6186,1487,3608,34731,2578
60788,797,8605,437,6827,54168,1778
64560,47,671,323,559,9127,112
29363,179,5952,1148,4655,40883,1297
25373,1795,47697,1231,31524,274262,16173
23510,15,511,1271,351,13549,160
6467,48,1673,1499,1064,54708,609
61643,274,4254,408,3402,32419,852
43913,66,773,871,587,19552,186
4690,252,30009,1521,19591,165937,10418
16321,1,104,1394,62,7530,42
61164,10,142,423,104,5265,38
58134,6,103,529,77,4647,26
15967,5,241,1399,174,5877,67
13220,248,2910,1439,1910,45039,1000
68455,10,105,205,82,5698,23
29439,365,9665,1146,6267,46646,3398
64071,14,116,337,101,7561,15
6537,2054,61199,1498,40156,420511,21043
4177,19,517,1528,388,12178,129
63678,37,231,350,200,6240,31
42676,10,147,886,125,6133,22
46073,389,6720,846,5488,73436,1232
22555,105,1785,1288,1100,15415,685
3193,201,7227,1538,5331,45719,1896
53978,8,132,654,102,9750,30
706,21,673,1559,480,26706,193
37500,681,24458,978,15977,137983,8481
60213,77,1672,459,807,16117,865
24116,1555,25666,1259,16862,60681,8804
70220,3,46,146,39,1862,7
54630,39,192,630,150,6526,42
22194,63,1601,1293,1033,12609,568
51409,67,923,733,796,13760,127
2266,59,2931,1547,2094,34916,837
4003,480,17882,1530,11206,102518,6676
20606,65,1447,1319,1040,19060,407
13490,413,13920,1434,8862,81956,5058
69351,7,127,175,102,3368,25
57096,36,476,558,372,14258,104
20958,27,1490,1312,1026,38793,464
59450,2875,35564,386,28355,134484,7209
20987,2,125,1312,90,10786,35
50340,128,2748,761,2114,32840,634
31802,52,1117,1103,786,22618,331
67017,87,1305,252,893,11099,412
24724,38,1428,1245,956,20297,472
49141,4,126,793,88,4394,38
58314,9,94,523,57,5220,37
44883,223,4717,859,3615,46637,1102
38014,19,443,964,335,2898,108
64192,106,1426,334,1140,10227,286
15555,9,731,1406,494,53651,237
47777,169,2683,824,2018,31585,665
39562,21,544,935,408,10305,136
34260,18,518,1058,336,6254,182
16445,33,837,1392,542,11317,295
31369,75,1761,1110,1117,54449,644
2577,292,8586,1544,5835,72543,2751
70615,1,62,133,48,1500,14
64348,430,6643,329,5526,80410,1117
60900,79,717,433,543,4599,174
28303,10,386,1168,240,22935,146
64357,42,329,328,283,6688,46
31798,75,1978,1103,1405,30361,573
38803,41,1244,944,879,14798,365
56562,3,61,573,41,3122,20
28304,2,169,1168,100,4267,69
55806,98,2121,595,1630,28331,491
59813,19,492,473,312,6113,180
62686,33,573,375,401,7581,172
1893,10,314,1550,219,16321,95
65151,23,367,305,301,7360,66
19980,2,83,1329,65,4856,18
52340,709,10079,704,7870,68407,2209
53290,71,1041,674,794,9156,247
50378,532,6745,760,5267,68586,1478
20398,6,213,1322,161,11238,52
69565,11,177,169,137,1968,40
64352,924,20776,329,17584,74010,3192
33396,26,1212,1076,798,15376,414
57643,96,1298,529,1030,17995,268
18768,7,454,1351,296,32006,158
52989,73,483,682,397,5869,86
50054,186,3340,767,2711,31432,629
69327,32,328,175,288,1961,40
57342,43,745,552,464,14660,281
21408,3,61,1304,51,15852,10
34257,43,1023,1060,819,17197,204
12625,8784,197138,1446,116339,609785,80799
23024,101,2248,1279,1623,19908,625
50246,1619,24556,763,18045,58766,6511
61668,20,125,408,94,6467,31
44039,24,344,869,252,4545,92
13608,23626,832473,1433,566533,2546402,265940
32296,5,319,1091,225,8244,94
68752,29,356,195,290,6845,66
16430,117,1410,1392,1111,20212,299
32062,90,1583,1100,1265,14313,318
41319,1,53,909,46,2054,7
12776,22,553,1445,306,18983,247
58942,25,202,502,150,8174,52
61845,101,1037,402,852,12222,185
56705,255,3046,569,2573,27601,473
7616,51,1272,1484,859,24867,413
66206,87,1353,147,1233,15795,120
59464,249,2918,485,2288,28241,630
47763,0,32,825,23,2640,9
59721,1795,45473,476,36193,264589,9280
8354,46,875,1478,584,8252,291
32340,13,540,1096,319,7938,221
17324,58,1294,1377,908,15491,386
50572,10,156,755,124,4252,32
42174,3,168,895,124,6080,44
1645,92,2704,1552,1853,42036,851
45807,2198,98508,848,64148,394870,34360
51762,10,342,723,270,13289,72
22212,33,1163,1293,765,13050,398
57966,17,241,534,188,5873,53
9487,31,797,1473,478,17411,319
66706,874,28709,262,22819,99366,5890
70314,11,75,144,58,2257,17
22382,1429,40785,1290,25421,298616,15364
31248,19,572,1112,381,10425,191
27508,31,657,1184,347,6479,310
16312,2,148,1394,99,8167,49
65566,5,366,295,272,9434,94
61999,22,287,396,219,9812,68
22921,500,9098,1281,5953,31808,3145
16294,6,210,1394,150,11802,60
30399,86,2379,1127,1526,28148,853
42790,8,268,884,180,10551,88
51417,1600,18263,733,14930,124714,3333
3580,24,1863,1535,1154,27400,709
16672,1,85,1388,60,6181,25
65272,7,32,302,27,2895,5
23296,24,1013,1275,668,10731,345
66291,22,425,275,336,19305,89
23828,244,2575,1265,1805,100141,770
63053,27,347,366,274,6309,73
19622,2079,74213,1336,50625,406793,23588
799,6097,299107,1558,189374,900837,109733
6929,66,1228,1493,797,8612,431
58242,417,12037,525,8092,41680,3945
63727,62,738,348,524,9312,214
63795,44,872,347,559,8360,313
70554,7,108,135,96,7228,12
28944,1928,75896,1156,51501,368695,24395
20507,22,1023,1320,714,16989,309
16696,21,1083,1388,811,16364,272
54909,27,596,620,414,17356,182
63614,2,150,352,79,3138,71
56907,11,113,563,91,3367,22
637,52,1898,1559,1279,25101,619
2190,14,620,1547,370,11754,250
36955,3,37,994,33,2512,4
50036,1,90,768,62,2742,28
13786,69,847,1430,437,12285,410
37997,642,11304,964,9648,105195,1656
65396,8,133,299,67,5012,66
62042,139,1563,395,1319,12474,244
63851,2,26,345,25,3683,1
34515,748,9325,1054,6409,39334,2916
35386,57,1520,1032,1037,10672,483
28491,2341,44844,1165,28135,233967,16709
37606,34,619,975,511,7145,108
26937,35,441,1197,388,10758,53
21303,0,77,1306,58,6728,19
2871,7,365,1541,264,7417,101
4269,3,237,1527,154,28050,83
14558,27,777,1419,573,9302,204
20309,71,1711,1324,1183,26954,528
56452,86,997,577,818,11702,179
10877,27,714,1463,457,10775,257
10094,33,836,1469,546,14722,290
14940,35,948,1415,603,15870,345
4136,5,163,1529,119,8361,44
13027,28,1247,1441,602,14553,645
13211,32,1102,1439,538,11833,564
23367,23,989,1274,714,10255,275
40638,36,347,919,263,4796,84
43063,261,4133,880,3224,27534,909
55438,842,15366,605,11551,149504,3815
63566,31,418,353,349,10210,69
36821,255,5521,997,3811,19494,1710
70364,132,2592,142,2431,32547,161
19715,58,904,1334,675,18210,229
34247,8,484,1060,306,9907,178
1976,2,136,1549,95,21484,41
42054,17,196,897,163,5093,33
8632,22,319,1476,214,5521,105
49082,40,352,794,311,5558,41
16952,107,2890,1383,2212,28252,678
13721,17,490,1431,291,9026,199
28657,3,47,1161,36,4415,11
37154,207,5528,988,3869,82798,1659
60262,20,236,457,206,18935,30
6544,1205,25060,1498,17210,255345,7850
52864,284,2642,685,2113,21075,529
15005,71,967,1414,678,10431,289
52124,25,381,711,256,8744,125
2153,108,3168,1548,2146,41887,1022
33710,23,695,1070,468,16715,227
51370,108,1837,734,1538,29732,299
50881,87,1501,747,1195,43318,306
2799,75,1326,1542,958,28681,368
24280,37,1346,1256,929,39208,417
62480,6,239,381,181,10416,58
19996,1,135,1329,95,3338,40
23441,17,306,1272,207,9869,99
49953,2481,36879,771,29823,342048,7056
43012,15,250,881,190,12310,60
60832,29,301,435,235,2898,66
35064,1,23,1039,17,2522,6
2718,21,1360,1543,1009,37410,351
23289,11,323,1275,216,3035,107
58876,317,3884,504,3051,32124,833
63082,57,891,365,764,10560,127
49151,75,1243,793,917,24704,326
18181,6,146,1361,113,7853,33
54614,155,2225,631,1780,25872,445
30678,27,707,1122,491,11704,216
10687,22,1269,1465,820,32998,449
2122,792,21145,1548,14135,154355,7010
27662,46,1027,1181,714,9582,313
36003,4,162,1017,137,7154,25
36930,37,944,994,774,25295,170
69770,9,136,161,110,3693,26
54032,37,707,652,540,9489,167
65471,115,1350,298,1084,11647,266
56349,155,4220,580,3310,33977,910
35056,2631,76940,1041,49969,212026,26971
70286,8,99,144,94,2351,5
38195,80,937,959,641,11858,296
3618,9,233,1534,189,10647,44
54767,143,1894,625,1552,22324,342
18830,217,6177,1350,4335,39032,1842
59701,336,7054,476,5446,20315,1608
20615,10,895,1319,546,5313,349
8740,222,4591,1476,2980,49398,1611
11577,8,488,1458,252,15828,236
55678,4,35,599,32,7317,3
23471,263,7495,1272,4825,61137,2670
10058,0,0,1469,0,9041,0
48915,494,10887,800,7915,103397,2972
31659,27,410,1106,331,7397,79
51794,125,1338,722,968,8936,370
32503,149,2101,1092,1480,34014,621
18981,8220,312793,1347,192338,1010255,120455
29278,1,115,1149,105,8163,10
38017,324,5684,964,4404,72797,1280
7196,34,1861,1489,1242,21889,619
25535,108,2563,1228,1443,20155,1120
65316,60,594,301,475,4012,119
52417,14,242,702,187,7065,55
17136,156,2146,1380,1556,20848,590
32706,757,12326,1089,8493,106922,3833
37912,302,7265,967,5441,77362,1824
9798,669,15911,1471,11343,38637,4568
39912,256,4302,931,3480,30704,822
30214,17,540,1131,321,19868,219
49534,32,986,782,691,21754,295
47,1799,126302,1566,56844,469055,69458
34148,626,8549,1062,6217,50655,2332
56899,12,96,564,77,4874,19
26187,145,3917,1214,2533,21695,1384
286,9,335,1562,250,16905,85
35927,680,22483,1020,16621,153079,5862
65398,27,212,299,183,5450,29
40237,9,279,926,219,7602,60
52691,111,1402,691,1155,40836,247
58708,4740,111222,509,78521,497517,32701
12821,37,1068,1444,641,15103,427
55709,19,140,598,137,4272,3
49074,971,15366,795,12363,99555,3003
69138,2617,83581,168,71034,328269,12547
21985,124,2937,1296,1698,37999,1239
30296,11,743,1129,452,27358,291
49157,55,1278,792,740,10696,538
36292,0,758,1010,660,23851,98
26488,179,4705,1208,2929,41774,1776
31733,1179,27408,1104,19167,92673,8241
68749,3,21,195,16,2027,5
18070,7,322,1363,238,14762,84
6053,345,14452,1504,9560,87856,4892
63826,26,353,346,299,5686,54
22734,35,669,1284,497,15347,172
38114,29,276,961,210,4646,66
13507,12,805,1434,440,18607,365
66487,6,90,270,50,1635,40
50349,1368,23772,761,19091,79206,4681
69346,57,553,175,451,8251,102
56643,11,189,571,156,6894,33
2167,7,321,1548,226,10312,95
20923,7338,264167,1313,184314,731845,79853
70525,30,297,136,290,13840,7
13686,47,986,1432,559,12384,427
25437,4,323,1230,213,9032,110
64713,160,2398,300,1979,19688,419
58514,43,445,516,334,7093,111
29003,12,376,1155,251,18221,125
22316,533,10580,1291,7372,81115,3208
44541,5618,246159,863,181813,372785,64346
57464,211,3088,550,2452,31264,636
1396,16,526,1554,341,12912,185
67092,40,686,250,601,13691,85
58246,161,1848,524,1350,9264,498
50216,34,884,764,714,10523,170
32737,446,12858,1089,8381,121593,4477
41850,6,150,900,126,7969,24
1084,148,5071,1556,3716,55199,1355
53646,85,649,648,550,10459,99
33652,226,3775,1071,2758,42363,1017
22038,47,1454,1295,975,16788,479
38455,12,238,952,163,3901,75
61718,23,319,406,250,6901,69
4636,301,6206,1522,4176,23825,2030
17673,35,991,1370,780,25455,211
64174,4,72,334,54,2583,18
28881,6,116,1157,104,4982,12
56243,45,530,583,412,7663,118
10473,94,2287,1467,1599,33338,688
7443,51,906,1486,721,54058,185
16807,37,1787,1386,1202,33793,585
21270,11,215,1307,148,5708,67
18253,0,0,1360,0,9375,0
26552,0,0,1206,0,9585,0
70548,18,182,134,175,6591,7
62955,319,3211,369,2655,26451,556
298,52,2768,1562,2036,23884,732
30885,59,664,1118,429,6460,235
63253,6,90,361,53,6530,37
25392,9842,262933,1231,163790,795407,99143
59594,139,3509,480,2845,21803,664
55216,3,99,612,83,2529,16
8498,5,363,1477,253,10227,110
64281,148,3300,330,2773,23048,527
19363,54,1378,1340,981,30011,397
34944,183,2708,1043,1987,43108,721
57456,1766,26311,550,19457,120634,6854
52052,30,468,714,330,7361,138
35987,4,76,1018,54,5330,22
18828,34,619,1350,444,12349,175
33067,6,57,1082,44,3838,13
979,10,573,1557,377,7097,196
69831,698,12900,159,11345,80426,1555
63377,10,128,358,116,3444,12
44418,945,14044,864,11270,71264,2774
65201,54,490,304,391,14202,99
68009,194,2740,220,2021,13023,719
21432,2200,77900,1304,54902,371109,22998
34989,23,634,1042,462,13066,172
41905,20,297,899,186,4802,111
43389,2,90,876,62,3933,28
16479,161,2989,1391,2184,80735,805
596,3308,115485,1560,77588,383927,37897
65760,4,77,290,57,6385,20
30910,20,614,1117,337,18896,277
16855,289,9283,1385,7285,220813,1998
56640,296,5457,571,4391,37309,1066
41759,3,273,901,92,4972,181
31778,52,902,1104,616,12169,286
19042,122,2256,1346,1675,20400,581
47583,4,113,827,79,5430,34
30584,60,1267,1124,808,15430,459
23992,42,1708,1262,1143,13042,565
50787,383,7560,750,6548,70828,1012
20672,31,1005,1318,721,27403,284
26101,10,322,1215,291,21412,31
6836,31,1159,1495,818,29678,341
55870,1,451,594,274,2523,177
9998,7,585,1469,368,10083,217
47596,180,2877,827,2357,47761,520
47803,57,1050,824,903,20087,147
52407,572,8454,702,6630,84379,1824
36384,356,4264,1007,3426,36590,838
23360,36,2043,1274,1707,19598,336
10950,43,1641,1463,990,22999,651
19252,354,5274,1342,3283,39750,1991
14446,9,1027,1420,677,6668,350
62012,131,1851,395,1465,14791,386
1567,94,4652,1552,3247,45265,1405
6680,18,387,1496,287,7433,100
52204,28,295,709,271,22983,24
27491,12,260,1185,155,12225,105
27003,337,8884,1195,6141,49657,2743
10627,2599,47570,1465,33770,162572,13800
69259,3,56,178,44,2341,12
27322,6,131,1189,88,3404,43
2764,567,10632,1543,7662,57045,2970
67028,3,83,252,54,2889,29
13791,70,1232,1430,760,7670,472
37488,39,731,978,575,11519,156
53069,457,4411,617,3514,56883,897
69043,237,4296,185,3666,36424,630
22420,1625,26167,1290,15711,120797,10456
21486,33,419,1303,291,6709,128
5871,7,174,1507,119,21998,55
15570,38,752,1406,497,18294,255
13292,290,14827,1438,9817,70103,5010
16942,150,4056,1384,2618,35423,1438
16143,68,1657,1396,1152,30067,505
41980,20,356,898,277,6502,79
31608,43,1437,1107,956,9528,481
24630,1025,50682,1247,35063,189294,15619
28724,210,4931,1160,3028,71519,1903
56916,1172,26439,563,20822,260814,5617
57344,93,846,552,686,10576,160
30896,1,47,1118,32,3347,15
4215,19,599,1528,399,24759,200
6395,489,25029,1500,14566,186004,10463
10996,61,1740,1463,1131,17277,609
58699,6,59,509,46,6853,13
60305,78,1239,455,995,16679,244
18849,15,375,1349,313,14956,62
64872,4,51,313,39,3626,12
14153,307,5522,1425,4003,29040,1519
53517,20,419,669,330,20364,89
2819,2607,62625,1542,41536,260760,21089
39621,21,380,935,310,6647,70
16432,35,1097,1392,888,23993,209
6655,11,249,1497,169,5050,80
52988,184,3621,682,3037,38657,584
49791,20236,686306,772,455580,1543154,230726
31989,85,1562,1101,996,25543,566
66646,4,27,264,24,1187,3
57732,219,2760,542,2200,13020,560
11245,1,166,1461,98,11321,68
60926,51,468,432,400,8066,68
22386,66,1672,1290,1201,50599,471
934,3671,183838,1557,122441,462036,61397
12504,31,1445,1448,787,18869,658
4679,1147,23447,1521,14747,97159,8700
16867,13,581,1385,422,18388,159
23952,17,622,1263,361,7152,261
13152,8,368,1439,210,12437,158
32917,1365,26619,1085,20311,173194,6308
7203,85,2135,1489,1551,48299,584
10018,37,2366,1469,1581,31615,785
23669,52,869,1268,626,22996,243
33905,257,7830,1067,5845,43484,1985
43529,1769,29207,874,22700,197362,6507
23177,3,130,1277,100,6347,30
16351,9196,321254,1393,196755,890392,124499
21128,51,1388,1309,1045,19303,343
5148,76,4427,1515,2944,40890,1483
3096,2768,82066,1539,51485,200426,30581
49168,1606,33106,792,23754,92474,9352
26622,5,205,1204,165,9380,40
2290,41,2110,1547,1384,48616,726
38321,9,186,956,140,6766,46
57505,215,2491,549,1940,14243,551
8916,470,16080,1475,10266,105538,5814
12140,74,3183,1453,1735,19599,1448
15826,784,42513,1402,24347,192426,18166
5713,39,834,1508,675,9811,159
7827,36,970,1481,654,31450,316
33093,129,2184,1082,1615,23498,569
37310,45,1026,983,851,17444,175
31731,853,19039,1104,13494,48111,5545
24134,25,1293,1258,906,24995,387
6738,237,13594,1496,8646,113038,4948
24352,5257,153462,1254,100418,337037,53044
31261,10,387,1112,252,8811,135
22979,29,1105,1280,776,11598,329
159,178,5951,1564,4720,64906,1231
10722,16,768,1465,504,11312,264
5322,103,2307,1513,1549,18152,758
69540,31,656,169,543,6129,113
26505,100,1982,1207,1315,28616,667
64274,61,758,331,603,6828,155
59880,13,159,470,120,3463,39
41437,5,59,907,45,6821,14
50782,170,1824,750,1489,13789,335
39802,26,330,933,282,9557,48
28742,16,239,1160,180,2922,59
33533,41,956,1074,782,26503,174
4250,218,5259,1527,3827,55957,1432
60554,37,540,446,461,9891,79
63632,11,167,351,129,3905,38
60049,12,102,465,84,5113,18
50316,3256,58649,761,49110,175292,9539
28337,41,2014,1167,1218,25279,796
14532,1283,36975,1419,27104,99518,9871
49920,3,121,771,75,13368,46
27387,430,12028,1187,8089,88169,3939
45243,13,219,855,174,6413,45
39814,68,1383,932,1183,18581,200
18234,232,4514,1360,3301,46122,1213
24785,9,105,1244,84,6524,21
9027,12,417,1475,281,7222,136
16930,71,3264,1384,2233,85470,1031
43549,3,166,874,134,9809,32
65846,6,115,288,89,2771,26
9275,63,3273,1474,2025,31814,1248
39193,44,1293,940,1007,19790,286
66728,1,11,262,7,1020,4
62213,30,330,389,209,2510,121
26629,80,2627,1203,1601,34378,1026
468,840,21002,1561,14993,86486,6009
66490,9,214,270,164,9445,50
69125,13,244,182,172,4365,72
59492,30,321,484,264,7047,57
29013,239,10120,1155,6795,51824,3325
3868,197,4989,1531,3680,29563,1309
67322,9,251,242,136,5486,115
20744,47,1702,1317,1105,28419,597
13031,17,817,1441,450,31724,367
13670,91,1510,1432,852,9681,658
19733,181400,5921429,1334,2683063,15242808,3238366
10200,50,1141,1468,724,39678,417
10380,712,27112,1467,17456,168176,9656
63258,114,1702,361,1400,16866,302
49442,65,1315,784,1049,10925,266
17332,104,987,1377,744,17052,243
1993,37,960,1549,717,13660,243
34442,57,1654,1055,1058,22064,596
2734,15,1347,1543,925,28500,422
54013,38,348,652,285,10768,63
16222,53,1077,1395,764,18327,313
51345,92,982,734,803,24954,179
32228,94,2348,1097,1650,20128,698
10485,41,1944,1466,1129,49082,815
27084,114,1830,1194,1042,7826,788
13212,1055,22203,1439,16558,66761,5645
48737,11,538,806,339,10879,199
59683,291,9470,477,7326,37960,2144
29255,39,961,1150,578,15280,383
56611,22,313,572,249,5368,64
34438,1891,41730,1056,27833,227591,13897
15273,18,593,1410,429,19711,164
23870,1845,47481,1264,32020,140975,15461
12559,587,27336,1447,14818,221157,12518
983,57,1496,1556,1049,40688,447
24390,1733,81790,1253,50057,363840,31733
39871,20,416,932,330,12276,86
26012,5,642,1217,373,13707,269
50522,20,189,756,165,4629,24
56799,39,488,567,422,7084,66
63548,9,98,354,66,1531,32
34766,49,1224,1046,848,31930,376
20713,11,416,1317,279,7135,137
1522,1091,48658,1553,30988,133539,17670
13537,23,815,1434,524,10093,291
16449,577,17967,1391,12524,103015,5443
14246,412,13067,1423,8403,70015,4664
3414,50,2424,1536,1716,58189,708
31146,13,163,1113,107,6876,56
25810,25,399,1222,272,7136,127
9916,157,3116,1470,2054,44089,1062
15113,6,199,1412,150,16111,49
22320,57,1662,1291,1082,15786,580
18932,20,463,1348,270,5676,193
61563,6,126,411,103,2849,23
65446,63,819,298,709,15799,110
8463,785,35908,1477,21041,232851,14867
12270,94,1058,1451,693,24532,365
17361,0,0,1376,0,8268,0
64654,87,1114,320,900,9520,214
7871,681,18842,1480,13186,120345,5656
5232,47,1440,1514,974,12575,466
44797,18,305,854,229,7565,76
14790,70,1289,1417,877,9244,412
60159,6,150,461,107,5856,43
61227,1370,26532,420,21146,136459,5386
51089,132,2364,741,1780,21729,584
16585,30,624,1390,444,17676,180
68290,4,67,211,51,2706,16
63326,49,798,359,598,14057,200
19260,11,398,1342,301,9649,97
34543,140,4177,1054,3103,44329,1074
322,153,11749,1562,6837,92401,4912
15195,36,1287,1411,932,21766,355
50028,3,92,769,79,3338,13
18202,590,30697,1361,21871,182896,8826
28448,716,32122,1166,21295,167196,10827
30668,70,2754,1122,1869,12151,885
35068,900,19950,1040,15153,101669,4797
47420,12,451,829,325,9588,126
35533,12,211,1029,154,5404,57
65206,119,1588,304,1229,28477,359
57354,290,3552,552,2718,22885,834
1719,40,2610,1551,1875,50671,735
32521,380,6596,1070,2868,99568,3728
10612,2234,75338,1466,46783,264767,28555
9539,738,25791,1472,16449,65342,9342
28000,4,223,1173,140,5559,83
48718,78,1535,806,1196,11861,339
14572,11,572,1419,385,20607,187
33282,46,680,1078,420,13152,260
36723,7,163,999,150,9452,13
18989,0,123,1347,93,5558,30
9315,173,3420,1473,2433,34475,987
12765,23,2246,1445,1107,18411,1139
43497,68,622,875,473,5648,149
52341,39,452,704,385,10986,67
56149,12,212,585,180,7726,32
16788,8,276,1386,220,5735,56
19040,12,332,1346,243,13779,89
68460,4,52,205,40,2691,12
30638,4576,128129,1123,89643,529502,38486
41272,12,195,909,171,4143,24
61555,135,1706,411,1436,26320,270
67836,8,119,225,97,6842,22
35543,14,265,1028,197,8230,68
10044,480,17078,1469,11326,130271,5752
30489,10,268,1125,155,4885,113
13140,200,14897,1439,8660,51472,6237
27223,30,752,1191,448,12939,304
8614,175,11947,1476,8279,65564,3668
36446,25,871,1005,659,11476,212
68909,4,77,190,65,2109,12
51596,4123,51659,727,37616,388710,14043
6493,132,3754,1499,2735,17179,1019
19167,35,927,1344,759,52732,168
34886,1078,14533,1044,11708,91453,2825
15305,2472,52459,1410,36025,166450,16434
40996,77,1078,913,851,17731,227
20915,7,412,1313,263,11825,149
3422,4,111,1536,67,8041,44
9680,42,1644,1472,993,15000,651
40636,5,109,920,79,4515,30
23444,101,5970,1272,3660,34416,2310
65014,12,126,308,90,2570,36
63787,89,725,347,565,7446,160
45740,64,783,850,668,31995,115
8194,1,167,1478,103,18145,64
48831,16,255,802,181,7187,74
65685,82,1732,292,1280,14842,452
48740,56,765,805,624,9525,141
15873,8,557,1401,226,10942,331
16582,25,634,1390,423,12564,211
2993,108,2836,1540,2118,31653,718
56056,2424,57161,588,46367,189111,10794
46403,3,137,843,107,5379,30
48798,42,440,803,360,10648,80
53680,2,35,663,28,3089,7
60566,1356,24662,446,19653,86015,5009
47068,4,64,834,52,3625,12
10723,223,10501,1465,7156,49792,3345
52053,89,1194,714,892,13338,302
6262,143,2330,1502,1469,88296,861
4916,58,6695,1518,4410,25129,2285
38159,19,396,960,278,12643,118
68727,18,201,196,141,5166,60
19892,670,47336,1331,30768,155423,16568
50818,50,569,749,490,7469,79
59653,61,999,478,775,12004,224
49887,55,599,772,489,24246,110
25759,35,1076,1223,611,11193,465
57723,24,196,542,165,8619,31
5358,47,2877,1512,1968,32344,909
21692,2,202,1299,135,10899,67
37671,0,28,973,25,4282,3
24161,138,2088,1258,1407,26928,681
29905,408,8887,1137,6214,94892,2673
47433,112,1867,829,1565,25828,302
8133,90,2176,1478,1296,12429,880
50992,6696,107392,744,88267,419709,19125
52921,2,44,684,38,10688,6
16965,42,1544,1383,1135,19889,409
51058,5,121,742,89,9113,32
9484,33,790,1473,487,10779,303
30401,596,18305,1127,11895,58057,6410
13232,119,3250,1438,2029,29645,1221
26277,7,600,1212,333,11338,267
53543,9,158,668,137,5346,21
68103,18,220,217,167,2915,53
12263,1,391,1451,181,14830,210
62907,1,30,370,21,4477,9
6022,41,1333,1505,882,12648,451
15792,15,686,1402,456,16537,230
49600,386,5124,780,3922,26548,1202
479,1761,41846,1561,27390,206563,14456
50142,99,1283,766,976,14766,307
14111,42,1101,1425,788,17426,313
55549,118,1049,602,842,18049,207
28805,39,969,1159,616,31782,353
21115,81,1922,1309,1445,21780,477
16757,784,28402,1387,19408,245409,8994
49035,9,127,796,102,5378,25
5092,8,495,1516,330,9904,165
67293,12,150,233,127,3699,23
18121,90,3308,1362,2132,17457,1176
48195,4842,80284,794,59987,225743,20297
35455,3,196,1031,136,11362,60
1433,108,4418,1553,2812,50710,1606
1666,13,408,1552,281,8595,127
22178,21,595,1293,479,24259,116
12891,147,8238,1443,4102,84896,4136
55510,62,723,603,543,7121,180
67064,61,1176,251,911,15896,265
26279,18,1516,1212,777,7062,739
1479,57,3225,1553,2146,58260,1079
60518,252,4261,447,3460,43979,801
49759,427,5314,775,3683,44468,1631
68237,87,1570,213,1291,27448,279
11701,121,3329,1457,1935,27312,1394
16969,32,860,1383,663,22478,197
56812,352,10132,561,7447,48828,2685
62674,6,62,375,46,2794,16
21810,9,248,1298,193,14867,55
38091,67,1035,962,863,7531,172
22608,4885,126051,1287,83710,248427,42341
34046,31,742,1064,494,12489,248
24387,57,1273,1253,848,10297,425
35866,3,105,1021,84,3753,21
50956,231,2596,745,2018,20868,578
51159,55,470,739,342,4367,128
16164,76,3536,1396,2411,33479,1125
15882,56,969,1401,700,22283,269
11677,101,2702,1457,1713,13494,989
17469,9,363,1375,271,6698,92
30385,399,6429,1127,4321,60808,2108
62602,69,605,378,500,6993,105
49750,98,1829,776,1571,35276,258
50485,15,238,757,181,4294,57
49,104,3417,1566,2011,50604,1406
64520,263,3438,324,2913,24072,525
69316,33,598,176,483,11865,115
48095,378,4600,821,3668,74886,932
2684,4,210,1543,147,12926,63
47284,31,829,831,664,21003,165
13001,0,0,1441,0,10996,0
340,95,5750,1562,3844,36157,1906
2598,8,190,1544,143,11878,47
16257,45,423,1395,307,14743,116
20198,16,370,1326,254,15530,116
8892,636,19727,1475,12344,124751,7383
27667,21,1013,1181,779,30204,234
33494,10,465,1074,314,5863,151
15969,515,14180,1399,9987,132463,4193
53303,8,182,673,124,5785,58
52767,52,574,689,445,23128,129
31085,49,1048,1114,678,36249,370
23509,21,709,1271,502,27728,207
51642,8,227,726,167,7696,60
13804,450,6258,1430,5030,62348,1228
57585,0,0,547,0,8041,0
12718,166,4817,1445,2692,48555,2125
21190,38,1620,1308,1203,22672,417
20275,2,119,1324,92,5812,27
57649,74,1168,545,954,21544,214
51681,1398,26178,725,20625,103512,5553
69159,0,7,181,5,1244,2
22219,261,5174,1293,3366,43584,1808
62120,245,2397,391,1834,12527,563
50314,51,937,761,744,14430,193
52118,8,184,712,133,5853,51
29387,72,1984,1147,1635,72319,349
272,790,31500,1563,24358,209441,7142
50175,13,136,765,126,10416,10
33322,61,1185,1078,798,13674,387
15077,4,715,1413,489,29478,226
14292,267,8259,1423,5744,46853,2515
7041,533,13472,1492,8552,53764,4920
60898,11,145,433,117,4068,28
24462,581,12192,1251,7912,78149,4280
59232,31,617,493,514,14643,103
43585,1,22,873,20,3090,2
61616,272,5792,409,4843,69659,949
17927,20,675,1365,505,8072,170
12345,33,2291,1450,1437,19818,854
41818,26,251,900,163,5959,88
65664,15,131,293,117,7416,14
45474,30,348,853,287,6302,61
48904,7,119,800,86,3841,33
65050,6,197,307,133,5921,64
19462,9,158,1339,133,7640,25
24883,278,3585,1241,2378,41829,1207
36070,50,756,1016,585,37555,171
68755,104,695,195,586,10119,109
6664,97,4551,1497,3252,32599,1299
34928,1515,43489,1044,36077,217128,7412
37908,7,90,967,74,7496,16
24123,9,359,1259,256,13385,103
4328,250,4890,1526,4166,48191,724
48654,64,788,534,585,11717,203
59616,27,227,479,177,4045,50
50440,9,116,758,106,5412,10
50029,4,83,769,72,2945,11
22116,427,9711,1294,6801,75632,2910
11786,1,239,1456,108,4881,131
27559,14,800,1183,543,10441,257
23419,26,1212,1272,892,14570,320
803,24,756,1558,517,36566,239
22159,16,412,1293,284,16161,128
3104,12568,491151,1539,319923,1555134,171228
9704,8,409,1471,265,9834,144
5371,21,339,1512,213,11867,126
37324,742,11787,982,9424,66191,2363
47673,17,195,826,145,2548,50
48315,1050,19353,817,14885,90806,4468
25478,224,3597,1229,2271,26944,1326
18336,469,9594,1359,5796,39391,3798
36464,9,123,1004,96,5651,27
50840,202,3056,748,2343,43587,713
33650,428,15634,1071,10981,100431,4653
70127,11,65,149,61,4290,4
25386,1485,30467,1231,20662,212545,9805
13216,0,0,1439,0,14284,0
28283,1774,23347,1169,17477,106749,5870
13071,116,6172,1440,3445,61110,2727
9220,109,3940,1474,2595,58626,1345
56364,1,56,579,34,4199,22
46273,57,699,844,618,10586,81
58613,1010,23629,512,19026,80524,4603
33235,80,1877,1079,1478,32855,399
27625,28,897,1181,482,10735,415
35877,78,1942,1021,1596,24819,346
51782,23,479,722,355,28067,124
61707,17,188,406,143,4088,45
3067,1212,34058,1540,24721,84974,9337
26764,984,17482,1201,13034,93747,4448
61314,55,764,418,627,20497,137
54771,57,591,625,445,11809,146
58818,961,24146,506,17038,106845,7108
12919,156,4644,1443,2628,19089,2016
37092,5,124,989,105,4986,19
32977,318,9082,1084,5218,55521,3864
60103,18,147,463,112,5212,35
51609,346,5404,727,4740,53043,664
10798,19,412,1464,270,12428,142
3057,15,628,1540,488,9870,140
32064,7056,156924,1100,94051,438663,62873
67834,9,207,225,182,2512,25
51878,13,231,719,198,5407,33
1850,16,816,1550,568,18231,248
24196,5,239,1257,176,8258,63
22738,30,727,1284,522,6183,205
62846,18,447,371,390,2899,57
48657,117,1087,801,872,14350,215
12167,28,623,1452,361,32272,262
49233,408,11313,790,8082,97911,3231
55857,21,315,594,242,5821,73
33397,67,749,1076,510,18472,239
3180,178,3991,1538,2141,28669,1850
218,24,3207,1563,1655,20875,1552
58416,81,889,519,721,31365,168
3722,434,13776,1533,9960,72398,3816
39821,2467,96500,932,72201,436566,24299
34318,150,2774,1058,1971,34081,803
51920,52,676,719,502,7832,174
34157,227,5011,1060,3447,41364,1564
52100,41,714,712,587,11561,127
12313,158,2284,1450,1388,14358,896
7860,9,299,1480,175,3601,124
112,34,2003,1565,1323,36864,680
54241,33,215,645,178,3066,37
24628,9,330,1247,280,4504,50
55361,112,1207,607,733,9867,474
58864,5,78,505,67,3436,11
69216,15,159,179,138,5035,21
24234,7176,169595,1257,124655,784121,44940
19124,10,323,1344,282,32797,41
321,4,295,1562,239,21996,56
4494,158,4224,1524,3077,20733,1147
11980,3,319,1454,166,12468,153
19210,0,152,1343,107,5058,45
5331,180,8771,1513,5579,101365,3192
45500,1287,70504,853,54746,257457,15758
16464,2134,70920,1391,37045,278212,33875
69460,83,901,172,789,6163,112
18032,13,441,1363,341,17768,100
53689,3611,69333,663,53070,163515,16263
23351,358,9166,1274,5783,26521,3383
59084,7,91,498,74,10116,17
15764,21,966,1403,697,30509,269
36427,264,3900,1005,2837,31335,1063
53447,6,75,670,52,3372,23
25903,96,2587,1220,1640,11245,947
61008,17,165,429,126,4054,39
66098,62,858,281,717,8196,141
34460,503,7683,1055,5955,53821,1728
23706,20,973,1267,685,12743,288
16561,8,518,1390,362,16028,156
15242,137,3054,1411,2148,73552,906
69552,62,1555,169,1330,12446,225
30469,1850,44962,1126,32593,235447,12369
27054,2215,52871,1194,32842,392093,20029
60026,12,175,466,140,5317,35
8318,94,3433,1478,2287,25109,1146
48480,1154,23212,814,16615,166567,6597
11254,76,3598,1461,1738,55520,1860
57887,145,2074,537,1773,38637,301
22636,3,117,1286,95,11837,22
10057,115,2563,1469,1453,11237,1110
6246,42,5074,1502,2998,18385,2076
60046,23,805,465,430,8405,375
9828,61,906,1471,566,10467,340
57881,23,420,537,307,8634,113
12004,6,445,1454,218,3878,227
28591,1320,27233,1163,16713,97414,10520
31375,509,10707,1110,7298,69186,3409
32305,60,789,1096,526,11514,263
54621,54,536,630,432,14761,104
4830,41,1038,1519,744,22536,294
18173,62,2104,1362,1671,37833,433
26952,769,15326,1196,10492,172521,4834
17529,34,1360,1373,973,23953,387
6670,16,294,1496,201,6526,93
2366,38,915,1546,710,10283,205
69444,39,467,172,403,7666,64
1530,9,1448,1553,834,19540,614
59925,2621,56514,468,44120,254753,12394
38396,13,252,954,195,6261,57
5223,312,7919,1514,5198,40416,2721
28803,50,2855,1159,1281,14853,1574
50125,287,4526,766,3339,61014,1187
25729,2,99,1224,65,8055,34
6215,13,557,1502,338,10736,219
51892,103,1525,719,1245,30229,280
35876,26,672,1021,535,25885,137
61484,65,604,413,508,7581,96
23171,24,644,1277,449,11205,195
20373,14,753,1323,563,34416,190
35194,23,419,1037,318,9417,101
64949,15,168,310,120,14306,48
66136,7,86,280,71,1699,15
36281,29,283,1010,220,5688,63
19024,48,728,1346,499,16791,229
7070,25,2396,1491,1533,20118,863
3353,5,385,1537,274,6887,111
63019,8,45,367,36,2848,9
16868,32,1151,1385,797,20181,354
16492,3,157,1391,98,6062,59
20569,43,1268,1320,853,35570,415
8256,352,7672,1478,5043,31248,2629
16947,4,148,1383,85,4033,63
35831,12,291,1022,194,3639,97
22538,2425,62143,1288,41976,145243,20167
53136,2,30,677,23,4285,7
9629,244,4392,1472,3139,41598,1253
64628,1364,23956,320,20434,176096,3522
20858,11,426,1314,257,13167,169
8335,86,2345,1478,1572,27980,773
70163,4,49,148,41,4228,8
33442,202,4958,1075,3339,22441,1619
29072,3,174,1153,105,5215,69
68319,32,617,210,551,8020,66
6872,23,484,1494,348,8777,136
55572,12,210,602,150,17580,60
55532,179,1983,603,1571,27724,412
36836,52,598,997,481,11057,117
13478,50,1152,1435,709,11895,443
41670,5,130,903,87,12615,43
37742,189,3456,971,2584,49383,872
11615,126,2687,1457,1682,33842,1005
22331,487,18106,1291,12453,120427,5653
22601,200,3701,1287,2697,18688,1004
53334,20,266,672,212,8567,54
61139,2548,29821,424,24048,98371,5773
43321,8,294,877,221,6324,73
7315,3428,85155,1488,53706,178249,31449
58795,35,381,507,304,3974,77
69717,13,99,163,94,3025,5
18129,68,2336,1362,1214,11170,1122
49314,2,27,787,22,2751,5
33321,89,1678,1078,1204,36884,474
32998,279,10318,1083,6497,37236,3821
63344,5,128,359,88,4668,40
34892,30,968,1044,672,24059,296
41830,241,4984,900,3861,36058,1123
14156,559,17227,1425,11662,88373,5565
26231,229,6507,1213,4111,37317,2396
2721,668,11795,1543,8206,86701,3589
43341,12,265,877,222,7191,43
64673,15,164,319,124,2926,40
15754,15,506,1403,352,13609,154
765,92,6554,1558,4096,88983,2458
43981,20,199,870,158,9211,41
8885,76,2154,1475,1320,12687,834
11397,1320,33488,1459,22759,149743,10729
51886,1295,15237,719,12201,67019,3036
52705,446,6297,691,4553,82058,1744
69763,11,105,161,91,2687,14
7299,51,1126,1488,773,32309,353
35581,5840,87759,1028,59320,311871,28439
12249,32,1127,1451,705,28630,422
12264,1,518,1451,191,16893,327
8423,144,3268,1477,2197,21902,1071
66766,5,42,260,38,2009,4
25076,8,289,1237,191,11422,98
55699,6477,160354,593,112442,353989,47912
6339,20,430,1501,294,8307,136
25341,229,11610,1232,8217,73603,3393
13228,71,2699,1438,1385,31144,1314
34358,26,605,1057,404,10340,201
3640,4,364,1534,220,16962,144
68875,25,568,189,515,9544,53
35086,4,212,1040,181,12749,31
5524,75,1597,1510,1001,10981,596
56603,8,67,572,54,5336,13
4719,13406,546468,1521,323289,1465642,223179
20699,49,1688,1317,1392,22426,296
28882,12,218,1157,166,7682,52
15758,253,8211,1403,5386,83777,2825
60466,127,2160,449,1501,18865,659
29681,119,3464,1142,2111,23058,1353
19644,529,11588,1336,7847,110017,3741
18479,4,322,1356,234,13130,88
60090,141,1767,463,1450,40512,317
17582,5118,178654,1372,115635,650102,63019
56101,72,872,587,638,28676,234
54127,301,4486,648,3648,33040,838
26830,56,1738,1199,1041,11533,697
19414,4,136,1339,88,4517,48
1356,354,8129,1554,5382,50137,2747
59661,1664,37815,474,30514,192013,7301
12841,5,245,1444,128,10509,117
17311,19,626,1377,495,13900,131
57485,15,109,549,85,3550,24
10431,1217,36656,1467,21942,182425,14714
54115,27,179,649,143,3069,36
29735,1758,44436,1141,27262,98591,17174
58433,32,439,519,376,9653,63
60391,3,54,452,45,4554,9
6045,8,528,1504,307,18080,221
13652,13283,329154,1432,190875,834341,138279
21644,37,820,1300,700,19495,120
44199,113,1809,866,1595,19171,214
66525,368,6954,268,5398,36391,1556
32234,458,17932,1097,13212,137751,4720
2953,200,6965,1541,5022,30189,1943
6431,355,6504,1500,4760,56303,1744
43885,150,2481,871,1885,19608,596
318,4432,141158,1562,72285,402346,68873
53104,6,101,678,74,5648,27
57440,1579,47981,550,32269,184670,15712
29951,41,926,1136,605,12760,321
15908,446,14919,1400,10781,125288,4138
57865,6,89,537,74,3330,15
27858,48,1063,1177,603,6149,460
33733,17,485,1070,313,8147,172
1600,76,7092,1552,5015,103295,2077
4599,7,255,1522,193,8246,62
1565,40,1355,1552,974,49928,381
51396,61,894,733,698,27018,196
8991,14,404,1475,263,26710,141
31950,51,877,1102,597,13368,280
68782,755,18185,194,12679,168128,5506
54192,2,18,646,10,3526,8
54382,517,7996,640,6048,32152,1948
55803,254,2819,596,1863,17220,956
28192,95,1599,1170,1184,38558,415
68564,25,278,201,210,5864,68
70409,170,2861,140,2605,14973,256
36396,383,6200,1006,4926,41709,1274
3689,49,1043,1533,731,17866,312
871,45,1342,1557,903,34600,439
3068,1031,44944,1540,29173,164900,15771
8695,34,816,1476,519,18533,297
43293,1492,25017,877,20878,182350,4139
19535,38,1064,1337,785,26533,279
34737,103,1290,1048,871,10217,419
66647,10,142,264,122,6640,20
44367,34,760,865,606,20496,154
58296,3175,34907,522,27297,140202,7610
23070,11,483,1278,303,10653,180
21662,1033,29702,1300,18837,243614,10865
28505,52,1673,1164,921,38100,752
57376,7148,89994,552,67149,264107,22845
51632,860,64224,726,47444,127744,16780
56960,79,1060,562,863,11928,197
22605,1651,47625,1287,28621,208062,19004
61509,102,1254,412,959,6712,295
70110,2,25,150,22,2427,3
24575,23,615,1249,422,9181,193
49467,50,985,783,721,21637,264
36250,53,1606,1011,1323,17778,283
26422,44,2204,1209,1336,19506,868
533,125,3766,1560,2861,48940,905
6552,9,270,1498,185,46502,85
16127,580,22649,1397,15639,166494,7010
68114,36,652,217,585,17217,67
28972,91,2214,1155,1381,19451,833
67977,25,557,221,427,8569,130
51512,110,2180,730,1506,15138,674
10158,303,7419,1469,4936,59503,2483
7407,2,51,1487,43,3241,8
13406,372,12897,1436,7267,132190,5630
4427,1601,37320,1525,24789,225437,12531
19238,19,807,1343,559,8343,248
50268,4,76,762,62,5999,14
31532,4,92,1108,59,3859,33
38223,19,271,959,188,6664,83
67399,13,276,240,227,6815,49
33943,19,196,1066,127,6050,69
54881,27,261,621,194,7120,67
4283,1677,42937,1527,24838,194155,18099
63390,2,41,358,27,2250,14
9625,352,10921,1472,6032,24674,4889
49496,1744,22985,783,15172,147073,7813
40769,34,319,918,255,4420,64
17064,36,1133,1382,905,39566,228
9659,986,30122,1472,18643,99838,11479
53899,8,213,656,161,5954,52
30085,4,185,1133,111,8233,74
27853,879,16654,1177,11378,199695,5276
60949,115,1343,431,1081,9185,262
638,172,5988,1559,4076,74038,1912
14188,265,5407,1424,3861,31554,1546
17214,24900,621668,1379,415367,1105920,206301
26227,22,406,1213,328,30522,78
9066,186,6810,1474,4382,40636,2428
37597,344,5163,974,4190,27293,973
8538,27,664,1477,433,8877,231
27954,91,863,1174,552,6159,311
27156,10,396,1192,257,18235,139
21805,128,3137,1298,2111,28151,1026
18649,161,2792,1353,1821,28532,971
23931,113,1705,1263,1258,36944,447
68759,2,80,195,78,2524,2
3775,125,4238,1532,2742,84886,1496
40216,5400,81355,926,64372,446540,16983
32337,51,1835,1096,783,14202,1052
67816,322,5171,226,4357,51450,814
18426,39,1308,1357,980,21501,328
6524,1961,73857,1498,45466,281571,28391
51708,23,250,724,208,2826,42
37950,2817,64079,966,48239,164762,15840
17966,102,2994,1365,1863,19462,1131
31864,225,4394,1103,2856,26570,1538
57016,14,167,561,129,5984,38
57796,37,675,540,487,12650,188
23116,10,316,1278,232,11141,84
65308,120,4103,302,3306,23236,797
36303,51,933,1009,572,12509,361
15239,0,0,1411,0,20733,0
57378,2,29,552,27,1478,2
55830,25,482,595,333,4733,149
1217,668,23613,1555,15944,108813,7669
9286,55628,2430737,1474,1216032,8742227,1214705
68919,4,108,189,84,4683,24
9003,23,1232,1475,708,21709,524
4036,23,415,1530,296,16200,119
38243,91,1457,958,1261,28950,196
63882,23,183,344,172,2802,11
53716,884,13580,662,10060,85279,3520
57788,11,153,540,96,7117,57
37277,2072,38122,984,31060,136455,7062
58033,55,713,532,569,12053,144
42366,2959,59259,854,48553,316862,10706
2849,57,1861,1542,1381,36103,480
13561,1609,43485,1433,29789,370263,13696
20365,21,442,1323,286,19435,156
44462,16,257,864,186,9943,71
2548,112,4698,1544,3027,50138,1671
14627,18,1090,1418,810,26903,280
12212,104,5691,1452,3098,29898,2593
67038,2742,170026,245,92467,1471161,77559
52088,19,326,713,245,13793,81
3405,39,2633,1536,1721,46614,912
22105,48,1010,1294,663,10321,347
59623,14,137,479,110,6331,27
27046,86,2910,1194,1801,46528,1109
41866,62,1378,899,1097,21765,281
10262,125,3206,1468,1927,42391,1279
63903,2946,57315,343,45543,219627,11772
14140,21,274,1425,195,13405,79
14776,102,1279,1417,899,17926,380
9117,864,41302,1474,26171,153682,15131
28053,96,3531,1173,2025,20431,1506
35683,231,3406,1026,2655,48302,751
2183,53,1342,1547,964,19154,378
1108,345,14629,1556,8974,57078,5655
14610,8,301,1419,234,7968,67
69883,5,68,157,57,4260,11
59164,112,1418,495,1173,11221,245
37674,29,867,973,726,33253,141
54373,26,247,640,208,9625,39
32567,68,702,1091,492,10885,210
62407,10,133,383,96,3452,37
69774,101,2146,161,2019,12753,127
51372,22,282,734,247,8917,35
341,155,13570,1562,8729,130395,4841
26527,20,532,1207,352,50277,180
10489,13,289,1466,176,6525,113
68053,270,4479,219,3875,33219,604
67573,10,176,233,138,5230,38
53376,180,3103,671,2375,13861,728
18431,54,1463,1357,1003,24837,460
1082,184,5475,1556,4165,45287,1310
50041,99,2032,768,1597,49054,435
16876,22,562,1385,380,12115,182
30340,612,12232,1128,8672,64619,3560
57334,52,1238,553,967,9375,271
2634,58,1148,1544,717,60353,431
11994,2,274,1454,140,5019,134
5850,181,8100,1507,5459,126891,2641
66996,0,28,252,16,2479,12
18058,9,789,1363,576,11962,213
19479,1,230,1338,112,9044,118
9813,77,5885,1471,3986,33562,1899
30493,679,13021,1125,8019,92021,5002
29600,1190,27934,1144,18930,163143,9004
68436,53,275,206,228,4353,47
44752,270,5188,861,3222,42525,1966
7447,31,675,1486,477,13108,198
56571,20,306,573,246,6479,60
30978,13,423,1116,251,8497,172
26580,186,6413,1205,4345,28449,2068
32472,12,410,1093,257,9817,153
6497,916,53598,1499,32784,306673,20814
10669,0,410,1465,253,8800,157
47065,50,931,834,700,12255,231
40105,131,1685,928,1354,12733,331
63323,32,257,359,211,3847,46
20480,75,1637,1321,1180,26328,457
23771,12617,328600,1266,207675,816853,120925
27161,57,1064,1192,591,13072,473
14343,330,7851,1422,5901,133926,1950
23567,46,718,1270,501,14305,217
19022,390,13569,1346,8831,119148,4738
11377,59,2189,1460,1359,47855,830
3340,96,4321,1537,2602,31207,1719
31669,4082,58616,943,47584,237260,11032
60660,881,13587,442,11040,93052,2547
56405,4,35,578,24,1788,11
53902,634,6607,656,5061,38295,1546
62497,53,660,381,516,13345,144
6643,25,968,1497,619,20916,349
64318,31,459,330,396,7132,63
19687,10,164,1335,145,17556,19
28951,2692,52128,1156,38132,178206,13996
38769,50,886,945,663,7176,223
48852,37,704,802,535,8014,169
56555,37,457,573,355,5523,102
13109,0,0,1440,0,14069,0
21354,616,26887,1305,16478,100103,10409
24004,11,329,1262,198,6898,131
59671,45,514,478,419,7805,95
25894,32,348,1220,198,7659,150
12400,97,6817,1449,3815,41323,3002
61223,259,3004,420,2428,16883,576
46537,20,416,840,374,7510,42
9113,129,3393,1474,2309,23289,1084
69122,5,34,182,28,1579,6
9104,21,579,1474,404,6710,175
36112,144,2490,1015,2106,70645,384
60081,49,726,464,592,6808,134
15673,2,96,1404,66,7755,30
27814,18,445,1178,286,15280,159
65822,33,349,284,280,7784,69
25117,13,638,1237,413,26542,225
30056,34,1161,1134,728,11564,433
50713,10,106,752,92,11498,14
36460,22,619,1004,496,12278,123
30970,7,154,1116,104,10220,50
57627,103,1818,545,1480,20456,338
32803,38,694,1087,452,14102,242
32548,52,1199,1092,805,46858,394
16507,30,1615,1391,1292,27340,323
30410,2,37,1127,30,4137,7
22148,54,1397,1294,980,18490,417
69863,10,184,158,163,4190,21
21150,51,1700,1308,1327,12213,373
33047,29,452,1083,247,5710,205
37780,78,1491,970,1062,34138,429
14359,9,267,1422,202,10081,65
34304,138,3801,1058,3124,63227,677
59633,6,50,479,37,5104,13
68645,30,216,198,164,4289,52
258,6,394,1563,232,13180,162
49307,752,8836,787,6956,72792,1880
30428,65,1992,1127,1204,22735,788
69674,6,62,165,37,2164,25
36843,3145,53460,997,37830,253545,15630
62078,4,76,393,50,2049,26
1300,114,4551,1554,3001,31376,1550
30862,52,1223,1118,805,25597,418
7563,95,3428,1485,2355,52308,1073
56147,5053,132208,585,96581,504273,35627
23338,14,585,1274,395,8819,190
68179,167,3554,215,3032,31635,522
3595,6448,200413,1535,111149,410847,89264
47329,26,333,830,273,7414,60
18374,70,1519,1358,1000,23461,519
34569,98,2237,1053,1648,25974,589
52224,257,2515,708,2117,29425,398
66209,20,202,277,157,17684,45
24173,10,309,1258,253,10483,56
58490,66,1044,516,835,30512,209
7043,8,268,1492,165,9156,103
28202,1755,33225,1170,21312,90122,11913
27269,5,69,1190,60,6118,9
36305,360,8638,1009,6852,42281,1786
32590,21,524,1091,378,6547,146
168,371,9721,1564,6737,95321,2984
15510,47,1651,1407,1135,10098,516
46552,31,490,840,380,12175,110
56027,250,6604,589,5442,37209,1162
28064,14,534,1173,343,7087,191
38185,804,13211,959,10705,73000,2506
34152,0,1847,1062,1155,18923,692
17377,3,102,1376,64,2063,38
18577,11,272,1354,235,27065,37
35788,186,4986,1024,3594,57573,1392
34510,110,2915,1054,2048,23258,867
8906,945,15775,1475,10291,40476,5484
7643,3728,116133,1484,73336,277871,42797
42442,42,1365,891,1129,21364,236
24029,45,1267,1261,1069,31577,198
22351,215,9021,1291,7170,83550,1851
65278,252,847,302,735,27831,112
36306,582,15606,1009,12316,58915,3290
41893,40,647,899,482,26386,165
19773,132,3548,1333,2637,55744,911
49027,81,1075,796,803,8393,272
4996,46,914,1517,699,28648,215
24678,112,1299,1246,867,18904,432
58480,5,56,516,50,4667,6
20948,183,3120,1312,2392,38792,728
64512,6,129,324,83,5689,46
34673,13,168,1050,120,5320,48
1007,41,1524,1556,1178,26983,346
609,135,6339,1559,3771,50977,2568
61441,651,8194,414,6573,72746,1621
39828,19,438,932,385,15381,53
55899,209,3372,593,2568,23579,804
20953,75,1227,1312,742,12968,485
14256,165,3254,1423,2177,25123,1077
52668,42,536,692,429,13458,107
18750,40,1980,1351,1156,22001,824
33958,66,1273,1066,935,9613,338
51239,29,644,737,516,15465,128
8781,510,8887,1476,5750,69657,3137
16563,0,0,1390,0,12255,0
65186,21,213,304,163,4332,50
27075,128,1961,1194,1267,32662,694
25223,117,2861,1235,1898,20649,963
55086,13,146,615,102,7785,44
34337,156,3941,1058,2778,27922,1163
35378,926,13944,1032,10949,157719,2995
68134,18,146,216,113,4921,33
67770,45,1386,228,1150,15977,236
36338,17,378,1008,312,12393,66
3706,109,3255,1533,2232,31417,1023
36127,2382,49788,1014,41064,219292,8724
54193,4,68,646,55,4095,13
3333,109,6229,1537,3795,26920,2434
25454,0,322,1230,201,23663,121
55694,15,224,598,176,7218,48
9573,927,30164,1472,20129,90729,10035
54342,51,489,641,385,11749,104
10855,354,14186,1464,8961,76779,5225
57808,82,1269,539,1086,18244,183
20711,8,172,1317,127,6876,45
214,47,3004,1563,2118,34225,886
4019,256,6117,1530,4508,24108,1609
6843,81,1088,1494,848,10303,240
57884,34,382,537,270,8033,112
31353,129,1230,1110,799,11149,431
36944,258,7086,994,5629,71550,1457
16335,38,1663,1394,1079,27813,584
1048,186,2727,1556,1654,12802,1073
57272,89,898,554,735,10407,163
47975,22,324,823,272,14958,52
54587,18,135,632,102,6300,33
62269,133,1135,387,868,14389,267
22151,85,3522,1294,2039,18618,1483
363,180,9736,1562,7372,55455,2364
69891,14,124,157,103,1945,21
51494,11,244,730,198,5321,46
70196,32,303,147,297,8997,6
29903,7,237,1137,188,8123,49
60383,0,53,453,46,5854,7
19602,9,257,1336,160,6477,97
61336,1041,18150,417,14175,114772,3975
52648,989,10922,692,7319,46453,3603
59851,158,2374,472,1874,31244,500
13139,17,985,1439,512,14056,473
4771,46,1208,1520,868,20834,340
30660,106,1911,1122,1280,21981,631
11912,54,4550,1455,2314,25543,2236
38917,942,26829,943,22179,174128,4650
57670,27,266,544,217,6066,49
28456,136,2900,1165,2195,31732,705
23736,7,274,1267,216,14630,58
17714,75,3515,1370,1997,13883,1518
19490,16,906,1338,672,30667,234
14923,143,1900,1415,1346,39176,554
68736,32,297,196,266,5121,31
57828,7,170,539,128,5242,42
21924,10,266,1296,187,39653,79
29890,8,703,1138,421,11872,282
54520,237,3762,634,2934,26722,828
35014,20,591,1041,409,10169,182
51027,221,3525,743,3083,40850,442
39730,526,8348,933,6296,100585,2052
44767,13,192,861,158,12708,34
6024,847,27187,1505,16858,167245,10329
9248,10,401,1474,270,7010,131
24301,5,230,1255,159,9010,71
22367,55,2703,1291,1922,22745,781
53472,61,587,670,494,16244,93
39343,6,123,938,92,16943,31
3638,5,155,1534,110,40495,45
543,4,186,1560,103,9989,83
32207,401,9806,1098,7077,98077,2729
9398,7,127,1473,89,5559,38
1816,56,3885,1550,2621,84576,1264
68013,4,36,220,32,2199,4
3194,1,84,1538,60,6096,24
12872,419,10972,1443,6639,62418,4333
56287,17,339,581,275,5979,64
66899,12,270,256,158,4993,112
9055,91,3238,1474,2047,27216,1191
531,25,871,1560,611,21632,260
65672,6,105,292,83,2670,22
53364,4,50,672,41,2986,9
2868,101,4902,1541,3321,132231,1581
9450,465,13787,1473,9148,59549,4639
61017,72,715,429,622,9153,93
24414,29,579,1252,412,12867,167
56619,265,2836,572,2330,23812,506
58717,269,6168,509,4568,54427,1600
12760,117,3222,1445,1785,27402,1437
65016,22,176,308,131,9925,45
67628,6,49,231,32,2058,17
34783,51,1847,1047,1291,84355,556
6734,6,275,1496,167,13969,108
21725,271,10064,1299,6455,100580,3609
1825,11,763,1550,498,28749,265
7029,231,22713,1492,13027,104900,9686
17020,225,4469,1382,2880,18368,1589
17153,266,5462,1380,3714,50622,1748
54758,266,2798,625,2081,61659,717
66040,43,297,283,219,2970,78
36142,5,165,649,127,3928,38
11395,26,935,1459,633,15916,302
36153,23,776,1014,628,13901,148
21571,19,668,1301,440,20094,228
15636,443,11652,1405,7715,74599,3937
40648,159,2425,920,1822,27588,603
53537,6,342,668,284,7575,58
16630,40,1270,1389,712,9177,558
5521,291,21731,1510,13787,163482,7944
428,39,3363,1561,2358,23174,1005
12366,82,2459,1450,1344,35019,1115
62790,9,126,373,95,2157,31
24328,195,4928,1254,2660,19692,2268
3119,28,955,1539,656,38257,299
61059,23,373,427,214,7877,159
9620,40,1745,1472,960,21348,785
20000,8,217,1329,158,4311,59
16357,1,101,1393,61,9101,40
52296,3752,76548,706,56835,190637,19713
50434,52,688,758,503,8541,185
12260,36,1707,1451,865,24123,842
8460,90,2788,1477,1760,14906,1028
40626,2453,46479,920,37745,321422,8734
65753,2,38,291,32,3434,6
66851,200,3500,257,2881,37843,619
34788,18,330,1047,239,28859,91
65419,324,6007,299,4852,50758,1155
10523,29,702,1466,460,14265,242
27927,112,2442,1175,1381,7803,1061
67454,16,112,238,90,3825,22
32280,63,2341,1097,1716,21459,625
65563,2,38,296,26,2222,12
11964,35,943,1454,514,6990,429
34781,39,429,1047,318,9618,111
10972,13,312,1463,200,14902,112
68256,288,5949,213,4507,38223,1442
7708,175,3408,1483,2379,22380,1029
62682,5,90,375,70,3163,20
15007,244,14790,1414,9690,100831,5100
13637,990,23514,1432,15125,136590,8389
41390,21,523,908,396,11272,127
30219,10,285,1131,146,6978,139
70450,14,203,138,163,3918,40
25220,110,2027,1235,1355,23850,672
25796,880,15008,1222,9932,91445,5076
44774,91,1229,861,867,16120,362
2750,7,268,1543,168,5772,100
53897,6,75,656,61,5955,14
64997,23,345,309,277,4054,68
60866,233,3787,434,3185,30597,602
59215,2,70,493,28,3406,42
26892,71,2893,1198,1429,16489,1464
67095,19,314,250,244,2077,70
33636,40,1674,1072,1090,36487,584
59266,57,564,491,474,8523,90
21754,84,1834,1299,1159,20004,675
42218,214,4379,894,3289,37015,1090
18744,57,981,1351,658,13521,323
17674,25,664,1370,487,18903,177
68707,483,10313,196,8997,86917,1316
61254,1500,14734,419,11465,42338,3269
1744,146,4512,1551,3452,52173,1060
29246,9,197,1150,132,6345,65
36282,67,1131,1010,817,18937,314
50874,19,284,748,202,6148,82
16354,76,2282,1393,1555,22113,727
50510,15,290,756,236,8250,54
13542,390,27744,1434,15238,117466,12506
33615,0,0,1072,0,13538,0
33349,71,2946,1075,2174,36628,772
19662,36,893,1335,622,12511,271
25190,73,1926,1235,1345,43034,581
2011,8,226,1549,149,12316,77
48481,3,102,814,81,3971,21
22736,5,255,1284,174,5040,81
70349,4,61,143,60,1322,1
60911,108,1601,432,1361,15195,240
15848,3,181,1402,139,6123,42
67800,53,524,227,440,5440,84
52615,16,142,695,113,3367,29
17704,6526,267904,1370,176151,1034612,91753
60494,13,117,448,85,1940,32
29281,147,5784,1149,3421,41498,2363
33688,216,4499,1071,3163,37202,1336
61412,2,47,415,32,4507,15
63339,22,130,356,118,3666,12
9448,26,1041,1473,762,12879,279
22878,1091,33113,1282,20673,206679,12440
23801,92,2540,1265,1741,35405,799
45469,41,662,853,571,15196,91
14116,40,906,1425,539,17244,367
27008,157,4680,1195,3299,29739,1381
37820,8,272,969,200,8510,72
51649,453,6290,725,5194,34375,1096
3974,4,159,1530,111,13790,48
52906,1261,12628,684,10483,149259,2145
32068,127,5308,1100,4141,47682,1167
3817,54,1510,1532,1053,36569,457
29981,21,698,1136,395,4322,303
14779,89,2384,1417,1564,16979,820
6137,319,12122,1503,8066,160144,4056
22092,87,2513,1294,1783,23501,730
23016,21,423,1279,295,7293,128
35399,27780,661609,1032,495703,1573231,165906
64249,560,7414,331,5933,46029,1481
34410,125,2314,1056,1732,13042,582
492,225,7935,1561,5570,83040,2365
56308,11,166,581,125,5015,41
7373,35,957,1487,664,33615,293
4717,6,212,1521,137,23497,75
33079,12,277,1082,209,7423,68
22987,665,49284,1280,33283,163550,16001
4701,72,1632,1521,1158,28153,474
23140,60,961,1277,823,39294,138
37029,1,12,991,6,3810,6
20676,13,561,1318,381,8708,180
60637,481,4741,442,3900,30029,841
12986,6,246,1442,131,9444,115
63846,3,68,345,51,7750,17
15548,100,4787,1406,3577,63925,1210
49139,48,911,793,633,14339,278
31291,28,622,1111,376,13454,246
54275,57,715,643,539,11811,176
33461,849,26342,1075,17760,104321,8582
40705,904,17405,919,12684,108625,4721
62138,239,4714,391,3678,44320,1036
58900,78,514,503,433,7496,81
37482,21,396,978,357,15081,39
43337,535,6929,877,5397,34123,1532
51613,33,349,727,276,10433,73
8765,36,1179,1476,783,14456,396
68511,3,83,204,64,2915,19
22466,102,1839,1289,1370,16597,469
43987,227,5252,869,3451,52846,1801
6353,18,441,1501,324,5758,117
34112,177,5018,1062,3438,28247,1580
68552,69,814,202,687,4855,127
27005,158,4636,1195,3786,32636,850
2850,71,4522,1542,2922,26634,1600
67431,11,104,239,79,3698,25
40376,3,89,923,69,3828,20
31663,24,403,1106,266,4631,137
9132,5,330,1474,232,38567,98
11162,129,9152,1461,5185,52433,3967
37983,20,263,965,202,5150,61
21722,46,1481,1299,994,23474,487
12158,4,271,1452,144,4894,127
17451,8,208,1375,172,9763,36
66664,3,27,264,18,987,9
2218,63,1269,1547,774,8646,495
30449,18,682,1126,417,5955,265
343,17,376,1562,242,14005,134
11014,12,1034,1462,601,27186,433
4704,44,1687,1521,1086,41639,601
9671,142,2457,1472,1653,9274,804
56467,107,1040,576,837,9081,203
28051,25,1216,1173,804,16332,412
26390,18,642,1209,433,3886,209
46426,15,194,842,145,6374,49
70521,24,203,136,192,29604,11
61885,166,1764,400,1452,30811,312
23066,3,202,1278,157,13680,45
65754,17,255,291,208,2778,47
62963,24,188,368,156,6237,32
67371,463,8396,240,7018,72142,1378
34633,13,452,1051,265,10028,187
13837,979,41491,1430,27213,121578,14278
4629,28,1830,1522,1290,49339,540
51870,296,2012,720,1535,21623,477
2824,3,302,1542,189,10688,113
9423,977,25487,1473,16471,124783,9016
34187,210,4511,1061,3099,41567,1412
6517,55,3538,1498,2461,53660,1077
31046,24,1176,1115,750,13642,426
761,103,4677,1558,2993,34719,1684
58857,221,4412,505,3496,60735,916
33591,112,3758,1073,2343,23651,1415
19440,18,190,1339,144,7153,46
5637,5,265,1509,170,8618,95
38523,114,3027,950,2356,29822,671
25668,154,3675,1225,2311,32280,1364
32620,2,233,1090,145,11775,88
5604,999,32156,1510,23437,242758,8719
20610,28,1595,1319,1151,24852,444
25910,59,1858,1220,1107,14612,751
49826,216,2881,774,2324,53969,557
16599,119,1719,1390,1142,23759,577
2036,429,12107,1549,7671,51509,4436
6485,659,13755,1499,8448,76999,5307
36945,42,1336,994,830,25530,506
10992,13,510,1463,313,11573,197
59203,95,963,494,758,6623,205
10439,20,998,1467,634,14264,364
53643,163,1545,664,1250,25834,295
55298,7,143,609,110,6523,33
54683,4,72,628,48,3013,24
5733,1793,64177,1508,41946,296978,22231
66489,19,261,270,223,4137,38
39999,111,1578,929,1185,11034,393
34008,6,317,1065,191,19602,126
50343,1899,29426,760,20468,123722,8958
3297,60,2953,1537,1887,22269,1066
57242,162,3048,555,2130,28800,918
40004,16,255,929,179,5127,76
22394,42,871,1290,615,8873,256
20087,12,363,1327,264,24161,99
50431,153,2221,758,1536,9157,685
22277,94,1304,1292,1057,23133,247
37103,2,71,989,52,5867,19
31573,22,322,1107,269,9136,53
24449,81,2410,1252,1494,32525,916
10931,34,2241,1463,1296,38307,945
59189,34,555,494,482,16195,73
50154,19,168,765,129,3139,39
37115,10,177,989,149,3471,28
8128,7737,198941,1478,118840,393854,80101
1216,33,1802,1555,1142,18507,660
14796,388,11526,1416,8035,72414,3491
59819,41,408,472,303,12432,105
34105,259,6848,1062,4957,40121,1891
51288,57,735,736,527,18631,208
61810,57,647,402,484,24956,163
25263,159,2648,1234,1871,16208,777
61604,32,387,410,312,5975,75
6626,36,1578,1497,1127,37600,451
56269,82,1701,582,1403,19359,298
26676,8,360,1202,216,10222,144
56644,120,1445,571,1126,20616,319
296,3297,175831,1562,115826,377164,60005
36416,1275,19625,1006,15102,142321,4523
55520,31,326,603,295,12999,31
56036,20,533,589,445,19019,88
63242,123,2066,361,1677,25408,389
24090,434,10203,1259,6465,85886,3738
38018,14,262,964,225,5224,37
69733,37,879,163,854,19534,25
57665,403,4051,544,2796,24095,1255
33828,9,486,1068,309,15311,177
32145,1094,28828,1099,20099,84146,8729
3658,13,683,1534,485,10486,198
15957,55,2254,1400,1500,25699,754
7073,21,819,1491,520,18416,299
22662,3,259,1285,162,5161,97
3659,19,424,1534,302,11181,122
61221,8,106,421,83,4471,23
65670,97,1583,292,1399,9971,184
48792,37,1219,804,1004,20025,215
10753,52257,1372220,1464,718034,2154676,654186
6468,422,7456,1499,4917,68455,2539
15708,467,16901,1404,11046,108262,5855
39054,60,973,941,761,18584,212
38526,7,230,950,180,6213,50
2307,16,418,1546,327,7436,91
9251,237,6770,1474,4190,39886,2580
61297,69,974,418,813,16378,161
16529,5,315,1391,224,8787,91
40381,38,922,923,732,13524,190
53109,85,905,678,722,10390,183
27208,10180,232293,1191,140726,480162,91567
68061,0,0,219,0,2217,0
381,16,743,1561,503,32472,240
55357,29,871,607,693,20918,178
11917,167,4921,1455,2680,28135,2241
8473,23,1093,1477,686,12686,407
60360,0,23,453,19,3272,4
66518,78,999,269,860,10375,139
15808,1818,48208,1402,29980,275248,18228
12396,705,34934,1449,20330,112309,14604
66782,4,30,260,23,3146,7
9673,287,8071,1472,5114,63949,2957
30745,492,6612,1120,5364,41082,1248
19623,6001,300477,1336,198844,919668,101633
18076,18,357,1363,250,9267,107
28476,1233,48820,1165,30394,355988,18426
37595,21,388,975,300,8139,88
65668,26,362,290,311,6218,51
50450,22,388,758,302,4976,86
50904,27,200,747,169,7039,31
23210,17,446,1276,394,19850,52
60344,14,297,454,256,7072,41
59213,17,300,494,237,4660,63
16437,56,733,1392,632,16695,101
26318,229,7061,1211,4085,35712,2976
9626,0,0,1472,0,11387,0
2197,36,3329,1547,2294,49603,1035
65583,17,177,295,143,3831,34
16157,161,5618,1396,3738,100099,1880
20877,10,304,1314,216,10881,88
41005,30,570,913,464,8340,106
70054,2,23,152,21,1434,2
49931,84,1726,771,1241,28279,485
9821,170,11047,1471,6909,42005,4138
5540,586,10004,1510,6158,53919,3846
61683,91,1630,407,1282,25561,348
38361,4817,72121,955,52555,161401,19566
5019,13,669,1517,406,17182,263
54062,309,3338,651,2379,17427,959
9681,119,5447,1472,3152,44316,2295
3092,2,119,1539,83,4777,36
17255,449,16426,1378,12264,125933,4162
316,25,989,1562,772,25234,217
21916,53,1750,1296,1068,36111,682
53428,86,506,670,424,6611,82
502,13,509,1561,361,22457,148
10909,11,434,1463,239,11927,195
49260,31,1098,789,815,22283,283
51496,181,6897,730,5036,16814,1861
23895,9,341,1264,275,35230,66
31668,5,149,1106,113,12454,36
35153,556,11105,1038,8491,87667,2614
1246,9,377,1555,277,37253,100
60689,47,955,441,727,8733,228
1135,33,960,1555,697,22829,263
42370,11793,336861,885,229426,841595,107435
10828,158,6493,1464,3963,32081,2530
33812,363,4595,1069,3417,43850,1178
25395,4177,95546,1231,57789,475446,37757
50265,631,8261,763,6682,59515,1579
41911,212,3098,899,2478,28773,620
56885,25,385,564,329,9509,56
31301,38,556,1111,372,14527,184
39415,24,442,937,339,11510,103
2248,119,7348,1547,4479,70819,2869
63096,12,102,365,85,3433,17
18574,11,571,1354,448,12949,123
59684,14,194,477,161,22326,33
46907,605,7983,836,6455,33093,1528
5235,29,877,1514,591,14377,286
48227,2199,47349,819,33390,220399,13959
22551,12,323,1288,228,8028,95
25316,190,2182,1232,1331,12360,851
41917,113,1288,899,982,11911,306
35388,7,115,1032,85,6630,30
13269,5,242,1438,127,14422,115
61619,2,18,409,14,2765,4
39847,79,2659,930,2138,20399,521
58989,0,16885,500,12324,84869,4561
27264,15,830,1190,494,23168,336
8866,740,15466,1475,9617,44918,5849
66833,0,9,258,3,1596,6
67425,59,691,239,577,13113,114
58635,8451,195372,512,157770,607055,37602
8832,548,14915,1475,9379,71369,5536
55901,53,591,593,445,12007,146
57588,23,229,546,179,5897,50
1168,30,1392,1555,1013,32698,379
41158,37,472,911,384,11530,88
54680,144,1081,628,872,21423,209
59337,55,746,489,582,12093,164
64550,29,449,323,338,8944,111
8244,112,1393,1478,906,18902,487
66859,152,2817,257,2298,33863,519
34773,24,539,1047,336,3755,203
6603,0,0,1497,0,16944,0
12277,34,6308,1451,2788,16063,3520
47265,139,1781,831,1468,19535,313
21081,1202,29234,1310,18400,165536,10834
50430,136,1553,758,1149,16955,404
19220,126,7152,1343,5066,54237,2086
54754,25,168,625,131,4074,37
8019,8,651,1479,468,17846,183
60850,155,1862,435,1218,16610,644
32301,22,518,1096,343,5576,175
37957,52,751,965,522,9679,229
42632,28,356,887,277,5896,79
62775,145,2510,373,1708,32727,802
27545,106,3983,1183,2540,34625,1443
67180,1339,33715,245,25195,190331,8520
11358,44,1888,1460,1315,27232,573
52323,236,3536,705,2817,33342,719
70494,16,148,137,139,4037,9
69248,104,1407,178,1212,17760,195
28677,42,1095,1161,851,24340,244
21227,17,385,1307,291,42376,94
17608,109,3242,1372,2350,31434,892
7189,281,5842,1489,3911,73719,1931
1088,199,7418,1556,5140,47247,2278
2916,355,14805,1541,8777,70710,6028
35782,139,1507,1024,1104,7949,403
55866,16,256,594,190,4574,66
64532,2649,45086,324,36529,251372,8557
21867,694,30641,1297,17430,253682,13211
65107,83,905,306,802,12572,103
261,120,5183,1563,3135,37837,2048
24298,104,2472,1255,1874,27224,598
2996,30,1061,1540,748,12952,313
32477,63,2360,1093,1748,57795,612
58718,2,46,509,35,2479,11
37380,1,22,981,16,1846,6
50796,4,53,750,44,6476,9
51550,512,5550,729,4477,43636,1073
69299,97,2483,148,2422,16593,61
53843,25,343,658,314,15674,29
16889,568,18631,1385,13389,172735,5242
13498,72,4281,1434,2476,26600,1805
7440,42,1340,1487,807,16906,533
9465,10087,255879,1473,140748,416353,115131
24945,7,294,1240,202,7163,92
41369,10,498,908,358,10438,140
59764,127,1372,474,1125,8916,247
25816,3,97,1222,65,7127,32
36926,32,456,983,371,14072,85
33508,308,5869,1074,4159,28021,1710
64804,23,663,291,526,16017,137
38685,9,156,947,113,5661,43
9420,221,6107,1473,3985,34700,2122
34264,18,451,1058,328,3878,123
49342,393,8897,785,7005,66599,1892
35188,118,1548,1037,1105,19946,443
24025,100,1867,1261,1345,50601,522
64720,33,1114,318,899,26600,215
50776,78,1323,750,1161,12902,162
52117,1595,18580,712,15259,108402,3321
48963,30,549,792,448,11627,101
32432,12,276,1094,161,10156,115
34273,162,2527,1059,1958,43134,569
38210,22,339,959,208,6508,131
25868,374,8607,1221,4969,53169,3638
27376,14,556,1188,340,9726,216
58920,28,450,502,350,16790,100
35871,0,41,1021,27,2461,14
35458,293,4712,1030,3663,70329,1049
8540,389,11930,1477,8279,91129,3651
12576,7,312,1447,134,9278,178
19536,748,20518,1337,14428,262519,6090
45759,41,617,850,494,12424,123
44257,18,465,866,371,9526,94
67651,27,603,232,494,9422,109
27418,8279,169391,1186,107730,478986,61661
2766,839,56199,1543,36635,339600,19564
4214,240,4406,1528,3191,33635,1215
53471,282,4096,670,3359,29359,737
58077,302,5758,531,4268,28517,1490
19587,442,6124,1336,3873,49820,2251
53263,83,1092,674,861,22107,231
14133,497,4179,1425,2792,42177,1387
30529,15,427,1124,286,11010,141
36787,41,907,998,748,15823,159
15802,46,798,1402,562,12151,236
23671,9,293,1268,200,3319,93
58249,31,212,525,167,3334,45
27949,942,19357,1175,12765,168225,6592
673,38,1278,1559,896,56018,382
28156,34,634,1171,474,5196,160
35421,38,1043,1031,773,21739,270
52630,1841,22874,694,17433,162421,5441
27427,1575,40107,1186,23991,248548,16116
53469,172,1752,670,1457,17898,295
18130,239,10997,1362,7749,162598,3248
315,133,4390,1562,3316,43267,1074
31135,39,2175,1114,1442,30738,733
39455,33,640,937,486,14021,154
63146,144,3035,364,2262,17397,773
38554,18,304,950,228,8907,76
29513,44,914,1145,475,8697,439
63428,65,1374,356,1170,17915,204
60515,24,295,447,237,7137,58
7873,37,1588,1480,1080,20615,508
12332,24,2796,1450,1386,30182,1410
40468,850,15874,922,12240,54477,3634
39511,307,5863,936,4290,88489,1573
34134,32,1031,1062,754,17132,277
8587,78,2564,1477,1543,19925,1021
36342,19,447,1008,366,9388,81
33766,5290,98660,1069,66834,386046,31826
35516,1503,24380,1027,17684,154065,6696
24079,852,28676,1260,19484,169770,9192
37138,99,2010,987,1622,30187,388
5179,49,1986,1515,1340,13107,646
14752,264,4983,1417,3331,30464,1652
31285,37,837,1111,566,8317,271
13444,110,7031,1435,3918,29405,3113
36027,2,18,1017,14,1524,4
55425,34,531,606,415,5166,116
12054,22,1260,1453,676,29713,584
1080,3,126,1556,77,9250,49
56992,293,3590,561,2812,37567,778
28429,324,7404,1166,4677,43013,2727
70133,612,7893,149,6960,38639,933
66016,249,2879,283,2523,16039,356
60665,105,1298,441,1092,12060,206
18843,83,2580,1349,1830,27977,750
57897,6,67,536,51,4196,16
45545,292,5313,852,3960,32502,1353
19809,0,0,1332,0,9646,0
62632,34,247,376,205,11345,42
4751,16,386,1520,270,12029,116
38300,4,146,957,101,5439,45
4815,14,696,1519,548,13757,148
21889,83,2029,1297,1484,22864,545
53022,173,5718,681,4589,17237,1129
68880,6,72,190,52,2015,20
22438,591,28021,1290,19041,129164,8980
46871,222,4832,836,3638,44900,1194
31578,108,1360,1107,923,15466,437
26079,15,257,1216,173,9459,84
56905,127,2399,563,1805,18659,594
22491,37,1477,1289,979,11857,498
35358,371,6723,1033,4854,43045,1869
4899,126,3718,1518,2668,62529,1050
30674,38,1887,1122,1093,20338,794
16255,6,477,1395,308,31401,169
32856,62,1409,1086,966,20633,443
31687,109,1497,1105,1085,8024,412
43218,1,55,878,37,1675,18
55893,62,1264,593,793,11272,471
63485,79,902,355,739,8884,163
9324,71,1409,1473,849,31431,560
20974,11,435,1312,313,10438,122
16709,18,2019,1388,1250,14183,769
17773,97,3493,1368,2432,29529,1061
50691,13,84,752,61,2887,23
28865,4,197,1158,125,12386,72
10164,35,1256,1469,814,15551,442
11451,29,1305,1459,804,13756,501
32359,244,4970,1095,3260,29728,1710
20125,528,19334,1327,13532,141761,5802
39996,2,132,929,105,9096,27
53911,68,769,656,583,6615,186
25673,1742,28895,1225,21756,143043,7139
19044,13,415,1346,276,9338,139
50117,10,211,752,164,6445,47
20400,81,1212,1322,814,10666,398
3830,44,1405,1532,990,39312,415
4890,15,1057,1518,758,18225,299
66296,69,486,275,368,4872,118
23377,23,820,1273,556,12520,264
50113,102,2194,766,1554,12334,640
60750,165,3573,438,2744,18649,829
8137,25,1049,1478,724,37163,325
21885,1,112,1297,77,5071,35
40538,165,2439,921,1877,14086,562
34207,386,9329,1060,6654,93886,2675
32565,3,119,1092,69,4222,50
32103,144,1826,1099,1279,19806,547
45934,35,1376,848,1069,7113,307
34452,267,6918,1055,4823,62521,2095
62214,17,293,389,234,10582,59
52450,7,148,700,117,5086,31
54282,32,344,643,271,7806,73
30503,44,685,1125,453,17675,232
48855,798,14086,802,9929,63985,4157
17974,89,4033,1364,2898,34978,1135
25176,388,7137,1236,6098,71160,1039
68140,28,374,216,294,6997,80
9284,5,236,1474,182,7241,54
23850,86,2260,1265,1380,10279,880
8590,6,333,1477,228,13653,105
17571,147,5808,1372,4198,34426,1610
31452,106,2158,1104,1563,31157,595
11886,132,6428,1455,3715,105063,2713
4873,744,14903,1519,9304,83511,5599
65693,51,319,292,272,4184,47
30073,710,12722,1134,9187,76371,3535
53047,2086,35431,680,26333,186898,9098
39329,15,340,938,296,7109,44
22127,99,2916,1294,1989,20178,927
26222,574,13356,1213,8381,56504,4975
515,2145,54042,1560,33780,217990,20262
33478,11,228,1075,179,9637,49
37299,81,1832,983,1458,27525,374
67611,73,557,233,394,6717,163
4160,342,8717,1528,6290,67338,2427
50460,520,7535,757,5857,66986,1678
49497,12,316,783,219,8402,97
56381,100,1020,579,714,24614,306
12974,3515,146450,1442,103421,402628,43029
34856,30,976,1045,572,14112,404
28814,30,636,1159,475,12085,161
13457,16795,482129,1435,312713,1254198,169416
64840,1047,11453,314,9295,59186,2158
7068,13,500,1491,378,21719,122
42680,82,1709,886,1347,14511,362
28431,102,3006,1166,1849,50725,1157
26646,79,1330,1203,849,10782,481
59426,142,1240,486,973,24014,267
58425,39,490,519,401,11541,89
46341,172,1917,843,1526,39172,391
61982,35,638,397,504,14523,134
21995,71,2413,1296,1521,24977,892
22926,292,6818,1281,4915,53017,1903
991,7,284,1556,210,23114,74
70142,2518,64994,149,63322,203060,1672
16774,77,1993,1386,1354,18474,639
812,15,430,1558,333,28460,97
16602,52,2626,1390,1877,45250,749
37005,7,142,991,106,6828,36
28824,41,1920,1159,1259,15864,661
51890,21,290,719,237,10409,53
67096,29,206,250,159,2526,47
3321,93,3614,1537,2540,51029,1074
48766,11,154,804,120,7483,34
69539,3,147,169,112,2621,35
27384,113,3325,1187,2031,24359,1294
34945,9,330,1043,230,14146,100
65687,9,236,292,211,9244,25
41776,62,490,901,357,6285,133
5490,237,6663,1511,4559,64941,2104
25448,4643,114623,1230,70436,556652,44187
63554,3,76,354,59,6297,17
63408,1,19,357,14,2648,5
54825,1494,13376,623,10733,67771,2643
24913,45807,1292787,1241,725361,4197738,567426
62924,20,315,369,251,8368,64
23954,14,225,1263,155,5777,70
30530,167,4147,1124,2662,32669,1485
12988,0,0,1442,0,68082,0
12119,11,433,1453,252,8152,181
66944,4,81,253,54,3475,27
6006,1901,67062,1505,42703,412101,24359
63729,41,548,348,411,4467,137
52619,9,74,694,47,2807,27
22627,260,7773,1286,5097,30161,2676
67533,96,1530,235,1246,8410,284
6829,159,6243,1495,3920,25576,2323
66621,15,443,265,282,9510,161
5237,528,15488,1514,10669,156781,4819
29972,12,464,1136,297,22996,167
20667,9,277,1318,231,13457,46
2775,15,1112,1543,771,20946,341
17330,22,1014,1377,697,20081,317
18462,4369,150130,1356,92520,501540,57610
24445,12785,246116,1252,144019,1249261,102097
11884,90,1758,1455,1111,11009,647
28280,0,17,1169,13,3451,4
61114,177,2605,425,1922,34768,683
40712,362,4726,919,3167,26507,1559
52628,170,2356,692,2007,25996,349
39815,330,7877,932,6671,87834,1206
4064,169,4041,1529,2860,33191,1181
11235,1159,22971,1461,14862,74453,8109
13112,26,735,1440,383,53936,352
29839,107,2974,1139,1754,18796,1220
51695,160,2072,725,1706,29438,366
65352,13,105,300,84,3455,21
29062,69,1514,1154,969,9522,545
26090,45,1404,1216,808,16733,596
18864,10,418,1349,258,6515,160
9261,36,1189,1474,739,22078,450
66139,17,201,280,163,4685,38
49755,11,150,775,106,3968,44
61716,179,2521,406,2100,20015,421
31674,134,1893,1106,1213,7488,680
10357,2404,112194,1467,72661,506144,39533
29876,5,161,1138,96,7072,65
11332,39,835,1460,543,10664,292
29891,84,2264,1138,1560,24721,704
35875,27,567,1021,413,9057,154
59369,97,1456,488,901,13556,555
35917,2068,58185,1020,45529,266142,12656
41095,219,3476,912,2732,19244,744
23713,899,46164,1267,31121,112455,15043
40776,8,237,917,186,3185,51
38033,58,1678,963,1261,45334,417
31485,6203,141600,1099,99542,611185,42058
59051,20,192,499,138,3939,54
426,91,2251,1561,1526,21960,725
38308,8,254,957,182,16994,72
49309,71,907,787,763,10983,144
63596,134,2470,352,1925,24741,545
37492,38,916,978,725,24944,191
31153,66,1722,1113,1405,38781,317
31172,30,782,1113,513,7383,269
35963,12,390,1019,293,11119,97
63661,28,470,350,350,7498,120
12713,32,1316,1446,747,13665,569
61065,96,707,427,515,5480,192
4013,58,1202,1530,828,28802,374
35506,4736,104815,1029,80274,420243,24541
33450,46,910,1075,706,9267,204
19933,434,11227,1330,8283,49327,2944
30667,34,1164,1122,807,7415,357
56311,7,173,581,138,5002,35
29213,16,459,1151,280,2922,179
59815,39,510,473,383,10160,127
36208,45,522,1012,392,5341,130
6575,1473,58392,1498,37837,255449,20555
317,102,4549,1562,3208,32214,1341
35168,86,1563,1038,1133,17580,430
43161,335,5820,879,4949,58860,871
19354,118,2003,1340,1604,77938,399
26810,5,168,1200,107,14665,61
3577,31,1084,1535,861,17122,223
48964,4,55,798,43,4092,12
27489,3426,96428,1185,64733,320486,31695
66527,23,560,268,435,10601,125
25778,130,4588,1223,2664,25543,1924
65469,37,327,298,267,4205,60
37728,47,650,971,517,15528,133
52469,21,535,699,391,8402,144
51711,305,4991,724,4032,43883,959
23621,16,580,1269,433,39763,147
57907,11,737,536,540,5170,197
41653,29,720,903,521,9033,199
59869,429,9274,471,7723,51017,1551
66649,1,9,264,7,1240,2
33502,2689,58451,1074,34666,175257,23785
54733,81,1065,626,829,22259,236
70155,21,207,148,176,4126,31
69067,41,514,184,396,9320,118
22901,148,3706,1281,2521,25695,1185
53692,1911,54622,663,40389,119171,14233
25974,25,621,1218,450,17863,171
5863,831,33490,1507,20956,176161,12534
26006,33,1914,1218,1084,36830,830
53812,85,706,660,495,8582,211
3214,349,28968,1538,18812,92871,10156
44167,463,6564,867,5596,60518,968
31235,6,365,1111,303,11097,62
19470,392,11806,1339,8485,167779,3321
28466,50,812,1165,488,9147,324
70088,9,103,151,95,2201,8
25782,40,1301,1223,773,12190,528
16776,546,13850,1386,9236,86811,4614
67945,18,195,222,134,6339,61
54297,36,195,643,157,4613,38
388,94,3283,1561,2322,54664,961
15656,242,6239,1404,3797,67503,2442
33711,823,12927,1070,9484,50137,3443
17725,47,1264,1369,983,43100,281
31202,3102,64578,1112,42675,149571,21903
57025,58,676,561,509,8051,167
27341,66,2908,1188,1609,60063,1299
4224,6,483,1528,280,6762,203
49803,23,248,774,190,6024,58
64427,42,665,326,510,6662,155
47853,16,364,824,278,5293,86
21092,711,68402,1310,41418,239199,26984
40096,76,1008,928,806,23137,202
5205,285,9926,1514,6248,80210,3678
57204,0,271,556,211,6602,60
27668,823,13543,1180,8287,102057,5256
54462,61,819,636,660,9760,159
20242,324,7099,1325,4216,31585,2883
10366,62,1067,1467,675,7351,392
5631,28,1464,1509,967,23097,497
57043,1,43,559,40,4290,3
33477,167,5379,1075,3295,20904,2084
62033,7,94,395,84,3619,10
29320,37,1373,1149,841,17533,532
24988,19,439,1239,373,18549,66
8094,239,18036,1478,12144,127364,5892
63042,2,79,367,53,4347,26
53562,20,352,667,245,11353,107
39332,28,691,938,594,13759,97
18248,147,2898,1360,1890,43089,1008
29033,0,0,1154,0,3661,0
31787,39,1061,1104,748,13703,313
10492,32,1210,1466,856,16100,354
19693,3,70,1334,51,5323,19
33294,50,561,1078,417,10108,144
54772,31,231,625,177,6395,54
37337,12,420,982,327,13232,93
68835,15,189,192,156,3841,33
45947,54,1073,848,870,20234,203
28100,47,1489,1172,998,34886,491
31097,101,3056,1114,2057,25811,999
34698,491,8430,1049,5580,90889,2850
9636,18,1523,1472,931,13229,592
69595,26,580,166,449,9382,131
36301,354,3710,1009,2804,31924,906
61900,9,82,399,72,5452,10
69246,2,61,178,49,1787,12
57483,33,407,549,279,8586,128
10971,121,4725,1463,2724,22266,2001
32165,306,11570,1098,6883,50315,4687
69997,19,253,154,217,4378,36
31642,217,7922,1106,5080,44659,2842
29086,3201,127823,1153,85052,252600,42771
13430,154,2005,1435,1398,16606,607
64745,2,62,317,45,4573,17
38295,27,269,957,230,6443,39
58611,150,2217,509,1816,41498,401
35750,70,783,1024,551,20566,232
8687,2,97,1476,68,6314,29
19917,70,2029,1331,1335,31872,694
2809,98,3822,1542,2817,40474,1005
30096,69,2284,1133,1493,22781,791
63993,30,575,340,481,10974,94
17228,243,6353,1379,3940,47241,2413
15040,10,660,1413,364,8099,296
13941,14,969,1428,561,37118,408
29040,393,12149,1154,7551,73092,4598
61273,4,84,419,72,1935,12
49092,61,975,794,878,15198,97
55924,5847,103087,590,75884,574708,27203
13354,126,5427,1436,2847,58801,2580
6949,65,2414,1493,1659,47354,755
654,164,8318,1559,5302,69552,3016
54806,25,207,623,185,7580,22
64692,8,142,319,90,3654,52
30272,915,13156,1130,9174,65564,3982
58995,4,81,500,64,3290,17
58145,121,4678,529,3716,28602,962
52283,3699,47986,706,36270,402174,11716
34982,137,3333,1042,2473,42743,860
22003,8,683,1295,456,22094,227
37677,938,17733,973,14128,147041,3605
29883,17,888,1138,606,28706,282
40491,13020,248797,915,157298,857311,91499
64376,80,1288,328,1122,12506,166
20793,2,531,1316,371,18973,160
53854,8,95,656,75,4563,20
21508,98,1326,1302,876,7372,450
9099,471,19717,1474,13121,130895,6596
3871,10295,563450,1531,341576,2147367,221874
69384,13,156,174,135,7779,21
61414,5,42,415,35,2571,7
1144,110,2836,1555,2195,20078,641
50646,406,5436,753,4793,65576,643
17583,68,947,1372,737,36084,210
42666,22,615,887,522,28503,93
48755,203,4370,805,2864,21917,1506
34621,35,641,1050,446,13355,195
56497,416,4525,575,3684,35361,841
57814,126,1427,538,1083,20243,344
48549,48,651,811,527,6734,124
12983,0,204,1442,101,6568,103
30307,17,316,1129,231,4958,85
49577,40,595,781,486,13738,109
35446,22,505,1031,360,11238,145
10130,33,900,1469,633,12651,267
20581,474,12754,1319,8874,109650,3880
6967,23,921,1493,645,26062,276
36310,273,4225,1009,3638,51329,587
68194,587,12420,215,10338,125424,2082
61564,15,196,411,164,5075,32
24016,155,5527,1261,3383,46457,2144
69791,12,252,160,218,3020,34
3539,22,428,1535,331,10410,97
18842,21,1309,1349,911,38610,398
1934,101,2263,1550,1549,34128,714
61539,83,1148,411,886,16987,262
65239,33,679,303,527,13015,152
37490,16,280,978,251,4371,29
66312,59,1247,275,960,12081,287
37256,7738,200796,984,160042,514636,40754
35087,21,346,1040,225,7491,121
3132,231,11590,1539,7402,73007,4188
58985,27,446,501,344,6227,102
10917,1,47,1463,39,12603,8
14759,9,372,1417,236,7911,136
12177,23,885,1452,527,12032,358
33411,35,746,1076,558,18427,188
61907,18,309,399,199,6318,110
65531,257,2912,297,2345,14389,567
40028,15,320,929,229,8097,91
50597,18,228,754,167,4322,61
5240,33,1468,1514,969,21673,499
51215,9,154,738,124,3657,30
21112,8,579,1309,408,11883,171
23481,36,402,1272,272,6787,130
54183,48,441,647,377,15693,64
15107,132,2647,1413,1728,25192,919
48296,84,1167,818,920,10237,247
68530,829,18958,203,16179,133360,2779
54972,53,357,618,276,5410,81
12640,42,2343,1446,1240,19885,1103
49228,29,1144,790,779,17254,365
4785,87,2369,1520,1530,17579,839
68549,4,130,202,76,3556,54
43163,157,3086,878,2499,27499,587
40999,45,932,913,785,13119,147
50589,738,8802,754,6927,77630,1875
49230,97,1406,790,1073,9747,333
40870,10,146,916,113,3563,33
67591,2,79,233,53,3121,26
2711,25,1226,1543,903,15829,323
55592,71,1320,599,1124,30033,196
19160,3,185,1344,139,9268,46
40121,36,380,927,279,5622,101
24049,0,46,1260,36,7593,10
773,2,111,1558,70,3828,41
33528,17,263,1074,184,8506,79
53823,10,174,659,130,6657,44
30807,86,1751,1119,1191,23243,560
19870,39,1218,1331,856,20836,362
13969,692,23680,1428,15466,94017,8214
24149,318,5990,1258,4107,53322,1883
27847,473,12649,1177,7799,72451,4850
49587,2,13,780,8,5932,5
31545,220,3141,1108,2285,24536,856
67967,35,375,221,280,5460,95
35792,554,8086,1023,6194,62426,1892
49966,28,506,770,410,6446,96
63944,24,207,342,160,2834,47
51961,33,623,717,451,14374,172
12513,242,6331,1448,4014,33814,2317
34185,54,1482,1061,1030,26082,452
2342,35,1386,1546,1052,26576,334
27483,11,402,1185,230,4513,172
25852,21321,496139,1221,292275,2302300,203864
27745,19,668,1179,389,12685,279
36320,198,4200,1008,3280,25275,920
33817,13,1003,1068,754,23816,249
53615,123,2485,665,1921,22921,564
68021,4,84,220,58,3733,26
59199,53,519,494,409,8152,110
56347,118,1141,579,911,12718,230
20965,29,312,1312,265,19111,47
18099,1,87,1363,65,5442,22
55567,101,913,602,725,24290,188
18303,42,1025,1359,707,31455,318
7748,2200,106979,1482,60555,458235,46424
61109,108,6119,425,4488,18152,1631
2891,2,228,1541,177,15999,51
48682,11,292,807,213,6618,79
5012,9,316,1517,225,9756,91
28333,370,7311,1167,4967,63057,2344
69683,8,68,164,68,1541,0
65861,6,156,288,111,7575,45
26350,67,1726,1210,992,24299,734
42254,266,3260,893,2636,31497,624
43115,169,2346,879,1993,27846,353
21093,10,492,1310,340,30348,152
12088,43,1491,1453,938,16656,553
38953,4,61,943,54,13645,7
30373,2,252,1128,150,5093,102
11478,347,9939,1459,6055,51850,3884
39962,234,3154,930,2779,34725,375
68628,59,831,199,698,9487,133
57219,31,278,556,233,13568,45
42972,14,236,882,179,12443,57
32611,17,489,1091,367,11427,122
25716,71,1753,1224,1168,12997,585
31650,80,2969,1106,1631,13458,1338
19661,78,2489,1335,1982,40181,507
15472,105,2744,1407,2014,30547,730
56573,169,2693,573,2168,19236,525
7900,11,714,1480,565,19120,149
26135,145,5275,1215,3665,48780,1610
57176,21,256,557,203,14407,53
19215,31,821,1343,596,14013,225
55661,419,8527,599,6627,40124,1900
27845,1372,23677,1177,14729,103613,8948
67277,9,93,243,73,4129,20
28783,80,1978,1159,1338,21688,640
60722,77,1076,439,859,10179,217
15621,83,2007,1405,1378,27819,629
26294,17,786,1212,503,13610,283
20771,135,2945,1316,2043,38484,902
22877,68,1150,1282,703,6184,447
5094,16,789,1516,536,17977,253
64857,22,554,314,320,7425,234
32705,15,443,1089,334,7015,109
56106,0,13,587,13,1330,0
23269,94,2267,1275,1559,22786,708
17078,185,2508,1381,1836,22020,672
9310,439,13739,1473,8993,38753,4746
69223,5,40,179,31,1054,9
58113,8,218,530,157,8376,61
51519,127,1124,730,978,38398,146
28290,29,747,1168,432,10408,315
52608,2,65,690,52,6358,13
42742,6,180,885,136,6869,44
18075,738,29833,1363,18798,166521,11035
39352,0,25,938,17,2744,8
11445,828,81236,1459,40102,279601,41134
26953,301,13012,1196,8396,91122,4616
43857,27,331,871,273,8439,58
29602,39,1111,1144,686,23413,425
14154,15,543,1425,385,8989,158
27108,337,13904,1193,8609,141164,5295
55821,94,1342,595,1075,36102,267
31141,64,1515,1114,1312,28976,203
47055,2,41,742,28,3976,13
2706,2843,54648,1543,37210,149799,17438
25964,393,4948,1219,4302,52858,646
12023,4,248,1454,133,8579,115
50911,1,25,747,19,5293,6
50532,703,11384,756,8657,57154,2727
3987,94,1293,1530,875,18518,418
57552,23,421,548,329,12655,92
3343,12,355,1537,239,35967,116
1892,222,9986,1550,6550,50898,3436
53479,242,3846,670,2162,63990,1684
30726,936,18634,1121,14143,69304,4491
12132,40,1369,1453,668,14937,701
9936,2293,188790,1470,107990,595310,80800
33241,214,3527,1079,2392,19187,1135
41225,19,394,910,351,6881,43
65797,3,35,290,23,5864,12
21240,135,1821,1307,1329,43591,492
43077,95,1141,880,730,8609,411
24583,28,933,1248,618,12562,315
15241,9,450,1411,297,24850,153
50469,768,9045,757,6883,58949,2162
35357,19,295,1033,196,5824,99
35600,9,229,1027,172,15446,57
58614,19,221,512,182,4908,39
65260,98,1031,303,844,10893,187
25567,1,224,1228,137,4079,87
19453,7,302,1339,227,7701,75
68786,2,11,194,7,717,4
61068,1368,24034,426,18570,79453,5464
23766,10,195,1266,133,10501,62
724,248,15475,1559,10034,148562,5441
49350,2162,56198,786,44522,371610,11676
61075,1960,42980,426,32763,190815,10217
12901,80,2130,1443,1245,20021,885
63313,111,2013,360,1452,29574,561
1910,1,70,1550,52,6195,18
7558,95,4731,1485,2930,49065,1801
11374,21,1505,1460,857,9469,648
16236,318,5959,1395,3250,20770,2709
15457,35,1773,1407,1259,16880,514
5651,28,1146,1509,778,12329,368
438,189,7228,1561,5214,46979,2014
33271,21,128,1078,100,2803,28
58550,3,46,514,37,2370,9
2554,328,24314,1544,17028,160627,7286
13860,1885,51083,1429,29728,177853,21355
15634,53,741,1405,558,22263,183
23794,15,614,1266,417,13793,197
38050,6,154,963,110,8507,44
52099,29,374,712,329,11816,45
55512,29,424,603,314,9116,110
12755,12,589,1445,296,5919,293
63609,23,441,352,303,8802,138
66583,105,1757,266,1470,13715,287
45342,84,601,854,480,16600,121
26445,2394,47957,1208,33110,213474,14847
10477,46,946,1466,626,13179,320
15403,104,3264,1408,2144,36225,1120
20042,71,2058,1328,1285,47974,773
28359,200,5416,1167,4236,85858,1180
17801,192,4776,1368,3780,42565,996
39786,46,910,933,704,7597,206
13440,8,456,1435,239,12977,217
70383,26,261,141,227,3068,34
65893,96,1650,287,1454,26138,196
21986,13,600,1296,356,4413,244
69510,7,106,170,98,4652,8
50997,18,297,744,246,7816,51
54284,80,967,643,792,12040,175
5140,166,6757,1515,3649,25122,3108
10830,10,1535,1464,716,9111,819
41754,1274,19269,901,14926,121344,4343
68555,12,233,201,182,3062,51
36026,36,1071,1017,678,55412,393
32619,189,6210,1091,3621,28458,2589
66618,48,821,265,667,12525,154
21793,14,461,1298,329,17008,132
20193,32470,932262,1326,582328,1574563,349934
5095,1,202,1516,181,14962,21
8497,14,738,1477,491,6004,247
8129,37,1173,1478,754,9986,419
28617,111,3187,1162,1919,20775,1268
23656,84,2706,1268,1991,47630,715
6923,7685,429648,1493,229677,984331,199971
28235,40837,735473,1169,534914,1307399,200559
67363,7,106,241,75,3682,31
28461,242,5422,1165,3778,71047,1644
28983,28,923,1155,566,15826,357
3210,79,1672,1538,1192,12001,480
21054,2,82,1311,61,10469,21
25134,41,1934,1236,1240,24515,694
21578,13,527,1301,341,14205,186
60980,2,52,430,33,4225,19
42925,0,430,882,341,21126,89
42935,6,96,882,70,4021,26
54745,171,1992,626,1523,20533,469
17101,11,787,1381,464,10817,323
23315,6,192,1275,151,5079,41
17677,24,550,1370,424,9108,126
17319,100,8286,1377,5185,34861,3101
58169,4,44,528,30,4111,14
46323,5,73,844,54,4795,19
13339,20,1034,1437,645,16508,389
18185,6,367,1361,274,18794,93
24774,88,918,1244,791,32219,127
12492,176,10955,1448,5512,51934,5443
24245,24,1040,1256,721,9076,319
42558,5,209,889,121,17062,88
27448,45,1972,1186,1101,14026,871
13822,23,656,1430,388,30341,268
32846,2167,56682,1087,39103,402157,17579
7003,16,637,1492,394,26901,243
46813,121,2424,837,1886,17966,538
15336,31,872,1409,596,24434,276
37681,272,4402,972,3684,53436,718
38164,8336,185006,960,142780,885982,42226
61127,77,1039,424,867,16996,172
32118,10,176,1099,119,8480,57
17363,25,459,1376,340,16338,119
15824,311,6048,1402,3962,56449,2086
9077,28,900,1474,621,15478,279
54779,20,147,625,115,3029,32
47217,109,1204,832,938,9885,266
11957,1397,68600,1454,40899,433450,27701
10339,149,4495,1467,2730,32995,1765
62992,52,728,368,644,21578,84
15198,94,2605,1411,1701,28293,904
38994,45,580,942,467,12031,113
26730,22,952,1201,500,9993,452
22111,84,3595,1294,2324,57226,1271
48486,60,1075,804,852,25053,223
29257,8,184,1150,157,10665,27
59905,77,1483,469,1082,14727,401
9836,150,5054,1471,3274,20674,1780
17275,1045,42158,1378,32838,170082,9320
58259,26,601,524,421,8646,180
61395,993,12774,416,9906,87489,2868
34548,52,1411,1053,1206,18329,205
53207,4,56,675,42,3994,14
61871,114,1123,400,953,11626,170
4246,38,1224,1527,921,14813,303
16632,36,1041,1389,757,13124,284
57115,7,118,558,77,9043,41
54554,229,4804,633,3950,36779,854
31333,82,839,1111,576,11286,263
34950,37454,1420308,1043,957807,3626697,462501
35083,10,271,1040,141,4462,130
1757,84,3582,1551,2612,36762,970
15487,511,18474,1407,12731,154672,5743
52021,55,557,715,498,11941,59
68941,21,407,188,306,7278,101
24729,16,534,1245,460,17799,74
26044,3153,69804,1217,46841,143192,22963
27592,181,5100,1182,3064,29735,2036
45836,31,816,849,630,11895,186
1863,71,3010,1550,2113,110147,897
58651,165,1349,511,867,11540,482
2060,1625,40586,1548,25559,179384,15027
62510,20,175,380,139,2643,36
61240,37,731,410,562,6294,169
58274,29,370,366,303,5431,67
15458,29,756,1407,553,38292,203
67261,774,14098,244,11284,110634,2814
66143,11,103,279,86,6140,17
24269,0,77,1256,57,3687,20
57701,26,336,543,266,6137,70
60710,338,3703,440,2740,19655,963
58670,8154,220053,510,151489,808703,68564
53545,256,3533,668,3037,29935,496
50625,229,5197,754,3691,56315,1506
13736,540,14733,1431,9238,71284,5495
46207,293,4203,844,3051,19467,1152
18760,42,1210,1351,906,37722,304
70141,5,101,148,76,3250,25
54718,6,50,627,49,2721,1
54065,215,2027,651,1539,16578,488
11321,10,598,1460,337,13103,261
11099,451,10574,1462,5725,34025,4849
8730,48,1094,1476,783,25417,311
54896,33,194,620,168,5631,26
30875,13,498,1118,320,6682,178
58243,82,741,525,654,17265,87
4992,6,190,1517,116,12720,74
60950,6,86,431,66,2951,20
6579,14,315,1498,209,8450,106
9789,20,1055,1471,636,12658,419
9060,363,5125,1474,3416,62952,1709
22917,20,890,1281,618,19152,272
14579,2,336,1419,233,14305,103
3351,10,583,1537,392,22235,191
10056,3207,72932,1469,40576,152403,32356
16313,0,57,1394,25,5688,32
10763,18,662,1464,434,11316,228
55842,107,1720,595,1384,14717,336
6679,117,3183,1496,2217,35940,966
68536,0,56,203,45,7359,11
27869,752,19986,1176,13718,150940,6268
20451,61,667,1321,451,10786,216
19694,89,2727,1334,1612,23103,1115
49870,22,1066,773,602,6816,464
69347,4,25,175,20,2113,5
38725,415,7733,946,5536,31707,2197
50928,17,162,746,134,3067,28
60917,6,34,432,33,2959,1
22706,1155,43223,1285,31843,202716,11380
51457,16,254,732,182,6731,72
19412,55,1466,1339,1003,29386,463
10115,5409,189629,1469,113744,548131,75885
49691,19,342,777,282,15261,60
37474,43,731,978,651,31449,80
53875,70,1038,630,939,10012,99
6304,19,1465,1502,920,13837,545
28766,40,595,1160,390,10940,205
24017,4,72,1261,59,12990,13
20886,55,1557,1314,966,35996,591
9840,1472,35323,1471,22792,212614,12531
17394,6,231,1376,154,6641,77
30561,15,251,1124,174,6758,77
23218,12,540,1276,378,6057,162
49490,20,284,783,230,17120,54
34281,53,1561,1059,1076,10199,485
15310,365,9214,1410,6244,72009,2970
61055,6,80,427,61,6741,19
31520,193,2968,1108,2126,32765,842
20830,39,976,1315,726,13628,250
26472,10,688,1208,427,15064,261
3662,6,159,1534,113,11633,46
53120,175,2217,677,1759,23788,458
23102,6,147,1278,125,4920,22
32509,31,589,1092,414,10399,175
44787,113,1735,860,1482,24613,253
55287,61,745,609,571,37370,174
14823,238,7691,1416,5726,59949,1965
69088,2,55,184,33,1417,22
50304,123,2181,762,1624,11572,557
51183,3,31,739,27,2394,4
17067,158,3022,1382,2064,20392,958
54488,18,260,636,177,7729,83
59769,268,2832,474,2334,19791,498
4600,32,862,1522,609,17885,253
8786,6,508,1476,302,16184,206
49478,42,995,783,737,8697,258
31295,19,764,1111,584,20327,180
2524,687,34033,1545,21523,78238,12510
70378,76,868,141,784,5496,84
23729,72,1828,1267,1283,19517,545
33959,6791,100559,1066,74819,384636,25740
52214,51,859,709,700,13579,159
26998,686,15503,1195,9788,71532,5715
3474,43,1030,1536,737,41274,293
319,116,6013,1562,4071,79991,1942
69113,14,464,183,416,3944,48
55319,127,2063,604,1735,29031,328
65632,8,51,294,41,3203,10
67378,2,17,240,11,2692,6
35743,144,1560,1025,1078,12461,482
33702,417,5895,1070,4211,20327,1684
14764,0,0,1417,0,6252,0
13660,25,1139,1432,677,12051,462
67033,35,549,251,370,7677,179
27830,11,261,1177,223,23242,38
20939,497,18644,1313,12324,80088,6320
1087,120,4112,1556,2860,68904,1252
23189,6,186,1276,167,16111,19
5011,3,154,1517,105,9196,49
58642,43,1290,511,888,12200,402
38662,0,34,947,27,4238,7
60991,31,835,429,533,16085,302
26856,444,5617,1199,3729,36577,1888
70493,4,71,137,60,4946,11
55366,29,311,607,249,11175,62
37098,26,584,989,494,11366,90
32506,25,400,1092,270,5467,130
68117,38,390,217,301,2629,89
26941,56,2203,1197,1331,22853,872
19992,28,1747,1329,1318,18456,429
30431,20,804,1127,519,21056,285
29440,5494,111512,1146,65863,461396,45649
21606,171,3450,1301,2443,20870,1007
53635,5,50,665,40,2666,10
36402,3,82,1005,66,7792,16
57944,145,932,535,757,15027,175
24529,20,512,1250,317,7493,195
53561,63,839,667,600,7034,239
64282,0,1206,330,937,37880,269
34801,16,275,1047,235,6872,40
25793,617,14182,1222,10032,63813,4150
5085,84,1189,1516,857,11877,332
41229,29,326,910,265,9098,61
5974,23,999,1505,731,17532,268
33037,18,656,1083,391,8306,265
37425,81,2198,980,1919,54923,279
60570,290,5382,445,4254,26989,1128
1000,23,986,1556,766,24609,220
40750,32,415,918,326,15416,89
37435,56,1136,979,841,16315,295
1380,66,1657,1554,1208,20846,449
66026,1337,18225,283,14123,77486,4102
49904,0,5,772,5,2019,0
785,165,4333,1558,2881,44489,1452
57330,381,5101,542,3651,21437,1450
64472,14,243,325,172,8645,71
48228,10,85,819,75,2636,10
24951,2,195,1240,130,7738,65
59180,1,57,495,45,3128,12
56183,63,638,584,498,8091,140
21452,76,2092,1303,1317,35933,775
70276,83,1243,144,1242,23538,1
21221,67,1991,1307,1585,54761,406
59521,30,427,483,301,11267,126
55000,31,327,617,249,6109,78
11828,94,2824,1456,1632,32415,1192
36389,245,4044,958,3241,49602,803
19319,2969,80026,1341,53205,466059,26821
17219,14,545,1379,347,10452,198
3395,956,30434,1537,20324,189607,10110
8783,255,5582,1476,3633,31356,1949
53929,120,1108,656,1008,20430,100
10478,14,531,1466,355,12369,176
56670,1695,44939,570,35138,151022,9801
62503,17,155,380,121,7122,34
52228,1610,35131,708,25917,197923,9214
2236,9,177,1547,137,8014,40
40995,7,274,913,184,5354,90
34670,137,2181,1049,1516,32919,665
8579,576,12659,1477,8093,130795,4566
30714,91,2100,1121,1729,34180,371
43565,16,322,874,267,8628,55
67522,13,218,236,203,3480,15
26095,395,4585,1215,4019,59182,566
69695,11,162,164,138,2045,24
55869,58,1159,594,791,16140,368
30245,25,503,1130,311,6428,192
9984,150,5010,1470,3476,45160,1534
20714,2,224,1317,153,4031,71
18449,567,9685,1356,6070,73312,3615
14054,46,2867,1426,1690,23636,1177
13117,619,25224,1440,14722,151495,10502
9676,380,14841,1472,9468,82720,5373
5348,66,1343,1513,879,23706,464
64501,31,253,324,208,4043,45
20539,28,1265,1320,801,26552,464
12486,6,493,1448,272,30475,221
65952,718,37637,285,32164,70063,5473
66730,19,126,261,108,4351,18
32096,331,7078,1099,4721,36009,2357
1448,71,4019,1553,2765,36781,1254
38394,9,125,954,102,8516,23
14190,69,1307,1424,930,18403,377
60797,29,520,437,422,12807,98
67791,53,744,227,586,11099,158
24787,22,735,1244,511,9100,224
53706,19,148,662,136,7036,12
34022,148,2026,1064,1550,21514,476
12555,313,6654,1447,5168,46852,1486
58492,25,726,516,520,21331,206
62789,70,880,373,580,12783,300
13345,20,491,1437,270,9471,221
37024,81,1236,991,1099,17375,137
9661,5,161,1472,104,7863,57
50639,2,31,753,27,2565,4
62153,1354,15347,390,11961,53303,3386
49004,40,869,792,742,23779,127
31652,3,88,1106,54,2925,34
6119,190,9509,1503,5998,85020,3511
61777,53,1524,404,1135,35337,389
20007,17,339,1329,250,8024,89
22818,1772,21405,1283,13776,103711,7629
37516,477,10921,977,7075,47706,3846
36019,117,3151,1018,2162,22155,989
33983,29,694,1065,402,15991,292
26566,101,3165,1205,2256,52593,909
21845,36,1866,1298,1215,32398,651
2316,26,739,1546,509,24475,230
5664,62,2608,1509,1583,16775,1025
40284,34,506,925,437,9687,69
49748,37,883,776,677,23213,206
9689,97,2896,1471,1838,29580,1058
64267,193,3311,331,2605,20603,706
36914,1268,19865,995,16423,111563,3442
42494,93,1217,890,950,18570,267
69521,22,325,170,306,7525,19
3673,12,336,1534,274,30264,62
22563,24,377,1287,259,9029,118
12007,28,1466,1454,768,26416,698
64546,26,833,323,606,10235,227
37701,27,464,972,326,5289,138
68447,33,626,206,491,8186,135
67409,33,413,239,315,6044,98
2258,125,2810,1547,1972,18477,838
2769,29,1200,1543,858,38336,342
18911,385,4994,1348,3399,105112,1595
56008,15,170,588,130,5692,40
30750,13,806,1120,443,13797,363
8359,83,3009,1477,1774,33150,1235
54684,801,13644,628,11014,107543,2630
31268,3038,52264,1111,38001,135822,14263
37817,11,658,969,505,14620,153
68158,42,675,215,507,13909,168
7562,81,3795,1485,2680,58254,1115
59398,11,196,487,161,7717,35
31189,67,1478,1113,1019,27102,459
69848,53,557,158,444,8076,113
20835,26,276,1315,207,10152,69
22620,675,19035,1286,10928,105652,8107
33698,14,282,1070,174,9396,108
67462,8,77,238,60,2384,17
37843,31,758,969,565,22366,193
59254,1875,25019,492,20450,136540,4569
38047,6,160,963,122,6157,38
55310,29,273,608,209,4510,64
30766,8,214,1120,158,11164,56
39197,21,580,940,503,16333,77
8007,277,5484,1479,3374,50275,2110
69053,38,786,185,716,11483,70
25496,17,316,1229,229,13739,87
60036,101,1088,465,935,18350,153
56793,417,4393,567,3671,34525,722
5556,59,3550,1510,2330,25467,1220
14665,36,1486,1418,1092,20400,394
20735,80,4196,1317,2881,49317,1315
2703,56,1892,1543,1293,18454,599
32624,13,595,1085,378,9552,217
22378,0,0,1290,0,2120,0
20183,117,2060,1326,1464,9951,596
62438,305,8342,382,6620,45455,1722
68806,12,80,193,67,3530,13
66831,23,364,258,300,9567,64
52050,24,343,714,257,11309,86
26009,13,840,1217,532,9363,308
50128,117,1490,766,1250,10053,240
28277,34,1170,1169,722,23088,448
60560,113,798,446,720,8666,78
60673,47,587,441,477,10386,110
56039,21,325,588,253,3968,72
53956,281,5789,588,4600,49553,1189
9316,176,4043,1473,2842,19756,1201
40734,32,469,918,402,10661,67
63202,23,252,362,220,12560,32
69868,6,166,158,154,2918,12
15844,12,469,1402,290,7133,179
50426,26,457,759,319,20598,138
8097,48,1123,1478,767,13630,356
32377,190,2893,1095,1957,13365,936
30017,755,12842,1135,9774,80630,3068
19434,4,343,1339,295,4048,48
23250,64,1646,1276,1249,33096,397
3460,1132,33846,1536,21738,141428,12108
67314,12,136,242,108,2636,28
54321,12,328,642,225,3475,103
67082,5,58,250,56,4782,2
29877,655,9247,1138,5445,44465,3802
10408,11,509,1467,308,4343,201
15399,91,1854,1408,1376,22712,478
66375,7,143,273,123,5835,20
54562,2110,308012,633,220647,384985,87365
25089,5,429,1237,278,17931,151
51320,495,6940,735,5734,78608,1206
66200,90,2231,277,1715,16101,516
26954,5,242,1196,220,14263,22
4749,312,17254,1520,11194,115220,6060
31176,5,238,1113,137,5566,101
38215,24,307,959,196,5279,111
10829,6,420,1464,279,13831,141
55048,107,925,616,731,4323,194
27500,23,830,1184,518,30928,312
8192,6,228,1478,165,17594,63
30059,139,2652,1134,1903,48877,749
67007,720,11469,252,8853,93937,2616
15,1897,52006,1567,31119,336394,20887
2599,133,4204,1544,2570,29692,1634
51813,3093,54018,721,39902,348717,14116
4515,28,1390,1524,1037,22303,353
46299,14,269,844,195,9090,74
48630,28,299,809,221,6749,78
10552,261,8984,1466,5649,43335,3335
49879,4,126,772,109,5395,17
1373,32,948,1554,643,12794,305
55090,16,290,615,137,2657,153
1999,97,2020,1549,1500,63399,520
68506,11,160,204,129,6719,31
39208,3215,67524,938,53904,257832,13620
42358,48,974,892,737,7558,237
17954,4,215,1365,179,4874,36
29881,96,1979,1138,1326,9924,653
29313,426,8369,1149,5316,48732,3053
4902,45,949,1518,590,19497,359
16856,67,1128,1385,788,19205,340
49206,1891,21110,791,15942,72463,5168
41618,37,592,904,484,15032,108
28436,58,1534,1166,936,23204,598
3978,4,159,1530,115,17674,44
7048,619,43991,1492,28421,145739,15570
6561,23,1016,1498,721,26969,295
30701,18,590,1121,364,10154,226
28985,775,12061,1155,8388,33091,3673
20638,121,5264,1318,3752,27857,1512
10065,9,244,1469,138,5970,106
12668,3401,96808,1446,58470,335909,38338
38390,8,272,954,203,9434,69
50724,25,249,752,195,3305,54
18023,150,6755,1364,4709,34900,2046
64573,9,36,322,32,1655,4
15498,6,154,1407,108,5849,46
34428,49,743,1056,490,11589,253
33661,5660,101895,1071,77027,406801,24868
12148,6,867,1452,511,17694,356
66571,4,58,266,50,2577,8
16909,82,1342,1384,978,17708,364
8181,21,653,1478,425,7346,228
52071,218,2114,712,1550,38589,564
33178,15,414,1080,278,7046,136
24497,89,1883,1250,1248,12790,635
60618,11,75,444,60,1940,15
25084,1377,26461,1237,18757,92028,7704
23115,283,4999,1278,2958,38896,2041
17057,303,5312,1382,3663,20381,1649
10959,7,222,1463,149,14649,73
28878,360,10075,1157,6628,75597,3447
33884,95,2243,1067,1409,16480,834
69776,492,9449,160,8112,76594,1337
24513,66,1797,1250,1238,26169,559
56139,31,391,586,320,13678,71
53238,59,845,675,702,6750,143
13744,493,10993,1431,6729,72756,4264
17506,33,699,1374,560,23803,139
61244,85,1062,420,788,9976,274
27459,48,1506,1186,901,14364,605
21829,83,1668,1298,1160,30028,508
5741,11,418,1508,289,5338,129
38979,33,494,943,413,4797,81
3186,227,7341,1538,4816,123510,2525
70130,12,130,149,104,3782,26
5398,1725,23990,1512,14907,115542,9083
63930,584,9355,342,6219,32329,3136
19169,1626,79540,1344,52993,251872,26547
54322,2327,40430,642,27614,107607,12816
51763,162,2991,723,2184,46981,807
3697,11,264,1533,185,11251,79
34967,34,613,1043,404,10893,209
67756,19,249,228,209,7918,40
50269,234,2993,762,2345,45541,648
23525,109,2624,1271,1829,27762,795
36151,76,911,1014,775,17623,136
14235,9,328,1424,222,21388,106
29995,525,13897,1135,9834,160243,4063
49654,1382,24117,778,16763,153955,7354
70049,1,30,152,27,1478,3
51030,134,1533,743,1164,15208,369
31040,40,546,1115,364,9005,182
16626,125,12334,1389,7501,49841,4833
2965,185,5972,1540,3979,53507,1993
67963,1,22,222,16,1773,6
54705,147,1765,627,1364,20748,401
12267,10,1094,1451,546,7929,548
49945,116,1599,771,1201,15871,398
53476,100,1170,670,889,20077,281
63158,200,2373,363,1836,27581,537
69641,3,81,166,63,1474,18
53514,48,626,669,505,13894,121
28588,27,586,1163,356,11808,230
36457,730,11579,1005,8418,29048,3161
1229,173,6915,1555,4208,41214,2707
33042,61,1118,1082,758,7084,360
33177,693,10860,1080,7626,91306,3234
26168,41,1393,1215,1147,10835,246
68971,89,1892,187,1586,15557,306
48643,951,13338,797,10531,59902,2807
13850,5574,150717,1429,94993,450409,55724
17586,34,1157,1372,693,10043,464
32420,106,4560,1094,3077,65326,1483
27261,13,273,1190,183,3779,90
68475,25,503,205,406,10041,97
34350,5,83,1058,69,15547,14
52607,285,1945,695,1716,112465,229
30994,22,472,1115,311,11084,161
17262,801,20970,1378,13893,61250,7077
12817,111,2612,1444,1424,22904,1188
50123,346,6421,766,5344,70945,1077
23052,372,8177,1279,5665,61346,2512
61914,1515,29119,399,22564,131298,6555
14983,0,48,1414,34,4429,14
42764,9,226,885,187,11426,39
9464,2744,152819,1473,98279,520492,54540
9279,787,25771,1474,16369,425189,9402
33116,58,565,495,430,7856,135
50352,280,3509,760,2920,25864,589
11520,1007,25092,1458,15588,114159,9504
61927,146,1483,399,1159,7817,324
23811,88,1249,1265,923,11716,326
64910,427,4084,312,3346,32994,738
9739,1,232,1471,165,10655,67
44061,3,39,869,28,3098,11
65073,9,52,306,38,5976,14
28317,17,531,1168,354,9030,177
70174,2,21,148,19,1472,2
48250,80,1647,819,1328,15888,319
24091,24,1088,1259,765,13605,323
55058,9,59,616,49,3160,10
32479,9,441,1093,262,15030,179
29814,45,1555,1139,996,15605,559
21686,356,8408,1300,5664,61193,2744
35615,20,461,1027,320,9810,141
70293,6,50,144,45,1119,5
20644,6,244,1318,159,8376,85
21333,137,2270,1306,1625,26457,645
27371,41756,861306,1188,415628,1654656,445678
28736,1813,37930,1160,24154,312513,13776
16367,5,517,1393,306,14956,211
48491,9,160,814,130,4447,30
7564,88,1812,1485,1175,23375,637
37479,77,1760,978,1251,24868,509
52305,8,97,705,72,4733,25
21229,2,285,1307,201,15683,84
54345,9,87,641,69,6173,18
22659,62,1712,1286,1112,28999,600
33981,301,10450,1065,8100,115921,2350
9018,17,771,1475,523,14558,248
53850,2,41,658,28,2318,13
30393,779,10069,1127,7087,62322,2982
30860,64,892,1118,626,17450,266
21930,200,5686,1296,3623,51830,2063
56585,11,80,573,61,4591,19
34361,44,644,1057,439,6087,205
40554,415,8617,921,6835,68888,1782
57712,94,1728,543,1334,30120,394
31588,6,115,1107,99,5063,16
58626,567,8588,512,6675,94022,1913
68978,142,1837,187,1678,20234,159
55031,29,354,616,295,12712,59
39320,115,1538,938,1173,10802,365
6192,1210,25720,1503,17416,149336,8304
50538,233,2855,755,2336,44580,519
10274,71,2453,1468,1728,38911,725
44522,94,3661,863,2477,27854,1184
60347,89,1189,454,841,14308,348
35360,30,814,1033,694,35064,120
1875,11261,398778,1550,277647,2024136,121131
24466,281,6984,1251,4009,31843,2975
21188,60,2466,1308,1519,18422,947
39983,10414,224834,930,163290,948278,61544
69613,1,102,167,73,2295,29
29377,136,4296,1148,2864,67011,1432
22844,483,14428,1282,9308,60609,5120
12037,31,1128,1453,656,18795,472
11946,474,28167,1454,14270,172222,13897
22336,51,1215,1291,959,36240,256
19192,68,2509,1343,1844,110600,665
30799,1,126,1119,82,8143,44
11642,134,3530,1457,2533,18772,997
57308,348,4664,553,3410,34591,1254
24656,47,857,1246,640,13624,217
57816,91,1316,539,1102,28211,214
17539,1188,46190,1373,30812,226878,15378
63651,98,1126,351,866,20105,260
24751,124,5036,1244,3332,27681,1704
23259,61,2058,1275,1712,47665,346
48695,61,643,806,501,7615,142
50795,261,4247,750,3477,30205,770
27942,10,536,1175,307,22370,229
24476,78,1520,1251,1051,12843,469
33257,23,489,1079,317,5361,172
31012,116,4247,1116,2659,64696,1588
8116,3,173,1478,102,10585,71
60020,4,50,466,39,2592,11
8726,8,268,1476,190,14195,78
23103,8,290,1278,204,8138,86
67507,538,11755,236,9275,68144,2480
2319,8,353,1546,219,11452,134
10435,0,0,1467,0,13811,0
13371,139,3434,1436,2127,20902,1307
21283,53,447,1306,383,13960,64
22678,182,5695,1285,3504,20522,2191
33867,746,18797,1068,12960,88472,5837
66166,4,54,278,44,1533,10
20169,19,334,1326,269,18259,65
8763,32,2358,1476,1426,19575,932
57263,43,904,554,695,9986,209
38303,6,66,957,46,6208,20
51701,145,1388,724,1151,17195,237
34749,225,6527,1048,4873,67934,1654
18940,9334,257046,1348,159219,1296741,97827
35220,16,212,1036,170,7991,42
7166,18,1189,1490,863,25234,326
23832,641,38996,1265,24983,96337,14013
50916,23,229,746,203,5864,26
62719,19,119,374,108,3638,11
58885,40,553,504,445,11469,108
38465,3200,44408,951,32471,170262,11937
14479,369,12445,1420,8038,144772,4407
29195,9,299,1151,183,6207,116
15492,392,10991,1407,8165,79212,2826
34688,4,136,1049,96,4649,40
14183,17,710,1425,488,13675,222
67415,72,1036,239,854,13611,182
38427,276,3323,953,2702,26348,621
6312,76,2820,1502,1970,23995,850
29524,60,1492,1145,1030,26840,462
11077,103,3184,1462,1958,19129,1226
16557,6,341,1390,222,13827,119
5821,95,1734,1507,1189,25704,545
52953,0,0,683,0,2579,0
24775,11,433,1244,307,7316,126
35658,9,273,1027,206,7358,67
5684,60,2172,1509,1450,29301,722
54206,101,1361,643,1182,34348,179
10249,96,2073,1468,1367,28951,706
27968,9,165,1174,101,12534,64
58065,29,396,531,284,5458,112
58934,917,8297,502,6614,54101,1683
64735,65,1081,312,919,10674,162
20859,22,499,1314,341,12396,158
54477,18,263,636,168,18201,95
22174,5,140,1293,104,3426,36
36330,6,81,1008,67,4747,14
3961,32,1360,1530,902,63467,458
64247,6,165,332,127,5921,38
11268,0,0,1461,0,12375,0
39718,1344,24653,934,21096,128370,3557
49070,45,938,795,736,16527,202
65397,7,76,299,63,2675,13
42352,28,355,893,236,6754,119
62316,8,132,386,102,3036,30
55714,9,88,598,73,3944,15
2464,1731,61055,1545,37779,214162,23276
54899,618,8678,607,7384,68404,1294
52239,9046,138498,708,100158,427070,38340
52460,1791,18431,700,15597,146702,2834
54590,10,110,632,84,2989,26
16014,899,29530,1398,20103,208171,9427
26569,54,1302,1205,904,15483,398
18681,26,871,1353,674,10881,197
32077,124,5957,1100,3979,37685,1978
49217,9,225,790,135,6998,90
64744,189,2288,318,1989,30470,299
19801,43,1570,1333,1102,11200,468
16096,11312,352516,1397,224710,1715558,127806
26991,159,6809,1196,4011,54278,2798
59134,40,514,496,404,6328,110
6594,5764,128086,1497,77852,366491,50234
67905,29,270,224,198,3858,72
39813,235,3489,932,2969,24999,520
54028,144,2137,652,1795,42975,342
65082,95,838,306,594,7223,244
42766,150,3288,885,2561,55798,727
53838,2,21,659,12,3999,9
11158,23777,408782,1461,277620,1502999,131162
53438,39,553,670,461,8967,92
59586,8,153,481,141,2636,12
65641,47,485,294,394,24776,91
32278,139,1837,1097,1219,12822,618
19312,44,1156,1341,849,24571,307
8095,752,23049,1478,14347,82397,8702
20231,8,291,1325,217,21738,74
28050,3,293,1173,166,7452,127
30160,63,1367,1132,854,27816,513
51805,8,70,718,57,3119,13
33121,2650,86074,1082,62689,411473,23385
21791,83,1827,1298,1274,15475,553
5109,117,4846,1515,3087,21616,1759
32806,28,698,1087,441,7330,257
60349,153,2769,454,2248,12627,521
55677,3949,60557,599,47920,347436,12637
18534,6,543,1355,384,10118,159
25023,25,827,1238,535,10893,292
33784,1292,26819,1069,19099,200427,7720
58276,381,10640,524,8000,44446,2640
44822,17,407,860,307,8301,100
20033,79,5346,1328,4110,57287,1236
59257,5773,224935,471,161819,997783,63116
69227,5,79,179,71,3922,8
52434,118,1187,701,948,31368,239
52189,85,1074,709,971,16987,103
4683,1520,42405,1521,31850,180033,10555
3785,97,3183,1532,2258,23483,925
27726,4851,84856,1180,47839,273286,37017
32058,6,169,1100,94,7983,75
56974,33,324,561,289,5970,35
41016,32,356,913,251,3150,105
24068,84,4365,1260,2950,10496,1415
57455,12,355,550,244,3917,111
34623,834,13381,1051,9426,52703,3955
2898,1,81,1541,51,6512,30
16115,13,218,1397,161,7364,57
13800,260,6384,1430,4373,39069,2011
36014,162,3855,1018,3274,28934,581
7410,33,1036,1487,718,21820,318
11151,32,718,1461,488,7121,230
18378,576,16541,1358,12028,153692,4513
19960,49,1016,1330,796,12462,220
13696,113,3188,1432,2055,22554,1133
33745,36,1324,1070,987,15911,337
60887,106,1442,433,1054,11251,388
51065,134,1750,742,1438,51795,312
70353,35,373,143,316,3127,57
3651,14,487,1534,344,29445,143
20852,119,3285,1314,2333,46560,952
59687,267,3763,477,2892,28831,871
8928,3,196,1475,104,4814,92
404,1246,51043,1561,28800,228580,22243
11120,18,483,1462,317,8904,166
31480,107,3702,1109,2346,88178,1356
3892,8,329,1531,231,30481,98
16134,574,6847,1397,4983,71457,1864
2262,59,2697,1547,1659,25800,1038
49667,92,2069,778,1453,25135,616
70254,71,883,145,845,12329,38
60269,41,562,457,452,10109,110
64313,719,16924,330,13350,106325,3574
18509,29,706,1355,542,9402,164
432,3,229,1561,133,14003,96
68094,7,86,217,65,2721,21
11549,49,3154,1458,1793,21610,1361
13714,51,660,1431,378,6402,282
46916,289,3738,836,3136,29768,602
55066,26,242,615,176,4883,66
9945,7,123,1470,72,10087,51
57295,5,63,554,47,3429,16
23424,244,4239,1272,2790,14125,1449
12788,145,6386,1444,3877,85674,2509
56647,66,574,571,476,7117,98
33630,23,328,1072,237,3614,91
50425,28,503,759,397,10040,106
62324,52,462,386,414,7652,48
21388,274,6051,1304,3823,23338,2228
50210,36,376,764,294,7297,82
5938,4,184,1506,133,4355,51
2861,48,841,1542,588,10358,253
60329,181,2741,455,2233,24202,508
6930,12,423,1493,306,17994,117
62176,412,6250,390,5028,61080,1222
26504,22,571,1207,412,22802,159
2585,547,10306,1544,6999,107733,3307
10336,1934,48514,1467,30934,188803,17580
55184,15,224,613,148,2340,76
18055,1065,26166,1363,18430,71335,7736
42628,38,1108,887,813,14268,295
38436,17,536,953,456,10323,80
27132,523,9552,1193,6807,92089,2745
26538,66,1021,1206,669,13606,352
67190,27,702,246,590,16796,112
3676,4,133,1534,95,14937,38
35562,28,1002,1028,681,9389,321
15521,98,1922,1406,1378,36781,544
22076,3,111,1294,80,5006,31
6391,18,272,1500,195,7462,77
2005,25,1583,1549,1172,59357,411
66426,10,130,271,97,2580,33
54545,207,2263,633,1823,30014,440
56889,8,98,564,85,4145,13
47357,8,86,830,75,4011,11
11179,243,4586,1461,2883,27545,1703
42885,0,12,883,8,7657,4
68492,8,46,204,39,2407,7
26281,984,27689,1212,20407,174833,7282
9399,71,3342,1473,2060,38322,1282
14073,100,5353,1426,3709,81503,1644
12773,70,2606,1445,1319,17248,1287
47051,14,377,834,300,8008,77
4216,48,1090,1528,776,23151,314
68350,202,2506,210,1898,18978,608
24155,24,842,1258,634,18729,208
36188,1215,23242,1013,19859,198444,3383
35376,18,334,1024,257,12257,77
24024,366,10547,1261,7302,80730,3245
52272,10,207,707,155,11261,52
50156,38,570,765,501,16887,69
33660,11,186,1071,153,8531,33
11088,7,211,1462,130,17935,81
58450,1487,15553,518,12618,56532,2935
24599,16,265,1248,187,9436,78
13784,118,4521,1430,2839,34139,1682
27444,23,1425,1186,874,20335,551
57041,28,232,560,145,6358,87
25858,9,268,1221,184,14607,84
34535,2929,57293,1054,43082,158486,14211
70580,16,225,134,224,5542,1
10340,139,7558,1467,4308,80004,3250
64641,16,257,320,202,7439,55
35465,341,7539,1030,4210,89635,3329
27502,636,12191,1184,7857,114895,4334
60969,14,173,430,133,6314,40
50547,24,358,755,231,11005,127
47956,220,1967,823,1531,17351,436
22005,70,1883,1295,1341,42407,542
70518,9,115,137,104,4734,11
33310,127,2767,1078,1682,23302,1085
24133,113,5749,1258,3983,37940,1766
62964,17,265,368,205,4708,60
69514,11,168,170,153,4847,15
32831,5,384,1087,224,3883,160
29079,112,3259,1153,1953,16084,1306
42546,342,4436,889,3840,45537,596
8794,18,488,1476,320,12383,168
1201,56,1708,1555,1257,34655,451
24651,22,427,1247,301,12547,126
4640,684,10518,1522,7039,56789,3479
41977,7,368,898,278,9062,90
21430,53,1747,1304,1162,34543,585
61497,7,111,413,81,2614,30
37241,16,386,985,315,11820,71
60066,1986,27126,464,22076,149678,5050
37020,45,910,991,723,14128,187
36541,6,184,1002,153,7994,31
25616,165,6629,1226,5284,58912,1345
25622,364,8650,1226,5647,56966,3003
41809,326,3027,901,2222,20898,805
49457,288,2533,784,2064,24221,469
30394,95,2110,1127,1325,37618,785
2229,161,6442,1547,4033,33055,2409
49339,572,11647,786,9522,70478,2125
53102,66,579,678,467,9471,112
24293,261,4879,1255,3051,41883,1828
29150,2,76,1152,36,1567,40
36876,149,1777,996,1451,18765,326
43345,411,9161,877,7553,82350,1608
21902,56,1982,1297,1444,15724,538
49050,248,5136,795,4067,46116,1069
2398,8,250,1546,172,7442,78
46873,2740,75266,836,54174,220985,21092
49495,67,829,783,627,20950,202
13041,0,0,1441,0,8487,0
20426,8,265,1322,223,8572,42
60030,6,107,466,79,2628,28
3324,65,1823,1537,1210,29908,613
52253,576,11595,707,8903,84028,2692
41280,108,1975,909,1737,26454,238
21046,85,1100,1311,711,8522,389
35280,16,346,1035,298,45956,48
21459,3624,86743,1303,59206,313416,27537
70232,29,439,146,398,6076,41
22431,85,2981,1290,2250,32542,731
57055,7,107,560,92,10941,15
68045,129,1664,219,1516,15691,148
40672,17,563,920,389,11415,174
30582,20,383,1124,249,3047,134
54532,226,2540,634,2084,28356,456
29374,269,3597,1148,2500,32140,1097
9029,17,878,1475,561,11313,317
19140,422,7233,1344,5897,59427,1336
23251,27,539,1275,356,11185,183
33110,1,93,1082,67,5266,26
61912,1474,23929,399,19265,110575,4664
47708,69,755,825,571,8838,184
59334,70,1039,489,760,9289,279
49988,42,1067,770,613,9021,454
27326,56,887,1189,637,15600,250
6495,8615,199308,1499,124350,462566,74958
50534,97,1261,755,962,21270,299
31683,1812,52353,1105,38502,126519,13851
68610,46,499,200,376,3306,123
37403,670,13392,980,10837,67287,2555
58706,58,1188,509,802,26870,386
31571,23,374,1107,237,8717,137
1185,15,498,1555,309,25203,189
1068,13,866,1556,500,13856,366
44308,123,1489,866,1221,12254,268
50835,667,12062,749,9405,150860,2657
46688,29,673,838,560,21765,113
9168,15,611,1474,385,8066,226
699,160,4292,1559,3013,67195,1279
69789,5,98,160,80,3037,18
50275,15,152,762,119,5802,33
49443,12,311,784,254,5797,57
62829,74,1023,372,832,15155,191
28759,42,1072,1160,623,8082,449
64393,5,164,327,120,7052,44
15482,0,0,1407,0,13552,0
16603,407,10446,1390,6700,33401,3746
59734,460,5232,475,4392,30282,840
41741,351,4553,902,3302,41004,1251
22075,4,215,1294,131,4386,84
29475,18,526,1146,297,15527,229
23925,11,456,1263,324,15715,132
35607,10,437,1027,304,5379,133
26355,1516,18004,1210,12894,65929,5110
37680,14,433,973,359,10007,74
11710,62,1815,1457,1001,15967,814
33065,22,825,1082,500,17131,325
36915,124,2365,995,1982,44589,383
17578,3,213,1372,152,11903,61
2123,51,3029,1548,2013,60000,1016
49839,84,960,774,840,49068,120
30533,10845,201532,1124,151694,641576,49838
4565,16,444,1523,306,14746,138
47323,65,1834,830,1341,24247,493
32033,51,1831,1100,1139,29583,692
34139,199,2189,1062,1581,8626,608
30624,64,1700,1123,1132,8790,568
63292,89,1916,360,1416,27271,500
48180,34,327,820,283,12623,44
689,7287,285847,1559,180966,797776,104881
21778,253,6805,1298,4734,51744,2071
18603,6,257,1354,200,13910,57
34439,65,867,1056,635,17883,232
25491,27,295,1229,215,8392,80
52159,20,331,710,267,11234,64
8826,340,9540,1475,6099,54274,3441
58603,177,1788,513,1427,10886,361
12275,36,764,1451,488,10983,276
50443,330,3382,758,2660,27940,722
1282,52,1210,1554,880,31457,330
28903,129,3320,1157,2228,17051,1092
55606,4,45,601,36,1900,9
42416,4,128,891,83,3687,45
47875,22,567,824,469,8786,98
5659,39,1083,1509,745,26594,338
22383,121,4899,1290,3303,44499,1596
10659,13,760,1465,443,10982,317
8208,11,548,1478,415,14881,133
64541,515,5042,324,4042,20020,1000
5836,2,171,1507,126,13013,45
38328,905,14107,956,10693,36705,3414
67047,24,537,251,403,12051,134
31809,83,1493,1103,939,26697,554
15910,1508,62554,1400,41872,337285,20682
22900,2,205,1281,153,5541,52
38330,132,2944,954,2345,16618,599
51736,55,611,724,479,9414,132
8627,399,16585,1476,8423,42910,8162
15455,93,2560,1408,1672,49987,888
50692,364,4135,752,2769,35236,1366
68513,10,260,204,168,5751,92
34283,14,747,1059,491,18389,256
59629,49,568,479,453,14425,115
21660,767,24704,1300,13688,126776,11016
7386,189,3352,1487,2227,22062,1125
18115,24,304,1362,229,9535,75
68762,4,92,195,65,3428,27
25484,386,18996,1229,12035,61284,6961
58053,43,486,532,371,8762,115
33340,52,848,1077,538,8277,310
58852,115,1615,505,1202,16522,413
40419,7,250,923,188,8374,62
20362,25,952,1323,713,13726,239
65053,281,3145,306,2517,19953,628
1874,1063,34442,1550,22058,155165,12384
15275,72,2580,1410,1872,29620,708
68019,26,264,220,208,5361,56
66125,56,1295,280,929,10245,366
15734,216,12403,1403,7407,29651,4996
20005,17,1270,1329,939,28034,331
28765,14,403,1160,245,16385,158
31432,485,5742,1109,4906,64196,836
38524,390,9344,950,6724,27378,2620
5273,1,72,1513,48,5514,24
14396,58,1902,1421,1322,40252,580
32130,1,38,1099,18,8034,20
56578,47,582,573,445,6873,137
50649,317,4440,753,3426,67739,1014
23739,41,1402,1267,947,23001,455
9589,13,306,1472,206,7276,100
10957,8,357,1463,206,10745,151
13276,27,297,1438,170,17084,127
15505,15,709,1407,515,18540,194
62115,2,39,392,33,3219,6
69566,42,352,168,301,5728,51
30293,23,787,1129,452,13022,335
57868,925,15828,537,12243,55953,3585
34811,4,155,1046,119,9179,36
1686,45,2511,1551,1725,39932,786
19590,29,547,1336,351,6910,196
7265,14,544,1488,386,18207,158
11849,146,7738,1455,3102,23889,4636
4318,12,645,1526,503,34048,142
1499,20,666,1553,489,20690,177
17300,9,115,1377,92,7319,23
55995,24,229,590,163,5043,66
51975,45,906,717,732,22139,174
49064,1,125,795,87,14465,38
47811,53,751,824,576,7491,175
29302,6,264,1149,205,12005,59
2140,32,560,1548,396,34383,164
12357,175,5226,1450,2972,22263,2254
11139,3402,106447,1461,73126,492357,33321
17400,2920,79257,1376,57125,364426,22132
9965,55,845,1470,604,13827,241
61131,2,63,424,50,2749,13
17767,36,1387,1369,1004,20830,383
63130,7,219,364,142,5486,77
69036,16,304,185,263,4303,41
36987,493,4227,992,3240,26393,987
66670,15,60,264,45,3391,15
14726,2,47,1417,39,7538,8
19303,2402,44811,1341,27260,131372,17551
4419,3404,117514,1525,72767,269146,44747
46104,35,329,846,229,4440,100
61529,0,4,412,3,1759,1
23522,33,1567,1271,1006,8877,561
38640,67,477,947,383,8020,94
14822,8,336,1416,167,18985,169
13921,199,9634,1428,6025,91840,3609
6593,102,2761,1497,1926,30204,835
12585,618,23177,1447,12802,89614,10375
47000,12905,278064,835,190716,1562852,87348
51963,8,145,717,116,6230,29
50026,4,35,769,31,2184,4
167,889,39143,1564,23090,85805,16053
68058,65,602,219,507,6446,95
3538,46,1788,1535,1200,62947,588
36475,1283,21465,1004,16617,95962,4848
70630,1,35,132,33,2373,2
30498,166,4881,1125,3364,49339,1517
56539,56,575,574,521,45941,54
20747,67,3956,1316,2926,39808,1030
61301,166,1474,418,1224,11519,250
14849,6,591,1416,372,8469,219
7034,1441,47541,1492,29163,129472,18378
28542,55,759,1164,486,14216,273
68175,14,392,215,313,4545,79
21523,6,314,1302,222,16202,92
29145,5099,145410,1152,93419,328281,51991
68027,7,368,217,332,2530,36
19825,28,197,1332,163,9892,34
57886,30,198,537,150,11443,48
32287,21,659,1096,377,10277,282
12673,851,43457,1446,25551,245984,17906
60550,18,237,446,209,7838,28
6500,20,641,1499,454,8376,187
18716,16,417,1352,319,33398,98
28308,5,223,1168,148,14209,75
19847,9,746,1332,516,15931,230
4188,142,7412,1528,4493,37499,2919
5219,18,2029,1514,1331,21525,698
40697,38,1029,919,814,19100,215
70116,11,107,150,105,5986,2
9035,291,6444,1475,4532,32805,1912
37845,16,128,968,102,8539,26
15511,5,167,1407,127,12091,40
54638,28,317,629,231,4799,86
29825,165,4810,1139,3115,70735,1695
18873,2,55,1349,47,7698,8
3708,8564,270316,1533,186266,717969,84050
30793,139,3409,1119,2572,35456,837
9953,232,17210,1470,11617,132325,5593
24114,22,852,1259,600,11803,252
2065,32,1491,1548,1076,15505,415
33605,265,4300,1072,2926,33642,1374
29170,181,5214,1151,3066,30313,2148
14020,739,28040,1427,19156,147651,8884
16905,156,3375,1384,2272,49849,1103
12109,97,2947,1453,1852,64383,1095
61287,841,9362,418,8129,78710,1233
64465,57,1060,325,822,8107,238
33276,239,3790,1078,2759,27163,1031
18619,0,0,1354,0,11708,0
35534,40,877,1029,659,9851,218
5143,72,4512,1515,3007,68502,1505
12608,3574,88373,1447,48477,146892,39896
9608,9,414,1472,226,8763,188
4913,19,491,1518,372,21184,119
36260,69,2178,1011,1470,38591,708
21881,16,519,1297,404,12001,115
13917,303,9868,1429,7241,74611,2627
43025,80,995,881,834,16489,161
6160,54,4019,1503,2488,26556,1531
1800,195,4116,1551,2837,24460,1279
53564,230,1974,667,1584,48217,390
24994,162,2460,1239,1554,18421,906
50120,148,1874,766,1457,23441,417
12860,41,2334,1443,1295,56471,1039
12202,268,8853,1452,4917,56169,3936
30664,10,388,1122,239,15266,149
56918,3,50,563,46,4225,4
53070,16,223,679,198,11024,25
61503,5,102,412,75,3632,27
12039,36,1004,1453,599,18019,405
27930,253,7953,1175,5202,55630,2751
48956,422,5967,798,4572,86427,1395
66343,46,694,274,595,9132,99
69781,27,310,161,286,7804,24
25005,33,770,1239,455,14169,315
23554,18,363,1270,243,6403,120
54361,154,1507,641,1208,25236,299
55645,60,749,599,637,21030,112
58070,40,335,531,247,5860,88
16886,2153,32618,1385,21108,146953,11510
3993,10,350,1530,251,7332,99
2723,3700,120143,1543,75110,258139,45033
64767,4,145,317,105,2651,40
37019,19,468,991,385,8807,83
14520,20,1422,1420,1080,15256,342
65897,64,638,287,573,8811,65
45741,20,276,850,235,8729,41
40456,11,287,922,219,9445,68
22793,1322,37721,1283,23791,324998,13930
30271,8,219,1130,151,9376,68
15170,16,449,1412,286,19078,163
65814,461,7448,289,6150,43104,1298
9206,302,5865,1474,4122,91064,1743
67483,614,11181,237,9633,104042,1548
47063,2103,35643,833,29405,260738,6238
18439,1852,65540,1357,44811,335625,20729
22167,23,372,1293,288,5399,84
3055,16,633,1540,450,20201,183
37271,132,1821,984,1266,26642,555
10009,65,1404,1469,862,8357,542
11657,27,1632,1457,844,13843,788
38319,1224,14763,956,11880,117086,2883
28959,93,2463,1155,1581,27212,882
21077,20,747,1310,518,39631,229
13909,18,830,1429,572,28060,258
43892,29,490,870,384,11191,106
54021,348,8762,652,6886,25714,1876
42168,5,48,895,43,2685,5
19929,115,5097,1330,3790,67765,1307
31634,15,348,1106,218,12056,130
23020,33,1985,1279,999,15781,986
21731,18,420,1299,300,10533,120
62052,23,279,394,183,7421,96
31273,299,4531,1111,3230,27093,1301
16203,28,686,1395,438,16519,248
30201,28,602,1131,436,5665,166
28060,5848,198131,1173,127104,287271,71027
23153,48,1360,1277,1047,19331,313
10462,827,14254,1467,9357,71607,4897
35597,36,554,1027,406,9476,148
57817,689,7227,539,5247,39080,1980
36714,1131,37932,999,31780,180412,6152
38950,325,6646,943,5261,25040,1385
55604,168,2641,601,2129,13176,512
55217,16,166,612,128,6072,38
25618,184,6957,1226,4597,70901,2360
7183,8,653,1489,379,13371,274
67071,15,145,250,92,4783,53
30248,206,8209,1130,4849,60922,3360
1982,36,1018,1549,707,33974,311
14852,43,2555,1416,1832,24815,723
51726,111,1532,724,1211,21781,321
11115,21,590,1462,367,15527,223
58775,26,369,507,281,9228,88
25462,1375,28865,1230,22374,164317,6491
66909,2,55,255,34,3506,21
14634,15,402,1418,319,17948,83
54918,13,242,620,162,3202,80
68592,47,629,200,501,8060,128
22260,334,7290,1292,5211,75299,2079
8092,177,4298,1479,2866,32920,1432
55906,3,46,593,35,2870,11
1626,5,75,1552,52,5507,23
44834,53,666,859,516,18441,150
64625,70,1060,321,865,12952,195
38326,15745,412335,956,314831,1612057,97504
42562,4,81,889,59,2904,22
26971,9,263,1196,154,8516,109
27186,90,3302,1192,1928,22887,1374
56737,165,2343,568,1849,25537,494
5719,867,18975,1508,13862,93707,5113
65252,21,347,303,263,3657,84
22286,427,11962,1292,8249,95165,3713
69040,30,267,185,200,3511,67
45919,557,6092,848,4907,40036,1185
30324,11,302,1129,195,10729,107
35904,39,733,1021,554,13255,179
9308,180,8485,1473,5267,33867,3218
54072,4,25,650,22,3086,3
26716,447,13855,1202,9175,127076,4680
13752,191,6805,1431,4393,75396,2412
51117,31,145,741,113,7600,32
1660,3,175,1552,135,9335,40
54609,658,5696,390,5228,45392,468
56502,2,51,575,31,1525,20
21840,75,2213,1298,1289,14451,924
55583,114,918,601,713,12051,205
58751,53,743,508,601,8434,142
25606,9,432,1227,253,10036,179
280,753,30777,1562,21212,116455,9565
62201,44,532,389,406,9286,126
62599,15,270,378,182,7513,88
44298,33,569,866,414,10660,155
28796,499,6133,1159,5274,77648,859
53129,282,3297,657,2527,58977,770
68247,3,27,213,20,2855,7
69899,33,612,157,551,5727,61
21458,1701,55714,1303,34247,386602,21467
62211,30,401,389,348,10585,53
69700,11,415,164,308,3234,107
21142,252,5465,1309,3962,53333,1503
65832,3,36,289,25,4031,11
43361,1,43,876,29,3610,14
30519,22,744,1125,451,16322,293
57235,2279,45650,555,35953,133790,9697
64843,100,1407,314,1246,6272,161
59350,206,2827,489,2280,21309,547
30067,4,112,1134,93,4257,19
50995,529,16801,744,13438,91702,3363
55920,1002,16621,592,12397,72219,4224
23955,703,32553,1263,19594,269008,12959
65966,2,47,285,24,3693,23
13520,685,16826,1434,10528,165637,6298
25549,111,2670,1228,1723,30949,947
57447,105,1179,550,921,11259,258
9252,45,644,1474,431,6660,213
61283,7,88,419,76,4767,12
17607,170,2555,1372,1750,42462,805
55450,52,625,605,492,8902,133
64956,10,265,310,192,8282,73
31665,6488,273343,1106,182089,720295,91254
51581,0,51,728,32,6055,19
2637,899,25246,1544,15646,99261,9600
65946,131,1902,286,1593,24660,309
37000,1444,29337,992,23406,256715,5931
21468,15,401,1303,348,26747,53
66880,50,634,256,517,9995,117
2664,41,1267,1544,855,29145,412
21126,15,581,1309,425,17127,156
41947,339,9667,898,7745,77060,1922
34526,183,2198,1054,1538,18502,660
20504,18,501,1321,341,22168,160
8575,30,1783,1477,1058,43835,725
28141,52,691,1171,480,40179,211
53840,17,112,658,74,3485,38
26376,29,787,1210,493,11110,294
27133,7,206,1193,149,7431,57
56257,22,379,582,295,17514,84
70131,7,78,149,69,2033,9
57958,109,1013,535,742,10137,271
58393,206,2903,520,2293,34074,610
1916,980,24046,1550,15588,98168,8458
595,14,669,1560,513,33608,156
68560,227,3123,201,2665,25815,458
23892,38,1196,1264,818,17691,378
66003,100,1510,284,1249,17233,261
57414,73,708,551,560,7297,148
4804,5505,139461,1520,72563,333511,66898
29894,173,2874,1137,2148,51677,726
20788,28,726,1316,612,22162,114
52085,50,497,713,427,11836,70
36321,272,3476,1008,2701,36336,775
40425,2673,28920,923,20704,101989,8216
68115,54,979,216,867,11566,112
50696,2601,27615,752,20953,117063,6662
64446,162,3987,326,3414,39203,573
25597,15,958,1227,534,8763,424
10030,54,1451,1469,875,9575,576
11383,10,473,1460,319,15820,154
54539,229,2542,634,1957,20003,585
20878,7,241,1314,175,7357,66
11784,3220,172926,1456,81993,800444,90933
57255,1009,15414,555,12836,81949,2578
32785,390,14577,1088,9787,48684,4790
30361,69,1763,1128,1098,16625,665
43191,15,431,878,320,10633,111
8643,4,53,1476,36,14070,17
35539,12,188,1029,144,4110,44
57916,14,250,536,171,4027,79
58690,43,331,510,253,6874,78
25933,488,15298,1219,9916,46300,5382
67557,159,2879,235,2324,17046,555
37765,51,1374,967,1140,22561,234
50701,41,248,752,199,4713,49
6083,23,800,1504,547,16207,253
48687,170,4837,807,3562,35462,1275
37718,520,22540,971,17665,60050,4875
910,18,896,1557,545,16796,351
15130,0,0,1412,0,38779,0
7836,15,496,1481,366,30566,130
49046,157,2038,796,1555,28262,483
13121,157,2973,1440,1945,24398,1028
4460,14,1538,1525,975,35916,563
60607,73,1620,444,1306,17777,314
35295,74,1289,1034,990,14571,299
61635,32,660,408,437,8406,223
30224,267,4703,1131,3498,66310,1205
2960,94,1988,1541,1454,16798,534
50276,18,233,760,202,12060,31
18611,31,1882,1354,1401,20326,481
68945,2,28,188,18,1972,10
23146,48,2790,1277,1781,26083,1009
29070,48,1204,1153,745,12031,459
32829,35,1234,1087,757,18588,477
10263,14,832,1468,499,13489,333
15205,359,12500,1411,7785,45260,4715
28885,35,2636,1157,1518,44959,1118
51851,9,159,720,121,4916,38
61599,44,522,410,463,14772,59
55318,1,9,608,9,2281,0
19110,66,3366,1345,2395,34705,971
14113,229,7078,1425,5046,79361,2032
60508,508,10656,448,7819,46060,2837
19668,757,30868,1335,18666,127429,12202
56766,6,97,568,90,5139,7
35234,30,494,1036,340,7370,154
55165,3,64,613,57,6493,7
23708,5,353,1267,220,12914,133
62617,36,382,377,305,5605,77
15108,164,4513,1413,3051,31175,1462
33070,2368,41079,1082,28327,142263,12752
2442,31,1779,1545,1208,33298,571
46571,32,366,840,297,7788,69
41097,415,9675,912,7948,49704,1727
32589,58,1348,1091,890,20796,458
14551,38,974,1419,679,41712,295
59271,147,5533,491,4366,54962,1167
10132,44,1494,1469,1018,15140,476
62853,24,417,371,351,4525,66
51657,1378,15780,726,12605,109437,3175
21799,34,1387,1298,969,11559,418
9987,27,1186,1470,738,20248,448
11239,40,1663,1461,1018,17887,645
14157,9727,173987,1425,112908,445090,61079
17789,11,529,1368,404,14084,125
68757,215,4454,195,3795,35322,659
32782,135,4450,1088,3000,18318,1450
65010,128,1409,308,1107,13858,302
8054,73,1468,1479,930,13353,538
63929,7,57,342,49,3201,8
8524,117,6586,1477,4298,60789,2288
40743,18,540,918,427,12624,113
6658,29,889,1497,652,12331,237
4271,8,419,1527,286,17435,133
35345,10,235,1033,153,6072,82
57767,37,403,541,319,5138,84
65380,0,14,300,13,661,1
14653,7,231,1418,139,6671,92
55876,54,750,594,534,5210,216
30223,9,496,1131,301,5347,195
1065,11,460,1556,324,7057,136
14275,119,2667,1423,2107,32728,560
14908,48,1060,1415,699,6412,361
23906,59099,1218602,1264,870888,2064374,347714
47660,9,217,826,190,25015,27
24222,3183,69384,1257,44774,501406,24610
19605,13,237,1336,169,4713,68
1328,202,3029,1554,2107,29785,922
64896,43,588,312,468,11273,120
31823,22,682,1103,482,15593,200
16061,11,411,1397,292,9169,119
17866,10,262,1366,190,5511,72
38247,29,789,958,572,29420,217
13146,199,9959,1439,6207,43431,3752
6077,5,168,1504,101,6230,67
13100,8,671,1440,352,5851,319
24440,22,297,1252,215,8827,82
54500,104,1057,635,851,11230,206
9128,58,1963,1474,1201,25308,762
17498,17,264,1374,213,11085,51
33470,167,2332,1075,1814,20209,518
30922,36,615,1117,499,11653,116
3965,35,1513,1530,1018,31185,495
15631,87,1990,1405,1363,21602,627
30367,21,400,1128,356,7408,44
39050,308,20606,942,10687,89057,9919
67599,4,66,233,47,3361,19
12049,32,1012,1453,555,5667,457
37551,136,2126,976,1654,23802,472
27931,412,9608,1175,6264,53020,3344
11685,24,1418,1457,691,10822,727
54880,20,146,621,133,11817,13
44406,97,1699,865,1225,28129,474
12057,36,1752,1453,957,36587,795
59620,49,685,479,499,11392,186
59702,653,10597,476,8536,51411,2061
51067,39,471,742,396,12209,75
45910,35,344,848,294,12602,50
41278,8,303,909,224,5610,79
38008,25,506,964,353,2809,153
19087,1672,44987,1345,31949,221929,13038
12656,246,8257,1446,4972,36804,3285
66697,0,17,263,14,1711,3
58373,186,2377,521,1940,22386,437
56633,91,919,572,724,7526,195
2967,35,2172,1540,1566,55827,606
15784,58,1881,1403,1160,27643,721
64028,31,396,339,305,7559,91
69667,6,32,165,24,1701,8
55025,17,399,617,289,10453,110
46236,10,204,844,158,5988,46
10835,31,2534,1464,1479,15548,1055
33643,18,260,1072,179,8400,81
44129,68,1301,868,1025,25180,276
8111,15,496,1478,306,7244,190
60632,40,704,443,529,5750,175
50470,153,1871,757,1590,25361,281
10685,33,1797,1465,1286,14005,511
28725,1173,26274,1160,16465,77793,9809
65116,21,357,306,225,3885,132
1021,266,13528,1556,8264,112304,5264
27792,228,3517,1178,2386,29978,1131
4369,137,2913,1526,1835,20294,1078
32639,107,2107,1090,1550,20953,557
63629,6,82,351,58,3235,24
60646,17,306,442,220,4203,86
64203,7,153,333,96,3793,57
36117,895,11187,1014,7811,77954,3376
28196,758,25046,1170,15959,66690,9087
9209,934,20453,1474,12036,88193,8417
17164,6,154,1380,112,12659,42
34853,0,98,1045,66,3765,32
66849,22,575,257,507,8394,68
12643,354,8033,1446,4995,40846,3038
26520,3,193,1207,139,6841,54
16902,39,504,1384,396,22951,108
2837,36,1021,1542,738,19985,283
45654,78,1172,851,950,15853,222
33145,13,431,1081,268,9285,163
17209,83,2291,1379,1203,16704,1088
24808,41,810,1243,620,25170,190
56118,5525,97513,586,72080,340497,25433
4498,39,1494,1524,819,19186,675
6308,131,5924,1502,4107,50316,1817
46356,220,3274,843,2216,16918,1058
3912,7,187,1531,141,8181,46
37638,375,7146,974,5313,27367,1833
27159,26,1453,1192,911,28676,542
54987,23,179,618,121,3694,58
64822,316,5974,315,4754,39889,1220
27266,176,5597,1190,3743,53547,1854
59133,164,2477,496,1860,25026,617
3637,34,1334,1534,889,32128,445
58677,89,1222,510,1016,11445,206
66168,18,311,278,238,5375,73
37596,13,385,975,304,11042,81
68862,20,647,191,529,2778,118
32355,65,1284,1093,861,12079,423
61066,18,281,427,212,13792,69
12196,3,236,1452,128,5753,108
179,75,3718,1564,2841,21112,877
58980,4246,119329,501,86248,228805,33081
4714,119,2796,1521,2042,19695,754
8745,38,1313,1476,862,17190,451
70002,496,5457,154,4847,26686,610
37774,5726,135754,960,102177,398422,33577
34064,204,4287,1063,3237,30206,1050
10884,8,610,1463,363,19920,247
34286,12,434,1059,284,10875,150
25305,38,812,1233,499,16420,313
42069,6,171,896,143,3490,28
68291,0,0,211,0,1482,0
31218,18,607,1112,294,21195,313
68811,501,11652,192,9506,74646,2146
50112,96,933,766,761,10293,172
61349,19,215,417,154,1802,61
10178,251,6186,1468,3873,22655,2313
14316,24,344,1423,298,5240,46
60610,24,448,444,345,6955,103
27775,227,4683,1179,3024,46550,1659
63598,270,3826,352,3033,21945,793
58028,233,1922,531,1417,14935,505
19799,5584,150616,1333,96051,391992,54565
41031,20,814,913,714,27680,100
947,164,4837,1557,2922,30852,1915
16100,6,302,1397,201,24393,101
68579,46,597,201,477,8306,120
59806,36,818,473,631,27052,187
61527,34,301,412,243,4206,58
34245,92,1223,1060,817,8946,406
31338,331,7185,1110,4803,36535,2382
36286,6895,108436,1010,80324,400429,28112
14606,2,138,1419,88,2777,50
58376,79,1957,521,1552,33956,405
35992,240,5328,1018,4560,26009,768
22233,534,18828,1292,13497,115423,5331
12265,3,263,1451,138,5565,125
13516,138,2977,1434,1876,39650,1101
34145,48,1863,1062,1363,15603,500
14981,799,42115,1414,23038,230835,19077
57898,82,810,535,598,9893,212
48233,17,249,819,193,13188,56
31899,4314,74678,1102,48728,153730,25950
30155,17,313,1132,200,6132,113
69743,3,114,162,88,6813,26
33164,6202,116407,1081,77871,351207,38536
8026,1004,105026,1479,53935,380364,51091
4065,2,91,1529,57,5770,34
66494,8,107,269,82,5062,25
58295,83,716,523,577,14968,139
24472,149,3588,1251,2518,36777,1070
20733,4,300,1317,213,14425,87
22195,6,335,1293,166,6497,169
10291,2255,184758,1468,100512,463869,84246
16122,774,17173,1397,11778,81045,5395
5515,16,242,1511,176,7913,66
8984,3,181,1475,97,11470,84
10956,108,3258,1463,2025,35466,1233
66993,15,181,253,158,5356,23
24344,9,424,1254,293,9314,131
57535,28,238,544,188,4935,50
18311,568,11711,1359,7707,65989,4004
12797,71,2070,1444,1260,45615,810
29724,67,2284,1141,1522,29691,762
64906,5,28,312,19,4874,9
41282,47,835,909,671,14310,164
44267,58,461,866,363,10104,98
15785,57,1428,1403,912,10137,516
59503,53,684,483,550,10840,134
1176,8,394,1555,260,10686,134
56177,21,422,584,242,6203,180
61197,91,1143,422,995,12054,148
33082,311,6910,1081,5066,67792,1844
62362,43,508,384,401,14305,107
60940,20,258,431,196,4833,62
50490,54,784,757,625,13930,159
17637,8,270,1371,209,8258,61
19736,190,5465,1334,4058,85451,1407
60931,9,209,432,140,4249,69
51397,0,31,733,26,2772,5
58696,135,2201,510,1714,12043,487
49939,662,8220,771,5980,93262,2240
26634,247,4976,1203,3474,55261,1502
8950,42,1663,1475,1061,14975,602
30640,29,460,1123,303,21991,157
6970,9,343,1493,244,8245,99
4385,512,11242,1525,6444,64725,4798
27034,460,14507,1194,8937,129834,5570
31435,58,916,925,703,7776,213
31811,115,3013,1103,2140,21034,873
15480,31,557,1407,379,26551,178
27991,60,980,1174,792,39860,188
41817,136,1579,900,1131,23517,448
62580,850,9899,378,6970,82681,2929
47524,329,3412,827,2857,28005,555
34422,193,7444,1056,5100,36644,2344
56447,25,366,577,300,9954,66
10878,116,2877,1463,1749,24663,1128
24051,14,418,1260,335,23133,83
56807,105,2145,566,1797,24811,348
39934,3,105,931,88,5245,17
35791,35,1835,1023,1101,11491,734
8159,6,247,1478,145,4335,102
50897,13,148,747,110,2897,38
33007,59,1432,1083,972,9477,460
63817,50,699,346,593,8584,106
39355,1519,22433,937,17219,148047,5214
18690,4,152,1352,116,8068,36
30652,17,513,1122,349,15878,164
34991,21,347,1042,221,8952,126
12566,51,5678,1447,3050,36054,2628
20746,99,5015,1317,3643,74419,1372
4557,344,16312,1523,8890,39805,7422
45559,197,2744,852,2401,31475,343
15543,39,1123,1406,808,33700,315
62233,152,3975,388,2830,32721,1145
27695,25,998,1180,629,7618,369
16999,19,1353,1383,912,42415,441
6821,6,222,1495,157,16446,65
25457,58,704,1230,578,12759,126
50661,441,8154,753,6273,69571,1881
31752,53,711,1104,458,10247,253
29032,12,336,1154,200,8079,136
18343,16,731,1359,592,29278,139
65319,218,1775,301,1397,10703,378
46708,71,888,838,669,21009,219
52681,1949,27242,691,22287,157955,4955
21342,9,410,1305,313,12525,97
6717,31,605,1496,395,13222,210
56703,6,212,569,181,8218,31
65534,48,765,296,532,8226,233
57,38,1116,1566,822,46025,294
47672,80,1165,826,942,17414,223
56376,233,2408,579,1916,31521,492
11566,140,8868,1458,5132,62984,3736
68991,4,19,186,14,1483,5
1842,124,3789,1550,2709,50512,1080
21167,24,599,1308,456,22566,143
52720,42,368,690,315,8245,53
12700,1477,98041,1446,52387,311049,45654
62780,77,698,372,590,11353,108
30695,125,2699,1121,1798,30684,901
50023,1,29,769,26,2211,3
69461,14,192,172,171,6857,21
12308,10130,250468,1450,136469,705609,113999
23242,8,137,1276,107,4412,30
65751,53,823,291,692,8574,131
14349,10,364,1422,261,10114,103
1147,19,657,1555,448,27816,209
69637,44,620,165,598,8856,22
53891,135,1028,656,842,17157,186
42957,896,27329,882,21063,195762,6266
51470,8,146,731,118,10390,28
53406,4,46,671,38,1188,8
12890,176,4044,1443,2611,48043,1433
14406,32,1161,1421,790,18108,371
30238,187,4197,1130,3430,46681,767
9440,10,599,1473,347,6545,252
31055,359,13064,1115,6241,37977,6823
69471,1,27,171,20,993,7
21906,5,276,1297,157,8741,119
29375,4131,83415,1148,54787,354683,28628
30995,4,61,1116,39,2248,22
855,76,3918,1557,2606,34567,1312
1227,1274,69241,1555,46269,317353,22972
36848,87,2110,997,1782,34506,328
6082,28,909,1504,613,42187,296
12734,25,1369,1445,783,12104,586
56513,10,144,575,83,3608,61
68860,44,785,191,676,10021,109
61326,54,871,418,704,10660,167
54507,35,418,635,318,7091,100
34678,37,400,1050,310,12628,90
6016,27,798,1505,559,13921,239
25094,12,350,1237,267,11453,83
38151,7658,102280,960,71162,362006,31118
42338,35,539,893,405,17049,134
7606,10,491,1484,291,10330,200
8283,12,609,1478,374,8247,235
61383,1,49,416,38,3672,11
391,175,4755,1561,3088,29708,1667
16499,2,353,1391,223,11606,130
62070,15,288,393,237,5744,51
61757,99,1019,405,819,9320,200
56929,175,2630,563,2216,27227,414
8035,342,10201,1479,6588,63133,3613
41839,27,668,900,500,12717,168
68418,53,534,207,396,5428,138
47249,702,18281,831,14862,104970,3419
25151,33,383,1236,231,6562,152
34130,51,398,1062,335,45801,63
20614,1142,66629,1319,38995,336559,27634
26418,37,743,1209,466,20205,277
5677,221,10102,1509,6125,107599,3977
13776,54,2395,1431,1555,17201,840
56669,12,240,570,219,12684,21
34261,87,2690,1059,1873,37314,817
17511,133,2786,1374,2233,68068,553
61248,67,849,420,658,10246,191
61744,127,1727,405,1306,23785,421
67400,6,96,240,65,2234,31
36514,57,604,1002,463,9697,141
15178,47,1095,1411,735,6878,360
21651,64,849,1300,681,5611,168
62356,10,109,384,89,8468,20
63633,18,144,351,120,3561,24
27028,5595,119307,1195,72890,669128,46417
4685,69,1360,1521,1025,45877,335
10719,9,488,1465,318,6186,170
11096,48,1468,1462,930,7824,538
34026,58,1690,1064,1309,22049,381
8789,70,3316,1476,2135,31739,1181
53898,33,352,656,284,5063,68
31312,303,5358,1111,3692,26610,1666
38094,753,10271,958,8296,48792,1975
38236,685,14764,958,11603,35032,3161
18865,187,4220,1349,2848,51950,1372
54827,50,443,623,318,9600,125
51686,5,120,725,97,7323,23
22290,203,3422,1292,2185,22351,1237
18079,8,132,1363,95,10867,37
64477,102,1007,325,799,11846,208
37222,87,2305,985,1747,17569,558
25184,74,3097,1235,2097,23272,1000
20396,23,847,1322,590,27944,257
70076,16,323,151,291,9074,32
1182,397,7052,1555,5211,50204,1841
17783,47,1898,1368,1426,51538,472
30083,246,12753,1133,8352,94002,4401
24794,485,12902,1244,8665,105980,4237
42436,64,969,891,627,16267,342
49028,8,95,796,81,4832,14
33459,35,767,1075,497,7734,270
54334,46,544,641,437,11231,107
21023,32,1676,1311,1122,24946,554
41055,1,21,912,20,3012,1
20572,71,2480,1320,1741,14290,739
11796,13,1788,1456,704,9283,1084
15230,144,3916,1411,2581,61987,1335
65225,7,97,303,72,4774,25
38240,2,16,958,11,1490,5
65304,57,1208,302,914,14001,294
7016,39,855,1492,573,10318,282
24164,17,795,1258,585,38791,210
68865,54,407,191,346,7878,61
65528,833,12274,296,10364,96287,1910
8449,13,912,1477,652,9256,260
27621,450,12643,1181,8455,75599,4188
9501,85,1677,1472,978,18209,699
28201,12,313,1170,194,6619,119
9415,80,1332,1473,952,15706,380
35800,21,292,976,234,8244,58
5901,32,794,1506,543,8819,251
68457,16,120,205,98,2142,22
9832,34,1465,1471,829,16623,636
36867,0,38,996,31,3808,7
55484,27,300,604,242,6768,58
55560,105,2020,602,1596,22433,424
10051,895,40385,1469,26346,219975,14039
27802,29,1715,1178,1097,31684,618
1957,502,9451,1549,7084,40183,2367
11330,252,10824,1460,6385,69576,4439
22492,26,651,1289,449,13968,202
29973,146,3103,1136,1969,22024,1134
68218,44,813,214,669,14289,144
68095,19,320,217,277,5042,43
52791,35,462,688,391,10805,71
28213,15,532,1170,399,13799,133
69684,120,2116,164,1900,16874,216
20154,6,215,1326,167,8418,48
47200,184,3262,832,2542,68776,720
38364,85,2006,955,1750,41339,256
37393,20,391,970,312,15456,79
27174,3,90,1192,59,2067,31
11318,4351,580251,1460,305891,1873801,274360
30648,21,604,1122,391,6676,213
29580,10,399,1144,263,15225,136
64450,59,1177,326,936,11279,241
61992,106,1980,396,1710,25924,270
38316,3,129,956,90,6283,39
62527,4,90,380,61,3043,29
5108,21,425,1515,291,10269,134
3950,7,929,1531,391,29030,538
32763,106,677,1088,546,14254,131
62834,158,1451,371,1248,12751,203
18146,101,2030,1362,1350,25652,680
20437,117,6509,1322,4458,53437,2051
53449,10,212,670,154,9843,58
38641,40,754,947,566,8547,188
48579,61,602,810,477,9278,125
18313,14,2190,1359,820,25517,1370
38297,27,463,957,354,11630,109
70308,32,401,144,385,5370,16
58,682,27716,1566,19304,261605,8412
18763,4856,190491,1351,123074,659156,67417
12286,19,919,1451,562,14152,357
19428,2,45,1339,32,6868,13
66364,106,1836,274,1525,11123,311
13615,18,1313,1433,848,23103,465
28928,111,3370,1156,1952,13873,1418
57878,13,195,537,145,11719,50
5260,42,670,1513,447,9840,223
11342,44,2161,1460,1232,15019,929
46899,18,290,836,209,3971,81
66048,22,446,283,388,5279,58
51055,64,481,742,407,15456,74
29027,19,449,1154,269,10798,180
35553,31,728,1028,489,8312,239
55507,86,1239,603,1025,12980,214
13687,7660,177297,1432,106217,662325,71080
56430,6,67,577,52,2699,15
18165,152,5496,1362,3823,24311,1673
25328,39,1022,1232,668,6788,354
48697,42,1333,806,934,18558,399
24436,83,1376,1252,899,17054,477
61611,11,64,409,54,2687,10
21987,161,3820,1296,2275,16915,1545
69609,1,33,167,29,2596,4
36253,52,1095,1011,835,13140,260
66028,34,523,283,417,10583,106
36883,243,2735,996,2302,31061,433
10808,36,1039,1464,631,9413,408
763,10,423,1558,289,12893,134
32546,149,2754,1092,1871,50329,883
59128,241,2735,496,2217,15059,518
60523,206,2437,447,2122,45408,315
36287,23,331,1010,283,8900,48
49677,788,14331,778,11376,112402,2955
5134,213,9816,1515,6585,96883,3231
20770,211,4520,1316,4076,35519,444
8015,110,3479,1479,2627,31245,852
28701,11,550,1160,308,8867,242
59823,34,446,472,276,15836,170
57686,200,2944,544,2385,12034,559
54605,26,462,631,193,11277,269
55098,97,730,614,605,15276,125
69528,86,826,170,692,9268,134
15154,3,148,1412,110,9075,38
28058,0,0,1173,0,3964,0
64552,167,4215,323,2760,19685,1455
18949,11,1076,1348,699,45508,377
33804,88,2544,1069,1756,41078,788
35674,22,355,1026,251,8459,104
58835,2,28,506,21,4678,7
30656,13,416,1122,246,10254,170
64382,50,846,328,691,13986,155
4396,2,133,1525,97,10510,36
26370,9,490,1210,293,10466,197
7699,25,1829,1483,1203,18790,626
24565,1344,140497,1249,95839,318527,44658
60310,6,103,455,79,2077,24
6267,9,84,1502,53,2459,31
43357,7,252,876,195,11569,57
59212,270,4360,494,3594,26916,766
52835,871,9038,687,7360,157497,1678
9426,3309,114810,1473,68089,289284,46721
56783,69,1033,567,808,13313,225
9024,5,210,1475,111,9701,99
69596,42,566,166,503,10467,63
62391,11,244,383,169,14412,75
69925,11,258,156,216,2503,42
14023,23,651,1427,410,15387,241
23362,401,10244,1274,7269,90274,2975
1883,11,535,1550,330,20648,205
61640,12,106,408,93,5416,13
57613,1303,15850,546,12162,154138,3688
18666,24,896,1353,682,15790,214
24533,30,2308,1250,1449,39299,859
49942,47,537,771,434,14998,103
1121,85,3850,1555,2665,37967,1185
44657,11,234,862,173,5376,61
15431,1657,48632,1408,31695,195590,16937
5941,19268,811560,1506,452708,1418065,358852
56152,1,20,585,19,3586,1
13983,1264,37349,1427,25411,243302,11938
22125,178,5276,1294,3677,35911,1599
70438,79,1476,139,1381,13617,95
63852,262,4851,345,4000,35927,851
13937,56,2959,1428,1916,38151,1043
37936,21,583,966,475,21274,108
34288,37,768,1058,540,4237,228
37200,80,1434,986,1225,15445,209
18187,162,3990,1361,2731,22916,1259
66667,0,14,264,10,2302,4
13067,10860,339907,1440,203116,1565752,136791
59580,110,1586,481,1282,20144,304
15805,119,3230,1402,2369,25159,861
62653,21,271,376,191,6034,80
17654,10,487,1371,373,11561,114
35040,53,800,1041,564,19814,236
52541,872,30818,697,24295,181071,6523
8652,63,2353,1476,1653,24248,700
69173,3,88,180,64,5096,24
423,0,1962,1561,1166,22243,796
39006,5,84,942,67,1833,17
30236,6,587,1130,335,13985,252
16301,4,147,1394,89,4621,58
356,64,2449,1562,1793,35358,656
22852,31,713,1282,479,8057,234
1183,91,1858,1555,1334,21825,524
67055,29,503,251,391,4828,112
36125,21406,523878,1015,316063,1260369,207815
8429,62170,2072372,1477,1329168,5850889,743204
31,130,4998,1567,3524,96672,1474
37576,2723,55115,975,38693,277623,16422
18192,19,934,1361,690,40279,244
36803,161,1333,998,942,7973,391
20970,20,322,1312,208,7305,114
49194,449,4455,791,3351,22663,1104
24131,28,781,1259,512,10478,269
34217,15,493,1060,318,10143,175
62490,74,958,381,807,15749,151
41842,23,2082,900,1351,12817,731
69278,6,55,177,50,2124,5
29482,10,437,1146,362,10865,75
35258,4,49,1035,43,4760,6
64709,8,156,319,121,2340,35
68584,2,16,201,14,3035,2
19361,25,436,1340,296,9787,140
31150,34,725,1113,385,11056,340
34638,324,5408,1051,3853,92333,1555
62172,32,461,390,376,10336,85
7292,17,671,1488,477,20725,194
1351,16,839,1554,596,17441,243
63854,718,12259,345,9909,106560,2350
64309,49,529,330,425,4588,104
16482,64,724,1391,558,24784,166
36121,35,924,1015,841,23975,83
38124,34,282,961,248,7929,34
16838,202,10659,1385,7051,63351,3608
21994,134,3061,1296,2020,31666,1041
56491,37,447,575,367,5458,80
8204,21,343,1478,273,5782,70
4330,243,6195,1526,4494,50292,1701
7390,137,6735,1487,4460,84921,2275
8543,368,8637,1477,5367,43318,3270
21921,2577,66257,1296,35433,221168,30824
13416,224,12033,1436,7909,127809,4124
32202,13,374,1098,253,24397,121
33644,104,1931,1070,1090,55819,841
26988,195,11771,1196,7458,43278,4313
29828,6,139,1139,99,5909,40
57637,17,272,545,182,12315,90
13947,25,1243,1428,740,18994,503
18258,781,22252,1360,16121,156500,6131
53323,19,147,673,118,5361,29
11872,16,846,1455,427,14803,419
55844,8,83,595,67,3517,16
14281,168,9354,1423,6045,100249,3309
20741,1046,41321,1317,31426,296652,9895
23139,22,612,1277,415,13677,197
57751,16,131,542,115,3127,16
21636,8,228,1300,153,4224,75
23067,140,6850,1278,4372,44886,2478
49731,23,412,776,337,7670,75
5171,42,3896,1515,2575,29076,1321
69821,0,4,159,4,1046,0
571,20,1790,1560,1191,20536,599
32088,87,2094,1099,1306,43608,788
67052,6,131,251,95,2881,36
57923,9,118,536,85,2328,33
12599,49,1916,1447,923,10532,993
19619,14,616,1336,442,13921,174
9093,126,4388,1474,2048,22325,2340
21872,11,655,1297,443,19384,212
58875,17,218,504,162,5035,56
6873,162,5132,1494,3255,47587,1877
11680,0,0,1457,0,8211,0
32804,202,2758,1087,1867,21702,891
57663,20,262,544,219,5395,43
22358,19,927,1291,705,23524,222
34792,82,1071,1047,697,13534,374
9366,2190,44212,1473,28289,144947,15923
58091,1729,28736,530,22126,100278,6610
62997,2,55,368,43,3191,12
40726,46,1165,918,937,24505,228
30734,209,3320,1121,2337,29325,983
9603,21,460,1472,310,6647,150
21428,37,1556,1304,961,17269,595
40864,45,731,916,650,18011,81
12803,836,23265,1444,13584,177814,9681
14990,11,319,1414,223,15666,96
66138,50,945,280,688,10233,257
67252,205,3602,244,3101,37768,501
70560,3,55,135,46,1400,9
26503,467,16807,1207,11336,118698,5471
38703,26,698,946,443,6915,255
14897,312,8213,1415,5966,62336,2247
57353,7009,415657,552,223627,686761,192030
11271,20,487,1461,324,27802,163
23855,4,123,1265,87,4172,36
37417,29,486,980,413,18891,73
3363,15,178,1537,127,15864,51
26332,421,8695,1211,5717,58484,2978
68430,2,76,207,32,6351,44
43053,13972,300769,821,206232,638963,94537
66829,704,11624,258,9606,82843,2018
35716,14,244,1025,188,8782,56
13418,15,396,1436,248,17272,148
58324,37,358,522,262,11028,96
55574,168,1549,602,1305,28574,244
48845,7,106,802,83,18282,23
70344,341,4066,143,3656,21051,410
35513,145,4703,1029,3733,59178,970
4571,1670,36518,1523,25039,120860,11479
55990,29,484,590,372,4152,112
44587,416,7862,863,5987,90821,1875
48475,17,360,814,314,6223,46
25916,170,4761,1220,3127,62456,1634
32392,11,591,1095,343,5238,248
8420,30,1130,1477,665,8020,465
8960,63,2552,1475,1590,36142,962
7442,3,128,1486,86,22843,42
16423,23,889,1392,603,8797,286
11396,308,14869,1459,7844,77195,7025
48559,17,202,811,133,5715,69
1050,702,17389,1556,11412,72348,5977
8523,119,3339,1477,2060,31245,1279
18743,39,1284,1351,1012,19207,272
6543,45,2365,1498,1494,16464,871
22452,82,3856,1289,2535,46281,1321
31387,31,1150,1110,699,10117,451
52891,37,426,685,364,6706,62
14947,1708,32566,1415,21849,129757,10717
66244,6,86,276,67,4573,19
6987,24,1121,1493,737,9071,384
3612,130,8607,1535,5686,52709,2921
8175,101,1297,1478,802,6802,495
15291,3,70,1410,42,3038,28
59166,11,113,495,92,4471,21
14443,4334,443458,1420,257764,848750,185694
17062,0,111,1382,81,6409,30
36910,8,253,995,197,4785,56
55984,103,1033,590,837,19216,196
55956,32,436,591,331,15844,105
12991,0,0,1442,0,7829,0
7691,25,970,1483,669,17774,301
12857,22,716,1444,388,8507,328
14964,33,1095,1414,727,7824,368
11018,867,27095,1462,14446,85604,12649
17460,11,208,1375,158,5788,50
67898,20,185,224,131,8335,54
17652,18,263,1371,208,14408,55
52427,85,1331,701,1052,57681,279
18341,143,3889,1359,2952,63121,937
12276,1716,61977,1451,37755,310256,24222
23439,42,2706,1272,1739,46397,967
67757,49,915,228,708,5680,207
2772,176,6439,1543,4397,99856,2042
17602,876,45631,1372,29736,101207,15895
60206,431,13944,459,11813,40580,2131
54836,95,706,622,511,11695,195
30451,112,1127,1126,701,8997,426
22924,175,4528,1281,3212,42000,1316
52579,63,701,696,567,13021,134
4091,79,1924,1529,1328,22797,596
30856,106,2412,1118,2070,28576,342
20012,24,1087,1329,713,10504,374
31806,38,644,1103,485,8634,159
17327,23,616,1377,434,11877,182
65089,19,172,306,122,5396,50
51954,113,1108,718,919,17379,189
40075,14,149,928,131,4894,18
4797,149,5520,1520,3704,65754,1816
67084,177,2224,250,1857,25011,367
46585,613,8217,840,6168,97534,2049
4528,7013,210418,1523,131526,623045,78892
18148,185,3264,1362,2188,22027,1076
21323,38,954,1306,649,12062,305
18814,1680,63851,1350,41976,180929,21875
68122,23,712,217,513,7991,199
14014,49,3807,1427,2527,28787,1280
22258,79,2488,1292,1669,31551,819
55972,771,8958,591,7375,55339,1583
5157,71,2223,1515,1497,36722,726
68177,38,429,215,349,5524,80
70487,15,296,137,290,14195,6
8310,7,158,1478,96,5388,62
4778,700,16365,1520,11099,48114,5266
27815,9091,274654,1178,173071,813074,101583
62546,116,2182,379,1693,12288,489
28276,84,2713,1169,1964,17301,749
8808,1499,57528,1475,41309,234734,16219
34618,17,327,1051,224,8024,103
14731,7,112,1417,82,7238,30
13610,128,4679,1433,2932,21004,1747
10086,33,1405,1469,845,14977,560
188,226,5352,1564,3545,28447,1807
20833,19,350,1315,256,13495,94
32968,3,34,1084,18,4524,16
32009,27,664,1100,439,14444,225
36553,41,1895,1001,1587,35041,308
53181,97,1238,676,987,10534,251
56589,52,597,572,462,6354,135
16546,359,15442,1390,10007,83112,5435
29102,22,397,1153,262,12294,135
49746,491,6235,776,5038,88178,1197
38125,5,243,961,200,10679,43
40922,2114,49179,915,31782,99485,17397
34293,264,9188,1059,6420,72870,2768
9690,928,30485,1471,19748,156051,10737
18184,13,563,1361,439,14745,124
30891,49,1270,1118,822,15967,448
26218,8,621,1213,317,6057,304
33108,8263,150686,1082,99720,521823,50966
4298,5,151,1527,104,18485,47
20216,81,1427,1325,956,24869,471
18044,436,15064,1363,10329,113951,4735
7218,8,514,1489,320,11700,194
70424,5,96,139,90,3766,6
44397,44,679,865,471,24682,208
23508,33,671,1271,491,18404,180
48620,8,133,809,101,5769,32
38722,229,3591,946,2728,22049,863
5037,5,182,1516,128,8647,54
53881,35,403,657,369,7050,34
2227,378,6931,1547,4823,20363,2108
20334,35,642,1323,420,9510,222
24727,142,8485,1245,5911,43373,2574
9841,22,682,1471,470,9312,212
45424,637,9926,854,7012,35090,2914
7644,18,859,1484,551,27515,308
6047,9711,291447,1504,157380,754978,134067
49042,879,9633,796,7682,82958,1951
51031,115,1081,740,941,31770,140
61024,77,896,428,683,11254,213
11482,28,1370,1459,904,48404,466
52257,118,1131,707,996,35192,135
10197,127,3958,1468,2566,47815,1392
52444,423,5075,701,4218,31095,857
23105,4,142,1278,95,5977,47
62597,7,65,378,55,4002,10
39353,5,112,938,86,8480,26
49439,4,42,784,32,2322,10
54962,578,6928,618,5478,75241,1450
18561,21,336,1355,263,5023,73
66410,9,205,272,126,4525,79
313,215,12120,1562,8031,120698,4089
8149,385,6947,1478,4527,47400,2420
64157,14,122,334,106,5661,16
16390,24,1049,1392,731,32587,318
30859,4,88,1118,69,12132,19
63045,8,190,367,127,6793,63
61219,64,1519,421,1242,10308,277
7231,1144,39553,1489,27628,115723,11925
30094,193,6116,1133,4360,54036,1756
669,2038,104092,1559,67492,561614,36600
61571,3,75,410,42,6077,33
5976,74,1978,1505,1307,10382,671
69012,11,154,186,150,2872,4
13021,0,0,1441,0,12922,0
12833,0,58,1444,23,6834,35
6577,9,378,1498,270,15364,108
12402,272,15610,1449,7707,101626,7903
67110,8,92,249,58,5431,34
4503,455,10661,1524,7563,40151,3098
21898,16,696,1297,434,22660,262
37656,50,729,973,652,14100,77
26586,7,446,1205,269,7943,177
33738,216,2241,1070,1665,19128,576
9511,559,9583,1472,6347,33370,3236
1098,263,10446,1556,5777,71123,4669
33927,141,2210,1067,1703,40226,507
18296,1346,35474,1359,24914,347791,10560
5693,69,2410,1509,1580,39897,830
61150,3,63,423,54,7238,9
3631,4,120,1534,75,6640,45
61739,11,267,405,217,10511,50
19258,618,21673,1342,15002,178804,6671
54085,2056,31647,650,26453,106289,5194
6795,208,7704,1495,4934,66009,2770
57047,13,280,560,203,16565,77
60712,47,839,440,625,6854,214
23707,8,198,1267,153,9202,45
62673,49,628,375,507,11716,121
11887,78,1707,1455,889,14634,818
5299,57,1019,1513,727,26733,292
16635,162,3981,1389,2727,45562,1254
32635,1664,30960,1090,22838,80014,8122
59887,38,366,470,278,6019,88
8602,5,349,1476,236,12992,113
66802,4,59,259,45,1510,14
48785,4110,59073,804,43118,217946,15955
5224,20,1113,1514,687,16650,426
19411,2,164,1339,130,8157,34
28668,612,12385,1161,7519,68975,4866
53784,7,92,660,80,6609,12
61654,24,416,408,294,5801,122
56476,16,221,576,175,5708,46
32066,14,288,1100,253,7806,35
12862,1568,46572,1443,29236,268239,17336
60031,89,1760,466,1261,8045,499
31843,225,3134,1103,2036,16738,1098
60202,4,40,459,26,5181,14
13576,158,7673,1433,3939,22578,3734
24006,27,574,1262,411,14546,163
64806,3,19,315,12,2535,7
5121,0,224,1515,154,8517,70
745,860,80696,1558,51183,319120,29513
55758,100,1159,597,922,13695,237
13770,628,18464,1431,11654,71574,6810
24014,21,562,1261,404,10657,158
29791,12789,361362,1140,251085,997831,110277
59009,97,3153,500,2496,14512,657
68606,133,1688,200,1503,12547,185
68463,17,324,205,278,6473,46
49537,26,444,782,404,16546,40
8030,12,631,1479,331,7432,300
53499,106,1581,669,1195,20659,386
41470,1757,48963,906,36002,326708,12961
66819,1061,13621,258,10996,70298,2625
43213,268,2660,878,2171,15180,489
52903,7,100,684,83,11648,17
14431,1417,40201,1421,27890,310009,12311
24229,4,247,1257,171,5908,76
66227,7,91,277,82,2389,9
38025,753,14784,963,10709,194819,4075
29579,70,3462,1144,2317,49109,1145
5998,16,552,1505,408,13562,144
7059,11022,352937,1491,199396,1210439,153541
16303,32,783,1394,506,21158,277
60313,60,846,455,681,31240,165
47988,234,3340,823,2611,29562,729
40962,58,922,913,812,23054,110
16658,2443,60827,1389,41522,476824,19305
12230,549,25031,1451,12707,136478,12324
61185,337,5983,422,4726,32544,1257
69572,29,434,168,371,6670,63
59945,478,7279,468,5605,51360,1674
15062,10,820,1413,559,24070,261
53813,190,1405,659,1097,20018,308
36504,4,127,1003,97,15193,30
43147,45,1138,879,921,16793,217
50155,17,243,765,183,8378,60
8190,113,2685,1478,1750,32399,935
18459,473,8461,1356,5401,73702,3060
40061,43,590,928,525,13539,65
21558,60,2192,1301,1440,30938,752
21901,97,4519,1297,2926,19486,1593
49063,41,854,794,724,25001,130
30929,14,451,1117,277,11586,174
60512,12,71,447,49,2987,22
48398,28,460,816,316,5260,144
56547,210,3508,573,2831,24950,677
15171,1,138,1412,105,5222,33
20064,15,1006,1328,563,20578,443
20249,114,1508,1325,1074,21297,434
49718,0,2620,777,1130,12018,1490
37906,111,2054,967,1529,20339,525
30817,20,364,1119,260,25626,104
66786,4,34,260,25,720,9
70093,16,212,151,200,4610,12
33345,253,5489,1076,3660,22270,1829
49276,0,0,788,0,12300,0
30076,20,412,1134,269,8968,143
66439,1,31,271,19,1491,12
67423,936,25479,239,20504,153338,4975
13463,21,1043,1435,643,10303,400
17157,79,1759,1380,1384,19316,375
1518,12,499,1553,296,36767,203
6107,53,1543,1504,1007,10762,536
164,1377,44005,1564,23981,159202,20024
40001,34,501,929,387,8079,114
54216,239,2249,645,1785,24279,464
15615,33,768,1405,589,19385,179
67545,121,1742,235,1516,19959,226
56493,10,85,575,61,4279,24
23361,10,319,1274,219,7600,100
36937,35,748,994,623,20511,125
24375,19,587,1253,418,11929,169
18684,43,2846,1352,2108,43168,738
3059,7,185,1540,109,5479,76
6355,103,1749,1501,1065,25316,684
19588,37,1281,1336,839,11981,442
62549,13,241,379,153,4657,88
10483,712,15395,1466,11074,39639,4321
54941,0,16,619,13,3547,3
66769,25,352,260,284,7275,68
32190,71,1462,1098,994,18405,468
18387,6,312,1357,231,8919,81
63912,48,874,343,672,6893,202
14472,125,2848,1420,1803,22883,1045
50551,2,96,755,66,8836,30
35739,9,614,1024,411,10741,203
32309,1365,29760,1096,22020,61071,7740
56260,28,337,582,277,9885,60
3087,2288,46428,1539,28914,193197,17514
33469,119,2670,1075,1797,27087,873
23364,4582,153036,1274,85007,500118,68029
54661,10,195,628,163,5486,32
34499,39,3606,1054,2131,15860,1475
51552,4,148,729,111,6098,37
16815,708,36173,1386,25757,228692,10416
55371,57,723,607,529,21422,194
23143,5,109,1277,90,6897,19
399,22,1070,1561,739,23328,331
876,18,1295,1557,880,46187,415
51138,4,49,740,39,2255,10
52358,10,235,704,162,5218,73
14589,0,2919,1419,1979,32056,940
37442,40,894,979,592,10874,302
15798,177,3784,1402,2629,48342,1155
58666,1455,48540,510,35976,95291,12564
10389,4,154,1467,84,4049,70
23384,984,19515,1273,12231,59128,7284
1708,3,190,1551,121,20326,69
22650,6669,124132,1286,89053,650107,35079
49133,573,21541,793,14353,164549,7188
4877,19,620,1519,453,49922,167
6721,120,7435,1496,4560,37762,2875
58618,590,7935,512,6219,69944,1716
39681,8,145,934,118,5370,27
37971,105,1671,965,1333,17122,338
65643,8,81,294,54,3495,27
21700,1160,14288,1299,8883,105153,5405
17358,49,1493,1376,1084,39137,409
58656,3283,78438,511,52076,392380,26362
53746,260,3748,662,2863,38328,885
46967,253,4996,835,4011,54810,985
69354,52,586,175,486,5047,100
26969,24,401,1196,259,10980,142
65392,5,76,297,48,2619,28
55505,3443,55138,604,41959,372355,13179
33603,3815,43558,1072,31518,115512,12040
59468,33,700,485,617,9968,83
48591,317,5143,809,4268,53402,875
38324,15,386,956,339,27022,47
10935,147,2584,1463,1691,17668,893
34303,13,349,1058,259,7739,90
22045,7,211,1295,177,8705,34
26694,5,112,1202,90,4206,22
26114,19,1272,1215,761,37315,511
26658,231,6453,1203,4797,33580,1656
63298,165,2150,360,1737,19512,413
38339,36,572,956,394,6359,178
8220,4,192,1478,135,7223,57
61489,66,958,413,794,10490,164
12754,196,9956,1445,6074,58992,3882
31444,472,12951,1109,9105,56486,3846
13720,83,2406,1431,1560,17607,846
18597,728,14229,1354,9395,129659,4834
1124,24,1104,1555,747,64114,357
1111,54501,1988550,1556,1359306,3228842,629244
21357,22,525,1305,401,13341,124
36380,4,66,732,44,4727,22
59867,775,23220,471,19047,74179,4173
14802,17,559,1416,396,28658,163
52413,20,256,702,187,4211,69
12370,38,852,1450,485,17028,367
49362,2,27,786,20,3703,7
32818,33,681,1086,541,12920,140
15580,0,0,1405,0,5627,0
17285,206,2605,1378,1922,19579,683
34840,7,124,1046,94,5669,30
13518,55,1155,1434,741,17399,414
25,174,12600,1567,7852,83335,4748
24769,268,5913,1244,4481,60494,1432
34858,2709,41381,1045,30926,147883,10455
22104,108,3493,1294,2180,33669,1313
21130,31,1053,1309,714,30471,339
37669,75,1215,973,1074,25256,141
21208,52,1942,1308,1264,15251,678
25327,786,21197,1232,12695,95193,8502
978,175,2994,1557,2159,26986,835
28450,503,15030,1165,9750,43858,5280
18899,25,1398,1349,1046,20525,352
69091,19,272,184,236,4868,36
70153,4,41,148,40,1801,1
45508,6,61,853,46,3536,15
1016,76,2251,1556,1563,42456,688
47863,23,353,824,312,10206,41
13380,0,0,1436,0,4844,0
48757,32,811,805,607,12494,204
3451,13,207,1536,133,8680,74
40235,77,798,926,631,7224,167
9717,38961,1156063,1471,765264,3747079,390799
13047,32,1485,1441,1050,53363,435
1207,5,639,1555,408,10223,231
51332,1162,18416,735,15022,82874,3394
8583,9188,658233,1477,365972,1928476,292261
51529,0,0,608,0,7666,0
28936,1897,40064,1156,27212,233963,12852
20422,27,1561,1322,1073,13892,488
33617,68,1275,1072,990,28799,285
59395,41,641,487,540,7314,101
155,808,38807,1564,22932,158899,15875
47397,45,566,829,461,10858,105
47833,13,224,824,162,2817,62
36322,650,9720,1008,6182,50050,3538
10317,20,388,1468,237,8358,151
16225,57584,2053755,1395,1558006,4532766,495749
7641,314,13368,1484,9084,98044,4284
27922,40,1469,1175,1030,21952,439
44831,12,236,860,177,5662,59
66677,94,2381,263,1891,26821,490
61542,380,5635,401,4126,35081,1509
19994,6,275,1329,179,19438,96
32439,5,144,1094,93,3243,51
54054,124,1282,651,1042,19144,240
9982,185,10042,1470,6645,92607,3397
17375,1,19,1376,17,4243,2
53644,54,640,664,451,13364,189
4229,31,422,1528,328,4704,94
51342,471,4124,695,3436,67826,688
21757,36,1271,1299,760,12723,511
21407,14,723,1304,493,26429,230
608,103,3138,1559,2221,47751,917
23202,378,10648,1276,8260,106313,2388
10921,40,1329,1463,818,17961,511
25973,4,273,1218,175,15709,98
58869,33,541,504,424,8689,117
56595,1016,25260,572,20522,115755,4738
53906,353,6423,656,4333,54793,2090
21970,258,10739,1296,6767,49737,3972
15986,3,93,1399,70,13360,23
32628,200,7229,1091,4732,47927,2497
45946,12,140,848,111,3006,29
64289,34,380,330,299,6943,81
39606,146,2198,935,1739,14464,459
5023,5,198,1517,149,13470,49
66981,233,5033,253,3728,43699,1305
58548,331,5276,514,4301,39843,975
32449,77,1444,1094,1025,19540,419
60677,12,97,441,75,5608,22
32429,144,1619,1094,1041,12332,578
23457,58,1463,1272,1171,46309,292
4021,29,928,1530,723,16465,205
3495,8,223,1536,140,9414,83
37740,12,532,971,420,12113,112
34108,2560,58380,1062,37076,107527,21304
64220,55,524,333,406,4075,118
62922,1,9,369,6,1918,3
4738,57,2656,1520,1846,29117,810
56656,34,277,571,216,7782,61
2075,307,12724,1548,8275,93070,4449
22970,12,604,1280,439,38191,165
13846,107,5280,1429,3212,38459,2068
35961,5,63,1019,59,4067,4
34355,10,200,1058,143,6701,57
61913,15,511,398,330,12498,181
39668,4,73,934,53,2183,20
18671,33,714,1353,523,11909,191
49095,97,1595,794,1237,11610,358
5775,22,617,1508,391,15465,226
18585,475,10549,1354,7580,98334,2969
65265,0,0,302,0,1795,0
20092,1336,29354,1327,23068,216067,6286
70367,201,2994,141,2796,41413,198
33371,46,629,1077,419,8036,210
14748,8,556,1417,368,11325,188
52353,36,725,704,593,18054,132
61070,286,4157,426,3425,35694,732
65433,76,907,298,746,11312,161
2814,2980,71445,1542,39627,177571,31818
66011,3,66,284,62,2173,4
62425,2569,66715,383,47836,119142,18879
22931,143,3004,1281,2091,23709,913
48442,330,4363,815,3526,47651,837
52818,56,861,687,669,12332,192
51349,291,3826,728,3270,38618,556
24943,142,4046,1240,2762,42742,1284
9978,43,2300,1470,1405,22957,895
24696,12,422,1246,275,14599,147
30732,10,372,1121,214,5484,158
38470,1162,16755,952,13465,41444,3290
56319,176,4077,580,3418,31441,659
35361,364,9275,1032,6790,65181,2485
6729,804,29552,1496,21067,165831,8485
55679,15,171,598,137,7835,34
21377,10014,451595,1305,250163,1066082,201432
32834,163,2220,1087,1500,15104,720
36790,3,61,998,52,6284,9
40125,166,3852,927,3344,30961,508
11963,2265,81405,1454,44699,402062,36706
27937,28,838,1175,538,14918,300
7084,523,12301,1491,7719,77433,4582
14003,263,5204,1427,3415,81575,1789
18232,7,325,1360,232,16639,93
26989,7,686,1196,408,18191,278
19794,10,505,1333,391,14015,114
4728,42,1017,1520,693,23478,324
19941,69,1977,1330,1377,21830,600
17117,3,164,1381,114,17076,50
55428,77,692,606,608,19751,84
45407,27,237,854,195,6727,42
12061,5,272,1453,136,5448,136
31257,105,2540,1112,1435,12283,1105
62984,2,30,368,23,3614,7
34735,2,182,1048,108,7713,74
37207,0,728,986,576,16454,152
18393,245,10534,1357,6866,100522,3668
66267,60,1411,276,908,42551,503
35466,27,504,1030,351,12395,153
4405,301,7174,1525,4523,51336,2651
65837,4,43,288,43,4909,0
4887,11,303,1518,231,14608,72
65021,140,2416,308,2140,21412,276
5632,523,15929,1509,9959,69572,5970
61721,35,396,406,324,10414,72
10757,14,735,1464,462,12612,273
35049,250,5937,1041,4306,59185,1631
35775,64,1592,1024,1216,25230,376
45348,57,751,854,606,22832,145
68503,3,37,204,26,2106,11
15678,271,7972,1404,5237,100057,2735
67925,48,498,222,382,4673,116
9191,72,2434,1474,1501,13776,933
35417,18,255,1031,187,7235,68
34879,18,539,1045,358,9053,181
34423,67,2773,1054,1962,22946,811
24750,717,30949,1244,23011,94674,7938
19495,67,3723,1338,2688,44543,1035
134,972,54787,1565,35168,697014,19619
34703,56,568,1049,394,5941,174
43597,270,7508,873,6045,45930,1463
33518,94,1916,1074,1210,17972,706
30207,139,2919,1131,1679,10787,1240
59071,66,482,498,392,7418,90
65646,47,414,293,336,9704,78
17370,187,8130,1376,5512,101839,2618
25165,69,757,1236,507,6721,250
26712,130,4757,1202,3156,38395,1601
5739,2519,48390,1508,31891,235122,16499
66747,31,337,261,286,3851,51
4524,232,9048,1524,6525,110079,2523
26299,34,1233,1211,741,24062,492
50012,73,1196,769,889,5767,307
51710,31,291,724,256,12288,35
16048,70,2190,1398,1341,10686,849
1504,41,967,1553,683,31053,284
1485,341,17019,1553,11293,110688,5726
46350,205,3872,843,3033,22901,839
60422,13,157,451,121,3804,36
3318,76,6339,1537,3898,76030,2441
17461,102,2161,1375,1629,32143,532
49009,45,322,797,244,4191,78
57122,37,699,558,527,15343,172
31867,7,247,1103,162,13118,85
9616,15,439,1472,286,6379,153
11750,4427,109755,1456,73922,491864,35833
56923,25,172,563,156,5436,16
15814,10,294,1402,187,7831,107
60147,82,808,461,619,6584,189
30945,415,16338,1117,10005,93622,6333
64081,1,49,336,31,3906,18
14615,62,1269,1419,907,14697,362
455,17,1226,1561,875,21773,351
65128,20,245,305,172,4069,73
14894,109,1134,1415,821,16925,313
25523,142,3604,1229,2054,20489,1550
65994,12,202,281,150,8326,52
6334,7,384,1501,253,15137,131
14985,68,3113,1414,1946,41209,1167
9723,410,10197,1471,6486,29992,3711
63996,51,882,340,710,11337,172
23733,1029,25312,1267,17969,169805,7343
62263,4,69,387,54,6500,15
42128,8,340,895,204,7892,136
18885,64,1588,1349,1180,22246,408
52905,488,9548,684,7105,94844,2443
35487,11,205,1030,133,3230,72
7178,9213,253207,1489,143215,588098,109992
47553,8,212,827,186,9829,26
20538,27,718,1320,570,44162,148
17152,5,202,1380,145,6056,57
30335,15,309,1128,263,36065,46
8456,1101,27611,1477,16670,136842,10941
8760,274,9069,1476,5629,78111,3440
18213,220,7518,1361,5146,202545,2372
70572,13,319,134,309,8140,10
22956,5,77,1280,58,3007,19
7186,91,4548,1489,3034,65373,1514
64057,47,628,338,538,8606,90
19359,169,5915,1340,3405,39467,2510
20278,605,9840,1324,6479,43930,3361
47205,108,1289,832,1074,10150,215
45011,67,1044,858,757,10758,287
2546,14,405,1544,283,23015,122
67734,60,903,229,765,9040,138
5362,38,2487,1512,1655,16262,832
33089,28,1217,1082,710,13441,507
50166,13,98,765,78,4433,20
50097,3045,46142,767,36514,298628,9628
21363,4,266,1305,195,11631,71
3497,3,124,1536,73,6152,51
55071,273,3607,615,3180,32827,427
48811,30,994,803,679,15547,315
31967,437,6203,1101,4392,41255,1811
60956,42,393,431,285,6598,108
16110,83,614,1397,454,12635,160
28231,14,646,1169,373,8076,273
16653,21,293,1389,237,14417,56
66464,11,194,270,153,6009,41
50063,63,574,768,471,13546,103
30809,22,480,1119,367,16273,113
2860,76,2819,1542,1864,39897,955
61099,117,2338,425,1823,26860,515
32588,30,1044,1091,644,10783,400
29593,131,2307,1144,1445,9313,862
1853,82,4403,1550,3073,72101,1330
54217,153,2806,645,2197,38798,609
29448,2005,60995,1146,42998,325463,17997
40285,49,544,925,453,5310,91
5234,78,3147,1514,2017,33983,1130
48540,48,628,808,528,16230,100
51130,3910,63560,740,43510,217288,20050
36218,27,380,1012,306,7663,74
39980,13,300,930,215,7318,85
10770,253,6335,1464,4085,26881,2250
69723,49,1095,163,975,13828,120
58945,221,3716,502,2482,47228,1234
38494,36,791,951,609,16817,182
61841,19,277,402,208,4456,69
35017,74,1252,1042,924,24285,328
37816,152,1680,969,1288,11370,392
31419,70,2097,1110,1418,17498,679
15368,14,930,1409,668,26671,262
48375,8723,101630,816,78186,459735,23444
31418,19,607,1110,410,16532,197
37253,32,1307,984,983,20732,324
835,17,1134,1558,643,16942,491
36336,2844,35405,1008,28067,231793,7338
29507,383,7643,1145,4900,35001,2743
48205,6,83,819,67,5769,16
52635,120,1508,693,1132,11468,376
5387,2,22,1512,19,2912,3
59377,20,263,487,186,9359,77
68361,12,110,209,81,3664,29
56161,552,4528,585,4054,48178,474
49524,19,228,782,165,6453,63
14717,19,1189,1417,793,10022,396
62640,103,2780,376,2132,29681,648
66850,2,15,257,13,1201,2
63404,160,2315,357,1835,24706,480
63683,12,241,350,190,3226,51
10016,8,322,1469,207,9121,115
16325,1,58,1394,38,9159,20
51817,118,1264,721,979,12111,285
12723,112,1578,1445,991,12834,587
54273,29,291,643,264,7040,27
24602,40,825,1248,573,11506,252
50062,74,750,768,568,7132,182
35574,20,495,1028,346,10092,149
9174,32,968,1474,662,15027,306
3006,1052,33991,1540,22989,205549,11002
22100,139,5523,1294,3866,56266,1657
37384,8,213,981,188,21307,25
25737,45,2143,1224,1314,27292,829
1722,379,14743,1551,11005,210664,3738
15690,249,3865,1404,2800,79055,1065
57872,1155,30299,537,21267,120670,9032
61837,349,5141,402,3953,20415,1188
1789,49,1907,1551,1381,18064,526
66193,31,358,278,280,4909,78
58711,61,476,509,415,9648,61
28237,4,262,1169,133,5859,129
10681,470,7788,1465,5343,34988,2445
28306,183,7616,1168,5431,21159,2185
18276,118,3622,1360,2330,16319,1292
8970,25,621,1475,416,6597,205
57465,56,426,550,343,10155,83
62223,208,3860,389,3104,14440,756
17722,19,741,1369,634,42996,107
23848,537,17725,1265,12369,127731,5356
56151,31,278,585,203,9951,75
57306,4,25,553,22,2509,3
4442,41,1104,1525,757,27133,347
61578,7,44,410,37,6543,7
64420,1754,30960,326,25759,144355,5201
31078,34,925,1114,561,17820,364
52010,22,565,716,435,13306,130
7403,19517,495777,1487,325072,1812290,170705
60375,15,128,453,100,1848,28
16458,93,2597,1391,2052,47099,545
67568,12,195,234,127,3086,68
7395,381,7039,1487,4258,42313,2781
32931,20,499,1085,247,8448,252
10870,3694,103417,1463,63503,509612,39914
23085,2124,48312,1278,37001,221363,11311
45252,138,3041,855,2487,23571,554
33866,1,85,1068,68,14454,17
36229,1,38,1012,25,3934,13
16921,13,637,1384,471,20573,166
36829,13,211,997,141,4242,70
9198,3150,116278,1474,61755,748039,54523
66035,6,76,283,59,2271,17
32230,276,4882,1097,3414,44231,1468
9667,27,1422,1472,738,12763,684
53713,35,211,662,162,10484,49
28104,88,3105,1172,1589,17603,1516
43117,322,4311,879,3438,34694,873
67194,82,1390,239,1060,11598,330
20339,13,632,1323,457,14591,175
22623,185,4113,1286,2765,20276,1348
54220,24,340,645,299,4538,41
9893,115,2622,1470,1621,15127,1001
36849,15361,316719,994,229987,1034947,86732
12836,192,3993,1444,2441,30302,1552
67294,35,390,242,324,2582,66
22135,263,7127,1294,4677,23609,2450
21818,41,1376,1298,1011,19011,365
69757,58,658,161,564,5962,94
44081,27,436,868,337,11966,99
68268,2,29,212,16,943,13
24833,22,542,1243,363,14231,179
30993,12,213,1116,157,2561,56
11775,57,1796,1456,721,8490,1075
20352,40,1485,1323,1109,16367,376
53816,109,1231,659,1066,18899,165
27176,1,88,1192,50,3476,38
38525,24,692,950,611,16836,81
3629,102,1946,1534,1313,28507,633
62865,1245,23113,371,18848,132758,4265
22225,309,5329,1292,3388,24010,1941
36780,8432,152813,998,104556,941234,48257
54623,2038,23681,630,18591,62948,5090
48482,15,225,814,180,6123,45
66713,2,57,262,40,3917,17
67352,20,248,241,192,5723,56
31422,11,311,1109,186,9986,125
49432,83,959,784,815,17008,144
49073,31,621,795,526,11883,95
50259,1304,22749,763,16760,194831,5989
28582,16,401,1163,223,9508,178
60643,6,154,442,86,5129,68
60285,19,125,456,90,4332,35
64590,105,761,322,557,6887,204
8469,73,1762,1477,1124,15769,638
24105,210,4426,1259,3224,41324,1202
57959,1618,19864,534,16532,72110,3332
27952,23,825,1174,623,16286,202
714,27,1633,1559,1287,52831,346
25872,564,9708,1221,5720,71353,3988
54797,6,93,624,54,7135,39
7552,708,47236,1485,29505,184319,17731
27644,136332,3485710,1181,1690407,7951082,1795303
3022,50,3697,1540,2334,19356,1363
31572,27,663,1107,436,29830,227
59392,75,926,487,705,15126,221
69048,26,180,185,158,3634,22
9587,96,4368,1472,2748,35723,1620
567,43,1719,1560,1235,18081,484
59498,15,99,483,80,8398,19
13247,158,2517,1438,1775,26424,742
10012,27892,573548,1469,349478,908618,224070
20041,8,486,1328,338,16633,148
9738,97,6452,1471,4120,44044,2332
16188,520,14198,1396,9470,74562,4728
19102,27,1055,1345,661,12169,394
48668,31,567,807,416,13796,151
16094,147,5541,1397,4056,31287,1485
24608,11,538,1248,345,12829,193
13517,8,284,1434,205,5727,79
38294,4,479,957,280,8651,199
62099,1869,35479,392,27430,190648,8049
69718,2,41,163,35,2347,6
62434,126,2372,382,1950,14859,422
7761,76,4337,1482,2769,53817,1568
30899,190,3777,1118,2993,51180,784
10441,47,1111,1467,708,9610,403
59247,142,2393,492,1856,14039,537
2333,18,762,1546,567,10922,195
959,15,806,1557,535,20619,271
31609,18,565,1107,344,10609,221
56733,11,117,568,95,3496,22
10159,223,7736,1469,5414,66635,2322
18172,1774,40826,1362,28720,129074,12106
63412,254,6552,357,5410,40373,1142
28810,8,404,1159,224,4540,180
31719,20,678,1105,435,8865,243
46225,2,30,844,22,5165,8
4587,34,1296,1522,750,14600,546
63022,643,7950,367,5988,51440,1962
49986,10,99,770,70,3764,29
6911,102,2685,1494,1699,13363,986
62022,146,1993,395,1576,13955,417
63190,116,1097,363,854,10407,243
32500,18,561,1093,348,15088,213
33736,10,622,1070,355,5375,267
14690,21,804,1418,548,14538,256
17261,36,531,1378,380,14526,151
29923,335,6439,1137,4977,44312,1462
13259,27,981,1438,459,13439,522
60496,29,341,448,310,14778,31
42123,24,564,895,391,14420,173
32199,14,402,1098,294,21473,108
50739,8,104,751,96,6512,8
14211,26,885,1424,703,74177,182
21277,994,44245,1306,31039,194910,13206
9566,265,11041,1472,6354,235752,4687
20785,49,1132,1316,699,23548,433
35178,165,1888,1035,1539,17758,349
230,2,150,1563,92,12119,58
35447,1,87,1031,68,4440,19
13475,255,13506,1435,8069,67489,5437
63634,696,10282,351,8364,76612,1918
8225,320,9296,1478,6010,71703,3286
13044,225,7573,1441,4145,63222,3428
12561,198,3877,1447,2389,24435,1488
38737,838,12924,946,10108,42778,2816
53751,497,5904,661,4656,46057,1248
34192,368,7949,1061,5309,94677,2640
68892,17,209,190,161,2573,48
46618,0,0,839,0,2967,0
10229,126,4208,1468,2614,29378,1594
45153,80,1047,857,814,15701,233
15619,79,2975,1405,2262,37144,713
21017,3,198,1311,135,7751,63
1978,84,1809,1549,1270,52435,539
57010,77,1001,561,834,16132,167
68485,27,321,205,286,6512,35
4986,41,965,1517,645,22663,320
11497,127,3111,1459,1519,19590,1592
40287,69,1213,925,998,22299,215
67862,121,1551,225,1269,10765,282
6078,69,2902,1504,1979,26372,923
9852,1172,15791,1471,11618,108542,4173
48893,37,457,801,325,7711,132
17689,11,564,1370,471,11301,93
64106,0,12806,336,10615,61577,2191
29200,9,467,1151,294,7553,173
58587,221,4039,513,3444,27102,595
28417,164,7406,1166,4971,21902,2435
41298,133,2110,909,1648,21863,462
8701,1,33,1476,23,4103,10
6164,218,11381,1503,8169,69200,3212
24089,8,247,1259,169,12032,78
50758,118,2011,751,1460,11602,551
35171,52,716,1037,559,16254,157
16565,452,8573,1390,5529,35371,3044
66027,29,469,283,358,10779,111
6421,12,485,1500,321,15664,164
741,15,859,1558,635,18857,224
24814,6106,161125,1243,101545,913412,59580
24379,7,263,1253,170,9300,93
25360,4101,94904,1231,57020,479382,37884
11306,70,2629,1460,1491,17805,1138
49649,128,2432,779,1754,23731,678
30789,11,218,1119,144,4542,74
38399,54,813,954,717,15224,96
19931,71,3066,1330,2220,38515,846
42259,18,315,894,244,10814,71
66871,4,39,257,32,1186,7
62303,468,5068,385,4098,25788,970
6954,22,1476,1493,1007,17210,469
64939,165,2596,311,2183,17156,413
18083,141,3337,1363,2449,41247,888
13584,16,1212,1433,756,48868,456
58215,32,478,526,413,10509,65
34507,78,1667,1054,1138,7996,529
68113,4,29,217,24,1809,5
51193,23,347,738,282,14497,65
39622,68,1595,934,952,23916,643
15090,577,25793,1413,16895,111647,8898
29346,4,112,1148,76,11468,36
9975,9,369,1470,245,15642,124
11133,19,496,1461,291,6919,205
12800,193,5253,1444,3324,32810,1929
21203,14,880,1308,618,12518,262
3550,10,392,1535,278,15971,114
11468,29,928,1459,432,7534,496
69998,85,986,154,838,6365,148
4085,1621,29262,1529,18221,128016,11041
18193,12,573,1361,413,17357,160
22425,350,18143,1290,12488,94128,5655
58235,53,619,525,518,17062,101
19480,122,3676,1338,2414,21044,1262
39012,191,3084,942,2366,14839,718
69852,153,2848,158,2435,32561,413
27976,16,285,1174,173,5971,112
55580,54,394,601,315,5134,79
67815,0,27,226,15,2635,12
10332,218,7367,1467,4351,32795,3016
9854,6,292,1471,202,6835,90
27289,2,133,1189,77,5643,56
3293,394,10952,1537,8268,67168,2684
24920,164,3075,1241,2226,25900,849
35580,9,301,1028,193,7789,108
59772,710,9845,474,7241,40094,2604
13925,40,1743,1428,1056,21788,687
27278,46,799,1190,642,9435,157
45847,24,502,849,333,3525,169
66051,15,207,283,158,6243,49
42238,151,2137,894,1810,21219,327
67674,15,406,231,296,4387,110
8277,314,5275,1478,3216,20938,2059
28901,183,2512,1157,1629,13843,883
49764,12,280,775,220,9363,60
33793,185,2527,1069,1662,18688,865
37924,0,34,967,27,17291,7
58177,66,1032,527,839,14575,193
69946,14,229,155,214,4223,15
19388,0,15,1340,15,3797,0
50027,9,125,769,101,4100,24
26081,54,5510,1216,3771,19335,1739
38839,1946,28954,944,22276,106980,6678
48725,635,12174,806,9391,98143,2783
15890,38,1485,1401,994,20898,491
67257,52,862,244,672,10551,190
5829,0,73,1507,56,7126,17
55640,1459,22222,600,16176,100330,6046
53709,3,36,662,24,3719,12
30366,33,474,1128,411,8294,63
49525,208,3231,782,2375,55185,856
28004,21,1105,1173,702,5616,403
67434,13,151,239,103,4883,48
37416,171,2333,980,1726,15879,607
30894,200,2498,1118,1729,34054,769
3263,23,617,1538,447,18239,170
63732,7,191,348,123,6156,68
22849,723,22348,1282,16091,112987,6257
60847,8,137,435,102,2614,35
16399,3121,147473,1392,82741,713782,64732
28910,103,2887,1156,1953,20507,934
62432,1,34,382,23,4003,11
16441,33,865,1392,619,14929,246
6620,202,5774,1497,4168,62349,1606
60580,60,893,445,683,10278,210
32177,23,500,1098,450,32255,50
47332,441,4867,830,3892,27558,975
24194,12,463,1257,356,10936,107
20703,375,14942,1317,10262,124518,4680
67523,5,54,236,38,2075,16
33138,12,370,1081,258,7290,112
63595,298,3651,352,2979,39973,672
38914,53,821,943,643,7035,178
15246,4,456,1411,114,11663,342
57137,7,87,558,56,2631,31
58913,23,265,503,218,19155,47
49114,32,331,794,284,9154,47
34434,38,1197,1056,806,38402,391
51270,1296,15789,737,12166,59944,3623
63861,14,188,344,146,6665,42
49271,173,2923,788,2369,35761,554
3455,93,4056,1536,2662,43206,1394
15448,49,1163,1408,867,19446,296
39410,67,1012,938,877,18035,135
19902,59,3375,1331,2297,28688,1078
5098,44,1561,1516,1047,16795,514
42500,575,15920,890,12390,90298,3530
12939,39,904,1442,445,13125,459
1829,17,433,1550,304,16226,129
3147,5219,211643,1539,125547,465455,86096
11742,24,549,1456,293,14887,256
18785,48,1268,1351,848,49952,420
8603,85,2338,1476,1446,27134,892
25375,13,298,1231,216,19678,82
56945,3,44,562,37,1659,7
7734,62,2193,1482,1456,27471,737
22314,221,4685,1291,3519,37162,1166
23053,40,1114,1279,833,13827,281
29655,68,1302,1143,867,15578,435
33050,74,2708,1083,2039,34167,669
70401,15,197,140,187,6661,10
33405,78,1627,1076,1071,15175,556
36990,50,1146,992,1009,19309,137
29306,18,604,1149,334,7995,270
23790,5247,144499,1266,94598,783857,49901
49641,61,645,779,472,5332,173
66132,30,427,280,326,9446,101
33262,79,1259,1078,842,10994,417
53302,37,576,673,457,13471,119
69368,790,11621,174,9986,55575,1635
30170,58,732,1132,582,18092,150
64478,15,111,325,83,5251,28
58176,70,1116,527,786,14027,330
2979,3610,105035,1540,58246,180132,46789
38001,88,1299,964,889,20563,410
38468,51,1545,952,1130,24166,415
56877,5970,183554,564,132492,391541,51062
58184,33,343,527,251,5938,92
42119,10,334,895,270,22112,64
67778,83,1554,227,1280,20091,274
20925,2276,173895,1313,115021,961116,58874
2367,14,449,1546,332,9620,117
35278,1414,15519,1035,10417,80473,5102
4941,552,30853,1518,12660,72117,18193
13763,138,3267,1431,1884,24229,1383
15237,0,0,1411,0,14963,0
50258,13,225,763,186,6100,39
69676,401,8412,165,7840,38792,572
8836,53,1163,1475,744,15778,419
35611,8031,196850,1027,136125,531536,60725
25768,68,1939,1223,1184,16360,755
63319,10,103,359,90,5340,13
53506,268,3347,669,2564,13902,783
31329,128,2224,1111,1610,23572,614
12485,25,1924,1448,1128,19943,796
5417,175,7159,1512,4882,92397,2277
54858,91,1007,621,755,15575,252
15779,20,654,1403,459,20665,195
22850,3,343,1282,239,10321,104
53366,81,688,672,563,8538,125
11121,9,254,1462,158,5863,96
8462,655,35608,1477,22089,72196,13519
11488,109,5411,1459,2841,35472,2570
8778,12,445,1476,268,5073,177
68789,396,6551,194,5582,57393,969
3241,38,2342,1538,1665,27910,677
11357,147,7749,1460,4102,64693,3647
69388,16,218,174,170,3044,48
58781,67,954,507,781,11405,173
32595,210,3172,1091,2174,14666,998
33144,1934,44930,1081,32084,342477,12846
69702,54,1117,164,1019,6972,98
60802,9,52,436,43,4153,9
11331,28,1778,1460,764,19077,1014
50339,1030,11381,759,9100,120603,2281
13006,7,310,1441,164,10715,146
10613,21,789,1466,537,29462,252
57079,31,326,559,256,3275,70
110,144,4606,1565,3293,55671,1313
25603,1277,22633,1227,14471,82886,8162
17234,18,477,1379,365,13990,112
46046,207,3834,846,3235,53263,599
5886,13,330,1507,249,4199,81
50751,35,517,751,429,10052,88
49848,72,854,774,628,7831,226
40790,200,3438,909,2462,60745,976
29447,898,15027,1146,10234,64535,4793
18235,9,343,1360,285,9986,58
34696,332,8791,1049,5957,38592,2834
39549,8990,157353,936,118476,803635,38877
28609,3,109,1163,63,7905,46
26561,77,2984,1205,1834,22181,1150
32783,49,1493,1088,985,23553,508
25821,2,63,1222,56,12101,7
21517,603,21057,1302,10918,89336,10139
21328,80,1112,1306,771,6107,341
69670,12,127,165,120,3773,7
29759,40,495,1141,414,12016,81
41347,30,677,908,534,6643,143
8719,1182,39757,1476,25415,163221,14342
50807,33,545,749,382,7007,163
27701,46,1236,1180,763,8162,473
3606,538,10334,1535,7316,75665,3018
37094,43,1035,989,852,9418,183
32613,172,4315,1091,2648,28084,1667
37846,2918,73021,968,56725,421895,16296
22642,126,1905,1286,1287,13322,618
576,94,3203,1560,2294,28176,909
17934,102,3793,1365,2677,34004,1116
10871,56,1051,1463,655,9009,396
48939,285,7473,799,6131,44873,1342
61083,553,9691,414,7713,89362,1978
51875,28,454,720,336,10751,118
9719,1148,66616,1471,40726,272716,25890
62921,69,1139,369,911,10093,228
34714,7,133,1048,111,5740,22
56607,29,500,572,411,4301,89
7325,8,270,1488,170,22582,100
9793,110,5744,1471,3699,74573,2045
3599,3,123,1535,93,8396,30
57328,169,2260,553,1813,26933,447
67653,3,28,232,15,2703,13
52406,665,8365,702,6630,36915,1735
34832,26,1166,1046,776,7014,390
52898,30,402,684,300,10655,102
19031,55,1950,1346,1481,38650,469
30873,19,706,1118,469,3772,237
39430,13,466,937,335,7083,131
9327,22,879,1473,569,9842,310
3874,252,5583,1531,3960,26763,1623
213,3782,72681,1563,46710,350291,25971
50740,2651,62405,751,42943,285995,19462
42995,91,1183,882,959,17104,224
25063,35,1376,1237,890,26880,486
7319,155,4197,1488,2871,59360,1326
50371,140,1548,760,1243,11704,305
22257,64,951,1292,816,22895,135
15584,17,914,1405,631,33831,283
42209,185,2655,895,2163,25321,492
70294,205,4843,144,4357,34880,486
34475,2372,33412,1055,25825,155710,7587
36962,15,259,993,210,14065,49
16343,117,1295,1394,854,27388,441
4950,202,5708,1518,3838,51240,1870
18617,0,0,1354,0,11212,0
69298,4,73,177,61,2775,12
18599,18,855,1354,637,29430,218
16785,38,1164,1386,865,17529,299
623,54,1605,1559,1170,20817,435
63709,59,806,348,617,6725,189
54416,4554,62059,638,45611,196386,16448
5304,20,874,1513,595,32033,279
57163,657,15313,557,12661,59206,2652
35063,159,2763,1041,2120,22182,643
34996,5343,87454,1042,59073,320581,28381
30837,850,15492,1119,10071,49029,5421
21948,4,59,1296,55,9176,4
41065,21,306,912,258,15331,48
60821,65,1332,436,986,15673,346
67582,9,168,234,125,3502,43
51660,436,4022,726,2897,27548,1125
58749,5,137,508,84,4202,53
58374,411,5813,521,4889,42200,924
64160,25,289,335,242,5511,47
8927,39,1562,1475,997,10072,565
12079,8,340,1453,185,7193,155
52180,9,120,710,84,2669,36
48496,22,435,813,338,29321,97
35308,61,915,1034,663,11839,252
12859,237,6795,1443,3999,33040,2796
49543,232,3347,781,2728,26345,619
19266,98,1662,1342,1321,13688,341
33150,80,2668,1081,1784,53232,884
34124,171,3103,1062,2246,19646,857
31654,40,768,1106,559,6132,209
22725,45,1164,1284,780,15178,384
17356,7,319,1376,243,9148,76
29044,16,1083,1154,547,19800,536
62588,35,590,378,404,11790,186
336,35,1922,1562,1379,72291,543
48944,95,1050,799,875,15557,175
53627,49,581,665,476,12243,105
50251,192,2552,763,1954,15566,598
66524,6,69,268,46,4271,23
48656,12,298,808,243,7368,55
5215,182,13458,1514,8650,52554,4808
50994,1452,29278,744,21400,74763,7878
37998,21,463,964,377,22625,86
60971,113,2137,429,1937,25029,200
7812,60,2128,1481,1427,31308,701
48602,14,280,809,210,4732,70
63376,39,741,358,599,16654,142
67949,2,89,222,71,6121,18
67309,1509,19132,231,14643,109410,4489
29315,77,1859,1149,1436,37163,423
49072,111,2001,795,1755,48043,246
24037,14,437,1261,352,12281,85
879,14,886,1557,622,32574,264
26702,2,457,1202,265,5883,192
58712,13,132,509,112,9394,20
64752,557,7032,317,5937,42956,1095
62635,45,593,376,451,10834,142
55896,38,363,593,293,10114,70
69735,8,258,163,245,5415,13
18051,19,397,1363,291,4852,106
6318,68,2365,1501,1557,18832,808
3648,19,1325,1534,912,13457,413
17058,251,7494,1382,4971,54583,2523
67204,81,1348,246,1145,14741,203
51987,107,2439,717,1856,48695,583
66050,50,1315,283,1026,14807,289
64482,75,1274,325,969,17789,305
59316,26,431,490,348,8207,83
33783,7,165,1069,116,4994,49
31302,5,33,1111,23,8234,10
54865,5,15,621,9,2077,6
1641,2,123,1552,80,6761,43
5538,19,441,1510,342,11627,99
13580,5,517,1433,291,14861,226
1199,69,2063,1555,1470,24592,593
61334,29,525,417,450,5784,75
33629,108,1915,1072,1390,17067,525
68413,47,647,207,507,10257,140
12283,57,2068,1451,1208,27997,860
69869,15,188,158,148,5786,40
70659,0,26,131,21,1006,5
45072,1,56,857,44,2971,12
203,39,2137,1564,1557,28449,580
58798,11,209,507,147,10890,62
60951,7,84,431,52,2720,32
61126,47,429,424,331,5989,98
56888,0,60,564,7,3477,53
56086,539,14722,587,12724,92275,1998
11616,599,12312,1457,8425,87822,3887
62063,1,27,188,21,1973,6
4331,179,8117,1526,5932,70427,2185
55243,66,582,611,503,11888,79
22301,7,103,1292,78,33620,25
10150,1,137,1469,90,4503,47
19873,33,935,1331,602,10224,333
39995,38,864,930,680,6113,184
31183,43,1298,1113,779,11038,519
29212,78,2015,1151,1288,14553,727
34030,21,492,1064,376,24008,116
56867,35,408,564,323,9596,85
54190,10,147,647,99,3321,48
36193,0,93,1013,71,7272,22
38075,96,3558,962,2855,58073,703
29454,13,221,1146,137,3346,84
49254,18,586,788,388,16664,198
6568,119,3083,1498,1873,51112,1210
50595,2427,57142,754,42483,119507,14659
17423,592,5065,1376,3875,60375,1190
4332,75,844,1526,587,12806,257
14617,83,3392,1419,2398,44073,994
5386,9,708,1512,454,8317,254
52147,286,4980,711,3583,36453,1397
19923,134,4180,1331,2791,54167,1389
6539,553,10804,1498,7351,65222,3453
22144,14,302,1294,218,6638,84
13024,44,1297,1441,788,10318,509
63247,80,759,361,603,11061,156
57409,24,253,550,212,12687,41
58506,112,1629,516,1176,20369,453
2592,8,382,1544,263,9538,119
19026,122,3452,1346,2253,25522,1199
54852,53,581,622,402,7079,179
17664,1995,55682,1371,38517,454916,17165
24460,8323,189394,1251,131914,542061,57480
2638,19,1645,1544,1106,34655,539
7053,363,16458,1492,10973,86987,5485
394,22,761,1561,557,44907,204
26273,26,1123,1212,736,16751,387
26655,39,581,1203,381,8036,200
24573,7,289,1249,195,4050,94
68108,157,2450,217,2047,17847,403
57458,3,58,550,46,4170,12
5093,9,242,1516,168,22517,74
16421,2050,85561,1392,47676,321258,37885
50524,51,628,756,456,9053,172
66115,13,96,281,86,5695,10
66694,10,97,263,68,1130,29
32947,22,1077,1085,615,9874,462
8087,114,1519,1479,1200,36703,319
14806,37,932,1416,600,18251,332
18781,81,2154,1351,1495,22690,659
40092,2,61,928,47,4073,14
1743,13,765,1551,468,41168,297
19481,138,5169,1338,3152,57313,2017
56024,359,5357,589,4221,40253,1136
6000,65,4780,1505,3267,66466,1513
64257,14,342,331,223,7163,119
16718,185,5698,1387,4010,30715,1688
22369,2394,47704,1291,34509,167359,13195
10353,359,9484,1467,6232,39843,3252
35565,14,344,1028,250,9032,94
2220,258,6318,1547,4334,60157,1984
22879,107,2000,1282,1454,19038,546
48826,34,507,756,407,13239,100
62925,73,1061,369,838,11838,223
48700,26,325,806,248,12546,77
33030,5,86,1083,61,3322,25
18333,234,6703,1359,4330,32889,2373
35352,113,3978,1033,3038,44836,940
52346,93,1472,704,1262,19644,210
50381,43,714,760,556,19040,158
28718,2,476,1160,269,11970,207
21235,53,995,1307,685,38290,310
60402,58,551,452,454,9205,97
40226,58,1133,926,922,18276,211
3520,221,5444,1535,3417,27013,2027
27082,11,612,1194,391,11568,221
9956,196,6474,1470,4652,65279,1822
16092,1,112,1397,66,14331,46
64040,48,638,338,476,7678,162
18871,16,504,1349,393,14851,111
49941,0,529,771,359,12814,170
59555,12,207,482,179,4061,28
64979,26,592,309,452,8764,140
68687,2,59,197,47,2528,12
30221,270,2529,1131,1571,19538,958
9810,189,7405,1471,4741,32745,2664
11573,8,230,1458,122,9067,108
8697,54,1312,1476,781,17555,531
57495,1,20,549,15,4319,5
64221,24,407,333,284,3836,123
57424,627,8983,551,7060,63341,1923
50159,72,616,765,471,7286,145
20481,24,550,1321,415,7575,135
38541,373,4712,950,3659,17914,1053
21008,158,4059,1311,3004,73761,1055
22584,2,122,1287,101,14836,21
1472,8,377,1553,264,18477,113
56396,48,631,578,519,12680,112
12671,0,0,1446,0,9229,0
29382,3,204,1148,135,3694,69
20491,509,7709,1321,4814,63861,2895
31321,85,1989,1111,1263,20991,726
17640,4,104,1371,79,7264,25
14841,8,319,1416,231,14314,88
61323,20,261,418,231,9835,30
68609,42,442,200,342,8957,100
21953,8,152,1296,94,8210,58
11475,26,2054,1459,1044,22270,1010
11815,18,580,1456,333,19972,247
30119,133,3863,1133,2767,16896,1096
48969,4,131,798,103,15814,28
38342,206,3436,956,2695,44400,741
31922,22,303,1102,177,3485,126
17165,142,3455,1380,2497,50293,958
28900,426,10256,1157,7391,109345,2865
66245,1014,12369,276,10146,76177,2223
31223,91,1991,1112,1183,27172,808
35789,3040,77188,1023,50740,738320,26448
29809,752,15810,1139,12629,137230,3181
51488,5,77,731,67,6105,10
9232,8,404,1474,278,5492,126
12506,2737,76133,1448,42069,470583,34064
20794,285,8835,1316,6179,61529,2656
24288,747,46041,1255,29273,81030,16768
9971,90,1990,1470,1338,25071,652
49517,114,877,782,682,11140,195
9317,32,1374,1473,983,30759,391
11375,934,36028,1460,25021,197030,11007
13007,14,1117,1441,704,10430,413
30257,13,311,1130,210,16000,101
6598,18,807,1497,499,23621,308
51119,41,593,740,434,7555,159
51232,456,5529,738,4291,76025,1238
34971,7,240,1043,142,4683,98
53661,19,264,664,222,7380,42
8073,117,4179,1479,2594,41996,1585
30461,327,9431,1126,6577,63225,2854
57206,41,776,556,593,29283,183
33175,26,283,1080,214,6535,69
52292,11,216,706,160,17076,56
69920,39,604,156,553,17017,51
29607,8,581,1144,330,15353,251
21745,264,3364,1299,2303,35229,1061
50993,243,2797,744,2156,13414,641
49089,33,482,794,396,16114,86
12577,404,18822,1447,10403,101605,8419
15719,490,8695,1404,5967,80371,2728
36890,328,6968,996,5178,87926,1790
20179,10,430,1326,258,6697,172
61848,7,110,402,82,1548,28
65349,7,81,300,57,5016,24
21788,39,763,1298,541,22992,222
62609,1386,28837,377,21671,209277,7166
64010,10,102,339,76,5443,26
42233,93,3764,894,2116,26147,1648
64280,83,1686,330,1443,11499,243
40326,8,188,925,151,7686,37
35842,885,14807,1022,12059,167230,2748
52927,794,11288,684,8783,50199,2505
18754,198,10707,1351,6861,40455,3846
25287,22,439,1233,282,11497,157
60490,2,33,448,19,4464,14
19203,10,466,1343,314,13930,152
16137,271,6391,1397,3911,34241,2480
13222,7,255,1439,136,6804,119
9228,844,45600,1474,30077,109005,15523
17211,16,760,1379,582,17648,178
41227,224,2544,910,2066,13789,478
48753,5,89,805,74,3977,15
9851,228,5479,1471,3411,24462,2068
64090,0,19,337,14,1312,5
795,12,265,1558,174,32574,91
58047,281,3939,532,3333,25924,606
11453,60,1680,1459,992,8927,688
35676,59,699,1026,541,10065,158
2021,9,641,1549,426,21301,215
50867,7,143,748,119,7298,24
59937,435,23096,468,17547,52261,5549
65132,10,111,305,94,3060,17
68187,86,1722,215,1565,20630,157
17031,14,373,1382,288,14602,85
26042,78,1458,1217,945,12502,513
36058,2217,72482,1016,56368,326678,16114
26597,9,103,1204,98,8494,5
59642,15,457,479,246,8096,211
66645,11,116,265,94,2299,22
59736,18,650,475,497,7259,153
8300,73,2472,1478,1635,13320,837
18365,30,1015,1358,741,12336,274
3045,38,531,1540,363,4254,168
32349,38,901,1095,542,18117,359
38898,17,327,943,236,5572,91
27541,24,668,1183,410,9295,258
25217,197,3638,1235,2517,17891,1121
21893,69,3066,1297,2230,45432,836
48934,251,3120,799,2413,26260,707
37933,6,92,967,71,13102,21
61319,26,400,418,340,5407,60
62541,4,27,379,23,1866,4
7430,1072,28109,1487,18394,169954,9715
6837,195,5348,1495,3760,34048,1588
13297,66,2853,1437,1765,35860,1088
10464,24,1512,1467,914,16565,598
37136,39,1344,981,1017,16751,327
3105,94,4704,1539,3257,82494,1447
70079,46,604,151,595,5188,9
28733,7,269,1160,171,11638,98
21460,96,3590,1303,2376,14398,1214
27928,16,184,1175,112,5640,72
22883,5,179,1282,157,12730,22
26824,1,62,1199,45,2475,17
16132,133,1757,1397,1248,16844,509
14528,38,928,1419,711,11443,217
19165,857,27518,1344,20007,170093,7511
21259,113,4576,1307,3196,36676,1380
31972,149,2990,1101,2113,21199,877
26007,263,5052,1218,3494,37690,1558
33639,918,14765,1072,10812,81643,3953
36749,89,1433,999,1191,17957,242
68949,2,89,188,83,5141,6
24495,2473,75836,1251,47004,459204,28832
5654,66,2579,1509,1543,39094,1036
29663,31,748,1143,486,5228,262
54,40,1110,1566,832,26516,278
2317,5408,115920,1546,59817,198035,56103
38411,37,578,954,436,7314,142
16042,7,334,1398,230,11152,104
21503,158,6955,1302,4619,35955,2336
36917,590,8911,991,6972,42370,1939
19515,0,0,1338,0,18511,0
23867,542,9200,1264,5389,69644,3811
39740,110,1394,933,1114,6441,280
4935,307,12680,1518,6615,39803,6065
59607,31,483,480,361,6991,122
1047,520,17711,1556,11717,117376,5994
34849,58,1440,1046,952,16783,488
34007,761,12812,1065,8512,110711,4300
66973,1,63,253,48,4132,15
35556,819,8592,1027,5943,41059,2649
3480,949,12657,1536,8237,53976,4420
6385,42,1147,1500,765,15651,382
33240,34,653,1079,459,16592,194
32777,294,3302,1088,2432,34562,870
8479,3934,156554,1477,94262,363460,62292
15806,139,5156,1402,3376,35633,1780
7820,44,1942,1481,1345,32828,597
43177,397,8988,878,7065,55065,1923
13604,89,1504,1433,1019,17680,485
27679,1819,45476,1180,28771,227362,16705
27190,197,3863,1192,2591,46298,1272
60869,64,903,434,729,16506,174
67894,0,10,224,5,1192,5
9591,89,1995,1472,1238,15205,757
67435,75,1355,239,1150,15376,205
8413,15,794,1477,532,19311,262
11401,43,2045,1459,1309,49331,736
57722,29,382,542,258,3227,124
54075,225,1920,650,1393,36656,527
66920,8,137,255,107,3824,30
58237,85,1364,525,1193,28444,171
34249,62,1242,1060,844,22956,398
68657,25,330,198,245,5244,85
54400,4,59,639,40,3011,19
42788,363,6427,884,5110,51945,1317
67080,30,431,250,391,5904,40
55127,1,64,614,46,3161,18
17054,97,3544,1382,2609,32568,935
36889,97,1575,996,987,15971,588
1381,109,2491,1554,1766,27406,725
52872,254,3032,685,2249,38934,783
57156,58,1168,557,790,19914,378
64627,14,268,321,211,6465,57
25054,21,1165,1238,903,26577,262
12696,17,1180,1446,613,14921,567
64056,27,382,338,320,7966,62
35503,215,3428,1029,2543,30576,885
30643,102,1837,1123,1176,21322,661
31831,44,889,1103,556,20204,333
32354,241,6019,1095,3611,74805,2408
38453,29,597,952,494,8283,103
5003,82,3305,1517,1963,16533,1342
12352,33,1774,1450,1116,49504,658
67165,45,480,247,373,5244,107
29664,19,331,1143,259,18279,72
10615,46,1340,1466,853,14882,487
29304,106,1396,1149,1144,19494,252
40872,163,2170,916,1684,14731,486
64571,2,45,322,36,1559,9
57621,182,2534,545,1921,29399,613
11583,7,207,1458,119,4350,88
18036,58,2018,1363,1415,20414,603
2326,9,205,1546,156,7675,49
47675,43,852,826,690,11726,162
35928,3,92,1020,66,5202,26
58332,22,941,522,729,14597,212
9407,25,835,1473,565,13788,270
43429,6,336,875,230,10811,106
28030,424,6473,1173,4353,22524,2120
21544,444,15773,1302,10040,87419,5733
9314,61,1108,1473,709,19830,399
10409,216,11337,1467,6864,99887,4473
30079,42,737,1134,485,10983,252
9173,21,928,1474,505,7648,423
63448,10,108,356,69,2899,39
53714,54,501,662,343,5992,158
3159,3161,59260,1539,41881,157583,17379
14062,302,8256,1426,5648,61152,2608
16029,43,1290,1398,830,19085,460
63128,66,1145,364,832,8976,313
38573,123,2200,949,1677,24361,523
56035,44,687,589,574,18892,113
22189,2,83,1293,54,5159,29
50065,5490,164260,763,104396,943492,59864
37065,20,374,990,289,7343,85
51737,47,553,723,430,9071,123
30719,20,693,1121,464,10372,229
44631,801,7941,862,6647,111624,1294
30355,53,1133,1128,786,20572,347
28981,346,11024,1155,7011,57494,4013
37132,16,308,988,264,22990,44
14269,25,1236,1423,818,33222,418
10499,133,2494,1466,1799,41152,695
5159,24,1535,1515,994,25736,541
50645,69,776,753,635,7306,141
20934,20,535,1313,386,13147,149
2801,1512,29568,1542,21064,139097,8504
61985,94,1099,397,832,21101,267
3410,18,546,1536,378,13027,168
67247,736,9953,243,7662,51535,2291
52137,126,1853,711,1524,19227,329
36522,6,220,1002,160,9645,60
66321,11,117,275,82,3762,35
7704,6,353,1483,219,3930,134
16713,137,1811,1387,1333,24520,478
60317,404,5776,455,4474,19496,1302
23670,59,945,1268,698,32214,247
23701,18,467,1267,372,30630,95
49293,21,343,788,265,8775,78
68698,20,355,197,281,3445,74
12693,3230,126397,1446,61743,745913,64654
14637,69,1777,1418,1225,35096,552
58157,63,1127,528,871,17102,256
3849,57,2206,1532,1504,58533,702
5018,3,113,1517,86,4289,27
8888,730,22459,1475,16499,101672,5960
20908,10,331,1313,226,8328,105
5794,591,19759,1507,12700,58968,7059
2541,46,2917,1544,2007,49455,910
13818,71,1779,1430,1015,7897,764
69363,1,38,174,35,1187,3
63193,309,5159,363,4224,36907,935
68344,45,538,209,480,8473,58
68086,10,184,218,131,4127,53
9536,116,2184,1472,1442,18912,742
56425,8,112,578,86,3234,26
57518,11,229,549,115,8376,114
15004,29,1234,1414,824,12583,410
14205,3734,90353,1424,62066,346443,28287
15574,1961,85128,1406,49730,165669,35398
31862,74,2259,1103,1430,17774,829
7439,8,765,1487,533,17596,232
2643,22,728,1544,484,17188,244
30259,14,483,1130,335,18281,148
63039,37,1121,367,795,11060,326
40058,3,164,929,126,6652,38
60199,10,245,459,203,12538,42
61724,0,0,400,0,5742,0
1097,5,162,1556,126,6796,36
65348,36,319,300,244,3774,75
23674,478,21214,1268,14003,97769,7211
5597,622,17398,1510,10299,74584,7099
27490,56,1020,1185,665,13537,355
69636,22,562,166,389,6992,173
21828,495,11544,1298,8538,52361,3006
30488,623,14240,1125,10195,107153,4045
32076,12,513,1100,299,10821,214
2476,19,840,1545,540,11950,300
69267,19,349,177,304,4083,45
68925,15,213,189,177,4338,36
32131,77,1904,1099,1417,31487,487
35030,32,689,1041,450,9957,239
51363,40,549,734,429,5603,120
52811,130,2151,688,1466,19292,685
66491,3,84,270,63,9020,21
2756,27,1440,1543,954,24368,486
52553,264,4174,697,3245,23385,929
2288,290,5770,1547,4006,72511,1764
17113,4,198,1381,158,6678,40
16483,47,1421,1391,893,16096,528
66830,6,68,258,53,3339,15
35897,12,344,1019,273,6829,71
13991,19,526,1427,313,13333,213
3627,129,6145,1534,4181,45969,1964
44421,136,2879,864,2250,44822,629
12727,41,1228,1445,708,13387,520
26981,92,1197,1196,677,10079,520
33146,43,726,1081,445,7606,281
31598,188,2547,1107,1636,10522,911
45098,16,442,857,316,3378,126
37244,1129,11729,984,9034,58876,2695
63631,40,239,351,192,6770,47
12946,75,2960,1442,1940,187887,1020
22078,19,374,1294,263,6893,111
19399,89,2590,1340,1847,74192,743
66425,70,451,271,371,5342,80
67412,37,531,239,409,6586,122
46912,35,871,836,654,15304,217
62561,23,399,379,312,10861,87
48990,106,1419,797,1238,29317,181
36711,41,823,999,621,8379,202
58484,27,192,516,162,5124,30
55811,478,5404,595,4414,36685,990
55068,4,34,615,30,3425,4
1132,60,2334,1555,1690,20144,644
30013,445,15285,1135,8821,69609,6464
57346,202,3894,552,2951,26020,943
25517,17,332,1229,225,12873,107
5547,325,15024,1510,10281,45842,4743
33465,70,1283,1075,921,33647,362
59435,7,86,486,57,5448,29
23956,244,5663,1263,3788,29430,1875
67484,6,61,237,44,2498,17
57177,12,107,557,87,3717,20
18095,31,2491,1363,1644,18910,847
69741,10,102,162,87,4630,15
41041,9,196,913,166,7078,30
38544,3,176,950,111,6663,65
21446,0,0,1303,0,4826,0
12092,120395,4254304,1453,2119708,7778743,2134596
33861,63,1090,1068,711,15162,379
64812,20,342,315,259,6625,83
64190,25,361,334,261,12757,100
70186,12,220,148,184,2588,36
55502,244,4177,604,3003,26506,1174
29355,238,4268,1148,2562,34599,1706
45058,27,335,857,253,12683,82
39377,1133,8601,938,6496,52310,2105
42895,21,266,883,223,6888,43
27470,137,2629,1185,1669,14669,960
32859,60,1442,1086,982,15798,460
5104,14,753,1516,500,15814,253
29468,167,4142,1146,3028,38387,1114
3809,11802,704434,1532,382426,2352845,322008
40994,35,798,913,633,10350,165
36786,131,1569,998,1367,31834,202
34808,45,998,1046,768,12995,230
28884,131,1936,1157,1268,12070,668
11681,35,787,1457,507,22388,280
24386,62,1187,1253,743,11018,444
15841,0,0,1402,0,6806,0
70514,2,24,137,24,1793,0
52383,11,101,703,67,4523,34
20657,73,3122,1318,2310,54914,812
38077,35,587,962,445,13573,142
31834,10,218,1103,161,5729,57
67980,11,152,221,123,2950,29
14195,155,3346,1424,2193,26652,1153
9607,26,665,1472,468,16263,197
51673,68,880,725,621,11411,259
6732,10,265,1496,199,9695,66
14399,1709,56513,1421,36181,580364,20332
17239,196,3357,1379,2218,23618,1139
28646,8,134,1162,87,6805,47
55486,105,873,604,685,13546,188
36936,18,365,994,336,6855,29
69379,2,101,174,88,2027,13
61808,957,16897,402,12993,64003,3904
1746,62,1661,1551,1079,32869,582
7237,41,1674,1489,1130,27042,544
35060,36,881,1041,614,12226,267
24086,3,164,1259,116,11925,48
7155,300,7588,1490,5028,70067,2560
58345,53,857,522,709,10697,148
6211,4,182,1502,122,12708,60
52869,13,113,685,78,5393,35
1035,58,1955,1556,1388,45172,567
26555,16,766,1205,517,22692,249
56853,3,57,565,41,2556,16
34750,9,263,1048,150,5823,113
56121,69,1078,586,860,12190,218
8384,3,75,1477,53,12632,22
68815,1,61,193,41,3579,20
30654,49,1044,1122,653,13200,391
67537,40,378,235,277,4549,101
34666,2,183,1050,122,7528,61
54467,19,236,636,209,8747,27
10186,376,9007,1468,5606,37196,3401
9900,142,3361,1470,2737,22059,624
52131,35,325,711,226,3150,99
64516,15,207,324,184,4681,23
9455,251,6159,1473,4184,20650,1975
42658,194,2710,886,2028,39602,682
31190,22,403,1113,254,4195,149
68690,25,295,197,233,3985,62
53798,4134,65793,660,50356,242248,15437
24844,137,2682,1242,1817,37904,865
21565,11,381,1301,196,12351,185
29053,9,756,1154,492,8197,264
17093,161,7990,1381,6076,79474,1914
22934,28,562,1281,407,26832,155
25299,18,657,1233,430,13728,227
39167,144,2712,940,2057,56703,655
64502,7,146,324,119,1892,27
67063,401,6149,247,4955,41158,1194
16598,241,8190,1390,4525,25796,3665
11617,1282,22790,1457,15262,68948,7528
27365,730,14922,1188,11125,96155,3797
37113,91,676,988,535,14467,141
41746,2,52,901,39,3920,13
26144,19,517,1215,342,8227,175
60045,11,147,465,93,7795,54
643,50,1909,1559,1327,41130,582
49589,14,241,780,214,8792,27
69050,3,57,185,48,1259,9
68036,22,547,219,433,5959,114
68520,17,217,203,167,6585,50
48157,23,506,820,422,16039,84
24502,10,420,1250,308,15484,112
32029,114,3555,1100,2335,29596,1220
51574,140,3883,728,2736,50592,1147
27452,309,9717,1186,6577,51978,3140
52300,11,117,705,78,3200,39
22997,33,1152,1280,752,12374,400
53648,8,90,664,80,5833,10
68280,0,4,212,4,1534,0
30256,65,1952,1130,1391,18554,561
33956,42,955,1066,719,18439,236
466,125,3934,1561,2735,33513,1199
17598,79,2213,1372,1626,28535,587
39052,6,134,942,111,9148,23
49355,54,331,786,250,3647,81
35471,898,28572,1030,23845,108410,4727
5518,2456,53335,1510,33614,567257,19721
56451,2,133,577,105,4387,28
28163,8,207,1171,170,4545,37
449,7,308,1561,215,24445,93
24541,24,805,1249,548,9378,257
58973,4176,79253,501,65999,335602,13254
62575,94,1038,378,790,9271,248
21514,5,136,1302,93,17474,43
37035,3,248,991,197,9270,51
13386,2417,97465,1436,56626,419797,40839
37275,1,47,983,37,4656,10
11989,122,4670,1454,2668,37256,2002
48008,40,809,822,497,27302,312
50091,53,1481,767,1189,27894,292
15381,215,5418,1409,3866,50106,1552
6363,29,1280,1501,889,26527,391
32107,12,286,1098,198,7811,88
18755,50,807,1351,551,14624,256
68600,3,28,200,27,3767,1
53920,5,51,656,39,5332,12
69262,6,160,178,132,4010,28
25939,13,129,1219,113,4794,16
26328,22,767,1211,445,8471,322
2549,24,942,1544,611,23028,331
64414,5,68,327,59,2698,9
10125,4468,104163,1469,61929,227894,42234
42394,1323,24301,892,18575,82145,5726
30888,209,4701,1118,3237,51022,1464
22982,14,813,1280,523,27596,290
21750,88,2482,1299,1861,31309,621
24490,30,1161,1251,690,10886,471
33447,6,130,1075,113,7486,17
2325,773,24251,1546,15329,67188,8922
36738,3333,90528,999,70419,434039,20109
19059,73,1582,1346,1157,21305,425
11628,291,6848,1457,4530,43674,2318
9138,42,2089,1474,1100,13392,989
5289,18084,725884,1513,439464,1092735,286420
972,51,1760,1557,1126,43513,634
55391,52,528,606,377,15933,151
12604,108,1822,1447,1210,17914,612
13901,745,19569,1429,11219,57931,8350
22409,154,11739,1290,6511,61209,5228
9253,8,489,1474,302,15864,187
31749,36,684,1104,440,15076,244
56701,14,228,569,175,5638,53
37619,12,609,974,451,13172,158
15125,3969,109277,1412,68145,286708,41132
3152,127,3342,1539,2158,18960,1184
2966,155,6069,1540,4039,31469,2030
16839,113,4414,1385,2955,69632,1459
14809,343,9329,1416,6320,76198,3009
64285,39,592,330,458,8716,134
57994,14,127,534,119,4579,8
27828,14,425,1177,215,9729,210
52375,83,983,703,789,23812,194
15894,13,2648,1401,1144,53945,1504
18290,123,3133,1359,2235,44055,898
19743,11,417,1334,301,8979,116
33136,40,1299,1081,829,16394,470
9908,49,1765,1470,1071,14930,694
54629,264,3131,630,2682,35841,449
30285,103,6813,1130,3796,31237,3017
16109,11,458,1397,314,10358,144
29499,9,182,1146,120,14836,62
14963,18,694,1414,453,8627,241
52716,66,718,691,578,12085,140
40779,53,747,917,574,17085,173
15373,1719,129904,1409,82865,470793,47039
9701,407,7064,1471,5018,36613,2046
16804,62,2856,1386,1936,29182,920
3712,41,1743,1533,1304,38421,439
58840,131,2058,505,1579,14160,479
47195,174,1822,832,1339,11896,483
62583,115,1613,378,1190,28571,423
61702,24,271,406,216,5370,55
18107,80,3504,1362,2453,52177,1051
5715,5,143,1508,93,16462,50
25572,46,644,1228,509,9274,135
46406,935,17522,843,12919,178303,4603
65290,7,114,302,93,2686,21
54847,25,226,622,156,4676,70
18964,104,2406,1347,1572,27617,834
8104,32,1675,1478,999,15445,676
28081,219,4027,1172,2854,202638,1173
53754,19142,260732,661,198151,1352748,62581
15601,113,2533,1405,1723,36400,810
22348,14,559,1291,387,15584,172
50389,324,4648,759,3673,50677,975
24007,48,1604,1262,1071,61613,533
26241,256,4603,1213,2790,15011,1813
52333,0,12,705,10,1988,2
41335,2166,46992,907,30894,116173,16098
32115,42,617,1099,412,13189,205
15715,27,1046,1404,791,32749,255
37978,2919,112133,955,77709,495897,34424
26221,23,453,1213,295,7528,158
38818,8,151,944,123,5015,28
53457,54,431,670,320,9958,111
13203,7,333,1439,194,5672,139
31927,863,14174,1102,9030,74249,5144
29434,31,454,1147,340,13496,114
2463,57,2162,1545,1589,48764,573
32442,25,345,1093,241,9328,104
59116,147,1697,497,1351,8528,346
58750,12,235,508,199,10746,36
24959,0,478,1240,324,22104,154
23111,12,200,1278,147,6355,53
69439,17,358,172,321,2485,37
27336,248,4567,1188,3215,65760,1352
34672,270,6105,1048,4830,117918,1275
41615,60,918,904,682,19243,236
33590,296,8251,1073,6001,74679,2250
24758,992,28067,1244,17683,71337,10384
29271,5,207,1149,152,10757,55
55744,12,138,597,92,3654,46
17760,36,1184,1369,759,27111,425
42031,75,1017,897,750,6181,267
22549,5,130,1288,96,6922,34
38165,24,638,960,432,22186,206
6673,28,2205,1496,1483,19791,722
24744,21,658,1244,415,10908,243
39220,47,761,940,633,12619,128
19650,99,2379,1335,1517,27592,862
36159,688,11117,1013,9214,96027,1903
50177,354,4942,765,4083,49915,859
10899,40,1390,1463,755,22109,635
20583,162,3956,1319,2708,30993,1248
37148,21,593,983,432,14974,161
36593,167,3016,999,2393,17069,623
25272,0,81,1233,56,6606,25
10077,8,348,1469,216,9224,132
33664,73,1916,1071,1426,34921,490
26043,47,1059,1217,668,9943,391
7039,86,2255,1492,1640,13500,615
21362,24,1482,1305,937,13884,545
35,671,25036,1567,18488,125968,6548
63938,6,37,342,29,1409,8
21720,21102,359728,1299,255665,805076,104063
21915,5,363,1297,226,16411,137
30662,29,889,1122,589,8268,300
26092,77,2044,1216,1256,10353,788
6592,10,555,1497,374,10011,181
7271,800,16626,1488,10368,74327,6258
33438,49,890,1075,583,27545,307
34053,4,263,1063,159,5690,104
61341,8,83,417,74,4643,9
24742,122,3067,1244,2199,30226,868
38504,16,165,951,151,5318,14
53878,151,5443,653,4289,33377,1154
53035,228,4525,681,3178,48438,1347
62691,122,1782,375,1455,16773,327
66536,451,6100,268,5076,24832,1024
56479,409,2981,576,2684,28161,297
473,25,1324,1561,913,32739,411
65243,103,1621,303,1257,18534,364
17623,1352,34398,1371,20973,97826,13425
17805,3414,74428,1368,44860,239592,29568
13913,259,7698,1429,5335,45529,2363
22527,1,86,1288,59,5315,27
52525,65,1000,697,857,12067,143
61377,862,17149,416,12631,127766,4518
53651,22,235,664,151,6878,84
22721,13,740,1284,447,10182,293
65799,11,123,290,95,1834,28
5820,13,747,1507,578,10520,169
55936,66,536,592,416,9396,120
61671,2,25,407,18,3088,7
53882,81,1276,657,880,22677,396
35883,6,77,1021,54,7768,23
50115,1065,16730,766,13279,132247,3451
31714,28,459,1105,310,5974,149
52860,40,418,686,286,7668,132
41731,4674,70478,902,55567,312891,14911
10643,54,1793,1465,1172,23739,621
19971,118,2996,1330,2254,22195,742
57743,102,1629,542,1323,21753,306
24132,15,809,1259,528,10130,281
10624,14,663,1466,396,23891,267
27804,27,595,1178,486,8604,109
5021,25,1052,1517,696,22533,356
5526,871,38204,1510,23887,194338,14317
62576,40,459,378,340,7061,119
12050,244,8021,1453,5179,140323,2842
70028,31,369,153,324,3625,45
40502,58,1096,922,857,12557,239
10536,4,133,1466,90,8121,43
56318,61,612,580,497,4777,115
34158,3,138,1061,94,6759,44
68051,15,169,219,139,7048,30
19764,7,284,1333,185,8001,99
14430,101,1797,1421,1300,25869,497
51464,39,827,731,706,9036,121
53246,189,1656,674,1538,11120,118
14507,145,4597,1420,2538,23992,2059
20781,23596,990438,1316,671501,3198490,318937
2521,19,712,1545,517,43882,195
31774,367,7148,1104,4722,37938,2426
17702,150,6451,1370,4807,57727,1644
15812,353,9122,1402,6222,95816,2900
3563,26602,1580250,1535,896126,3531322,684124
11940,15,794,1454,474,24611,320
55786,295,5297,596,4578,45580,719
52975,18,260,682,208,5425,52
15204,49,1415,1411,958,20048,457
53867,10001,156098,656,123747,936089,32351
31542,23,520,1108,434,13017,86
21453,151,3542,1303,2633,67550,909
28158,31,1407,1171,855,21183,552
29455,5,225,1146,140,7634,85
16171,92,3199,1396,2026,58121,1173
53851,44,545,658,478,8172,67
62499,13,120,381,97,3456,23
51696,316,4127,725,3374,24370,753
63226,53,674,362,559,15164,115
51727,280,3243,724,2501,21008,742
4413,65,2727,1525,1892,56915,835
23556,11,491,1270,262,4810,229
8339,361,10735,1478,7076,31721,3659
41129,54,893,911,665,9050,228
70321,43,1171,143,1012,12873,159
67745,22,518,229,382,13845,136
14836,12,361,1416,261,14189,100
6454,4,356,1499,235,34583,121
63139,6,54,364,43,5326,11
25806,125,3488,1222,2121,15003,1367
65322,31,364,301,328,8817,36
16414,339,13969,1392,8924,180095,5045
11265,56,2337,1461,1433,23007,904
51141,11,315,740,246,10063,69
11610,80,2375,1458,1394,54218,981
50153,16,309,766,237,9003,72
35770,3736,64161,1024,44730,357775,19431
21657,79,2313,1300,1466,25108,847
69319,10,65,176,63,3938,2
65539,4,87,296,71,4844,16
28941,2115,60233,1156,39139,324652,21094
27807,180,5054,1178,3115,46285,1939
9081,40,713,1474,478,23650,235
28894,34,1167,1157,734,10185,433
18510,6,156,1355,100,3381,56
10474,273,11350,1466,6953,70246,4397
13443,137,5278,1435,2833,34924,2445
22693,6,381,1285,256,16558,125
49888,695,9041,772,6590,38115,2451
17992,123,3096,1364,2255,40959,841
7069,203,2746,1491,2049,18400,697
45585,280,3582,852,2634,40130,948
33925,91,2190,1067,1586,55325,604
9118,1280,61820,1474,38777,335842,23043
11945,510,10440,1454,6308,88119,4132
18571,30,408,1354,310,16733,98
24104,43,422,1259,306,6689,116
49326,23,279,751,239,19169,40
47101,98,1260,833,1033,12510,227
31943,45,1682,1102,1100,20577,582
31765,33,1605,1104,1079,17646,526
35943,483,11678,1019,8893,116928,2785
9897,909,71666,1470,39377,198056,32289
33521,1131,18907,1074,13367,89536,5540
39334,4,96,938,81,5411,15
35269,6,109,1035,83,3392,26
23888,88,3166,1264,1983,20067,1183
7021,47,1865,1492,1181,33023,684
34948,325,4910,1043,3721,44187,1189
49066,6,60,795,48,4482,12
57615,53,909,546,712,11205,197
28407,11,181,1166,147,5974,34
65578,51,701,156,672,3669,29
36730,2,126,999,91,8928,35
22860,1,45,1282,35,2282,10
59110,126,1520,497,1190,16250,330
22915,20,955,1281,661,33305,294
49974,615,10203,770,8346,118486,1857
33559,179,3802,1073,2537,27007,1265
23366,75,4772,1274,3399,34762,1373
9396,52,1436,1473,883,32348,553
29352,16,539,1148,373,13650,166
66445,6,150,271,97,4130,53
57792,128,1925,540,1497,12890,428
63559,1178,17119,354,14158,123612,2961
46699,514,10445,837,8846,124039,1599
56941,30,505,562,383,9177,122
29541,131,2136,1145,1550,8992,586
4616,26,641,1522,451,7927,190
69420,59,475,166,400,5325,75
54445,226,4255,637,3387,34845,868
58870,28,254,504,202,8658,52
43932,51,489,870,407,15703,82
9262,751,20464,1474,13015,143027,7449
16770,28,1073,1386,781,23387,292
15799,427,6956,1402,4700,55269,2256
70408,2,47,140,43,4613,4
49269,596,11675,789,9741,56924,1934
2069,228,13781,1548,9947,102847,3834
34140,11,240,1062,148,2689,92
18740,220,8403,1351,5495,29747,2908
48772,8,394,804,315,3276,79
29917,29,795,1137,659,21815,136
20378,15,710,1323,505,25095,205
67838,26,688,225,546,7951,142
200,50,4852,1564,3279,35993,1573
35717,20557,430274,1025,270132,1054894,160142
28899,16231,362104,1157,221137,1088638,140967
35587,26,729,1028,581,24181,148
43647,49,394,873,296,5075,98
20936,23,499,1313,364,14306,135
68931,17,320,189,249,1979,71
32272,20,596,1097,379,5424,217
63185,1,36,363,25,3822,11
54124,244,3403,648,2663,31712,740
20549,17,1574,1320,1145,19845,429
52694,5675,87737,676,68837,260265,18900
21852,77,1074,1298,714,12580,360
36432,11,343,1005,274,10598,69
12507,141,3458,1448,1909,43468,1549
21820,2,97,1298,57,13960,40
45874,5,132,849,95,4618,37
49482,645,8372,782,7191,80190,1181
15316,145,2342,1410,1590,18831,752
53786,26,352,660,285,15605,67
44661,20,374,862,287,11693,87
37329,15,158,982,117,7062,41
68213,15,169,214,140,3100,29
32537,96,3695,1092,2536,26741,1159
69377,33,379,174,340,5686,39
27532,15,305,1184,270,10317,35
56406,5,92,578,73,4653,19
28649,150,3437,1161,2096,17924,1341
27505,407,17494,1184,9363,123008,8131
25636,714,23139,1226,14132,200276,9007
32871,77,1567,1086,1133,16914,434
18196,141,8645,1361,5873,89454,2772
54982,452,4546,585,3566,35668,980
59681,2,49,477,38,5409,11
9805,289,12639,1471,8108,45162,4531
7473,70,3008,1486,1858,57008,1150
42786,26,384,885,315,16795,69
27195,15,732,1191,438,10617,294
68415,4,104,207,75,3084,29
56922,2648,29715,563,22287,123300,7428
57853,10,188,537,126,5491,62
19083,8,632,1345,476,20502,156
37673,1136,40364,973,28756,134801,11608
67716,10,171,230,133,7355,38
39096,21,565,941,443,12285,122
10022,35,1565,1469,1066,60852,499
16840,8,280,1385,206,16019,74
15810,629,22409,1402,15499,364703,6910
51503,4,75,730,61,8054,14
8422,170,8185,1477,5218,67373,2967
55802,97,1705,596,1369,22262,336
12973,15,1149,1442,588,17161,561
48877,38,411,801,321,19369,90
12616,20,1590,1447,941,32170,649
24659,369,5172,1246,3499,50091,1673
24800,60,1746,1243,1199,19579,547
3797,108,2292,1532,1624,14328,668
16427,7,277,1392,183,11129,94
33114,23,307,1082,197,5061,110
34396,141,2060,1056,1548,25886,512
60795,11,109,437,84,3351,25
3359,127,5256,1537,3466,75315,1790
32109,12,226,1099,183,5712,43
12744,272,8363,1445,6191,55820,2172
53259,2,76,675,62,2902,14
35844,7,138,1022,98,4633,40
8307,18,969,1478,627,20639,342
31528,31,905,1108,526,14612,379
65416,191,5408,299,4406,36031,1002
22081,5,236,1294,164,8554,72
54862,118,891,621,722,11068,169
57310,444,5706,553,4440,41100,1266
35832,40,585,1022,413,6252,172
9750,4,319,1471,209,8231,110
33252,128,3940,1079,2680,49446,1260
62493,3037,58044,375,41819,248137,16225
24904,59,1647,1241,1155,24062,492
62106,57,862,392,657,22033,205
10085,305,6635,1469,4012,43206,2623
43545,179,2257,874,1767,18557,490
11856,23,1126,1455,462,9247,664
59933,49,934,468,785,7849,149
33319,72,1805,1070,1050,11741,755
9525,8,354,1472,203,4219,151
12560,36,1697,1447,824,18069,873
14373,44,1181,1422,840,21314,341
23446,17,617,1272,448,10476,169
36277,3416,96171,1009,79165,417878,17006
32456,58,1512,1082,982,16740,530
24415,161,4450,1252,2951,25811,1499
20620,262,3956,1319,2626,17862,1330
23910,11,180,1264,128,11971,52
44441,87,1077,864,934,17118,143
34962,20,819,1043,547,13882,272
62216,13,164,389,135,5942,29
57374,41,553,552,475,17162,78
57578,4223,80266,541,60863,159127,19403
33718,1151,25045,1070,14685,87704,10360
37775,57,865,970,621,9981,244
24499,39,968,1250,773,23931,195
28551,562,14427,1164,9994,73692,4433
35787,2,83,1023,65,6481,18
62606,50,658,370,584,13137,74
12377,283,8911,1450,5124,112009,3787
11658,38,886,1457,442,5847,444
32426,226,3323,1094,2576,25525,747
1701,236,7886,1551,5363,87530,2523
36006,10716,247580,1018,182770,1012577,64810
46485,5,98,841,78,6299,20
1038,24,1496,1556,1041,40441,455
57746,69,740,542,622,9858,118
36261,33,258,1011,190,2875,68
15817,7,141,1402,105,17295,36
33810,396,13809,1069,9410,61114,4399
6840,109,5067,1494,3276,81396,1791
9328,23,1090,1473,672,16708,418
59881,9,70,470,63,4134,7
66401,0,39,272,25,1941,14
63001,22,317,368,230,5171,87
10183,17,637,1468,442,10868,195
53947,49,1024,655,695,6756,329
66643,24,417,265,360,7037,57
13239,552,14628,1438,9357,65499,5271
56649,66,948,571,585,9360,363
61569,411,8962,410,6270,39536,2692
62918,191,1632,369,1273,13068,359
6157,306,6943,1503,4671,100731,2272
37917,142,3001,967,2289,30542,712
33081,105,2504,1082,1851,62331,653
7731,9,303,1482,204,11123,99
48844,107,1510,802,1224,17584,286
69412,77,1319,173,1222,12038,97
49234,30,419,790,319,8581,100
24338,35,801,1254,507,7457,294
66531,17,188,268,132,17701,56
35899,1499,35382,1021,27100,195556,8282
51506,38,463,730,403,14369,60
54650,684,10693,629,7883,79427,2810
68846,68,775,191,648,18678,127
2523,364,8235,1545,4851,23900,3384
60445,6791,120154,450,93918,352388,26236
1560,1733,34890,1552,21975,168433,12915
18892,0,14,1349,12,2675,2
34586,18,286,1053,213,5816,73
65801,31,255,289,188,7021,67
39,119,6477,1566,4576,102414,1901
27757,7,258,1179,160,9344,98
3173,17,724,1539,508,21834,216
52748,181,3538,690,2668,29008,870
8937,173,2353,1475,1562,25937,791
68294,4,102,211,75,4867,27
6184,59,1747,1503,1151,9982,596
23779,257,6870,1266,4292,74346,2578
8852,59,1669,1475,987,24862,682
36795,103,1948,998,1681,27875,267
41693,14,338,902,272,7413,66
48463,67,1275,811,961,37027,314
49000,15,258,797,185,4899,73
13677,21,808,1432,484,13929,324
28149,22,522,1171,406,6671,116
18085,5,234,1363,165,4301,69
15645,14,489,1405,350,17270,139
18024,1528,16713,1364,11987,59487,4726
48897,28,579,800,406,5602,173
12127,0,0,1453,0,9013,0
56123,31,356,586,294,5458,62
304,15,621,1562,453,17216,168
59030,29,466,499,376,6317,90
14129,85,1811,1425,1470,11649,341
42815,738,10560,884,7949,45615,2611
46756,34,411,837,351,9408,60
15898,22,889,1400,634,13749,255
33091,185,10994,1082,7731,41935,3263
8819,106,1915,1475,1237,16583,678
1897,2,233,1550,144,7933,89
13890,28,1833,1429,1193,41918,640
69424,22,472,173,396,3260,76
28445,113,2542,1166,1527,8017,1015
13045,17,1393,1441,670,15586,723
31772,80,1432,1104,1128,39908,304
2918,34,703,1541,509,17188,194
49895,0,2336,772,1245,10104,1091
35635,148,2287,1027,1733,37582,554
15340,32,743,1409,538,12737,205
62651,4,60,376,42,3252,18
48812,58,1802,803,1478,19588,324
54213,26,168,645,131,15246,37
42288,2,67,894,40,3685,27
59364,60,646,488,497,15784,149
9347,4,194,1473,117,7737,77
35853,16,312,1017,241,5382,71
9288,373,9409,1474,6756,58673,2653
61043,7,66,428,52,3789,14
42758,102,1898,883,1565,33439,333
31615,26,681,1106,397,5702,284
57201,67,878,556,677,8614,201
3226,349,30233,1538,19540,129981,10693
48573,354,4978,810,3846,64768,1132
58521,325,2776,515,2263,21111,513
16237,745,39647,1395,25548,179496,14099
45477,386,3949,853,2891,29458,1058
26539,124,2936,1206,1960,39124,976
67788,31,467,227,398,6986,69
50416,4338,87889,759,65261,398387,22628
69016,2,6,186,5,658,1
4578,117,4018,1523,2522,18664,1496
55550,6,64,602,51,6832,13
69072,2,41,184,35,1470,6
27513,5,177,1184,119,3283,58
33517,2,122,1074,70,7249,52
50694,71,1410,752,1193,28059,217
55047,72,1028,616,728,24095,300
21335,85,2620,1305,1890,53091,730
53808,29,356,660,304,11911,52
21726,48,1012,1299,684,11186,328
23593,345,12112,1270,8625,76501,3487
56252,32,240,580,207,6001,33
9807,219,3735,1471,2075,41453,1660
36473,24,659,1004,578,25032,81
6195,9,955,1503,607,10041,348
59549,31,459,482,334,7638,125
35354,61,1850,1033,1496,13287,354
1085,36,1623,1556,1144,39004,479
58745,144,2393,508,1768,20376,625
10603,14,551,1466,365,26401,186
54799,12,116,624,95,5396,21
58074,139,1613,531,1248,21079,365
21218,30,1283,1307,749,9067,534
51044,53,390,743,307,8656,83
26292,1,36,1212,30,6084,6
61381,78,843,416,595,5805,248
60605,22,175,444,132,4453,43
53126,618,6098,677,4987,43770,1111
66682,32,545,263,439,8330,106
6359,14,602,1501,442,20260,160
15460,37,548,1407,359,7585,189
36902,64,921,995,737,12776,184
5460,111,7080,1511,4657,65145,2423
58181,84,903,527,687,28418,216
27345,216,2223,1188,1495,23278,728
36062,61,1085,1016,807,6646,278
30782,0,0,1119,0,10498,0
12108,144,2866,1453,1808,19108,1058
12015,1628,60905,1454,34293,319056,26612
29023,47,1407,1154,909,42659,498
64003,19,345,340,293,11915,52
4232,627,21194,1528,14218,139922,6976
19468,93,3373,1339,2346,20918,1027
63853,1,32,345,24,3446,8
7225,29,1032,1489,656,17418,376
68056,79,1274,218,1046,13622,228
16532,587,27930,1390,18125,249266,9805
27105,37,2296,1193,1303,19192,993
26210,27,720,1214,440,10708,280
12087,102,5647,1453,3990,38846,1657
15722,70,2097,1404,1465,23440,632
1250,25,738,1555,562,21818,176
63180,27,421,363,334,5821,87
58418,3893,85980,509,63231,328093,22749
37600,3,126,975,97,5159,29
310,204,5180,1562,3159,40083,2021
19836,78,1520,1332,906,36418,614
5981,13,319,1505,208,9496,111
7678,52,1444,1483,956,28954,488
17888,4,109,1366,79,4118,30
33519,74,1703,1074,1062,13841,641
32214,145,2363,1098,1510,14329,853
66858,24,404,257,325,11250,79
52115,7245,118367,711,94299,572101,24068
47548,20,325,827,262,5235,63
6623,118,7518,1497,5133,87320,2385
30998,272,3782,1116,2623,26177,1159
37342,0,0,965,0,5396,0
10248,7,460,1468,290,7443,170
63752,24,388,348,329,8738,59
66235,7,218,277,161,9373,57
49087,160,2345,794,1944,19856,401
2263,5,168,1547,118,19606,50
50263,440,4770,762,3766,41363,1004
63473,9592,172704,355,117949,651947,54755
68719,88,1242,196,1048,14034,194
37067,11,190,990,138,4119,52
21009,260,8986,1311,6074,100478,2912
67344,336,5297,241,4526,74108,771
10850,20,1330,1464,693,17085,637
16119,4,106,1397,82,10298,24
66322,15,179,275,145,9875,34
68003,1,12,220,10,1031,2
56948,5,102,562,73,6528,29
32562,161,1989,1083,1389,48638,600
25723,0,55,1224,35,4371,20
22595,21,633,1287,441,31022,192
41354,30,372,908,287,8096,85
8581,7,339,1477,226,5469,113
5321,0,11680,1513,6852,53114,4828
58338,2385,81185,522,61766,395859,19419
36481,254,3577,1004,2973,55854,604
35493,9,170,1030,142,2907,28
14868,1,74,1416,46,7297,28
59008,18,115,500,81,3590,34
29262,4,209,1150,128,14449,81
3613,248,14663,1535,8883,138990,5780
56671,12,233,570,181,9237,52
8638,87,3026,1476,2154,20406,872
9678,6,233,1472,151,14427,82
34048,10,436,1063,271,7661,165
13775,0,0,1431,0,13799,0
68683,2557,51735,197,43432,255947,8303
10988,66,2272,1463,1428,63545,844
36932,13,290,994,235,4360,55
49007,144,1920,797,1507,13963,413
56931,552,9260,563,7285,58987,1975
23152,2,132,1277,90,4251,42
57013,7,199,561,162,4115,37
33602,3610,102495,1072,74573,408940,27922
27222,111,2680,1191,1643,24382,1037
18888,39,1803,1349,1275,36540,528
30827,6,397,1119,234,4745,163
22643,120,1799,1286,1244,38555,555
35898,0,0,1021,0,5046,0
21723,596,14519,1299,9081,91105,5438
53879,1895,35554,657,26305,96707,9249
42504,7,215,890,189,7422,26
38982,484,9890,943,7402,95475,2488
43087,24,242,880,206,6133,36
60819,46,1115,382,860,25776,255
57636,26,368,545,249,4540,119
9816,1,55,1471,48,8631,7
33210,343,4152,1080,2961,30032,1191
26982,4,104,1196,78,4163,26
57558,33,633,547,546,16491,87
38412,77,1241,953,1032,15678,209
65622,18,345,294,281,7267,64
66288,28,172,275,151,3931,21
27,86,4912,1567,4159,102195,753
64437,13,154,326,132,6217,22
24592,333,5255,1248,4188,33574,1067
5721,19,726,1508,550,10833,176
68723,4,82,196,72,10399,10
11928,360,10867,1454,6806,94454,4061
15177,23,473,1411,327,9208,146
8522,58,2248,1477,1508,32688,740
42656,4265,137290,887,102840,373554,34450
20133,237,5927,1327,3384,48093,2543
52813,67,888,687,745,8029,143
16707,41,581,1388,440,5559,141
15053,8,533,1413,361,55650,172
57639,64,1063,545,771,8259,292
3215,15,729,1538,505,18795,224
30302,44,1335,1129,912,18418,423
37746,2152,39342,971,30441,344450,8901
17923,140,3550,1365,2544,20871,1006
27715,14,323,1180,215,5922,108
27216,137,1944,1191,1215,14841,729
14475,778,17787,1420,14062,139254,3725
34176,7,62,1061,55,3533,7
15781,118,3918,1403,2652,54593,1266
68956,0,18,188,16,533,2
35905,44,950,1021,693,5503,257
49679,17,358,778,271,14399,87
13191,21,1104,1439,704,16026,400
10814,34,2370,1464,1518,56101,852
38775,8,183,945,163,15663,20
29713,15,310,1142,204,3919,106
13494,24,1600,1434,889,12344,711
7716,3677,147999,1483,87355,452833,60644
13148,437,22220,1439,12423,127146,9797
1251,40,1521,1555,1011,12606,510
12549,1872,160625,1447,90899,511384,69726
17606,5,304,1372,241,21855,63
16782,884,22438,1386,16877,125294,5561
12935,178,6861,1442,4135,29465,2726
18695,44,1064,1352,769,18340,295
25273,0,676,1233,491,8210,185
1454,30,1561,1553,1047,13608,514
13730,827,39492,1431,22290,211409,17202
1334,74169,1798360,1554,1336876,4247395,461484
68499,6,90,204,69,6967,21
4773,40,1188,1520,841,58009,347
53847,172,1296,658,993,11410,303
4811,49,2041,1519,1467,33658,574
21812,474,10561,1298,7217,40720,3344
26087,637,12200,1216,7708,32789,4492
18217,43,1725,1360,1379,23417,346
12458,163,12148,1449,6975,104397,5173
68196,533,5197,215,4019,21667,1178
6336,18,446,1501,311,17531,135
63821,1188,15051,346,12393,60670,2658
63164,77,767,363,661,14616,106
58704,6917,122361,504,90712,438902,31649
13813,11,381,1430,234,18355,147
33109,7,194,1082,153,16108,41
50941,1424,22887,746,16383,101300,6504
46631,2,85,839,64,3886,21
61723,263,4383,406,3588,52587,795
20505,29,774,1321,464,22223,310
28145,10,255,1171,159,7754,96
34625,2,131,1051,94,9624,37
21560,6,1132,1301,821,18876,311
20681,1118,28336,1318,17224,197778,11112
47871,6,113,824,82,3655,31
6879,47,3197,1494,2334,29263,863
69491,64,646,171,582,9337,64
11093,13,631,1462,344,5669,287
26439,30,635,1208,379,11896,256
17914,906,18210,1365,13754,192459,4456
66692,1,21,263,19,2076,2
63570,7,37,353,35,2746,2
10610,282,10050,1466,6568,95876,3482
57159,2688,44674,554,33560,215515,11114
61291,20,251,418,188,3470,63
34525,18,417,1054,276,11425,141
30579,13,380,1124,250,12672,130
23971,1040,13602,1262,9282,69711,4320
29054,43,564,1154,391,6383,173
62219,4,110,389,84,4735,26
26816,99,2898,1199,1961,19158,937
36770,101,1088,998,877,15944,211
46320,798,24081,843,18719,129801,5362
668,9,380,1559,266,14069,114
62721,42,384,374,288,7060,96
15797,720,25553,1402,16688,112501,8865
17733,92,3289,1369,2348,54899,941
62887,18,218,370,186,8005,32
55169,54,919,613,614,14603,305
28788,2339,70941,1159,45423,434789,25518
70190,45,398,147,358,3014,40
26478,13,221,1208,176,16525,45
31491,1004,12379,1109,8586,59808,3793
22664,23,562,1285,411,11515,151
64209,4,43,333,29,2976,14
3046,19,916,1540,630,32997,286
42829,25,475,884,319,12217,156
68082,13,435,218,276,8852,159
62489,394,8793,381,6317,71856,2476
26909,899,29970,1197,20844,175844,9126
1658,122,2590,1552,1846,20588,744
18144,8,352,1362,227,14267,125
5236,25,2403,1514,1577,28214,826
1418,298,8907,1553,6350,129504,2557
65900,103,1748,287,1497,34956,251
55746,0,0,597,0,3097,0
34083,1093,16734,1063,12577,167067,4157
50909,38,538,747,390,9493,148
31020,29,1154,1115,675,14375,479
59502,25,279,483,204,13521,75
25051,83,1912,1238,1316,27690,596
34716,7,440,1048,269,8255,171
64273,64,1240,331,1075,9142,165
69323,16,228,176,188,3378,40
63314,86,1436,318,1140,7141,296
9765,29,713,1471,452,15272,261
63801,186,2944,347,2451,34123,493
37515,180,2980,977,2172,21558,808
33939,10230,287063,1047,216017,961587,71046
15651,12,312,1405,250,23737,62
28689,84,1657,1161,1018,17108,639
33933,31,364,1066,272,17054,92
51109,3,54,741,40,2411,14
9687,650,15759,1471,9339,58171,6420
64215,560,8701,311,6412,77953,2289
69924,5,121,156,103,2895,18
2663,49,2747,1544,1872,27419,875
49811,21,402,774,299,7718,103
20521,706,30678,1320,19534,157679,11144
63218,153,2131,362,1583,15852,548
19126,22,1543,1344,1094,39863,449
70037,14,331,152,280,3886,51
18067,12,969,1363,685,12557,284
54483,210,2898,636,2350,25825,548
45355,116,1318,854,948,11806,370
8309,154,5571,1478,3593,35669,1978
36736,9,359,999,282,22284,77
38374,924,13829,955,10974,61789,2855
3994,402,11969,1530,7581,129669,4388
51262,57,331,737,254,4391,77
32342,58,1320,1096,887,16388,433
635,199,6829,1559,4884,74700,1945
63081,18,310,365,271,11562,39
70464,52,469,138,453,7381,16
42124,3,161,895,65,3155,96
64921,3,55,312,44,3042,11
55144,683,12151,613,10045,73739,2106
64487,2,37,325,33,2707,4
42634,13,146,887,106,7540,40
27277,882,12669,1190,8781,42345,3888
51462,1874,23823,732,19811,77059,4012
67341,15,279,241,186,4719,93
28148,19,820,1171,548,10350,272
4277,461,21877,1527,12971,72628,8906
66794,0,273,260,192,7114,81
21705,3713,103796,1299,63843,588964,39953
14320,3171,80361,1422,56765,277631,23596
65038,37,410,307,308,6005,102
40882,19,447,916,358,8365,89
29293,3,230,1149,124,3690,106
59102,8,59,497,46,2607,13
2782,3354,98055,1543,53134,164659,44921
16661,20,704,1389,459,11680,245
37947,32,330,966,256,5419,74
22334,6,325,1291,241,17721,84
10789,4480,135369,1464,69558,382560,65811
22739,6,259,1284,189,13591,70
62941,503,11476,369,9301,80197,2175
16054,25,834,1398,567,9836,267
38537,53,721,950,576,14151,145
2856,368,10527,1542,7801,79570,2726
35115,227,3613,1039,2812,59933,801
53739,59,784,662,632,13068,152
35218,4,93,1036,82,2398,11
25195,132,4291,1235,2778,27098,1513
41452,134,2985,907,2145,14722,840
50297,0,45,762,37,2833,8
17910,16,1049,1365,849,9734,200
19556,1635,39385,1337,27495,119570,11890
52642,44,691,693,613,17915,78
27818,5,184,1178,98,12793,86
34234,991,13705,1060,10144,56543,3561
33101,229,5425,1082,3856,53266,1569
61255,6967,158238,419,118266,436162,39972
31293,262,2685,1111,1666,19908,1019
49789,380,9246,775,6995,111568,2251
66688,131,2747,263,2219,22213,528
49832,43,934,774,820,19006,114
38220,10,300,959,213,6552,87
64073,16,183,337,143,3714,40
16541,4899,147036,1390,97523,457531,49513
21950,25,437,1296,309,4869,128
1592,31,1263,1552,900,45667,363
5865,656,15735,1507,10310,180314,5425
22444,29,383,1289,319,6559,64
23082,5,235,1278,159,15788,76
16662,16,577,1389,387,11218,190
34961,249,4352,1043,3128,22192,1224
39952,11,353,930,271,4576,82
31446,2,111,1107,73,2509,38
56811,26,241,566,196,5292,45
42660,9,385,887,259,9098,126
15713,17,364,1404,244,5184,120
48983,14,281,798,205,5488,76
67385,36,736,240,624,10683,112
9685,34,998,1471,688,14218,310
63256,1,34,361,26,3711,8
68876,341,7317,190,5786,39644,1531
2760,20,935,1543,657,20918,278
58787,226,4112,507,3169,81744,943
5602,17,874,1510,565,21175,309
50191,39,453,765,313,17618,140
66882,66,1894,256,1606,11245,288
33316,66,1420,1078,1301,30587,119
59765,31,705,474,509,15410,196
69369,9,67,174,52,2022,15
34170,777,23780,1061,19007,134381,4773
5005,15,498,1517,344,26052,154
54558,29,326,633,268,4335,58
44302,65,930,866,671,17584,259
31463,506,7591,1109,4794,32594,2797
6487,147,4001,1499,2738,55373,1263
46182,22,428,845,305,8447,123
62600,1,53,378,26,2098,27
59552,460,5038,482,3785,41112,1253
4372,4,640,1526,454,6527,186
64141,290,4672,335,3432,31030,1240
26382,1345,31855,1209,22436,252262,9419
53884,94,836,657,691,9471,145
18522,44,2168,1355,1516,17472,652
30779,4,191,1120,101,4863,90
25459,1032,23665,1230,17727,84997,5938
58119,55,647,529,539,10357,108
16681,844,25383,1388,15926,288077,9457
30368,1887,33157,1128,24503,177185,8654
9887,1017,31944,1470,22185,162195,9759
1041,1837,47993,1556,29447,220808,18546
13529,4021,82934,1434,61360,348942,21574
38507,1725,32931,935,24701,80629,8230
69786,1,59,161,37,2662,22
23785,361,7684,1266,5233,46639,2451
11157,403,14222,1461,8478,52162,5744
17254,105,3566,1378,2543,31967,1023
33798,61,1122,1069,814,23072,308
28563,37,842,1163,550,31895,292
13388,4,301,1436,166,12407,135
20568,7,378,1320,264,14747,114
29006,1442,35505,1155,24850,183498,10655
19545,295,5147,1337,3170,23907,1977
23883,1677,40182,1264,26122,258633,14060
11768,153,5209,1456,2554,95695,2655
49487,73,734,783,586,24284,148
38851,48,1454,944,1187,24683,267
18231,144,3455,1360,2764,39276,691
57188,11,123,556,84,5612,39
517,26,761,1560,455,21943,306
2989,6,136,1540,105,16088,31
25773,128,2772,1223,1783,13974,989
10343,556,18745,1467,12633,161408,6112
1495,295,17352,1553,11445,89996,5907
16985,413,5688,1383,4879,33325,809
56954,490,11670,561,8687,39024,2983
20826,1,46,1315,40,2794,6
63133,19,176,364,144,4304,32
16181,295,6282,1396,4377,51344,1905
5470,7,104,1511,75,25432,29
4259,8704,423384,1527,244967,531350,178417
10885,39,899,1463,612,16126,287
16908,32,1413,1384,1068,45068,345
22307,5045,144185,1292,78346,303446,65839
14255,4,66,1423,46,3421,20
30615,29,867,1123,487,9537,380
20424,28,912,1322,593,13837,319
33856,49,602,1068,369,6288,233
61940,516,13522,398,9966,100500,3556
49013,66,1429,797,1219,17166,210
57251,39,701,555,486,13043,215
34952,12,397,1043,227,9752,170
31214,23,770,1112,477,6792,293
60111,1513,27849,463,22457,104032,5392
60307,59,520,455,402,5460,118
713,13,470,1559,329,25349,141
67386,30,579,240,425,9833,154
65298,67,805,302,710,7359,95
20052,381,11298,1328,6838,34776,4460
31427,54,1084,1109,644,10660,440
61332,686,8606,417,7127,47071,1479
27080,15,119,1194,83,16598,36
5606,76,2458,1510,1562,16028,896
11967,57,1266,1454,534,16382,732
62278,21,225,387,181,2524,44
12955,298,12947,1442,7739,86888,5208
17991,47,1726,1364,1242,42195,484
36293,14,311,1010,247,13458,64
2318,286,9646,1546,6531,82733,3115
1953,96,2502,1549,1797,17805,705
46911,54,1107,836,849,10387,258
11978,23,1209,1454,627,11921,582
26745,0,0,1201,0,8154,0
56202,47,720,584,560,8467,160
58017,2,30,533,24,3957,6
17276,239,4507,1378,3368,45003,1139
61333,52,548,417,434,6569,114
67115,7,126,249,85,5007,41
63624,5,181,347,98,7592,83
9057,29,1785,1474,1112,16520,673
55994,284,5012,590,4088,22503,924
34393,36,989,1057,756,20269,233
33787,607,12520,1069,9326,69879,3194
3717,382,17501,1533,11254,92721,6247
13888,671,19620,1429,12025,136660,7595
37422,4679,66733,980,54731,314454,12002
59356,93,1397,488,1207,18622,190
7728,113,1803,1482,1047,13625,756
47907,16,139,823,111,4285,28
8361,8373,158305,1477,101803,525745,56502
33351,41,737,1077,486,8540,251
9996,28,1388,1469,857,36454,531
5921,30,1086,1506,777,76187,309
67465,15,139,238,113,2525,26
62678,47,508,375,357,6723,151
32895,1658,33141,1085,22688,79441,10453
34723,647,7161,1048,5300,51076,1861
60843,17,165,435,135,5127,30
52936,92,1392,684,1091,13577,301
19048,29,1571,1346,1080,32509,491
58902,6,56,503,40,7507,16
65270,1,25,302,19,1799,6
34244,51,781,1060,554,9286,227
46843,13,113,837,84,5033,29
56563,20,380,573,291,11621,89
27360,4,187,1188,120,2497,67
68147,6,37,216,25,3689,12
18621,0,0,1354,0,12917,0
50892,3300,65708,747,46638,286823,19070
54332,145,1869,642,1550,18434,319
61430,676,9345,415,7291,38847,2054
9208,157,6011,1474,3708,49435,2303
9469,50,604,1473,496,6895,108
3980,59,3428,1530,2572,38906,856
4438,364,9014,1525,6226,39378,2788
24522,2877,52156,1250,37416,271769,14740
25962,76,1636,1219,1239,30505,397
8135,60,1718,1478,1175,21419,543
15335,534,12071,1409,6779,73457,5292
33932,18,1075,1066,667,9655,408
62192,312,2319,389,1960,22267,359
36515,19,380,1002,323,14615,57
769,11047,351043,1558,210089,958824,140954
32636,18,518,1090,326,10386,192
58649,99,897,511,726,12581,171
51623,160,1694,719,1291,17376,403
27710,312,4440,1180,2946,17682,1494
61103,64,714,425,600,9999,114
53101,51,396,678,334,9690,62
13552,259,8429,1433,4955,78436,3474
56719,22,283,569,212,4697,71
55124,95,1839,599,1372,23858,467
7730,116,2032,1482,1318,37451,714
441,697,24966,1561,15823,117714,9143
24964,15,509,1240,344,6678,165
33780,125,2080,1069,1459,25742,621
52039,52,690,715,484,14737,206
66032,11,84,283,66,3498,18
54107,45,431,649,275,8901,156
61663,26,189,407,171,4092,18
23479,30,689,1272,504,25314,185
31407,34,949,1110,653,24429,296
3821,107,5108,1532,3456,41789,1652
5913,9,140,1506,110,4126,30
21554,8,155,1302,139,7788,16
26400,36,1874,1209,1126,33236,748
1586,26,1458,1552,1020,20994,438
65313,5,105,295,91,2362,14
64556,6,140,323,112,2859,28
40775,259,3695,917,2990,40218,705
34993,177,6146,1042,4359,76606,1787
36232,47,587,1011,469,7095,118
32552,28,786,1091,474,4407,312
9463,784,26549,1473,16759,130736,9790
42300,125,6137,893,5072,35661,1065
65162,102,1208,305,1011,13553,197
62014,30,614,395,458,5234,156
49883,23,490,772,397,8869,93
20598,14,463,1319,304,5633,159
63966,27,423,341,327,10403,96
24188,26,1081,1257,727,14930,354
52742,493,6432,690,5289,51067,1143
52008,9,213,716,165,5136,48
54336,28,262,641,203,9214,59
69148,20,440,181,366,5038,74
60437,15,161,451,120,4980,41
57955,5,113,535,63,8516,50
23008,10,233,1279,184,7320,49
2180,14,282,1547,199,10660,83
34491,28,944,1055,602,8888,342
65985,219,4006,285,3259,25505,747
534,990,45084,1560,26088,111740,18996
52286,300,3549,706,2852,47916,697
54421,52,559,638,397,13356,162
48318,105,2882,817,2094,38517,788
4755,189,11310,1520,5784,96366,5526
36327,104,1887,1008,1634,22893,253
31319,67,1160,1099,750,8905,410
21073,3,127,1310,88,4467,39
28997,70,1166,1155,758,22716,408
57571,6,113,547,74,2874,39
55551,440,7335,602,6089,58024,1246
42432,413,5707,891,4641,53753,1066
21866,863,17240,1297,10943,86685,6297
4351,726,21567,1526,14403,64675,7164
55454,45,402,605,338,12388,64
32300,3,189,1096,122,4314,67
1707,20,1314,1551,871,50402,443
51883,78,1115,719,956,11801,159
14063,3,166,1426,116,9074,50
38956,8,66,943,54,2527,12
70124,2,66,149,59,2935,7
7627,1045,31035,1484,20671,215449,10364
49155,132,1492,793,1244,20855,248
21257,19,286,1307,184,5822,102
49472,4838,76037,783,57341,294086,18696
49556,8,64,781,53,5853,11
65759,199,2451,291,1847,29287,604
30915,170,2439,1117,1624,31411,815
39358,52,718,938,575,20256,143
29747,35,1074,1141,602,11085,472
27623,55,1041,1181,574,6352,467
52749,30,526,690,322,10171,204
20435,24,442,1322,282,7010,160
20564,1079,30419,1320,20802,131880,9617
3527,6,116,1535,95,9768,21
27385,51,911,1187,608,21426,303
2751,582,39706,1543,26762,268263,12944
21327,31,594,1306,463,9268,131
10997,38,2970,1463,1751,28724,1219
16673,3,183,1388,131,10485,52
32911,122,2825,1085,1856,19136,969
25055,23,549,1238,347,10077,202
33173,191,2980,1080,2004,29369,976
13464,7,380,1435,168,6122,212
53918,329,2788,656,2171,17744,617
4805,12421,424132,1520,276613,822673,147519
57182,336,4296,556,3468,36796,828
58534,1453,40766,515,28676,236288,12090
62421,39,428,383,363,8689,65
3257,21,491,1538,351,35170,140
7732,24,597,1482,391,15761,206
52312,11,158,705,95,11573,63
32430,12,700,1094,433,16979,267
61406,99,3577,415,3023,23340,554
26738,61,2410,1201,1354,11199,1056
53950,1925,24873,655,20624,124776,4249
10922,3,81,1463,62,12936,19
63255,145,1781,361,1412,12635,369
31516,30,612,1108,310,10395,302
25900,536,8234,1220,5412,57141,2822
17627,91,1678,1371,1266,15562,412
48992,148,2057,797,1475,13305,582
11426,7,247,1459,153,5832,94
24643,79,1604,1247,968,7974,636
63847,153,1913,345,1556,11303,357
35569,89,2226,1028,1633,18724,593
3388,26,912,1537,623,15579,289
29402,28,1048,1147,621,10759,427
59190,86,1722,494,1201,15498,521
32244,70,1009,1097,682,13279,327
54413,33,350,638,262,11137,88
22585,11,392,1287,264,6005,128
6002,11186,580564,1505,402156,2070593,178408
55178,42,464,613,375,8981,89
14395,29,793,1421,532,25710,261
55702,64,896,598,795,12764,101
21193,169,5372,1308,4566,50103,806
11308,18,737,1460,434,14091,303
1167,6271,171727,1555,106587,548673,65140
12865,563,20717,1443,11990,114565,8727
20410,40,1214,1322,958,6832,256
13811,5274,208848,1430,125002,551001,83846
50248,28,297,763,231,5667,66
22777,149,7368,1283,4099,66676,3269
15961,75,2454,1399,1843,34535,611
31296,52,1059,1111,701,14461,358
32378,1911,61239,1095,40198,114049,21041
20768,18,807,1316,593,31098,214
5327,67,3549,1513,2142,17405,1407
46515,424,6224,841,5041,42057,1183
46962,22,614,835,457,7398,157
63353,2803,33873,358,26302,129922,7571
48854,22,450,802,362,9708,88
60028,56,736,466,633,10101,103
36439,190,3181,1005,2373,32602,808
65267,3,48,302,29,3050,19
41816,90,1667,900,1397,20734,270
23547,161,2770,1271,1800,25953,970
54869,22,242,621,169,7286,73
29002,7,228,1155,188,15120,40
12527,18,854,1448,432,8136,422
31525,18,478,1108,376,8551,102
69544,17,190,169,144,5404,46
22490,3,78,1289,61,5798,17
273,124,3018,1562,2116,12627,902
5298,21,531,1513,365,7927,166
3863,351178,10423322,1531,5275613,24564770,5147709
19371,47,599,1340,397,8090,202
69701,14,100,164,97,3696,3
60613,51,615,444,440,11042,175
46142,941,10641,846,7531,39923,3110
68408,22,122,192,113,2608,9
34954,156,3048,1043,2048,19172,1000
58226,21,218,525,181,5153,37
64855,66,747,312,638,9758,109
64748,5,47,317,35,2758,12
53086,286,4062,679,3242,24971,820
60970,9,142,430,91,8142,51
66156,51,1620,279,1113,11539,507
30289,517,9698,1130,6695,59426,3003
49199,95,934,791,750,17743,184
550,12,1200,1560,762,9588,438
13525,26,719,1434,471,15388,248
47837,5,126,824,85,2463,41
40222,26,486,926,318,15347,168
68878,26,268,190,219,2568,49
17257,2503,58392,1378,35008,109399,23384
7345,4,189,1488,119,6721,70
68787,25,310,194,279,3083,31
20200,62,2379,1326,1769,28837,610
29137,3812,117629,1152,74692,519991,42937
7585,5,160,1485,119,5217,41
14301,19,724,1423,511,32613,213
69878,73,1057,158,885,13103,172
21537,246,13292,1302,8300,61170,4992
53329,1086,11183,673,8641,60823,2542
36138,22,506,1014,368,5142,138
11526,2698,67455,1458,38950,241547,28505
64403,231,2511,327,2017,14791,494
67428,136,2054,239,1779,13724,275
24306,1,84,1255,65,5856,19
53927,66,662,656,397,6843,265
24912,87,2743,1241,1841,24392,902
8353,76,3614,1478,2444,58741,1170
47400,200,2491,829,2066,40674,425
12172,37,867,1452,511,5212,356
52128,19,321,711,255,12970,66
16429,26,1650,1392,1122,47285,528
17472,12,361,1374,260,9417,101
58478,2719,89473,513,67349,235631,22124
56498,37,645,575,509,13053,136
22675,10,325,1285,233,8269,92
18386,206,11113,1357,7165,71015,3948
56282,450,6986,581,5745,40761,1241
20891,17,207,1314,155,9067,52
57776,6,40,540,31,4604,9
27484,27,1001,1185,689,23823,312
29842,1,189,1139,119,3006,70
67171,11,167,247,136,4961,31
37270,98,1420,984,1072,17611,348
57793,123,1476,540,1146,17690,330
31122,18,522,1114,412,11460,110
38177,148,3339,960,2173,26084,1166
735,41,3581,1558,2702,76969,879
18370,5,121,1358,91,10345,30
64679,21,221,319,205,4873,16
66767,8,182,260,145,5466,37
50457,158,2632,758,2104,62259,528
26372,19,673,1210,427,26459,246
403,50,3930,1561,2680,30023,1250
70373,13,124,141,124,2332,0
25676,2298,69229,1225,48668,250108,20561
205,18,1526,1564,990,31401,536
54565,18,223,632,153,5910,70
7421,98,1950,1487,1323,10690,627
58443,5250,159081,518,114057,461061,45024
22952,938,22814,1280,14719,58935,8095
65498,3,239,297,162,4274,77
22951,125,3893,1280,2254,19358,1639
31162,35,1501,1113,906,24723,595
37844,47,511,969,379,6665,132
5832,6,229,1507,139,5294,90
15145,65,1525,1412,910,8464,615
32870,67,2050,1086,1364,30769,686
57388,5,132,551,104,7003,28
16277,7,409,1395,274,27657,135
53377,3,17,672,16,2853,1
25557,120,5537,1228,3463,45682,2074
64682,6,52,319,39,3030,13
48574,57,871,810,711,15847,160
63538,148,2468,354,2117,18361,351
23822,16,375,1265,195,6984,180
15763,5,144,1403,85,4212,59
27366,12,221,1188,147,6671,74
67026,5,114,252,76,3124,38
52636,152,2251,693,1692,32291,559
3169,1,132,1539,88,10782,44
57620,476,12923,545,10468,42077,2455
36081,228,3143,1016,2456,26554,687
29117,210,4260,1152,2820,26945,1440
67404,246,4745,240,4107,28059,638
18157,20,398,1362,317,8106,81
32325,1,98,1096,73,4686,25
26967,13,239,1196,184,14585,55
11442,107,7342,1459,3912,36072,3430
51879,44,455,717,357,13009,98
7188,27,1084,1489,771,22427,313
56835,201,1872,562,1423,16609,449
19752,122,4723,1333,3240,40383,1483
12187,39,2914,1452,1390,19365,1524
12392,59,2332,1449,1577,27958,755
267,5,226,1563,146,14720,80
10328,69,1666,1467,984,14292,682
11353,613,14692,1460,8657,59441,6035
27013,35,1054,1195,896,37375,158
64438,9,209,326,160,6505,49
5176,712,23812,1515,16221,110452,7591
21842,0,0,1298,0,5502,0
58926,18,222,502,174,6113,48
45145,45,809,857,539,9781,270
49681,14,180,778,121,7153,59
24719,19,605,1245,362,6738,243
64635,63,1064,321,875,14459,189
69895,82,1127,157,1085,13402,42
15642,169,3691,1405,2364,62210,1327
30402,1,75,1127,34,5211,41
69152,5,67,181,56,1883,11
11517,511,19583,1458,12149,130582,7434
57034,46,514,560,409,5486,105
54163,863,8618,648,6811,184457,1807
67168,6,252,247,164,14145,88
17158,392,20949,1380,10913,98990,10036
41631,21,236,903,181,11092,55
39453,373,3654,841,2876,50625,778
70586,3,68,134,68,3606,0
61370,28,329,416,274,7829,55
16330,7,174,1394,118,11664,56
15174,6,469,1411,322,10635,147
36085,107,2491,1016,1837,11679,654
22732,1173,23435,1284,15515,125615,7920
18176,62,1979,1361,1265,15906,714
67289,13,118,243,73,4594,45
6180,13,231,1503,157,12705,74
13127,18,1310,1439,573,16658,737
26436,13,457,1208,289,11417,168
30279,1599,27925,1130,19485,150609,8440
65598,153,1728,295,1404,13623,324
4914,37,1885,1518,1193,9636,692
46169,3,212,845,148,11257,64
22110,338,5667,1294,4010,45563,1657
26756,52,2230,1201,1336,23992,894
25652,100,2922,1225,1702,26780,1220
57453,2,22,550,17,2134,5
64867,33,974,313,358,11614,616
65809,14,127,289,102,4418,25
1958,111,4647,1549,2858,20805,1789
29400,13,651,1147,413,14485,238
34899,13,310,1044,227,10175,83
63002,36,537,368,422,6119,115
24722,2,188,1245,137,17619,51
55264,838,14036,610,11865,66303,2171
30771,33,694,1120,443,13756,251
25393,1294,23438,1231,15212,140437,8226
54311,113,1222,642,1052,17094,170
22469,70,2138,1289,1516,36687,622
36861,4,121,996,104,8808,17
42524,4,56,890,42,2726,14
15807,40,1012,1402,767,14786,245
10131,134,3771,1469,2505,28476,1266
17976,130,3335,1364,2182,21808,1153
17303,324,2913,1377,1992,29373,921
23491,136532,3052596,1271,2248643,4909458,803953
59550,645,16242,482,12524,79816,3718
30709,59,1805,1121,1146,20696,659
56400,6,86,578,77,8874,9
15949,23,1234,1400,876,24966,358
4761,30,1678,1520,972,42406,706
45804,14,116,849,101,6315,15
40452,114,1434,922,1064,16975,370
40031,27,424,929,297,11345,127
604,85,4335,1559,3203,34374,1132
55493,491,7389,604,5854,95758,1535
61545,153,5758,411,4786,45145,972
34807,8,164,1047,112,3163,52
29186,53,1122,1151,684,10389,438
727,735,31015,1559,18375,127173,12640
13611,220,8259,1433,5247,53548,3012
2049,129,3566,1549,2592,49520,974
69675,61,1104,165,985,8888,119
34660,10,248,1050,167,11478,81
51100,98,1491,741,1031,28747,460
20529,5,204,1320,138,4142,66
68428,30,572,207,471,27111,101
62403,4,53,383,34,4971,19
52682,231,3144,691,2516,28863,628
27368,115,1737,1188,1193,19289,544
874,6984,300806,1557,172814,931729,127992
13400,25,917,1436,519,7632,398
38410,38,840,954,708,15466,132
22513,24,1192,1288,807,19803,385
6628,801,20793,1497,13849,113653,6944
23803,71,1282,1265,846,15766,436
35870,8,187,1021,123,7382,64
66789,1,18,260,14,1281,4
67625,5,217,232,201,4410,16
65426,248,6350,299,4647,58455,1703
49710,3724,60550,777,45365,199230,15185
61428,52,944,415,769,11695,175
60390,7,168,453,121,6810,47
56973,19,345,562,279,13330,66
69493,16,558,171,553,7050,5
789,89,2466,1558,1412,31489,1054
13342,442,22931,1437,12877,150909,10054
57004,9,168,561,128,7318,40
68239,48,1075,213,689,21955,386
69697,5,132,164,113,2967,19
23539,27,460,1271,346,18981,114
52761,54,688,689,557,10410,131
41405,309,2547,908,2129,23908,418
12475,299,6492,1448,3895,22893,2597
22625,223,7658,1286,4452,65935,3206
60072,47,763,464,585,13659,178
31570,11,316,1107,202,5610,114
37511,0,56,977,39,3495,17
13881,26,1060,1429,782,36695,278
3990,15,1055,1530,833,13612,222
5251,4,292,1514,168,5170,124
26450,49,814,1208,554,15767,260
49488,62,560,783,498,10921,62
14703,64,3717,1418,2632,21823,1085
59978,16,268,467,247,9672,21
68735,72,882,196,776,14492,106
39919,26,344,931,279,10565,65
25381,270,5523,1231,3728,39626,1795
19447,21744,561609,1339,333099,1649950,228510
52991,186,2744,681,2361,34173,383
53738,1240,23917,662,20382,90841,3535
24009,31,505,1262,379,7679,126
28721,11,654,1160,378,7576,276
70179,1,41,148,36,1209,5
61505,5,79,412,67,3537,12
43853,26,380,871,290,9736,90
49427,25,339,784,292,11979,47
29862,2,80,1138,52,4964,28
26599,259,3937,1204,2479,37391,1458
81,88,3820,1566,2541,87232,1279
65379,4,41,300,33,5709,8
33125,89,3276,1081,2332,48659,944
38158,1839,30363,960,23780,112464,6583
59158,44,2186,495,1750,14584,436
17271,9,275,1378,178,5345,97
578,154,9673,1560,7422,114691,2251
43749,473,7556,872,6013,47331,1543
768,56,2132,1558,1447,30710,685
56362,105,1293,579,1107,17365,186
15484,173,6723,1407,4638,49039,2085
49854,246,2874,773,2192,24375,682
54256,19,195,644,141,3877,54
18957,85,1034,1348,871,48528,163
20553,142,4165,1320,2781,85074,1384
35952,93,5311,1019,3442,37617,1869
13177,13,755,1439,496,17425,259
15868,4,212,1401,136,4006,76
54198,268,2315,646,1948,18461,367
29231,100,4081,1150,2529,29262,1552
55444,49,468,605,366,10409,102
62625,6,240,376,183,3722,57
15789,15,251,1403,176,7133,75
49850,36,591,773,434,10183,157
70241,289,4260,146,3819,44055,441
56631,2,42,572,25,4704,17
41364,25,285,908,215,13058,70
55079,6,50,615,43,1861,7
22141,58,1596,1294,1171,21924,425
40683,503,11549,919,7532,46971,4017
11943,1,358,1454,118,8743,240
25740,414,9381,1223,6131,34056,3250
1930,73,2312,1550,1665,56121,647
54447,0,1275,637,978,12022,297
19547,254,10331,1337,6984,51749,3347
55632,487,8533,600,6476,50162,2057
11029,86,3621,1462,1990,16936,1631
18836,1,70,1349,38,7366,32
31023,150,2209,1115,1466,42857,743
55612,77,630,600,516,13450,114
33279,32,1092,1078,700,9914,392
61472,3,23,413,20,3966,3
48846,704,9617,802,6745,64318,2872
41591,12,199,904,163,5876,36
67694,0,0,230,0,1314,0
4022,108,3824,1530,2496,53371,1328
45248,9,118,855,106,12333,12
48089,53,1622,821,1285,6267,337
65932,12,215,286,181,5297,34
24334,100,3730,1254,2486,19045,1244
21291,103,1616,1306,1099,30669,517
2557,33,2342,1544,1565,62407,777
19058,46,822,1346,624,6489,198
10623,353,11515,1466,7662,60117,3853
32487,282,4118,1093,3237,46448,881
17367,10,265,1376,197,5778,68
6401,19,523,1500,375,11107,148
51476,331,5806,731,4540,37834,1266
28982,59,1286,1155,799,16947,487
1247,35,1275,1555,921,36089,354
8570,20,962,1477,600,20272,362
64033,35,299,339,235,3230,64
6341,34,837,1501,578,20158,259
29762,77,1316,1140,778,9923,538
30046,1018,40293,1134,29945,222351,10348
17402,31,1092,1376,902,18267,190
6449,119,3370,1499,2476,92257,894
47901,36,520,824,418,12687,102
11820,0,0,1456,0,12906,0
23543,60,1811,1271,1154,39032,657
14491,7,241,1420,172,15774,69
26401,186,2864,1209,1742,19069,1122
38149,43,734,960,539,10515,195
60492,172,1506,448,1266,17182,240
37254,2,104,984,80,4036,24
35402,15,306,1032,206,3532,100
14890,49,1041,1416,668,44069,373
40742,83,1450,918,1207,9541,243
6261,192,6828,1502,4827,63349,2001
36461,31,345,1004,241,4409,104
411,30,701,1561,445,11360,256
37675,136,2099,973,1744,32954,355
32323,24,841,1096,543,20025,298
25275,1,143,1233,127,27202,16
64276,168,2672,331,2186,82573,486
12192,150,5834,1452,3192,33658,2642
60589,74,688,445,517,11804,171
30109,438,14928,1133,10074,87217,4854
33860,460,5980,1063,3862,71047,2118
65882,166,2682,287,2032,16312,650
65978,173,6318,285,5118,35768,1200
70496,4,37,137,35,1482,2
50493,194,3012,757,2573,38326,439
14506,71,2171,1420,1539,30634,632
18161,81,2767,1362,1948,67874,819
22267,120,3472,1292,2511,33871,961
59544,3265,65986,482,51045,402412,14941
49632,5,114,779,81,6067,33
33025,21,609,1083,428,7607,181
42642,238,3351,887,2721,56000,630
70091,60,633,151,598,15168,35
67299,20,280,242,204,8183,76
62573,44,895,378,675,10665,220
12030,22,736,1453,400,19521,336
58621,63,772,512,613,22533,159
31346,131,1951,1110,1403,32491,548
27680,2247,99583,1180,59019,439642,40564
18991,0,34,1347,29,20339,5
7503,102,3063,1486,2038,13327,1025
13640,37,1073,1432,588,17156,485
33220,33,675,1080,425,22691,250
57859,23870,454012,537,324487,1246019,129525
19970,7,173,1330,124,6173,49
42098,9,106,896,95,2009,11
40150,110,1824,927,1466,29697,358
27332,12,661,1188,396,8533,265
24251,26,938,1256,633,18368,305
8067,141,3036,1479,2018,23147,1018
54364,345,3214,641,2521,12351,693
34824,0,19,1046,15,3920,4
6883,77,4315,1494,2226,18336,2089
6947,226,4542,1493,2719,53673,1823
50889,28,470,746,362,9632,108
22377,2,44,1290,35,5224,9
17267,11,380,1378,297,6000,83
64702,22,696,319,566,8365,130
16333,3,229,1394,156,15696,73
12405,36,2235,1449,1264,19571,971
10683,70,2208,1465,1394,21849,814
25229,34,606,1235,374,6432,232
35567,46,222,892,170,22293,52
31482,317,4888,1109,3391,36768,1497
610,129,2912,1559,1747,40692,1165
25545,49,1112,1228,704,6608,408
35385,22,522,1032,318,7693,204
1410,22,778,1553,521,21962,257
53761,139,1526,661,1198,16221,328
36873,172,2754,996,2204,39099,550
30657,54,522,1122,354,9363,168
45082,2,33,856,29,2128,4
64047,3,93,338,73,2974,20
56040,596,4817,589,4460,32654,357
50020,37,357,769,324,6583,33
18879,23,694,1349,499,21506,195
9559,18,367,1472,252,8617,115
62396,119,638,383,512,9903,126
18630,231,6633,1353,4541,54466,2092
37343,271,6156,982,4943,37536,1213
48569,11,176,810,126,4104,50
64521,6,64,324,51,4601,13
49583,21,288,780,253,12652,35
4373,26,700,1525,467,11158,233
37865,10064,237832,968,172598,724693,65234
68462,14,147,199,129,4799,18
54782,51,618,624,511,15134,107
30150,20,648,1132,441,7828,207
6412,2080,95939,1500,59137,655674,36802
1699,77,3593,1551,2340,99543,1253
6733,16,905,1496,642,15067,263
56328,226,3826,580,2960,48054,866
2973,6246,181071,1540,99137,513900,81934
31406,8,405,1110,257,7438,148
62230,7,265,388,218,3376,47
19915,4,171,1331,126,11406,45
92,381,10761,1565,5912,62067,4849
49890,2310,79529,772,64230,435497,15299
60961,48,574,430,460,7192,114
5755,3349,75136,1508,50599,232217,24537
56926,335,6143,563,4825,65263,1318
60521,35,394,447,285,8309,109
59766,88,690,474,507,10904,183
24588,96,1722,1248,1072,15493,650
33227,1384,40497,1079,22370,159462,18127
67893,1,26,224,15,1756,11
61196,13,133,422,116,7860,17
46640,4,45,839,32,3767,13
12044,5,320,1453,178,14267,142
6036,110,4005,1504,2271,57321,1734
27548,45,1372,1183,818,15505,554
33765,26,729,1069,479,11749,250
49430,662,11260,779,8483,91675,2777
42855,89,1443,837,1139,14956,304
8407,153,1909,1477,1220,34500,689
4121,100,3561,1529,1891,29488,1670
61685,68,479,406,361,5876,118
32175,11,309,1098,239,36018,70
13664,20,1352,1432,720,8760,632
36453,346,5310,1005,4081,37460,1229
24143,59,981,1258,671,30506,310
31299,24,520,1111,293,3360,227
5175,98,4226,1515,2864,42360,1362
26185,10,540,1214,340,7993,200
65956,8,179,285,130,8900,49
51604,11,89,727,60,3897,29
33230,14,245,1079,164,15914,81
770,351,11814,1558,6752,34323,5062
59410,42,681,486,542,8275,139
68072,2,87,218,70,4720,17
20417,316,11757,1322,7565,94955,4192
10240,352,5464,1468,3685,63040,1779
23219,106,2724,1276,1954,42011,770
18918,0,267,1348,197,7203,70
36242,81,1811,1010,1577,53239,234
60810,35,375,436,339,7328,36
59035,1360,30164,499,23980,166269,6184
16772,336,8284,1386,5331,72818,2953
7536,57,2365,1485,1583,59851,782
15347,85,1561,1409,1153,29866,408
30232,6,155,1131,98,5345,57
7366,51,1433,1487,924,14575,509
49403,8,101,785,67,4503,34
2126,30,1852,1548,1328,26833,524
36512,174,1817,1002,1407,15044,410
60915,75,759,432,666,7431,93
43385,17,242,876,177,7546,65
19417,118,5303,1339,3008,36071,2295
5048,135,8028,1516,5342,58882,2686
24492,305,7353,1251,4913,55902,2440
59663,0,3,478,3,3310,0
6165,9,484,1503,275,31085,209
66799,1,14,259,11,1429,3
23802,201,5585,1265,4043,52787,1542
11285,0,0,1460,0,8202,0
4624,613,18777,1522,11903,89775,6874
23764,12,877,1266,696,10779,181
31805,68,1050,1103,707,22154,343
32988,1337,34485,1048,22503,259398,11982
17068,78,2436,1382,1870,29135,566
27929,22,316,1175,205,11883,111
22604,2607,80035,1287,52226,466472,27809
68089,31,270,218,217,4357,53
2894,46,1706,1541,1190,29969,516
23181,0,0,1276,0,13647,0
59463,4621,82667,481,59713,445073,22954
19376,2,61,1340,38,3589,23
43069,30,561,880,481,27868,80
31725,889,18967,1105,13248,89695,5719
60024,6,56,466,43,2534,13
10214,687,43621,1468,27441,231514,16180
2844,80,3451,1542,2285,24175,1166
35781,42,697,1024,552,10631,145
52166,26,705,710,565,10761,140
38971,75,993,943,731,7857,262
11575,176,7636,1458,4558,42302,3078
60826,17,163,434,136,6287,27
49325,26,770,787,593,12223,177
13344,27,667,1437,382,8195,285
6855,26,482,1494,352,28904,130
52980,1115,10744,682,8491,94500,2253
13620,4,451,1433,253,5472,198
17815,13,396,1368,321,11347,75
68473,5,90,205,72,4089,18
65639,2,50,294,33,5045,17
49313,84,972,787,784,13420,188
31606,60,1279,1106,814,7262,465
6290,391,14882,1502,10298,102611,4584
46450,56,807,792,680,19940,127
21443,322,9808,1303,6909,69693,2899
70095,99,2048,151,1891,24465,157
15481,22,552,1407,376,7497,176
40575,45,1332,921,1037,17505,295
40454,13,104,922,84,5973,20
52943,57,719,683,571,13149,148
66961,10,167,254,131,3276,36
39659,13,154,934,119,4726,35
17831,25,661,1367,473,8898,188
15294,762,19056,1410,13527,187914,5529
50623,86,1420,754,1160,19422,260
44056,20,182,869,122,3596,60
61976,6,110,397,103,2817,7
22845,8,422,1282,284,6995,138
58030,21,401,532,312,12000,89
38875,32,629,944,537,15984,92
23278,42,1767,1275,1239,48245,528
49491,10,230,783,154,21872,76
17496,31,808,1374,510,6909,298
14026,639,9999,1427,6155,105303,3844
2859,519,10373,1542,6803,106514,3570
9880,7,239,1470,160,24053,79
2324,141,5255,1546,3902,23687,1353
66221,31,511,277,387,4513,124
5245,146,3488,1514,2193,30097,1295
33266,405,4551,1078,2919,26364,1632
46650,2103,30418,839,24222,249309,6196
27390,79,3171,1187,2093,62108,1078
53790,258,7263,660,6406,85512,857
58173,9,168,528,139,7137,29
62202,43,335,389,285,9374,50
51809,831,39822,721,27742,153916,12080
22654,540,8206,1286,5564,26991,2642
65411,27,230,299,179,4531,51
16463,1136,18743,1391,12017,65081,6726
4642,108,3492,1522,2450,42260,1042
50834,233,4123,749,3258,67792,865
20086,9,261,1327,192,6850,69
67929,13,180,223,138,3334,42
908,150,5084,1557,3788,61426,1296
10231,30,661,1468,396,27801,265
54106,68,540,649,442,7366,98
70561,1,28,135,28,3408,0
25647,10,566,1225,382,11612,184
49985,42,604,770,471,13801,133
53219,5,84,675,63,4108,21
28536,11,261,1164,180,5208,81
66449,30,402,271,320,9294,82
28190,567,15960,1170,11400,136079,4560
58126,179,2753,529,2200,27794,553
16620,52,4727,1389,2585,36380,2142
10516,6,177,1466,123,7915,54
59670,22,190,478,140,10408,50
35874,28,392,1021,270,6136,122
69948,215,6188,155,5737,33248,451
53225,154,2681,675,1807,34966,874
20082,62,1006,1327,693,17769,313
44044,19,378,869,287,9759,91
13028,37,721,1441,603,18282,118
10386,2356,100723,1467,55838,572581,44885
22914,40,911,1281,537,18287,374
61508,41,516,412,422,6971,94
52313,48,1696,705,1379,21968,317
48485,20,304,814,238,7788,66
28143,171,4895,1171,2852,20503,2043
11118,75,1422,1462,906,29471,516
69788,29,194,160,162,3984,32
55809,19,320,595,286,9894,34
8572,23,927,1477,608,14644,319
17516,1128,33569,1373,21746,153138,11823
32320,11,288,1096,203,8985,85
64912,10,220,312,158,4637,62
1964,53,979,1549,734,22608,245
25546,65,1247,1228,916,21789,331
46344,2,80,844,53,3639,27
60814,2436,40527,436,32244,267346,8283
32217,71,2074,1098,1342,46868,732
23875,173,7302,1264,5479,89552,1823
51101,45,715,741,566,7307,149
48101,252,3660,821,3097,39783,563
69097,14,414,183,329,10510,85
30610,40,1288,1123,887,22537,401
4928,201,4718,1518,3437,46316,1281
65045,282,3674,306,3032,59771,642
54704,220,3852,627,3162,39141,690
57068,12,171,559,152,8447,19
9931,466,16818,1470,10942,140716,5876
7024,232,4840,1492,3258,36972,1582
48898,71,622,800,493,8866,129
35819,5883,168369,1023,127774,342681,40595
18077,691,27412,1363,16584,142699,10828
16391,184,2651,1392,1910,23147,741
69069,51,515,184,495,5800,20
18516,67,3248,1355,2182,49985,1066
49622,11,533,779,247,10955,286
46468,0,18,842,15,3134,3
66163,86,1146,278,942,11711,204
22459,23,352,1289,251,5813,101
6148,402,15027,1503,10652,99515,4375
15899,437,9656,1400,5468,39065,4188
6281,21,716,1502,459,16119,257
49549,75,610,781,508,16322,102
58738,45,480,508,379,6831,101
59758,55,710,441,584,17706,126
20163,23,1152,1326,869,13735,283
17171,46,873,1380,650,12407,223
37927,246,6058,967,4482,105204,1576
43729,134,2045,872,1506,8572,539
11644,146,7323,1457,4315,48878,3008
7737,58,1765,1482,1234,69879,531
11476,37,2910,1459,1788,18392,1122
69029,36,578,185,508,7413,70
57709,5,83,543,63,6585,20
35230,13,127,1036,87,2945,40
16471,1880,47992,1391,31227,184122,16765
8798,0,107762,1476,67777,197970,39985
32695,18228,530006,1090,344699,976206,185307
9912,5129,136634,1470,84707,250758,51927
8431,783,17298,1477,10950,71915,6348
58106,123,1722,530,1300,25288,422
4308,457,10026,1526,7340,113003,2686
55482,9,107,604,84,3327,23
5099,45,1377,1516,951,91113,426
32873,106,1888,1086,1343,22598,545
70211,9,122,147,111,3266,11
17282,279,4269,1378,3038,23810,1231
45714,137,2895,851,2214,16477,681
34019,9,446,1064,309,5607,137
11371,3276,59500,1460,36801,291801,22699
28093,1199,26904,1172,17406,137188,9498
69199,83,1231,180,1105,19536,126
20774,12,300,1316,221,26288,79
70620,7,103,132,92,5184,11
57536,30,312,548,269,9542,43
34946,16,420,1043,272,8107,148
26559,198,4256,1205,3185,33509,1071
57569,76,1055,547,836,15932,219
68660,377,5072,198,3924,32718,1148
16083,114,2636,1397,1831,27219,805
15197,281,7254,1411,5111,65999,2143
43111,6,95,879,71,4630,24
51724,34,360,724,304,10559,56
32960,43,1024,1084,608,11304,416
55333,8,65,608,57,5665,8
12960,0,0,1442,0,12613,0
24715,10,255,1245,177,11241,78
28553,52,760,1164,516,7205,244
36819,8,247,997,185,8274,62
28441,9,978,1166,524,5961,454
13248,473,9492,1438,7175,52624,2317
8903,1415,41942,1475,29470,108717,12472
27317,89,2104,1189,1407,15398,697
33084,32,1021,1082,619,15843,402
12350,54,1707,1450,1096,20152,611
17791,4,105,1368,71,4155,34
57358,50,1020,552,772,15454,248
2874,76,3071,1541,2050,54775,1021
44368,14,496,865,398,20653,98
25282,336,4392,1233,2670,27124,1722
3971,67,1647,1530,1166,23123,481
12241,59,4189,1451,2152,35677,2037
32627,43,1007,1091,717,10052,290
10285,129,5702,1468,3556,35371,2146
34785,22,523,1047,359,9951,164
1720,474,16336,1551,12000,61893,4336
36974,36,901,993,728,20814,173
32019,272,5436,1099,3343,22543,2093
69398,47,665,174,563,8490,102
50507,61,1337,756,852,10383,485
50243,458,7223,763,5482,34760,1741
32493,88,1898,1091,1492,20373,406
57300,14,162,553,123,7189,39
498,16358,635603,1561,378346,1579626,257257
31933,26,647,1102,415,6663,232
1369,31,1402,1554,906,12836,496
59077,42,420,498,342,11228,78
21374,656,8851,1305,5642,32158,3209
24337,21,649,1254,500,9933,149
56055,21,394,588,306,10336,88
16057,25,894,1398,664,31146,230
67692,54,540,230,441,3855,99
55807,14,169,595,131,8511,38
32292,51,1217,1096,732,7973,485
28110,3408,110740,1172,78405,225760,32335
63455,8,23,356,19,2432,4
39625,3171,59410,934,44221,254587,15189
37730,30,620,971,477,13871,143
48473,2179,29749,815,23476,149656,6273
53293,5,20,674,20,2723,0
6739,212,4224,1496,2468,19514,1756
34513,130,3040,1054,2161,20187,879
69783,9,118,161,108,1552,10
27135,36,870,1193,728,18997,142
69027,4,60,185,48,2780,12
55858,39,283,594,233,7428,50
37784,10,168,970,123,2479,45
44959,160,2142,858,1782,39679,360
9477,36,901,1473,624,13525,277
15765,192,4679,1403,3314,35435,1365
44115,1057,13579,868,10411,47758,3168
4426,195,6821,1525,4890,33544,1931
48624,18,388,809,255,8927,133
60469,5,43,449,37,5508,6
49231,571,10360,789,7306,47132,3054
38635,1271,19711,923,14737,162885,4974
38230,3,173,959,113,8046,60
42010,9,101,897,72,5746,29
34650,688,20818,1050,15402,110326,5416
3723,77,1975,1533,1363,20162,612
29793,2,107,1140,76,4984,31
14451,23,505,1420,331,15256,174
59878,340,5538,470,3258,51215,2280
6806,490,12628,1495,8724,42301,3904
68801,1,42,193,17,1973,25
35227,391,6810,1036,5138,86073,1672
11103,330,11655,1462,6942,57065,4713
15106,60,854,1413,646,12041,208
8648,137,6392,1476,3917,24745,2475
66856,243,4984,257,4305,45600,679
16577,0,182,1390,131,7827,51
25126,7,198,1236,178,10732,20
28027,59,1632,1173,1104,19862,528
13865,58,1232,1429,856,13551,376
34524,56,863,1054,623,15657,240
54493,1381,20179,587,16250,150644,3929
50665,2,92,753,70,3218,22
18913,23,1094,1348,828,13574,266
31938,620,18209,1101,11026,157719,7183
16106,1360,30096,1397,21661,158698,8435
61872,19,161,401,124,1854,37
26724,55,2546,1201,1357,87628,1189
2988,201,7211,1540,5202,55970,2009
34235,155,5453,1060,3664,38100,1789
12032,34,1198,1453,651,21848,547
23854,323,7221,1265,4461,37782,2760
40817,538,5070,917,4069,39526,1001
10351,43,2109,1467,1349,59465,760
28662,96,1475,1161,952,11328,523
9263,283,8691,1474,5633,31944,3058
48986,93,875,798,659,12414,216
9408,79,1474,1473,958,9046,516
50498,17,245,757,182,7535,63
52644,18,238,693,209,16322,29
51164,66,646,739,534,10193,112
66863,1,20,257,15,745,5
2625,13,793,1544,564,26068,229
60813,47,735,436,616,8698,119
43253,34,909,877,761,21579,148
68692,128,1608,197,1330,10736,278
12586,62,3013,1447,1674,36158,1339
58518,14,263,515,161,3223,102
19939,13,489,1330,378,28077,111
6443,25,943,1500,582,20471,361
12414,0,0,1449,0,12555,0
34968,81,1928,1041,1591,38012,337
21518,177,6476,1302,4334,42475,2142
7321,39,1091,1488,767,18387,324
53333,42,520,673,418,18755,102
16580,157,5310,1390,3384,24727,1926
43713,23,556,872,462,14245,94
53463,58,578,670,486,6219,92
20862,238,6733,1314,5007,45708,1726
67586,12,202,233,180,5060,22
19739,0,71,1334,50,8396,21
25712,57,798,1224,546,13293,252
18862,0,0,1349,0,6493,0
7113,41,1294,1491,881,37198,413
19559,48,1823,1337,1266,15422,557
52952,18,232,683,166,5687,66
62420,20,306,383,246,4529,60
67446,19,117,238,95,3605,22
65681,101,1374,292,1143,12263,231
15956,303,9365,1400,6001,82129,3364
15903,19,474,1400,322,10495,152
62854,1,18,371,16,1579,2
21663,124,4935,1300,2707,18856,2228
28986,87,2123,1155,1277,16537,846
48778,40,389,804,270,4655,119
18106,799,19885,1362,13959,88843,5926
49441,1,58,784,56,2648,2
26249,8,749,1213,491,27112,258
41834,36,689,900,560,19869,129
1175,56703,1730952,1555,920372,3552792,810580
35247,98,1776,1036,1287,33849,489
70245,35,413,145,373,3875,40
26132,355,4847,1215,3751,48242,1096
2651,133,4746,1544,3387,101667,1359
4275,212,8936,1527,6679,160536,2257
10892,192,5066,1463,3127,35478,1939
27113,8,327,1193,200,8058,127
62683,131,1912,375,1536,14181,376
1987,688,21571,1549,13183,153816,8388
2370,225,7524,1546,5207,59129,2317
8880,22,1013,1475,661,34793,352
24590,170,2847,1248,1963,21069,884
57513,1000,11535,549,9648,53423,1887
24027,1,117,1261,72,5558,45
51994,77,1269,716,1118,28188,151
14832,4,236,1416,148,4889,88
6856,11,204,1494,125,12947,79
1851,1,53,1550,36,3792,17
22187,8,394,1293,263,8406,131
7369,10,626,1487,452,6657,174
69234,38,338,169,318,4609,20
66867,17,327,257,259,2883,68
62615,5,85,377,65,3224,20
15527,539,14075,1406,10061,153286,4014
1636,145,5001,1552,3489,43965,1512
58654,40,499,511,438,13873,61
20085,10,740,1327,586,12314,154
56103,25,159,587,118,3586,41
29245,20,506,1150,295,7883,211
42734,43,537,886,482,15465,55
13384,13,549,1436,254,9977,295
12223,234,6269,1452,3567,33244,2702
14570,6,491,1419,310,5870,181
26312,2043,56889,1211,34184,418514,22705
4540,21,977,1523,716,56280,261
8,89,5043,1568,2694,88023,2349
10372,17,541,1467,343,8015,198
34483,17,811,1055,506,21326,305
7672,151,4990,1483,3078,28094,1912
54769,112,997,625,802,13878,195
35854,1527,23955,1022,17857,178545,6098
14021,189,5554,1427,3995,50751,1559
648,955,53487,1559,29546,207272,23941
25952,9,276,1219,196,14942,80
38180,82,957,960,696,7207,261
54120,6,29,649,27,5850,2
38435,106,2279,953,1309,14612,970
34136,56,893,1062,607,23898,286
67216,6,215,245,120,15310,95
24987,22,965,1239,690,10976,275
29092,114,3425,1153,2163,27491,1262
72,159,4753,1566,2959,56367,1794
45525,1039,23150,852,17044,188195,6106
11937,14,466,1454,228,24696,238
54760,373,4813,625,3949,17496,864
37631,153,3759,974,3150,49820,609
40644,2,155,920,70,5304,85
59755,66,677,475,571,9657,106
6028,316,5618,1505,3640,52737,1978
60079,3,82,464,59,4407,23
8053,120,2823,1479,1772,23528,1051
35311,1236,25896,1034,19326,96084,6570
62629,0,57,376,41,3404,16
14125,1110,40243,1425,26386,90694,13857
29258,5818,146992,1150,100201,461246,46791
3129,46,3268,1539,2217,56967,1051
57961,70,1326,535,1130,17053,196
27693,4,154,1180,107,2719,47
41235,30,541,910,482,25106,59
29615,21,518,1144,271,6163,247
23506,409,8242,1271,5566,53210,2676
52918,1154,17778,684,14148,73237,3630
20732,27,350,1317,264,12467,86
43119,163,2957,879,2427,27049,530
55150,2,78,613,62,4800,16
19175,8,494,1344,321,10647,173
23879,87,3483,1264,2274,24476,1209
37678,113,2415,973,1677,22129,738
14513,4644,77110,1420,53666,378791,23444
48287,9207,140912,818,98455,369774,42457
29365,142,10460,1148,6568,39476,3892
23972,823,19671,1262,16345,106826,3326
64813,25,197,315,143,13708,54
52737,62,1117,690,881,14013,236
33886,558,13095,1067,9481,67620,3614
24335,489,9948,1254,7055,93369,2893
68612,5,92,199,62,2974,30
47091,31,423,834,351,14940,72
62791,36,641,372,483,8329,158
51026,46,681,743,591,36629,90
56808,33,433,566,361,10375,72
59632,83,592,479,450,10494,142
19181,31,1260,1344,886,21078,374
13667,3721,125007,1432,72892,698948,52115
60464,14,125,450,90,3925,35
28327,41,2316,1167,1427,25829,889
2682,342,9955,1543,6764,57845,3191
39413,47,1082,937,799,12844,283
23927,136,2704,1263,2004,19364,700
60180,5,120,452,80,5907,40
25832,3950,169903,1222,102162,598086,67741
36776,739,11179,998,8861,85911,2318
23495,96,3173,1271,2091,31176,1082
69704,7,149,164,135,2068,14
27907,9,411,1175,395,22824,16
33481,30,567,1075,389,13795,178
30228,24,741,1131,484,7007,257
56829,82,1277,566,1119,13409,158
35828,501,7728,1022,5832,81792,1896
18573,48,1326,1354,1080,65819,246
35856,1,68,1022,55,5145,13
56424,6,52,578,46,3501,6
31322,28,798,1111,486,6548,312
30537,43,1836,1124,1067,17069,769
30303,73,2482,1129,1600,21144,882
49845,7,119,774,97,5054,22
29566,25,583,1144,348,17758,235
11169,161,2384,1461,1606,61059,778
9011,157,5462,1475,3962,31048,1500
5849,71,1818,1507,1174,33637,644
10581,8,364,1466,205,11411,159
32933,129,3477,1085,2527,33230,950
2878,160,4091,1541,3158,25795,933
24317,3,137,1255,99,4024,38
65332,57,764,300,669,16614,95
14518,26,567,1420,403,9543,164
35436,113,3130,1031,2729,38696,401
68845,23,380,192,287,6709,93
51390,445,7155,733,5782,46952,1373
7848,15,543,1481,368,12298,175
36722,907,20711,999,15229,187762,5482
35193,8,97,1037,69,1961,28
49526,123,3021,782,2294,45010,727
62365,132,1889,384,1479,15409,410
20750,35,1049,1316,714,16487,335
61850,4,122,401,107,2043,15
29619,35,1612,1144,1061,30144,551
41137,11,445,911,362,14109,83
56486,1,8,576,7,5054,1
49209,233,2811,790,2212,17710,599
33562,2002,49497,1073,30284,166208,19213
52083,220,3159,713,2557,26881,602
10787,45,1566,1464,871,16337,695
12746,233,6719,1445,3782,86745,2937
50401,73,1042,759,845,8664,197
18733,46,2247,1352,1284,53196,963
68305,97,2567,211,2129,32679,438
5780,64,2150,1508,1459,26159,691
53044,12,319,680,248,7883,71
28638,86,1332,1162,1103,34896,229
54778,147,880,625,655,7082,225
50165,0,378,765,294,4124,84
61232,30,257,420,194,4785,63
66031,11,358,283,263,6235,95
57685,123,1817,544,1372,23287,445
52412,55,657,702,555,31780,102
61734,11,59,405,50,3552,9
69465,7,100,172,72,4698,28
43472,55,770,875,653,12726,117
59228,228,1879,493,1508,20721,371
25525,6,806,1229,498,7515,308
4661,65,2870,1521,1877,43728,993
54600,207,2373,631,1967,42577,406
56525,13,129,574,102,11816,27
65659,15,188,293,141,7994,47
57839,320,4564,538,3702,32512,862
68663,3,90,197,71,3885,19
31942,99,1837,1102,1200,23318,637
15072,12,617,1413,473,34310,144
6149,303,16146,1503,10782,309860,5364
1476,32,706,1553,520,28747,186
867,58,1468,1557,1093,30867,375
60796,2641,48574,292,39930,199674,8644
9985,72,2118,1470,1567,23953,551
30414,17,974,1127,623,17661,351
19783,83,1693,1333,1105,10473,588
15243,237,4965,1411,3442,109105,1523
6848,57,1923,1494,1356,17692,567
31889,14,538,1102,332,4732,206
70032,20,483,152,392,7047,91
53986,632,5654,653,4042,27403,1612
60519,33,371,447,295,4423,76
51103,87,922,741,754,17694,168
30258,160,3122,1130,2085,29001,1037
54995,26,509,618,256,7339,253
13153,23,1061,1439,585,14212,476
16896,4,180,1384,134,10668,46
52688,91,819,691,673,10355,146
70084,0,165,151,156,4675,9
23300,43,960,1275,640,14901,320
5860,1483,52556,1507,32334,229350,20222
3836,319,16780,1532,10916,193930,5864
616,99,2774,1559,2067,32290,707
12133,6,281,1453,111,11985,170
25007,4,68,1239,57,8111,11
31776,74,3520,1104,2148,40238,1372
4014,442,8863,1530,5606,69759,3257
62562,38,365,379,292,9096,73
48666,105,1448,807,1138,54375,310
61120,6,39,424,29,3797,10
66044,23,299,283,235,8111,64
18508,5,617,1355,473,6482,144
4951,16,475,1518,348,9263,127
53193,3,67,676,47,3927,20
32308,305,5320,1095,3585,47084,1735
18368,23,1085,1358,711,18505,374
5973,8,209,1505,153,3983,56
48524,39,433,812,361,8817,72
30358,36,713,1128,469,4670,244
34880,13,388,1045,265,17276,123
30684,2135,68975,1122,44712,211157,24263
4147,7,374,1529,281,28823,93
53525,167,2036,668,1689,53571,347
59536,4,53,482,39,6100,14
7168,30,642,1490,386,10300,256
49935,1141,61321,771,53565,146856,7756
5472,62,1609,1511,996,27100,613
32414,118,5534,1094,3502,30319,2032
67948,38,309,222,236,7770,73
40017,29,871,929,685,11193,186
56320,35,472,580,390,6505,82
13861,33,2028,1429,1329,19408,699
56596,9,193,571,130,9923,63
16874,2,114,1385,86,13763,28
52638,10,226,693,164,13444,62
28827,7,170,1158,120,14188,50
11060,262,18558,1462,10882,134053,7676
7045,2574,68106,1492,45063,248481,23043
10513,32,2095,1466,1359,34851,736
2210,51,4169,1547,3060,36220,1109
54318,5,83,642,63,3094,20
22530,55,1320,1288,807,11294,513
24892,2,51,1241,47,7413,4
56380,103,1297,579,1024,9565,273
14564,156,5856,1419,4225,30619,1631
33564,74,1063,1073,824,15377,239
14691,167,10035,1418,6246,33943,3789
19009,706,21009,1347,14635,157082,6374
57542,7,82,548,60,3588,22
53206,271,2623,675,2144,19266,479
52129,8,168,711,108,8197,60
69874,32,472,158,393,6196,79
55952,1035,12084,592,10917,72175,1167
21536,154,5573,1302,3636,21139,1937
56880,190,2887,564,2310,38806,577
1212,504,15676,1555,10335,80729,5341
54914,254,5005,620,3876,42103,1129
58878,7,133,504,115,3770,18
68551,12,177,202,148,1462,29
39640,175,3407,934,2750,20525,657
63318,26,257,359,216,9379,41
17337,10,125,1377,99,5408,26
41597,41,610,901,464,17780,146
19593,11,528,1336,316,13599,212
35822,21,438,1023,328,13978,110
12410,186,3659,1449,2063,25555,1596
38026,41,988,964,727,27009,261
56060,2,93,588,67,4097,26
63103,27,519,365,415,7256,104
11686,45,2195,1457,1187,12809,1008
11176,218,13257,1461,8671,62741,4586
50196,86,1596,764,1298,26408,298
25451,2004,86809,1230,60759,479594,26050
14705,227,4866,1418,3150,21392,1716
11452,196,8294,1459,4920,31806,3374
4272,421,11696,1527,8151,57184,3545
69806,19,148,160,124,4997,24
66805,3,68,259,45,2716,23
60674,49,352,441,292,7161,60
18988,25,799,1347,497,15306,302
19130,22,413,1344,334,23018,79
46147,4,66,846,52,4015,14
20994,9,227,1312,159,7722,68
30454,7,218,1126,130,4713,88
58283,4942,66357,523,52636,174082,13721
66289,185,3176,275,2423,32806,753
25846,28143,1241232,1222,727603,3799646,513629
60718,842,8097,439,6543,32022,1554
40914,3966,63481,914,48740,481755,14741
64039,18,188,339,143,6933,45
67892,5,40,224,31,2205,9
54641,96,1784,629,1341,15102,443
31547,54,1152,1108,837,10859,315
4582,250,15358,1523,9922,59189,5436
17796,4,93,1368,63,2583,30
58438,72,901,518,625,11268,276
44928,71,1264,859,904,12762,360
90,88,2605,1565,1786,45529,819
63978,23,209,340,162,9472,47
3504,76,1864,1535,1458,112782,406
22828,0,0,1282,0,3669,0
54805,1249,15222,623,11359,63983,3863
21472,33,754,1303,488,9304,266
38373,58,963,955,744,9769,219
10865,7,402,1464,234,7677,168
62592,92,2066,378,1635,21648,431
32571,62,929,1091,658,10090,271
50654,26,497,753,397,8970,100
35759,10,162,1024,129,16081,33
15979,212,5550,1399,3788,31811,1762
15767,48,1108,1403,746,24679,362
8107,8,658,1478,408,13155,250
5773,370,13147,1508,7934,72482,5213
59310,9,97,490,70,3588,27
49630,9,126,779,98,3929,28
18215,110,5327,1361,4175,60080,1152
54839,111,800,622,622,7157,178
11799,196,12393,1456,7101,67146,5292
23270,5,327,1275,224,11319,103
13863,301,14884,1429,9017,99699,5867
46009,219,7974,847,6153,23756,1821
15528,17,476,1406,369,20371,107
32674,8,229,1090,178,8137,51
36118,154,3371,1015,2899,30678,472
30136,137,4090,1132,3085,95422,1005
21617,215,4394,1301,2880,38141,1514
31783,70,1868,1104,1306,14421,562
58742,22,178,508,144,2841,34
30759,4828,150941,1120,116690,570915,34251
53530,273,4142,668,3206,30826,936
21278,1,58,1306,39,2157,19
3782,151,7264,1532,4763,52389,2501
43397,304,2902,874,2131,16793,771
24812,50,1051,1243,688,13945,363
12972,13,1018,1442,580,30465,438
650,393,6752,1559,4692,43141,2060
38476,26,808,952,586,14006,222
25899,171,4314,1220,2888,37773,1426
52797,27,264,688,221,6034,43
70421,13,151,139,123,4875,28
58007,20,97,533,67,6337,30
17994,3,716,1364,268,11715,448
41148,28,504,911,395,9064,109
62226,3,43,388,36,2544,7
31998,91,4261,1101,2845,16599,1416
57385,39,678,551,472,23415,206
9074,14,923,1474,581,17232,342
56115,922,16661,586,14058,162904,2603
63950,25,269,341,239,5250,30
40898,38,846,915,714,9284,132
51917,22,167,719,122,3405,45
34471,13,977,1054,652,12268,325
48741,2,49,805,35,5247,14
69729,20,204,163,175,5632,29
25447,45,2122,1230,1237,16088,885
29110,40,2386,1153,1484,35463,902
5161,29,600,1515,430,13104,170
30569,102,2939,1124,2031,24328,908
5640,82,3121,1509,1824,34893,1297
13351,115,2082,1436,1365,12853,717
19655,973,18065,1335,12116,178982,5949
19092,123,3381,1345,2395,32158,986
46885,2967,40501,836,28700,186835,11801
43813,6,58,872,49,6459,9
13930,3328,120678,1428,71973,472644,48705
33066,29,640,1082,416,19354,224
19978,50,1382,1329,938,7899,444
30269,60,1749,1130,1068,19006,681
26175,3,322,1214,193,11334,129
17003,67,1771,1383,1234,12454,537
34461,12,209,1055,132,8518,77
36728,960,16438,999,11500,77513,4938
64418,18,216,327,180,7374,36
26059,859,17745,1216,12817,83212,4928
9974,165,3846,1470,2276,27082,1570
61469,28,463,413,386,9354,77
12454,5333,239309,1449,157231,482381,82078
2534,93,1883,1545,1127,10195,756
14762,29,2381,1417,1617,22695,764
65575,19,178,295,119,5638,59
28771,4,89,1160,47,1643,42
37967,0,17,965,15,4727,2
67020,7,181,252,133,4568,48
17001,4,155,1383,122,9615,33
24655,59,760,1247,681,48400,79
32585,9,215,1091,142,5386,73
22264,620,16701,1292,10888,96931,5813
21272,100,2626,1306,1908,20351,718
36523,4,206,1002,149,20170,57
21140,18,617,1309,417,16524,200
47233,43,780,831,568,6348,212
64587,4,50,322,27,1198,23
43709,331,6967,872,6124,55597,843
28973,33,515,1155,343,4817,172
32358,4,159,1095,102,15361,57
13522,187,5403,1434,3398,42401,2005
51017,106,2190,744,1648,30860,542
36386,286,2257,1007,1732,27963,525
54040,29,271,651,228,8844,43
27160,21,608,1192,367,9344,241
4891,42,711,1518,536,15574,175
14945,18,909,1415,656,14728,253
40254,22,510,925,391,12729,119
53123,1,132,677,99,2965,33
54453,208,3829,637,3239,38511,590
14220,26,465,1424,376,13767,89
3419,165,5628,1536,4043,26231,1585
11053,11,378,1462,240,10909,138
56817,9,145,566,121,4817,24
63770,15,270,347,196,3976,74
14350,16,1448,1422,954,25747,494
21709,337,8885,1299,6008,58665,2877
13690,94,3276,1432,1963,58802,1313
27231,52,1866,1191,996,26462,870
32060,6923,141769,1078,91446,294581,50323
34270,25,276,1059,206,3119,70
10199,6,164,1468,102,7029,62
15323,5,143,1410,100,11950,43
27445,132,5864,1186,4542,67217,1322
56588,4957,76451,573,51935,317916,24516
55963,486,6592,591,4511,37179,2081
16234,7,226,1395,182,14942,44
59795,26,307,473,237,5916,70
52655,12,91,693,73,4237,18
6259,19,656,1502,475,32298,181
42548,3,52,889,37,4201,15
49068,240,6380,795,5153,45406,1227
28024,202,12156,1173,6262,79317,5894
5591,12,1166,1510,628,42126,538
31807,726,10149,1103,6276,40383,3873
28513,72,1189,1164,731,28914,458
15149,168,3154,1412,2207,51190,947
69042,0,15,185,11,563,4
36756,154,3597,999,2692,19573,905
11764,7043,262456,1456,157932,1309372,104524
61252,2575,31327,419,26098,100026,5229
61830,1660,31776,402,25778,171552,5998
44654,218,2913,862,2555,22264,358
16420,7,223,1392,152,8810,71
35951,208,2499,1019,1999,34933,500
2485,20,694,1545,519,18115,175
62010,99,2112,396,1678,17816,434
14874,45,2228,1416,1432,48796,796
61511,21,391,412,286,9846,105
10777,92,1801,1464,1256,33259,545
4517,17,645,1524,453,16560,192
65143,41,866,305,526,7537,340
25469,882,12537,1230,8657,95864,3880
46405,55,1130,843,888,23852,242
55644,576,7648,599,6285,45052,1363
2202,29,861,1547,616,10857,245
42109,1089,20823,895,14033,108071,6790
49740,144,2808,776,2395,26445,413
54365,11,128,640,95,3670,33
12371,55,3144,1450,1523,25524,1621
11100,396,7520,1462,4751,42309,2769
17762,38,879,1369,611,13454,268
37126,390,11921,988,9596,116143,2325
45168,2,38,856,25,3866,13
29964,105,2402,1136,1675,16624,727
24932,9,356,1240,257,10150,99
24509,380,10320,1250,6544,50973,3776
4949,334,7176,1518,4936,37793,2240
32090,411,8694,1099,5535,30771,3159
53826,110,2683,652,1762,10709,921
25747,22,312,1223,246,5985,66
57953,219,2715,535,2260,34567,455
27706,13,126,1180,89,5530,37
50810,16,261,749,199,5615,62
5187,12,403,1514,293,8225,110
3296,557,6084,1537,3836,266424,2248
51838,60,650,721,478,20489,172
59996,387,4915,466,3965,36271,950
20851,210,4896,1314,3067,36273,1829
35142,191,3321,1038,2410,24875,911
9747,117,4941,1471,2624,17490,2317
16194,32,1488,1396,956,39524,532
8144,82,2177,1478,1350,44922,827
35393,33,1060,1032,772,18765,288
35082,11,254,1040,169,14618,85
5722,40,990,1508,608,41196,382
64493,33,345,325,287,5999,58
19455,9,235,1339,169,7974,66
36200,15,412,1013,328,11134,84
21191,45,939,1308,646,15029,293
10184,36,1128,1468,730,39360,398
66506,23,333,269,254,5213,79
24686,5,254,1246,182,18676,72
65786,544,5237,290,4446,40083,791
20656,214,5634,1318,3690,98882,1944
25065,23,811,1237,565,33918,246
9973,86,1239,1470,748,10790,491
10432,0,0,1467,0,10249,0
57567,4,176,547,44,5963,132
15896,212,3942,1401,2833,29419,1109
41786,303,4259,901,3523,63233,736
27068,1420,29341,1194,18823,203508,10518
30620,4197,91129,1123,64995,228556,26134
4539,281,7962,1523,5920,149486,2042
53650,126,1417,664,1170,18662,247
21577,530,20237,1301,11730,83826,8507
2363,23,866,1546,617,23986,249
30068,5,52,1134,43,3345,9
63111,1024,12491,365,9687,92156,2804
18201,0,160,1361,136,8604,24
28750,8,222,1160,120,16568,102
27608,29,847,1182,572,21753,275
30032,94,1726,1135,1258,23908,468
23920,443,6785,1263,4738,86810,2047
14249,0,0,1423,0,10126,0
11589,45,1650,1458,996,10622,654
12770,824,33967,1445,19114,109182,14853
65203,77,1413,304,1130,12253,283
9226,4,251,1474,155,11146,96
4483,356,27236,1524,18337,138639,8899
1630,35,1190,1552,763,19147,427
28964,228,4309,1155,2939,43423,1370
33972,32,362,1066,262,13911,100
63433,0,20,356,14,1530,6
34310,3,84,1059,52,3261,32
1258,18,812,1554,554,21489,258
6147,73,2352,1503,1641,31425,711
22726,149,2289,1284,1616,34703,673
9649,229,10409,1472,6477,45420,3932
1129,60,1577,1555,1067,27394,510
16803,31,847,1386,646,34445,201
54793,1019,12465,624,9995,142656,2470
6684,6034,282159,1496,165220,1708648,116939
1299,635,9878,1554,6889,50887,2989
30577,6,78,1124,54,4855,24
68578,6,109,201,84,2308,25
44903,23,459,859,308,5256,151
36901,50,624,995,508,6423,116
15761,44,889,1403,647,28242,242
52962,21,628,683,466,18906,162
8551,46,1817,1477,1097,24731,720
33274,32,666,1078,465,10679,201
67468,21,446,236,364,6161,82
56540,77,1466,574,1123,24031,343
2453,74,2043,1545,1415,23619,628
50543,13,258,755,198,11369,60
27396,40,1453,1187,970,26519,483
49417,85,1285,784,1156,18838,129
36131,9,250,1014,166,8848,84
55547,30,355,602,316,8447,39
42602,27,361,888,308,8189,53
59101,45,414,497,327,10812,87
61181,138,3792,422,2613,25680,1179
22925,8,287,1281,197,6955,90
14376,13,377,1421,303,19753,74
56488,40,746,575,584,8000,162
24218,146,3443,1257,2387,50819,1056
17761,260,5645,1369,3932,32585,1713
34632,213,2755,1051,2356,63746,399
66813,3,23,259,16,3054,7
16241,4,186,1395,130,4820,56
2064,65,1956,1548,1278,12214,678
14007,11171,348440,1427,198604,884735,149836
14775,17,242,1417,145,10657,97
2582,105,4631,1544,3113,31103,1518
12779,244,13883,1445,8828,74557,5055
67203,57,1019,246,823,20372,196
5513,12,239,1511,154,10738,85
17913,79,2466,1365,1911,19973,555
42322,478,6484,893,5522,60832,962
59253,263,3131,492,2449,27556,682
60992,89,788,429,619,9768,169
28072,24,638,1173,392,25835,246
13955,7,511,1428,294,19136,217
70328,9,78,143,76,9557,2
58903,33,319,503,241,5817,78
52103,45,543,712,400,7398,143
64433,22,292,326,217,4993,75
35109,99,2585,1039,1900,30618,685
6174,37,918,1503,631,18841,287
52836,31,181,687,151,20138,30
36779,7,86,998,67,2595,19
64624,64,839,321,690,6006,149
63991,1263,23329,340,18085,75441,5244
62558,6,105,379,88,3171,17
53705,4960,70861,662,57208,338748,13653
61378,1,30,416,20,3696,10
34882,70,442,1045,329,12938,113
55478,1,28,604,26,3317,2
32712,203,5016,1089,3157,27379,1859
30841,6,289,1118,173,4480,116
17333,11,580,1377,410,20256,170
50876,98,1741,747,1414,30609,327
68010,10,108,220,78,4511,30
19029,35,1602,1346,1140,66576,462
3900,28,973,1531,756,11383,217
22674,671,15298,1285,9729,119923,5569
30014,60,1676,1135,1049,12342,627
61247,72,1042,420,865,25030,177
33006,179,2803,1083,2366,23709,437
25638,10,472,1226,338,28490,134
1453,210,9073,1553,5754,151414,3319
26022,603,8186,1217,4536,35158,3650
20806,12,790,1315,597,8117,193
31240,129,7919,1112,4696,44335,3223
47316,6,175,830,141,6132,34
44024,5,197,869,148,6235,49
66372,206,2126,273,1765,16721,361
28923,355,10482,1156,7326,39219,3156
17208,12,403,1379,307,10537,96
6185,20,822,1503,464,9724,358
59461,139,2090,485,1624,12199,466
65248,21,112,303,89,5798,23
5644,1162,35685,1509,22382,289482,13303
8624,343,5389,1476,3326,42808,2063
47712,2180,29062,825,23351,161079,5711
65140,106,800,305,642,6287,158
32605,22,841,1091,472,18872,369
41594,49,433,904,353,7906,80
9979,12,301,1470,195,5561,106
61966,40,292,397,238,3459,54
37190,10,260,986,204,7758,56
62449,51,531,382,390,6811,141
67812,629,11549,226,9325,72799,2224
31697,3077,75712,1105,45141,372460,30571
18727,39,991,1352,707,54014,284
54711,31,246,627,209,11293,37
814,6571,174595,1558,119469,583974,55126
41942,39,483,898,384,7010,99
41752,41,444,901,355,5190,89
50331,146,2452,761,1797,22169,655
36394,17,356,993,244,6334,112
29465,22,546,1146,317,15237,229
61203,16,206,422,165,5191,41
56621,1,44,572,38,2947,6
56638,49,368,571,312,7981,56
24359,1534,14785,1253,10007,98101,4778
7420,6,256,1487,174,13616,82
15503,16,763,1407,517,28267,246
18553,12,680,1355,492,13533,188
60320,7,158,455,100,5033,58
62872,10,173,371,106,3662,67
51249,46,519,737,388,6814,131
5323,20,497,1513,314,21547,183
37099,4,72,989,66,4373,6
39884,94,1915,931,1394,14704,521
2531,1423,60913,1545,38844,331288,22069
7524,188,6497,1485,4653,80411,1844
56017,30,545,589,415,14693,130
49085,79,800,794,688,10837,112
31839,763,20531,1103,12368,92396,8163
12246,164,7767,1451,4244,30465,3523
16118,25,867,1397,536,8505,331
26766,1301,38412,1201,25532,120668,12880
28978,5665,180337,1155,121760,720442,58577
49671,0,44,778,25,1941,19
8964,5,140,1475,92,3652,48
18268,79,2162,1360,1524,19331,638
15659,935,32351,1404,23253,157966,9098
17813,153,6167,1368,4177,34436,1990
56832,22,411,565,319,7643,92
58435,37,397,519,345,9161,52
66373,4,49,273,41,2826,8
25715,13,188,1224,170,6351,18
18082,40,1051,1363,827,32171,224
32167,177,2180,1098,1430,17845,750
20946,62,1207,1312,792,22089,415
46022,15,457,847,370,10475,87
59896,53,619,470,506,8083,113
49274,19,291,784,236,12938,55
20573,305,7923,1319,5521,52527,2402
755,46,2421,1558,1611,30039,810
28688,717,18033,1161,11907,121265,6126
30125,54,2933,1132,1680,19928,1253
54329,24,364,642,271,10297,93
29173,5,372,1151,234,9338,138
50590,26,286,754,208,9386,78
55281,6,105,609,76,5577,29
15675,433,10259,1404,7298,85631,2961
14538,5,66,1419,47,4866,19
15419,708,20113,1408,14503,126723,5610
15566,7,324,1406,198,8562,126
50722,66,868,752,752,22376,116
5208,124,2581,1514,1808,28117,773
27252,9,110,1190,80,8856,30
33263,320,16523,1078,11805,68982,4718
55207,540,6406,612,5324,43359,1082
70403,86,1079,140,989,9610,90
49507,18,417,782,329,11028,88
37429,566,18272,979,14799,204032,3473
13063,29,622,1440,369,15286,253
37401,0,32,980,27,4645,5
23440,61,700,1272,437,7537,263
32807,67,1048,1087,625,7151,423
61605,1044,21666,410,15518,58942,6148
47775,23,297,824,243,11680,54
55077,66,793,615,488,10016,305
16618,17,515,1389,295,9149,220
27383,3,218,1187,120,7562,98
2487,12,552,1545,374,14324,178
53202,10,130,676,103,4972,27
44449,28,260,864,214,7253,46
33781,16,294,1069,210,5138,84
29698,47,3191,1142,1906,21158,1285
39067,9,237,941,198,5763,39
28357,21,642,1167,399,12029,243
56263,32,212,582,166,4232,46
16843,26,748,1385,506,16410,242
49704,184,3062,777,2449,30409,613
35839,250,3527,1022,2807,95069,720
68222,11,242,214,163,5665,79
50698,6303,133416,731,102872,573243,30544
64277,56,1040,330,692,11801,348
53358,48,354,672,274,8091,80
3941,30,1400,1531,967,12848,433
48876,19,306,801,237,8878,69
58369,160,3855,521,2865,25186,990
38078,227,3828,962,2885,26913,943
18367,34,849,1358,598,10515,251
24676,90,1213,1246,916,20587,297
30548,54,1215,1124,713,15467,502
61147,20,316,423,222,7034,94
20921,95,2228,1313,1508,17294,720
48886,10,190,801,142,8157,48
49963,6723,117191,771,80592,341051,36599
44381,53,1185,865,923,20982,262
30128,368,11775,1132,8177,108250,3598
26192,81,1660,1214,1479,22954,181
40129,798,21042,927,15625,70405,5417
60264,1490,31694,457,25978,172242,5716
1715,71,3893,1551,2748,22817,1145
53696,261,3365,663,2912,56704,453
19868,40,939,1331,710,12043,229
64881,13,161,313,138,7059,23
32769,3074,105692,1088,72656,244992,33036
66447,19,341,271,268,6298,73
354,103,2859,1562,1685,53508,1174
17393,12,149,1376,110,8883,39
51461,0,0,732,0,5249,0
46729,97,2754,838,2185,28759,569
18430,31,1122,1357,737,9544,385
47815,71,1661,824,1137,45496,524
13061,1186,22389,1440,13655,174845,8734
28345,26,931,1167,610,15303,321
47370,2,78,830,64,3646,14
69652,26,209,165,171,3419,38
14327,271,6678,1422,4870,56919,1808
35962,644,13394,1019,11294,80943,2100
29502,12,216,1146,146,6258,70