Mod,likes,downloads,time,unique_dl,views,dl_dif
41839,27,668,938,517,13472,151
24409,188,3138,1290,2098,14844,1040
58176,70,1116,565,822,14920,294
4820,23,469,1557,387,27594,82
3100,259,14051,1577,7235,83807,6816
38403,110,1534,992,1283,19023,251
63078,33,929,403,859,9048,70
65590,7,101,333,96,8853,5
6782,14,519,1533,222,8304,297
64044,115,1164,376,1014,8899,150
4253,182,4341,1565,2873,73019,1468
5146,138,5887,1553,4349,19817,1538
60338,23,170,492,127,2864,43
44197,2680,46543,905,39093,186698,7450
16537,124,7630,1428,4587,23111,3043
62033,7,94,433,86,4025,8
59950,9,74,506,61,3038,13
62538,10,109,417,106,4094,3
436,12735,336316,1599,184619,656230,151697
9567,34,1844,1510,584,15634,1260
26479,18,1055,1246,754,16712,301
5953,30,749,1544,471,14793,278
29315,77,1859,1187,1487,46237,372
18893,172,3487,1387,2506,16687,981
55567,101,913,640,883,27983,30
25966,21,548,1257,387,8291,161
8001,15,441,1518,276,13292,165
8067,141,3036,1517,2098,23910,938
4341,171,3997,1564,2781,49317,1216
58448,201,2101,556,1624,13167,477
48594,21,406,847,305,13904,101
23560,603,13099,1308,6592,37332,6507
20366,286,11574,1361,5166,86274,6408
37689,52,1156,1010,973,26552,183
56286,65,864,619,658,16723,206
59280,18,315,529,187,6788,128
3238,32,800,1576,491,8901,309
16921,13,637,1422,446,21025,191
60032,4,75,503,55,7089,20
18832,179,4781,1388,3474,66881,1307
32182,420,7033,1136,3289,27513,3744
31337,16,556,1148,260,7747,296
11120,18,483,1500,324,9183,159
30338,63,1287,1166,837,11267,450
11604,112,3978,1496,2298,27944,1680
8545,28,982,1515,633,13628,349
6245,414,11594,1540,8035,53708,3559
26444,9,136,1246,79,17868,57
33497,2,246,1112,143,4806,103
22088,10,313,1332,194,9175,119
60140,28,511,499,445,10991,66
8019,8,651,1517,482,18218,169
57591,5653,83216,584,58959,238815,24257
1880,58,1217,1588,804,12276,413
14860,226,7311,1454,4439,35779,2872
19349,83,2629,1379,2061,98422,568
33766,5290,98660,1107,66289,434125,32371
56736,145,3044,606,1606,21302,1438
65781,17,198,328,197,5575,1
12175,1743,64027,1490,36435,197179,27592
12200,3,276,1490,164,6146,112
54416,4554,62059,676,42497,229008,19562
15784,58,1881,1441,1181,28363,700
26278,25,547,1250,333,6641,214
27199,13,574,1229,305,16439,269
34641,144,1146,1089,899,12054,247
34000,44,656,1103,468,14716,188
1471,109,2360,1591,1432,38967,928
51849,33,586,758,483,14204,103
28429,324,7404,1204,4835,44973,2569
1305,81,3086,1592,1869,35974,1217
29702,149,4289,1180,2503,39272,1786
25532,95,2246,1267,1599,14268,647
49556,8,64,819,64,6329,0
53609,92,1078,704,977,27109,101
60448,12,73,488,63,4889,10
37055,51,870,1028,748,13479,122
51964,9,127,755,74,8374,53
3293,394,10952,1575,8500,69831,2452
9414,31,1866,1511,1192,42765,674
12849,22,926,1482,535,32687,391
49820,24,434,812,345,5995,89
49525,208,3231,820,2375,55185,856
63072,5,70,404,52,4983,18
29520,8,611,1183,367,19689,244
257,9,348,1601,205,15660,143
23065,547,15518,1316,10484,66912,5034
8934,363,7936,1513,5657,101026,2279
48838,8,293,840,134,2861,159
60712,47,839,478,625,6854,214
31117,47,1164,1152,734,12855,430
54589,586,15708,670,8471,134217,7237
51689,22,232,763,206,15010,26
11476,37,2910,1497,504,19068,2406
39580,61,867,973,648,21288,219
55207,540,6406,650,6199,49115,207
20315,760,18064,1362,8521,58243,9543
18056,2172,65976,1401,37975,466441,28001
40471,36,581,960,505,13802,76
47311,74,2300,868,1652,15048,648
64879,100,1082,351,839,14829,243
23145,61,1177,1315,1033,20577,144
30440,3,73,1164,52,5180,21
1779,1062,45243,1589,27249,300691,17994
4512,32,738,1562,574,19099,164
15116,74,3132,1450,1107,36870,2025
30985,32,419,1154,403,72224,16
9711,40,763,1509,503,11241,260
18949,11,1076,1386,699,46903,377
25913,5,275,1258,160,5813,115
44782,2040,27473,898,19932,119563,7541
31435,58,916,963,732,8198,184
48927,146,2619,837,2327,28361,292
2951,233,4870,1579,3348,57431,1522
28697,398,9062,1198,5189,37400,3873
50216,34,884,802,844,12186,40
2997,24,919,1578,519,19945,400
5014,619,23061,1555,13788,238700,9273
63355,8,164,397,139,6168,25
22562,1066,24837,1325,15137,77716,9700
60523,206,2437,485,2395,48880,42
56088,53,1025,625,926,19977,99
11420,30,1016,1497,487,14206,529
56930,429,6071,601,5545,76628,526
58181,84,903,565,766,31549,137
52975,18,260,720,224,5753,36
69834,5,112,192,86,1312,26
32808,164,4905,1125,3584,35073,1321
29512,2064,37246,1183,19126,109088,18120
39600,230,6118,972,3434,55284,2684
14080,19,798,1464,468,20092,330
15277,153,3069,1448,2253,32993,816
2646,62,2450,1582,1626,49019,824
3366,79,4515,1575,3178,50245,1337
19740,10,327,1372,223,13883,104
35978,77,1253,1057,961,26413,292
14171,25,870,1463,633,22500,237
25989,143,4070,1256,2592,21889,1478
32566,61,1073,1129,690,16271,383
698,5,212,1597,174,9985,38
34250,88,1964,1098,1289,17381,675
54972,53,357,656,300,5900,57
8355,129,2592,1516,1777,21917,815
33800,24,685,1107,517,18802,168
24188,26,1081,1295,745,15272,336
28663,17,373,1199,203,11185,170
17147,15,498,1418,384,11270,114
18985,75,4005,1385,2622,25335,1383
50887,5975,89045,785,64070,301610,24975
11005,4825,166263,1500,89992,559977,76271
9813,77,5885,1509,3071,34528,2814
13306,466,18137,1475,14009,113316,4128
35421,38,1043,1069,717,22729,326
5075,146,6756,1554,4485,57854,2271
27715,14,323,1218,224,6342,99
24894,582,11594,1279,6831,94121,4763
52614,220,2315,732,1409,35282,906
29276,50,1964,1187,1263,27577,701
65898,9,135,325,107,4780,28
34547,7,191,1091,142,3651,49
63752,24,388,386,368,9753,20
61780,94,1239,441,891,16472,348
32750,14,355,1126,171,6434,184
37596,13,385,1013,239,11620,146
61183,19,410,460,321,7667,89
13644,101,3631,1470,2090,44181,1541
68290,4,67,249,55,3051,12
41084,35,597,950,506,10061,91
39780,664,6919,971,5785,39137,1134
2089,158,3588,1586,2589,93138,999
7318,206,3079,1526,2314,32563,765
37066,6,144,1028,92,2907,52
55923,14,305,630,243,9159,62
35460,50,519,1068,434,8412,85
67090,596,12071,288,10749,80811,1322
55186,77,1282,651,1267,15729,15
9235,16,324,1512,250,15122,74
35884,10,440,1059,351,9061,89
50775,8,278,788,215,7409,63
1708,3,190,1589,107,20628,83
53038,40,641,719,522,12628,119
14236,5,361,1462,273,10767,88
54698,0,258,666,214,5647,44
68090,502,11410,191,10453,154622,957
56001,5,51,628,43,5231,8
19725,12,822,1372,579,26600,243
39745,154,2838,971,2400,29204,438
25962,76,1636,1257,1289,32010,347
38420,37,942,991,778,14628,164
20564,1079,30419,1358,12474,139420,17945
26014,111,2444,1255,1666,25240,778
6857,5,123,1532,80,12687,43
27452,309,9717,1224,4764,57459,4953
23274,13,352,1313,293,24127,59
14003,263,5204,1465,3232,84734,1972
28310,11,356,1206,232,20538,124
5773,370,13147,1546,5995,73977,7152
58734,20,384,546,333,10042,51
59499,159,2760,521,2199,33037,561
25344,373,10627,1270,7394,34374,3233
36930,37,944,1032,698,26642,246
8987,1709,56112,1513,29175,158687,26937
8812,77,3866,1513,2018,56249,1848
46873,2740,75266,874,34228,254934,41038
13802,68,3122,1468,1597,30786,1525
31195,543,10066,1151,5240,30886,4826
51720,3,45,762,40,9949,5
5331,180,8771,1551,4640,104212,4131
65510,121,1248,335,1153,20555,95
20761,31,1604,1354,983,17102,621
66171,58,1988,316,1446,22807,542
12585,618,23177,1485,12900,93948,10277
19180,4448,114434,1382,65060,465278,49374
41637,613,13625,941,8824,74987,4801
55824,72,1049,633,830,142015,219
15646,164,4178,1443,2908,32759,1270
15462,12,398,1445,283,14682,115
55164,26,173,651,143,8207,30
63817,50,699,384,664,9949,35
34981,4358,81874,1080,51066,288414,30808
15828,22,770,1440,433,28747,337
42168,5,48,933,45,2840,3
55854,8,154,632,108,7411,46
2974,852,53894,1578,20190,287823,33704
26501,1228,28489,1245,19136,121303,9353
39790,1056,15150,970,11162,48656,3988
48000,99,1879,860,1431,32991,448
47371,33,732,867,447,20306,285
11578,52,1056,1496,635,15163,421
24780,149,2014,1282,1343,21709,671
17946,164,2990,1403,2319,39727,671
30603,143,1008,1161,835,14325,173
47153,37,487,871,454,34590,33
62200,19,203,427,172,6213,31
9640,16,740,1510,106,10850,634
3836,319,16780,1570,11341,200869,5439
15389,7258,206045,1447,114546,743264,91499
56763,14,269,605,214,11537,55
61371,5,91,454,63,4863,28
12292,40,1227,1489,688,27579,539
39030,149,3302,980,2000,24307,1302
42847,48,629,921,429,9843,200
1480,16,531,1591,418,8881,113
31325,2518,61389,1149,27811,241715,33578
49739,17,266,814,254,6279,12
53148,3588,69654,715,49830,333263,19824
37838,2,88,1007,51,9753,37
1477,1,52,1591,38,3796,14
32060,6923,141769,1116,65118,319565,76651
63635,1642,29944,389,27888,217913,2056
31565,21,932,1146,680,12399,252
52520,123,1591,733,1285,91678,306
9507,5,199,1510,122,14734,77
61516,22,338,450,335,13713,3
15342,31,1359,1447,919,21601,440
35050,835,14735,1078,10784,111878,3951
34083,1093,16734,1101,13212,177279,3522
21558,60,2192,1339,1483,31839,709
65343,9,92,339,87,5876,5
162,147,4914,1602,3265,57809,1649
61878,112,1041,438,809,14623,232
2685,57,2294,1581,1184,57590,1110
13048,3,132,1479,74,3943,58
5362,38,2487,1550,1133,16614,1354
44614,25,368,901,310,6106,58
7664,537,33754,1521,17953,211555,15801
59009,97,3153,538,1822,16538,1331
37782,318,3851,1008,2410,37671,1441
35002,4965,151420,1080,63578,782131,87842
54364,345,3214,679,2624,14438,590
39404,719,7477,976,5437,93877,2040
23513,28,1163,1309,629,17173,534
55136,16,211,652,199,6843,12
50395,189,2639,797,2219,37751,420
32181,247,5486,1136,3760,37118,1726
40502,58,1096,960,789,13290,307
5908,13,1051,1544,335,17493,716
3245,130,1609,1576,1063,17759,546
13564,2,258,1471,124,6458,134
5169,284,17452,1553,7369,78737,10083
22486,403,9083,1327,5661,61753,3422
22686,40,1188,1323,898,25625,290
26251,19,1179,1251,682,11752,497
53574,54,653,705,431,12349,222
26245,61,764,1251,566,9996,198
57214,8,107,594,86,7890,21
56087,92,746,625,711,6824,35
5812,609,30737,1545,19189,94217,11548
48855,798,14086,840,8230,72038,5856
29464,87,3458,1184,1935,29595,1523
64106,0,12806,374,10615,61577,2191
37075,43,1102,1028,888,21834,214
39061,40,1040,979,773,22381,267
25521,100,1875,1267,1237,25186,638
9971,90,1990,1508,1195,26052,795
28103,308,5971,1210,4890,57450,1081
24130,43,724,1297,536,10535,188
3191,16,1217,1576,622,25364,595
13082,1769,64688,1478,39340,335020,25348
63589,21,483,391,409,9286,74
65094,9,323,344,235,4400,88
8260,4,202,1516,139,14980,63
2345,124,2999,1584,2406,53935,593
24943,142,4046,1278,2180,45767,1866
63259,68,884,399,769,15866,115
34429,87,1814,1094,961,9049,853
41354,30,372,946,289,8753,83
7203,85,2135,1527,1412,50208,723
1654,150,4002,1590,3001,25328,1001
51123,49,788,778,678,14574,110
31499,784,11675,1146,7051,87709,4624
64124,28,552,372,476,7031,76
29147,22,475,1190,341,11500,134
19687,10,164,1373,145,17978,19
27520,68,1693,1222,958,18587,735
41376,8848,277164,946,117243,946364,159921
24490,30,1161,1289,721,11370,440
62502,8,101,418,92,3549,9
3543,120,6186,1573,2992,34260,3194
63624,5,181,385,117,9067,64
26343,97,2247,1248,1236,20699,1011
38393,739,26811,992,8461,118256,18350
49256,142,1215,827,1019,20046,196
51803,18,515,759,383,10018,132
17834,55,1852,1405,1071,14383,781
16748,43,875,1425,651,18238,224
68916,46,351,227,300,3376,51
20795,35,278,1354,248,12774,30
1007,41,1524,1594,1146,27470,378
8821,4,280,1513,184,9243,96
15467,359,8600,1445,5880,55199,2720
37401,0,32,1018,29,4822,3
4646,418,20009,1560,11715,76485,8294
30286,14,278,1168,186,6354,92
48193,117,1269,858,1030,17131,239
30474,4,211,1164,188,12226,23
2224,1860,60498,1585,39051,273672,21447
18358,40,1585,1396,1177,10857,408
58706,58,1188,547,957,32111,231
2584,52,1317,1582,820,20079,497
35348,19,444,1071,289,9072,155
21051,6,190,1349,116,9656,74
62880,47,780,409,564,10548,216
50736,54,791,789,569,21353,222
7386,189,3352,1525,2371,23539,981
54401,97,702,677,619,11899,83
54881,27,261,659,189,7451,72
24170,66,2288,1296,1373,74083,915
50760,76,855,789,769,9570,86
52367,62,439,742,365,9440,74
22214,173,2780,1331,1700,36068,1080
56033,9,281,627,175,6450,106
34583,4246,119418,1091,84500,456280,34918
32514,4,171,1130,141,8676,30
3559,3,163,1573,121,18429,42
50079,39,663,805,509,13572,154
43099,19,420,918,372,11788,48
13463,21,1043,1473,522,10550,521
35444,18,284,1069,190,4052,94
11128,1684,76189,1499,45297,191955,30892
27345,216,2223,1226,1554,24426,669
8294,5,155,1516,98,10977,57
30920,26,1031,1155,578,10738,453
22823,101,2150,1321,1314,14401,836
54842,7,61,660,44,5200,17
26692,17,776,1240,473,11775,303
49103,35,701,832,564,17978,137
50401,73,1042,797,779,9625,263
49816,70,940,812,681,18178,259
7312,5,285,1526,197,12433,88
866,3461,130597,1595,87752,349380,42845
60852,142,1448,472,1204,19509,244
28494,226,4487,1203,3098,68786,1389
55607,2203,23292,639,20859,123754,2433
59464,249,2918,523,2718,33196,200
57953,219,2715,573,1910,38036,805
55707,684,8764,636,8267,68443,497
37092,5,124,1027,107,5175,17
62329,24,159,423,136,6760,23
26599,259,3937,1242,2597,39374,1340
12964,77,2044,1480,858,24245,1186
38116,55,575,999,372,6318,203
55355,85,646,645,586,10350,60
8683,1315,36928,1514,25237,201746,11691
25832,3950,169903,1260,62189,652425,107714
30525,176,6275,1162,3295,24831,2980
28686,494,7994,1199,4550,31507,3444
31652,3,88,1144,57,3018,31
27318,40,609,1227,401,15207,208
65923,47,391,324,355,12981,36
19063,309,4743,1384,3223,27218,1520
21829,83,1668,1336,1102,30809,566
50840,202,3056,786,1898,47497,1158
46265,51,1035,882,817,15269,218
19265,259,5742,1380,4134,44582,1608
59629,49,568,517,365,15343,203
56049,1255,18485,626,12094,129252,6391
50758,118,2011,789,1078,12996,933
57722,29,382,580,276,3518,106
49482,645,8372,820,7976,88006,396
23115,283,4999,1316,2762,45218,2237
61534,27,325,450,254,6852,71
14752,264,4983,1455,3639,32518,1344
23547,161,2770,1309,1895,27805,875
29402,28,1048,1185,640,11111,408
4636,301,6206,1560,3984,24386,2222
33292,31793,750360,1116,386995,2327934,363365
4866,1735,35124,1557,19798,198147,15326
64154,269,4692,372,3079,34870,1613
18484,45,1887,1394,1322,16306,565
7001,256,7946,1530,5399,45246,2547
33541,6,243,1112,107,5064,136
50643,101,1446,791,1226,25594,220
18625,46,4564,1391,2610,52830,1954
2192,129,3785,1585,2699,20995,1086
39925,139,2937,969,2279,32010,658
56894,2006,22730,602,11783,459034,10947
53882,81,1276,695,665,24597,611
41964,44,471,936,371,9895,100
11584,20,1196,1496,687,14338,509
63399,10,96,395,94,7312,2
27591,36,760,1220,426,7475,334
29998,9,363,1173,253,11149,110
50752,387,5621,789,4443,62774,1178
62721,42,384,412,333,8023,51
57988,166,2337,572,1940,62803,397
8535,2919,97533,1515,46927,391121,50606
33884,95,2243,1105,1240,17099,1003
66642,31,422,303,373,10085,49
30357,29,715,1166,491,9379,224
7866,85,954,1518,660,11739,294
41549,257,5574,943,2926,51342,2648
32957,31,511,1122,346,5214,165
9904,2535,95779,1508,48450,518223,47329
19291,1305,39561,1380,26553,259543,13008
38304,4,101,995,74,2715,27
12548,11,1017,1485,491,11997,526
54483,210,2898,674,1332,30315,1566
53482,19,174,707,135,5760,39
7325,8,270,1526,183,23093,87
56555,37,457,611,398,6173,59
5182,8,345,1552,183,27346,162
13232,119,3250,1476,1833,31500,1417
2586,15,485,1582,326,12316,159
4112,18,683,1567,445,23124,238
40538,165,2439,959,2011,15383,428
19699,68,2949,1372,1704,74001,1245
12795,122,3772,1482,2313,71457,1459
62229,1,86,426,65,1607,21
64945,2,21,349,13,2534,8
51731,0,0,762,0,3535,0
62549,13,241,417,183,5411,58
64778,148,1271,354,1136,21841,135
9001,88,2684,1513,1144,30598,1540
15618,276,5762,1443,4396,35673,1366
40978,31,417,952,302,21349,115
4351,726,21567,1564,15420,68948,6147
21151,90,3542,1346,2448,63578,1094
44353,41,471,903,322,11628,149
50541,3,73,793,54,4215,19
59939,17,202,506,161,7320,41
57235,2279,45650,593,37381,159823,8269
3122,20,777,1577,589,28185,188
1894,40,820,1588,598,29637,222
31606,60,1279,1144,646,7689,633
4669,37,1091,1559,695,26028,396
23954,14,225,1301,168,6066,57
14813,12,308,1454,221,12956,87
23911,190,4923,1302,3610,115135,1313
59084,7,91,536,91,10501,0
32068,127,5308,1138,3316,50201,1992
21540,1729,36698,1340,16181,228547,20517
34968,81,1928,1079,1451,42041,477
11148,180,6693,1499,3792,47583,2901
20852,119,3285,1352,2408,47928,877
16719,10,351,1425,198,15392,153
27262,119,2648,1228,1597,17178,1051
30217,167,6918,1169,4660,44699,2258
55850,456,7212,632,6257,52175,955
68245,4,60,251,33,4118,27
60072,47,763,502,717,16497,46
18494,64,2603,1394,1941,35927,662
23862,24,708,1302,573,64428,135
67644,9,275,261,251,8533,24
53023,190,1661,719,1281,17086,380
55813,2,73,633,27,2936,46
19282,0,0,1380,0,6460,0
64187,20,278,371,242,9672,36
9645,5062,112433,1510,67510,584536,44923
26135,145,5275,1253,2665,51731,2610
41126,11,121,949,101,11616,20
38085,180,2490,1000,1751,33051,739
25286,28,678,1271,448,11333,230
2658,1615,83134,1582,43076,577249,40058
53415,17,146,708,137,4582,9
35689,50,1609,1062,1094,24561,515
9335,711,16732,1511,9540,48833,7192
35928,3,92,1058,52,5402,40
50920,164,2900,784,2188,30618,712
68154,2,31,254,22,5691,9
12799,11,750,1482,340,28852,410
66448,0,23,309,19,4217,4
16061,11,411,1435,302,9363,109
66688,131,2747,301,1429,31234,1318
52516,3858,86758,736,41245,485486,45513
14395,29,793,1459,446,26741,347
25398,61,1914,1269,870,14444,1044
14216,1388,43277,1462,30979,286845,12298
57383,30,488,589,446,18552,42
55236,324,4120,649,3567,72107,553
49092,61,975,832,676,15980,299
35962,644,13394,1057,11235,89026,2159
61893,11,82,433,75,5451,7
40732,93,1043,956,886,19700,157
7252,706,19959,1526,14451,137261,5508
33129,45,1435,1119,678,12258,757
24153,13,459,1296,333,15673,126
69511,2,72,208,53,5605,19
53244,21,306,713,195,9299,111
25413,20,746,1269,500,10058,246
5813,34,887,1545,646,13188,241
4522,24,826,1562,553,28829,273
39532,1225,25853,974,14155,148139,11698
9629,244,4392,1510,3176,44208,1216
733,91,3023,1596,2106,77149,917
22471,186,5161,1327,3420,41719,1741
27548,45,1372,1221,744,16097,628
22425,350,18143,1328,8286,100110,9857
40435,47,1045,961,746,19132,299
44541,5618,246159,901,181813,372785,64346
30425,46,1164,1165,647,17151,517
58134,6,103,567,65,4868,38
311,9407,171751,1600,133086,688534,38665
64056,27,382,376,329,9115,53
26459,53,761,1246,610,22791,151
32057,947,18650,1138,12699,172297,5951
4538,12,389,1561,285,19844,104
12318,154,5351,1488,2598,42474,2753
4004,125,4013,1568,2471,63241,1542
10552,261,8984,1504,4183,45629,4801
51344,84,1120,772,990,14523,130
64396,6,154,365,138,3015,16
54199,459,5118,680,4137,44485,981
18818,4907,121745,1388,69210,350470,52535
42602,27,361,926,304,8457,57
33596,104,2777,1111,1800,23469,977
19379,299,11560,1378,6063,68453,5497
25783,7,139,1261,106,6672,33
37384,8,213,1019,195,21931,18
64902,1,31,350,11,3561,20
22965,129,3223,1318,2056,40069,1167
18750,40,1980,1389,1062,22624,918
61644,25,305,446,276,6034,29
32365,41,1433,1133,713,41302,720
22757,20,408,1322,312,13261,96
56585,11,80,611,64,4902,16
22174,5,140,1331,108,3551,32
58514,43,445,554,358,7590,87
65822,33,349,322,311,8743,38
60942,159,2194,469,2127,15348,67
57462,9,108,588,74,3242,34
55872,108,1046,632,748,16514,298
11864,61,6561,1493,2523,61004,4038
9287,73,5005,1512,2691,25971,2314
42023,8,140,935,79,6444,61
63728,6,69,386,64,5000,5
29969,5,233,1174,152,17677,81
1393,213,4881,1592,3569,175724,1312
60287,126,3105,494,1918,32698,1187
24379,7,263,1291,174,9494,89
34416,278,4968,1094,3294,58585,1674
27780,907,16083,1217,9794,88829,6289
64203,7,153,371,78,4297,75
48711,27,689,844,525,33550,164
65881,11,94,325,76,5606,18
40411,10,334,961,272,5941,62
56768,0,359,605,318,12538,41
56056,2424,57161,626,52517,248523,4644
48498,329,4216,851,2950,47102,1266
61489,66,958,451,615,11931,343
10896,62,1374,1501,839,13755,535
18018,55,1313,1402,679,19623,634
24445,12785,246116,1290,137649,1377388,108467
18866,8623,243014,1387,140278,1112610,102736
66130,2649,53621,318,51127,319651,2494
13258,88,2925,1476,1570,33495,1355
10179,355,8797,1506,6016,76366,2781
60669,45,587,479,527,8841,60
31372,19,537,1148,368,11820,169
36931,148,1358,1032,1147,14915,211
22768,63,2481,1322,1899,31152,582
43797,43,699,910,609,24281,90
22753,1320,35633,1322,26113,159005,9520
15807,40,1012,1440,777,15333,235
57009,93,1132,593,945,9009,187
2010,39,838,1587,542,21738,296
42678,85,1921,924,1081,50449,840
55696,4,98,636,83,19286,15
60607,73,1620,482,1183,20110,437
31642,217,7922,1144,2918,47792,5004
54770,83,666,663,632,25929,34
11549,49,3154,1496,1774,22385,1380
4124,759,16039,1567,10333,104975,5706
26463,68,2402,1246,1543,25136,859
5986,32,1444,1543,989,10876,455
52050,24,343,752,256,12368,87
41411,712,15901,946,12206,57890,3695
5269,59,973,1551,734,22600,239
19598,49,1395,1374,1010,28859,385
26780,54,1583,1238,783,14872,800
33396,26,1212,1114,821,15840,391
12183,114,9684,1490,3518,102401,6166
31785,4,66,1142,54,5317,12
48053,298,5671,860,4715,32247,956
9079,185,6983,1512,4905,82943,2078
4832,175,6054,1557,4206,35190,1848
53504,15,264,707,213,4205,51
2935,254,14145,1579,7921,94578,6224
23616,360,11815,1307,6276,152383,5539
57806,39,397,577,301,11977,96
69567,16,145,206,103,2309,42
54999,6,46,655,37,4123,9
43741,2028,50863,910,32955,241365,17908
66737,4,69,299,63,6623,6
3759,0,90,1571,58,9058,32
11617,1282,22790,1495,16904,76102,5886
8457,115,3713,1515,2464,21427,1249
12746,233,6719,1483,3925,89726,2794
66723,977,16246,300,15137,181368,1109
61291,20,251,456,186,3866,65
63292,89,1916,398,1193,30577,723
1997,202,10843,1587,6684,137999,4159
7529,137,3107,1523,1740,22581,1367
22266,17,285,1330,232,5434,53
59203,95,963,532,724,7103,239
5877,1077,23510,1545,14238,118966,9272
18498,41,3590,1394,2376,48618,1214
70000,250,3307,190,2969,42820,338
9875,16,905,1508,402,10465,503
25886,134,2446,1259,1547,30040,899
9164,74,2121,1512,1449,27250,672
35658,9,273,1065,212,7645,61
7357,8,314,1525,197,4527,117
28306,183,7616,1206,5183,22300,2433
9357,18,326,1511,153,3888,173
10870,3694,103417,1501,56084,544663,47333
848,51,1855,1596,1192,37276,663
18051,19,397,1401,267,5141,130
62303,468,5068,423,3923,30635,1145
22396,9,651,1328,448,14771,203
39759,5820,122942,957,97239,400373,25703
59136,12,96,534,85,7106,11
60322,14,223,493,178,1952,45
1721,11,444,1589,311,15819,133
57389,129,2305,589,2051,32923,254
5739,2519,48390,1546,27623,248920,20767
47184,113,2475,870,1806,32837,669
65853,55,1106,326,763,20790,343
65942,34,290,324,235,4253,55
32356,3,89,1133,63,5055,26
64889,59,1001,351,950,23364,51
15734,216,12403,1441,7798,31190,4605
8753,102,4139,1514,2132,23336,2007
41447,1558,24191,910,15792,176543,8399
31322,28,798,1149,507,6895,291
11559,0,122,1496,42,4091,80
7704,6,353,1521,221,4026,132
13974,51,1670,1466,1066,34123,604
6459,128,3717,1537,2007,65651,1710
7620,25,743,1522,544,21679,199
15133,12,670,1450,456,18541,214
64694,25,213,357,211,9649,2
5176,712,23812,1553,16395,119350,7417
49189,24,435,829,293,12877,142
28196,758,25046,1208,6372,72850,18674
49255,66,1674,827,1093,21966,581
28410,110,2734,1204,2002,20633,732
25139,505,10832,1274,5752,34807,5080
37749,267,3782,1009,2597,24785,1185
9450,465,13787,1511,7934,61321,5853
4065,2,91,1567,58,5921,33
28438,1102,21553,1204,15684,116664,5869
23695,104,1851,1306,1610,45369,241
22808,351,11547,1321,8622,113786,2925
24634,6,190,1285,152,5909,38
32072,84,1861,1137,1340,32643,521
28249,21,391,1207,292,4812,99
36737,14,202,1035,162,7713,40
18102,14,492,1400,366,8541,126
53496,38,692,707,499,7596,193
16870,1145,43051,1423,22928,409940,20123
16406,3,108,1430,50,5324,58
62698,1613,51403,395,22920,182430,28483
33198,78,888,1118,615,8348,273
26368,473,6490,1248,4335,25965,2155
20579,15,807,1357,539,16745,268
61545,153,5758,449,2744,55734,3014
66214,1,41,315,40,2892,1
62230,7,265,426,259,3901,6
58489,4844,61703,554,51532,194239,10171
5733,1793,64177,1546,36491,309333,27686
64668,11,215,357,163,7336,52
37767,15,350,1008,281,8448,69
21063,41,944,1348,670,16941,274
18982,67,1323,1385,1074,32724,249
63567,15,98,391,81,6865,17
7366,51,1433,1525,747,15259,686
54027,63,873,690,734,12494,139
42815,738,10560,922,9876,55803,684
59446,95,1207,523,1064,17988,143
32101,43,824,1137,483,17721,341
28033,23,483,1211,344,11799,139
23815,36,1021,1303,788,25967,233
33454,9,238,1113,161,3551,77
16115,13,218,1435,171,7703,47
26756,52,2230,1239,1374,24911,856
9539,738,25791,1510,8936,70158,16855
37718,520,22540,1009,8482,65621,14058
13561,1609,43485,1471,24061,398646,19424
24885,16,410,1279,319,9514,91
59729,40,763,514,536,12526,227
36466,169,3608,1042,2890,32336,718
40662,8,109,958,81,3934,28
32630,27,774,1128,620,19257,154
21793,14,461,1336,340,17775,121
37875,152,2136,1006,1776,35223,360
25692,164,6009,1262,2779,60158,3230
28385,13,501,1205,278,9834,223
16162,1301,40045,1434,26075,193699,13970
6398,98,2747,1538,1460,32325,1287
59703,55,1014,514,620,14440,394
7488,390,7938,1524,4291,50281,3647
53173,14,107,714,87,4043,20
60023,19,372,504,308,8872,64
14481,46,1058,1458,907,53680,151
26866,39,1198,1236,809,13241,389
24968,80,4139,1278,2213,21913,1926
45734,5,83,888,51,3776,32
7517,138,3963,1523,2770,88909,1193
32834,163,2220,1125,1572,16120,648
42286,670,9847,932,7444,59505,2403
51695,160,2072,763,1842,35573,230
61033,204,5703,466,4787,48330,916
31967,437,6203,1139,4641,44514,1562
29273,113,3740,1187,2071,35054,1669
13671,33,1118,1470,681,7374,437
18919,1513,26563,1386,17702,144662,8861
45795,8,87,887,70,7573,17
32570,57,677,1129,487,15508,190
13289,0,0,1476,0,5984,0
55914,433,10265,630,5838,111221,4427
9716,728,29212,1509,19754,207484,9458
18765,23,411,1389,279,12390,132
27310,77,1664,1227,1108,17104,556
52645,39,501,731,351,8159,150
54625,151,2634,668,1589,28715,1045
3295,2,49,1575,42,5061,7
10307,22,934,1506,393,18133,541
19576,13,496,1375,415,17311,81
31658,16,899,1144,465,8637,434
47138,8,260,871,197,9624,63
60671,35,419,479,287,4950,132
4993,25,761,1555,436,31067,325
21996,235,4804,1334,3355,44748,1449
6087,8,212,1542,143,7753,69
29195,9,299,1189,153,6510,146
15676,41,1187,1442,692,15132,495
15454,172,4069,1446,2780,50317,1289
14169,54,1164,1463,841,14128,323
21626,32,548,1338,370,9431,178
47699,49,1072,863,892,25454,180
33639,918,14765,1110,12286,93410,2479
17378,0,116,1414,86,4045,30
22056,5013,153073,1333,89865,866327,63208
25549,111,2670,1266,1768,32222,902
1640,41,879,1590,727,25123,152
54232,14,186,683,152,6831,34
16303,32,783,1432,499,22025,284
52923,56,864,722,678,14978,186
32203,11,237,1136,151,7315,86
7170,16,298,1527,208,11370,90
18092,33,837,1401,603,9405,234
27447,187,7385,1224,3386,32690,3999
51727,280,3243,762,2209,22973,1034
17769,81,3164,1407,1652,63929,1512
23052,372,8177,1317,5936,66115,2241
47135,216,4639,871,3721,54498,918
20141,97,2250,1364,1573,31225,677
14664,503,13135,1456,9015,51096,4120
14479,369,12445,1458,8336,149279,4109
39388,275,3309,976,2574,29069,735
3090,145,5105,1577,3008,46160,2097
40352,6,136,962,108,2170,28
22524,831,18391,1326,8489,136096,9902
16661,20,704,1427,397,11885,307
67936,31,400,261,353,5001,47
28194,44,845,1208,572,8215,273
36888,107,1938,1034,1388,27782,550
15136,22,379,1450,222,11455,157
51854,190,2548,758,1901,17215,647
51592,844,11005,765,8451,73843,2554
44081,27,436,906,372,13258,64
59249,85,999,530,970,16623,29
36785,17,470,1036,287,7982,183
49802,33,809,812,694,16398,115
42945,133,2771,920,2231,30641,540
14513,4644,77110,1458,45311,423946,31799
30164,13606,410475,1170,298795,1008292,111680
38023,30,614,1001,476,13943,138
64128,31,239,373,213,3351,26
34557,61,1594,1091,967,18445,627
25252,17,354,1272,230,6670,124
2440,82,4002,1583,2145,78947,1857
55831,26,313,633,258,10017,55
67358,657,14421,277,11720,100906,2701
18578,31,596,1392,454,16627,142
35781,42,697,1062,556,10951,141
3210,79,1672,1576,1224,12435,448
41338,25,467,946,370,30397,97
2042,524,21941,1587,10095,167998,11846
64801,223,3578,354,2229,44945,1349
56767,14,145,605,101,7886,44
20598,14,463,1357,265,5764,198
51692,188,1824,763,1589,8466,235
19360,36,892,1378,678,17613,214
41569,89,1134,943,824,15071,310
33470,167,2332,1113,1921,21521,411
15108,164,4513,1451,1265,33389,3248
17988,3,152,1402,94,10436,58
48778,40,389,842,323,5194,66
28820,33,524,1197,479,23595,45
33499,130,3100,1112,2335,28155,765
15246,4,456,1449,125,11951,331
4902,45,949,1556,614,20045,335
34718,493,10949,1086,7460,82364,3489
31754,21,527,1142,354,13391,173
55496,181,3352,642,1851,20803,1501
27478,5,207,1223,127,9755,80
32905,781,13760,1123,7928,117198,5832
19983,219,9110,1367,4631,65324,4479
724,248,15475,1597,6051,152301,9424
51909,51,443,757,401,14435,42
53612,10,127,703,120,9773,7
39929,18,332,969,276,9722,56
38529,11877,218474,988,136747,773449,81727
29877,655,9247,1176,6108,50144,3139
59252,86,744,530,628,7741,116
12593,45,888,1485,494,10820,394
57631,13,71,583,51,5711,20
57787,272,3416,577,2410,35234,1006
53543,9,158,706,146,5755,12
32916,229,7132,1123,5960,92221,1172
22656,88,1574,1324,1074,38263,500
55212,31,438,650,360,9753,78
63165,15,253,395,96,2751,157
53016,111,1100,719,1043,16684,57
36380,4,66,770,44,4861,22
5693,69,2410,1547,1361,41477,1049
28887,5664,208569,1195,101750,955440,106819
54690,23,146,666,122,4600,24
27583,16,550,1220,355,11087,195
37983,20,263,1003,222,5390,41
23573,5,312,1308,158,4261,154
8456,1101,27611,1515,16841,142559,10770
40697,38,1029,957,486,20141,543
65265,0,0,340,0,2155,0
41582,75,1731,943,1385,20209,346
29836,201,3944,1177,2205,34891,1739
51569,3480,58773,766,29500,375729,29273
36937,35,748,1032,657,21548,91
2860,76,2819,1580,1903,40702,916
27613,0,0,1219,0,19066,0
53553,39,233,706,195,11112,38
25950,188,4760,1257,3125,47199,1635
348,1683,52272,1600,32877,157367,19395
18213,220,7518,1399,4113,210494,3405
31003,56,1409,1154,894,12478,515
990,1750,92655,1594,33090,277847,59565
39111,43,488,979,331,15026,157
28354,31,901,1205,590,31352,311
5008,211,5619,1555,3587,94018,2032
37563,106,1344,1013,1040,15629,304
6300,73,2477,1540,1468,23378,1009
49125,5,113,831,91,7895,22
50230,12,147,802,124,6008,23
54254,301,3245,682,2674,33789,571
67811,1189,23852,264,20316,181090,3536
8101,369,13374,1516,7922,48409,5452
54528,24,220,672,154,4517,66
18024,1528,16713,1402,10902,65022,5811
62369,4,79,422,79,4057,0
37968,16,199,1003,182,8396,17
40706,12917,261470,957,166564,823066,94906
53571,711,8704,705,7103,74144,1601
39988,216,5467,968,2638,51444,2829
58434,3,25,557,22,2656,3
65272,7,32,340,31,3196,1
15478,57,1497,1445,1094,17691,403
20536,3,260,1358,199,5195,61
19085,327,13996,1383,7681,45852,6315
34379,54,1163,1095,756,36329,407
22087,33,1180,1332,886,28342,294
29570,134,3172,1182,1979,91763,1193
15549,109,2931,1444,1698,30305,1233
8469,73,1762,1515,799,16276,963
51550,512,5550,767,4508,47436,1042
17381,7,134,1414,94,3536,40
14188,265,5407,1462,3596,34178,1811
53049,3,40,718,37,6519,3
4434,35,1129,1563,908,13056,221
10803,13,659,1502,319,4887,340
55978,71,868,629,796,15087,72
7632,19,897,1522,642,13973,255
70205,23,182,185,159,7670,23
70002,496,5457,192,5153,34277,304
11299,45,1078,1498,737,12896,341
8056,116,6042,1517,3333,52952,2709
57639,64,1063,583,593,9499,470
36463,20,442,1042,362,8114,80
1225,26,674,1593,505,20381,169
38077,35,587,1000,437,14388,150
36033,2061,43268,1055,22996,204736,20272
51933,29,305,756,221,12491,84
60518,252,4261,485,3037,48770,1224
61310,26,306,450,239,3911,67
4009,568,23248,1568,14774,68073,8474
10230,60,2304,1506,1506,25366,798
8527,126,5246,1515,3096,44606,2150
37123,159,3141,1026,2769,30993,372
10408,11,509,1505,325,4579,184
18040,109,4181,1401,3088,43414,1093
19617,3,171,1374,122,9815,49
15209,828,20112,1449,14967,92839,5145
35563,29,579,1066,462,13065,117
67181,516,4705,284,4440,38693,265
15489,3806,82039,1445,51994,301664,30045
32096,331,7078,1137,5257,40242,1821
48626,143,1659,847,1466,22206,193
51302,736,10690,774,7787,126393,2903
63198,98,1445,401,795,7620,650
57206,41,776,594,685,33370,91
4804,5505,139461,1558,81041,369597,58420
33030,5,86,1121,62,3429,24
35880,2369,38556,1059,22254,249951,16302
1366,2,290,1592,198,12168,92
16857,240,11473,1423,6252,79855,5221
2599,133,4204,1582,2426,30422,1778
57767,37,403,579,356,5706,47
53768,5,85,699,68,5530,17
63582,121,1390,391,1099,22540,291
8935,1,129,1513,73,9932,56
3781,63,2025,1570,1376,35438,649
19256,53,1725,1380,1116,30090,609
57660,36,634,582,587,12031,47
54219,340,8201,683,4582,64513,3619
25753,52,1377,1261,826,13972,551
23558,46,663,1308,520,11465,143
53800,84,730,698,566,14016,164
29579,70,3462,1182,1697,50788,1765
52018,59,819,753,729,12263,90
17419,18,451,1414,315,11255,136
39271,126,1580,977,1328,20880,252
40605,30,412,959,331,9451,81
62469,181,3520,419,3505,80748,15
53009,41,468,719,359,7321,109
16645,87,3283,1427,2335,70573,948
9219,32,966,1512,515,12741,451
15331,110,3384,1447,2230,43008,1154
20594,48,672,1357,562,10398,110
17786,3,244,1406,178,8230,66
27872,172,4822,1214,3480,47392,1342
15075,10,286,1451,196,7220,90
40779,53,747,955,628,18337,119
37282,63,1060,1021,769,28167,291
50587,1003,13685,792,9763,98694,3922
13149,68,3554,1477,1679,34144,1875
38159,19,396,998,282,12963,114
2119,808,21930,1586,13894,913323,8036
47689,33,686,863,493,30762,193
887,19,840,1595,659,22130,181
68466,0,30,243,24,4801,6
7310,11,367,1526,282,23785,85
40608,67,1060,958,853,9082,207
61961,47,519,435,364,9819,155
50497,8,116,795,85,15959,31
2652,4,164,1582,118,34587,46
13093,1769,108103,1478,49124,378351,58979
11314,211,5784,1498,3109,58228,2675
36141,22,983,1051,774,52438,209
53250,52,498,713,443,8213,55
14123,138,1768,1463,1267,18349,501
12275,36,764,1489,504,11414,260
46166,56,1102,883,853,12054,249
67450,15,211,276,190,3867,21
29286,191,5086,1187,3022,43724,2064
64650,74,988,358,878,5967,110
10541,170,3659,1504,2133,20750,1526
31204,702,11228,1150,9957,95513,1271
22542,322,5905,1326,4269,74332,1636
54457,190,1068,675,980,12284,88
21960,101,3894,1334,1702,52914,2192
5476,54,4289,1549,2684,40104,1605
65069,3,21,344,21,4990,0
6489,22,890,1537,533,20848,357
51051,23,369,781,287,5778,82
47583,4,113,865,79,5621,34
29794,65,2635,1178,1321,20511,1314
626,48,1381,1597,932,23824,449
32622,34,916,1129,736,20863,180
21651,64,849,1338,694,5759,155
586,634,15709,1598,12068,142758,3641
31686,4367,138831,1143,77703,385403,61128
67114,4,59,287,58,6197,1
47413,31,506,867,403,15539,103
20878,7,241,1352,186,7690,55
57421,7,162,589,131,9842,31
31124,107,2046,1152,1223,18436,823
16386,41,1441,1430,946,39479,495
49317,14,197,825,178,10655,19
34592,354,3875,1090,2938,31689,937
6656,233,5181,1535,2891,17555,2290
28993,12,319,1193,228,13579,91
41488,150,3686,944,3305,31847,381
66078,9,100,320,85,3208,15
41955,29,327,936,235,3968,92
20910,960,19119,1351,11231,69869,7888
35660,76,1496,1065,881,11010,615
46586,11,242,878,223,9977,19
15658,3439,140366,1442,81878,664834,58488
40388,16,330,961,173,7002,157
462,3,297,1599,216,14564,81
3116,333,19210,1577,13468,80482,5742
63389,182,2710,396,2343,34824,367
65267,3,48,340,35,3353,13
34558,26,542,1091,402,13552,140
67093,53,994,288,637,18666,357
50101,159,2076,805,1378,18821,698
8288,228,14503,1516,7316,91915,7187
7551,41,1388,1523,967,12306,421
27249,26,912,1228,595,15064,317
24418,18,485,1290,350,16618,135
56798,53,972,605,825,28816,147
49253,409,7109,827,6388,47510,721
29031,607,14776,1192,10243,150420,4533
50128,117,1490,804,1135,10828,355
40693,25,441,957,379,18435,62
24450,206,1638,1290,1213,22616,425
58926,18,222,540,186,6652,36
22602,1140,28624,1325,15140,217717,13484
19488,19,352,1376,287,15579,65
30403,5,374,1165,229,17650,145
49493,26,394,821,284,4650,110
54769,112,997,663,786,15286,211
7764,243,7330,1520,4031,49096,3299
3961,32,1360,1568,914,64364,446
40577,5,140,959,105,5557,35
50058,439,8587,805,4760,113608,3827
32390,27,805,1133,600,5931,205
60239,34,267,496,217,3166,50
14569,8925,624199,1457,229672,1457577,394527
34552,2,78,1091,50,8818,28
18047,41,1430,1401,683,20196,747
56361,79,1583,617,1250,13066,333
24814,6106,161125,1281,85318,966738,75807
6538,905,32320,1536,16718,84481,15602
30506,2138,39633,1163,28511,138552,11122
7857,64,3259,1519,1571,14308,1688
13677,21,808,1470,486,14295,322
14761,75,2379,1455,1637,23551,742
2179,1003,27317,1585,20070,195116,7247
22190,300,21033,1331,5725,223908,15308
54956,3094,49205,655,32369,298623,16836
54349,2452,30700,679,24501,118048,6199
26566,101,3165,1243,2366,56193,799
13309,43,709,1475,450,6938,259
43809,203,3253,910,2665,69074,588
7266,77,3674,1526,2615,42630,1059
46450,56,807,830,344,20674,463
1676,12,680,1589,458,16767,222
69074,11,171,222,129,4656,42
13518,55,1155,1472,759,17819,396
4289,944,16350,1565,14245,102153,2105
64028,31,396,377,370,9043,26
67705,11,301,268,297,5671,4
9011,157,5462,1513,4073,32379,1389
40316,981,14251,963,11564,181386,2687
53831,9,61,697,59,6131,2
57411,18,213,589,123,6159,90
49096,5,104,832,90,10652,14
15002,30,1189,1452,841,19473,348
24600,2386,76905,1286,32686,258562,44219
17319,100,8286,1415,3711,36192,4575
67187,3,61,284,45,4215,16
22155,1168,35692,1331,16910,196100,18782
4467,99,4020,1563,1817,27619,2203
5181,5,281,1552,140,5164,141
38908,19,357,981,288,7762,69
25816,3,97,1260,66,7291,31
27525,2894,67625,1222,35064,274429,32561
59173,277,2703,533,2598,36759,105
1078,427,23724,1594,14853,139465,8871
21750,88,2482,1337,1973,33107,509
27145,407,13093,1230,6170,39886,6923
40482,27,584,960,544,12520,40
21706,55,1294,1337,858,15003,436
23301,10,313,1313,218,8336,95
30283,2,130,1168,60,18127,70
10396,79,4595,1505,3014,78694,1581
18106,799,19885,1400,15458,97065,4427
46828,2,133,875,91,4880,42
23658,1,159,1306,104,15754,55
8733,98,6043,1514,3443,32759,2600
56374,7,89,617,68,4499,21
61896,54,1110,438,862,21115,248
14933,136,2772,1453,1865,28646,907
22205,19,732,1331,449,56873,283
17140,1739,35709,1418,24164,148611,11545
18604,19,813,1392,494,28202,319
1124,24,1104,1593,657,64988,447
67237,1,36,283,33,3500,3
10116,3,121,1507,74,2562,47
20048,40,834,1366,465,29361,369
49605,1391,21214,818,19277,158523,1937
25875,52,1177,1259,974,22891,203
12521,4,508,1486,231,7607,277
52893,43,792,723,507,11383,285
21915,5,363,1335,230,16771,133
33945,30,763,1104,531,11186,232
35860,5,116,1060,93,2367,23
21578,13,527,1339,331,14522,196
55099,46,981,650,514,25794,467
35065,21,564,1079,427,5838,137
19365,143,6452,1378,4352,57065,2100
11004,100,3754,1500,2209,54478,1545
22400,0,0,1328,0,4253,0
2635,7,192,1582,138,25370,54
50713,10,106,790,97,11927,9
9490,18,638,1510,422,9873,216
51503,4,75,768,70,8376,5
35282,22,683,1073,449,10893,234
9926,72,4361,1508,2794,95384,1567
50237,68,1572,801,1066,29003,506
442,886,45082,1599,18309,216363,26773
1952,2377,87271,1587,54672,311358,32599
9977,94,1530,1508,953,13325,577
54442,63,821,675,649,10179,172
7183,8,653,1527,387,13643,266
28568,23,360,1201,260,20025,100
42758,102,1898,921,1205,35331,693
53375,19,226,710,186,7976,40
64611,1840,20909,359,19959,120539,950
18368,23,1085,1396,619,18909,466
13663,461,11875,1470,7879,102374,3996
54852,53,581,660,473,8202,108
29484,17,228,1184,195,7107,33
54118,2465,45540,687,24849,200475,20691
11904,259,12519,1493,7525,114731,4994
17725,47,1264,1407,888,44599,376
38249,19,264,996,173,4841,91
32385,3,166,1133,116,11785,50
22944,50,1220,1318,492,17942,728
19166,24,782,1382,629,12517,153
1002,54058,2899030,1594,898444,6634090,2000586
20997,881,18460,1350,15252,71029,3208
2105,1,150,1586,91,20189,59
13984,681,24141,1465,13767,251681,10374
4900,205,8470,1556,4443,125581,4027
16913,59,1299,1422,837,13230,462
20022,2743,72278,1367,51108,332393,21170
36529,263,3812,1040,3319,40198,493
3143,3202,204147,1577,75032,664803,129115
4494,158,4224,1562,3023,22085,1201
54815,14,563,661,155,19489,408
34513,130,3040,1092,1780,22142,1260
33925,91,2190,1105,1239,57812,951
2739,9,544,1581,378,24138,166
547,1464,36275,1598,20301,94349,15974
22025,49,833,1333,571,17457,262
39875,8,67,969,51,3314,16
25299,18,657,1271,443,14277,214
23364,4582,153036,1312,87777,551118,65259
64774,53,815,355,422,6134,393
15006,8,440,1452,312,15881,128
20511,4,98,1358,88,6223,10
65244,19,283,341,272,3993,11
22621,502,23481,1324,14002,294221,9479
58903,33,319,541,271,6780,48
69011,17,448,224,348,4672,100
795,12,265,1596,177,32949,88
65862,25,431,326,372,11072,59
3112,73,1321,1577,993,11526,328
4953,42,1284,1555,830,20416,454
24905,10,366,1279,239,9427,127
38495,4,103,989,67,7528,36
15093,6,710,1451,464,6279,246
20647,13,933,1356,508,15483,425
21699,242,2738,1337,2081,20959,657
13138,49,1467,1477,814,40487,653
46559,91,1057,878,918,13478,139
31113,241,8112,1152,4439,26103,3673
36129,454,13101,1052,11010,79776,2091
57055,7,107,598,72,11849,35
16458,93,2597,1429,2204,50370,393
23251,27,539,1313,378,11846,161
63593,212,3249,390,2828,19457,421
52971,111,2963,721,808,30979,2155
24657,16,366,1284,221,5523,145
61208,48,547,459,531,14125,16
21089,236,5600,1348,3233,90755,2367
37566,25,490,1013,417,19118,73
11877,97,4482,1493,1929,39663,2553
31381,17,466,1148,296,4252,170
68282,25,346,250,344,7150,2
6166,2005,103467,1541,38617,488914,64850
60920,7,123,470,54,6743,69
506,11,349,1599,248,15545,101
27969,18,606,1212,432,17004,174
44016,16,310,907,245,9592,65
20945,140,6005,1350,4055,46999,1950
49851,30,458,811,397,8527,61
25054,21,1165,1276,924,27899,241
24239,6823,145023,1294,93827,355781,51196
63684,12,162,388,142,5607,20
2024,78,2382,1587,1433,21451,949
11494,0,0,1497,0,16504,0
58014,16,157,571,138,7494,19
17205,9,776,1417,559,28916,217
54504,650,5737,673,5596,57324,141
14792,108,3355,1455,2467,151151,888
41007,35,702,951,617,10355,85
20496,1145,25159,1359,16891,127141,8268
9990,361,11506,1507,6010,79743,5496
18278,184,6910,1398,4102,51651,2808
2799,75,1326,1580,986,29561,340
25727,71,3089,1262,2270,38095,819
31806,38,644,1141,532,9339,112
56471,68,747,614,501,13645,246
25443,121,1918,1268,976,33538,942
11001,16,729,1500,434,10777,295
6743,10,412,1533,293,9374,119
17432,74,1900,1413,1382,19552,518
11447,27313,1238445,1497,459760,3062023,778685
49319,642,7738,825,5836,116221,1902
52166,26,705,748,540,12034,165
34399,5570,111516,1094,46000,238385,65516
4731,53,861,1558,596,11613,265
18836,1,70,1387,38,7479,32
32681,201,2506,1128,1546,18668,960
29368,132,3687,1186,2593,31788,1094
59190,86,1722,532,1465,18705,257
60505,13,138,485,119,6680,19
31740,6,200,1142,132,7657,68
13343,91,4654,1475,2317,83094,2337
5957,4,360,1544,286,9531,74
34914,817,12194,1082,8093,82563,4101
51062,111,899,780,829,18142,70
21431,226,5553,1342,2459,66337,3094
29530,7,374,1183,260,9083,114
23012,0,62,1317,45,8505,17
55574,168,1549,640,1484,32443,65
10600,18,962,1504,623,24391,339
12068,1322,30413,1491,22010,216567,8403
58354,52,750,559,713,49944,37
21188,60,2466,1346,1287,19356,1179
20410,40,1214,1360,982,7128,232
37632,26,299,1012,246,8483,53
35842,885,14807,1060,11886,180225,2921
34949,4,90,1081,44,5812,46
21805,128,3137,1336,2201,29814,936
49468,4,113,821,68,6625,45
22601,200,3701,1325,2812,20119,889
9979,12,301,1508,205,5901,96
46236,10,204,882,156,6253,48
68211,193,7004,252,4304,53835,2700
61696,15,108,445,100,6759,8
53783,32,281,699,258,4456,23
28612,39,1055,1200,625,17736,430
27097,97,2263,1231,1450,16533,813
35475,35,952,1068,742,17274,210
2186,12,294,1585,223,12373,71
1585,379,13967,1590,9449,189232,4518
19428,2,45,1377,33,7029,12
36119,18,540,1053,419,9025,121
4933,10,311,1556,238,14480,73
50439,188,3064,796,2923,32529,141
19335,31,1032,1379,663,15679,369
21863,3,378,1335,176,4484,202
59883,22,363,508,294,5625,69
57925,132,5399,574,1121,33248,4278
32128,79,1190,1137,728,11249,462
1979,14,971,1587,543,41486,428
58427,1137,13114,557,8548,49072,4566
36127,2382,49788,1052,27977,239336,21811
24662,413,13912,1284,8397,52472,5515
60449,50,369,488,288,4996,81
7898,3,216,1518,140,16280,76
25896,56,1162,1258,600,8523,562
9041,60,1050,1513,796,20892,254
20377,8,494,1361,403,12575,91
60887,106,1442,471,925,13947,517
27033,80,2735,1233,2379,30432,356
335,32,1613,1600,1071,34615,542
4169,1,196,1566,95,13202,101
24555,52,1760,1287,1105,19942,655
56017,30,545,627,481,17592,64
41554,35,634,943,552,15091,82
29298,255,8975,1187,5089,77468,3886
67965,7,252,259,177,3504,75
23834,65,5579,1303,3453,49972,2126
2775,15,1112,1581,700,21350,412
26910,39,1054,1235,850,30487,204
45525,1039,23150,890,11617,204575,11533
15774,182,5565,1441,2963,25890,2602
11583,7,207,1496,121,4554,86
17392,6,289,1414,221,23731,68
20964,11,310,1350,224,11469,86
60366,8,185,491,181,7640,4
65178,54,1036,342,426,15460,610
16788,8,276,1424,168,5960,108
60259,103,1014,495,913,15797,101
54722,6,63,665,59,4030,4
22956,5,77,1318,59,3130,18
4003,480,17882,1568,11044,105812,6838
15297,2,268,1448,158,11579,110
58883,0,755,542,598,12438,157
29528,38,1932,1183,1283,18694,649
67890,1,45,262,43,2427,2
14594,16,324,1457,245,19141,79
20724,42,1197,1355,908,38897,289
53832,7,71,697,54,9784,17
34637,503,8413,1089,5882,135011,2531
64256,3,54,369,44,18373,10
62155,593,5189,428,4022,46368,1167
18507,33,1198,1393,809,18927,389
60711,21,212,478,176,11093,36
62164,29,373,428,272,6568,101
22092,87,2513,1332,1889,24944,624
8240,159,4360,1516,2752,32186,1608
15605,14,859,1443,565,19737,294
4717,6,212,1559,129,23966,83
2771,50,2116,1581,1222,48925,894
58204,7,140,565,121,8246,19
65243,103,1621,341,1508,25019,113
17350,21,631,1415,447,15256,184
33317,47,1504,1116,931,9965,573
949,62,3771,1595,2067,23615,1704
33718,1151,25045,1108,9453,90073,15592
59620,49,685,517,561,12542,124
18730,8,96,1390,70,33234,26
1365,7,378,1592,288,21137,90
29090,62,2244,1191,1595,40389,649
57783,99,3234,578,1628,35741,1606
21053,86,2001,1349,1299,38927,702
3645,22,819,1572,604,10238,215
61873,21,299,439,290,4139,9
62941,503,11476,407,5500,89350,5976
1487,10,814,1591,403,14450,411
43333,90,1042,915,638,38022,404
50259,1304,22749,801,15474,221143,7275
27502,636,12191,1222,7444,122258,4747
66439,1,31,309,26,1816,5
13394,31,721,1474,418,21847,303
6412,2080,95939,1538,50397,672212,45542
5384,403,10052,1550,6669,49152,3383
54305,706,20067,680,12010,134559,8057
9829,286,5900,1509,3931,24007,1969
58123,56,934,563,735,15608,199
35269,6,109,1073,86,3554,23
25357,5,295,1270,220,5598,75
63401,411,8598,395,6262,41966,2336
22319,7,499,1329,305,8694,194
40323,14,196,963,160,17696,36
49789,380,9246,813,6532,123782,2714
36388,6,415,1045,343,11656,72
29623,36,1868,1182,1221,35508,647
37199,1,23,1024,19,3522,4
9722,39,810,1509,525,6470,285
62633,33,375,414,371,10228,4
56206,76,935,622,895,11866,40
33863,27,691,1105,332,14552,359
66309,20,155,313,135,4097,20
57453,2,22,588,18,2248,4
45860,30,419,887,353,9533,66
19121,12,359,1382,227,12677,132
9626,0,0,1510,0,11717,0
32915,186,3009,1123,2233,31910,776
22235,62,2359,1330,1616,41769,743
14489,10,548,1458,398,10733,150
28295,9,272,1206,170,12679,102
28037,16,391,1211,246,23709,145
23459,195,5159,1310,3190,67885,1969
15843,10,164,1440,115,14670,49
28258,2546,91959,1207,47137,448643,44822
11974,30,1621,1492,868,15577,753
52991,186,2744,719,1981,37857,763
10909,11,434,1501,246,12119,188
58189,37,833,565,471,11334,362
62736,72,493,412,473,13890,20
53568,44,541,705,497,10041,44
21749,175,5280,1337,2299,50014,2981
17417,246,6922,1414,5044,58860,1878
21233,21,342,1345,230,7595,112
22417,62,2960,1328,2501,33736,459
28585,31,1493,1201,682,20415,811
53350,2953,42059,710,33275,264849,8784
63495,9,63,393,60,5223,3
5658,43,733,1547,575,13089,158
30844,68,2627,1156,1514,15722,1113
57283,409,9148,592,5933,35446,3215
41424,26,799,946,602,8538,197
66494,8,107,307,91,5474,16
33861,63,1090,1106,618,16093,472
22116,427,9711,1332,7409,81729,2302
271,157,13870,1601,3980,61713,9890
64751,51,517,355,514,6706,3
31728,12,368,1143,242,8755,126
52434,118,1187,739,1043,32995,144
16597,19,403,1428,314,15083,89
20784,431,7803,1354,5044,109874,2759
10692,31,1206,1503,781,14137,425
2907,527,15048,1579,10206,53425,4842
28933,25,370,1194,322,26241,48
59497,5,70,521,68,4836,2
30443,25,968,1164,591,14541,377
1509,76,2643,1591,1820,13069,823
28093,1199,26904,1210,13917,155166,12987
13460,146,4597,1473,2287,47740,2310
17682,5,187,1408,128,10385,59
32291,41,1001,1134,721,23931,280
48674,14,340,845,230,10456,110
61166,9,65,461,53,6823,12
46640,4,45,877,33,3847,12
6313,19,724,1539,502,11335,222
5010,3523,146537,1555,62327,397107,84210
47675,43,852,864,744,12584,108
20840,403,10103,1353,6126,45684,3977
31788,992,26972,1142,17978,115848,8994
17940,8,163,1403,93,12835,70
33007,59,1432,1121,867,10108,565
37460,9116,127936,1016,91074,610624,36862
51462,1874,23823,770,12499,81598,11324
50578,80,1712,792,848,21252,864
54104,45,398,686,337,8025,61
20037,110,1972,1366,1144,36452,828
30096,69,2284,1171,1536,23645,748
28980,325,6421,1193,4161,61510,2260
47685,25,495,864,423,7353,72
54641,96,1784,667,591,16642,1193
14574,4,298,1457,212,20515,86
52083,220,3159,751,2720,29498,439
35188,118,1548,1075,1186,21495,362
29283,20,417,1187,277,10563,140
49486,84,1123,821,907,7523,216
51477,69,1105,769,980,17129,125
51346,76,877,772,704,18191,173
7453,45,2535,1524,1335,42861,1200
37077,9,100,1028,86,4523,14
68950,2233,63501,226,47625,373971,15876
92,381,10761,1603,6462,67506,4299
15500,22,958,1445,716,22004,242
48904,7,119,838,93,4096,26
21458,1701,55714,1341,33675,409690,22039
22529,9,365,1326,224,7890,141
14982,36,1396,1452,979,19705,417
22658,197,3982,1324,3034,49593,948
32997,40,1052,1122,704,11742,348
8252,19,663,1516,456,14052,207
57959,1618,19864,572,17239,81781,2625
55327,15,131,646,110,5743,21
48172,967,10785,858,7889,62588,2896
56724,146,2900,607,2492,30194,408
55657,34,679,637,546,9570,133
28372,8,318,1205,200,7214,118
47859,75,1552,862,1282,23656,270
10178,251,6186,1506,3498,24505,2688
30934,4,81,1155,68,3929,13
25140,848,14958,1274,11034,98585,3924
19238,19,807,1381,513,8660,294
1268,22,1135,1592,872,40641,263
67528,42,511,273,486,4649,25
49540,1,63,820,51,3444,12
16889,568,18631,1423,14392,184588,4239
1901,77,3622,1588,2616,29819,1006
9906,26,317,1508,223,14550,94
20528,212,8169,1358,5680,58893,2489
67099,46,616,287,513,7246,103
58314,9,94,561,57,5409,37
20319,25,380,1362,209,6096,171
37403,670,13392,1018,10020,74468,3372
38123,62,1948,999,1251,38500,697
49138,99,2715,831,1921,25781,794
38453,29,597,990,570,9489,27
66358,11,209,312,191,3629,18
53242,29,226,713,199,4518,27
17273,260,10387,1416,7034,74984,3353
54555,62,367,671,330,6187,37
17979,27,892,1402,420,18517,472
40004,16,255,967,202,5465,53
38087,4,109,1000,54,4523,55
23130,190,5458,1315,4082,66581,1376
24711,34,359,1283,274,12997,85
33118,31,543,1120,350,8916,193
10044,480,17078,1507,9339,137719,7739
40535,8,444,959,296,12515,148
218,24,3207,1601,1425,21215,1782
21838,2,88,1336,63,5190,25
48253,22,464,857,228,18366,236
32996,28,877,1122,602,8245,275
13366,7137,249870,1474,131887,1201563,117983
55039,31,350,654,295,22893,55
28844,4,195,1196,122,6141,73
32717,31,389,1127,326,12318,63
60362,1285,20581,474,17409,125857,3172
28693,20,520,1198,304,7542,216
23992,42,1708,1300,1139,13474,569
39679,109,1676,971,1319,25690,357
22638,673,11541,1324,7629,52711,3912
60147,82,808,499,772,8172,36
26036,10,994,1255,551,15567,443
41999,17,144,935,132,3640,12
17326,146,4574,1415,2982,61125,1592
29769,49,3233,1178,1409,18161,1824
19049,63,1346,1384,995,21552,351
9133,61,2736,1512,1718,34067,1018
45036,26,510,896,408,7577,102
19242,637,7803,1380,7151,41104,652
20507,22,1023,1358,727,17335,296
53467,9,208,708,141,4031,67
47114,53,1489,871,926,19654,563
21238,39,767,1345,579,29153,188
22559,4,172,1326,128,16453,44
16604,54,1266,1428,778,27690,488
21694,91,1362,1337,1050,14963,312
12781,46,1213,1483,533,14221,680
4469,38,1277,1562,742,20228,535
32564,177,1937,1129,1397,30401,540
35241,315,5179,1069,4235,47221,944
20515,2,171,1358,127,7805,44
1589,25,1337,1590,742,19676,595
48749,3,46,843,36,2696,10
30290,481,12102,1167,9317,106371,2785
33748,67,807,1108,631,9236,176
12397,36,1203,1487,673,9923,530
8841,169,6753,1513,3235,55411,3518
61490,262,2790,451,2739,28589,51
27098,14,180,1231,120,3913,60
33201,23509,426357,1118,251496,1577740,174861
51490,8,164,769,154,9948,10
11426,7,247,1497,157,6070,90
25431,273,5489,1268,3993,53706,1496
18347,7,419,1396,269,11100,150
3397,4239,133408,1575,76668,585755,56740
2588,272,17250,1582,8799,134197,8451
54696,12,196,666,151,12017,45
57563,468,9390,562,6352,70580,3038
30021,110,3484,1173,2362,37238,1122
37766,294,4899,1008,2936,84343,1963
38223,19,271,997,200,7056,71
54260,0,629,682,346,5620,283
31211,80,1086,1150,685,13125,401
5037,5,182,1554,131,8836,51
35596,43,1110,1065,842,21690,268
56706,21,326,607,287,7811,39
46344,2,80,882,54,3838,26
56679,146,1845,608,1577,15192,268
51342,471,4124,733,2076,71649,2048
59570,302,7727,519,5832,77320,1895
18303,42,1025,1397,726,32758,299
49079,14,177,833,146,7326,31
31172,30,782,1151,365,7753,417
19165,857,27518,1382,18070,179785,9448
29661,20,327,1181,213,9032,114
24513,66,1797,1288,984,26752,813
28865,4,197,1196,127,12964,70
3055,16,633,1578,466,20863,167
53050,31,385,718,303,5675,82
21414,330,5288,1342,3620,74076,1668
27902,13,321,1214,189,5156,132
55900,745,17086,631,13788,113940,3298
29186,53,1122,1189,713,11074,409
26101,10,322,1253,242,21959,80
25651,25,672,1263,420,10298,252
57367,461,6244,590,5200,44226,1044
7116,3,172,1528,83,18848,89
55608,10,289,638,100,10252,189
14037,87596,4580251,1464,1123415,9125520,3456836
32197,81,1293,1136,929,10943,364
38118,231,4432,999,3207,31878,1225
29091,49,1053,1191,695,23006,358
21403,13,333,1342,261,13858,72
13686,47,986,1470,577,12786,409
70381,12,82,179,76,5154,6
51251,3,41,774,32,3489,9
56871,16,731,602,679,5511,52
38325,6,189,994,144,8024,45
47440,15,220,866,193,9843,27
24017,4,72,1299,61,13173,11
44746,1,90,899,70,5696,20
60391,3,54,490,53,4796,1
61377,862,17149,454,10408,144555,6741
45021,278,3587,896,2459,35089,1128
7109,3572,103282,1529,51862,667763,51420
3501,87,2379,1573,1572,59818,807
602,10,657,1597,408,22918,249
36486,117,1233,1041,981,19972,252
47011,395,4095,873,3519,26218,576
13716,64,5579,1469,821,19285,4758
20487,21,1474,1359,1148,26928,326
29225,166,3755,1188,3085,24360,670
20933,20,479,1351,281,7769,198
58143,25,333,567,275,7313,58
10964,84,1749,1501,1127,28612,622
59201,41,497,532,468,12566,29
67374,8,86,278,82,3852,4
51881,43,437,757,386,11417,51
12865,563,20717,1481,12308,120446,8409
13587,13,624,1471,437,13057,187
3537,6,130,1573,93,13047,37
24065,3871,137340,1298,48739,602864,88601
32823,72,2090,1125,1125,20912,965
31183,43,1298,1151,789,11342,509
19533,27,1139,1375,772,26643,367
37953,46,459,1004,416,6400,43
58906,20,262,541,254,7492,8
38506,243,5469,935,3775,84108,1694
51354,1033,18130,772,13508,153222,4622
29309,137,2202,1187,1466,26334,736
24716,152,3176,1283,1550,26131,1626
8430,550,10225,1515,6656,44442,3569
36151,76,911,1052,787,18813,124
33813,29,657,1106,502,14044,155
22216,10,219,1331,156,6831,63
26407,42,550,1247,414,19483,136
19791,9,380,1371,252,26943,128
44221,11,202,904,137,7651,65
51478,5,119,769,97,7074,22
3073,20,958,1578,681,20121,277
65031,1,59,345,57,6229,2
56562,3,61,611,42,3275,19
19738,38,603,1372,468,22291,135
22613,312,14023,1324,7944,87007,6079
1897,2,233,1588,149,8143,84
32279,5,133,1135,102,4887,31
37740,12,532,1009,419,12467,113
52628,170,2356,730,1707,27957,649
59494,4,50,522,42,3431,8
55818,25,178,633,158,5082,20
10829,6,420,1502,269,14224,151
665,361,14682,1597,10608,79244,4074
50201,102,1790,802,1470,33064,320
18319,98,5370,1397,3606,44381,1764
8110,202,3800,1516,2357,19984,1443
32150,93,2869,1137,2189,17023,680
34892,30,968,1082,673,25593,295
13859,23,1151,1467,608,12457,543
28978,5665,180337,1193,94895,792233,85442
19203,10,466,1381,264,14297,202
64904,15,108,350,105,5805,3
9642,305,12179,1510,4338,44142,7841
60558,61,725,484,469,22963,256
29349,0,0,1186,0,11840,0
51867,11,129,758,95,3242,34
1593,259,11664,1590,6670,59930,4994
17410,49,474,1414,342,9770,132
34524,56,863,1092,659,17026,204
32175,11,309,1136,246,37834,63
15100,92,4776,1451,2479,28906,2297
14283,52,1722,1461,803,41699,919
13391,189,8617,1474,5234,50809,3383
42326,18,272,931,236,11629,36
34712,11,550,1081,343,10280,207
18132,13,380,1400,345,38963,35
55596,30,309,639,280,13684,29
39997,216,4480,949,3870,37298,610
11954,24785,1065857,1492,370984,3157009,694873
38164,8336,185006,998,114213,973929,70793
21440,46,1481,1341,930,36778,551
9470,16,478,1511,327,14403,151
4092,559,8465,1567,6579,50326,1886
59841,330,4026,457,3522,42889,504
20952,11,549,1350,395,5629,154
28270,71,2195,1207,1365,17661,830
23988,4,83,1300,68,9709,15
12082,375,16396,1491,8004,114723,8392
31603,109,1479,1145,1067,19601,412
57379,277,4094,589,3385,40079,709
38685,9,156,985,123,5911,33
3774,390,21886,1571,13393,177714,8493
20940,22,1284,1351,817,11736,467
64221,24,407,371,382,5147,25
24425,46,1888,1290,1261,22755,627
10914,774,107366,1501,8719,336754,98647
63661,28,470,388,358,9814,112
11121,9,254,1500,160,6063,94
16966,316,9396,1421,7412,101092,1984
828,9,727,1596,493,12021,234
26850,18,463,1237,279,8046,184
63191,60,1558,399,701,17264,857
28852,68,3762,1196,1051,15058,2711
39637,24,308,972,211,5505,97
28133,110,1922,1209,1390,39396,532
25631,227,3458,1264,2014,28710,1444
12129,170,3185,1491,1980,44061,1205
50654,26,497,791,414,9356,83
67570,55,1024,272,792,14865,232
8326,105,932,1516,623,12415,309
62299,33,356,424,315,5218,41
57583,13,134,585,104,10333,30
33171,1,36,1118,23,13490,13
32255,24,711,1135,333,5480,378
495,46,1706,1599,1009,20155,697
29987,21,512,1174,342,13945,170
61004,346,9289,467,5088,43609,4201
24849,42,1568,1280,1021,18875,547
2809,98,3822,1580,2550,41594,1272
66144,34,508,317,426,31523,82
42109,1089,20823,933,18397,137626,2426
12148,6,867,1490,465,18202,402
10720,25,438,1503,324,20323,114
3474,43,1030,1574,606,42917,424
53432,10,175,708,104,5330,71
53696,261,3365,701,2964,63251,401
37982,1735,34350,1003,24305,240365,10045
27422,183,4430,1224,2978,34416,1452
29816,70,1322,1177,955,33174,367
5610,154,4240,1548,2543,16636,1697
8789,70,3316,1514,2232,32928,1084
21755,238,5876,1337,3425,36110,2451
57451,100,1576,588,1521,47343,55
15583,259,8443,1443,5755,63590,2688
17869,3,127,1404,81,6990,46
24684,2984,146809,1284,43906,493632,102903
19336,80,1328,1379,866,10873,462
56315,3,37,618,36,2226,1
28985,775,12061,1193,8633,37002,3428
3106,62,2339,1577,1879,18614,460
57847,5,53,576,49,4063,4
61804,108,1971,439,1447,25327,524
22905,8,469,1319,274,15944,195
7702,459,14956,1521,12198,51094,2758
17557,10,288,1411,168,7519,120
3772,38,917,1571,719,14565,198
33432,107,1946,1114,1593,17643,353
33185,122,3066,1118,1889,96424,1177
66675,26,226,301,221,5549,5
48527,52,421,850,365,5252,56
21859,5,202,1335,159,5225,43
49881,48,739,810,513,13167,226
10485,41,1944,1504,1162,50304,782
32391,5,177,1133,125,2502,52
56157,34,418,623,354,9470,64
25002,24,828,1277,588,15148,240
52864,284,2642,723,2527,25148,115
28499,61,2108,1202,1000,16896,1108
21629,82,1379,1338,924,26625,455
60126,463,10713,499,6594,57975,4119
5574,119,3094,1548,1856,25776,1238
3524,1571,32164,1573,19628,763473,12536
7723,54,1329,1521,850,18228,479
16498,0,40,1429,27,5220,13
2879,9,465,1579,185,16037,280
5274,49,1118,1551,771,14337,347
34630,3,153,1089,110,6453,43
17711,727,17144,1408,12916,91750,4228
19499,21,921,1376,545,13891,376
50258,13,225,801,196,6447,29
15235,24,746,1449,366,11599,380
5334,16,704,1551,430,11668,274
23441,17,306,1310,211,10140,95
31498,23,657,1146,410,9723,247
28617,111,3187,1200,1963,21528,1224
34505,416,7785,1092,5514,38675,2271
39952,11,353,968,278,4737,75
33085,71,1016,1120,763,8693,253
30769,55,840,1158,545,8871,295
10110,74,1513,1507,914,11487,599
37138,99,2010,1025,1852,34416,158
62968,2,40,406,39,2118,1
62315,33,1026,424,913,14788,113
35569,89,2226,1066,1210,20186,1016
1097,5,162,1594,127,6902,35
15955,2524,60968,1438,42822,273751,18146
22518,41,1432,1326,931,38012,501
56155,32,529,623,412,9457,117
69045,3,46,223,40,1918,6
40757,19,252,956,193,4437,59
49829,211,2349,812,1822,13556,527
19611,5182,155025,1374,88128,605115,66897
36330,6,81,1046,70,4980,11
63751,3,93,386,68,7303,25
26454,5,370,1246,240,15893,130
31651,9,280,1144,171,5551,109
48080,78,996,859,725,18970,271
22877,68,1150,1320,727,6437,423
8060,1594,34241,1517,21206,94430,13035
32208,5,214,1136,136,6521,78
37469,77,2386,1016,1033,11822,1353
5936,487,15761,1544,8508,62086,7253
17870,339,11922,1404,7373,61246,4549
20592,19,992,1357,673,7825,319
6137,319,12122,1541,8169,165672,3953
54408,6,49,608,47,6242,2
29778,4,700,1178,404,18146,296
18087,616,27760,1401,15814,89687,11946
26280,282,7861,1250,4172,75786,3689
53240,23,298,713,245,8333,53
35998,24,353,1056,279,5882,74
38183,3,31,997,24,5209,7
53698,351,3596,701,2837,57759,759
53156,15,200,715,137,8069,63
63096,12,102,403,97,4213,5
65801,31,255,327,235,8663,20
64909,13,183,350,164,8168,19
16532,587,27930,1428,16406,256464,11524
68455,10,105,243,98,6991,7
19434,4,343,1377,90,4216,253
32354,241,6019,1133,3101,78398,2918
15359,18,353,1447,278,11643,75
28084,5,145,1210,68,6574,77
67305,479,4608,280,4470,41410,138
53519,25,217,707,176,10844,41
45759,41,617,888,542,13065,75
54558,29,326,671,290,4943,36
159,178,5951,1602,4547,65631,1404
57695,13,269,581,251,11513,18
33589,118,2355,1110,1342,92529,1013
24762,29,591,1282,484,13654,107
1038,24,1496,1594,1076,41340,420
32771,22,321,1126,238,6816,83
13315,185,4015,1475,2499,26572,1516
42506,728,8089,928,6638,90081,1451
51571,193,3004,766,1553,25788,1451
29004,19,257,1193,207,7692,50
49654,1382,24117,816,19835,188049,4282
49635,200,2682,817,2343,41897,339
3792,63,2338,1570,1408,16384,930
23970,8,153,1300,117,4626,36
49805,2,51,812,46,5487,5
5371,21,339,1550,177,12126,162
28297,21,499,1206,386,12256,113
22752,0,51,1322,48,11461,3
49649,128,2432,817,1528,24986,904
36775,14,849,1036,628,14810,221
56287,17,339,619,303,6774,36
57093,31,326,597,280,5162,46
36904,68,1476,1033,1331,12480,145
6363,29,1280,1539,911,27388,369
37835,2,33,1007,32,8902,1
59762,35,236,512,197,5934,39
65896,744,8486,325,8209,79369,277
27695,25,998,1218,652,7904,346
45,768,24815,1604,15387,381298,9428
48233,17,249,857,203,13970,46
15865,2086,175534,1439,67425,631465,108109
26826,1922,52521,1237,32204,309029,20317
23205,157,2864,1314,1863,24039,1001
32877,489,9279,1124,5512,47126,3767
50637,594,11938,791,5654,107408,6284
40454,13,104,960,87,6226,17
28427,2620,90874,1204,63886,283765,26988
55340,131,2494,646,2167,39262,327
13607,505,13671,1471,10106,173941,3565
59226,209,5750,531,4346,56310,1404
35927,680,22483,1058,13485,164060,8998
7188,27,1084,1527,797,23055,287
13902,16,382,1467,224,7047,158
22513,24,1192,1326,826,20235,366
42442,42,1365,929,1153,22338,212
13610,128,4679,1471,2205,21570,2474
15008,90,3035,1452,2308,41377,727
42995,91,1183,920,941,17728,242
4390,778,16921,1563,10711,86504,6210
2996,30,1061,1578,758,13381,303
68430,2,76,245,44,7276,32
34249,62,1242,1098,898,24793,344
707,19,1467,1597,913,40587,554
65262,7,44,341,38,2095,6
4879,6,261,1557,209,15014,52
12733,11,1061,1483,406,12581,655
9714,37,790,1509,461,14368,329
55698,8,76,636,71,10296,5
4343,218,7065,1564,3225,56898,3840
6879,47,3197,1532,1968,29656,1229
19676,28,1211,1373,878,19895,333
51024,1549,27516,781,25470,143703,2046
64329,73,1329,368,1089,14666,240
7393,30,1110,1525,627,25336,483
31989,85,1562,1139,941,26432,621
6187,451,11135,1541,8226,129448,2909
59420,37,403,524,353,7690,50
34003,41,754,1103,584,61020,170
23523,77,4596,1309,2125,57368,2471
48624,18,388,847,211,9305,177
62438,305,8342,420,4238,54825,4104
31935,181,5366,1140,3796,46352,1570
52898,30,402,722,326,11529,76
49508,7,165,820,94,12516,71
30089,156,4578,1171,2841,56730,1737
27734,6,214,1218,142,7331,72
33405,78,1627,1114,1009,16108,618
17191,10,1079,1417,591,15809,488
1982,36,1018,1587,759,35111,259
50513,62,1004,794,883,15563,121
44248,41,704,904,611,41693,93
52320,2,29,743,24,3182,5
15960,3,164,1437,100,5915,64
24460,8323,189394,1289,122430,606771,66964
51430,28,348,770,305,10421,43
3075,478,16303,1578,11066,102936,5237
6834,12,254,1533,184,16693,70
59998,23,172,504,152,5339,20
64511,4,77,362,63,3410,14
569,289,8390,1598,5831,61149,2559
14226,75,3266,1462,2306,54972,960
2782,3354,98055,1581,54444,170736,43611
10030,54,1451,1507,891,9988,560
23186,29,1173,1314,832,11954,341
17303,324,2913,1415,2201,31661,712
10944,1,41,1501,21,15847,20
33876,21,756,1106,544,20439,212
58396,237,4789,558,2731,31779,2058
57225,92,1285,594,847,31555,438
26909,899,29970,1235,20981,186850,8989
68442,12,220,244,172,5643,48
36003,4,162,1055,135,7410,27
3215,15,729,1576,438,19246,291
54333,139,3708,679,1851,36816,1857
22176,8,404,1331,270,8259,134
35695,25,591,1064,463,19737,128
1581,433,12384,1590,8952,134673,3432
63937,10,71,380,59,6159,12
25655,424,6804,1263,4112,47554,2692
54587,18,135,670,110,6524,25
41636,83,1054,941,873,36991,181
53036,33,410,719,349,23356,61
63631,40,239,389,192,6770,47
50436,152,2104,796,1973,19090,131
41180,602,18076,949,13006,125544,5070
14765,33,895,1455,593,17637,302
18695,44,1064,1390,768,18937,296
900,0,70,1595,59,10597,11
66683,18,157,301,144,4500,13
60477,179,2224,487,2163,63644,61
38144,30,482,999,278,7587,204
59000,2,35,538,24,3422,11
65411,27,230,337,167,5168,63
22616,414,8436,1324,3788,75712,4648
62005,19,139,434,91,2754,48
12418,26,1166,1487,762,31371,404
1866,5,165,1588,104,10431,61
21921,2577,66257,1334,38149,239230,28108
31404,40,788,1148,467,24414,321
33257,23,489,1117,317,5647,172
50470,153,1871,795,1657,28225,214
61847,15,183,440,157,6323,26
53643,163,1545,702,1380,28518,165
8432,47,878,1515,567,12865,311
8283,12,609,1516,338,8455,271
15245,82,1499,1449,1006,37195,493
28341,8,229,1205,171,21837,58
6241,210,3534,1540,2978,21880,556
65777,807,17183,328,14878,128242,2305
58236,41,557,563,528,28473,29
4816,15,567,1557,351,27992,216
934,3671,183838,1595,113586,492459,70252
35175,66,979,1075,685,13733,294
31591,3497,93055,1145,54509,256386,38546
16562,29,1637,1428,1052,13206,585
61564,15,196,449,146,5480,50
35272,98,1407,1073,984,20462,423
46495,1794,50995,879,16887,146351,34108
57156,58,1168,595,879,21590,289
36405,52,1028,1044,877,14708,151
13521,391,16333,1472,9590,164708,6743
21140,18,617,1347,384,16926,233
4917,6,369,1556,215,18869,154
9791,35,1555,1509,901,26276,654
4527,120,6930,1561,3449,37654,3481
41060,24,449,950,405,7999,44
1333,9,293,1592,212,12099,81
461,348,9447,1599,6572,129984,2875
50586,45,491,792,399,23375,92
10057,115,2563,1507,1527,12910,1036
53501,2253,25117,707,22163,181117,2954
30081,8,178,1171,138,8512,40
10194,1140,25191,1506,14577,87325,10614
25560,2,62,1266,53,5397,9
11486,644,35208,1497,15981,227314,19227
22708,19,336,1323,226,3519,110
10490,2,194,1504,132,12339,62
16927,522,10654,1422,6912,70229,3742
62950,20,317,407,238,4781,79
29688,1533,85690,1180,37271,200860,48419
3992,3,182,1568,129,9325,53
2779,10,481,1581,342,22270,139
62663,352,5148,414,3765,62184,1383
16466,13,471,1429,367,25201,104
14326,67,1905,1460,1431,29853,474
26712,130,4757,1240,3394,41137,1363
28897,46,864,1195,500,45372,364
45280,438,7861,893,6318,43563,1543
23074,71,2921,1316,2083,52521,838
52394,2,27,741,22,3763,5
24744,21,658,1282,351,11149,307
3830,44,1405,1570,893,40322,512
50208,43,873,802,733,18198,140
21331,62,1707,1344,1166,24520,541
12776,22,553,1483,273,19498,280
60213,77,1672,497,966,19248,706
9982,185,10042,1508,6286,94468,3756
13965,102,2868,1466,2020,42478,848
63883,0,24,382,20,2204,4
30227,3,64,1169,46,3914,18
25363,2,37,1269,29,2807,8
58735,17,255,546,214,7652,41
18527,16,395,1393,284,6338,111
20609,6,248,1357,194,5874,54
52664,39,401,730,360,11976,41
13674,57,2237,1470,1411,29834,826
35226,16,304,1074,199,12187,105
30307,17,316,1167,226,5218,90
25314,40,2283,1270,1344,42056,939
11487,1451,66485,1497,28111,398308,38374
25032,8,384,1276,276,7304,108
51913,19,293,757,251,6601,42
2091,15,675,1586,468,22962,207
64393,5,164,365,137,7661,27
38451,20,302,990,299,5288,3
24879,39,755,1280,470,10596,285
64771,115,963,355,848,6601,115
13798,1905,45855,1468,30028,175127,15827
10677,211,10213,1503,6190,72398,4023
13216,0,0,1477,0,14629,0
36175,1431,46675,1051,17878,265256,28797
58452,1181,16872,556,9351,54819,7521
42805,8,198,916,140,7994,58
39852,65,710,970,482,17216,228
54564,101,862,671,795,16536,67
38635,1271,19711,961,15401,180361,4310
34166,95,2699,1099,1421,32386,1278
33056,3,119,1121,76,22653,43
49329,51,726,825,693,28126,33
27570,92,2926,1220,1737,42490,1189
59687,267,3763,515,3675,34800,88
16776,546,13850,1424,9712,92988,4138
17621,12,485,1409,410,11410,75
15456,58,3373,1446,1652,54642,1721
1472,8,377,1591,273,18946,104
20907,18,480,1351,343,11959,137
53565,604,7160,705,5611,56243,1549
68795,1,16,231,16,6445,0
31287,7,135,1149,94,25246,41
29418,402,6255,1185,4056,28892,2199
63459,19,294,393,274,6606,20
35038,795,30773,1079,16858,257932,13915
6218,111,4590,1540,2484,49558,2106
17068,78,2436,1420,1818,29645,618
61679,30,277,445,178,5675,99
18627,193,8508,1391,6150,34713,2358
49790,18,384,813,353,16017,31
25326,243,8912,1270,3456,50208,5456
3056,90,3521,1578,2302,27188,1219
15742,908,91876,1441,38317,163160,53559
65352,13,105,338,88,3899,17
10081,1,152,1507,80,6247,72
23828,244,2575,1303,1782,103448,793
27847,473,12649,1215,6109,74993,6540
988,26,1522,1594,901,13029,621
54117,38,401,687,366,11320,35
30066,20,481,1172,300,9979,181
10234,104,9971,1506,4531,40207,5440
10471,69,1736,1505,959,17200,777
27210,116,3075,1229,1645,27526,1430
64050,23,628,376,614,15160,14
164,1377,44005,1602,24650,166101,19355
28407,11,181,1204,161,6358,20
12064,9,359,1491,190,24286,169
65810,8,91,327,87,7297,4
15809,121,1986,1440,1252,33341,734
8211,10,909,1516,543,21776,366
61237,1040,13069,456,11273,87695,1796
20348,65,1638,1361,1084,36537,554
34541,16,723,1092,427,8018,296
6493,132,3754,1537,2038,17882,1716
62852,35,723,409,693,3900,30
57746,69,740,580,587,10599,153
69675,61,1104,203,1032,13291,72
20689,5,133,1355,97,7929,36
51868,74,769,758,639,6978,130
34550,295,4867,1091,3326,30797,1541
36400,1,22,1044,20,1869,2
24196,5,239,1295,119,8375,120
2177,4,242,1585,184,9065,58
29767,18,256,1178,183,14641,73
30647,275,6252,1160,3687,79533,2565
19415,69,1132,1377,781,17966,351
15783,6,382,1441,240,25474,142
62080,16,197,431,170,8396,27
34345,101,2878,1096,1501,39440,1377
14100,32,1321,1464,963,29409,358
924,24,1008,1595,744,16317,264
31196,4,121,1151,95,8536,26
29238,145,3697,1188,2687,33253,1010
8483,41,1217,1515,664,12525,553
9089,23,1007,1512,575,35247,432
53607,93,1115,704,898,23327,217
51758,15,198,761,141,4701,57
37202,2063,98810,1024,36809,513139,62001
55982,425,6607,628,6254,79622,353
27646,511,12936,1219,6695,84088,6241
23273,15,619,1313,510,25006,109
34301,15,437,1097,331,6588,106
8865,346,6965,1513,3683,39222,3282
9214,27,1012,1512,669,10303,343
67139,6,100,286,88,11460,12
16139,6028,112721,1434,77049,440271,35672
35682,3789,70423,1064,49082,450877,21341
4196,144,5175,1566,3220,94416,1955
35836,15,524,1060,348,16724,176
54375,75,908,678,710,10336,198
11488,109,5411,1497,2881,36141,2530
23701,18,467,1305,388,31677,79
50503,1,42,794,34,2833,8
53417,10,99,708,89,10163,10
53114,53,576,716,406,9795,170
32338,26,507,1128,435,8267,72
32597,21188,562490,1129,240310,1980745,322180
59615,5,52,517,49,3268,3
26033,783,20425,1255,13317,154666,7108
45107,6,172,895,142,5665,30
23837,4,120,1303,93,6643,27
52090,453,4410,751,3507,30158,903
57743,102,1629,580,1494,24412,135
15259,125,2733,1449,1952,23578,781
31610,42,1720,1145,1045,13951,675
312,17,890,1600,676,49921,214
16244,385,9403,1433,6510,62697,2893
65021,140,2416,346,2308,25080,108
32293,24,245,1134,147,5439,98
22010,130,5133,1333,3695,132955,1438
2079,26,544,1586,340,19173,204
4878,27,1048,1557,576,13422,472
16810,34,1000,1424,775,14755,225
16118,25,867,1435,543,8733,324
12299,100,3045,1489,1606,30768,1439
11396,308,14869,1497,7805,79740,7064
37276,19,539,1021,312,9609,227
28662,96,1475,1199,980,11899,495
32098,18,971,1137,577,13986,394
24301,5,230,1293,162,9226,68
11645,216,15848,1495,7690,53095,8158
60324,18,229,493,222,6679,7
10290,0,0,1506,0,5228,0
15881,16,639,1439,525,15968,114
110,144,4606,1603,3189,57729,1417
12072,171,5756,1491,3267,35321,2489
9205,607,23616,1512,10490,130870,13126
31263,201,5409,1150,3297,47327,2112
4504,52,3261,1562,1661,63760,1600
38255,25,304,996,233,6330,71
43773,32242,768481,910,349354,1999334,419127
16196,42,916,1434,719,23870,197
8144,82,2177,1516,1377,45957,800
54644,170,2463,667,1807,27329,656
29262,4,209,1188,135,14923,74
35759,10,162,1062,141,18126,21
49330,784,17510,825,8673,150697,8837
37739,23,627,1009,511,28924,116
59412,394,4751,521,4682,31207,69
34375,111,3094,1095,2554,34544,540
9118,1280,61820,1512,38855,350943,22965
32735,100,1518,1126,1009,22066,509
62006,54,551,434,465,10792,86
65612,9,125,332,115,5409,10
59871,5208,119188,508,92008,342095,27180
19086,3,277,1383,205,15507,72
60842,84,2052,473,1541,17993,511
47259,808,8212,869,7352,52421,860
22035,3,52,1333,43,5855,9
58749,5,137,546,105,4739,32
21853,29,584,1336,378,13501,206
25289,477,8464,1271,6039,44705,2425
21322,64,1515,1344,1090,9833,425
22521,78,3175,1326,2244,26523,931
27079,95,2336,1232,1346,17618,990
9069,59,2491,1512,1594,37604,897
61252,2575,31327,457,28713,114797,2614
31848,59,1329,1141,907,16756,422
33378,159,2036,1115,1545,12514,491
14534,52,1175,1457,860,24961,315
23397,289,5721,1311,4239,44376,1482
30629,18,293,1161,219,5234,74
64835,259,5678,352,3504,54044,2174
27987,21,636,1212,408,19692,228
5613,37,1538,1547,912,15130,626
30086,1215,17191,1171,13270,81758,3921
53936,54,632,694,479,30742,153
42766,150,3288,923,2458,62870,830
1107,81,3246,1594,2056,17630,1190
55583,114,918,639,772,13316,146
52639,16,137,731,122,5900,15
112,34,2003,1603,1228,37761,775
9599,74,2042,1510,1379,33369,663
21455,9,348,1341,268,12020,80
23337,2859,179429,1312,64936,749193,114493
66508,106,1100,307,1097,16073,3
35959,0,0,1057,0,3909,0
25894,32,348,1258,206,7988,142
62434,126,2372,420,2033,18223,339
2326,9,205,1584,131,7948,74
47077,28,557,872,329,25570,228
9668,38,1180,1510,864,57664,316
29249,18410,298096,1188,178374,1348278,119722
23326,122,2668,1313,2002,36925,666
55520,31,326,641,315,14268,11
31274,4385,90712,1149,61296,212282,29416
39048,98,1080,979,759,8159,321
25660,11,469,1263,220,8420,249
30270,39,1421,1168,1063,13537,358
627,2120,75654,1597,41440,224409,34214
60829,92,2359,473,1133,55557,1226
47491,102,940,866,743,16141,197
27096,20,436,1231,274,12788,162
3901,151,7183,1569,4610,31357,2573
50355,754,12185,798,9420,133873,2765
30520,164,8521,1162,3293,40926,5228
10367,378,14188,1505,7362,69309,6826
15648,498,13671,1443,6966,65961,6705
40451,248,5083,960,3675,25587,1408
52536,404,5505,735,3921,45247,1584
22945,19,557,1318,404,6658,153
36766,389,7718,1036,6909,71383,809
56920,27,720,600,532,13923,188
31414,100,2327,1148,1226,10141,1101
58573,11,124,552,112,5155,12
18165,152,5496,1400,3635,25448,1861
19880,201,6360,1369,3900,74034,2460
24037,14,437,1299,350,13124,87
36901,50,624,1033,557,6885,67
14052,31,2072,1464,1318,35607,754
38839,1946,28954,982,19449,115980,9505
686,1728,48459,1597,31503,169350,16956
18446,1,65,1394,57,4745,8
11356,1974,57527,1498,29189,172481,28338
14121,83,2531,1463,1798,20281,733
33656,855,11144,1109,8482,107007,2662
56116,17,132,624,87,8118,45
59920,97,2085,507,1679,25313,406
751,125,8518,1596,4247,104354,4271
26439,30,635,1246,407,12945,228
4752,12,216,1558,149,20141,67
25068,3379,84887,1275,48103,365998,36784
63717,1,75,387,69,2745,6
54926,27,193,657,154,5832,39
1605,31,1040,1590,565,6062,475
32363,3575,52180,1133,37447,958675,14733
1021,266,13528,1594,6245,115692,7283
22959,1656,51014,1318,23971,239459,27043
1288,46,996,1592,689,23476,307
39682,26,607,972,514,22485,93
21731,18,420,1337,303,10733,117
67948,38,309,260,264,9011,45
57533,43,1219,586,1014,26621,205
28471,8,459,1203,298,12996,161
54138,265,4150,686,3656,26644,494
17092,113,13250,1419,6570,43666,6680
59578,73,461,519,431,10839,30
20239,2,94,1363,79,5500,15
54824,6,87,661,70,3566,17
37201,52,720,1024,590,7598,130
51215,9,154,776,120,3867,34
17865,1015,34348,1404,14903,143958,19445
35146,43,934,1076,628,26027,306
30865,102,933,1156,560,13730,373
12356,89,1973,1488,947,16916,1026
3764,5,171,1571,124,16261,47
29220,33,1254,1188,786,10552,468
50062,74,750,806,491,8059,259
780,219,7104,1596,3861,116766,3243
18729,102,2784,1390,2237,49264,547
22993,178,5343,1318,4056,28037,1287
11503,186,6197,1497,3199,77083,2998
23345,24,1204,1312,805,12453,399
25440,264,3152,1268,1954,24703,1198
45520,171,2792,890,2442,17259,350
18369,77,2033,1396,1624,18262,409
61613,77,1914,447,1512,20121,402
13654,41,2224,1470,1258,28477,966
6156,112,4485,1541,2910,73864,1575
24158,40,685,1296,572,11634,113
19965,7,266,1368,123,6326,143
10154,1165,46053,1507,22780,243828,23273
5952,21,938,1544,665,15025,273
57832,71,993,577,783,11959,210
26551,91,1237,1244,671,8614,566
8891,7,268,1513,108,10176,160
14843,19,422,1454,282,12948,140
52703,405,4192,729,3693,58205,499
31081,75,1420,1152,866,17542,554
31831,44,889,1141,576,20871,313
51474,87,960,769,698,7527,262
25578,166,6590,1265,3963,30001,2627
4633,13,327,1560,199,14008,128
10419,93,4758,1505,2914,35783,1844
36997,26,781,1030,655,9023,126
45532,55,932,890,726,23723,206
36294,64,1497,1048,1125,20984,372
61949,22,196,436,171,7860,25
16151,41,1389,1434,961,17229,428
16625,262,2650,1427,1988,42456,662
13067,10860,339907,1478,182629,1697604,157278
2065,32,1491,1586,1018,15906,473
37168,1,53,1025,38,7069,15
16248,11590,268444,1433,158565,883554,109879
30238,187,4197,1168,3303,47270,894
28750,8,222,1198,128,17971,94
28507,540,10178,1202,7369,52066,2809
17874,13,529,1404,356,11585,173
12140,74,3183,1491,1053,20212,2130
31359,89,1685,1148,1098,22992,587
29633,1222,25771,1181,14390,251126,11381
16718,185,5698,1425,4027,32996,1671
30130,63,1337,1170,984,14089,353
5512,34,1582,1549,813,20893,769
18650,71,2417,1391,1701,50977,716
36433,87,3447,1043,2071,26958,1376
26744,717,33751,1239,15013,142837,18738
66509,54,738,307,557,7577,181
43637,46,470,911,404,14291,66
19198,63,1381,1381,1006,18886,375
53747,2,33,700,26,2427,7
57612,4512,60236,584,50230,233288,10006
16409,39,489,1430,352,8234,137
34959,809,16245,1081,12942,151704,3303
12617,17,1266,1485,673,42129,593
37912,302,7265,1005,5763,83395,1502
34993,177,6146,1080,4480,79592,1666
62791,36,641,410,598,9940,43
35077,78,2414,1078,1671,28439,743
2938,69,4551,1579,2979,54306,1572
55272,10,104,648,56,2550,48
66217,14,264,315,177,10119,87
32315,1,34,1134,24,2530,10
3991,16,704,1568,498,42677,206
59806,36,818,511,546,31893,272
4839,5,104,1557,72,4041,32
15020,598,13898,1452,9984,73626,3914
29679,57,1708,1181,643,10617,1065
16663,38,767,1427,254,17240,513
37127,158,2358,1026,1989,16776,369
49300,33,559,826,531,14917,28
22095,16,441,1332,312,7406,129
56019,34,416,627,329,8387,87
48346,774,9379,855,7656,91033,1723
24861,384,6490,1280,5150,26587,1340
50218,342,4220,802,3374,49613,846
3229,25,1167,1576,530,13897,637
4121,100,3561,1567,1969,30751,1592
13774,21,1293,1469,744,16256,549
49666,7,75,816,43,11241,32
3114,1,136,1577,120,10388,16
58695,2268,36374,548,24751,141279,11623
32132,168,3752,1137,2065,28589,1687
20819,59,1610,1353,1134,50813,476
57067,469,5062,597,4068,46372,994
51742,144,2682,761,2513,45295,169
22207,99,2946,1331,1893,29556,1053
20029,104,3853,1366,2090,30164,1763
28237,4,262,1207,134,6002,128
33068,143,2366,1120,1550,10721,816
53564,230,1974,705,1702,51476,272
47303,66,1092,868,951,24132,141
41980,20,356,936,297,7061,59
21681,196,13641,1338,4562,111191,9079
49980,12,280,808,215,5252,65
32569,25,331,1129,219,6307,112
23147,56,1824,1315,1012,42306,812
5947,71,2768,1544,1904,27687,864
55279,54,745,647,576,15875,169
21927,10,805,1334,505,15057,300
11033,0,600,1500,358,8255,242
33141,1171,22938,1119,19455,94496,3483
27301,3091,83644,1227,49978,574625,33666
52423,13525,279089,740,152335,920447,126754
18816,7,605,1388,441,10642,164
39057,21,451,979,439,16727,12
36338,17,378,1046,317,13112,61
68176,4,170,253,58,7125,112
5768,4,154,1546,82,11062,72
25328,39,1022,1270,686,7091,336
11397,1320,33488,1497,20167,165076,13321
13678,18,595,1470,383,33981,212
57072,40,381,597,287,3787,94
60912,9,103,470,100,2663,3
27916,7,453,1213,291,18566,162
27163,16,631,1230,381,6095,250
48744,41,639,843,433,7517,206
37903,99,3640,1006,2957,32126,683
8245,81,1678,1516,1143,14325,535
66172,30,269,316,236,4349,33
22891,6,118,1319,83,6962,35
31203,9,120,1150,71,7323,49
5695,6263,204522,1547,112312,707377,92210
24025,100,1867,1299,1287,53480,580
11069,43,1694,1500,885,26421,809
18794,150,3042,1388,2358,23169,684
9344,94,4061,1511,2173,21061,1888
49887,55,599,810,488,26814,111
42957,896,27329,920,11457,204177,15872
10931,34,2241,1501,1119,38867,1122
11792,753,19468,1494,10746,104491,8722
8524,117,6586,1515,4465,63012,2121
65643,8,81,332,66,4052,15
20650,13,401,1356,287,12919,114
58446,10,250,556,204,5988,46
50097,3045,46142,805,38239,350520,7903
13664,20,1352,1470,591,8982,761
54561,25,293,671,243,8617,50
9899,20,748,1508,556,9996,192
56522,3,51,612,46,5961,5
55370,526,10508,645,9999,80936,509
62213,30,330,427,231,2827,99
22336,51,1215,1329,985,37150,230
33424,1,66,1114,45,3240,21
3141,38,1032,1577,733,31670,299
885,1331,29639,1595,20625,95951,9014
64120,21,227,374,211,10071,16
48267,4,69,857,55,2069,14
2804,426,15763,1580,10082,108656,5681
33941,26,1046,1104,773,15483,273
64334,13,167,367,140,8900,27
24736,1343,34649,1283,18705,161390,15944
69862,17,171,196,141,8792,30
48545,10,148,849,110,8776,38
43053,13972,300769,859,156718,808364,144051
30378,97,2630,1166,1483,13970,1147
30954,310,5880,1155,4431,41221,1449
21045,49,1162,1349,901,21641,261
55438,842,15366,643,14625,203367,741
41210,2980,58618,948,36471,301338,22147
49335,9,83,825,77,2045,6
31368,406,8739,1148,6251,78355,2488
29320,37,1373,1187,870,18432,503
10622,1089,45627,1504,31764,255096,13863
15667,175,5378,1442,2216,30549,3162
41715,39,350,940,254,11416,96
14487,47,1033,1458,748,9314,285
43765,1734,42241,910,20641,436429,21600
65997,12,104,322,88,5805,16
37417,29,486,1018,428,19538,58
6668,62,1879,1534,1067,35858,812
1418,298,8907,1591,6291,133648,2616
33243,16,592,1117,398,7274,194
4711,16,397,1559,288,13198,109
6809,12,397,1533,260,40118,137
20851,210,4896,1352,3431,41606,1465
32317,37,384,1134,261,3368,123
60951,7,84,469,63,3099,21
37860,14,256,1006,223,13008,33
22267,120,3472,1330,1254,35019,2218
20043,49,1483,1366,902,11101,581
11390,1304,46974,1498,32276,177328,14698
36969,263,1779,1031,1446,26604,333
38267,15,249,996,168,4476,81
51983,255,4089,754,3311,32307,778
16012,313,8894,1436,6385,113763,2509
51923,33,568,757,445,18451,123
47400,200,2491,867,1763,45236,728
11118,75,1422,1500,921,30333,501
32434,60,955,1132,673,10895,282
26112,1930,58171,1253,26826,392393,31345
8364,6,322,1515,210,13335,112
31004,32,1059,1154,744,18659,315
26270,259,6198,1250,3377,100254,2821
1882,185,3798,1588,2388,31717,1410
10147,530,22999,1507,14356,84234,8643
23955,703,32553,1301,20253,282796,12300
3354,17,394,1575,227,13178,167
35208,6,141,1074,101,7050,40
22624,2698,57867,1324,33149,145503,24718
25459,1032,23665,1268,16354,94627,7311
67781,5,168,265,96,8303,72
31454,72,1418,1147,907,16848,511
21563,69,1131,1339,687,22488,444
19722,4,170,1372,142,10452,28
16321,1,104,1432,63,7690,41
51025,80,1194,773,890,20017,304
20335,309,8343,1361,5712,47843,2631
21124,16,860,1347,290,16277,570
8139,23,1052,1516,672,14208,380
36414,97,1828,1035,1343,40905,485
18774,49,2160,1389,986,44021,1174
50354,0,31,798,24,5675,7
10337,72,2065,1505,1418,18824,647
12043,6,499,1491,268,12983,231
11393,14,446,1497,295,9002,151
53630,0,69,703,69,4852,0
10837,43,1800,1502,793,24252,1007
6482,18,383,1537,261,8966,122
37713,4,103,1010,90,11762,13
22931,143,3004,1319,2006,24970,998
1334,74169,1798360,1592,690719,5129364,1107641
42546,342,4436,927,4323,49880,113
8984,3,181,1513,99,11572,82
7510,76,1054,1524,689,18892,365
62510,20,175,418,163,3035,12
9973,86,1239,1508,800,11426,439
3674,11,186,1572,135,20384,51
22923,68,1999,1319,678,19171,1321
20313,27,1641,1362,1123,61236,518
27709,204,13309,1218,6993,47545,6316
30768,10,310,1158,230,5216,80
46378,216,2984,881,2289,38121,695
3625,74,1194,1572,648,15375,546
67405,21,352,278,342,6293,10
37947,32,330,1004,268,5642,62
48430,149,2460,854,1174,34510,1286
3157,20,335,1577,215,10667,120
14349,10,364,1460,270,10372,94
21538,15,391,1340,276,13948,115
63671,244,3881,388,3298,25210,583
48337,16,390,855,327,7116,63
66126,850,10005,318,8757,72568,1248
23678,1,131,1306,100,6141,31
57248,8,42,593,35,3211,7
58678,20,434,548,394,17198,40
54509,13476,200410,645,145022,1366451,55388
9660,37,2779,1510,1651,17657,1128
55652,86,1338,637,1242,10266,96
22739,6,259,1322,187,13866,72
27643,2629,63354,1219,39469,138047,23885
39050,308,20606,980,4487,96722,16119
36210,88,2846,1050,1726,24092,1120
37324,742,11787,1020,9209,76683,2578
52324,145,4107,743,3124,21404,983
48568,141,3005,848,2127,47511,878
21902,56,1982,1335,1298,16463,684
56912,60,1121,601,1035,16208,86
35086,4,212,1078,147,12996,65
27631,87,1535,1219,963,16694,572
24827,225,1806,1281,1378,23463,428
28301,629,13427,1206,9743,80738,3684
33868,50,613,1106,412,6806,201
3858,40,995,1570,650,52309,345
11178,37,1581,1499,829,22262,752
15415,7,127,1446,87,12922,40
5081,77,2195,1554,1517,26047,678
32113,84,1159,1137,994,26648,165
53252,4,174,713,155,5321,19
17468,6,157,1413,109,4571,48
14325,166,7525,1460,4848,99669,2677
36780,8432,152813,1036,113462,1029252,39351
5631,28,1464,1547,1048,24121,416
23919,240,8560,1301,5320,73359,3240
5909,65,2848,1544,1827,50750,1021
25225,78,1464,1273,803,37646,661
34703,56,568,1087,423,6356,145
27326,56,887,1227,683,16743,204
2116,83,5236,1586,2918,47786,2318
25818,12,573,1260,377,10250,196
6036,110,4005,1542,2332,59176,1673
15417,214,4399,1446,2905,54582,1494
11573,8,230,1496,127,9428,103
58815,320,3219,544,2575,31689,644
10626,1021,78434,1503,34692,357227,43742
32426,226,3323,1132,2375,31378,948
50865,23,517,786,193,8823,324
11953,109,4804,1492,2915,42809,1889
29940,140,3531,1175,1840,15250,1691
55642,5,59,638,45,4480,14
16701,8,747,1426,539,19837,208
18112,1705,51976,1400,30498,269598,21478
19346,141,3413,1379,1972,31625,1441
7311,45,2201,1526,1385,23678,816
56780,15,303,605,278,4826,25
31698,5,188,1143,86,4951,102
19972,105,2360,1368,1309,38391,1051
50995,529,16801,782,16604,127509,197
51556,1640,18627,767,15889,75551,2738
25386,1485,30467,1269,20566,230203,9901
59372,603,10914,526,10105,82557,809
39951,563,5991,968,4465,77065,1526
10734,12,260,1503,180,5110,80
36155,2,126,1052,105,7069,21
19836,78,1520,1370,928,37340,592
59961,73,1601,506,1472,32466,129
59256,57,590,530,534,11303,56
17678,96,2640,1408,1835,54536,805
56700,118,1136,607,943,17876,193
54068,358,3471,689,3081,27771,390
38392,3539,45762,979,27799,275447,17963
11499,28,1272,1497,771,35095,501
21230,8,223,1345,130,5048,93
175,143,6200,1602,2269,57468,3931
5036,12,404,1554,330,20404,74
66620,18,193,303,177,3537,16
68102,10,68,255,62,2908,6
15127,17,340,1450,193,6427,147
9588,243,8627,1510,5667,44760,2960
60628,87,1285,481,981,13988,304
26088,5,61,1254,40,4943,21
41692,2988,61894,941,49367,201687,12527
23603,285,6580,1308,3915,93553,2665
24712,31,1095,1283,728,14266,367
2411,591,20529,1584,15992,61062,4537
2009,1405,131288,1587,46916,423503,84372
32138,3,125,1137,87,4732,38
8679,11,400,1514,245,12216,155
61215,44,604,459,512,22762,92
15555,9,731,1444,500,54216,231
49997,75,830,807,724,13896,106
20714,2,224,1355,162,4249,62
3589,16171,523482,1573,283352,1148427,240130
62651,4,60,414,54,3723,6
3740,737,18302,1571,12623,109435,5679
22325,135,5717,1329,3923,53798,1794
19673,91,2188,1373,1504,18524,684
7297,15,525,1526,343,13782,182
32653,55,1076,1128,709,10169,367
65671,41,616,330,593,17326,23
59760,391,6638,512,6601,36176,37
21537,246,13292,1340,6156,62255,7136
1479,57,3225,1591,1468,59318,1757
26443,203,5238,1246,3785,99624,1453
25047,13,614,1276,432,10474,182
11627,1,200,1495,126,6969,74
5259,73,2763,1551,1893,28245,870
25572,46,644,1266,430,9468,214
54413,33,350,676,307,12263,43
11940,15,794,1492,425,25543,369
32804,202,2758,1125,1990,23815,768
39514,3,102,974,99,6891,3
28722,7,554,1198,328,27732,226
56944,7,70,600,46,7194,24
14396,58,1902,1459,1182,41183,720
29157,60,1191,1189,637,18160,554
44074,188,2929,907,2275,20633,654
33808,669,10216,1107,7361,39307,2855
23061,188,3086,1316,2165,67561,921
16249,220,6409,1433,4711,57153,1698
68246,14,264,251,201,6789,63
31631,11,395,1144,212,6118,183
8007,277,5484,1517,3517,53400,1967
5792,19,523,1545,376,28618,147
16401,173,4885,1430,3766,54896,1119
70132,53,797,187,752,7428,45
59715,164,2441,514,2107,35449,334
16583,23,585,1428,435,34247,150
34077,13,223,1101,170,12636,53
9446,103,5119,1511,3030,20454,2089
1981,16,821,1587,361,36779,460
25055,23,549,1276,365,10686,184
21093,10,492,1348,346,30911,146
1425,32,1593,1591,872,21446,721
19990,263,12763,1367,5915,127124,6848
47753,484,8129,863,7120,77389,1009
19450,10,402,1377,280,11183,122
30765,127,2097,1158,1393,19115,704
49121,50,726,831,634,11198,92
29457,970,24143,1184,8296,92172,15847
13396,175,3906,1474,2378,27910,1528
26188,14,485,1252,323,14032,162
58193,75,538,565,492,19265,46
56711,78,1039,607,999,16484,40
40615,1251,46372,957,13122,366573,33250
6584,16,882,1536,599,39719,283
26996,274,8367,1233,3462,54479,4905
23799,197,3449,1304,2477,38887,972
52071,218,2114,750,1661,43147,453
61728,78,1354,443,1254,21398,100
55244,9,124,649,96,6894,28
50191,39,453,803,343,19002,110
24488,31,1370,1289,809,18415,561
8437,70,3606,1515,2020,37937,1586
5003,82,3305,1555,2067,17566,1238
49832,43,934,812,737,21109,197
18885,64,1588,1387,1341,25162,247
8033,17,640,1517,397,8632,243
18789,41,2032,1388,1484,21246,548
20656,214,5634,1356,3209,101711,2425
9891,2607,72716,1508,40373,217858,32343
58171,90,1985,565,1281,21185,704
40125,166,3852,965,3168,33654,684
36905,42,462,1033,318,7416,144
35159,10,186,1076,148,15217,38
40203,18,620,964,340,9965,280
13961,4531,139558,1466,87944,979577,51614
32448,6516,97543,1132,66705,352247,30838
62406,177,6258,419,4289,37850,1969
37383,68,1489,1019,1339,26132,150
12268,1637,44790,1489,30366,237578,14424
3120,979,66155,1577,39232,353687,26923
27604,134,3512,1220,2477,28757,1035
26113,11412,418206,1253,170596,1281400,247610
27282,21,300,1228,197,11784,103
19006,35,1508,1385,1072,19909,436
11432,98,5618,1497,2509,62775,3109
8945,10,502,1513,345,6883,157
52855,50,914,724,749,9060,165
58810,165,2569,544,2474,20217,95
5612,5,275,1547,190,22559,85
13937,56,2959,1466,1752,39568,1207
14779,89,2384,1455,1651,18131,733
40442,2,26,961,22,1320,4
15849,1924,53514,1440,38417,314744,15097
67601,453,8242,271,7721,102753,521
62927,5,52,407,38,6190,14
24393,111,8400,1291,3309,44323,5091
31998,91,4261,1139,1692,17548,2569
18300,14,369,1397,269,30814,100
9682,32,1150,1510,814,20839,336
22950,1274,25639,1318,17243,174837,8396
62924,20,315,407,251,8368,64
23117,411,7303,1316,3061,66040,4242
37356,28,364,1019,300,7395,64
62188,545,13228,427,6427,46747,6801
64440,4209,79748,364,68981,467427,10767
10206,258,11974,1506,5776,56946,6198
21745,264,3364,1337,2134,37667,1230
46458,3286,62178,879,44062,359326,18116
22561,16,503,1326,376,7223,127
56108,6,88,625,72,3405,16
31483,19,609,1147,392,16080,217
15092,11,214,1451,151,6823,63
31915,377,6483,1140,5100,31593,1383
15288,8,844,1448,554,21736,290
12375,79,2952,1488,1433,27716,1519
19187,76,2731,1381,1800,25166,931
26471,14,373,1246,259,10094,114
12248,49,1896,1489,979,21326,917
57179,6730,132735,594,97097,674794,35638
24026,9,514,1299,405,23095,109
65562,27,449,334,356,7672,93
30431,20,804,1165,545,21538,259
52203,69,703,747,580,17110,123
41148,28,504,949,382,9431,122
4799,165,4361,1558,2983,22307,1378
18822,28,1215,1388,906,16790,309
47489,44,841,866,608,10735,233
26156,26,1398,1253,550,16552,848
8530,1426,72730,1515,28628,207059,44102
32791,134,2622,1126,1307,38242,1315
59513,13,214,521,194,4954,20
47739,25,295,863,243,8099,52
58071,40,381,569,363,9342,18
27485,48,1033,1223,649,13792,384
36442,29,566,1043,469,15962,97
3463,18,311,1574,219,17286,92
4941,552,30853,1556,9726,74165,21127
58398,18,183,558,172,5516,11
702,77,4307,1597,2690,36258,1617
31055,359,13064,1153,5961,40571,7103
52959,95,749,721,662,12162,87
19480,122,3676,1376,2198,22347,1478
37635,178,3575,996,1850,41758,1725
8422,170,8185,1515,3906,71220,4279
3279,56,1041,1576,778,35734,263
43950,41,378,907,323,11002,55
34760,96,1824,1085,995,10704,829
59212,270,4360,532,4314,32384,46
11242,4,94,1499,54,12208,40
11381,30,1465,1498,973,25269,492
9323,1321,42808,1511,21873,181799,20935
16392,285,5617,1430,3563,68758,2054
69883,5,68,195,66,5066,2
12080,19,817,1491,354,11538,463
41894,191,3215,937,2782,25319,433
34570,892,28379,1091,11506,110541,16873
15979,212,5550,1437,2478,33902,3072
9109,2626,115219,1512,41041,528390,74178
54650,684,10693,667,8293,92194,2400
17084,1069,47092,1419,19062,318308,28030
29458,31,801,1184,455,12843,346
9495,8,218,1510,136,12854,82
66573,0,6,304,3,663,3
2209,165,4127,1585,2509,33110,1618
14287,0,0,1461,0,10464,0
18708,3,226,1390,123,5536,103
16883,86,3662,1423,2529,49722,1133
59001,8,44,538,37,2124,7
30974,42,525,1154,348,5643,177
49397,287,5776,823,4006,49653,1770
19227,7,515,1381,351,12900,164
49717,90,3432,815,2049,14517,1383
19821,116,1723,1370,1231,14111,492
30157,62,1317,1170,909,9351,408
31772,80,1432,1142,1125,43320,307
59812,22,213,511,194,7426,19
50281,1068,21076,800,12648,114630,8428
50730,120,2022,789,1735,30694,287
17244,21,650,1416,505,9955,145
55058,9,59,654,55,3520,4
1660,3,175,1590,140,9581,35
29665,78,1284,1181,860,21864,424
24136,56,1297,1296,887,20683,410
24588,96,1722,1286,1209,17069,513
61974,36,511,434,330,6342,181
17361,0,0,1414,0,8415,0
6583,594,26867,1536,15999,189337,10868
13117,619,25224,1478,11080,158559,14144
48522,117,1794,843,1390,38771,404
56381,100,1020,617,826,27894,194
58491,1310,14451,554,12358,80849,2093
579,44,853,1598,630,35024,223
40014,26,617,967,584,8761,33
31802,52,1117,1141,811,23716,306
50683,84,1081,790,799,18292,282
51486,536,6658,769,4074,36480,2584
19140,422,7233,1382,5376,61730,1857
1392,5,190,1592,151,20077,39
57535,28,238,582,197,5271,41
2703,56,1892,1581,1060,19101,832
55604,168,2641,639,2312,14702,329
15677,2,188,1442,148,7866,40
49526,123,3021,820,1435,50552,1586
61511,21,391,450,295,10507,96
16972,104,8992,1421,2847,125524,6145
61302,77,748,456,596,8470,152
5803,4277,138626,1545,62769,589576,75857
8316,163,5413,1516,2388,57083,3025
26053,287,11239,1254,6902,71096,4337
53583,18,202,705,154,8016,48
27355,8,252,1226,160,9480,92
20774,12,300,1354,223,26780,77
46073,389,6720,884,5532,80407,1188
285,347,6813,1600,4109,36525,2704
34079,1030,23886,1101,17964,147818,5922
31725,889,18967,1143,11485,102885,7482
39764,135,2015,971,1755,22457,260
17474,79,5827,1412,3171,39753,2656
56064,134,2617,626,1376,29624,1241
44804,101,1435,898,1172,18894,263
23535,37,901,1309,648,41931,253
18574,11,571,1392,343,13235,228
22274,18300,356953,1330,162061,1068916,194892
57785,7,45,578,32,6314,13
16665,264,8248,1427,4661,87847,3587
21349,111,1183,1343,686,20682,497
17042,13,220,1420,166,17108,54
10639,4508,153518,1503,67281,701124,86237
9558,2565,113883,1510,66717,290221,47166
66502,665,12985,307,7840,98009,5145
50125,287,4526,804,3731,67784,795
62296,28,382,424,331,4569,51
5315,3171,79087,1551,42665,411130,36422
59181,0,381,533,312,6773,69
54917,233,4357,658,2653,29165,1704
66999,7,178,290,168,5573,10
60,139176,5660747,1604,1945605,9937104,3715142
54822,109,1459,661,1300,18929,159
9396,52,1436,1511,902,33221,534
56624,9,112,610,75,5999,37
35568,165,4104,1066,2542,19757,1562
18817,32,783,1388,615,15065,168
65392,5,76,335,61,2987,15
4920,37,1110,1556,732,33316,378
34497,49,943,1092,716,12396,227
51807,30,445,759,248,10905,197
58436,0,0,556,0,7096,0
38980,4,79,981,63,4930,16
15961,75,2454,1437,1837,35737,617
7430,1072,28109,1525,19271,184928,8838
6685,1113,29758,1534,19558,244421,10200
41689,23,520,941,442,14021,78
38217,502,7413,997,5779,90803,1634
41097,415,9675,950,5455,52775,4220
56475,1688,37001,614,24163,275736,12838
29339,24,749,1186,529,35040,220
24585,2125,51165,1286,38784,344495,12381
64414,5,68,365,49,2980,19
49233,408,11313,828,8007,111584,3306
11284,12,555,1498,303,9840,252
43996,0,1065,907,700,25438,365
51130,3910,63560,778,46842,248261,16718
13979,49,2483,1466,1391,31295,1092
13888,671,19620,1467,10692,145847,8928
3420,87,3202,1574,2451,46865,751
4068,42,1024,1567,722,15297,302
47815,71,1661,862,1106,51615,555
53511,61,1290,707,871,15394,419
21852,77,1074,1336,770,13717,304
37454,29,482,1017,407,10391,75
56335,7,48,618,44,2841,4
61100,2,37,463,26,2506,11
36872,49,502,1034,445,8598,57
23067,140,6850,1316,3044,46707,3806
9759,983,45178,1509,23828,146731,21350
18503,17,1121,1393,768,14768,353
18523,61,2221,1393,1046,10829,1175
18947,19,509,1386,372,10714,137
54794,14,162,662,114,8418,48
31399,78,1019,1148,734,12355,285
66498,13,285,307,216,6086,69
18408,106,2314,1395,1685,24701,629
9556,79,2076,1510,1305,24765,771
51188,10239,138390,776,95302,509077,43088
54868,1396,19078,659,16459,85276,2619
26182,13,664,1252,284,13062,380
37761,28,336,1008,309,12270,27
17374,12,416,1414,337,21988,79
12092,120395,4254304,1491,1483424,8535039,2770880
6528,8,330,1536,247,29758,83
62629,0,57,414,51,3943,6
32548,52,1199,1130,839,48949,360
530,26,998,1598,754,29728,244
4546,20,657,1561,501,15191,156
67783,17,444,265,320,9950,124
48885,110,1689,838,1490,21977,199
56502,2,51,613,29,1647,22
41860,70,784,937,597,16851,187
10995,341,10835,1501,6291,140309,4544
63153,50,475,402,417,11620,58
56611,22,313,610,272,5794,41
7478,1027,57956,1524,34800,310269,23156
36873,172,2754,1034,2323,41350,431
24959,0,478,1278,326,22897,152
42512,31,553,928,465,14572,88
18585,475,10549,1392,7057,104637,3492
21062,720,15259,1348,10357,63161,4902
51191,44,528,776,460,7890,68
38339,36,572,994,383,6829,189
67939,61,967,260,842,8212,125
25234,124,4850,1272,2458,45956,2392
38565,20,398,987,255,4221,143
11116,39,845,1500,535,41903,310
22737,6,341,1322,244,16587,97
10919,76,3466,1501,1587,20239,1879
31608,43,1437,1145,711,9916,726
54209,13,87,684,67,5193,20
8473,23,1093,1515,699,13000,394
21315,186,5503,1344,3053,51308,2450
1332,254,9767,1592,6990,57900,2777
42412,18,506,929,287,11349,219
48957,4188,72658,834,46095,554745,26563
25641,7,199,1264,121,4533,78
55096,38,431,652,326,18677,105
60966,60,958,468,755,11306,203
12401,11,392,1487,212,8956,180
15689,38,610,1442,401,19480,209
11735,40,1056,1494,627,18774,429
21898,16,696,1335,339,23252,357
17712,188,9473,1408,6698,56807,2775
6078,69,2902,1542,1871,27415,1031
38175,44,901,998,710,21650,191
17054,97,3544,1420,2184,34033,1360
4215,19,599,1566,385,25514,214
8159,6,247,1516,150,4475,97
3849,57,2206,1570,1541,59601,665
55456,27,466,643,339,13020,127
15141,245,7469,1450,4509,37454,2960
36149,1,104,1052,79,9405,25
46824,16,419,875,253,11095,166
66914,16,215,293,201,6564,14
6210,21,754,1540,540,20113,214
40820,35,841,955,612,11110,229
32668,38,1443,1128,763,14049,680
56745,103,1605,606,1292,17497,313
35120,130,1597,1077,1191,45395,406
63002,36,537,406,484,7181,53
64747,21,326,355,253,13203,73
3326,1,166,1575,119,16947,47
7403,19517,495777,1525,277958,1951209,217819
27729,11,277,1218,166,9786,111
2374,60,1308,1584,907,23107,401
10384,94,1732,1505,1716,11673,16
30013,445,15285,1173,9537,77147,5748
49911,6,57,810,52,2330,5
9434,28,1210,1511,711,12838,499
20549,17,1574,1358,764,20368,810
27747,689,28577,1217,13478,156626,15099
29062,69,1514,1192,1038,10118,476
10375,66,2000,1505,1289,47805,711
36168,57,1391,923,882,16334,509
62930,48,568,407,346,12041,222
56701,14,228,607,169,6147,59
20351,846,33463,1361,24028,256652,9435
57967,74,1243,572,1172,19535,71
19760,21,994,1371,604,6319,390
17814,400,18263,1406,9996,104833,8267
21634,32,1777,1338,909,10832,868
26008,32,992,1255,675,18312,317
20016,101,4611,1367,3301,114430,1310
13163,211,9419,1477,5692,62775,3727
32177,23,500,1136,317,33462,183
57675,15,211,582,184,9521,27
63240,439,9752,399,6861,66062,2891
14256,165,3254,1461,2201,27577,1053
19378,37,833,1378,675,8527,158
12025,3383,136032,1492,83253,455298,52779
62947,4,51,407,22,5499,29
19534,527,22672,1375,11897,153571,10775
37094,43,1035,1027,854,9847,181
18723,52,1081,1390,805,28812,276
44278,197,1888,904,1490,18904,398
56636,70,1226,609,1090,35119,136
14502,75,4297,1458,1816,26600,2481
46024,22,307,885,243,15584,64
17610,16,1021,1410,757,30807,264
60254,54,1110,495,809,21523,301
7892,142,2491,1518,1411,13653,1080
47092,16,199,872,150,13635,49
37117,318,5370,1027,4613,32043,757
32609,50,1259,1129,913,28882,346
1753,103,2488,1589,1486,21807,1002
63344,5,128,397,114,5508,14
17750,47,1184,1407,985,30074,199
15252,13,536,1449,408,6903,128
45570,11,147,889,90,2794,57
62879,36,504,407,407,7677,97
1908,37,3040,1588,1683,67887,1357
54901,41,635,658,476,14069,159
29003,12,376,1193,207,19399,169
24243,203,8130,1294,4281,52415,3849
7138,9,610,1528,408,32295,202
58283,4942,66357,561,53612,194255,12745
53810,111,1426,698,1308,9266,118
65405,30,484,337,477,7209,7
7807,1875,78310,1519,27647,599023,50663
35295,74,1289,1072,1096,15680,193
66541,12,138,306,72,1594,66
57938,829,8240,573,6424,41311,1816
52963,4,51,721,35,3908,16
41750,29,440,939,384,11527,56
1877,31,1460,1588,1093,37353,367
41028,56,711,951,526,21328,185
55143,21,382,651,332,7263,50
10493,1235,37214,1504,25370,223921,11844
13182,51,1795,1477,1069,12028,726
19867,121,2914,1369,2088,37366,826
34969,241,1510,1081,1247,15984,263
18069,12,758,1401,547,19082,211
24994,162,2460,1277,1443,19737,1017
63139,6,54,402,43,5326,11
20893,93,1402,1352,1070,32033,332
62152,33,276,428,227,10194,49
32809,1590,45699,1125,28111,133262,17588
6907,413,20769,1532,12773,66787,7996
47216,6,120,870,89,5631,31
30085,4,185,1171,117,8386,68
62884,643,12041,408,7129,119696,4912
16312,2,148,1432,99,8362,49
21930,200,5686,1334,2795,55273,2891
213,3782,72681,1601,48883,384685,23798
15050,545,18040,1451,12206,134571,5834
60337,44,452,492,401,5396,51
55380,80,737,645,715,13854,22
2711,25,1226,1581,922,16361,304
25291,14,660,1271,541,4293,119
54339,179,2175,679,1812,12690,363
12180,2480,104888,1490,60552,473106,44336
25853,953,18194,1259,11177,71881,7017
29469,1174,29396,1184,14384,288743,15012
64155,8,143,373,120,3982,23
61039,53,526,466,439,10265,87
56683,81,995,608,916,15457,79
60132,4,64,500,48,3916,16
56695,8,152,608,133,3765,19
7548,740,20095,1523,11222,111675,8873
27054,2215,52871,1232,30060,419147,22811
36350,92,967,1046,872,17623,95
32463,97,1570,1131,1136,40702,434
30666,830,25843,1160,16579,213240,9264
13456,0,0,1473,0,71804,0
21959,93,1722,1334,1272,19830,450
16920,18,657,1422,386,37332,271
33681,12,157,1109,108,5873,49
60410,121,2287,490,2259,31039,28
42039,14,177,935,149,12195,28
61109,108,6119,463,2260,20440,3859
7484,7922,205859,1524,118253,630397,87606
59459,20,289,523,251,7022,38
56744,2568,48165,604,31855,180381,16310
35958,14,591,1057,279,7002,312
28804,18,666,1197,374,10473,292
31959,24,443,1139,285,9142,158
23244,423,7339,1314,4471,57035,2868
36076,6,60,1054,51,4337,9
61886,275,6012,438,4479,47055,1533
28283,1774,23347,1207,18924,124083,4423
7245,1399,45341,1527,24179,259605,21162
58742,22,178,546,154,3132,24
37674,29,867,1011,549,34224,318
60579,7,77,483,65,3148,12
57398,19,179,589,126,4699,53
52115,7245,118367,749,69467,641907,48900
37700,6,171,1010,152,15537,19
57573,11,157,585,139,4813,18
28023,303,9422,1211,6603,82576,2819
6150,787,37699,1541,21394,239804,16305
12709,705,19203,1484,13465,86921,5738
10574,237,5406,1504,3855,30697,1551
5647,24,1143,1547,453,8680,690
30771,33,694,1158,475,14315,219
4811,49,2041,1557,1164,35750,877
56956,43,335,600,297,4465,38
6818,49,2233,1533,1607,14251,626
25263,159,2648,1272,2228,18622,420
44486,55,499,902,461,15556,38
67816,322,5171,264,5149,71434,22
12992,187,7015,1479,4319,46354,2696
67186,2,113,284,107,3051,6
5379,241,11066,1550,7344,82079,3722
17581,138,13418,1410,4195,69773,9223
18657,550,16224,1391,10218,70526,6006
22172,12,396,1331,335,8915,61
48764,81,1440,842,1292,21340,148
28757,26,782,1198,549,15996,233
3358,196,10826,1575,5425,108760,5401
19544,31,1582,1375,952,38295,630
59830,16,150,510,142,3987,8
51069,4375,87400,780,60972,266261,26428
66682,32,545,301,439,8330,106
19895,29,1089,1369,887,16009,202
6225,170,5589,1540,3986,34884,1603
27615,598,11988,1219,7454,80581,4534
10948,56,847,1501,532,14607,315
65414,60,839,337,837,13568,2
21952,209,6136,1334,3793,24782,2343
67171,11,167,285,153,5657,14
19547,254,10331,1375,7212,54658,3119
57670,27,266,582,232,6537,34
36157,18,196,321,161,9263,35
26380,48,1725,1247,942,52260,783
57217,6,34,594,29,1972,5
18141,6,254,1400,223,41212,31
45147,3,114,895,70,4779,44
3196,92,2572,1576,1155,29802,1417
104,13,1429,1603,911,13468,518
65157,32,90,343,75,6921,15
41112,15,303,950,275,7103,28
1993,37,960,1587,753,14161,207
40211,6,335,964,190,6807,145
48805,31,391,841,294,7101,97
16379,6,696,1431,108,17369,588
15941,22,797,1438,465,8983,332
12154,18,781,1490,468,15514,313
7336,7,340,1526,212,13707,128
5339,146,9464,1551,5417,55946,4047
6479,33,1109,1537,639,26239,470
45784,26,480,888,409,13907,71
34849,58,1440,1084,956,17392,484
25463,21,331,1268,283,19416,48
4064,169,4041,1567,2654,34192,1387
60336,25,243,492,227,8119,16
41645,206,1933,940,1547,33358,386
36043,13,448,1054,240,9565,208
14276,10,404,1461,323,9952,81
2546,14,405,1582,290,23330,115
25189,55,1835,1273,1316,45145,519
40055,49,1040,967,834,7637,206
25343,252,10687,1270,2768,59474,7919
53022,173,5718,719,928,21159,4790
31971,34,952,1139,602,17058,350
50532,703,11384,794,7343,61509,4041
29518,852,16432,1183,8485,72311,7947
35620,6,240,1065,181,9096,59
31059,179,3220,1152,2164,41278,1056
34049,25,569,1101,438,10409,131
8525,3,192,1515,122,3681,70
59602,68,496,518,454,8364,42
64803,27,401,354,401,5769,0
16554,42,3568,1428,2231,41471,1337
62773,56,1200,411,1019,15706,181
5785,89,3758,1546,3065,64860,693
34798,22,332,1085,232,4706,100
20995,26,1250,1350,657,17373,593
58550,3,46,552,42,2557,4
23964,151,3013,1301,1889,28501,1124
25713,1972,66102,1262,29120,259617,36982
63595,298,3651,390,2604,45504,1047
30084,32,646,1171,446,13220,200
66754,4,39,299,35,5435,4
13375,0,0,1474,0,7645,0
66343,46,694,312,578,10935,116
11717,22,1750,1495,976,29017,774
23581,32,1346,1308,904,6999,442
42764,9,226,923,206,11792,20
58212,1088,17072,564,14015,80522,3057
21287,7,147,1344,123,6232,24
53870,0,11,695,10,2953,1
1182,397,7052,1593,5073,53479,1979
13204,33,959,1477,671,23584,288
16259,104,2895,1433,1917,20213,978
15643,7,193,1443,142,15848,51
38098,16,298,1000,276,9159,22
61491,111,2532,451,1180,23225,1352
61382,6,87,454,67,3006,20
69098,7,92,221,81,7373,11
47370,2,78,868,71,3825,7
22033,8508,277803,1333,98435,623324,179368
53345,148,1503,710,1393,33655,110
9583,954,38955,1510,24027,147782,14928
23289,11,323,1313,237,3252,86
30900,188,2075,1156,1407,31668,668
34130,51,398,1100,357,48324,41
45445,41,715,891,474,19266,241
34904,236,5260,1082,3729,111496,1531
827,58,1684,1596,1064,31301,620
1300,114,4551,1592,3024,31661,1527
21709,337,8885,1337,5492,61792,3393
49325,26,770,825,593,12993,177
32129,17,427,1137,341,17311,86
69117,2,26,220,22,3063,4
40995,7,274,951,198,5821,76
20974,11,435,1350,307,10671,128
35685,8,595,1064,388,7688,207
38573,123,2200,987,1677,24361,523
50784,265,3273,788,2673,24446,600
33952,155,2562,1104,2047,12060,515
66468,276,4859,297,4767,59758,92
16571,67,968,1428,654,21343,314
3084,929,44013,1578,18123,142222,25890
23509,21,709,1309,513,28642,196
12620,348,7417,1485,4718,38533,2699
59351,2,55,527,52,9281,3
51972,182,2204,753,1935,34339,269
28938,46,944,1194,680,17686,264
4831,112,4213,1557,2581,18039,1632
33528,17,263,1112,195,8993,68
34108,2560,58380,1100,35830,132548,22550
61685,68,479,444,404,6645,75
68471,2,32,243,22,3078,10
25475,183,2927,1267,1778,29337,1149
70054,2,23,190,21,1434,2
53512,12,133,707,98,7380,35
29983,6,222,1174,151,14497,71
17613,132,3036,1410,1747,16521,1289
11080,56,2908,1500,1875,19559,1033
65811,7,71,327,53,5422,18
31023,150,2209,1153,1280,45220,929
21316,5,164,1344,118,15577,46
30643,102,1837,1161,1213,22741,624
11996,18,526,1492,303,17235,223
4860,816,20309,1557,12872,119751,7437
18951,2,99,1386,60,7890,39
39606,146,2198,973,1832,15281,366
14293,37,1626,1461,1214,23790,412
67317,11,152,280,149,3280,3
28907,175,2295,1195,1536,14476,759
69748,2,18,200,18,5639,0
23445,0,24,1310,18,2289,6
18732,542,5532,1390,4613,39282,919
62326,109,1277,423,1001,13818,276
19293,230,3506,1379,2133,50835,1373
62417,5,93,421,71,7547,22
58985,27,446,539,303,6907,143
15380,582,18312,1447,10387,53601,7925
9559,18,367,1510,258,9122,109
14665,36,1486,1456,1116,21118,370
3163,8,187,1577,95,5633,92
32199,14,402,1136,263,22000,139
32506,25,400,1130,282,5727,118
37934,199,5423,1004,2701,38002,2722
55869,58,1159,632,536,18386,623
61910,579,14640,437,8650,115243,5990
936,6,327,1595,241,19378,86
40710,46,515,957,448,5172,67
52625,118,970,732,704,23317,266
17328,54,689,1415,520,13091,169
7373,35,957,1525,691,34810,266
10372,17,541,1505,350,8191,191
41468,22,572,945,454,14888,118
21162,34,536,1346,342,10887,194
12752,1070,33868,1483,17776,143276,16092
53905,15,192,694,176,9977,16
1034,12,460,1594,268,18233,192
58259,26,601,562,480,9634,121
10648,120,4684,1503,1801,30461,2883
56907,11,113,601,106,3691,7
57620,476,12923,583,12632,56312,291
19380,44,1089,1378,772,25888,317
7225,29,1032,1527,583,17756,449
20923,7338,264167,1351,160197,886833,103970
28511,584,13105,1202,7436,55592,5669
12283,57,2068,1489,1093,28613,975
30895,424,13516,1156,7057,111062,6459
16727,36,2117,1425,1303,41854,814
32009,27,664,1138,384,15026,280
56895,24,319,602,186,4803,133
55725,383,8276,636,4685,54696,3591
48887,10,117,839,110,5508,7
5556,59,3550,1548,2358,25998,1192
11438,33,1447,1497,966,11913,481
45059,10,282,895,173,8652,109
54334,46,544,679,437,12176,107
59763,192,2565,512,2360,32828,205
8825,1318,30171,1513,22060,153950,8111
56998,6124,124205,598,78377,711561,45828
67053,10,101,289,85,4183,16
29243,623,13406,1188,8333,35604,5073
62640,103,2780,414,1390,37862,1390
27961,57,929,1212,612,13117,317
49587,2,13,818,10,6044,3
27196,5,224,1229,144,4822,80
22647,7200,106320,1324,77396,249571,28924
39684,43,932,972,782,29983,150
1014,120,4612,1594,3361,70575,1251
35904,39,733,1059,601,14080,132
49992,4,60,808,53,4273,7
33478,11,228,1113,193,10146,35
49782,9,243,813,161,7295,82
20520,112,1874,1358,1372,42970,502
38466,167,1616,990,1238,44598,378
38082,40,657,1000,453,10052,204
35110,11,144,1077,95,5139,49
32645,106,2400,1128,1542,31312,858
40835,18,279,954,255,10317,24
21356,112,2174,1343,1513,37443,661
20789,6,341,1354,222,7812,119
56899,12,96,602,85,5206,11
67659,203,3592,269,1484,63964,2108
14142,76,1706,1463,1094,11419,612
37253,32,1307,1022,998,21561,309
3271,340,11855,1576,6691,46075,5164
14257,38,7604,1461,1680,40582,5924
28655,258,5260,1199,3543,68822,1717
6647,6,277,1535,192,12440,85
15094,4048,165549,1451,72164,519960,93385
29502,12,216,1184,159,6547,57
7805,3,75,1519,64,22464,11
4910,8259,250895,1556,140214,599119,110681
11308,18,737,1498,444,14391,293
54213,26,168,683,137,15956,31
44866,112,1623,898,1409,17211,214
37407,350,7006,1018,6465,80262,541
48831,16,255,840,215,7742,40
10210,6,304,1506,177,4534,127
33276,239,3790,1116,2565,30196,1225
23878,202,3286,1302,2218,47729,1068
25151,33,383,1274,238,6850,145
35720,24,528,1063,433,12476,95
28240,89,1039,1207,695,23869,344
34109,32,254,1100,198,4126,56
49813,29,547,812,420,15898,127
59384,95,1772,524,1495,16536,277
63193,309,5159,401,3519,47749,1640
1165,33,1686,1593,710,26329,976
59733,2478,60498,513,50106,358852,10392
53209,10,83,713,77,3932,6
10281,2086,43319,1506,31688,196625,11631
13218,342,9807,1477,5362,76601,4445
26589,143,2946,1243,2125,41362,821
5976,74,1978,1543,1346,10724,632
60387,186,2868,491,2355,73050,513
8016,106,5428,1517,2822,42970,2606
55475,274,3459,639,2675,32041,784
7174,150,7821,1527,5167,79549,2654
6845,11,257,1532,200,11656,57
19902,59,3375,1369,1424,29592,1951
4376,185,5239,1563,4028,75341,1211
58092,31,383,568,316,7977,67
26371,0,128,1248,88,5304,40
32261,41,452,1135,282,4224,170
39373,24,822,976,567,20404,255
5881,22,603,1545,475,15753,128
53416,19,239,708,166,5941,73
65576,2,28,333,23,3304,5
14485,69,1894,1458,1370,14858,524
20634,31,1665,1356,1156,24767,509
24769,268,5913,1282,4656,63450,1257
43913,66,773,909,650,20869,123
3496,152,6902,1574,4320,80739,2582
4895,169,15393,1556,5420,64939,9973
4449,37,1957,1563,1397,21583,560
26354,4770,150722,1248,82189,542281,68533
19670,40,902,1373,696,23499,206
13779,19328,757629,1469,210362,1386249,547267
31243,124,2756,1150,1679,22259,1077
7442,3,128,1524,92,23294,36
57726,514,6891,579,5911,68371,980
66477,25,222,308,162,5002,60
5589,2961,118827,1548,54970,506993,63857
55964,38,347,629,291,4186,56
53299,41,526,712,430,7244,96
20129,5,263,1365,215,14135,48
48645,278,2585,846,2385,20480,200
32452,306,6843,1131,5044,43783,1799
40996,77,1078,951,763,18342,315
26908,24,721,1235,488,25852,233
68663,3,90,235,77,4732,13
10262,125,3206,1506,1711,44758,1495
54958,0,0,657,0,10196,0
28383,15,364,1205,239,4610,125
60253,1,104,495,84,11892,20
50402,167,1648,797,1237,13922,411
6374,21,431,1539,263,16049,168
6298,4,120,1540,86,7413,34
14014,49,3807,1465,2016,29872,1791
53838,2,21,697,13,4189,8
51320,495,6940,773,5293,84446,1647
6267,9,84,1540,55,2575,29
13017,160,4415,1479,2587,45260,1828
6348,8105,468089,1539,171242,1307633,296847
42025,0,106,935,84,4437,22
1263,5,306,1592,224,18826,82
33939,10230,287063,1085,107539,1099736,179524
12177,23,885,1490,534,12360,351
59646,9,84,517,73,5534,11
5640,82,3121,1547,1784,35889,1337
13127,18,1310,1477,522,17107,788
57454,27,287,588,259,19500,28
24527,19,820,1288,449,21188,371
18612,1,152,1392,131,8062,21
63609,23,441,390,374,10425,67
427,146,17893,1599,5278,186541,12615
15589,319,4552,1443,3030,55800,1522
21766,15,356,1337,234,3874,122
12822,64,2748,1482,1522,47605,1226
18430,31,1122,1395,749,9796,373
25094,12,350,1275,270,11710,80
51006,18,177,782,157,6604,20
21491,24,938,1340,506,17076,432
63039,37,1121,405,795,11060,326
66036,53,505,320,451,13296,54
1612,5,361,1590,219,8697,142
24245,24,1040,1294,747,9479,293
4201,194,4533,1566,2833,53307,1700
35062,2,75,1077,51,2770,24
69314,37,569,214,516,8040,53
26322,153,3681,1249,2718,25009,963
31304,64,2318,1149,1658,24204,660
4757,12,520,1558,302,28679,218
47715,538,7075,863,5692,64504,1383
64844,13,86,352,70,6128,16
10929,176,7798,1501,2759,48637,5039
61124,221,3835,462,3315,21823,520
1117,5855,157509,1594,87984,362694,69525
25555,55,1531,1266,1023,12127,508
55894,18,263,631,208,19494,55
26651,322,6964,1241,4802,61607,2162
63230,19,228,400,211,5420,17
10935,147,2584,1501,1738,18396,846
40386,925,8293,961,5728,78816,2565
38857,48,904,982,652,9820,252
24398,4741,80044,1291,52492,337608,27552
23966,124,3602,1300,1914,37976,1688
66212,17,210,315,189,17813,21
32516,254,6115,1130,3350,69274,2765
8002,16,925,1518,698,17635,227
32425,20,518,1132,382,10471,136
54191,56,612,684,385,11670,227
6304,19,1465,1540,730,14133,735
53713,35,211,700,174,10774,37
4903,569,34187,1556,9863,150885,24324
10123,681,16003,1507,12169,140928,3834
3059,7,185,1578,112,5708,73
56359,949,13425,617,11714,99235,1711
66767,8,182,298,145,5466,37
60332,32,863,492,781,10462,82
20436,854,11214,1360,8356,100580,2858
17425,58,1198,1414,920,22024,278
12380,14,2004,1488,688,28322,1316
36195,578,7152,1049,5568,80086,1584
2220,258,6318,1585,4572,65116,1746
31018,104,3520,1153,2259,116893,1261
30761,149,3665,1157,2153,28730,1512
65181,35,381,340,316,7310,65
24590,170,2847,1286,1898,22368,949
15798,177,3784,1440,2809,50815,975
29784,116,5892,1178,2493,33302,3399
9655,898,34532,1510,15715,128567,18817
42183,514,6549,933,6485,52741,64
66639,19,322,303,282,7807,40
3884,20,478,1569,329,15090,149
40348,435,7038,962,5850,72257,1188
7509,23,1087,1524,557,33805,530
5321,0,11680,1551,6967,54741,4713
33075,160,2660,1120,1809,18632,851
21584,31,1697,1339,1118,16865,579
28684,123,2675,1199,1507,57450,1168
31938,620,18209,1139,6980,161653,11229
6211,4,182,1540,129,13122,53
13444,110,7031,1473,3395,30109,3636
3328,1453,25723,1575,21337,112448,4386
9705,517,9796,1509,5646,56404,4150
22494,6,138,1327,87,9010,51
29020,249,5052,1192,3672,36254,1380
28632,177,5708,1200,3054,72446,2654
55870,1,451,632,246,3084,205
55649,82,755,637,620,11331,135
40734,32,469,956,441,11492,28
58130,22,278,567,263,11586,15
54588,1,23,670,16,3533,7
1129,60,1577,1593,1102,27876,475
3634,1731,40743,1572,28027,88134,12716
16801,126,3225,1424,1898,34264,1327
32933,129,3477,1123,2414,36328,1063
6721,120,7435,1534,2324,38681,5111
29383,41,886,1186,557,14720,329
19363,54,1378,1378,1017,31162,361
2759,16,626,1581,450,32570,176
52526,264,2600,735,2386,78223,214
14956,78,678,1453,479,7558,199
27565,79,3357,1221,2135,43520,1222
44449,28,260,902,212,7684,48
23195,9,199,1314,135,8469,64
4545,13,387,1561,250,5969,137
57138,10,322,596,163,8782,159
69279,10,58,215,52,5775,6
16448,98,2953,1430,1841,49450,1112
41296,50,656,947,600,31729,56
979,10,573,1595,382,7264,191
64401,678,7585,365,6411,54371,1174
64148,18,303,373,301,9602,2
31776,74,3520,1142,2069,41765,1451
14122,401,13405,1463,8459,101047,4946
8024,62,2219,1517,593,13895,1626
24958,46,715,1278,561,29370,154
26500,124,3241,1245,2122,19781,1119
34860,7,270,1083,159,9110,111
33790,8,187,1107,131,8197,56
27341,66,2908,1226,1603,61693,1305
25960,22,244,1257,227,6403,17
31634,15,348,1144,225,12391,123
35417,18,255,1069,197,7588,58
11376,19,734,1498,423,15781,311
18878,71,1809,1387,1296,19326,513
38233,13,207,923,142,7804,65
64931,13,105,349,96,3062,9
11710,62,1815,1495,1039,16772,776
16792,11,323,1424,228,14527,95
9002,23,829,1513,549,16930,280
10810,10,458,1502,252,20642,206
11096,48,1468,1500,889,8115,579
14370,1,152,1460,88,3574,64
37531,65,668,1015,578,14814,90
1573,131,5118,1590,3056,59653,2062
48794,94,1166,841,1051,27637,115
54867,4873,91489,658,69178,504805,22311
30399,86,2379,1165,1607,29863,772
41129,54,893,949,726,9618,167
2123,51,3029,1586,1834,62264,1195
21091,17,412,1348,286,10377,126
12576,7,312,1485,136,9418,176
12352,33,1774,1488,917,50775,857
33885,83,2789,1105,2069,31127,720
10474,273,11350,1504,7193,75796,4157
60019,44,961,504,557,20295,404
57971,53,1009,572,746,32747,263
27107,74,2557,1231,1269,34112,1288
60490,2,33,486,15,5182,18
57276,56,581,591,492,18763,89
48052,221,2760,860,2281,38801,479
10549,18,470,1504,359,24460,111
66084,71,797,320,756,17865,41
52967,50,749,721,606,32506,143
11358,44,1888,1498,1383,28428,505
2122,792,21145,1586,11674,158630,9471
60847,8,137,473,115,3203,22
60368,75,842,491,737,6102,105
59465,97,2176,467,1462,32323,714
24742,122,3067,1282,2316,31353,751
6873,162,5132,1532,2864,49665,2268
3954,20,1057,1569,579,15447,478
1746,62,1661,1589,1077,33638,584
27950,12,237,1213,177,5932,60
58921,251,2626,540,2262,15159,364
9760,47,1306,1509,817,19001,489
18313,14,2190,1397,820,26389,1370
66521,2,65,306,57,3627,8
52002,265,2571,754,2343,36076,228
56934,5,83,601,69,3441,14
48,639,42863,1604,24434,184059,18429
25360,4101,94904,1269,55235,513351,39669
37998,21,463,1002,321,23868,142
53906,353,6423,694,5505,68436,918
20320,0,36,1362,36,10591,0
29009,36,416,1193,268,4464,148
14541,153,3379,1457,2403,44577,976
34838,21,406,1084,301,10261,105
14716,14,572,1455,427,45945,145
35828,501,7728,1060,5828,86649,1900
57322,78,1051,591,944,36515,107
63774,1143,25359,385,23801,253337,1558
27510,43,909,1222,573,17353,336
27457,36,894,1224,618,10167,276
37373,4,84,1019,68,6197,16
19213,31,780,1381,533,25196,247
23778,4,598,1304,324,11471,274
38047,6,160,1001,125,6292,35
33422,165,3438,1114,1852,26833,1586
19510,50,1469,1376,1093,20691,376
8664,10,645,1514,462,11682,183
13132,89,3390,1477,1784,23755,1606
62748,15,483,412,191,4199,292
39689,232,3468,972,2851,55482,617
25940,17,323,1257,229,10599,94
6368,19,1087,1539,590,10759,497
41625,49,718,942,555,22516,163
35069,138,1731,1078,1385,15104,346
27051,310,4962,1232,3342,23610,1620
52521,54,1020,735,586,32600,434
12666,18,676,1484,296,10640,380
648,955,53487,1597,20343,215204,33144
18586,14,601,1392,378,8948,223
9850,300,11858,1509,7057,97704,4801
60557,43,584,484,573,10887,11
49939,662,8220,809,6721,108475,1499
65466,80,1133,336,778,10776,355
68293,7,48,249,44,3081,4
34636,23,894,1089,572,15864,322
36262,0,0,1049,0,3434,0
28759,42,1072,1198,631,8309,441
19862,3,153,1369,122,21431,31
29492,501,8098,1184,4407,80956,3691
65542,15,124,334,82,3315,42
51287,152,1520,774,1058,18201,462
20244,404,17642,1363,8179,69802,9463
12304,87,3229,1489,2056,53082,1173
32392,11,591,1133,353,5370,238
19115,27,1073,1383,683,27209,390
16606,108,2840,1428,1567,33030,1273
54830,8,85,661,66,5845,19
26215,5,347,1252,173,8979,174
32937,135,3530,1123,2091,32482,1439
4612,12,472,1560,314,15295,158
6859,109,5231,1532,3038,34812,2193
60320,7,158,493,92,5696,66
6999,95,2658,1530,1537,20370,1121
64541,515,5042,362,4857,26440,185
32235,853,23537,1135,13317,173705,10220
34858,2709,41381,1083,33746,163776,7635
15986,3,93,1437,79,13932,14
53485,43,1149,707,735,24492,414
64299,14,172,368,102,8127,70
26958,7,500,1234,285,7531,215
56814,3,93,604,83,3821,10
51459,111,1149,770,911,16383,238
46247,56,884,882,672,16981,212
6083,23,800,1542,468,16671,332
30729,77,4425,1159,2682,61485,1743
55437,5,61,643,41,4837,20
58295,83,716,561,639,16789,77
4097,11,632,1567,453,10818,179
69836,33,392,197,343,4194,49
23552,70,1833,1308,883,10495,950
10217,3,196,1506,137,7958,59
65900,103,1748,325,1336,42819,412
2077,41,1033,1586,563,19634,470
10908,162,9240,1501,3651,70028,5589
50672,28,371,791,331,4076,40
56214,34,475,622,460,6819,15
12424,2895,128565,1487,58758,688291,69807
48486,60,1075,842,961,27366,114
51390,445,7155,771,3428,49944,3727
57542,7,82,586,65,3827,17
31864,225,4394,1141,2611,29158,1783
11093,13,631,1500,350,5832,281
26360,37,638,1248,374,12800,264
1028,132,3412,1594,2412,70360,1000
8739,2338,89697,1514,53232,281568,36465
14579,2,336,1457,231,14689,105
24911,44,1191,1279,830,40968,361
56393,15,283,616,219,11545,64
35525,321,5822,1067,3368,39521,2454
46257,60,1265,882,1052,12584,213
53106,53,833,716,537,11269,296
5700,9,251,1547,183,11225,68
5301,13,466,1551,250,14223,216
9317,32,1374,1511,817,31874,557
27978,14,297,1212,268,12128,29
19342,52,2605,1379,1460,13405,1145
20844,25,679,1353,497,20900,182
4728,42,1017,1558,693,23478,324
28454,403,10582,1203,6483,74071,4099
1178,2856,98027,1593,64757,339280,33270
53666,59,907,702,788,12505,119
17783,47,1898,1406,1285,53223,613
7055,6,233,1530,136,9669,97
69561,13,219,206,181,6820,38
4344,65,2450,1564,1815,42786,635
23474,9,295,1310,224,10590,71
18889,8,171,1387,131,14409,40
28100,47,1489,1210,992,37160,497
24596,331,13234,1286,4717,83050,8517
27992,12,169,1212,111,3006,58
19545,295,5147,1375,2508,25510,2639
29676,297,5854,1181,3235,65443,2619
19207,15,290,1381,266,15335,24
54825,1494,13376,661,11410,76806,1966
31842,9,752,1141,427,10446,325
41704,205,3538,940,3048,40269,490
8587,78,2564,1515,949,20840,1615
7270,1509,73546,1526,28970,386585,44576
12942,41,1124,1480,727,20447,397
66708,51,757,300,738,14531,19
7117,84,1943,1528,1590,21306,353
29425,70,1694,1185,1429,18552,265
57797,9,133,578,115,6339,18
36070,50,756,1054,610,38899,146
21272,100,2626,1344,2046,21824,580
29865,11270,227017,1176,147982,694578,79035
64192,106,1426,372,1275,13033,151
25356,103,1948,1270,1031,36767,917
23416,3764,118406,1310,46033,400500,72373
37628,119,1409,1012,1247,17424,162
760,53,3066,1596,1774,21312,1292
20292,95,3382,1362,2605,33945,777
52918,1154,17778,722,11843,87530,5935
40150,110,1824,965,1411,31417,413
28452,205,2091,1203,1647,16723,444
52540,12,157,735,144,13195,13
23771,12617,328600,1304,183781,868124,144819
52986,2288,34395,720,18459,131352,15936
38523,114,3027,988,2551,32170,476
24331,12,273,1292,169,3913,104
64939,165,2596,349,1930,19323,666
53178,16,240,714,209,5088,31
5495,338,16081,1549,8827,140418,7254
31248,19,572,1150,405,11080,167
27795,13,193,1216,172,15972,21
14852,43,2555,1454,1526,25532,1029
14429,277,4253,1459,2853,60620,1400
33034,1269,17893,1121,14146,97241,3747
59776,30,369,512,360,6744,9
12700,1477,98041,1484,54498,326122,43543
35273,35,625,1073,440,10808,185
31685,3551,84353,1143,52819,271473,31534
45329,87,1425,893,1232,22907,193
2734,15,1347,1581,841,29093,506
26918,27,827,1235,508,6452,319
6564,527,26126,1536,14675,96789,11451
65991,595,6872,322,6825,84088,47
56787,4146,81353,605,51055,513544,30298
35956,90,2202,1057,1745,35015,457
33237,37,1019,1117,547,9931,472
13879,6,602,1467,361,12523,241
12353,16,951,1488,399,9486,552
15110,17,407,1450,290,6432,117
5120,14,521,1553,365,11994,156
1411,8,316,1591,229,8012,87
16298,55,1039,1432,801,35242,238
66857,8,179,295,164,7046,15
26103,8,310,1253,253,5836,57
5180,73,2931,1552,1776,27374,1155
21087,41,1103,1348,656,29625,447
35717,20557,430274,1063,260275,1212197,169999
6982,8,479,1531,371,27505,108
131,12925,845158,1603,363554,3699065,481604
64918,220,5126,350,4117,25624,1009
13422,25,1623,1474,1042,28393,581
32366,9,421,1133,274,6745,147
19764,7,284,1371,190,8147,94
31833,83,2546,1141,1614,22594,932
22063,32,1084,1333,740,46800,344
28963,120,2991,1193,2005,15685,986
58481,265,2318,555,2075,21697,243
28650,216,5603,1199,2918,52963,2685
23250,64,1646,1314,1178,34298,468
26830,56,1738,1237,1107,11984,631
31751,132,3313,1142,2378,38205,935
8114,47,1417,1516,757,16713,660
62658,10,101,414,31,12584,70
17019,6,190,1420,167,10492,23
4849,108,2297,1557,1162,14859,1135
5894,3,293,1545,169,10166,124
26629,80,2627,1241,1675,35867,952
2526,6,238,1583,147,6888,91
16620,52,4727,1427,2400,37097,2327
51135,101,1545,778,1370,20631,175
21740,14,505,1337,279,7502,226
40695,931,12036,957,10673,135635,1363
8243,1218,30048,1516,18393,79836,11655
7748,2200,106979,1520,45390,466011,61589
48781,47,516,842,459,7968,57
55093,122,1115,653,987,16159,128
5057,108,3504,1554,2646,64827,858
62129,26,185,429,169,8095,16
65490,63,891,335,884,9507,7
3908,17,1009,1569,662,26271,347
60597,64,905,483,713,13466,192
58519,1107,24998,553,16693,201966,8305
330,158,5551,1600,3075,33658,2476
22178,21,595,1331,562,26174,33
27661,96,1518,1219,758,18761,760
32885,12,576,1124,255,12508,321
6394,1016,56495,1538,26065,301812,30430
4626,54,1768,1560,1000,29675,768
6616,103,2662,1535,2332,39133,330
4127,18,603,1567,410,12843,193
62575,94,1038,416,1014,12828,24
54559,192,2086,671,1426,30074,660
1104,282,10366,1594,5509,67515,4857
22177,57,2744,1331,1215,35588,1529
14252,37,1237,1461,838,28348,399
2216,61,2079,1585,1699,32797,380
30911,221,2711,1155,1846,31196,865
8506,223,17473,1515,8208,99771,9265
60494,13,117,486,113,2289,4
43892,29,490,908,358,11753,132
19169,1626,79540,1382,38169,259200,41371
62480,6,239,419,218,11902,21
63694,59,680,387,662,19874,18
11631,172,7399,1495,4193,55183,3206
35839,250,3527,1060,2476,100087,1051
2577,292,8586,1582,5364,75054,3222
63471,89,748,392,710,20320,38
972,51,1760,1595,1153,44796,607
37118,12,413,1027,295,8582,118
42010,9,101,935,74,5919,27
32377,190,2893,1133,2171,14548,722
28582,16,401,1201,205,9775,196
68681,3,29,235,20,4820,9
1705,16,659,1589,461,23676,198
59918,39,705,507,673,14408,32
63430,65,864,394,587,16234,277
30945,415,16338,1155,9785,101813,6553
56300,13,178,619,162,10499,16
2770,883,23538,1581,15225,111378,8313
33277,33,1085,1116,575,19312,510
57284,42,627,592,394,12556,233
15904,49,2304,1438,1559,23850,745
13271,199,3975,1476,2511,38424,1464
2903,661,20297,1579,10238,81931,10059
10248,7,460,1506,308,7907,152
29607,8,581,1182,335,15701,246
49837,45,568,812,434,5285,134
14178,6005,148957,1463,69444,480062,79513
50469,768,9045,795,7416,64347,1629
33157,11,403,1119,282,10280,121
13900,4,558,1467,64,6835,494
9842,846,31104,1509,16640,117506,14464
29988,75,1500,1174,972,22068,528
36892,32,345,1033,302,10262,43
57883,3,49,575,42,5113,7
4329,52,1601,1564,1115,34441,486
62682,5,90,413,79,3587,11
4165,13,300,1566,192,24086,108
9908,49,1765,1508,1086,15280,679
63087,11,96,403,85,4224,11
3711,13,433,1571,226,15379,207
1387,623,23145,1592,14495,372187,8650
59836,33,390,510,367,9622,23
59782,6,60,511,49,4050,11
999,32,878,1594,656,30825,222
61779,4,90,441,83,9772,7
61399,23,609,454,427,6422,182
7163,601,10766,1528,7757,114151,3009
49964,992,20224,807,15587,190571,4637
59685,215,4027,515,3792,51994,235
30638,4576,128129,1161,67672,567055,60457
16859,5,876,1423,483,27887,393
13131,18,1053,1477,543,15068,510
57560,26,204,585,167,4805,37
52228,1610,35131,746,30061,267102,5070
64881,13,161,351,152,8325,9
49948,15,235,809,161,4468,74
54857,3,70,659,51,3689,19
5216,9,168,1552,119,13015,49
28972,91,2214,1193,1416,19947,798
3452,41,1495,1574,986,28202,509
63098,114,1701,403,1334,17710,367
19288,0,0,1380,0,5015,0
18630,231,6633,1391,4794,57142,1839
23060,35,437,1316,394,18134,43
60742,169,3299,477,2385,21224,914
27533,55,1568,1222,1005,14652,563
31846,31,1627,1141,1082,12007,545
5973,8,209,1543,157,4136,52
25984,30,787,1256,505,18901,282
28690,63,1096,1199,719,9993,377
25703,136,3861,1262,2381,27644,1480
5240,33,1468,1552,935,22114,533
30263,160,4868,1168,3492,59702,1376
37845,16,128,1006,107,8734,21
33045,47,603,1121,410,5025,193
35913,71,1512,1057,1207,16758,305
10894,12,806,1501,542,22588,264
60589,74,688,483,534,14231,154
57718,21,244,581,212,4554,32
50450,22,388,796,309,5285,79
15625,331,7436,1443,4123,71583,3313
64967,31,421,347,388,5111,33
32511,17,496,1130,308,7685,188
20989,120,2814,1350,1990,25807,824
1458,77,3749,1591,2628,29088,1121
23924,386,7137,1301,4320,61519,2817
9750,4,319,1509,130,8451,189
43087,24,242,918,180,6520,62
38017,324,5684,1002,4755,81885,929
4946,545,46021,1556,14274,217209,31747
35629,37,979,1065,587,12334,392
1306,2486,71670,1592,40299,135938,31371
48964,4,55,836,47,4299,8
36531,213,1791,1040,1547,18380,244
61078,29,643,464,252,7317,391
68390,21,443,246,360,9180,83
28110,3408,110740,1210,53597,265258,57143
23727,88,2253,1305,1692,24663,561
35811,97,2005,1061,1233,14490,772
44939,27,295,897,240,10971,55
27112,25,571,1231,414,30880,157
41041,9,196,951,171,7398,25
60144,198,3031,499,2246,32006,785
5999,113,3563,1543,2764,22936,799
21346,16,929,1343,578,39584,351
20663,442,12466,1356,9990,117032,2476
65892,1,37,325,29,4293,8
28596,576,12552,1201,8782,106773,3770
49743,15180,322283,814,221100,864043,101183
11321,10,598,1498,286,13407,312
42875,142,1330,921,1237,18579,93
66365,12,227,312,139,10926,88
50331,146,2452,799,2016,24508,436
48629,7630,205988,847,70170,877100,135818
4000,17,557,1568,402,15542,155
58897,131,1825,541,1580,34249,245
5033,8,119,1554,66,8252,53
15271,13,452,1448,276,19853,176
63313,111,2013,398,1682,34585,331
17078,185,2508,1419,1823,23347,685
521,598,31123,1598,17128,129187,13995
49065,50,932,833,797,28742,135
13246,469,13155,1476,5641,113623,7514
12929,231,7665,1481,3759,43447,3906
29821,134,3585,1177,1410,43047,2175
12089,28,1096,1491,632,9414,464
33949,75,2049,1104,1413,24035,636
44091,44401,697300,906,433681,1826463,263619
29397,5,397,1185,347,21543,50
24204,5,967,1295,561,20432,406
37687,5,69,1010,54,3035,15
18912,1785,53664,1386,26852,356419,26812
60886,106,1112,471,1044,15439,68
66265,7,84,314,82,4376,2
26777,405,8960,1239,5430,95151,3530
25395,4177,95546,1269,52744,499673,42802
51930,6,103,756,84,8298,19
17239,196,3357,1417,2299,24781,1058
44572,30,585,901,260,12802,325
14947,1708,32566,1453,19619,144362,12947
66022,85,836,322,784,13440,52
49643,9,183,817,133,4638,50
50336,5981,71541,799,52475,290173,19066
17187,26,714,1417,538,10388,176
62888,71,1913,408,1628,28399,285
30725,9,125,1159,98,6389,27
35709,11,299,1063,254,8881,45
57404,652,9295,588,8696,44259,599
29743,48,796,1179,520,10114,276
62132,246,4470,429,4369,70566,101
31438,5,232,1147,164,6010,68
50956,231,2596,783,2001,23109,595
2576,76,3765,1582,2520,120333,1245
1578,13,902,1590,635,10481,267
65539,4,87,334,83,5494,4
35436,113,3130,1069,2694,40731,436
8420,30,1130,1515,677,8412,453
10652,8199,221010,1503,98790,619199,122220
4229,31,422,1566,336,4885,86
36557,5,81,1037,64,6401,17
42704,85,1366,920,1197,24687,169
13808,54,818,1468,446,12489,372
9003,23,1232,1513,728,22010,504
20725,21,1182,1355,861,16637,321
2916,355,14805,1579,6833,72704,7972
33345,253,5489,1114,3658,24910,1831
37777,51,869,1008,489,10623,380
35647,1027,21517,1065,14281,157433,7236
22673,7,68,1323,51,3243,17
11158,23777,408782,1499,225894,1704372,182888
60037,56,512,503,495,9429,17
37130,334,8995,1026,7003,48342,1992
1707,20,1314,1589,626,51748,688
14572,11,572,1457,418,21879,154
48654,64,788,572,613,12269,175
63713,143,1351,387,1223,21580,128
66361,22,333,312,282,2830,51
20440,12,331,1360,241,7191,90
27386,10,176,1225,151,6695,25
27777,40,1318,1217,651,14055,667
36324,36,842,1046,756,11724,86
5518,2456,53335,1548,37288,595154,16047
8497,14,738,1515,503,6176,235
309,20,1201,1600,665,26836,536
69724,8,112,201,83,3609,29
3199,3,87,1576,64,11751,23
27684,0,0,1218,0,5107,0
55333,8,65,646,61,6087,4
48341,28,2375,855,781,9173,1594
34001,13,315,1103,173,3738,142
20101,36,1622,1365,1155,44602,467
15135,30,522,1450,340,11990,182
64013,105,712,377,548,8845,164
9846,620,28825,1509,14138,70196,14687
23646,122,1497,1307,1273,36805,224
3388,26,912,1575,545,16044,367
6354,34,775,1539,530,19564,245
27414,67,1584,1225,926,9917,658
37495,763,8792,1016,6045,40365,2747
6640,31,371,1535,240,29106,131
49209,233,2811,828,2013,19246,798
54244,1144,15236,683,14386,102209,850
5569,128,3671,1548,2383,20578,1288
48415,172,2211,854,1763,34952,448
15607,9,238,1443,191,7389,47
60738,1096,16573,477,11671,146656,4902
58486,75,874,554,802,11975,72
12543,35,2772,1486,1556,29292,1216
60510,28,328,486,294,4732,34
3550,10,392,1573,186,16241,206
63346,231,3122,397,2535,51805,587
59110,126,1520,535,1359,19533,161
10344,23,788,1505,522,15082,266
7190,11,523,1527,133,19797,390
15569,27,952,1444,705,15658,247
13790,175,8604,1468,4547,40150,4057
37644,86,1263,1012,1033,23373,230
965,70,1809,1595,1366,30610,443
35805,58,1706,1061,1244,18314,462
16721,23,902,1425,654,21552,248
10793,13,494,1502,315,12294,179
21200,49,1576,1346,1251,24989,325
51926,27,442,756,337,6923,105
49467,50,985,821,807,23359,178
19589,22,482,1374,436,18237,46
33636,40,1674,1110,1055,38244,619
4722,41,1381,1559,842,19476,539
56588,4957,76451,611,54853,362203,21598
61697,52,1039,443,814,13542,225
57530,2495,47080,586,31125,336346,15955
33962,16,316,1104,213,11881,103
66142,14,189,317,178,7931,11
45440,4,108,892,65,1670,43
35549,136,2740,1066,1757,20576,983
66689,35,516,301,402,11730,114
8644,96,3139,1514,1944,43363,1195
30601,251,1872,1161,1532,18985,340
35247,98,1776,1074,1354,35245,422
37824,70,959,1007,834,12829,125
50427,45,654,797,489,8719,165
48160,1777,16598,858,10569,369018,6029
57068,12,171,597,163,8817,8
2791,8,491,1580,309,9754,182
15381,215,5418,1447,3880,52343,1538
59905,77,1483,507,871,17915,612
68612,5,92,237,64,3658,28
17383,0,162,1414,71,6791,91
20967,24,722,1350,535,14094,187
27727,573,11346,1218,6083,53337,5263
4104,173,2799,1567,2348,28622,451
35220,16,212,1074,180,8372,32
10808,36,1039,1502,658,9838,381
64456,7,68,363,67,3256,1
18601,678,31068,1392,15516,205565,15552
55310,29,273,646,224,4759,49
58934,917,8297,540,7490,65858,807
36803,161,1333,1036,1056,8915,277
3845,28,452,1570,282,9031,170
50547,24,358,793,239,11498,119
26646,79,1330,1241,915,11870,415
10457,19,702,1505,467,16523,235
3745,502,21463,1571,10653,142184,10810
32355,65,1284,1131,913,12763,371
60889,47,575,471,514,18640,61
33462,1638,42455,1113,29567,245915,12888
25994,230,8001,1256,4271,44892,3730
51126,138,2562,778,1626,29344,936
58831,21,164,544,123,4563,41
17729,36,2299,1407,1443,68991,856
4269,3,237,1565,160,28901,77
26035,123,974,1255,876,11656,98
14930,29,977,1453,697,13191,280
37595,21,388,1013,178,8344,210
754,14,850,1596,482,27613,368
22065,4406,74060,1333,49579,302949,24481
64499,10,84,363,64,3057,20
14205,3734,90353,1462,58009,377556,32344
56135,25,335,624,311,14712,24
55837,2,44,633,40,4454,4
63341,1,38,397,27,2052,11
30830,98,3352,1157,2333,38640,1019
58704,6917,122361,542,93574,537637,28787
7554,3322,249065,1523,53638,680792,195427
4416,15,399,1563,265,6911,134
19376,2,61,1378,38,3673,23
893,13,592,1595,378,7783,214
22870,1098,30300,1320,22243,223577,8057
5520,92,4435,1548,2873,21421,1562
13173,1338,103202,1477,32314,274612,70888
49619,85,1412,818,1209,21164,203
63655,4,22,388,20,2239,2
55407,886,7205,644,5714,77198,1491
14642,3576,113087,1456,67519,636390,45568
58600,5,68,551,46,3928,22
37062,366,7318,1028,5288,61400,2030
53656,43,795,702,555,13196,240
10536,4,133,1504,97,8329,36
718,431,19157,1597,13737,152968,5420
19322,0,0,1379,0,7883,0
32274,25,1062,1135,747,21303,315
4782,30,1811,1558,1230,22631,581
40785,384,3677,955,2550,22891,1127
58973,4176,79253,539,60535,384890,18718
4247,80,2296,1565,1450,31964,846
18854,5,337,1387,100,5638,237
37436,5,85,1017,65,6449,20
15204,49,1415,1449,986,20658,429
42660,9,385,925,316,10554,69
19986,12,607,1367,432,6001,175
52266,6283,103185,745,62493,308820,40692
27931,412,9608,1213,5516,56350,4092
37818,1,45,1007,38,3015,7
61295,12,61,456,39,3461,22
20814,12,243,1353,171,6156,72
23118,7,121,1316,82,6774,39
42044,243,2489,935,1809,30882,680
87,976,44433,1603,22717,180421,21716
22059,1,94,1333,40,6087,54
60911,108,1601,470,1401,17660,200
68254,5,66,251,54,2211,12
26056,225,8326,1254,2832,70815,5494
17231,8,311,1417,195,12590,116
56426,2,38,616,16,1652,22
22108,93,6841,1332,4061,32246,2780
54106,68,540,687,438,7655,102
52128,19,321,749,255,12970,66
57415,10,157,589,127,3997,30
15106,60,854,1451,670,12450,184
48956,422,5967,836,4572,86427,1395
66161,232,2480,317,2419,15272,61
21685,0,0,1338,0,4535,0
19662,36,893,1373,627,12669,266
13455,16,642,1473,320,13733,322
36340,2,184,1046,149,5984,35
34872,217,4512,1083,2574,41537,1938
30948,1957,42844,1155,28958,274013,13886
59814,27,436,511,279,7672,157
11475,26,2054,1497,848,22569,1206
62139,2,75,429,52,3477,23
24428,545,16186,1290,11535,99684,4651
19479,1,230,1376,118,9216,112
27982,340,5612,1212,3013,48783,2599
1205,452,11465,1593,7854,153920,3611
25457,58,704,1268,578,12759,126
69138,2617,83581,206,78215,637986,5366
3653,2,126,1572,88,16059,38
2181,3,95,1585,48,7908,47
50572,10,156,793,127,4414,29
32842,282,5205,1124,2777,38251,2428
67529,7,45,273,45,2449,0
8783,255,5582,1514,3513,33069,2069
29942,288,4087,1175,2826,31989,1261
30209,26,350,1169,200,4130,150
18146,101,2030,1400,1224,26690,806
34845,31,412,1084,309,5065,103
14137,1354,42944,1463,29090,412543,13854
13842,70,2137,1468,1289,40440,848
52373,73,941,741,822,21274,119
14730,1451,45051,1455,30282,330097,14769
59651,43,378,516,365,6322,13
52837,49,915,723,478,13984,437
18752,27,677,1389,425,15665,252
48636,25,308,847,265,11651,43
54758,266,2798,663,2257,68649,541
37471,20,791,1016,603,9282,188
49178,2872,37381,830,30348,350294,7033
60547,13,133,484,109,3076,24
6292,108,2370,1540,1569,17919,801
40254,22,510,963,375,13043,135
8096,10,112,1516,87,18342,25
32985,35,558,1122,357,7250,201
1250,25,738,1593,365,22420,373
56565,113,2007,608,1440,38131,567
64759,739,27335,355,15253,119686,12082
30710,277,4335,1159,3180,31612,1155
38109,3,158,999,123,8042,35
22250,12,825,1330,610,24478,215
26559,198,4256,1243,3586,36563,670
38211,118,1445,997,1252,22969,193
31019,754,14597,1153,10991,132259,3606
54742,10,98,664,78,3087,20
30416,1995,49662,1165,27014,255147,22648
14311,15,466,1461,359,23492,107
54455,102,1111,675,1006,12722,105
48262,3213,65843,857,49380,263967,16463
54829,149,1919,661,1667,23155,252
28889,34,1755,1195,1016,21893,739
56187,107,1217,622,991,18910,226
53412,421,5077,708,3684,44505,1393
47380,213,2900,867,2362,33388,538
58119,55,647,567,584,11072,63
36464,9,123,1042,95,5779,28
17208,12,403,1417,234,10927,169
11550,1553,71080,1496,41476,409165,29604
58800,6,48,545,40,3463,8
60104,14,213,501,176,6327,37
2101,6079,125688,1586,83083,436611,42605
54635,32,271,668,214,7206,57
26658,231,6453,1241,4083,36092,2370
15767,48,1108,1441,762,25450,346
3507,397,10544,1573,7240,54365,3304
13113,7,107,1478,75,4636,32
11881,10,647,1493,331,15802,316
61978,294,4432,435,3436,36460,996
45589,65,790,890,684,31681,106
54569,1,48,670,32,3652,16
25869,2285,66333,1259,27279,422835,39054
24655,59,760,1285,712,49761,48
27759,259,5108,1217,3480,42996,1628
56316,3,36,618,32,2865,4
26753,15,454,1239,368,9859,86
33601,12,349,1110,227,6029,122
52253,576,11595,745,10190,98787,1405
58720,54,638,547,438,14207,200
26689,931,20662,1240,15698,225559,4964
19202,7,299,1381,187,9241,112
52667,3155,44167,728,27198,382114,16969
58493,59,501,554,361,10545,140
11336,2584,92506,1498,51391,174251,41115
15272,1257,37196,1448,17966,165335,19230
53044,12,319,718,251,8928,68
41998,38,874,935,681,7058,193
66525,368,6954,306,6257,44198,697
41065,21,306,950,270,16281,36
1485,341,17019,1591,7191,115923,9828
35167,14,300,1076,232,6127,68
32275,2846,59094,1135,34923,315522,24171
65797,3,35,328,26,6401,9
34048,10,436,1101,256,7855,180
31352,96,1905,1148,959,18184,946
36422,8,160,1044,138,7640,22
27980,335,11291,1212,6816,62551,4475
11444,920,40244,1497,15936,174618,24308
32533,0,55,1130,39,4315,16
4773,40,1188,1558,836,59684,352
59949,38,423,506,366,8788,57
2653,2147,55830,1582,23768,161193,32062
16962,27,878,1421,603,15642,275
36287,23,331,1048,283,9350,48
23516,34,617,1309,506,35184,111
50867,7,143,786,128,7880,15
8982,29,995,1513,645,28229,350
27252,9,110,1228,83,9162,27
32586,440,7788,1129,4297,46720,3491
1535,46,851,1591,708,40975,143
3887,3,204,1569,138,14368,66
8091,14,731,1517,424,7973,307
37747,16,603,1008,396,9567,207
52052,30,468,752,398,8328,70
32798,280,4545,1126,2380,28529,2165
22034,72,2113,1333,1150,21573,963
35321,451,7841,1072,6129,46927,1712
58026,29,322,570,299,21521,23
39422,267,3588,975,2767,25253,821
61247,72,1042,458,899,29666,143
48669,626,10354,845,9382,82500,972
27553,10,301,1221,204,10996,97
9208,157,6011,1512,3534,51991,2477
27392,51,2524,1225,1604,31258,920
64315,36,349,368,249,6027,100
64885,139,2707,351,1718,29784,989
6274,2,63,1540,49,5931,14
17433,133,1972,1413,1495,21402,477
4314,24,1282,1564,975,18771,307
50959,9,71,783,64,5658,7
37843,31,758,1007,483,24382,275
54012,96,749,691,704,27989,45
18044,436,15064,1401,8482,120567,6582
17472,12,361,1412,272,9885,89
36101,191,5320,1053,3857,32116,1463
23175,73,2428,1315,1745,55592,683
40124,41,441,965,359,19916,82
33474,32,996,1113,719,10017,277
25375,13,298,1269,227,20335,71
2128,21,318,1586,185,12199,133
48834,55,512,840,467,14541,45
31899,4314,74678,1140,46811,170583,27867
31215,48,1452,1150,982,18109,470
12056,33,1488,1491,866,21890,622
21362,24,1482,1343,742,14453,740
61358,27,473,455,406,12080,67
60456,20,303,488,217,8653,86
24367,1216,21329,1291,15466,126232,5863
69015,3,23,224,23,3943,0
39761,10,273,971,238,6025,35
68061,0,0,257,0,2607,0
13652,13283,329154,1470,199841,931496,129313
64384,12,68,366,61,2163,7
31761,31,1492,1142,1027,14774,465
66040,43,297,321,255,3799,42
67349,6,78,279,71,3645,7
37346,167,2238,1020,1456,20818,782
17427,1820,33709,1413,24651,117093,9058
30931,9,241,1155,146,5363,95
47907,16,139,861,116,4477,23
61981,22,673,435,385,16938,288
9112,9,130,1512,102,4501,28
24783,11,215,1282,126,6474,89
38163,0,30,998,28,3022,2
47052,267,2749,872,2417,40087,332
63318,26,257,397,177,10277,80
30874,21,901,1156,659,6016,242
5651,28,1146,1547,766,12822,380
18362,7,232,1396,194,7127,38
7107,85,4738,1529,3064,50978,1674
62235,25,282,426,264,17896,18
10031,12,483,1507,238,6874,245
59292,805,13430,528,9786,80444,3644
15548,100,4787,1444,3577,67028,1210
10414,45,1120,1505,662,27580,458
62216,13,164,427,129,6499,35
61941,60,580,436,398,7564,182
30498,166,4881,1163,3532,52902,1349
51875,28,454,758,367,11552,87
49087,160,2345,832,1901,21500,444
39332,28,691,976,626,14364,65
64786,7,69,354,63,2811,6
27273,16,559,1228,347,6585,212
63536,577,11642,391,8416,74045,3226
63041,214,2108,405,1724,34905,384
13864,237,7993,1467,5933,49787,2060
51498,4,31,768,28,4220,3
18505,433,16876,1393,7872,165716,9004
33659,48,1143,1109,737,19674,406
3253,47,991,1576,715,32534,276
25628,1528,48347,1264,22948,265815,25399
31479,21,355,1147,275,6695,80
7276,5,289,1526,193,13641,96
31753,31,569,1142,388,10646,181
51076,33,426,780,331,14973,95
2151,2,163,1586,108,12055,55
64159,4,47,373,44,2693,3
13480,27,908,1473,592,26171,316
36067,2723,83870,1054,31963,584186,51907
14640,10,308,1456,208,11497,100
38829,14090,316666,982,178459,1137070,138207
3612,130,8607,1573,5912,55048,2695
12812,319,8006,1482,4690,45166,3316
16294,6,210,1432,155,12262,55
29363,179,5952,1186,4576,42538,1376
723,73,1897,1597,1460,34550,437
47329,26,333,868,294,7846,39
37705,7,112,1010,98,5932,14
16287,6,481,1432,184,17000,297
10225,33,1710,1506,683,26437,1027
18461,97,3276,1394,2301,75718,975
32671,11,572,1128,406,11488,166
38662,0,34,985,14,4484,20
59606,7,219,518,165,8439,54
15861,1950,55664,1439,32048,302610,23616
40531,125,2327,959,1649,20835,678
52575,288,2995,734,2653,24991,342
25027,126,3072,1276,1659,26479,1413
23409,172,6165,1311,4138,66357,2027
62672,184,2757,413,2485,24491,272
6328,85,4312,1539,2185,26055,2127
6880,69,7092,1532,2402,65373,4690
2090,152,3766,1586,2722,41370,1044
61738,301,5976,443,5326,68274,650
45314,3516,74217,893,56336,237534,17881
8142,52,1958,1516,1114,23582,844
24200,75,1789,1295,1194,11641,595
17731,94,1093,1407,665,7308,428
28227,19,310,1208,251,5122,59
63804,1,27,385,26,4115,1
28512,11,256,1202,181,10120,75
22244,339,18559,1330,7573,107949,10986
37088,6,121,1027,95,4495,26
55133,161,1866,652,1679,50427,187
29860,650,25535,1176,18827,142501,6708
58250,14,136,563,106,10605,30
1661,433,11416,1590,7750,56773,3666
60795,11,109,475,90,3558,19
23875,173,7302,1302,4022,92850,3280
50915,39,481,784,433,10335,48
19825,28,197,1370,165,10576,32
33258,8,265,1117,197,9698,68
16230,0,227,1433,146,4457,81
17815,13,396,1406,324,11445,72
42710,69,1227,924,979,12495,248
34979,16,535,1080,233,5662,302
54092,28,202,687,157,5988,45
65195,11,73,342,71,2823,2
48659,29,817,846,349,8718,468
62077,4,42,431,33,1684,9
4147,7,374,1567,251,29141,123
4956,13,580,1555,397,27441,183
34851,20,733,1083,491,10870,242
17380,4,168,1414,150,10410,18
9263,283,8691,1512,3117,33370,5574
18383,80,2314,1396,1378,25781,936
31581,7577,154029,1137,104829,632911,49200
56593,15,182,610,159,11313,23
64227,8,146,370,61,6544,85
31928,88,3270,1140,1956,31530,1314
13542,390,27744,1472,12621,121104,15123
35309,80,1226,1072,999,19160,227
51728,66,1538,762,1290,39346,248
7669,1,101,1521,70,12429,31
18472,1,84,1394,75,9311,9
14814,27,871,1454,654,26050,217
48593,1794,25586,847,24207,303042,1379
29738,116,2509,1179,1670,29299,839
59,36,1079,1604,818,24335,261
8614,175,11947,1514,3532,68281,8415
14906,816,39797,1453,23137,260347,16660
5299,57,1019,1551,739,27343,280
25402,136,2650,1269,1904,32321,746
23176,37,952,1315,662,12439,290
31623,49,1720,1144,835,10181,885
15935,219,4778,1438,3109,22370,1669
26895,39,672,1236,567,12817,105
62201,44,532,427,472,10655,60
60590,17,270,483,242,14261,28
50306,62,701,800,602,8422,99
35773,3,280,1062,179,10367,101
22212,33,1163,1331,606,13526,557
33958,66,1273,1104,973,10473,300
50694,71,1410,790,856,30380,554
55920,1002,16621,630,15203,96228,1418
51369,141,1315,772,1044,21849,271
58357,2986,58717,549,25927,512801,32790
29785,13,742,1178,420,16101,322
5483,3,82,1549,65,8659,17
65440,28,340,336,311,11070,29
17117,3,164,1419,120,17492,44
33755,52,1456,1107,827,9947,629
21789,28,504,1336,324,15343,180
21696,59,1110,1337,725,27915,385
31054,79,2059,1153,1470,27543,589
57637,17,272,583,211,13744,61
44668,62,930,900,841,14391,89
32201,349,7082,1136,4027,41693,3055
50479,83,1287,795,997,17137,290
15324,191,10723,1448,5385,61674,5338
35061,1,35,1077,28,3696,7
29452,993,19751,1184,12642,155310,7109
30697,491,9701,1159,5941,47701,3760
10054,13,732,1507,490,19059,242
17511,133,2786,1412,2376,71224,410
27231,52,1866,1229,764,27136,1102
62798,20,332,410,304,6130,28
24909,50387,4308870,1279,553069,5982226,3755801
21869,60,2149,1335,1428,23588,721
42124,3,161,933,73,3380,88
41331,54,686,946,605,13185,81
34260,18,518,1096,367,6698,151
464,81,2753,1599,1589,27087,1164
61185,337,5983,460,5406,38137,577
48120,118,1799,859,1326,20226,473
5966,3,181,1543,129,6864,52
11677,101,2702,1495,1542,14262,1160
28303,10,386,1206,244,23414,142
12913,14,825,1481,413,30225,412
46855,3,47,874,41,8429,6
27682,18,707,1218,430,8910,277
4905,4,166,1556,105,6129,61
27201,67,970,1229,673,15960,297
9783,129,6615,1509,2716,41312,3899
59392,75,926,525,779,17090,147
57463,51,754,588,525,23295,229
17333,11,580,1415,417,20776,163
2810,2690,64454,1580,39538,150487,24916
61405,70,1012,454,641,14083,371
48601,312,4160,847,3365,35854,795
25539,258,5587,1266,3341,28077,2246
57527,9,120,586,104,5642,16
59266,57,564,529,469,9273,95
849,2454,150822,1596,89639,375692,61183
69290,258,3935,208,3196,45936,739
1776,12,224,1589,169,8834,55
25164,18,867,1274,504,15486,363
56487,188,3811,614,2634,54387,1177
921,53,2210,1595,1556,31957,654
26636,140,5805,1241,3963,90339,1842
68530,829,18958,241,15777,178826,3181
41165,37,734,949,636,6025,98
4080,36,1300,1567,884,20545,416
31247,5,301,1150,190,7360,111
11333,33,1056,1498,619,14602,437
24306,1,84,1293,52,6042,32
48387,859,10742,854,9151,130347,1591
60069,2,41,502,28,3413,13
60843,17,165,473,144,5687,21
27480,24,995,1223,465,8553,530
66268,20,185,314,179,5248,6
31953,18,181,1139,132,17165,49
11899,183,2538,1493,1569,25771,969
17930,457,8250,1403,4423,61963,3827
13579,0,22,1471,11,11864,11
824,399,20486,1596,11645,127992,8841
25241,8,333,1272,227,8754,106
2187,77,4664,1585,2738,52818,1926
1913,47,1398,1588,920,25805,478
13778,114,4262,1469,2403,39116,1859
55509,39,533,641,440,14991,93
2388,46,1389,1584,1020,26715,369
9023,42,1006,1513,548,14599,458
25479,18,596,1267,505,29156,91
21785,276,6690,1336,4185,58721,2505
36479,34,812,1042,642,23675,170
21134,22,429,1347,284,4173,145
31485,6203,141600,1137,89560,675287,52040
6123,8,260,1541,186,12379,74
19393,11,352,1378,280,13163,72
37542,226,3613,918,3394,108101,219
33023,29,848,1121,435,10018,413
49011,7809,194939,835,139905,542626,55034
51625,70,872,764,762,13995,110
29086,3201,127823,1191,48265,274273,79558
21299,16,515,1344,297,14362,218
38093,0,19,1000,17,8127,2
49417,85,1285,822,916,20228,369
60344,14,297,492,129,7814,168
22992,20,662,1318,451,18469,211
31529,23,1087,1146,686,11043,401
36436,149,3816,1043,3486,35604,330
261,120,5183,1601,2456,39288,2727
32136,302,4792,1137,2563,43807,2229
61052,34,506,465,447,18002,59
34518,56,3136,1092,1465,32033,1671
12436,311,10035,1487,6382,108176,3653
36261,33,258,1049,216,3239,42
6006,1901,67062,1543,37172,438943,29890
29111,502,12897,1191,8187,119024,4710
29930,14,575,1175,300,19357,275
12531,5,209,1486,113,9563,96
51681,1398,26178,763,20625,103512,5553
22327,495,20680,1329,7734,129436,12946
12187,39,2914,1490,1241,19848,1673
53463,58,578,708,526,6595,52
63326,49,798,397,643,17144,155
17759,22,427,1407,300,14553,127
37673,1136,40364,1011,20809,154374,19555
35646,30,1135,1065,832,18726,303
5237,528,15488,1552,10885,167635,4603
36812,1497,33016,1036,26487,111069,6529
57302,263,3016,591,3012,16797,4
23660,151,6886,1306,3516,37653,3370
3448,18,701,1574,375,18532,326
19614,199,1804,1374,1169,23069,635
17694,466,22862,1408,10433,174567,12429
69798,28,683,198,551,12707,132
7727,30,1660,1520,1105,19120,555
29138,51,1413,1190,945,35905,468
40109,26,406,966,338,6018,68
45063,29,225,895,201,6337,24
23822,16,375,1303,207,7316,168
24041,13,471,1299,347,7903,124
13536,20,1155,1472,793,44388,362
16480,62,3198,1429,1909,44853,1289
6455,17,417,1537,311,20996,106
51153,9,87,777,57,3931,30
7733,12,523,1520,302,21462,221
68602,217,5079,238,3724,30835,1355
31084,144,2338,1152,1366,25818,972
20480,75,1637,1359,1225,27336,412
8189,44,1174,1516,548,26923,626
64548,5,94,361,86,4875,8
22874,643,19770,1320,11360,60502,8410
30010,296,6708,1173,4524,40768,2184
26481,42,486,1246,438,18948,48
3672,2,80,1572,54,11756,26
40188,33,287,964,256,6659,31
32053,43,794,1138,498,7273,296
61087,10,230,464,197,5100,33
59017,28,341,538,292,16060,49
62609,1386,28837,415,28193,261518,644
3652,18,238,1572,188,23911,50
52445,2303,28446,739,25264,256582,3182
23436,0,0,1310,0,5091,0
54078,4587,54019,687,38806,173698,15213
1783,53,2156,1589,1680,83090,476
49626,283,2119,817,1592,39427,527
46043,64,1221,884,900,28413,321
26509,174,2912,1245,1611,17440,1301
48735,15,155,844,136,4353,19
63353,2803,33873,396,27970,165664,5903
34544,4,57,1092,52,2416,5
3261,3835,101750,1576,54173,548240,47577
32755,32,939,1126,540,9901,399
30513,28,780,1163,560,6882,220
11103,330,11655,1500,7234,59588,4421
13596,202,6356,1471,4490,50267,1866
59716,145,2386,514,2299,14626,87
28707,12,455,1198,299,22327,156
3333,109,6229,1575,3827,27582,2402
4256,24,2724,1565,1927,39990,797
61608,2493,28735,447,27749,144062,986
682,15,1007,1597,552,12872,455
59502,25,279,521,220,14382,59
27229,70,1380,1229,944,77290,436
28960,105,3714,1193,2095,30865,1619
37179,29,408,1025,294,17685,114
50778,69,1030,788,855,13840,175
15584,17,914,1443,611,34408,303
42079,43,670,934,469,12796,201
10181,24,2581,1506,1733,29741,848
4366,432,14713,1564,8945,42355,5768
27481,24,315,1223,222,4680,93
34873,7,151,1083,111,2317,40
396,20,663,1599,526,50609,137
12909,103,3173,1481,1129,31002,2044
49471,183,3763,821,2728,52461,1035
6317,75,3468,1539,2042,35042,1426
7689,75,5208,1521,2861,25681,2347
26409,46,816,1247,701,16358,115
65906,6,63,325,55,6399,8
22571,18,568,1325,298,15038,270
29513,44,914,1183,378,8970,536
55829,2572,60770,621,37677,505264,23093
25274,223,2518,1271,1743,22962,775
60946,10,52,469,43,7487,9
18232,7,325,1398,243,17089,82
37999,471,11250,997,6633,85807,4617
23084,60,2507,1316,1668,42925,839
53799,42,411,698,355,8210,56
19306,62,2095,1379,1525,33343,570
16636,36,1284,1427,938,21437,346
37721,98,2022,1009,1841,26566,181
57355,790,14099,589,9043,91243,5056
46921,149,3052,874,2521,43154,531
32228,94,2348,1135,1510,21962,838
2862,6,108,1580,66,10318,42
18492,15,559,1394,383,25753,176
34953,13,306,1081,225,3703,81
16089,438,9023,1435,6645,48361,2378
58636,53,1099,550,925,12700,174
49998,5,79,807,69,3903,10
19436,71,2334,1377,985,33114,1349
38488,184,3637,989,2825,50781,812
6556,1,55,1536,38,6375,17
26262,39,1240,1250,747,11106,493
24140,109,3046,1296,1955,66569,1091
7329,1105,23095,1526,14575,160482,8520
6268,6,388,1540,280,13616,108
29696,23,305,1180,265,7695,40
10994,94,2637,1501,1488,33246,1149
52553,264,4174,735,2380,25847,1794
29307,132,4999,1187,1645,29114,3354
1687,5,201,1589,155,10213,46
63961,27,370,379,307,9927,63
66327,19,275,312,265,8932,10
17270,236,7046,1416,4786,69766,2260
47544,17,246,866,160,15151,86
20035,18,197,1366,168,8654,29
56576,14,164,611,152,7452,12
23134,192,4149,1315,2656,41591,1493
58290,102,2323,559,725,24491,1598
57717,69,712,581,656,8837,56
53387,32,627,709,578,7010,49
52181,11,162,748,135,6802,27
9961,58,2019,1508,837,20483,1182
89,640,29582,1603,15939,155347,13643
12897,0,0,1481,0,4701,0
12878,52,2195,1481,1324,19963,871
35901,33,532,1059,459,13923,73
59997,210,3406,504,1983,24435,1423
23395,618,12569,1311,8931,104027,3638
35870,8,187,1059,132,7732,55
23927,136,2704,1301,1916,20542,788
39184,43,1520,978,1006,29421,514
7706,3,228,1521,164,7996,64
3639,34,1045,1572,790,13535,255
13687,7660,177297,1470,109200,717260,68097
59638,31,447,517,416,6375,31
57503,137,1494,587,1120,10502,374
13351,115,2082,1474,1426,13692,656
15645,14,489,1443,357,17686,132
18805,85,1794,1388,1659,17989,135
17853,58,2099,1405,1759,63815,340
21034,122,3561,1349,2595,47070,966
15480,31,557,1445,401,27591,156
28794,32,932,1197,624,29108,308
3159,3161,59260,1577,46434,192076,12826
51256,390,4248,768,3477,33450,771
66677,94,2381,301,1523,33181,858
14781,14,442,1455,233,10939,209
7218,8,514,1527,335,12070,179
63871,1,7,382,5,2551,2
12757,46,2416,1483,1344,18756,1072
9978,43,2300,1508,1425,23721,875
47162,75,2881,870,1136,31225,1745
44410,1184,17875,848,8846,148539,9029
37949,53,776,1004,581,11249,195
9229,1527,71477,1512,34932,274823,36545
31132,37,1572,1152,972,16774,600
33025,21,609,1121,440,7973,169
46877,7,79,873,68,5159,11
22569,67,1186,1325,835,16010,351
29097,8,91,1191,73,5038,18
20929,134,3444,1351,1692,29578,1752
2570,214,16729,1582,8529,96049,8200
40889,32,344,953,280,8585,64
2204,56,1570,1585,909,20968,661
61007,41,360,467,267,10766,93
350,53,2004,1600,1504,34010,500
25462,1375,28865,1268,17906,176903,10959
63384,0,6,396,6,1498,0
24676,90,1213,1284,887,21458,326
18686,14,466,1390,348,15698,118
5794,591,19759,1545,13806,64083,5953
12923,10721,241362,1481,162408,779762,78954
12429,123,4698,1487,3143,52296,1555
30093,521,11957,1171,5176,68107,6781
207,41,2019,1602,1114,33941,905
25517,17,332,1267,229,13144,103
20310,89,4434,1362,2443,36832,1991
54378,81,2735,678,854,15757,1881
9411,185,5314,1511,3003,33337,2311
65160,4,55,343,44,4350,11
59785,113,1547,511,1263,32450,284
57480,75,1020,587,740,8748,280
19542,21,676,1375,499,14909,177
37148,21,593,1021,452,15534,141
625,25,2739,1597,1373,31549,1366
28881,6,116,1195,85,5178,31
21842,0,0,1336,0,5717,0
64365,2,109,366,39,2578,70
39686,1192,19061,972,15458,103202,3603
29732,60,1598,1179,536,18560,1062
17728,54,1864,1407,1095,17927,769
54,40,1110,1604,741,27343,369
60224,115,1789,496,1631,25373,158
68093,7,130,255,115,4941,15
35999,96,1648,1056,1583,19736,65
59386,861,19727,525,13505,132661,6222
17314,14,895,1415,612,34532,283
14631,206,8787,1456,6023,36058,2764
15419,708,20113,1446,11942,135630,8171
28840,4,121,1196,72,5060,49
34603,2,157,1090,115,12248,42
21058,33,756,1348,670,13704,86
48703,94,1171,844,933,16865,238
11353,613,14692,1498,8748,62363,5944
66146,286,3137,317,2949,20662,188
18258,781,22252,1398,11516,172490,10736
21247,159,4116,1345,2790,26335,1326
27,86,4912,1605,3161,102841,1751
57373,11,187,590,157,3387,30
18460,4,212,1394,136,5619,76
36332,211,2717,1046,2070,22560,647
23062,111,2191,1316,1575,35357,616
55821,94,1342,633,1054,37935,288
59972,43,797,505,585,14938,212
56660,7,100,609,60,5280,40
2045,4,337,1587,200,12644,137
30588,42,699,1162,485,6568,214
514,476,11846,1598,7355,83907,4491
54942,1,14,657,11,2459,3
37870,453,8416,1006,7349,104253,1067
24883,278,3585,1279,1661,44777,1924
13069,78,3186,1478,1756,62429,1430
26226,75,1302,1251,960,41654,342
24392,110,5561,1291,2203,75853,3358
38001,88,1299,1002,622,21841,677
18594,540,7699,1392,4507,39919,3192
10023,115,1750,1507,1119,21802,631
5521,291,21731,1548,10908,166865,10823
8629,51,1392,1514,720,9090,672
17907,16,543,1404,291,16190,252
38728,1032,14932,984,9872,110566,5060
7497,90,2588,1524,1919,37077,669
59811,83,1078,511,979,15716,99
12532,50,1466,1486,665,10090,801
11083,50,1297,1500,874,13760,423
6717,31,605,1534,349,13524,256
49695,16,248,815,212,6633,36
60275,57,348,495,285,5026,63
65922,127,1846,324,1744,27897,102
60431,8,144,489,70,6519,74
54579,42,709,670,492,31674,217
69934,93,1154,194,1107,11175,47
17275,1045,42158,1416,21813,173203,20345
595,14,669,1598,519,34486,150
63930,584,9355,380,8355,42371,1000
56188,85,815,622,764,13354,51
16804,62,2856,1424,1870,29802,986
14985,68,3113,1452,1298,42429,1815
48137,41,647,858,471,9880,176
7073,21,819,1529,428,18637,391
1448,71,4019,1591,2655,37557,1364
19313,99,4101,1379,2644,46957,1457
9447,6,385,1511,232,6003,153
62478,11,115,419,109,2908,6
19490,16,906,1376,674,31919,232
44079,193,2164,906,1520,43401,644
60067,10,163,502,124,11353,39
22530,55,1320,1326,834,11750,486
51269,38,616,774,553,31027,63
30423,48,366,1165,323,14794,43
7657,248,7364,1521,4602,39387,2762
19388,0,15,1378,15,3930,0
8960,63,2552,1513,1299,36969,1253
51951,41,733,756,684,10376,49
38050,6,154,1001,84,8711,70
63621,146,6700,390,4094,28087,2606
24070,16,416,1298,300,10885,116
5964,81,2513,1543,1521,61808,992
42792,125,1164,922,824,11722,340
58640,17,307,549,285,10160,22
31395,14,415,1148,255,7079,160
48398,28,460,854,281,5744,179
6169,10,384,1541,242,6904,142
7178,9213,253207,1527,144226,625972,108981
17738,23,974,1407,623,18268,351
61212,7,97,459,70,2362,27
36726,11,285,1037,233,13569,52
25716,71,1753,1262,1139,13619,614
40640,1267,41096,935,16795,231577,24301
14871,9417,350332,1454,156468,1658807,193864
67507,538,11755,274,9275,68144,2480
49625,19,300,817,176,13813,124
34466,341,8980,1093,7571,172281,1409
3242,6,256,1576,184,7223,72
66168,18,311,316,285,6437,26
58261,132,1691,562,1312,16788,379
57615,53,909,584,662,12351,247
41319,1,53,947,46,2171,7
41680,42,670,941,522,8841,148
51087,1064,13828,779,11099,88935,2729
46209,77,1622,883,1369,25706,253
7068,13,500,1529,356,22234,144
44172,347,4339,905,3837,109814,502
53123,1,132,715,114,3457,18
9647,370,9630,1510,5745,62221,3885
66376,13,272,311,132,4826,140
51026,46,681,781,629,39318,52
38544,3,176,988,124,7066,52
24217,38,1434,1295,932,15869,502
59714,1295,17293,514,9834,64460,7459
25175,13,118,1274,91,3599,27
42054,17,196,935,173,5605,23
37634,2,95,1012,65,28328,30
62366,55,710,422,689,13982,21
32829,35,1234,1125,775,19273,459
26513,34,626,1245,378,12759,248
23371,18,370,1311,265,11110,105
6646,47,1801,1535,815,19022,986
5119,84,3368,1553,1698,40028,1670
56289,27,392,619,292,10855,100
54400,4,59,677,41,3177,18
31924,25,1053,1138,694,11088,359
57213,88,749,594,652,19863,97
38847,113,2585,982,2196,48692,389
30372,14,1159,1166,697,28369,462
30546,207,5025,1162,2879,61763,2146
53226,930,9663,713,7989,84335,1674
37312,18,458,1021,368,9679,90
34014,63,1125,1102,815,17497,310
16965,42,1544,1421,853,20467,691
3029,21,948,1578,678,20046,270
27887,106,1632,1214,1004,9023,628
16598,241,8190,1428,4328,27340,3862
30978,13,423,1154,256,8671,167
32118,10,176,1137,121,8748,55
8937,173,2353,1513,1504,27350,849
12808,798,16511,1482,11237,82215,5274
63773,48,365,385,333,9479,32
28900,426,10256,1195,8411,123538,1845
23125,6261,140585,1315,69741,508811,70844
43781,17,519,910,387,13293,132
1828,158,9514,1588,6806,45118,2708
29894,173,2874,1175,2199,53316,675
15149,168,3154,1450,2060,53036,1094
51815,1,89,759,64,5564,25
53090,142,1368,717,1184,21394,184
58930,352,4236,540,4204,19156,32
10777,92,1801,1502,1256,33259,545
63362,19,226,396,198,10307,28
38060,109,2057,1001,1871,32751,186
41856,9,220,937,163,12199,57
2227,378,6931,1585,4988,21272,1943
55031,29,354,654,328,13579,26
49589,14,241,818,194,9190,47
30940,20,505,1155,367,18831,138
56454,42,632,615,536,34013,96
34092,149,3293,1100,2406,20132,887
37257,175,1867,1022,1589,23168,278
31028,78,2510,1153,1592,19968,918
21291,103,1616,1344,1140,31849,476
14949,30,587,1453,291,19296,296
22130,377,7658,1332,5668,65424,1990
56343,9,125,618,98,3696,27
54294,151,2949,681,2468,35936,481
64337,34,540,367,501,6684,39
4727,331,5632,1558,3431,47374,2201
40026,107,1959,967,1841,29589,118
51749,120,1263,761,1026,10128,237
19464,149,3103,1377,1905,54331,1198
23419,26,1212,1310,822,14899,390
18913,23,1094,1386,831,13725,263
66698,16,218,301,196,10012,22
48488,75,950,852,779,22521,171
34797,13,196,1085,103,3628,93
18591,0,0,1392,0,7133,0
20041,8,486,1366,341,16868,145
53107,79,1332,716,876,13538,456
12112,318,15611,1491,8488,217709,7123
55428,77,692,644,659,21548,33
29749,88,2017,1179,1251,55749,766
10284,0,180,1506,118,3856,62
409,675,29554,1599,13497,88071,16057
4309,12,384,1564,297,5724,87
24592,333,5255,1286,3720,34949,1535
53303,8,182,711,131,6138,51
22225,309,5329,1330,3662,25948,1667
14803,17,415,1454,320,25869,95
276,27,739,1600,488,32259,251
27929,22,316,1213,210,12224,106
57712,94,1728,581,1252,36680,476
22140,45,1112,1332,697,15778,415
10613,21,789,1504,558,30402,231
28316,154,3105,1206,1994,45582,1111
67576,4,101,272,90,3514,11
50360,4,338,798,174,8367,164
62253,13,317,426,254,9217,63
7048,619,43991,1530,18890,152316,25101
57663,20,262,582,235,5917,27
40803,118,1894,955,1860,16228,34
16641,7,179,1427,83,10286,96
35434,37,603,1069,484,13768,119
60512,12,71,485,60,3485,11
55773,22,264,634,174,5266,90
36187,564,11061,1051,9771,76670,1290
49366,879,11849,824,9034,133120,2815
24495,2473,75836,1289,35651,474663,40185
3205,346,10087,1576,6181,57657,3906
26739,13,302,1239,241,8636,61
22792,9,235,1321,194,12389,41
34035,321,4974,1102,3493,25438,1481
49750,98,1829,814,1305,37300,524
50849,17,120,786,105,3165,15
15600,88,2236,1443,1486,42511,750
20877,10,304,1352,220,11162,84
61835,109,1697,439,1399,17116,298
63706,597,9125,387,8726,80501,399
56220,12,135,622,106,8723,29
17689,11,564,1408,314,11662,250
62001,4,99,434,96,10572,3
66680,15,264,301,213,9457,51
64645,52,818,358,670,12115,148
13784,118,4521,1468,2986,36566,1535
8547,123,2724,1515,1510,21586,1214
4266,12,727,1565,412,28935,315
3538,46,1788,1573,1070,64272,718
36871,224,5473,1034,3995,63515,1478
8111,15,496,1516,290,7464,206
21320,5,146,1344,102,6210,44
41369,10,498,946,365,10760,133
58393,206,2903,558,2761,39986,142
51139,6,97,778,83,2894,14
12483,20,874,1486,417,12199,457
21666,2233,78697,1338,34781,263032,43916
41889,196,1954,937,1512,29644,442
28330,20,738,1205,450,11932,288
39046,170,2284,980,1761,31209,523
2349,34,1304,1584,885,11628,419
16293,250,7293,1432,2923,58737,4370
33300,100,1858,1116,1374,9799,484
3990,15,1055,1568,726,13796,329
22767,16,714,1322,439,19481,275
29453,324,12806,1184,7901,137883,4905
24429,269,7108,1290,4631,34484,2477
23720,288,5797,1305,3923,65584,1874
35176,19,596,1075,362,21234,234
50943,44,567,784,296,10295,271
36203,44,1124,1050,641,44448,483
1762,21,1060,1589,575,25888,485
2004,96,2384,1587,1826,41105,558
51687,1,14,763,14,1783,0
25070,1585,44177,1275,21938,252301,22239
11012,33,1311,1500,631,13014,680
64925,202,3946,349,3662,45662,284
30534,70,1415,1162,1178,30435,237
14258,131,3079,1461,2014,44657,1065
4916,58,6695,1556,2714,26093,3981
55746,0,0,635,0,3314,0
35527,14,211,1067,146,6754,65
36446,25,871,1043,681,11923,190
35280,16,346,1073,310,47526,36
18508,5,617,1393,481,6750,136
13730,827,39492,1469,16950,219645,22542
26947,3,122,1235,70,9234,52
26696,4,217,1240,141,16800,76
17730,0,1238,1407,999,22101,239
32866,292,8082,1124,3839,80233,4243
49155,132,1492,831,1330,23487,162
48925,124,1723,829,1215,15552,508
6028,316,5618,1543,3508,54925,2110
57958,109,1013,573,843,11798,170
53829,58,1134,697,1046,26240,88
25850,2,173,1259,121,10389,52
52444,423,5075,739,3568,34564,1507
41191,18,219,949,151,10710,68
32509,31,589,1130,452,10830,137
35743,144,1560,1063,1117,13059,443
59341,1026,47859,527,25912,270325,21947
50480,3134,36186,795,27285,259900,8901
6107,53,1543,1542,634,11146,909
67218,29,357,283,302,3731,55
27486,43,2597,1223,1547,18327,1050
4762,1175,21626,1558,13160,212335,8466
49137,152,2037,831,2016,21286,21
45542,213,2022,890,1750,28982,272
726,30,1708,1597,1172,51273,536
31980,233,5072,1139,3438,21125,1634
13776,54,2395,1469,1268,17987,1127
65929,42,765,324,656,19120,109
39601,197,3732,973,2872,48850,860
65356,769,10886,338,9419,106423,1467
50057,3,113,806,95,6419,18
54355,14,143,678,110,4573,33
40145,241,2221,965,1783,9695,438
68555,12,233,239,229,4029,4
41088,22,297,950,231,9075,66
52058,7,78,752,62,5455,16
36308,12,305,1047,281,9225,24
14624,73,2239,1456,1586,29973,653
50732,3,103,789,93,4686,10
20798,43,1317,1354,681,18008,636
49254,18,586,826,152,17346,434
28009,202,4320,1211,3169,30205,1151
21066,92,1173,1348,812,23357,361
16354,76,2282,1431,1340,23254,942
8461,272,6914,1515,3946,79610,2968
26571,38,744,1243,473,17443,271
14849,6,591,1454,325,8713,266
17935,3,63,1403,50,3497,13
60531,20,321,484,235,10361,86
22547,42,1020,1326,826,14718,194
28458,1,134,1203,50,9054,84
49352,52,927,823,562,18781,365
13033,13,784,1479,445,18143,339
15034,300,3859,1451,2343,29641,1516
60282,35,686,494,458,13278,228
40602,45,883,959,705,40044,178
2855,66,1501,1580,972,23054,529
57384,3,164,589,135,2722,29
28957,4319,88067,1194,57348,348236,30719
51235,7,114,776,85,3898,29
14563,61,1962,1457,1263,15541,699
16460,0,0,1429,0,32267,0
2316,26,739,1584,535,25202,204
23138,33,1369,1315,785,21209,584
29701,39,1071,1180,614,8533,457
38323,50,481,994,380,8542,101
9151,33,1828,1512,1197,21630,631
14023,23,651,1465,427,15850,224
62322,13,117,424,114,4638,3
47516,21,406,866,305,8923,101
58670,8154,220053,548,114479,983342,105574
12714,39,1659,1483,730,15038,929
20459,12,1265,1359,869,8542,396
66697,0,17,301,17,2224,0
49302,27,396,826,363,9652,33
794,13,471,1596,355,25245,116
20362,25,952,1361,745,14306,207
5591,12,1166,1548,640,42708,526
47026,7,60,872,46,8403,14
29519,474,6086,1183,4025,47108,2061
12598,145,3950,1485,2116,25278,1834
50759,61,814,789,639,11445,175
16941,55,1627,1422,1132,19359,495
181,60,2346,1602,1687,93681,659
11459,1743,37741,1497,24833,172700,12908
20352,40,1485,1361,1085,16638,400
8040,6,142,1517,100,5261,42
31805,68,1050,1141,679,23194,371
35635,148,2287,1065,1804,39199,483
36739,1,173,1037,141,20314,32
23169,60,1322,1315,1066,20038,256
19690,309,5688,1373,3053,69299,2635
55158,230,2722,651,1974,26370,748
53067,2316,48070,718,26244,218650,21826
68693,11,130,235,119,5152,11
37547,28,554,1014,413,9993,141
60733,47,370,477,339,9715,31
52430,6,161,739,119,8567,42
34133,32,1011,1100,586,11310,425
12919,156,4644,1481,2138,19823,2506
2970,126,2718,1578,2109,30689,609
21889,83,2029,1335,1519,23965,510
37588,275,6883,1013,4148,46533,2735
8284,44,962,1516,370,5446,592
48734,14,179,844,143,17312,36
60744,7,99,477,89,2695,10
50490,54,784,795,601,14677,183
57043,1,43,597,36,4583,7
3404,10,352,1574,272,16095,80
60761,26,390,476,338,7067,52
31779,33,947,1142,613,10016,334
52447,72,691,739,583,9626,108
22948,21,457,1318,369,17269,88
9224,295,4966,1512,3087,31502,1879
54071,80,787,688,680,13487,107
22105,48,1010,1332,681,10584,329
63853,1,32,383,29,3725,3
29166,71,1244,1189,734,19507,510
38537,53,721,988,594,14597,127
24611,8,218,1286,152,10334,66
41171,104,1095,947,829,15981,266
22560,15,430,1326,296,11507,134
29277,25,645,1187,378,7518,267
64086,2,61,375,47,1990,14
9627,78,1589,1510,1095,16074,494
50091,53,1481,805,881,30264,600
28958,81,1447,1193,983,14278,464
30924,5,116,1155,83,11369,33
58500,244,2677,554,2376,15917,301
10972,13,312,1501,210,15240,102
20008,14,569,1367,425,7539,144
54238,1,657,683,479,28343,178
31668,5,149,1144,119,12870,30
13037,8,527,1479,291,8384,236
8751,37,997,1514,634,12653,363
3952,120,3023,1569,2308,44961,715
16238,2023,56569,1433,36357,509936,20212
21779,44,1763,1336,630,20313,1133
39355,1519,22433,975,18253,159697,4180
5078,64,1160,1554,775,42354,385
15915,132,3770,1438,2788,24916,982
65604,214,6011,333,4977,58307,1034
22041,823,15472,1333,10395,144757,5077
64872,4,51,351,40,4298,11
17990,16,455,1402,349,20241,106
18905,52,557,1386,456,11915,101
9174,32,968,1512,683,15638,285
13090,124,4693,1478,2988,105746,1705
61132,50,979,462,820,20044,159
60977,69,1177,468,1091,16336,86
24,462,21654,1605,12663,168540,8991
5100,332,8077,1554,5037,116333,3040
64200,302,4531,360,3387,27011,1144
27360,4,187,1226,122,2625,65
15268,26,1056,1448,789,43346,267
47524,329,3412,865,3169,32164,243
26627,4,202,1241,109,5125,93
20294,40,541,1362,421,23785,120
15896,212,3942,1439,2887,30483,1055
16193,204,8703,1434,5797,94961,2906
64382,50,846,366,811,17383,35
31495,59,985,1147,755,17001,230
55670,292,3992,636,3174,320630,818
10144,576,24710,1507,13439,132592,11271
37206,23,989,1024,642,13157,347
10863,63,2383,1502,1502,33623,881
5273,1,72,1551,50,5677,22
14688,54,1145,1456,734,10603,411
35174,950,16632,1075,11233,248265,5399
9275,63,3273,1512,1732,32753,1541
11089,17,589,1500,329,10411,260
56953,31,415,600,375,7537,40
6451,19,426,1537,330,21243,96
34337,156,3941,1096,2088,29034,1853
6891,121,2688,1532,1875,28840,813
3023,842,12097,1578,7972,41993,4125
18076,18,357,1401,254,9539,103
36108,19,474,1053,367,16484,107
17438,409,9028,1413,5829,61133,3199
8044,25,536,1517,368,10126,168
34932,152,2053,1082,1533,13455,520
30815,109,1824,1157,1103,37807,721
21100,52,1963,1347,1507,19829,456
65711,31,816,329,589,12422,227
35206,16,361,1074,287,6022,74
30827,6,397,1157,242,4894,155
8707,592,28920,1514,12260,123953,16660
28192,95,1599,1208,1266,41550,333
30289,517,9698,1168,6242,63228,3456
56084,1825,30281,625,20528,149164,9753
22644,1343,27240,1324,17708,106882,9532
48506,1,83,851,71,3805,12
13426,26,2269,1473,1122,16999,1147
61797,66,501,441,402,7719,99
24122,20,588,1297,376,6913,212
15722,70,2097,1442,1475,24755,622
3491,16,333,1574,209,15080,124
35011,8,288,1080,186,7536,102
6365,182,8788,1539,5341,55061,3447
52666,26,243,730,179,7133,64
25071,89,1869,1275,960,9190,909
8573,67,2071,1515,1041,17385,1030
19042,122,2256,1384,1708,20845,548
37482,21,396,1016,357,15081,39
53561,63,839,705,632,7641,207
19260,11,398,1380,298,10185,100
11342,44,2161,1498,997,15683,1164
17058,251,7494,1420,5039,56450,2455
37441,21,427,1017,386,6089,41
39668,4,73,972,53,2271,20
26864,159,3500,1236,2584,26535,916
11829,24,1260,1494,663,12941,597
11648,75,2379,1495,1310,23047,1069
48751,38,626,843,449,15939,177
46683,67,1016,876,800,22136,216
37852,3,100,1006,87,5258,13
59352,52,717,527,509,19537,208
12482,135,6382,1486,2996,134702,3386
59704,101,1181,514,1016,8375,165
8706,157,5232,1514,3085,97369,2147
32741,1318,36167,1127,18923,83061,17244
45268,71,1669,893,1045,14494,624
5343,41,2268,1551,1212,14649,1056
70259,4,83,183,82,3536,1
42674,104,1985,924,1561,44476,424
21112,8,579,1347,395,12243,184
3729,451,25697,1571,14711,202152,10986
64343,15,270,367,245,8606,25
50869,28,200,786,183,3912,17
37950,2817,64079,1004,43101,174614,20978
3247,439,18349,1576,11023,102701,7326
14576,2,225,1457,137,7274,88
50573,469,6160,793,5802,73001,358
48315,1050,19353,855,15215,104067,4138
16564,13,392,1428,259,16525,133
27407,692,12890,1225,9253,183078,3637
58850,63,757,543,719,12813,38
21289,379,5058,1344,3202,50908,1856
18311,568,11711,1397,8133,72903,3578
33480,9,275,1113,183,7932,92
32802,78,1225,1125,829,9674,396
33308,29,1423,1116,839,14148,584
55811,478,5404,633,4990,43034,414
15081,5,136,1451,86,6164,50
32546,149,2754,1130,1990,54493,764
3948,42,2051,1569,1474,33303,577
37376,14,269,1019,217,7569,52
50389,324,4648,797,4119,58219,529
36734,196,3535,1037,2996,18855,539
3126,135,4787,1577,3180,28174,1607
57224,33,220,594,204,3998,16
49516,248,4404,820,3869,21597,535
1954,6,399,1587,320,44533,79
36934,54,1097,1032,703,18181,394
30348,431,6425,1166,4596,44195,1829
6071,20,370,1542,227,8884,143
64648,1043,14151,358,9860,62743,4291
65978,173,6318,323,5885,68017,433
17178,1073,72182,1417,36872,428173,35310
22112,9,271,1332,194,14754,77
21890,9,691,1335,400,12782,291
48746,32,1018,843,622,13658,396
13633,283,11620,1470,7211,105784,4409
33057,1005,17603,1121,13800,116922,3803
606,29,1109,1597,835,37807,274
5222,91,1445,1552,881,23071,564
12167,28,623,1490,363,32881,260
4015,20,935,1568,666,9656,269
14019,2176,90526,1465,46560,228935,43966
30615,29,867,1161,466,9726,401
23,923,37239,1605,22215,220526,15024
47385,90,970,867,777,7711,193
17102,2,105,1419,85,25074,20
58945,221,3716,540,2857,54106,859
22807,89,1265,1321,890,22697,375
31822,1480,34368,1141,26103,161058,8265
28414,99,4132,1204,2603,38323,1529
9807,219,3735,1509,2159,43311,1576
18339,1,145,1397,106,8339,39
61954,10,108,436,88,7165,20
2184,8,96,1585,78,9707,18
61995,4454,201672,429,72319,756914,129353
35553,31,728,1066,501,8600,227
49206,1891,21110,829,17551,83936,3559
4700,144,3585,1559,2032,39428,1553
2602,24,987,1582,689,49079,298
20678,0,67,1356,45,4305,22
65544,52,722,334,674,10362,48
58053,43,486,570,371,9428,115
67598,8,81,271,64,7752,17
18235,9,343,1398,294,10235,49
68657,25,330,236,246,6384,84
38203,8,76,997,69,2799,7
1363,23,691,1592,489,27390,202
57859,23870,454012,575,385295,1757381,68717
22619,3688,132133,1324,56765,456480,75368
23312,50,1310,1313,813,19670,497
55956,32,436,629,361,18006,75
56828,84,1010,603,939,12775,71
29194,66,1049,1189,772,9194,277
9476,41,1592,1511,992,10902,600
21454,6141,132836,1341,80258,443145,52578
17368,338,10455,1414,7752,123374,2703
3442,26,726,1574,583,11221,143
51991,10,240,754,161,20210,79
40082,9,124,966,93,7610,31
52612,18710,464319,732,203455,1512937,260864
3339,198,7410,1575,4544,67528,2866
37711,38,899,1010,699,22012,200
31737,3106,71053,1142,44118,230758,26935
69053,38,786,223,716,11483,70
42650,240,2345,925,1945,41450,400
36730,2,126,1037,94,9222,32
20441,17,821,1360,510,23769,311
58399,64,1354,558,992,27535,362
11694,0,0,1495,0,14116,0
33494,10,465,1112,307,6054,158
13692,1329,35265,1470,22637,196731,12628
48516,13,419,851,215,8180,204
23564,14,384,1308,250,20639,134
11698,42,1975,1495,1140,13342,835
37946,1108,89886,1004,8664,252120,81222
56948,5,102,600,80,7047,22
33680,156,2783,1109,2219,23100,564
26350,67,1726,1248,1023,25508,703
50338,46,441,799,391,8098,50
232,7,407,1601,283,21354,124
56563,20,380,611,332,12984,48
31305,82,4527,1149,2085,23745,2442
26017,4209,120876,1255,61592,307703,59284
2552,2433,73627,1582,45445,192738,28182
14029,120,4722,1465,2370,34267,2352
20355,47,1952,1361,701,20344,1251
57259,7,94,593,64,5581,30
23464,1083,37092,1310,25405,230441,11687
47599,6,123,865,91,18491,32
52619,9,74,732,50,3007,24
10676,19,570,1503,362,10629,208
12577,404,18822,1485,9245,105448,9577
34211,181,2551,1098,1622,18104,929
24430,21,576,1290,388,10998,188
22909,163,2964,1319,2193,25201,771
37408,102,1986,1018,1607,17280,379
29608,20909,618825,1182,338565,1049494,280260
61182,4,48,460,42,4370,6
48968,274,4328,836,3360,64722,968
28290,29,747,1206,426,10812,321
33213,1165,19332,1118,14588,202983,4744
16116,41,2342,1435,1289,14425,1053
68980,10,65,225,65,3359,0
22001,67,2078,1333,1325,28974,753
55205,40,617,650,477,14665,140
36042,6,187,1055,133,2915,54
16084,5602,131070,1435,67768,358887,63302
24618,213,4645,1286,3414,28428,1231
55430,1064,10243,644,7344,69959,2899
63348,21,366,397,356,12273,10
60787,73,815,472,496,14092,319
18886,2,86,1387,75,8047,11
24032,28,590,1299,411,14509,179
31558,61,1828,1146,952,32342,876
60996,1,20,467,13,3259,7
610,129,2912,1597,1826,42363,1086
15638,11,157,1443,116,11741,41
11563,18,860,1496,588,16645,272
52814,58,1419,725,797,13915,622
23902,2,110,1302,78,4069,32
3520,221,5444,1573,3165,27931,2279
6453,11,281,1537,201,37616,80
50144,290,4390,804,3639,51957,751
49640,35,360,817,307,3411,53
12328,5,230,1488,135,28323,95
3577,31,1084,1573,774,17438,310
62759,6,49,411,40,2778,9
17984,4203,102440,1402,60254,308456,42186
25338,22,655,1270,389,10544,266
29076,12,478,1191,325,6451,153
69513,122,1704,208,1379,22568,325
25119,116,2564,1275,1697,28542,867
31519,17,347,1146,253,12891,94
38567,24,763,987,493,6521,270
21735,75,1991,1337,1362,28521,629
48906,40,442,838,370,13493,72
14670,3868,149024,1456,71779,729199,77245
27994,27,957,1212,673,29266,284
15492,392,10991,1445,6454,83825,4537
53488,18,240,707,194,4698,46
44151,38,1157,905,556,49491,601
59924,82,681,507,611,8677,70
33160,187,4227,1119,3245,44930,982
60950,6,86,469,72,3215,14
3324,65,1823,1575,1223,30836,600
16225,57584,2053755,1433,833560,5158637,1220195
56993,26,264,599,210,7248,54
9193,46,2428,1512,993,16026,1435
5189,189,9950,1552,5776,103810,4174
23883,1677,40182,1302,27033,267674,13149
45769,12,149,888,120,3281,29
9241,192,7253,1512,4612,64997,2641
3681,15,537,1572,369,30559,168
13189,161,3557,1477,2569,24541,988
1679,13,363,1589,283,9063,80
37979,487,13687,1003,10446,187244,3241
23398,213,5073,1311,3836,58411,1237
18254,0,0,1398,0,10483,0
57445,10,186,588,146,4113,40
9383,17,215,1511,165,8637,50
50793,6,167,639,138,15929,29
61774,19,193,442,125,7174,68
770,351,11814,1596,7357,37357,4457
66197,11,328,315,306,11654,22
27788,51,2348,1216,1414,39185,934
36087,10,239,1053,186,11214,53
13818,71,1779,1468,1021,8079,758
2977,35,996,1578,734,52636,262
22940,1399,32762,1318,15930,112719,16832
17883,31,331,1404,246,7368,85
24573,7,289,1287,197,4205,92
15505,15,709,1445,548,19274,161
26719,3,237,1240,143,8446,94
10363,300,7013,1505,4205,103381,2808
50043,996,12103,806,9618,45878,2485
20271,52,1309,1362,1030,23435,279
38803,41,1244,982,895,15570,349
59697,60,632,514,490,16515,142
50064,2326,28733,806,23369,129480,5364
52602,406,4428,733,3589,38522,839
21122,185,2739,1347,1930,35733,809
14924,2,338,1453,214,10183,124
23482,192,5257,1310,2266,42414,2991
57568,273,3544,585,3110,90938,434
3777,9,536,1570,401,21218,135
63935,32,558,380,551,7733,7
59014,371,7957,538,4936,45156,3021
28940,94,4129,1194,2729,59481,1400
13247,158,2517,1476,1095,28134,1422
39740,110,1394,971,1211,6939,183
56785,871,11979,605,10359,89901,1620
14386,78,2976,1459,2034,47661,942
58633,30,387,550,317,6660,70
14900,50,2920,1453,1695,14793,1225
55882,6,131,631,97,6889,34
30080,185,2878,1171,2214,19613,664
21826,188,5205,1336,3370,52213,1835
61919,27,430,437,419,8289,11
11918,6,243,1493,106,8545,137
36334,26474,620784,1046,295521,1806862,325263
31031,215,5576,1153,3899,24415,1677
16798,14,386,1424,296,4723,90
7419,139,3988,1525,2261,43348,1727
52927,794,11288,722,7167,58793,4121
7231,1144,39553,1527,27060,121572,12493
45714,137,2895,889,1456,18209,1439
50240,277,4727,801,2771,47000,1956
64793,218,3312,354,2531,32765,781
9781,7,348,1509,240,10338,108
25064,37,1372,1275,953,33346,419
49230,97,1406,828,1090,10478,316
48847,200,2484,840,2063,35220,421
35088,1170,21752,1078,15524,212563,6228
37658,287,4972,1011,3305,44761,1667
25371,86,3132,1269,2167,20550,965
60170,112,1608,496,1515,12350,93
3779,18,1055,1570,706,13320,349
29367,446,14237,1186,9302,120171,4935
29761,24,664,1178,369,27071,295
25382,2231,59486,1269,32832,289760,26654
34609,35,465,1090,303,13288,162
67351,9,62,279,58,2646,4
10773,293,8384,1502,5136,44451,3248
19630,312,4802,1374,3472,39669,1330
11388,37,1787,1498,811,33751,976
14552,13,424,1457,322,11240,102
11847,140,17517,1493,8057,170520,9460
24669,43,1150,1284,712,11250,438
7256,35,740,1526,479,7180,261
5093,9,242,1554,175,23192,67
3437,6,222,1574,146,20104,76
33977,730,14982,1104,11886,90594,3096
67930,7,117,261,104,5162,13
41268,34,710,948,467,9124,243
41265,76,1320,948,1078,26461,242
2730,14319,489924,1581,215743,1464452,274181
68224,346,7287,252,6116,68650,1171
61948,30,684,436,662,9867,22
48730,1066,33976,844,13827,228941,20149
23129,198,4227,1315,2968,51705,1259
26383,115,1689,1247,1278,15975,411
25868,374,8607,1259,3784,56549,4823
13235,134,4900,1476,2820,59500,2080
60451,34,1229,488,467,13917,762
41822,1346,55704,938,35280,198243,20424
28732,207,1380,1198,1161,31223,219
25465,83,1783,1268,1433,29587,350
3594,119,3386,1573,2343,47406,1043
38419,7,302,991,162,17582,140
23109,10,380,1316,281,7014,99
14459,130,7710,1458,3262,46064,4448
40494,535,9895,960,5169,58777,4726
14098,32,1307,1464,827,13846,480
209,312,16123,1602,11017,197836,5106
22154,3,135,1331,116,10792,19
15619,79,2975,1443,1881,37822,1094
13696,113,3188,1470,1958,23620,1230
27647,287,7776,1219,5292,36444,2484
3812,18828,808268,1570,415011,1629480,393257
3506,447,11195,1573,7404,33694,3791
4755,189,11310,1558,3929,98970,7381
55784,6,49,634,37,2660,12
6609,60,2093,1535,1556,31233,537
58728,3228,54571,547,45547,229123,9024
4105,7,197,1567,129,11565,68
47423,41,1392,867,1061,31219,331
23358,21,314,1312,233,8297,81
54779,20,147,663,132,3568,15
26220,11,162,1251,125,25140,37
61565,14,211,449,164,3552,47
9284,5,236,1512,182,7452,54
3451,13,207,1574,135,8871,72
56372,43,560,617,451,12310,109
8332,283,6919,1516,4500,33037,2419
25206,36,929,1273,572,25682,357
9884,395,13994,1508,8535,67866,5459
20588,93,1948,1357,949,34840,999
29897,47,1078,1175,579,9260,499
70198,1,59,185,55,2193,4
57714,59,521,581,441,9171,80
38004,5622,222088,1002,113074,558121,109014
33151,75,1568,1119,943,14170,625
27055,113,2522,1232,1695,21334,827
28015,86,6584,1211,3286,28235,3298
12653,24,1041,1484,649,13948,392
61737,53,553,443,507,5123,46
32395,4,262,1133,152,4897,110
17353,448,11418,1414,6208,123582,5210
42434,380,8587,929,3948,105922,4639
2833,525,9945,1580,4839,92177,5106
14109,11,368,1463,240,17869,128
26592,3,364,1243,234,8017,130
61539,83,1148,449,1060,19700,88
1278,16,897,1592,553,23407,344
17932,101,1389,1403,1070,21127,319
23177,3,130,1315,101,6536,29
62587,21,249,416,192,14810,57
36051,32,374,1054,326,14063,48
15542,2431,63480,1444,44790,377588,18690
17625,158,2616,1409,1761,13403,855
11165,1024,20050,1499,13740,80554,6310
35084,83,1625,1078,1427,20426,198
53978,8,132,692,76,10232,56
27559,14,800,1221,551,10702,249
26554,93,2253,1243,1412,57053,841
30210,24,553,1169,442,7661,111
8875,35,1775,1513,1217,24585,558
30732,10,372,1159,218,5643,154
62105,254,6001,429,4683,60457,1318
49296,134,3172,826,2284,37810,888
5887,165,7305,1545,4912,55195,2393
4726,11,497,1558,345,18043,152
6746,219,5888,1533,3992,66362,1896
31592,120,3345,1145,2251,29380,1094
12755,12,589,1483,304,6094,285
4603,77,1210,1560,864,11241,346
25636,714,23139,1264,13137,207498,10002
53367,20,236,710,184,10130,52
32730,169,4426,1127,2880,20890,1546
12251,95,3337,1489,1895,42339,1442
19975,41,1190,1368,950,16519,240
15642,169,3691,1443,2404,63330,1287
31934,11,375,1140,190,11094,185
26668,451,15205,1240,9369,92846,5836
46350,205,3872,881,3593,26293,279
25725,34,1171,1262,770,8411,401
24819,17,216,1281,163,7476,53
51791,2972,46721,760,32867,286542,13854
9113,129,3393,1512,2409,24307,984
7747,10,595,1520,383,30665,212
17526,62,1754,1411,1317,34251,437
9597,221,6679,1510,4791,97677,1888
49524,19,228,820,109,6645,119
37272,7,199,1022,155,12602,44
56643,11,189,609,147,7368,42
62226,3,43,426,43,2784,0
8979,570,11739,1513,8642,49587,3097
16618,17,515,1427,296,9298,219
50588,93,863,792,662,10349,201
31024,61,1531,1153,1048,27004,483
57146,31,475,595,391,11177,84
61612,39,786,447,678,10471,108
54747,3,57,664,49,4965,8
33702,417,5895,1108,4589,22715,1306
41213,65,1161,949,959,8299,202
31635,115,4464,1144,2634,40689,1830
51392,10,207,771,135,4263,72
15626,64,1412,1443,947,43531,465
32865,897,21367,1124,14711,157798,6656
64942,6,85,349,83,4794,2
45477,386,3949,891,3299,32329,650
38674,107,2031,985,1093,19973,938
12223,234,6269,1490,3692,34532,2577
19389,6713,129268,1378,77542,283866,51726
59379,25,424,525,364,10877,60
20504,18,501,1359,345,22669,156
40932,835,36471,953,25236,83097,11235
24512,182,6719,1288,4575,50209,2144
49653,2,57,816,40,5883,17
1560,1733,34890,1590,23009,179983,11881
15805,119,3230,1440,2472,26408,758
33297,75,863,1116,568,8901,295
63422,47,646,395,608,24565,38
32527,39,1399,1130,982,30299,417
35943,483,11678,1057,8023,126395,3655
19084,29,379,1383,288,9369,91
3532,317,17541,1573,11177,111137,6364
23153,48,1360,1315,1064,19734,296
41928,61,1616,936,1134,45697,482
36427,264,3900,1043,2726,34145,1174
33133,63,1721,1119,1242,18831,479
7197,94,2394,1527,1595,24720,799
12230,549,25031,1489,13535,147246,11496
28027,59,1632,1211,958,20807,674
50235,16,238,801,213,4894,25
48846,704,9617,840,6664,69125,2953
27671,5,99,1218,67,2982,32
66763,3,148,298,80,3197,68
30869,143,4830,1156,3004,46157,1826
20606,65,1447,1357,934,20067,513
64973,105,1435,347,1204,17502,231
35511,112,2881,1067,2234,94573,647
6000,65,4780,1543,2332,67115,2448
15062,10,820,1451,570,24705,250
36223,32,576,1050,482,5273,94
16520,713,15245,1429,8007,57041,7238
55440,5,117,643,83,4730,34
42776,39,1080,923,1005,17175,75
65588,4,63,333,37,2792,26
44166,324,5663,905,4779,65779,884
48729,28,361,844,310,11846,51
13151,24,1778,1477,670,12967,1108
12053,582,14765,1491,8388,74676,6377
3682,169,9772,1572,3289,67155,6483
3663,5,118,1572,93,10886,25
33832,273,6134,1106,4447,110862,1687
58981,56,647,539,443,14878,204
24141,52,1151,1296,787,14814,364
55308,117,2155,646,1575,30020,580
7257,7,454,1526,259,23359,195
12234,4753,68767,1489,46128,327606,22639
58537,302,7145,553,4869,45861,2276
38853,183,3689,982,3428,46567,261
10631,356,14715,1503,7895,79201,6820
33054,329,8926,1120,6873,88737,2053
3629,102,1946,1572,1346,29258,600
11414,404,19588,1497,10301,73860,9287
29089,623,13764,1191,10250,81882,3514
26702,2,457,1240,273,6162,184
69109,10,118,221,103,3672,15
7776,11,747,1520,352,17360,395
736,4497,118815,1596,72326,349487,46489
36480,1649,38125,1042,25603,164904,12522
7828,24,998,1519,697,38881,301
2836,4391,208662,1580,76092,281328,132570
27062,66,3331,1232,2185,46930,1146
22289,134,1745,1330,1286,14455,459
38364,85,2006,993,1589,43435,417
55153,258,2504,651,2279,19323,225
19271,19,749,1380,534,10360,215
20804,4,104,1353,90,10406,14
34514,776,38563,1092,16196,243435,22367
39338,26,354,976,316,16336,38
59688,24,308,515,235,9749,73
26442,1031,34521,1246,23039,96608,11482
3377,1147,27658,1575,19141,251402,8517
22525,60,3028,1326,1983,59780,1045
28855,113,1862,1196,1042,9073,820
63130,7,219,402,73,5964,146
221,37,1709,1601,1306,34248,403
55086,13,146,653,111,8341,35
53929,120,1108,694,1093,21685,15
18103,120,3722,1400,2554,109943,1168
31038,6,59,1153,44,8764,15
5140,166,6757,1553,3459,25880,3298
40616,23,656,958,436,13903,220
19514,1072,40910,1376,22088,270035,18822
67586,12,202,271,197,6151,5
12681,7,1185,1484,557,10990,628
48012,193,3442,860,2907,51169,535
46618,0,0,877,0,3170,0
4650,447,18086,1560,12045,100624,6041
54284,80,967,681,900,13300,67
11674,366,12507,1495,7073,57342,5434
54402,22,205,676,105,7869,100
37442,40,894,1017,609,11233,285
40752,36,710,956,572,8043,138
2937,150,11901,1579,6617,87177,5284
34106,1256,27116,1100,20898,119147,6218
11642,134,3530,1495,2446,19829,1084
33338,5,155,1115,129,10214,26
33654,13,356,1109,221,4110,135
57852,373,7201,575,7162,67558,39
20597,33,583,1357,403,7441,180
51579,298,3932,766,3384,59196,548
49937,68,1192,809,979,44189,213
35275,92,2007,1072,1477,24201,530
38716,33,307,984,234,5064,73
50284,88,1348,800,889,20460,459
33248,50,1424,1117,928,12020,496
37444,124,2947,1017,2734,40183,213
37561,55,974,1014,775,23150,199
52333,0,12,743,10,2071,2
46416,377,9670,881,6639,103889,3031
59335,929,28890,527,23924,154836,4966
44792,209,4550,898,2899,29148,1651
19446,13001,415116,1377,267656,1262984,147460
10377,115,3856,1505,2069,41809,1787
67679,26,459,269,400,8299,59
26605,4137,178056,1242,88037,788408,90019
59002,40,405,538,361,10262,44
34817,118,1836,1084,1756,30327,80
20690,54,1299,1355,938,22071,361
46885,2967,40501,874,31837,206392,8664
51434,119,1941,770,1772,18148,169
31016,529,6986,1153,5647,22581,1339
4051,2,123,1568,95,11714,28
66919,679,15534,292,12602,92691,2932
19564,12,475,1375,363,32584,112
27327,3,115,1226,78,16352,37
43701,6564,80667,910,59014,317289,21653
6215,13,557,1540,351,10991,206
23043,465,8596,1317,6489,39956,2107
56586,79,664,611,550,12765,114
56516,24,241,612,154,5430,87
49496,1744,22985,821,18097,177110,4888
54514,31,315,673,289,9334,26
620,6,356,1597,223,47389,133
56604,14,117,610,92,2995,25
50103,20,334,805,296,5386,38
38013,35,618,1002,564,6407,54
8125,59,2101,1516,1269,19399,832
54171,0,208,685,141,5797,67
33379,409,11728,1114,8394,79591,3334
4115,41,936,1567,699,24901,237
9676,380,14841,1510,8652,85399,6189
57698,97,2965,581,2678,22398,287
33874,11,94,1106,74,4962,20
51724,34,360,762,329,11232,31
10830,10,1535,1502,717,9240,818
36987,493,4227,1030,3473,28333,754
70424,5,96,177,90,3766,6
9673,287,8071,1510,5106,66357,2965
1968,127,3480,1587,2132,47740,1348
51598,6,236,765,150,10302,86
15779,20,654,1441,463,21054,191
8538,27,664,1515,403,9319,261
18784,90,2890,1389,2077,26516,813
30083,246,12753,1171,6122,98510,6631
12262,109,1994,1489,1136,20420,858
55482,9,107,642,89,3746,18
35438,33,614,1069,449,11962,165
47667,21,548,864,217,7103,331
30468,254,5849,1164,4255,33679,1594
35854,1527,23955,1060,18056,191010,5899
47000,12905,278064,873,161584,1700577,116480
56903,7,143,602,112,4309,31
59573,3,69,519,57,6240,12
53772,58,589,699,556,15919,33
2582,105,4631,1582,3030,31771,1601
8247,61,1613,1516,1012,23548,601
69020,0,10,224,9,933,1
60979,40,805,468,732,7285,73
52312,11,158,743,100,12145,58
59752,20,364,512,325,22021,39
23429,2,32,1310,22,2426,10
24275,4,109,1294,91,12099,18
64789,23,335,354,297,6239,38
14181,317,8139,1463,5869,48504,2270
8855,16,947,1513,628,18520,319
7053,363,16458,1530,10547,93033,5911
54853,37,478,659,338,10223,140
49684,379,4549,815,3676,29934,873
36207,292,5779,1037,2478,59175,3301
35788,186,4986,1062,3086,59746,1900
2525,958,15163,1583,11950,115369,3213
25482,3,169,1267,136,11122,33
21554,8,155,1340,140,8065,15
30070,196,6292,1172,3674,27658,2618
57357,48,386,589,317,8823,69
34781,39,429,1085,345,10389,84
33111,3,148,1120,75,3532,73
13611,220,8259,1471,4405,55350,3854
56247,14,191,621,159,6242,32
18049,58,1257,1401,906,32996,351
49160,14,210,830,176,15809,34
4160,342,8717,1566,5884,70973,2833
25795,446,10620,1260,6715,46006,3905
53141,88,840,715,766,17090,74
39570,277,2927,973,2484,25688,443
64006,31,240,378,190,5017,50
60130,47,854,500,756,9786,98
64170,19,303,372,286,13433,17
27937,28,838,1213,461,15665,377
35555,5,103,1066,83,7363,20
14874,45,2228,1454,1358,51618,870
13108,5,273,1478,114,5769,159
68941,21,407,226,378,9814,29
50985,270,6771,782,5284,62893,1487
12675,17,710,1484,396,14543,314
5836,2,171,1545,131,13396,40
14918,13,985,1453,681,22843,304
19571,145,2285,1375,1618,16073,667
48620,8,133,847,86,6017,47
3893,12,465,1569,333,7904,132
13803,129,5425,1468,3733,30031,1692
69982,22,243,193,227,4127,16
64178,35,222,372,215,5435,7
52593,2196,39562,729,22134,292642,17428
60848,12,202,473,140,2838,62
17325,32,598,1415,412,8732,186
8462,655,35608,1515,21663,74804,13945
38848,429,8451,982,8083,95071,368
1166,4,229,1593,149,25855,80
49127,42,415,831,377,5248,38
15636,443,11652,1443,8142,79864,3510
52615,16,142,733,114,3494,28
25003,40,950,1277,632,11653,318
11346,0,0,1498,0,11329,0
58666,1455,48540,548,15528,116376,33012
32856,62,1409,1124,941,21900,468
52382,21,370,741,234,7452,136
33162,7811,192432,1117,107671,944333,84761
22193,11,267,1331,137,7268,130
6575,1473,58392,1536,32446,265844,25946
55685,33,553,637,318,11500,235
33262,79,1259,1116,872,11566,387
29278,1,115,1187,102,8401,13
23310,589,16264,1313,10495,74710,5769
29760,16,1418,1179,799,33469,619
29713,15,310,1180,211,4233,99
44434,101,785,902,635,15106,150
52987,120,1181,720,1123,20499,58
7532,210,2739,1523,2127,16962,612
35328,63,1185,1071,860,17730,325
50371,140,1548,798,1322,13189,226
63311,29,176,398,151,4685,25
35580,9,301,1066,196,8037,105
30246,18,407,1168,241,6862,166
6620,202,5774,1535,4384,65315,1390
64980,630,6853,347,5400,25946,1453
5791,43,811,1545,600,20517,211
47086,1641,35084,872,22032,172900,13052
28243,575,14728,1207,7043,84676,7685
10770,253,6335,1502,4254,28166,2081
57311,145,1726,380,1452,27243,274
51182,28,395,777,267,7585,128
56804,27,233,604,201,10541,32
29098,41,2024,1191,1345,49532,679
64403,231,2511,365,2053,19348,458
9148,36,1476,1512,628,26347,848
52669,556,7406,730,5176,61790,2230
33286,212,4403,1116,3372,38499,1031
280,753,30777,1600,21541,120459,9236
65238,1186,17186,341,13597,70550,3589
27516,9,483,1222,282,19519,201
65825,4,69,327,60,6825,9
36062,61,1085,1054,615,7177,470
10450,94,1992,1505,1225,20231,767
33562,2002,49497,1111,29981,183938,19516
15451,80,1156,1446,771,7583,385
1744,146,4512,1589,3104,55160,1408
55,233,8436,1604,4623,66492,3813
26764,984,17482,1239,13458,102295,4024
24118,22,450,1297,333,10990,117
21922,2879,116354,1334,44628,200525,71726
13022,0,0,1479,0,11048,0
65887,9,471,325,440,19055,31
62328,2474,27826,423,23604,109350,4222
58054,39,460,569,360,11996,100
12534,1351,42427,1486,21356,273219,21071
32454,42,732,1131,426,14331,306
41237,26,461,948,408,10765,53
59868,22,652,509,519,17088,133
35710,8,526,1063,380,11011,146
19395,52,1585,1378,1134,15979,451
30667,34,1164,1160,665,8088,499
23231,1948,70916,1314,34155,524045,36761
12527,18,854,1486,409,8428,445
6429,1115,48195,1538,26756,257589,21439
8359,83,3009,1515,1796,34313,1213
56846,61,685,602,596,19626,89
15651,12,312,1443,259,24480,53
60643,6,154,480,95,5570,59
9209,934,20453,1512,12724,93544,7729
57733,83,975,580,854,12476,121
5461,30,911,1549,459,20149,452
57656,19,202,582,198,4694,4
19513,14,502,1376,369,17794,133
27878,247,4956,1214,3135,36514,1821
49826,216,2881,812,2453,58357,428
32373,28,551,1133,338,7127,213
52947,148,2578,721,1734,11798,844
36131,9,250,1052,170,8989,80
24021,176,7987,1299,4762,30536,3225
56803,54,910,604,652,15025,258
36807,19,449,1036,365,12040,84
44697,128,1396,900,1393,19556,3
63228,68,1233,400,1082,16127,151
59199,53,519,532,457,9493,62
61637,21,280,446,232,7877,48
51438,4,58,770,35,2821,23
22254,47,690,1330,370,10206,320
56410,307,5327,616,4650,71673,677
51658,68,1133,763,924,15088,209
18987,67,1609,1385,1133,18297,476
18060,5,412,1401,263,13906,149
55902,40,550,631,461,18282,89
13024,44,1297,1479,772,10720,525
18921,8,134,1386,97,10974,37
33146,43,726,1119,427,7952,299
5505,100,7135,1549,4154,46531,2981
31712,3,98,1143,78,8007,20
9713,25,1135,1509,599,8676,536
51484,91,1541,769,984,12303,557
27189,1153,19007,1230,14716,110803,4291
34631,75,1498,1089,1078,11173,420
22066,101,2861,1333,2112,38192,749
5597,622,17398,1548,10492,81375,6906
23080,7,667,1316,423,16008,244
46454,79,572,880,465,9153,107
31876,15,267,1140,167,4827,100
15576,104,2154,1444,1514,39257,640
2961,16,322,1579,222,19444,100
59657,53,651,516,639,9010,12
2886,20,1149,1579,904,50042,245
21002,28,666,1350,503,14460,163
48673,8,102,845,79,17609,23
62874,2,41,409,37,3793,4
52117,1595,18580,750,16262,117207,2318
37198,0,57,1024,44,4434,13
2476,19,840,1583,522,12197,318
23005,0,24,1317,20,3706,4
20901,49,1811,1351,1278,38264,533
4346,337,20855,1564,8478,106623,12377
50396,893,15677,797,10083,123831,5594
22456,5,261,1327,206,11985,55
24685,63,1001,1284,749,14001,252
27511,786,26224,1222,14115,136280,12109
24209,57,1762,1295,993,15815,769
68041,8,85,257,85,4939,0
26230,20153,887876,1251,217968,1979034,669908
403,50,3930,1599,2213,30751,1717
27178,4168,128410,1230,61181,325659,67229
26022,603,8186,1255,4277,36976,3909
43757,55,1080,910,835,25738,245
21007,14,358,1349,252,12020,106
61046,29,553,466,466,14243,87
64354,37,283,367,252,4322,31
2356,33287,1241204,1584,593416,4421606,647788
11008,1414,46666,1500,21526,130474,25140
10784,227,4068,1502,3016,46298,1052
11840,1,249,1493,128,5519,121
6763,114,5170,1533,3527,89292,1643
32217,71,2074,1136,1350,49492,724
5853,1016,44354,1545,23907,325674,20447
35592,113,2733,1065,1653,39367,1080
59052,105,1606,537,1256,7117,350
33605,265,4300,1110,3174,36223,1126
22349,23,738,1329,396,33952,342
578,154,9673,1598,7462,116316,2211
35036,94,1879,1079,1057,22913,822
6644,35,771,1535,552,23314,219
18016,53,1539,1402,1100,33731,439
26856,444,5617,1237,3768,39952,1849
6933,21,752,1531,522,22297,230
6483,108,2367,1537,1692,64271,675
35165,9,243,1076,175,4581,68
38494,36,791,989,622,17471,169
52254,308,4376,745,3103,34910,1273
37578,111,1773,1013,1470,31847,303
48931,27,450,837,387,11186,63
35800,21,292,1014,207,8758,85
7199,24,1854,1527,1148,15335,706
52201,29,384,747,340,11523,44
5719,867,18975,1546,15939,108203,3036
36432,11,343,1043,253,11105,90
28923,355,10482,1194,6944,41635,3538
15181,168,3909,1449,2316,40389,1593
9912,5129,136634,1508,78091,270855,58543
68071,27,464,256,451,17013,13
30196,205,6151,1169,4615,119803,1536
8780,34,1431,1514,898,13237,533
56263,32,212,620,165,4410,47
8795,17,790,1514,453,9003,337
61688,44,473,445,412,16394,61
16732,36,655,1425,533,29137,122
26885,23,343,1236,254,10017,89
32117,78,1109,1137,738,11016,371
26888,319,9898,1236,6815,85653,3083
36015,20,724,1056,476,11104,248
13116,2677,75380,1478,34733,173371,40647
56059,131,1376,626,1108,23911,268
1719,40,2610,1589,1712,52403,898
14866,9,177,1454,121,9417,56
17992,123,3096,1402,2095,42967,1001
4198,512,20274,1566,12157,142602,8117
35924,30,1019,1058,815,6171,204
32232,785,31811,1135,12163,99093,19648
27075,128,1961,1232,1262,34245,699
31350,3,107,1148,74,4642,33
6755,2,142,1533,87,10240,55
64808,6,196,353,182,5192,14
32476,70,1834,1131,1325,21310,509
6185,20,822,1541,431,10121,391
61566,4,46,448,35,2984,11
10460,1063,19797,1505,14345,61407,5452
35696,8,255,1064,177,14734,78
56733,11,117,606,102,3770,15
54604,58,744,669,560,12472,184
18623,59,2473,1392,1201,27851,1272
50364,17,154,798,118,3015,36
45702,1,73,889,48,3713,25
34434,38,1197,1094,842,39821,355
28687,11,298,1199,186,8768,112
14030,870,35895,1465,18393,204580,17502
15985,38,1034,1437,732,17145,302
35476,50,1354,1068,782,11499,572
21892,310,3369,1335,2081,15775,1288
35060,36,881,1079,602,12721,279
362,2149,72144,1600,40989,227000,31155
52894,32,387,723,360,12756,27
11856,23,1126,1493,381,9436,745
37397,17,229,1018,158,6962,71
20900,1887,35544,1351,24521,179403,11023
7578,19,450,1523,337,11562,113
29391,15,769,1185,503,6946,266
17705,79,3330,1408,2446,35137,884
61723,263,4383,444,3363,62220,1020
31588,6,115,1145,105,5370,10
53678,115,906,701,723,10776,183
25316,190,2182,1270,1343,13061,839
50150,24,327,804,306,14833,21
41741,351,4553,940,3594,44429,959
45438,136,2441,892,2013,31429,428
49993,17,489,808,426,8484,63
41358,18,487,946,377,8614,110
22090,35,1457,1332,737,21009,720
7663,531,24326,1521,14235,249815,10091
54248,61,537,682,437,11334,100
61714,50,473,444,472,10223,1
33298,21,381,1116,325,20664,56
60954,659,9290,469,8907,46465,383
38020,2008,41439,1002,27198,378672,14241
32076,12,513,1138,230,11079,283
55629,1,10,638,9,2297,1
57851,1,26,576,17,5900,9
52449,41,266,738,214,9236,52
17666,36,992,1409,738,27218,254
41278,8,303,947,137,5776,166
54603,38,323,669,238,6569,85
33438,49,890,1113,548,29017,342
29109,105,2332,1191,1393,20581,939
37467,52,813,1016,680,11174,133
67378,2,17,278,12,3033,5
38405,18,521,991,333,14200,188
63300,170,2654,398,2406,26733,248
10887,28,1106,1501,665,18263,441
55463,1,39,643,35,3101,4
59099,8,231,535,201,5714,30
13562,194,9648,1471,4431,99507,5217
27003,337,8884,1233,6511,52599,2373
43057,203,2479,918,1997,36015,482
37273,7,140,1022,107,8726,33
22820,83,3511,1321,1915,38964,1596
14133,497,4179,1463,2997,45559,1182
58510,3644,56001,553,38687,188163,17314
31146,13,163,1151,109,7191,54
4635,16,481,1560,349,18945,132
57069,158,1756,597,1589,17328,167
25460,33,1254,1268,711,10776,543
23723,24,644,1305,396,17222,248
13435,23,1039,1473,507,10820,532
10798,19,412,1502,294,13085,118
5194,35,1310,1552,834,19532,476
32340,13,540,1134,197,8264,343
35134,8,204,1077,152,7197,52
52008,9,213,754,165,5318,48
18344,24,1040,1396,634,8697,406
39334,4,96,976,83,5576,13
27106,2,134,1231,72,4354,62
31378,0,0,1148,0,6886,0
3304,229,8167,1575,5233,29896,2934
17401,1426,44272,1414,20752,221467,23520
67227,60,1611,281,915,14164,696
67158,27,536,267,371,23509,165
48572,609,5650,847,5409,43868,241
22667,133,3402,1323,2421,32718,981
56179,369,9863,622,5770,138304,4093
9695,40,2762,1509,1612,19055,1150
17349,99,2460,1415,1772,40807,688
10624,14,663,1504,392,24189,271
57296,458,7843,591,5084,70009,2759
369,1081,26213,1600,16472,120483,9741
25476,10367,207072,1267,138574,1102576,68498
31398,121,1988,1148,1384,22722,604
21972,61,1956,1334,1024,19329,932
52879,223,2145,723,1882,17027,263
63280,26,426,398,354,11897,72
4776,5,351,1558,215,6732,136
58405,194,4535,558,2669,21734,1866
6053,345,14452,1542,9495,90790,4957
14794,107,1466,1455,1086,10844,380
46925,10483,363061,867,145291,1419038,217770
32475,71,1702,1130,1070,14207,632
3675,4,182,1572,139,15977,43
62283,59,916,424,866,21936,50
5860,1483,52556,1545,26003,239621,26553
5810,86,3743,1545,2472,50817,1271
39450,15304,335651,975,248389,1062479,87262
33288,13,199,1116,152,6026,47
7196,34,1861,1527,1085,22356,776
24797,3,91,1282,72,6320,19
19308,19,356,1379,244,6600,112
31389,304,8232,1148,5791,58834,2441
53186,377,4659,713,3614,40732,1045
34152,0,1847,1100,1155,18923,692
9869,11,570,1508,346,9527,224
42965,46,467,920,321,8642,146
58769,114,1442,545,1273,16089,169
57737,15,125,580,123,6078,2
56443,9,136,615,113,4006,23
57577,18,440,585,296,26390,144
50224,565,8600,802,6710,120404,1890
18931,53,1199,1386,1026,32241,173
50418,1681,23926,796,20161,97498,3765
31333,82,839,1149,613,12189,226
3226,349,30233,1576,8623,133539,21610
3341,170,4084,1575,2333,31612,1751
67746,35,730,267,666,10522,64
53844,77,1362,696,1128,16419,234
2682,342,9955,1581,6624,60072,3331
24044,5,208,1299,87,3057,121
34403,37,800,1094,532,12079,268
17594,416,15463,1410,10783,139158,4680
45780,154,2205,888,1857,23845,348
67744,1,31,267,27,6315,4
32297,27,418,1133,378,6116,40
31784,21,441,1142,342,4520,99
63022,643,7950,405,6985,60217,965
3329,686,17476,1575,10637,96451,6839
15322,105,3329,1448,1767,32622,1562
25397,29,668,1269,519,9723,149
65365,43,475,338,465,4139,10
2891,2,228,1579,179,16402,49
11053,11,378,1500,248,11388,130
8689,83,3170,1514,2007,25905,1163
9720,4952,172231,1509,95004,373694,77227
65112,136,1284,344,1254,13276,30
60718,842,8097,477,7585,39751,512
68761,9,145,233,138,5361,7
10143,1375,54518,1507,29571,138486,24947
1646,13,370,1590,275,18866,95
60821,65,1332,474,1159,18611,173
5121,0,224,1553,161,8813,63
25979,27,931,1256,595,31281,336
9340,76,3393,1511,2430,47399,963
17684,0,0,1408,0,19454,0
59843,3,36,510,26,2887,10
5283,581,51586,1551,14084,243044,37502
32590,21,524,1129,403,6955,121
7234,142,4148,1527,3000,32438,1148
67289,13,118,281,89,5166,29
52954,7,83,721,46,3188,37
34112,177,5018,1100,3252,30439,1766
24759,778,22178,1282,13165,99664,9013
23222,485,11091,1314,7305,42508,3786
13628,52,3372,1470,2206,40443,1166
43445,25,338,913,323,10688,15
15644,1,160,1443,76,16520,84
51471,52,1007,769,998,31013,9
6595,43,997,1535,662,20004,335
54554,229,4804,671,4344,44099,460
24369,193,4490,1291,3279,37422,1211
6603,0,0,1535,0,17781,0
23227,53,2680,1314,1225,62286,1455
10118,1173,46927,1507,29429,170305,17498
66333,99,1695,312,1624,38032,71
60400,34,496,490,335,8893,161
27605,19,296,1220,212,4791,84
1992,784,19443,1587,10600,150857,8843
59640,10,159,517,134,3556,25
5540,586,10004,1548,6472,58729,3532
7046,140,5947,1530,3666,52017,2281
16908,32,1413,1422,948,46731,465
15046,30,1102,1451,663,21440,439
39419,3,82,975,65,7046,17
17977,156,4245,1402,3252,25902,993
37957,52,751,1003,670,11779,81
12272,0,36,1489,24,4311,12
18820,3177,86741,1388,45963,409598,40778
61129,37,417,462,360,14543,57
25751,21,511,1261,335,11080,176
69622,5,50,205,48,3335,2
34261,87,2690,1097,1857,38699,833
33887,10,401,1105,288,11003,113
26715,71,2680,1240,1656,52001,1024
9308,180,8485,1511,4871,34846,3614
26941,56,2203,1235,1173,23676,1030
35334,69,805,1071,586,5579,219
194,788,32039,1602,18238,148214,13801
3838,614,46172,1570,23492,314567,22680
21741,416,8419,1337,6666,50935,1753
5396,16,1227,1550,719,9214,508
27967,7,351,1212,176,5383,175
43113,24,429,917,275,10022,154
60845,51,615,473,584,12501,31
51526,68,898,768,695,29725,203
18665,620,32049,1391,18599,234792,13450
11618,635,6328,1495,3537,61301,2791
58244,233,4843,563,3783,28400,1060
34839,19,397,1084,242,10668,155
13978,50,1928,1466,1118,61509,810
14149,256,4478,1463,2816,20750,1662
51998,112,998,754,782,15988,216
54659,26,226,666,208,9898,18
9265,61,3276,1512,2062,26955,1214
40061,43,590,966,467,14180,123
63019,8,45,405,40,3134,5
41711,4,152,940,127,7370,25
5849,71,1818,1545,944,34246,874
53366,81,688,710,603,9239,85
33211,87,2745,1118,2048,54941,697
9691,5,224,1509,134,7450,90
14111,42,1101,1463,676,18404,425
21689,5277,141036,1338,75585,455197,65451
54885,3,56,659,34,5470,22
24951,2,195,1278,158,7985,37
3816,61,2002,1570,1473,39424,529
9868,87,5048,1508,2277,32398,2771
40277,54,552,963,439,6708,113
28397,13,800,1204,378,10455,422
30388,15,802,1165,484,12105,318
25353,38,940,1270,595,29016,345
13858,5,240,1467,147,19784,93
50996,65,828,782,464,21288,364
15007,244,14790,1452,5903,103549,8887
8652,63,2353,1514,1538,24992,815
30276,3,75,1168,66,2677,9
38190,15,168,997,138,5216,30
26578,40,1275,1243,645,15312,630
19631,160,1662,1374,1095,23504,567
25172,4,90,1274,61,5769,29
38037,71,1118,1001,917,24865,201
31469,170,3022,1145,2196,69994,826
55611,379,7706,638,6032,40392,1674
26,13194,619142,1605,367189,2320059,251953
19646,26,771,1373,599,12175,172
19925,42,625,1368,433,24168,192
5148,76,4427,1553,3022,42118,1405
64424,47,819,364,810,29310,9
1057,141,3336,1594,2233,46141,1103
51105,722,11067,779,9629,64380,1438
21227,17,385,1345,297,43651,88
22054,244,8335,1333,3683,98938,4652
22468,80,3891,1327,2740,53049,1151
1067,12,675,1594,489,21621,186
7824,3056,138535,1519,81632,347511,56903
61743,14,191,443,159,13622,32
18634,1,107,1391,91,14921,16
2849,57,1861,1580,1312,36610,549
63407,152,2799,395,2731,24989,68
12405,36,2235,1487,1294,20088,941
37879,128,1819,1005,1645,21133,174
19899,30,842,1369,645,12241,197
42676,10,147,924,112,6361,35
52872,254,3032,723,2247,44774,785
5855,32,1085,1545,750,15963,335
32266,29,1495,1135,856,23561,639
34539,5239,155330,1092,69723,546148,85607
55901,53,591,631,524,13773,67
3722,434,13776,1571,6262,77540,7514
32673,33,1517,1128,923,12780,594
57343,75,1246,590,869,11453,377
34101,280,5693,1100,4297,109246,1396
32797,6,184,1126,102,11883,82
21940,15,297,1334,205,6987,92
15777,15,444,1441,308,23660,136
10183,17,637,1506,457,11333,180
40468,850,15874,960,13681,59743,2193
7422,208,3888,1525,2669,41944,1219
61582,89,1700,448,1245,25827,455
21341,1113,23250,1343,16667,188907,6583
32697,408,12476,1128,6251,121056,6225
8181,21,653,1516,431,7621,222
51236,18,218,776,169,8325,49
21275,3,301,1344,202,8910,99
29372,0,0,1186,0,6106,0
9055,91,3238,1512,2111,28303,1127
32131,77,1904,1137,1526,33797,378
27908,226,6320,1213,3431,79610,2889
48898,71,622,838,488,9592,134
1335,60,1392,1592,993,19919,399
65390,14,363,338,338,5957,25
54230,4,44,683,36,3771,8
6540,43,3020,1536,1063,52521,1957
34394,28,579,1095,458,9175,121
16503,6,754,1429,450,8327,304
3000,15,844,1578,583,22793,261
50509,4,136,794,102,8418,34
17785,243,7385,1406,4642,71785,2743
8078,6206,174700,1517,102936,371613,71764
21149,7,184,1347,150,10867,34
62565,110,1402,416,1207,13968,195
7039,86,2255,1530,1769,14574,486
58616,7,71,550,61,3894,10
23749,20,736,1305,491,9957,245
55055,54,408,654,321,14480,87
7804,4138,83420,1519,55425,321403,27995
19211,0,184,1381,139,12038,45
17852,15,657,1405,514,14599,143
30871,22,731,1156,553,4953,178
37680,14,433,1011,366,10364,67
14220,26,465,1462,382,14362,83
18904,53,1468,1386,946,19526,522
27828,14,425,1215,216,9836,209
2049,129,3566,1587,2733,51901,833
23530,6116,150786,1309,80785,805500,70001
34051,1901,41883,1101,28758,305845,13125
51285,168,1930,774,1703,29518,227
66442,111,1376,309,1016,17231,360
19799,5584,150616,1371,103749,423515,46867
42148,222,4841,933,3370,36321,1471
29850,34,1574,1176,712,13221,862
6787,82,3011,1533,1878,60656,1133
24467,447,14766,1289,10954,107664,3812
54252,113,990,682,711,38302,279
24476,78,1520,1289,1104,13528,416
29620,494,10021,1182,5901,50726,4120
6311,958,30292,1540,18699,169079,11593
19318,410,12610,1379,8934,157780,3676
24466,281,6984,1289,4105,33798,2879
10299,82,1560,1506,990,18417,570
66610,3,116,303,91,6505,25
10815,60,2111,1502,1451,33035,660
66073,234,6484,320,3845,45613,2639
54521,27237,414980,672,305254,2295899,109726
12615,13360,350882,1485,208120,1069725,142762
35898,0,0,1059,0,5405,0
33061,3569,77844,1120,50633,328686,27211
38448,1037,13511,990,10428,92680,3083
30076,20,412,1172,279,9333,133
22804,7,360,1321,234,10581,126
22159,16,412,1331,281,16447,131
60311,435,4999,493,4481,68494,518
59823,34,446,510,299,18616,147
24407,120,4571,1290,2324,45195,2247
17137,1335,69880,1418,21511,767070,48369
11903,68,1778,1493,795,14846,983
20853,29,623,1352,456,9086,167
34520,23,303,1092,198,5773,105
50160,21,297,803,246,14773,51
19413,11,357,1377,306,20915,51
7612,19,1191,1522,588,28128,603
2918,34,703,1579,530,17736,173
1760,410,15468,1589,10773,78487,4695
28465,277,5013,1203,3134,29776,1879
48487,1350,15441,846,11621,155126,3820
2556,9,567,1582,357,12447,210
57644,188,2170,583,1699,28654,471
56517,128,2707,608,2130,24728,577
62169,24,266,428,202,7571,64
22198,67,1908,1331,1319,38246,589
52182,11,125,748,102,7171,23
12885,166,7066,1481,2683,96574,4383
11081,3,163,1500,108,19606,55
67469,7,121,275,110,7870,11
59650,173,2783,516,1314,30294,1469
63003,13,381,406,289,9926,92
3879,175,10250,1569,6067,103261,4183
8985,31,1788,1513,1129,26481,659
52267,6,63,745,38,4631,25
47923,1,112,861,77,8248,35
6878,20,581,1532,416,18342,165
33074,16,377,1120,249,10963,128
47915,0,0,861,0,3300,0
40456,11,287,960,219,9780,68
10496,39,642,1504,395,6541,247
17639,81,1963,1409,1317,26300,646
8997,147,4074,1513,3143,62453,931
19613,137,5748,1374,2359,69428,3389
11124,15,585,1499,288,8526,297
34617,259,6125,1088,4389,53317,1736
53203,11,140,713,77,3598,63
56151,31,278,623,214,10751,64
59397,71,679,525,620,5003,59
53911,68,769,694,568,7372,201
67243,18,333,282,266,5055,67
27371,41756,861306,1226,444800,1856411,416506
4631,19,409,1560,310,11329,99
16278,3,397,1433,254,12133,143
34972,94,2889,1080,2183,31934,706
29481,27,386,1184,338,8509,48
36528,49,884,1040,754,21898,130
60493,433,6718,486,5845,54863,873
59597,54,505,518,424,8486,81
64562,12,125,361,109,5557,16
17534,213,3555,1411,2542,55570,1013
61050,83,1173,465,820,13773,353
23069,9,332,1316,247,9265,85
52189,85,1074,747,998,18005,76
43173,433,5853,916,5105,87508,748
27120,24,582,1231,353,18197,229
59567,63,840,519,741,9515,99
41868,354,4648,937,3316,24796,1332
31618,68,2105,1145,1154,7093,951
23350,421,6788,1312,4509,58414,2279
57184,387,7690,594,6222,65056,1468
56972,136,1642,600,1463,18575,179
11362,79,1785,1498,914,18068,871
32342,58,1320,1134,732,17193,588
18661,12,470,1391,350,9314,120
28634,201,3936,1200,2048,14821,1888
48491,9,160,852,133,4718,27
60935,445,8429,452,5797,92224,2632
46515,424,6224,879,4694,46193,1530
8148,2,249,1516,178,10199,71
53479,242,3846,708,2586,72349,1260
3111,918,125531,1577,41616,300748,83915
17894,73,1958,1404,1018,16128,940
29203,80,1654,1189,995,16679,659
20131,240,5359,1365,3966,57112,1393
8049,76,2550,1517,1781,14288,769
15876,337,6389,1439,4218,35316,2171
21704,69,1176,1337,742,31922,434
13486,52532,1497539,1472,592615,3806348,904924
54720,36,591,662,379,14354,212
12379,63,2471,1488,1099,29784,1372
24436,83,1376,1290,950,17714,426
16101,459,14233,1435,10072,84166,4161
34139,199,2189,1100,1834,9879,355
15853,24,850,1439,531,27519,319
9652,25,1196,1510,649,14848,547
20506,37,1222,1358,751,9739,471
25898,243,5759,1258,4861,78442,898
58205,718,9907,557,8612,166215,1295
59254,1875,25019,530,24606,163324,413
24811,8,185,1281,126,11458,59
3149,250,5765,1577,3582,50267,2183
63749,0,0,386,0,3556,0
12724,0,0,1483,0,3618,0
22622,585,12493,1324,9129,54320,3364
48595,180,3793,847,2770,81742,1023
49378,4,27,823,23,2643,4
22741,2088,47916,1322,34527,256270,13389
34353,21,325,1096,236,6002,89
67261,774,14098,282,11105,136676,2993
35771,38,1517,1062,1166,21066,351
18880,15,296,1387,186,8938,110
1512,147,5931,1591,3912,78770,2019
31413,12,366,1148,247,12228,119
50954,5469,65632,783,50375,344485,15257
9856,198,5131,1508,3422,31752,1709
30434,9,221,1164,152,6982,69
12727,41,1228,1483,655,13841,573
23843,173,1861,1303,1284,23448,577
3322,33,1579,1575,1093,20803,486
38021,57,1128,1002,1001,17292,127
35346,21,318,1071,249,11133,69
23338,14,585,1312,359,9298,226
9952,155,7910,1508,4054,88670,3856
61239,46,372,458,317,10389,55
49063,41,854,832,755,27226,99
67002,76,800,290,608,8279,192
33710,23,695,1108,492,17523,203
3727,127,5718,1571,2814,49437,2904
3066,295,9696,1578,6043,107950,3653
54489,463,5750,673,5065,50761,685
19592,9,341,1374,213,8937,128
28038,1,284,1211,169,12935,115
38712,5031,174152,984,63043,635263,111109
14263,1085,26005,1461,18073,114695,7932
58173,9,168,566,138,7819,30
59033,73,1335,537,1016,16443,319
55518,3417,87610,641,57351,319894,30259
49491,10,230,821,144,23193,86
44418,945,14044,902,12422,81688,1622
41669,83,2947,938,858,28569,2089
34037,98,2768,1102,1963,15278,805
15262,58,2135,1448,1339,33574,796
11027,14,621,1500,370,33207,251
37525,11,268,1015,217,12418,51
23791,440,11634,1304,7910,65404,3724
66781,2,34,298,29,1323,5
21864,163,4757,1335,2704,44531,2053
57048,51,782,594,663,11088,119
8117,27,502,1516,335,5859,167
28555,1616,52118,1201,33893,239809,18225
17229,138,2828,1417,2179,23824,649
49341,484,8450,824,5752,53866,2698
19123,30,1120,1382,845,44815,275
31290,31,513,1149,290,4436,223
2266,59,2931,1585,1943,35304,988
23144,56,3318,1315,1651,31311,1667
11371,3276,59500,1498,38616,313864,20884
41137,11,445,949,280,14541,165
21027,34,1268,1349,776,18443,492
33544,203,3046,1112,1796,25220,1250
49864,35,176,811,163,6792,13
25558,97,2181,1266,1608,17695,573
7636,38,1998,1522,1354,27025,644
23435,8676,197669,1310,147015,630609,50654
3308,6,567,1575,395,41599,172
30332,425,5599,1167,3361,24791,2238
49295,120,2100,825,1662,29466,438
58160,52,574,566,517,5756,57
551,95,3136,1598,2183,53542,953
22351,215,9021,1329,5645,85405,3376
51499,57,599,768,566,11420,33
24317,3,137,1293,99,4106,38
6877,150,2457,1532,1373,18829,1084
36185,537,17019,1051,11827,43014,5192
15061,13,614,1451,468,38722,146
35559,49,687,1066,497,10895,190
66520,9,90,306,79,1961,11
6252,21,946,1540,620,30396,326
10843,6120,221840,1502,103696,745831,118144
44741,9,105,899,88,8328,17
6626,36,1578,1535,917,38385,661
11111,65,2054,1500,692,16846,1362
3263,23,617,1576,470,18935,147
1099,7,341,1594,232,16832,109
13648,167,3122,1470,1946,25970,1176
13198,43,1810,1477,804,16993,1006
8081,5,215,1517,137,6227,78
32413,46,489,1132,320,4195,169
36257,17,331,1049,280,13952,51
35671,33,732,1064,554,12592,178
456,199,6010,1599,3550,50020,2460
68218,44,813,252,569,23063,244
22450,594,10500,1327,7501,66841,2999
65665,12,225,331,210,5184,15
42990,56,982,920,577,15757,405
3305,26,1048,1575,769,10171,279
16127,580,22649,1435,12671,181126,9978
30962,110,3370,1150,2560,46227,810
62449,51,531,420,424,8465,107
14749,114,3747,1455,1993,31110,1754
59055,46,500,537,500,4489,0
22655,2,163,1324,125,12547,38
6986,101,2235,1531,1698,17107,537
16647,0,0,1427,0,5411,0
55291,46,635,647,504,17261,131
16651,95,2599,1427,1597,34283,1002
26438,20,668,1246,413,7052,255
53166,14,185,714,170,3096,15
18681,26,871,1391,689,11207,182
16187,273,15096,1434,6626,152085,8470
37305,81,1888,1021,1721,49861,167
45606,162,6048,890,4361,40884,1687
56608,0,17,610,16,3473,1
404,1246,51043,1599,29283,236632,21760
17166,3,119,1418,56,5080,63
15577,356,10411,1444,6294,40291,4117
21499,14,707,1340,412,20374,295
37227,165,2576,1023,2207,38776,369
36516,56,1083,1040,1011,18141,72
15599,419,6701,1443,5300,57577,1401
22701,7852,172551,1323,128078,680002,44473
15408,14,449,1446,291,11075,158
62608,13,280,415,214,10797,66
49971,69,717,808,567,15250,150
46753,25,385,876,339,22355,46
58190,80,2928,565,2075,42815,853
35365,52,1969,1071,1734,28407,235
60080,61,865,499,672,9619,193
33711,823,12927,1108,9107,55763,3820
6359,14,602,1539,381,20539,221
49538,68,1516,819,811,14344,705
13970,2765,70683,1466,35774,355314,34909
58001,172,3763,571,2417,27227,1346
58965,20,351,539,231,7512,120
27954,91,863,1212,591,6652,272
2945,22,1838,1579,1333,65747,505
15009,13,348,1452,270,11609,78
192,203,8797,1602,5213,78730,3584
32061,9,211,1138,165,6453,46
59607,31,483,518,373,7471,110
31444,472,12951,1147,6834,60424,6117
28553,52,760,1202,516,7205,244
19197,3,262,1381,132,11548,130
7555,72,2151,1523,1465,61687,686
58960,1757,43794,538,24922,143814,18872
54411,23,189,676,159,10771,30
50958,258,3386,783,2950,16071,436
12963,248,6707,1480,3773,76764,2934
36026,36,1071,1055,773,61211,298
49513,108,1145,820,1085,16659,60
47433,112,1867,867,1611,27804,256
26896,36,2058,1236,813,17029,1245
32144,6,167,1137,126,3384,41
26653,5474,227187,1241,93366,727514,133821
35178,165,1888,1073,1609,19206,279
35636,17,301,1065,212,8794,89
42254,266,3260,931,2196,34187,1064
62999,12,206,406,197,3950,9
27180,13,470,1230,287,7471,183
18170,38,1348,1400,1074,23999,274
63676,69,623,388,368,5191,255
29953,405,7461,1174,4944,109634,2517
58281,48,1003,562,823,19349,180
25523,142,3604,1267,2184,21781,1420
30569,102,2939,1162,2102,25779,837
17157,79,1759,1418,1463,20147,296
32141,175,4050,1137,2302,28953,1748
38914,53,821,981,698,7590,123
7449,14,515,1524,197,16227,318
7473,70,3008,1524,1187,58316,1821
12508,32,863,1486,483,27595,380
36831,53,624,1035,554,10339,70
30253,158,3752,1168,2667,67532,1085
5604,999,32156,1548,17652,279058,14504
3510,660,21231,1573,12735,56681,8496
10517,1131,66240,1504,22649,246098,43591
27405,19,728,1225,460,13203,268
58052,34,248,570,224,9629,24
19591,109,2206,1374,1293,19326,913
26099,51,2027,1253,1241,20399,786
33759,7,149,1107,125,6645,24
27257,3,102,1228,78,7679,24
58214,342,5776,564,4652,45436,1124
54884,6,53,659,45,10176,8
33709,641,14326,1108,12163,41676,2163
17781,109,5743,1406,3834,78376,1909
20705,33,1083,1355,713,13501,370
51460,138,1929,770,1437,27818,492
53610,199,2712,704,2356,16114,356
9293,11,423,1512,291,11580,132
22277,94,1304,1330,1128,24780,176
38360,12,251,993,205,10751,46
61040,147,1613,466,1394,20856,219
9514,5479,100490,1510,63209,336865,37281
65924,74,773,324,700,6890,73
18610,0,0,1392,0,58492,0
59932,155,1707,506,1390,34098,317
38311,5,124,995,92,3319,32
28735,9,888,1198,409,14662,479
43992,7,131,908,110,10043,21
33252,128,3940,1117,2858,52806,1082
48916,68,1117,838,886,13225,231
64420,1754,30960,364,24929,184750,6031
10338,14,1229,1505,616,16466,613
24125,721,14199,1297,10648,36065,3551
23524,3,173,1309,119,14544,54
49426,0,18,822,15,2446,3
21900,95,1895,1335,1124,12394,771
3098,21,1178,1577,851,19164,327
60705,10,122,478,89,6903,33
6816,5,99,1533,66,6823,33
14549,91,2570,1457,1624,18086,946
43195,25,626,916,511,32046,115
9196,1410,58300,1512,31911,250702,26389
32859,60,1442,1124,1037,16862,405
10828,158,6493,1502,4113,34186,2380
57897,6,67,574,57,4476,10
49667,92,2069,816,1614,27101,455
42322,478,6484,931,5551,66022,933
36926,32,456,1021,334,15056,122
16563,0,0,1428,0,12534,0
33279,32,1092,1116,717,10265,375
28642,35959,1187986,1200,566521,2258548,621465
49332,142,1609,825,1105,10765,504
62606,50,658,408,657,17733,1
30046,1018,40293,1172,17059,234663,23234
24593,101,3496,1286,1345,59471,2151
32045,316,5869,1138,4088,58304,1781
40743,18,540,956,342,13043,198
33588,135,3917,1111,2559,18554,1358
65634,31,320,332,223,7290,97
36793,66,2558,1036,1484,13602,1074
56542,108,1757,612,1461,17035,296
40406,32,359,961,295,5116,64
12644,542,10960,1484,8045,41538,2915
11721,88,4087,1495,2090,43825,1997
42752,357,7026,923,5827,33831,1199
29879,1685,26261,1176,20820,89708,5441
18910,25,1138,1386,764,8657,374
53539,37,590,706,512,15350,78
837,38,2296,1596,1739,26269,557
20924,286,4750,1351,2955,81355,1795
41995,21,292,935,251,7551,41
29864,18,1045,1176,828,24975,217
32063,59,2033,1138,1490,27545,543
14261,38,1088,1461,474,13181,614
56414,1,63,616,41,4310,22
58501,151,2097,554,1587,38172,510
32161,23,1060,1136,637,25115,423
56479,409,2981,614,2559,29954,422
41390,21,523,946,446,12359,77
22527,1,86,1326,60,5687,26
25742,19,541,1261,339,15929,202
64895,61,646,350,491,7424,155
36906,245,4198,1033,3651,30267,547
36404,165,3312,1044,2700,24580,612
23110,117,4273,1316,3224,52534,1049
8719,1182,39757,1514,22270,171013,17487
38472,218,3285,990,2668,26765,617
18321,155,3865,1397,3127,49537,738
31158,31,480,1151,307,5714,173
19059,73,1582,1384,1249,22564,333
12625,8784,197138,1484,121444,668032,75694
24241,9,535,1294,367,8968,168
40497,456,5397,960,4421,69502,976
55697,4,109,636,103,15302,6
2725,2,94,1581,51,8574,43
9061,12,560,1512,337,21736,223
52458,99,1198,738,789,9951,409
37293,148,10196,1021,5717,45071,4479
19798,16,413,1371,320,9582,93
60392,54,691,490,587,11974,104
35678,1417,25104,1064,18233,183634,6871
3203,69,1614,1576,1244,104135,370
61254,1500,14734,457,11889,49702,2845
3486,56,1134,1574,774,24539,360
19508,10,408,1376,332,35320,76
4742,51,2444,1558,761,19302,1683
31986,139,2025,1139,1633,10254,392
30361,69,1763,1166,1048,17744,715
64628,1364,23956,358,23200,218169,756
56285,26,480,619,314,10697,166
61772,1,19,442,14,3569,5
19037,749,36648,1384,13207,194474,23441
26745,0,0,1239,0,8658,0
22865,4,492,1320,332,9917,160
2718,21,1360,1581,510,38553,850
49270,145,2868,827,2436,31791,432
22730,863,23024,1322,11680,132292,11344
1603,2629,84227,1590,42209,264442,42018
928,183,5986,1595,4350,28926,1636
25653,124,3253,1263,2068,31148,1185
60673,47,587,479,490,11976,97
28348,355,15905,1205,10287,135429,5618
56988,6,38,599,38,3556,0
19774,18,315,1371,226,11686,89
53392,8,143,709,134,7095,9
18813,24,1492,1388,1018,9110,474
15823,61,1748,1440,1131,32922,617
41375,1405,23144,946,18381,92951,4763
51640,14,147,764,124,6282,23
22523,362,8886,1326,6665,46484,2221
33000,5,47,1121,40,9274,7
25147,12,620,1274,380,11497,240
14525,2471,30142,1457,19874,138413,10268
16054,25,834,1436,446,10237,388
2125,9,500,1586,313,32454,187
57780,2,36,578,27,6475,9
18249,54,2148,1398,1275,19282,873
66761,9,85,299,78,4669,7
24282,8068,139540,1294,91353,377981,48187
16405,192,7726,1430,4767,38879,2959
3827,9,165,1570,120,5873,45
13404,185,6405,1474,3648,34177,2757
11686,45,2195,1495,1150,13589,1045
44587,416,7862,901,4960,97523,2902
16839,113,4414,1423,2610,71947,1804
15329,908,19671,1447,10072,149355,9599
12574,32,4567,1485,2123,19269,2444
52842,73,721,724,567,11753,154
31931,51,2574,1140,993,8905,1581
61984,2,40,435,36,2180,4
31299,24,520,1149,295,3478,225
23097,28,796,1316,543,39046,253
60371,8,185,491,173,9245,12
30969,225,6760,1154,5226,35352,1534
26177,6,424,1252,301,12273,123
62559,87,1177,417,902,9309,275
3495,8,223,1574,151,10132,72
29780,10,375,1178,248,6134,127
36121,35,924,1053,788,24984,136
1523,5,285,1591,195,8305,90
48755,203,4370,843,3263,24315,1107
39323,39,927,976,778,48145,149
57941,70,749,568,707,12629,42
37340,407,9588,1020,8110,92811,1478
15923,26,1042,1438,786,26102,256
50029,4,83,807,78,3132,5
7511,283,6083,1524,3227,49991,2856
62780,77,698,410,647,12746,51
1068,13,866,1594,522,14571,344
36955,3,37,1032,36,2623,1
58430,28,307,557,278,13311,29
53120,175,2217,715,2114,27674,103
15674,11916,476227,1442,217415,1407373,258812
50702,30,1218,790,996,9406,222
31911,45,1012,1140,575,9191,437
54101,13,74,687,49,3397,25
29305,180,3020,1187,1963,20696,1057
59194,25,234,532,198,7831,36
52721,623,6104,728,5689,32830,415
4642,108,3492,1560,2515,43697,977
56936,10,127,601,116,3385,11
6716,4,259,1534,169,14324,90
61391,8,83,454,61,2202,22
58077,302,5758,569,5077,34948,681
8384,3,75,1515,56,12811,19
52989,73,483,720,432,6239,51
37310,45,1026,1021,787,18338,239
1370,3239,97961,1592,57741,435938,40220
16614,106,2543,1427,1819,22213,724
29742,209,2636,1179,1703,21688,933
10514,20,1026,1504,608,16269,418
37607,45,966,1013,730,9792,236
69859,0,0,196,0,3568,0
26879,15,405,1236,243,5891,162
21667,157,6823,1338,4403,75111,2420
53694,54,446,701,400,9529,46
10237,7,196,1506,136,8212,60
53877,130,1664,695,1345,20921,319
40988,17,407,951,343,7946,64
25831,15,224,1260,189,9706,35
23570,51,1626,1308,1151,25675,475
54529,86,828,672,638,28095,190
43149,17,279,917,255,10216,24
50911,1,25,785,21,5543,4
49555,460,17923,819,8458,116391,9465
31422,11,311,1147,191,10230,120
49713,375,4358,805,3721,44372,637
18113,4067,201804,1400,84962,871699,116842
50173,163,1969,803,1746,21294,223
57668,53,447,582,357,10791,90
11556,21,789,1496,533,31904,256
4020,14692,401910,1568,182841,835451,219069
67372,1,12,278,11,1471,1
61830,1660,31776,440,21130,199324,10646
65175,26,418,342,325,9464,93
35449,31,469,1069,350,4154,119
49478,42,995,821,661,9230,334
23140,60,961,1315,859,41066,102
63606,27,656,390,523,10679,133
33163,77,777,1119,676,7369,101
54923,22,185,657,145,3584,40
65379,4,41,338,37,6348,4
40337,404,6681,958,5482,62466,1199
30114,0,0,1171,0,5366,0
2155,11,561,1586,309,22402,252
30720,48,1250,1159,767,20075,483
15082,5,89,1451,64,12378,25
2607,179,6362,1582,4050,53951,2312
39983,10414,224834,968,141201,1088184,83633
44807,1774,21192,898,16842,144085,4350
33976,29,1485,1104,920,38722,565
25949,192,9040,1257,5622,45548,3418
56277,57,907,619,661,15492,246
59849,17390,687502,510,221614,3130681,465888
8152,29,965,1516,683,13779,282
3174,12395,482165,1577,259046,1645304,223119
17953,18,773,1403,509,11334,264
24144,11,322,1296,161,7689,161
59314,215,7407,527,3163,35183,4244
13047,32,1485,1479,815,54911,670
60483,1,11,486,10,2944,1
40142,394,6821,965,4905,28731,1916
27697,113,3380,1218,1910,11787,1470
64692,8,142,357,84,4116,58
61628,76,1291,446,1241,17650,50
14103,31,963,1463,701,52025,262
21924,10,266,1334,192,41047,74
49323,254,2785,825,2286,40154,499
19654,3,128,1373,109,12557,19
21148,5258,134303,1347,98282,312304,36021
25410,5,153,1269,93,6614,60
39143,204,2911,978,2644,32797,267
55559,243,5222,640,4126,42768,1096
61709,34,363,444,303,6990,60
2146,17829,1141720,1586,412462,2949777,729258
63433,0,20,394,15,1752,5
18680,5,616,1391,420,14288,196
38386,10119,244056,992,140186,1057521,103870
3417,85,3760,1574,1679,36047,2081
42498,54,1220,928,784,14493,436
60890,15,130,471,125,5770,5
7760,194,17206,1520,5920,127806,11286
48179,6,46,858,38,3930,8
23512,528,29174,1309,13462,86065,15712
41659,88,5217,941,1703,17375,3514
28747,7,380,1198,310,5806,70
68243,15,106,251,90,2680,16
4001,188,7442,1568,4887,146608,2555
6732,10,265,1534,204,9847,61
35556,819,8592,1065,5906,45625,2686
9168,15,611,1512,397,8336,214
56647,66,574,609,472,7673,102
27042,100,1116,1232,552,9938,564
56992,293,3590,599,3555,46788,35
2306,79,3449,1584,2197,94456,1252
50642,88,1452,791,1167,21312,285
47356,390,6507,868,4019,56833,2488
53886,1,34,694,26,6190,8
52816,30,432,725,345,14564,87
50251,192,2552,801,1723,17415,829
30281,14,314,1168,203,7167,111
28416,172,2468,1204,1551,46434,917
24788,2,280,1282,201,7076,79
54450,129,1388,675,1204,15136,184
66616,7,90,303,81,4320,9
24810,3896,93172,1281,63262,249704,29910
48152,23,322,858,233,9664,89
4798,12,473,1558,322,12828,151
21934,68,1820,1334,879,11634,941
60768,44,723,476,573,15777,150
5825,27,1285,1545,807,20959,478
42035,91,2378,935,1477,16268,901
48429,4,223,854,175,12496,48
987,88,2336,1594,1723,21671,613
2624,302,12066,1582,4472,136230,7594
14559,6391,158933,1457,99194,457578,59739
26037,16,446,1255,282,5317,164
13492,66,1940,1472,1157,27948,783
64386,4,71,366,55,4699,16
27443,4631,97401,1224,78791,282420,18610
68498,55,1967,242,1601,26428,366
25694,60,1226,1262,676,19346,550
8939,495,8165,1513,5090,80072,3075
4834,8185,295526,1557,133476,803541,162050
49755,11,150,813,98,4129,52
13316,65,4232,1475,2253,37911,1979
13109,0,0,1478,0,14404,0
31137,60,2643,1152,1476,18435,1167
41782,22,628,939,491,23565,137
54482,52,582,674,389,5899,193
9453,42,1527,1511,809,15935,718
25349,22,834,1270,512,27694,322
6720,493,49634,1534,21635,246548,27999
6817,44,2846,1533,1288,31803,1558
58369,160,3855,559,2096,33447,1759
353,18,917,1600,634,42731,283
56202,47,720,622,521,9174,199
34309,25,542,1097,335,10497,207
13829,181,10099,1468,5259,49687,4840
51155,42,570,777,481,12364,89
24388,13,319,1291,225,13004,94
18479,4,322,1394,249,13380,73
24710,1044,91884,1283,28799,186442,63085
3477,3,147,1574,111,13823,36
24908,292,7540,1279,4794,62442,2746
42093,745,20315,933,14658,164558,5657
42872,15,361,921,298,11011,63
51054,7,76,780,70,5263,6
21638,91,1488,1338,966,15932,522
68932,4,50,227,36,2496,14
52610,118,1446,733,1211,13229,235
38045,23,467,1001,358,9187,109
35235,133,2696,1074,2345,26520,351
28501,339,9262,1202,7110,96945,2152
7342,10,261,1526,183,9528,78
21820,2,97,1336,58,14370,39
20450,3,104,1359,67,4337,37
29381,2452,57847,1186,37415,262750,20432
30583,7,407,1162,306,17359,101
28242,1,107,1207,67,6257,40
5897,12,487,1544,388,16167,99
23867,542,9200,1302,5366,73521,3834
24265,20,1217,1294,775,44499,442
58843,124,1327,543,1293,11093,34
8569,155,3481,1515,1988,28610,1493
21442,10,313,1341,216,6469,97
6033,2,116,1542,80,8542,36
54718,6,50,665,49,2891,1
14908,48,1060,1453,709,6608,351
49843,48,376,812,310,4182,66
16022,340,17437,1436,10859,72142,6578
16474,6471,244505,1429,103872,892696,140633
67225,1,114,283,95,2602,19
28649,150,3437,1199,2174,18664,1263
17189,6,207,1417,135,9932,72
35345,10,235,1071,158,6336,77
15765,192,4679,1441,3467,36967,1212
11736,10,378,1494,222,12778,156
28457,206,5118,1203,2958,44449,2160
67175,1,20,284,12,2272,8
3207,16,790,1576,552,29313,238
30324,11,302,1167,213,11630,89
30691,5,198,1159,117,7832,81
10970,24,981,1501,631,12270,350
36788,70,1401,1036,1076,28328,325
17104,42,1973,1419,1622,24216,351
54600,207,2373,669,2002,48615,371
33995,4162,87458,1103,50739,411666,36719
20455,21,630,1359,477,7977,153
11457,2,115,1497,61,10430,54
23384,984,19515,1311,10773,65764,8742
65621,19,277,332,257,7148,20
65814,461,7448,327,6618,57983,830
26348,26,747,1248,390,7633,357
6063,413,17301,1542,12848,93150,4453
25007,4,68,1277,57,8360,11
24119,22,225,1297,175,4375,50
51109,3,54,779,43,2624,11
53802,699,7676,698,5770,101322,1906
3943,92,2401,1569,1762,17141,639
5202,21,691,1552,491,26793,200
18915,104,3799,1386,2209,71868,1590
36936,18,365,1032,347,7115,18
5998,16,552,1543,418,13824,134
20137,126,3833,1364,2332,51437,1501
48541,88,1535,849,1293,32916,242
48693,18,253,845,198,4543,55
16343,117,1295,1432,914,28627,381
52717,3339,39924,728,36393,160345,3531
39705,1,41,972,23,1741,18
35066,10,245,1078,138,7195,107
16534,37,562,1428,424,14833,138
59222,3009,45523,531,42455,252895,3068
37472,2,20,1016,16,2956,4
14054,46,2867,1464,1398,24262,1469
39471,164,2910,975,2542,30072,368
67276,11,182,281,128,7091,54
40476,20,715,960,362,10743,353
51355,26,261,772,253,10237,8
56748,54,1026,604,911,27588,115
65349,7,81,338,62,5458,19
25760,23,1446,1261,551,14225,895
2319,8,353,1584,221,11591,132
10249,96,2073,1506,1339,29878,734
12133,6,281,1491,111,12215,170
29619,35,1612,1182,866,31303,746
22925,8,287,1319,207,7276,80
3183,286,7251,1576,4852,45333,2399
23173,267,8384,1315,4037,73010,4347
56486,1,8,614,7,5173,1
53025,3,42,719,30,2245,12
18250,4640,144286,1398,77618,408085,66668
25220,110,2027,1273,1446,25746,581
58243,82,741,563,692,18354,49
50788,5,155,788,98,10700,57
3662,6,159,1572,97,12013,62
16164,76,3536,1434,2448,34136,1088
6057,116,10929,1542,5896,70174,5033
32186,120,3963,1129,2476,45865,1487
54076,81,689,688,576,22801,113
558,74,2985,1598,2167,45910,818
35770,3736,64161,1062,45295,393329,18866
41607,15,393,942,293,9494,100
52797,27,264,726,147,6367,117
21791,83,1827,1336,1226,16204,601
57685,123,1817,582,1536,26695,281
38331,536,8652,994,7320,95737,1332
16539,788,37917,1428,21889,204777,16028
33539,12,284,1112,233,7865,51
24150,3,101,1296,79,5755,22
9960,1892,38573,1508,26023,116485,12550
35336,31,789,1071,563,10365,226
9577,720,20974,1510,13074,78933,7900
62517,21,410,418,404,5332,6
9073,15,804,1512,525,22496,279
56405,4,35,616,24,1987,11
184,235,13096,1602,6893,113746,6203
17310,18,389,1415,276,7727,113
37727,24,622,1009,424,10248,198
60000,71,1736,504,1287,44001,449
53509,349,5983,707,4668,75755,1315
21966,12,597,1334,281,6886,316
68435,28,561,245,479,2731,82
4013,58,1202,1568,858,29887,344
22197,229,4660,1331,2392,35196,2268
31052,196,5045,1153,3525,36816,1520
34234,991,13705,1098,9345,63061,4360
62562,38,365,417,292,10193,73
55033,45,548,654,528,6191,20
63653,16,135,389,103,6051,32
48926,58,954,837,628,27314,326
1113,159,5447,1594,3825,41318,1622
9851,228,5479,1509,3611,26300,1868
48832,2,41,840,38,2160,3
24687,45,1022,1284,801,16476,221
53298,73,900,712,775,13988,125
35377,19,343,1071,225,5490,118
31362,172,2861,1148,1936,27258,925
60216,15,298,496,246,5547,52
18873,2,55,1387,49,7954,6
65949,127,2661,324,1842,50636,819
8713,1,135,1514,79,6874,56
27693,4,154,1218,104,2833,50
2892,3,188,1579,124,8366,64
52022,626,6131,753,4980,67923,1151
36902,64,921,1033,808,13764,113
64906,5,28,350,24,5420,4
33100,9,466,1120,297,9105,169
26746,43,1549,1239,1067,23287,482
13174,95,7170,1477,2922,34699,4248
10691,21,1714,1503,986,12922,728
63775,4,131,385,98,2754,33
44406,97,1699,903,1304,30262,395
32501,19,221,1131,132,5114,89
3125,12,205,1577,146,10385,59
17864,42,1467,1404,1131,26230,336
50556,81,804,793,731,18425,73
3091,31,1082,1577,702,22806,380
38901,2113,36893,981,30471,120193,6422
38402,1288,21146,992,14512,194664,6634
53171,4689,72206,714,58138,346447,14068
45273,318,3449,893,2618,56301,831
29763,557,14281,1178,9883,144798,4398
11126,126,5200,1499,2893,24719,2307
67540,36,339,273,332,5290,7
63535,3,96,392,77,5154,19
66784,17,383,298,334,14624,49
3418,482,25848,1574,12622,178971,13226
27068,1420,29341,1232,20340,220569,9001
67150,14,397,285,319,9754,78
54707,63,459,665,377,6634,82
26502,1062,23427,1245,15208,107897,8219
54821,177,1125,661,935,12340,190
61470,11,170,451,151,6951,19
57341,48,671,590,609,11975,62
8070,713,23047,1517,12368,79816,10679
29795,84,1560,1178,1128,29523,432
24859,54,1788,1280,1181,28137,607
11687,38,491,1495,261,3775,230
59846,17,296,510,290,8769,6
58559,120,728,552,656,12185,72
35774,2773,51860,1060,25486,383625,26374
13602,96,3185,1471,2179,28612,1006
1534,19,822,1591,604,24324,218
9389,15,1046,1511,545,23436,501
40725,188,5194,957,3410,72761,1784
14336,6,132,1460,93,3324,39
6736,16,718,1534,496,11769,222
58904,37,692,541,571,14226,121
28838,13,426,1196,304,5450,122
22378,0,0,1328,0,2224,0
9232,8,404,1512,238,5751,166
9328,23,1090,1511,679,17113,411
25567,1,224,1266,145,4294,79
19637,1,47,1374,33,6099,14
3752,15,661,1571,496,9491,165
21680,27,1661,1338,759,14100,902
58931,42,725,540,499,25452,226
33964,2,136,1104,94,9226,42
46650,2103,30418,877,25666,272223,4752
49828,316,5003,812,4377,122281,626
24602,40,825,1286,529,11927,296
50008,74,915,807,635,9145,280
66297,25,357,313,318,7596,39
39104,7,105,979,84,9109,21
8717,90,2644,1514,1782,27327,862
14039,1725,79801,1464,26722,303926,53079
5261,113,1406,1551,904,15611,502
27837,5,107,1215,66,5090,41
51880,311,3740,757,3586,33033,154
53403,54,1118,709,559,19239,559
61764,127,2036,442,1466,25731,570
8760,274,9069,1514,4512,80119,4557
33241,214,3527,1117,2498,20161,1029
62462,8,113,420,96,4442,17
142,11,732,1603,520,17917,212
60111,1513,27849,501,24359,120781,3490
52358,10,235,742,144,5442,91
6840,109,5067,1532,2753,83158,2314
31292,28,416,1141,277,5319,139
19793,204,5030,1371,2769,19649,2261
19302,19,353,1379,249,14134,104
1062,13,908,1594,535,14421,373
8685,141,6962,1514,4477,42029,2485
62464,6,73,420,60,4710,13
7358,5,166,1525,115,19974,51
23583,39,828,1308,512,5336,316
52886,91,920,723,828,14662,92
61863,8,136,439,118,7370,18
62788,6,67,411,56,3068,11
35271,5,137,1073,94,7153,43
56102,68,798,625,658,18421,140
42318,294,4524,931,3723,45746,801
24890,444,8700,1279,6439,54613,2261
3020,14,1383,1578,637,51888,746
2659,6,330,1582,209,21765,121
41950,67,2369,936,1422,20420,947
49754,25,450,813,368,11417,82
66085,39,620,320,599,5437,21
28063,51,1525,1211,1001,17140,524
15189,21,450,1449,304,18644,146
23410,4,210,1311,148,11654,62
40480,1,36,960,31,4563,5
26492,15,557,1246,273,8863,284
140,2296,150554,1603,63257,569777,87297
2120,5,106,1586,68,14544,38
36912,4,191,1033,149,15062,42
3104,12568,491151,1577,193484,1670166,297667
2026,3446,164808,1587,62096,499035,102712
10404,433,15707,1505,7312,54516,8395
28114,294,6234,1210,4628,44802,1606
56564,1689,32164,611,21476,203398,10688
18864,10,418,1387,259,6710,159
4578,117,4018,1561,2130,19620,1888
3673,12,336,1572,287,31158,49
15709,50,1304,1442,852,14989,452
49852,168,2120,811,1749,20780,371
25362,116,1994,1269,892,21504,1102
41994,78,845,935,657,6550,188
57310,444,5706,591,5256,51300,450
32449,77,1444,1132,782,20741,662
16341,290,4681,1432,3719,57898,962
20118,501,9467,1365,6994,61179,2473
49157,55,1278,830,782,11393,496
34766,49,1224,1084,777,33284,447
56200,591,4980,622,4157,49544,823
16254,0,82,1433,60,2531,22
28491,2341,44844,1203,29066,253358,15778
57830,63,449,577,425,7905,24
27617,32,683,1219,441,4922,242
23276,13,205,1313,181,22067,24
14901,57,2713,1453,1442,38343,1271
41633,79,1527,941,1149,34177,378
54477,18,263,674,195,19900,68
8862,52,2813,1513,1581,27929,1232
36662,92,1503,1037,1102,16166,401
51635,233,2761,764,2377,22816,384
63612,112,1543,390,1282,10715,261
27208,10180,232293,1229,155018,530629,77275
16262,41,1221,1433,786,11296,435
35589,15,238,1065,195,2981,43
49561,427,10900,819,6312,57317,4588
16094,147,5541,1435,3998,32570,1543
14465,1015,29859,1458,21666,246651,8193
15413,12,853,1446,527,9548,326
33048,67,855,1121,568,7541,287
14630,2861,55694,1456,27397,310673,28297
69560,2,58,207,35,1272,23
18958,569,29960,1386,17674,84669,12286
48933,1610,24968,837,16948,115217,8020
61840,68,801,440,753,15117,48
3504,76,1864,1573,1535,117599,329
24595,256,8837,1286,6478,93509,2359
27620,1375,23785,1219,14424,168479,9361
31145,96,1188,1151,827,24954,361
33223,143,2642,1117,1574,34133,1068
2454,150,4551,1583,3165,43403,1386
41008,61,1188,951,947,28926,241
43210,89,3361,916,2115,37611,1246
23898,297,7799,1302,4294,31586,3505
52720,42,368,728,350,8986,18
22309,15,425,1330,313,34317,112
25271,81,1823,1271,1323,39084,500
25965,13,684,1257,407,7604,277
6856,11,204,1532,125,13391,79
13451,99,3572,1473,2146,57785,1426
10394,2947,85189,1505,47058,193815,38131
61694,80,893,445,689,10655,204
23461,52,1150,1310,796,18125,354
39075,16,344,979,236,12892,108
2033,5,351,1587,233,30435,118
113,715,61057,1603,29077,260536,31980
32603,69,2103,1129,1574,9858,529
3970,10,1026,1568,803,10786,223
13475,255,13506,1473,8408,69941,5098
34882,70,442,1083,351,13586,91
48632,50,612,846,531,38616,81
29968,696,7305,1174,4980,26763,2325
34728,33,709,1086,433,16733,276
16782,884,22438,1424,18341,135250,4097
52274,6,118,744,87,7598,31
21422,237,4570,1342,3216,18138,1354
63484,42,351,393,326,6065,25
12850,175,4690,1482,2875,29499,1815
19718,2123,38696,1372,24760,223694,13936
14151,97,2284,1463,1626,24588,658
41460,400,5224,945,4375,44262,849
34185,54,1482,1099,1089,27200,393
12303,14,836,1489,501,18144,335
59550,645,16242,520,12920,96157,3322
41020,33,446,951,342,5543,104
56897,36,458,602,403,20036,55
19688,52,1230,1373,946,46762,284
20367,408,7252,1361,4652,44543,2600
22046,61,1020,1333,694,13416,326
20100,232,4759,1365,3225,23356,1534
36895,21,301,1033,204,6447,97
58188,32,491,565,353,14441,138
36834,109,1333,1035,1152,17302,181
43421,110,1769,914,1562,24212,207
5445,14,438,1549,359,11444,79
64129,12,109,373,98,2116,11
212,152,3569,1601,2507,36635,1062
52591,39,528,733,374,11780,154
30207,139,2919,1169,1901,11862,1018
16237,745,39647,1433,18518,188504,21129
68378,16,180,247,165,3593,15
3081,71,1992,1578,1218,21377,774
32947,22,1077,1123,631,10247,446
66445,6,150,309,123,4883,27
19840,373,9219,1370,6512,92467,2707
27442,50,924,1224,612,13483,312
22337,499,8826,1329,5850,97188,2976
44661,20,374,900,296,12464,78
30393,779,10069,1165,6814,66986,3255
41277,23,525,947,455,14373,70
47055,2,41,780,31,4155,10
14571,1,99,1457,72,11022,27
54430,13,260,676,159,8248,101
19,192492,4907703,1605,1857915,12397783,3049788
5533,75,2364,1548,1281,57729,1083
3164,16,1016,1577,761,33553,255
34369,43,855,1095,587,4442,268
17289,1254,28526,1415,19046,245339,9480
50312,93,1445,799,1396,25398,49
59247,142,2393,530,1782,16881,611
6722,19,770,1534,474,56658,296
53865,23,307,695,228,10914,79
67341,15,279,279,266,6085,13
22038,47,1454,1333,995,17220,459
48025,285,8058,860,2386,30046,5672
47357,8,86,868,82,4289,4
22563,24,377,1325,293,9640,84
41651,4,232,941,141,4411,91
48195,4842,80284,832,49189,262327,31095
5094,16,789,1554,602,19813,187
29980,6,775,1174,422,9456,353
45538,925,22907,890,16250,173483,6657
36353,28,587,1046,482,8691,105
66143,11,103,317,100,6955,3
23586,0,118,1308,87,5885,31
15063,2,390,1451,294,26169,96
58200,68,1377,565,1007,15318,370
38256,16,443,996,357,6588,86
67477,12,127,275,104,4148,23
22785,0,0,1321,0,15099,0
12188,118,3497,1490,2067,41177,1430
28070,79,1262,1211,936,19239,326
68790,10,99,232,95,3369,4
40245,5782,192080,963,153143,575466,38937
36047,5111,120125,1050,78939,734483,41186
61860,24,467,439,317,7038,150
23439,42,2706,1310,1509,47345,1197
21409,0,0,1342,0,5849,0
34140,11,240,1100,157,2848,83
7149,9,528,1528,334,16807,194
31047,282,7824,1153,3322,62198,4502
53813,190,1405,697,1336,24091,69
69775,6,98,199,85,2991,13
57597,8,104,584,92,10266,12
49294,597,7287,826,5951,71234,1336
26425,2,99,1247,41,4846,58
16373,14,857,1431,564,34495,293
4688,539,15258,1559,11192,105602,4066
16521,625,15446,1429,11136,77282,4310
3635,171,3793,1572,2712,25453,1081
29979,8132,152520,1174,86685,510668,65835
42624,55,1045,925,918,29243,127
28739,64,2050,1198,1211,23806,839
16006,128,2401,1437,1449,23530,952
2590,131,3465,1582,1512,13728,1953
32339,1072,32009,1134,10774,194093,21235
14762,29,2381,1455,1479,23234,902
15939,0,121,1438,94,12420,27
16102,9,499,1435,337,12784,162
302,78,6042,1600,3813,33277,2229
42113,33,619,933,455,15532,164
55252,42,759,648,455,17370,304
29541,131,2136,1183,1722,9792,414
7752,315,15052,1520,7855,88810,7197
3408,11,225,1574,120,7710,105
6002,11186,580564,1543,287019,2293467,293545
26606,38,819,1242,464,7038,355
6025,16,1119,1543,638,31606,481
39280,24,792,975,641,23139,151
50175,13,136,803,132,11020,4
58555,419,3093,552,2720,19073,373
32818,33,681,1124,556,13653,125
59305,3172,90539,528,63143,483608,27396
11517,511,19583,1496,10234,137584,9349
31813,6388,211055,1141,81775,949639,129280
2737,123,3242,1581,1712,24639,1530
62162,9,148,428,125,8312,23
26835,885,18214,1237,13445,184662,4769
10610,282,10050,1504,5572,99774,4478
35827,779,14438,1060,7072,164746,7366
38385,58,1014,992,899,22316,115
49710,3724,60550,815,36385,221629,24165
51673,68,880,763,605,12621,275
23238,64,2310,1314,1549,22014,761
20056,317,1700,1366,1124,14932,576
49823,43,433,812,401,6408,32
61966,40,292,435,261,3864,31
62846,18,447,409,319,3629,128
19010,34,3327,1385,2005,18767,1322
33651,5,171,1107,103,4742,68
1087,120,4112,1594,2885,70362,1227
30140,38,919,1170,844,58989,75
36983,10,187,1030,150,7751,37
39,119,6477,1604,4023,103064,2454
24751,124,5036,1282,2149,29723,2887
21784,82,3575,1336,2197,27790,1378
13575,24,1076,1471,700,13960,376
54870,28,175,659,142,7641,33
40508,9,319,960,234,11524,85
64097,417,8359,374,6643,52111,1716
49534,32,986,820,738,22871,248
28200,214,7647,1208,4580,49741,3067
19653,48,3477,1373,1892,30401,1585
11554,574,50809,1496,23164,158145,27645
616,99,2774,1597,2107,33168,667
43171,49,608,916,473,7974,135
2469,33,897,1583,596,16352,301
37955,1284,45749,1004,19817,113844,25932
30367,21,400,1166,253,7643,147
12465,52,1916,1486,891,23966,1025
9432,28,978,1511,631,21271,347
49085,79,800,832,616,11320,184
40174,296,7245,965,6114,46300,1131
43941,12,191,908,153,6880,38
225,3322,158166,1601,76926,397424,81240
48617,16,208,847,138,5516,70
59732,21,156,513,138,3189,18
2168,22,525,1586,386,18998,139
17909,20,238,1403,163,3974,75
63267,7,56,399,50,2619,6
11348,13,803,1498,469,16569,334
12111,340,16855,1491,6836,174179,10019
33426,15,532,1114,375,33694,157
42520,11,347,928,267,12953,80
15115,4,103,1450,74,12059,29
5067,50,1222,1554,844,19246,378
32918,137,1417,1123,995,17531,422
9991,36,1121,1507,736,12594,385
35861,39,536,1060,443,4141,93
22134,6226,126421,1332,76738,453622,49683
34876,42,756,1083,480,12645,276
41911,212,3098,937,2356,31938,742
16119,4,106,1435,84,10830,22
50315,32,478,799,412,13921,66
69574,901,20797,206,17437,145959,3360
26660,1598,25286,1240,16044,164688,9242
60454,462,5984,488,5607,58964,377
50890,18,161,785,146,6366,15
25273,0,676,1271,518,8656,158
10581,8,364,1504,206,11586,158
27076,92,2437,1232,1492,20295,945
60758,19,368,476,243,6386,125
15683,0,86,1442,61,4544,25
2501,9,308,1583,212,15891,96
29573,221,7324,1182,5557,109978,1767
31482,317,4888,1147,3746,39811,1142
18071,12,497,1401,299,7750,198
40629,60,719,958,635,13191,84
56331,323,4192,618,3410,32996,782
23454,164,5709,1310,3913,33742,1796
28136,13,239,1209,165,5050,74
68536,0,56,241,50,8151,6
12868,66,5034,1481,2452,39762,2582
52806,80,1409,726,1097,18980,312
69331,40,380,213,342,4555,38
13123,0,82,1478,30,3923,52
55396,291,3468,644,2653,36584,815
17063,11,922,1420,615,32468,307
24386,62,1187,1291,776,11375,411
42726,254,3893,921,3488,56558,405
24277,8,134,1294,122,19833,12
62613,48,548,389,542,12643,6
26811,669,16621,1238,11084,163981,5537
67348,7,89,279,59,2843,30
28996,574,13591,1193,7644,65224,5947
38361,4817,72121,993,53270,180731,18851
16821,45,1987,1424,1178,39445,809
53908,323,10965,694,6176,49272,4789
20716,8,214,1355,176,14842,38
66807,1,29,297,29,2433,0
30203,25,803,1169,601,6512,202
20675,15,931,1356,594,20910,337
58007,20,97,571,74,6873,23
12599,49,1916,1485,873,10800,1043
53945,138,1942,693,1513,13871,429
35469,12,383,1068,243,7117,140
62460,18,175,420,162,4606,13
49704,184,3062,815,2865,35306,197
68392,19,127,246,89,6014,38
20430,10,362,1360,284,11957,78
8500,23,888,1515,545,10166,343
7742,288,14622,1520,7390,188705,7232
7057,40,3330,1529,1931,49103,1399
17163,1128,26669,1418,10785,168616,15884
20626,8,225,1356,170,10632,55
4587,34,1296,1560,729,14888,567
29299,10,384,1187,259,9611,125
56579,5,81,611,65,6514,16
15240,15,647,1449,500,18329,147
23114,554,9770,1316,7124,84621,2646
47777,169,2683,862,1792,34780,891
10481,519,11302,1504,7943,33039,3359
9503,323,8971,1510,5523,72283,3448
26906,159,3036,1236,1879,53517,1157
25652,100,2922,1263,1521,28582,1401
3539,22,428,1573,333,10634,95
67462,8,77,276,64,2862,13
13892,85,4227,1467,2553,22802,1674
5177,203,10161,1553,4881,128711,5280
21180,12,366,1346,245,24896,121
37166,98,1502,1025,1299,36393,203
30327,80,2345,1167,826,16245,1519
14472,125,2848,1458,1864,23600,984
38154,9,183,998,147,8770,36
34561,44,1862,1091,1173,12239,689
65702,10,116,329,109,4860,7
18609,4,134,1392,111,12214,23
5089,63,1105,1554,663,31765,442
35137,38,880,1077,682,17647,198
16327,40,2002,1432,1446,31927,556
4605,223,5330,1560,3724,45019,1606
25499,415,14276,1267,5988,83111,8288
40705,904,17405,957,14973,128620,2432
63317,182,6507,397,1896,33500,4611
54049,34,445,689,356,4838,89
35618,205,3733,1062,2733,37287,1000
69595,26,580,204,467,13659,113
11137,51,1454,1499,706,27056,748
4081,1367,45014,1567,23272,292016,21742
48804,40,511,841,445,11287,66
18387,6,312,1395,233,9139,79
8991,14,404,1513,274,27209,130
5171,42,3896,1553,2171,29887,1725
25654,4927,100372,1263,51779,451211,48593
2753,110,4647,1581,2497,30119,2150
52905,488,9548,722,6803,109221,2745
30491,15,433,1163,189,4784,244
35,671,25036,1605,17545,127317,7491
40073,42,730,966,651,8720,79
39220,47,761,978,661,13436,100
3255,86,1712,1576,1003,43906,709
35494,113,1853,1066,1137,18707,716
35048,1423,30867,1079,20368,267941,10499
8182,1371,42741,1516,26521,147641,16220
68523,0,11,241,8,1857,3
52169,22,402,748,286,10830,116
1830,42,1160,1588,833,32589,327
31240,129,7919,1150,4758,45355,3161
47288,4,38,869,33,5089,5
56313,23,364,618,259,7751,105
29281,147,5784,1187,3494,42601,2290
18925,62,2254,1386,1319,16321,935
37817,11,658,1007,516,14990,142
17018,902,16783,1420,11358,133286,5425
33463,3,185,1113,118,5971,67
9677,15,540,1510,332,33674,208
2655,74,2531,1582,1726,26528,805
8956,30,822,1513,629,7756,193
62274,9,183,425,152,5974,31
17603,24,882,1410,667,28569,215
57867,126,5600,575,1641,24985,3959
21607,148,4492,1339,3100,20993,1392
8015,110,3479,1517,2367,32804,1112
15042,64,1403,1451,1107,73568,296
20097,12,355,1365,258,11242,97
55633,25,472,638,336,17924,136
21274,402,10979,1344,7336,59910,3643
25689,156,1645,1262,1301,22541,344
60776,6,52,473,36,3071,16
54236,68,553,683,486,6786,67
13627,40,1285,1470,813,56374,472
35866,3,105,1059,72,3929,33
12032,34,1198,1491,663,22434,535
44381,53,1185,903,1050,22689,135
65161,7,50,343,42,2107,8
33349,71,2946,1113,1676,38239,1270
56143,13,169,624,118,9148,51
29951,41,926,1174,670,13796,256
25126,7,198,1274,181,11153,17
26840,1056,33920,1237,15820,248262,18100
22114,35,1169,1332,853,18588,316
20110,22,697,1365,539,14275,158
44430,265,3761,902,3357,55815,404
24625,70,1479,1285,949,19210,530
46708,71,888,876,732,22647,156
26838,1362,34427,1237,22729,185943,11698
9171,23,821,1512,523,12342,298
57227,17,304,593,284,8509,20
10256,161,6369,1506,2887,68442,3482
3542,1404,70362,1573,33328,322450,37034
37306,23,591,1021,452,14083,139
9518,9,246,1510,175,8566,71
51555,21,325,767,212,11404,113
49156,20,279,831,220,5662,59
10857,53,2326,1502,861,19239,1465
8069,28,725,1517,422,10078,303
49005,52,785,835,638,6366,147
27381,531,13475,1225,11284,30667,2191
7066,0,0,1529,0,4521,0
53024,457,6900,719,6898,32148,2
33812,363,4595,1107,3681,46704,914
49509,41,830,819,578,9482,252
61230,19,135,458,131,3844,4
61198,48,833,460,698,24541,135
62849,83,1081,409,827,11142,254
52909,771,10420,722,9768,55526,652
5417,175,7159,1550,3732,97768,3427
65966,2,47,323,27,4463,20
20053,1,51,1366,36,8353,15
30718,131,4498,1159,2586,41273,1912
51404,583,5249,771,4464,26958,785
10345,716,16712,1505,8866,95811,7846
52385,1,73,741,41,2521,32
33953,23,586,1104,389,13865,197
23789,174,2820,1304,1977,14346,843
9064,716,22564,1512,11250,163796,11314
34440,7,228,1093,166,7774,62
51345,92,982,772,775,26409,207
7709,16,624,1521,386,36112,238
10985,6,222,1501,132,6124,90
33353,232,4730,1115,2783,20740,1947
20075,15,438,1366,270,11365,168
12817,111,2612,1482,1393,23568,1219
7825,21,1766,1519,932,21038,834
16322,45,2536,1432,1754,34630,782
6463,381,5241,1537,3160,52077,2081
6369,7,177,1539,131,6414,46
7581,119,2225,1523,1484,35138,741
67723,13,157,268,150,7858,7
8438,12,355,1515,252,6074,103
21158,62,1561,1346,1144,20964,417
62686,33,573,413,392,8562,181
24718,87,1504,1283,1042,8679,462
23446,17,617,1310,461,11026,156
46571,32,366,878,327,8279,39
57861,1503,50682,575,22490,216345,28192
18564,5,112,1393,65,7598,47
19136,12,297,1382,189,19336,108
19311,119,4648,1379,3035,60158,1613
10134,35,913,1507,620,12625,293
14492,96,3067,1458,1940,75329,1127
3364,38,1806,1575,967,27925,839
52722,2,15,728,14,2379,1
64157,14,122,372,111,6859,11
19083,8,632,1383,417,20853,215
11582,554,21090,1496,13297,98544,7793
6178,1898,77594,1541,38354,196286,39240
1628,1317,63997,1590,25367,127659,38630
58067,0,0,535,0,4113,0
37804,28,460,1007,369,7361,91
12121,211,10898,1491,5677,58446,5221
1430,375,15325,1591,7570,69107,7755
54183,48,441,685,404,16863,37
28460,57,1048,1203,641,10944,407
60720,2857,35414,477,31656,125938,3758
30664,10,388,1160,254,15991,134
29824,3616,80828,1177,57105,298302,23723
20957,1,71,1350,63,6487,8
26441,74,1190,1246,1031,40970,159
65252,21,347,341,254,4691,93
9617,9,226,1510,155,9895,71
25145,47,587,1274,499,14373,88
31002,1919,35774,1154,24138,232378,11636
36372,290,4434,1045,2494,56052,1940
7507,91,2085,1524,953,15794,1132
59925,2621,56514,506,30581,293426,25933
46819,0,114,875,86,5410,28
5291,11,267,1551,185,11582,82
15361,24,521,1447,370,24867,151
1223,39,1360,1593,864,40157,496
50353,24,355,798,290,7978,65
14601,272,7723,1457,5670,50944,2053
63304,124,1835,398,1216,19956,619
39263,34,384,977,328,15399,56
28367,28,600,1205,419,19741,181
30837,850,15492,1157,10704,53293,4788
19215,31,821,1381,494,14440,327
67801,8,91,265,85,2470,6
50734,367,6856,789,5950,29440,906
33600,205,4415,1110,2587,45483,1828
65996,8,77,322,40,6490,37
32207,401,9806,1136,6522,104549,3284
32854,125,2282,1124,1834,18004,448
52364,396,4722,710,4169,33179,553
20374,424,8675,1361,5755,77608,2920
12511,12,198,1486,102,6377,96
23792,14,393,1304,271,5532,122
62138,239,4714,429,4603,61743,111
19206,577,17967,1381,12238,135396,5729
27589,19,865,1220,525,11325,340
5311,278,5038,1551,3447,58821,1591
5484,45,1539,1549,996,18339,543
52723,110,1078,728,917,16586,161
63189,46,929,401,517,9514,412
21686,356,8408,1338,6030,66506,2378
15666,743,20369,1442,12329,170171,8040
33083,12,533,1120,384,14329,149
33543,12,279,1112,213,5912,66
17999,11,279,1402,204,4801,75
60198,19,490,497,446,15487,44
24390,1733,81790,1291,29243,377303,52547
26956,391,7255,1234,3891,30860,3364
56703,6,212,607,199,9041,13
15243,237,4965,1449,3552,112851,1413
62265,9,149,425,102,8740,47
63199,314,3191,401,2868,33836,323
61672,110,1543,445,1272,19981,271
54246,1079,11609,682,8838,75580,2771
13296,41,2374,1476,1188,29952,1186
9974,165,3846,1508,2347,28233,1499
4010,161,8127,1568,3491,60771,4636
59619,187,1768,517,1447,13961,321
34437,159,3406,1094,2526,51425,880
24326,212,2849,1292,2080,11537,769
39816,102,2031,970,1331,21730,700
59377,20,263,525,227,10488,36
11177,413,18352,1499,11338,46094,7014
52955,30,714,721,362,6966,352
18946,36,510,1386,373,8849,137
1466,127,3317,1591,2342,21571,975
9211,14,749,1512,452,15719,297
23149,128,1664,1315,1252,15670,412
52216,332,2486,747,2244,27929,242
16449,577,17967,1429,11151,107706,6816
46429,30,1200,880,614,16516,586
57782,66,980,578,618,17188,362
39235,6,152,977,121,5101,31
30373,2,252,1166,156,5225,96
18382,19,709,1396,512,8448,197
26655,39,581,1241,410,8555,171
16314,0,56,1432,36,7113,20
8886,81,2565,1513,1609,17654,956
60304,61,1395,493,1365,18426,30
13286,3480,175941,1476,42685,469576,133256
36938,637,12454,1032,8472,123400,3982
51869,1792,20552,757,19270,84868,1282
18184,13,563,1399,433,15469,130
29657,104,1821,1181,954,13171,867
62017,265,4886,433,3305,40128,1581
34175,6,200,1099,125,2483,75
56255,8,97,620,80,3450,17
53803,63,1265,698,472,9051,793
62391,11,244,421,171,15563,73
16890,77,2344,1423,1662,28823,682
32082,9,210,1137,140,4586,70
24094,218,3606,1297,2592,34152,1014
34474,102,1478,1093,565,11670,913
28201,12,313,1208,181,6814,132
68205,5,116,252,90,2377,26
26510,289,6537,1245,4485,70482,2052
36879,284,5876,1034,3067,31866,2809
4472,56,2385,1562,1485,16864,900
25355,7,270,1270,178,7869,92
57813,50,649,577,587,19033,62
36267,5,45,1048,40,3611,5
21019,9,490,1349,417,19589,73
49855,15,264,811,241,12630,23
24741,37,1452,1283,967,35225,485
11265,56,2337,1499,1170,23859,1167
54397,103,1431,677,1269,22879,162
520,177,10085,1598,6690,180649,3395
929,88,3420,1595,2406,94799,1014
4550,194,4791,1561,3111,75539,1680
21834,408,4735,1336,2736,21969,1999
49995,178,2497,808,1965,20761,532
3807,68,3941,1570,2403,43254,1538
23180,41,878,1314,640,17770,238
51548,98,1206,767,991,20183,215
10148,1,102,1507,67,4864,35
27802,29,1715,1216,1125,32839,590
15267,27,1319,1448,953,19432,366
29747,35,1074,1179,575,11467,499
34358,26,605,1095,419,10781,186
54594,12,86,669,78,4140,8
40370,4,47,962,45,2923,2
61217,98,1885,459,1565,37924,320
18923,127,1889,1386,1224,20121,665
16057,25,894,1436,696,32150,198
12456,24,789,1487,448,8844,341
3771,91,9537,1571,6082,46952,3455
33284,34,589,1116,435,8644,154
2530,24,1082,1583,678,22173,404
875,6,578,1595,431,16618,147
1497,226,3345,1591,2075,15779,1270
42634,13,146,925,103,7925,43
54271,60,997,681,832,21365,165
70447,261,6755,176,6644,46995,111
25037,172,8332,1276,5012,52272,3320
26227,22,406,1251,333,31251,73
9070,411,9574,1512,5548,117454,4026
14031,422,7641,1465,5297,131629,2344
41298,133,2110,947,1646,22640,464
36497,9428,206746,1041,127844,1210486,78902
52285,10,175,744,128,14368,47
29869,54,1123,1176,802,26180,321
50370,522,9044,798,7481,59076,1563
5729,618,26272,1546,12849,98775,13423
22738,30,727,1322,540,6416,187
28763,32,944,1198,665,21146,279
34324,38,1112,1096,832,23713,280
4357,491,14022,1564,9542,90158,4480
49316,13,172,825,142,6636,30
35893,564,7540,1059,6542,83234,998
23669,52,869,1306,662,24157,207
30686,33,537,1159,369,6823,168
20958,27,1490,1350,971,39743,519
23770,904,17776,1304,10935,66797,6841
44069,59,953,907,897,30079,56
41076,38254,1156796,950,608320,2702826,548476
19888,35,468,1369,384,15406,84
33687,1,14,1109,14,3195,0
36318,1070,30768,1046,20194,108637,10574
3155,229,12634,1577,7075,46773,5559
19632,234,5411,1374,4059,71948,1352
15160,776,18716,1450,12383,207774,6333
50399,126,1670,795,1075,24143,595
53079,22,327,717,263,11733,64
6535,355,9514,1536,6391,155179,3123
13175,150,11449,1477,5409,68610,6040
50293,5,70,800,46,3014,24
19009,706,21009,1385,15584,167433,5425
31162,35,1501,1151,903,25633,598
40410,216,3288,961,2777,19594,511
64901,11,107,350,101,4654,6
40299,44,815,963,666,12550,149
32005,44,1209,1138,859,5872,350
48592,2,71,847,59,6782,12
22594,31,691,1325,599,26841,92
53899,8,213,694,167,6207,46
5650,34,1458,1547,852,20606,606
22003,8,683,1333,463,22534,220
14213,180,3440,1462,2530,44326,910
56596,9,193,609,148,10862,45
6015,152,12231,1543,2712,88665,9519
65552,10,73,334,63,1625,10
54793,1019,12465,662,10906,171971,1559
45011,67,1044,896,826,12004,218
46937,967,14315,873,12635,118186,1680
29179,118,3011,1189,1583,24803,1428
13006,7,310,1479,170,10911,140
13114,6,348,1478,204,15326,144
19025,9,176,1384,132,13651,44
28943,5,315,1194,195,6903,120
56384,14,202,617,171,6289,31
15180,60,3276,1449,2025,75278,1251
429,13,626,1599,511,10541,115
55627,426,9008,638,7622,82797,1386
54797,6,93,662,61,7374,32
55908,198,3681,631,2540,35097,1141
13809,0,0,1468,0,20667,0
2459,406,10861,1583,6696,107218,4165
20200,62,2379,1364,1670,29389,709
3806,392,24673,1570,10851,174363,13822
34153,14,243,1099,214,8351,29
2814,2980,71445,1580,42082,190424,29363
37099,4,72,1027,67,4497,5
65163,1060,3619,343,2680,280799,939
7038,36,1036,1530,713,27162,323
33713,1150,29289,1108,18997,78831,10292
60373,41,729,457,590,6373,139
52299,108,872,743,722,16096,150
43721,92,799,910,588,10916,211
25916,170,4761,1258,3285,65481,1476
30299,406,9739,1167,6738,115883,3001
19387,30,717,1378,573,21485,144
62801,829,18450,410,9451,79351,8999
24955,193,3603,1278,2624,37255,979
29668,48,2026,1181,1216,51771,810
3628,113,4922,1572,2910,31162,2012
31599,23,290,1145,228,4868,62
30611,523,12791,1161,9593,104036,3198
3540,7,389,1573,308,15955,81
37742,189,3456,1009,2509,54328,947
27736,187,5464,1217,2632,16390,2832
12778,25,608,1483,318,8883,290
9379,0,0,1511,0,5642,0
41617,43,537,942,436,13791,101
15405,4,171,1446,125,5872,46
10376,109,3607,1505,2253,57093,1354
61429,327,5841,452,4146,80023,1695
32652,6,409,1128,283,17910,126
54846,82,597,660,485,11886,112
24351,2051,47909,1292,32865,234492,15044
40374,27,320,962,299,8763,21
34026,58,1690,1102,1126,23547,564
40899,2817,71881,953,40636,377923,31245
59632,83,592,517,523,11909,69
1656,18,934,1590,690,25768,244
4794,97,1641,1558,1206,21612,435
56177,21,422,622,215,6742,207
54321,12,328,680,228,3748,100
23111,12,200,1316,156,6572,44
37228,64,832,1023,817,9727,15
26841,224,4125,1237,3285,47476,840
51480,85,1595,769,1533,79109,62
25911,49,1399,1258,874,27161,525
9955,88,2932,1508,2416,15865,516
34784,38,1244,1085,697,17203,547
18292,21,818,1397,547,22812,271
18788,150,4477,1389,3162,24547,1315
62540,35,315,417,277,12746,38
27754,94,1189,1217,879,15719,310
22438,591,28021,1328,8855,137345,19166
51684,0,21,763,18,3016,3
4572,128,3569,1561,2576,41157,993
2251,213,5042,1585,2315,43493,2727
55524,1291,20971,641,20120,105452,851
4623,5,298,1560,199,14160,99
14365,245,8096,1460,4661,42183,3435
6660,255,4672,1535,3702,94605,970
10973,7,639,1501,393,20333,246
35810,40,767,1061,589,8650,178
10599,145,5411,1504,3639,58456,1772
9658,17,621,1510,397,10583,224
58896,43,610,541,418,7605,192
53095,206,3024,717,2616,32064,408
33215,136,4196,1118,1970,27573,2226
22338,90,1765,1329,987,16900,778
26845,20,476,1237,413,34091,63
31493,64,1797,1146,1339,18343,458
15684,2,73,1442,54,3332,19
9522,15,459,1510,280,13219,179
58230,34,530,563,434,16717,96
55471,0,30,642,20,1983,10
41494,7,281,944,174,14248,107
17390,0,33,1414,27,5163,6
43161,335,5820,917,4481,67208,1339
18899,25,1398,1387,856,20986,542
1953,96,2502,1587,1570,18420,932
5549,3,236,1548,169,28939,67
16785,38,1164,1424,894,18179,270
13053,31,851,1478,525,9263,326
16610,1,47,1427,39,7111,8
14962,25,906,1452,496,6088,410
46915,3675,62838,874,46605,267729,16233
3105,94,4704,1577,3394,84376,1310
54508,73,916,673,603,14569,313
34075,94,1606,1101,1152,12788,454
27601,250,5668,1220,3972,46268,1696
16843,26,748,1423,535,17052,213
60970,9,142,468,94,8394,48
60892,0,27,471,24,3729,3
65423,13,77,337,53,3108,24
15146,278,7358,1450,5621,43946,1737
51100,98,1491,779,1117,31101,374
5297,82,1790,1551,1131,18307,659
28291,8,272,1206,181,8378,91
18621,0,0,1392,0,13237,0
30561,15,251,1162,180,7054,71
24155,24,842,1296,672,19818,170
16696,21,1083,1426,698,16820,385
34303,13,349,1096,282,8454,67
53293,5,20,712,20,2848,0
54449,58,516,675,274,16982,242
1284,4,133,1592,88,23952,45
8412,221,4139,1515,2285,33869,1854
29638,6,135,1181,111,10576,24
52143,32,319,749,261,3027,58
10200,50,1141,1506,751,40803,390
61925,14,175,437,153,4491,22
49671,0,44,816,28,2057,16
48896,23,229,838,201,8692,28
55759,53,1030,635,413,8960,617
4438,364,9014,1563,4793,40662,4221
14824,76,1470,1454,1093,48796,377
6950,3626,112657,1531,56026,226537,56631
61881,37,365,438,298,6571,67
51045,270,3977,781,3509,76545,468
6425,276,6407,1538,4518,70494,1889
16602,52,2626,1428,1940,47065,686
17072,236,4904,1419,3344,46046,1560
32324,10,235,1134,171,8036,64
25042,8,358,1276,225,8618,133
42380,710,10324,930,9057,125563,1267
543,4,186,1598,105,10336,81
51158,22,426,777,340,32002,86
10063,0,0,1507,0,7550,0
35524,365,15693,1067,10766,64643,4927
2248,119,7348,1585,4655,73810,2693
48524,39,433,850,386,9469,47
63276,264,5351,398,3886,71603,1465
38369,8,92,993,65,3362,27
31933,26,647,1140,417,7149,230
46820,41,1330,875,1219,36157,111
5780,64,2150,1546,1328,27269,822
22132,1814,33264,1332,23590,115663,9674
34318,150,2774,1096,1778,36237,996
8720,4211,139877,1514,66857,856274,73020
48261,3,187,856,110,7513,77
32971,32,755,1122,443,6389,312
15458,29,756,1445,567,39492,189
44338,393,4926,903,4571,71061,355
24132,15,809,1297,434,10381,375
21776,409,8366,1336,5601,161838,2765
27353,143,4169,1226,2673,34449,1496
587,227,7705,1598,5299,90978,2406
51228,14,125,776,125,3339,0
17311,19,626,1415,514,14188,112
13754,29,990,1469,592,19160,398
32046,38,1744,1138,991,25716,753
24531,179,5685,1288,3099,36061,2586
57985,3,49,572,41,5734,8
19185,3,53,1382,44,5722,9
38491,8611,191842,989,121015,685407,70827
61325,53,551,456,517,11249,34
18392,240,4755,1395,3027,63222,1728
26748,126,3137,1239,2051,35283,1086
19409,240,6012,1377,4113,60271,1899
40418,18,273,961,244,6441,29
16928,24,562,1422,401,11473,161
39718,1344,24653,972,17537,144737,7116
55111,15,162,652,128,7724,34
9315,173,3420,1511,2474,37118,946
54816,172,2109,661,1609,26118,500
35654,15,513,1065,338,3966,175
18783,8,197,1389,161,5461,36
28219,21,424,1208,270,15077,154
33189,6,191,1118,119,10474,72
15802,46,798,1440,518,12623,280
47316,6,175,868,150,6513,25
44922,2477,64818,896,34449,356762,30369
30841,6,289,1156,169,4610,120
64405,2,24,365,21,2394,3
53604,72,1529,704,1180,28926,349
152,498,5319,1602,4015,31735,1304
16390,24,1049,1430,584,33623,465
15775,15772,358280,1441,210746,1660622,147534
59509,6,75,521,28,4814,47
12038,41,1666,1491,883,50562,783
9314,61,1108,1511,676,20761,432
29061,291,7621,1192,4479,77476,3142
18180,2366,47919,1399,31039,159734,16880
30356,47,1272,1166,713,7588,559
15425,4906,146459,1446,83877,1004408,62582
22732,1173,23435,1322,16322,132922,7113
21509,22,693,1340,417,13309,276
34384,578,10741,1095,7279,90773,3462
50226,59,873,802,759,18760,114
155,808,38807,1602,24416,169344,14391
49529,24,357,820,343,11633,14
35057,81,1523,1079,1005,28606,518
25638,10,472,1264,297,29857,175
32541,72,3441,1129,2289,41948,1152
30530,167,4147,1162,2616,34778,1531
12914,24,1053,1481,717,18522,336
58162,223,3469,566,2998,55617,471
5702,108,2829,1547,1955,35470,874
23137,147,3021,1315,1960,32829,1061
59371,13,248,526,161,4640,87
56181,11,133,622,85,5763,48
911,25,1562,1595,1195,59438,367
31035,24,842,1153,576,10793,266
8725,497,10704,1514,6985,35219,3719
7803,2,168,1519,67,7751,101
11332,39,835,1498,528,11103,307
19642,56,2477,1374,1598,107418,879
62489,394,8793,419,5334,106117,3459
14581,98,4871,1457,3283,87590,1588
48857,3,73,840,62,4706,11
29560,322,9260,1183,6347,74267,2913
57299,47,644,591,535,11880,109
39980,13,300,968,191,7651,109
26832,28,417,1237,349,9534,68
19416,585,14808,1377,8595,134314,6213
3175,32,1548,1576,771,15023,777
13757,53,1240,1469,712,22631,528
64641,16,257,358,212,8190,45
37252,29,423,1022,289,4525,134
21870,88,1251,1335,616,16334,635
1340,22,950,1592,697,8249,253
61063,4,106,464,95,5034,11
54409,16,177,677,114,5266,63
48748,231,3819,843,2897,30168,922
55416,24,251,644,207,6105,44
55410,17,255,644,180,3383,75
45224,6,110,894,87,2889,23
31783,70,1868,1142,1090,15029,778
26359,10708,342549,1248,96728,695199,245821
44631,801,7941,900,5303,117118,2638
17602,876,45631,1410,22193,109792,23438
53661,19,264,702,233,7807,31
17551,36,1588,1411,821,11043,767
67072,61,1070,288,1014,25722,56
23473,3,133,1310,96,4808,37
5902,131,4206,1544,2945,41843,1261
6594,5764,128086,1535,70348,390945,57738
70267,19,229,183,219,2184,10
4679,1147,23447,1559,15511,103277,7936
20573,305,7923,1357,4657,55254,3266
37261,471,7979,1021,7337,126888,642
725,66,3788,1597,2099,28787,1689
23452,25,574,1310,417,15196,157
34526,183,2198,1092,1645,20100,553
60199,10,245,497,228,13583,17
58535,17,103,553,88,5895,15
63651,98,1126,389,1073,24186,53
60822,101,1723,474,1196,8597,527
10166,1093,26911,1507,14651,106323,12260
51227,13,199,776,159,5043,40
65861,6,156,326,132,8323,24
37450,2497,56000,1017,25523,346133,30477
27772,26,827,1217,452,10497,375
16644,145,7030,1427,4275,19230,2755
15171,1,138,1450,70,5362,68
33395,7599,165520,1114,90396,641178,75124
55353,171,2637,645,2404,31818,233
33502,2689,58451,1112,32620,185584,25831
50330,6,90,799,72,6066,18
10261,308,11287,1506,7112,72191,4175
29468,167,4142,1184,2847,40918,1295
13905,1328,37771,1467,23348,128151,14423
23952,17,622,1301,377,7532,245
18340,5185,88178,1397,51382,370262,36796
4817,28865,713985,1557,342417,1674159,371568
6624,5,215,1535,154,21023,61
63156,14,183,401,159,3651,24
33446,56,1520,1113,1172,12175,348
12633,59,2405,1484,1465,27884,940
21658,9,479,1338,273,10965,206
23217,10,751,1314,434,10004,317
1638,216,5817,1590,4099,25253,1718
4950,202,5708,1556,3991,53777,1717
47110,49,1088,871,967,18303,121
34135,21,299,1100,208,4194,91
57204,0,271,594,237,7567,34
67670,10,158,269,114,6785,44
61210,6,120,459,84,10183,36
62114,25,233,430,221,2660,12
33486,30,871,1113,441,8502,430
12718,166,4817,1483,2578,50790,2239
12235,1702,27667,1489,18305,112932,9362
815,51,1474,1596,921,48437,553
69362,29,306,212,269,7481,37
14822,8,336,1454,173,19686,163
809,596,17232,1596,10554,74397,6678
55993,103,1486,628,1158,21248,328
36944,258,7086,1032,5832,75833,1254
61165,28,715,461,593,8285,122
29984,16,607,1174,487,4826,120
50285,99,1782,800,1533,40550,249
8195,1125,23211,1516,17143,83718,6068
34420,4,69,1094,59,6867,10
54134,189,2013,686,1850,16907,163
13217,18,921,1477,493,15880,428
59802,96,1502,511,1058,15845,444
39177,19,321,978,264,7033,57
26110,67,1462,1253,965,20907,497
741,15,859,1596,566,19227,293
576,94,3203,1598,2399,30462,804
5175,98,4226,1553,2754,43989,1472
2906,2631,86683,1579,47146,227860,39537
54074,32,390,688,289,5925,101
8467,278,11470,1515,6846,149372,4624
28701,11,550,1198,312,9025,238
23824,18,543,1303,384,9872,159
44512,3,36,901,30,2119,6
13339,20,1034,1475,658,16933,376
68413,47,647,245,642,13160,5
59766,88,690,512,627,14171,63
50696,2601,27615,790,22433,130725,5182
31595,77,2620,1145,1552,39191,1068
54011,52,854,691,625,14924,229
10789,4480,135369,1502,75342,422200,60027
43397,304,2902,912,2131,16793,771
10479,116,2508,1504,1599,36947,909
61618,33,399,447,347,11321,52
56074,84,1162,626,919,23932,243
16531,9160,171677,1428,98769,421807,72908
54310,39,374,680,337,9103,37
33414,19,490,1114,331,10186,159
15515,180,5061,1444,3569,61304,1492
1645,92,2704,1590,1853,43159,851
64921,3,55,350,44,3359,11
37939,27,445,1004,365,12953,80
2746,779,16654,1581,11477,55562,5177
21169,11,513,1346,365,16135,148
46245,88,1063,882,770,11477,293
23850,86,2260,1303,1467,11172,793
2527,22,936,1583,526,28384,410
59310,9,97,528,74,3989,23
35576,467,5821,1066,4274,60578,1547
65618,18,231,332,219,5801,12
4791,63,1418,1558,854,23503,564
7643,3728,116133,1522,68442,292355,47691
37246,374,13263,1022,7667,88097,5596
49935,1141,61321,809,17614,162402,43707
53459,162,1849,708,1413,12992,436
28179,11,424,1209,274,7665,150
24385,448,21269,1291,6289,97617,14980
31157,50,1038,1151,724,20214,314
37487,7542,135275,1016,86194,573353,49081
4096,76,2247,1567,1240,25108,1007
30921,27,519,1155,342,4932,177
9967,10,388,1508,250,12681,138
57257,14,123,593,110,8377,13
15875,61,833,1439,665,26257,168
6108,2,90,1542,71,6580,19
26058,115,2645,1254,1725,48941,920
36230,7,143,1050,117,5468,26
1829,17,433,1588,284,16638,149
7618,332,12231,1522,6505,149055,5726
23359,39,866,1312,574,11629,292
7638,454,13511,1522,10189,186310,3322
8508,37,1185,1515,753,13166,432
23213,1,84,1314,63,4289,21
15325,411,18502,1448,12125,103884,6377
50796,4,53,788,47,6731,6
27069,42,851,1232,531,21751,320
5663,13,541,1547,385,18123,156
4887,11,303,1556,235,14838,68
38418,13,131,991,117,5954,14
18697,329,12931,1390,9537,119497,3394
23679,42,1196,1306,900,21976,296
9059,8,348,1512,227,9924,121
29751,47,1384,1179,715,13622,669
56485,5,92,613,81,4968,11
11649,42,2816,1495,1460,26508,1356
63600,15,160,390,138,5470,22
18488,314,11639,1394,8185,44680,3454
31567,590,8231,1145,4492,54948,3739
63638,3,48,389,46,2139,2
28497,16,465,1202,277,4777,188
21125,6934,236043,1347,121507,1246936,114536
29649,1804,55508,1181,33829,284695,21679
35141,395,7403,1076,4225,59387,3178
3069,26,1663,1578,1199,82691,464
452,2,137,1599,90,4386,47
52036,25,468,751,398,15527,70
66519,5,85,306,57,5286,28
39845,111,1866,968,1264,57398,602
22587,25,553,1325,357,10666,196
27332,12,661,1226,404,8783,257
45140,247,6333,895,3468,64665,2865
1123,4716,227181,1593,82583,376179,144598
52114,174,2886,750,2432,19191,454
2980,30,731,1578,561,8908,170
18988,25,799,1385,507,15838,292
37940,82,1098,1004,915,17577,183
33214,252,7733,1118,6091,88753,1642
15890,38,1485,1439,1062,22233,423
42782,21,399,923,317,13183,82
7439,8,765,1525,369,17902,396
1595,3,161,1590,113,12707,48
20293,73,4711,1362,2780,57280,1931
54422,22,225,676,164,9401,61
20124,18,308,1365,184,4701,124
34333,100,2258,1096,1303,19271,955
57690,60,1209,581,848,20695,361
68777,1,48,232,36,3188,12
25098,580,7944,1275,5201,48841,2743
23242,8,137,1314,115,4572,22
49355,54,331,824,286,4061,45
33627,33,1869,1110,752,16189,1117
69041,143,8294,222,2591,37538,5703
58091,1729,28736,568,21770,125094,6966
67337,87,1325,279,1164,17681,161
54151,165,2461,686,1976,43100,485
27635,417,4614,1219,4182,55374,432
58234,21,203,563,149,12402,54
55079,6,50,653,45,2011,5
6914,193,8383,1532,5018,39485,3365
28561,18,249,1201,224,12858,25
17719,9,261,1408,222,12522,39
13408,0,39,1474,38,2000,1
2585,547,10306,1582,6792,113536,3514
57290,156,1893,591,1691,16193,202
48837,4,359,839,84,4957,275
58016,251,15074,571,4111,101685,10963
36841,14,179,1035,161,4861,18
3785,97,3183,1570,1536,24851,1647
11267,5,205,1499,90,3413,115
4678,58,2052,1559,1334,24021,718
17898,161,3815,1404,2622,20957,1193
25472,16,484,1268,357,8130,127
50188,328,6316,803,4872,66758,1444
38213,7,224,997,167,11246,57
4204,10,335,1566,218,16324,117
8149,385,6947,1516,4721,49882,2226
52700,12533,184628,729,148985,874873,35643
12530,141,4339,1486,2668,35861,1671
56685,376,4072,608,3612,43233,460
18007,5,399,1402,265,11205,134
68762,4,92,233,87,4682,5
18436,12819,391935,1395,157889,1713363,234046
52682,231,3144,729,2699,32290,445
25507,21,894,1267,592,34762,302
66298,4,85,313,59,5054,26
21817,25,850,1336,580,10953,270
17457,97,1841,1413,1647,66250,194
32333,10,421,1134,239,28179,182
56020,1882,56907,626,29981,343864,26926
55123,52,659,652,637,10904,22
13721,17,490,1469,294,9228,196
8038,517,8517,1517,5891,88813,2626
3435,3,190,1574,87,14337,103
33815,7,189,1107,154,11683,35
44224,45,852,904,596,10067,256
4211,308,11698,1566,6869,104703,4829
18547,1,65,1393,40,7599,25
1781,127,4963,1589,2710,36353,2253
11976,256,8237,1492,4065,54296,4172
9712,32,2441,1509,1335,45994,1106
21705,3713,103796,1337,56734,621922,47062
57103,7,68,596,65,2906,3
21235,53,995,1345,698,39193,297
13473,95,7125,1473,2209,30418,4916
44333,1347,21100,903,16537,100607,4563
35614,146,5035,1065,3394,69344,1641
5337,2,87,1551,76,14570,11
26699,5,113,1240,98,6590,15
48808,23,784,841,569,21901,215
20920,311,9660,1351,6769,102249,2891
35424,53,824,1069,649,24510,175
23711,0,46,1305,38,5012,8
33347,315,6861,1115,3731,76986,3130
18068,8,712,1401,523,15342,189
24201,30,760,1295,535,15307,225
26544,274,6342,1244,4069,89631,2273
18377,299,12002,1396,7267,50388,4735
35889,38,607,1058,544,23687,63
24941,7666,142949,1278,79561,749991,63388
36098,0,0,1053,0,3220,0
59541,2257,49439,520,34396,289167,15043
68091,157,2632,254,1838,51377,794
28811,20,1150,1197,611,16321,539
21339,3,79,1343,60,4046,19
22482,56,735,1327,547,13180,188
25645,71,2838,1263,1892,27216,946
17103,18,837,1419,619,7782,218
34257,43,1023,1098,706,18111,317
18255,534,12183,1398,9429,72417,2754
18128,44,1286,1400,898,23737,388
27455,203,4746,1224,3509,26607,1237
5105,37,2065,1554,1425,29572,640
30929,14,451,1155,279,11871,172
59127,15,238,534,188,4589,50
27912,78,2041,1213,1510,13096,531
37083,23,458,1028,358,15474,100
67205,26,549,283,538,7558,11
4189,75,1963,1566,1418,18091,545
59117,115,1221,535,902,9262,319
60205,1474,41064,497,19982,153527,21082
3631,4,120,1572,85,8117,35
49792,219,2325,812,1960,27758,365
24290,1110,21498,1293,17290,56589,4208
37047,7,122,1025,98,3511,24
34145,48,1863,1100,1235,16628,628
15725,2193,71581,1442,48893,505674,22688
18545,135,3746,1393,2762,46301,984
20859,22,499,1352,347,12798,152
47621,1935,21922,864,20368,116345,1554
56501,115,2994,613,2011,57993,983
10687,22,1269,1503,709,33804,560
4241,19,515,1565,301,13843,214
32588,30,1044,1129,663,11219,381
44327,33,615,903,497,13239,118
51696,316,4127,763,3901,27645,226
39132,30,590,978,478,10278,112
66890,3,17,294,14,3779,3
1833,5,213,1588,160,14494,53
6047,9711,291447,1542,152170,776684,139277
6674,20,2413,1534,1269,15841,1144
16638,271,4255,1427,2921,26439,1334
26093,7,641,1254,271,10113,370
23076,14,530,1316,473,22421,57
20501,656,14045,1359,8709,131467,5336
13111,66,1535,1478,888,28782,647
9765,29,713,1509,428,15769,285
33771,13,225,1107,153,7705,72
50701,41,248,790,220,5117,28
3054,149,6403,1578,4375,49481,2028
821,7,452,1596,345,11322,107
7848,15,543,1519,379,12790,164
40213,222,3911,964,3227,41528,684
13672,78,2521,1470,1698,19048,823
49705,170,2159,815,1774,36579,385
32288,450,10783,1134,6858,74590,3925
50343,1899,29426,798,17211,135274,12215
17067,158,3022,1420,2026,21245,996
61083,553,9691,452,5664,103717,4027
52450,7,148,738,116,5400,32
45894,13989,325589,886,178877,1326623,146712
10291,2255,184758,1506,64598,477675,120160
52301,46,789,743,536,14089,253
36991,259,6398,1030,4574,36315,1824
8479,3934,156554,1515,90642,385418,65912
30909,39,1417,1155,810,18032,607
48363,47,907,855,688,28361,219
57520,5,62,587,48,7870,14
32065,236,7150,1138,4092,29700,3058
39167,144,2712,978,2205,61172,507
14318,138,4760,1460,3459,114218,1301
26632,14,236,1241,199,11953,37
51557,24,211,767,182,7062,29
15713,17,364,1442,250,5381,114
55780,136,1605,634,1558,21377,47
68686,1,34,235,30,1130,4
59474,56,656,522,414,22990,242
30512,0,38,1163,22,5080,16
30633,107,1685,1161,1096,18598,589
51015,1083,20053,782,17354,85058,2699
20195,9,423,1364,296,14979,127
41731,4674,70478,940,61031,364314,9447
63803,53,831,385,794,8171,37
56888,0,60,602,7,3680,53
59765,31,705,512,579,18805,126
67753,9,90,266,86,15092,4
34954,156,3048,1081,1982,19887,1066
20385,4,226,1361,169,10414,57
17428,26,434,1413,307,16960,127
13200,65,2361,1477,1154,35593,1207
30340,612,12232,1166,7816,70048,4416
24167,508,26297,1296,8976,148782,17321
2722,10,313,1581,128,11354,185
22578,49,1519,1325,919,10838,600
28911,2,147,1194,89,9729,58
55314,262,4031,646,3097,49379,934
50294,139,2529,800,2127,26336,402
41231,10,359,948,307,7460,52
7104,563,32804,1529,17266,201077,15538
9501,85,1677,1510,948,18930,729
25345,86,1056,1270,623,11539,433
7496,613,20888,1524,12791,112453,8097
2523,364,8235,1583,5076,25092,3159
62751,29,376,411,315,11613,61
9948,121,4289,1508,2776,37517,1513
23798,2264,83705,1304,34711,203699,48994
17960,178,3084,1403,1838,42680,1246
47315,1404,12924,868,10715,86898,2209
36925,10372,444035,1032,126100,1143153,317935
28364,20,1157,1205,667,8633,490
24286,2923,135324,1294,49602,415704,85722
67105,13,175,287,175,3187,0
18674,27,482,1391,352,9424,130
65525,37,626,335,473,11655,153
234,12,973,1601,590,17242,383
36553,41,1895,1039,993,35928,902
44567,1180,20177,901,12985,183929,7192
13212,1055,22203,1477,17191,74614,5012
1600,76,7092,1590,2865,104773,4227
2201,244,9358,1585,5493,72756,3865
41959,165,2635,936,2076,25189,559
21266,68,2916,1345,1985,39237,931
9672,202,5125,1510,3444,15983,1681
33894,0,60,1105,37,4818,23
17003,67,1771,1421,1273,12945,498
23077,39,1865,1316,1138,30336,727
1441,8,651,1591,477,13052,174
22579,32,799,1325,566,24069,233
19018,265,5874,1384,3377,65262,2497
61214,8,122,459,104,9510,18
52742,493,6432,728,5243,55545,1189
26388,39,3031,1247,1555,39188,1476
17336,185,6857,1415,4607,39593,2250
36894,23,356,1033,294,17541,62
58857,221,4412,543,3046,74203,1366
30522,596,10679,1162,7030,79028,3649
10765,35,3663,1502,1762,17272,1901
17620,124,3323,1409,2055,36794,1268
28404,48,891,1204,683,34528,208
23920,443,6785,1301,5268,94133,1517
13103,114,5071,1478,2687,42041,2384
4790,117,2512,1558,1523,13290,989
4480,143,5548,1562,2930,54925,2618
32447,16,803,1132,508,14724,295
54925,1804,42450,657,26950,223285,15500
6591,94,2003,1535,1670,17508,333
1971,2624,112102,1587,53227,417593,58875
54706,76,683,665,521,8498,162
20610,28,1595,1357,960,25635,635
43341,12,265,915,230,7491,35
39964,3172,49903,968,42639,404195,7264
34531,1,30,1092,21,4733,9
40675,415,6000,958,4607,59404,1393
37936,21,583,1004,505,22416,78
32763,106,677,1126,590,15329,87
63566,31,418,391,398,11074,20
30022,61,1945,1173,1284,31023,661
12254,7020,122366,1489,65727,304783,56639
33314,128,3783,1116,2082,34104,1701
42736,2901,60147,924,39482,403880,20665
24293,261,4879,1293,3127,43520,1752
2071,23,1071,1586,733,34943,338
11950,14,209,1492,135,13422,74
37672,26,908,1011,813,28699,95
29116,13,1289,1191,664,14014,625
37710,839,9588,1003,7951,75325,1637
60899,10,57,471,48,6208,9
61127,77,1039,462,984,19159,55
2161,17,585,1586,465,28235,120
25723,0,55,1262,36,4539,19
31771,18,635,1142,462,13160,173
8058,25358,714415,1517,407207,2115697,307208
55719,35,680,636,458,20306,222
54911,3,19,658,13,2495,6
34824,0,19,1084,15,4037,4
22684,1594,26719,1323,17329,164628,9390
27253,17,672,1228,414,35403,258
32979,2698,47382,1122,37547,134933,9835
53446,0,598,708,305,4111,293
28472,76,1545,1203,909,26268,636
66792,9,158,298,108,6160,50
59297,76,1148,528,907,11604,241
4417,615,10831,1563,7555,48591,3276
17316,3,239,1415,182,22303,57
6174,37,918,1541,650,19418,268
32983,58,2337,1122,1670,20624,667
22497,10,261,1327,192,13143,69
17127,42,2911,1419,2119,41044,792
19027,143,4767,1384,2821,33439,1946
66770,807,10071,296,9585,63698,486
31741,1531,19616,1142,12746,101998,6870
1192,10642,348394,1593,191536,756474,156858
32211,182,3579,1135,1907,23552,1672
1770,247,5660,1589,3067,45930,2593
56413,36,361,616,328,9705,33
24411,35,868,1290,484,8059,384
30072,5883,123078,1172,77522,600576,45556
56243,45,530,621,423,8222,107
50748,3,94,789,82,2151,12
25381,270,5523,1269,3890,41694,1633
5406,38,829,1550,491,19224,338
24108,35,586,1297,425,9027,161
54216,239,2249,683,2045,27716,204
39314,297,3762,976,3322,26588,440
59475,127,1439,522,1184,16082,255
26742,151,4132,1239,2365,29601,1767
31675,1733,36664,1144,18160,277925,18504
49984,83,1809,808,814,17716,995
30390,44,1023,1165,651,21009,372
40945,2,56,952,36,3716,20
28778,1094,18668,1197,13320,64715,5348
50763,8,225,789,160,10733,65
32976,4,88,1122,57,8044,31
25266,19,328,1272,284,16680,44
41686,19,241,940,198,9076,43
49776,1093,14742,813,12776,148564,1966
24901,378,13190,1279,8734,130451,4456
31537,56,1049,1146,564,19693,485
2696,252,6649,1581,3779,78665,2870
42895,21,266,921,239,7256,27
28540,108,2964,1202,1978,25617,986
11544,40,1088,1496,674,12924,414
11580,27,1642,1496,590,19473,1052
48676,22,334,845,304,15394,30
29822,223,4062,1177,2697,22481,1365
9798,669,15911,1509,12876,43515,3035
22261,9,246,1330,184,7757,62
30202,11,389,1169,296,5063,93
37910,145,2298,1005,2162,24833,136
52726,107,3559,728,1012,27652,2547
57254,285,4842,593,3708,14257,1134
50096,1662,32466,805,26139,254180,6327
8330,8,384,1516,263,10285,121
57041,28,232,598,145,6358,87
45836,31,816,887,589,12317,227
48073,20,257,859,237,11450,20
17823,2658,67137,1405,35031,402615,32106
64362,23,305,366,214,6608,91
43241,9602,192502,915,147427,1390229,45075
19678,71,3809,1373,2315,33289,1494
3959,36,2129,1568,1449,43233,680
31327,4,227,1149,207,24256,20
1871,1,158,1588,119,8835,39
9557,115612,3010861,1510,1232480,7989881,1778381
57342,43,745,590,531,16545,214
2840,213,7843,1580,5898,64498,1945
46568,8,94,878,69,4884,25
24401,30,580,1291,406,15114,174
28951,2692,52128,1194,33541,193463,18587
18811,1785,39372,1388,32359,225640,7013
37242,35,680,1022,464,9137,216
64209,4,43,371,27,3209,16
47439,106,1568,867,1422,14777,146
57222,15,174,594,118,8426,56
1826,2083,42070,1588,30621,89923,11449
29267,56,2222,1188,1282,27458,940
24307,828,25645,1293,15691,105276,9954
53333,42,520,711,439,20577,81
40384,12,318,961,242,9019,76
11455,36,1507,1497,974,21098,533
64900,27,278,350,232,4812,46
54380,22,504,678,388,7564,116
25261,4251,127507,1272,72617,563778,54890
12993,610,14956,1479,9117,37880,5839
60404,761,19624,490,13136,139309,6488
6436,311,21944,1538,8612,144941,13332
23494,20,964,1309,520,11932,444
49000,15,258,835,187,5108,71
28396,17,397,1204,256,12492,141
57587,320,7613,584,3643,47299,3970
27657,133,1837,1219,1121,32726,716
62268,9,82,425,75,3662,7
48481,3,102,852,83,4658,19
56797,177,1921,605,1889,19494,32
12697,656,17680,1484,10286,104351,7394
62527,4,90,418,70,3340,20
42099,96,1055,934,956,10094,99
53755,67,668,699,545,19740,123
11062,660,13982,1500,8520,43494,5462
24978,19,1083,1277,449,11794,634
27365,730,14922,1226,11398,104469,3524
58609,20,225,551,220,13820,5
10917,1,47,1501,39,13149,8
19476,23,523,1376,376,6492,147
61256,10,163,457,148,6590,15
16991,3515,88286,1421,55734,447876,32552
58356,36,521,559,432,16743,89
4657,8,259,1560,175,10574,84
3455,93,4056,1574,2029,44357,2027
54287,1522,24245,681,16600,141241,7645
52512,161,2022,736,1743,30730,279
24160,2133,38063,1296,26870,125178,11193
2270,0,200,1585,117,3788,83
34236,17,376,1098,148,6874,228
18398,227,35667,1395,7662,97425,28005
3202,2,76,1576,49,10211,27
21445,13,216,1341,167,15125,49
33981,301,10450,1103,6911,126049,3539
27609,41,995,1220,515,9688,480
56011,10,116,628,81,8972,35
23710,198,4173,1305,3003,19949,1170
15733,101,2883,1441,1738,30306,1145
41295,74,479,947,386,31803,93
31569,38,600,1145,434,9493,166
20333,38,921,1361,696,18013,225
4574,15,529,1561,336,15344,193
48686,9,119,845,110,6588,9
37569,23,278,1013,220,7471,58
60730,2812,47696,477,36298,280810,11398
52921,2,44,722,40,11251,4
14777,4,146,1455,106,20764,40
10418,0,1337,1505,864,10997,473
6266,13,973,1540,465,7173,508
20969,59,3259,1350,2254,60908,1005
37474,43,731,1016,661,32273,70
16672,1,85,1426,49,6298,36
69551,17,216,207,216,3359,0
21077,20,747,1348,524,41028,223
62774,54,946,411,623,7548,323
18785,48,1268,1389,860,50656,408
16035,3,160,1436,116,20401,44
59522,89,931,521,889,9635,42
60693,21,242,478,196,6671,46
25354,41,1106,1270,884,26556,222
13717,85,2096,1469,1410,12167,686
22794,16,784,1321,579,15631,205
5786,69,1990,1546,1380,28772,610
19720,4,152,1372,107,12157,45
20905,5,71,1351,66,16111,5
54596,113,1075,669,721,11152,354
14132,49,1210,1463,713,17066,497
53247,18,345,713,294,6119,51
34700,232,5878,1087,2645,55115,3233
29640,120,1308,1181,1001,8569,307
1421,336,11677,1591,7934,66250,3743
7498,67,1839,1524,1353,38340,486
19222,6,428,1381,299,19216,129
4563,48,1850,1561,1192,38454,658
5901,32,794,1544,507,9214,287
23323,185,6224,1313,3685,46136,2539
57152,13,146,595,125,6456,21
51688,27,429,763,333,7746,96
38139,161,2686,999,2135,16187,551
51387,9139,131802,771,91896,750008,39906
40195,47,654,964,520,14029,134
36954,608,10869,1032,8544,66447,2325
21862,8,301,1335,141,21257,160
25227,32,1621,1273,1345,44914,276
67683,53,667,269,651,8083,16
56967,155,5693,600,2641,53417,3052
64196,211,3215,371,2551,13791,664
11991,4,261,1492,139,12546,122
11295,105,5176,1498,3304,41087,1872
27636,1022,41204,1219,18567,211696,22637
12243,14,626,1489,381,32647,245
58426,130,1683,557,1577,34074,106
8122,9,594,1516,354,12299,240
27156,10,396,1230,274,18950,122
25249,1090,22847,1272,11810,178098,11037
66559,304,6936,303,4156,49615,2780
25574,297,8751,1266,5083,439464,3668
29814,45,1555,1177,1071,16296,484
31774,367,7148,1142,4743,40892,2405
59941,7,130,506,96,5629,34
3301,135,2290,1575,1554,25910,736
15551,1891,78539,1444,41910,433336,36629
19743,11,417,1372,212,9275,205
32405,6627,124550,1133,87699,627231,36851
34621,35,641,1088,483,14218,158
17879,815,15443,1404,9597,89427,5846
51961,33,623,755,490,15332,133
1842,124,3789,1588,2195,52063,1594
3732,43,937,1571,603,19834,334
43647,49,394,911,326,5480,68
11135,4415,120423,1499,66195,314942,54228
22005,70,1883,1333,1287,43867,596
22894,2429,82354,1319,47319,357137,35035
38460,51,2088,990,830,15532,1258
38051,45,567,1001,504,27741,63
68094,7,86,255,68,3405,18
23594,5,151,1308,114,3503,37
45851,15,284,887,200,4020,84
33536,2,118,1112,72,6659,46
3670,43,725,1572,479,12964,246
12539,298,17819,1486,8925,58705,8894
41834,36,689,938,568,21129,121
19782,25,300,1371,215,11227,85
66879,24,264,294,245,7327,19
15190,15,459,1449,323,7074,136
29993,108,1913,1174,1623,46506,290
28072,24,638,1211,400,26480,238
9299,30,806,1512,584,13513,222
53518,3320,35208,707,31018,283310,4190
36538,16,396,1040,280,13250,116
2140,32,560,1586,407,35410,153
26700,41,822,1240,557,8941,265
35313,87,2185,1072,1801,8193,384
48945,274,4356,837,3516,84688,840
40051,190,2910,966,2285,20931,625
34299,141,10887,1097,2803,28674,8084
195,1175,31119,1602,18904,129856,12215
10065,9,244,1507,148,6258,96
29303,66,1725,1187,1038,10075,687
23000,26,1052,1318,724,41004,328
29722,77,1714,1179,1061,18252,653
4240,1214,24159,1565,16718,115519,7441
16083,114,2636,1435,1750,28374,886
56940,10,178,600,153,8613,25
24698,188,5627,1283,2472,43055,3155
21573,36,866,1339,619,8430,247
27683,6,273,1218,175,7161,98
47126,1,90,871,66,6418,24
31890,160,3866,1140,2777,24551,1089
69173,3,88,218,86,6034,2
40951,96,1356,952,1162,13099,194
1372,69,1917,1592,1142,19070,775
64077,8,166,375,110,6220,56
114,2269,127825,1603,65918,815829,61907
15934,23,693,1438,446,13325,247
22694,0,0,1323,0,3291,0
34350,5,83,1096,72,16277,11
29578,123,2999,1182,1963,36803,1036
9464,2744,152819,1511,69340,553549,83479
3514,23,659,1573,462,22838,197
18181,6,146,1399,107,7990,39
11170,24,1596,1499,899,26850,697
50220,83,1506,802,1202,19846,304
28198,6,172,1208,144,8679,28
13994,78,1902,1465,1192,17872,710
40414,122,2204,961,1924,73033,280
11421,43,2928,1497,1270,22695,1658
31572,27,663,1145,461,30561,202
1371,244,7324,1592,4503,60280,2821
35742,22,462,1063,293,25106,169
60039,88,2323,503,1384,54527,939
31894,14,261,1140,164,3832,97
51175,86,974,777,925,25150,49
56659,86,974,609,949,12113,25
43613,888,19112,910,15338,88291,3774
50275,15,152,800,130,6107,22
25116,38,861,1275,515,9704,346
59938,26,620,506,426,8857,194
56952,6,53,600,41,3926,12
40961,58,885,952,713,20552,172
17523,39,1620,1411,1176,21651,444
4850,184,2700,1557,2160,25341,540
38797,2,23,982,22,1854,1
5536,45,1654,1548,1039,34925,615
31151,66,1153,1151,723,8271,430
41341,4,135,946,116,7787,19
49430,662,11260,817,9711,107701,1549
37552,351,5960,1014,3812,47052,2148
45725,46,550,888,481,11156,69
11707,23,1259,1495,650,6444,609
55841,1,9,633,7,1542,2
21187,7,496,1346,319,19611,177
3960,41,1236,1568,691,40049,545
49347,5644,81763,824,64198,433694,17565
49575,806,16063,819,11080,181715,4983
5137,355,16468,1553,6569,121755,9899
21256,3876,118965,1345,63673,530936,55292
55637,3,111,638,64,5963,47
47508,5,82,866,61,4761,21
57097,7,62,596,43,5310,19
2594,409,13894,1582,8485,47260,5409
27109,12,621,1231,326,17139,295
31478,18,749,1147,450,8169,299
20488,26,1025,1359,694,9369,331
35547,14,384,1066,284,15609,100
49027,81,1075,834,853,9384,222
11181,3,265,1499,157,40001,108
5563,126,2575,1548,2094,136334,481
38694,28,283,985,236,2684,47
14971,35,1651,1452,847,17141,804
37538,981,13509,1014,12424,95484,1085
15685,2,66,1442,45,4111,21
30648,21,604,1160,358,7005,246
12458,163,12148,1487,6027,108781,6121
14537,10,188,1457,134,18435,54
40473,209,3649,960,3493,48726,156
16444,54,1570,1430,1159,30709,411
44106,3534,52371,906,39795,283747,12576
24950,617,17880,1278,12493,147738,5387
69566,42,352,206,301,5728,51
36475,1283,21465,1042,17048,110630,4417
5325,6,198,1551,158,7891,40
21239,0,0,1345,0,14741,0
28698,96,2694,1198,1777,33724,917
34432,498,11685,1094,7734,95972,3951
30430,20,624,1165,330,14764,294
38444,54,524,991,417,12507,107
35897,12,344,1057,221,7186,123
14277,15,840,1461,638,24356,202
3412,20,766,1574,539,20578,227
14397,139,4894,1459,2177,46003,2717
53993,19,257,691,202,8671,55
26677,956,29420,1240,11460,216285,17960
13957,32,727,1466,430,8937,297
35040,53,800,1079,558,20584,242
25553,25,1159,1266,749,28358,410
54606,120,1086,669,978,7808,108
2647,26,997,1582,630,10650,367
17533,22,305,1411,190,7047,115
34284,10,324,1097,233,7921,91
22670,26,533,1323,435,15720,98
58164,227,2438,566,1920,21084,518
33036,12,367,1121,261,8392,106
64910,427,4084,350,3641,38229,443
23322,140,4486,1313,3067,41056,1419
54098,11,104,687,99,8864,5
59674,95,1201,515,1019,17421,182
54759,154,1701,663,1150,13625,551
9594,4,240,1510,155,8423,85
60345,13,160,492,111,3980,49
16114,3,266,1435,178,12991,88
14727,857,33321,1455,22370,184340,10951
23574,2748,60952,1308,35950,203409,25002
23747,14,372,1305,240,11052,132
10666,7,728,1503,442,14052,286
69997,19,253,192,189,5206,64
12286,19,919,1489,477,14930,442
22662,3,259,1323,162,5396,97
26428,34,292,1246,205,4887,87
638,172,5988,1597,4004,76270,1984
8575,30,1783,1515,1022,44993,761
58551,60,1253,552,938,17219,315
25625,127,3149,1264,1725,17942,1424
33200,951,16832,1118,10844,81797,5988
12252,138,4112,1489,2935,84383,1177
16482,64,724,1429,552,25784,172
11813,255,12542,1494,6497,63761,6045
23171,24,644,1315,458,11735,186
40485,18,247,960,184,7840,63
3456,70,7299,1574,3804,34938,3495
28910,103,2887,1194,2013,21639,874
37929,38,705,1005,606,13544,99
10184,36,1128,1506,697,40071,431
25952,9,276,1257,202,15516,74
28548,8,282,1202,164,8061,118
9206,302,5865,1512,4402,96630,1463
43513,8,257,912,226,13193,31
56430,6,67,615,54,2902,13
17473,2100,66374,1412,40537,527958,25837
62581,163,1982,416,1828,29450,154
22011,9,414,1333,324,25846,90
66665,11,73,302,58,11553,15
50483,1652,45047,795,32060,276934,12987
260,47,1247,1601,932,28988,315
28143,171,4895,1209,3178,21856,1717
52804,85,1039,726,961,17634,78
31402,156,3406,1148,2133,42287,1273
42855,89,1443,875,1283,17327,160
605,37,2292,1597,1587,66562,705
61430,676,9345,453,8941,52615,404
60263,17,287,495,284,11826,3
51796,19,398,760,379,7254,19
54119,27,398,687,312,12100,86
43531,1,91,912,81,11144,10
62384,725,16249,422,12204,107013,4045
26505,100,1982,1245,1400,29967,582
23978,22,914,1300,616,18643,298
47347,24,398,868,337,10688,61
59532,4,53,520,30,3878,23
40676,149,1091,958,888,13620,203
55318,1,9,646,9,2457,0
57502,46,647,587,596,7687,51
9730,51,1653,1509,1034,42034,619
18196,141,8645,1399,3196,91680,5449
20421,5,539,1360,403,9290,136
36827,189,2580,1035,2146,47036,434
6007,137,6045,1543,3605,39144,2440
4362,10,224,1564,168,9490,56
32033,51,1831,1138,1043,30701,788
26349,69,1848,1248,1115,19934,733
36829,13,211,1035,145,4430,66
15257,28,857,1449,607,13628,250
955,516,19623,1595,13320,71455,6303
3978,4,159,1568,119,18054,40
65294,21,278,340,259,7897,19
7024,232,4840,1530,3237,38564,1603
38201,399,6061,997,4667,27073,1394
4577,1047,48166,1561,26555,290699,21611
45325,1,56,893,52,5057,4
33781,16,294,1107,225,5334,69
29472,89,2202,1184,1161,21289,1041
2623,5,247,1582,153,16964,94
27323,6,123,1227,116,12524,7
60647,120,3764,480,2420,30940,1344
9756,8,504,1509,323,6261,181
31284,99,1516,1149,1212,15028,304
9637,59,4438,1510,2379,63578,2059
21857,1093,25008,1335,15691,158968,9317
66545,33,388,304,276,6156,112
36915,124,2365,1033,2102,47924,263
20740,438,9982,1355,7160,88580,2822
57433,95,1122,588,1026,12966,96
42842,102,1191,922,941,13145,250
17020,225,4469,1420,2927,19055,1542
21199,5731,165433,1346,95470,894162,69963
1216,33,1802,1593,1074,19272,728
21600,16,549,1339,421,12704,128
16107,294,6671,1435,4935,58280,1736
41109,33,532,950,490,22040,42
65142,15,333,343,235,6535,98
16880,11,358,1423,282,15852,76
50198,2,69,802,53,6582,16
46278,27,463,881,383,13144,80
36140,9,63,1052,63,12773,0
26935,479,11797,1235,7141,371145,4656
9253,8,489,1512,302,16274,187
877,21,961,1595,730,20491,231
49076,62,669,833,491,8951,178
10856,1083,46777,1502,21446,262785,25331
10831,31,1153,1502,814,23964,339
34480,344,6903,1093,4183,68506,2720
2232,67,1219,1585,743,17012,476
31114,546,9510,1152,6177,47309,3333
29199,15,469,1189,354,19467,115
7691,25,970,1521,672,18011,298
67063,401,6149,285,4945,59949,1204
55865,78,1183,632,821,9310,362
5482,104,2560,1549,1683,28105,877
50199,0,9,802,7,1544,2
59912,738,21710,507,14131,131946,7579
25967,41,2795,1256,1434,25253,1361
57994,14,127,572,123,4821,4
41450,52,903,945,485,11967,418
4829,3,146,1557,96,11712,50
31582,1842,24198,1145,15758,119953,8440
14680,3,143,1456,102,15626,41
35441,9,200,1069,165,5042,35
29361,6,330,1186,218,7810,112
14722,23,672,1455,496,7075,176
57986,4,41,571,29,2803,12
1029,5,257,1594,149,13236,108
59969,87,2079,505,1728,20355,351
11985,133,2138,1492,1209,14401,929
18571,30,408,1392,291,17485,117
34483,17,811,1093,526,22241,285
60896,662,9065,471,8035,84189,1030
58059,126,2962,569,1919,16204,1043
70127,11,65,187,61,4290,4
36761,788,13823,1037,9567,98094,4256
18256,4,60,1398,46,13847,14
45975,2,25,885,22,3250,3
18593,1807,47600,1392,32130,247308,15470
2052,260,4836,1587,3509,73133,1327
5201,34,836,1552,566,17049,270
26009,13,840,1255,534,9491,306
31688,20,569,1143,256,4251,313
24030,35,986,1299,698,33173,288
8781,510,8887,1514,5569,75943,3318
62104,33,472,430,403,13637,69
28894,34,1167,1195,759,10597,408
24976,5,315,1277,228,7883,87
38497,9170,370135,989,221409,744702,148726
37275,1,47,1021,33,4797,14
8421,216,4185,1515,3047,26787,1138
1918,18,575,1588,430,21375,145
61927,146,1483,437,1442,10474,41
61265,349,6389,457,5708,77089,681
34986,37,845,1080,652,15112,193
63464,66,831,393,612,10566,219
14953,18,819,1453,543,15771,276
20605,69,950,1357,669,15053,281
33904,11,436,1105,261,6054,175
23252,9,343,1313,225,8923,118
13559,292,8685,1471,5601,33748,3084
52854,3,63,724,54,4183,9
374,36,1752,1600,1052,21285,700
54090,4280,49925,688,41898,273591,8027
60178,14,158,498,135,6283,23
33533,41,956,1112,479,27720,477
59035,1360,30164,537,17724,197259,12440
16421,2050,85561,1430,40133,337059,45428
11386,65,2635,1498,1172,23689,1463
2660,1,148,1582,93,6981,55
31225,92,2967,1150,1293,51847,1674
26730,22,952,1239,514,10448,438
10953,56,2114,1501,1174,19457,940
19543,4,79,1375,63,13160,16
37926,70,1396,1005,1083,36991,313
45353,81,845,892,747,22530,98
21818,41,1376,1336,1008,19882,368
53332,29,409,711,330,5655,79
65488,61,1755,335,560,9425,1195
13883,0,162,1467,73,7237,89
25806,125,3488,1260,2185,15704,1303
13283,1,110,1476,66,22083,44
15487,511,18474,1445,13272,161807,5202
50961,27,437,783,383,8852,54
58642,43,1290,549,703,13327,587
2041,560,22176,1587,11515,113378,10661
14152,15123,1073301,1463,232153,2094759,841148
27411,133,1368,1225,899,16639,469
53592,4,186,705,97,4514,89
36828,48,611,1015,531,12334,80
55655,2,15,637,12,2273,3
37175,291,3256,1025,2450,49539,806
3182,410,16328,1576,9862,50297,6466
29246,9,197,1188,126,6486,71
28928,111,3370,1194,2041,14541,1329
14412,251,6653,1459,3244,47238,3409
41101,163,2444,950,2142,53713,302
62323,48,1274,424,636,19096,638
13545,5,414,1472,215,25679,199
53225,154,2681,713,1400,38815,1281
56665,1376,18363,608,12540,106351,5823
37007,343,3639,1030,3055,40866,584
34671,175,3530,1080,2335,33591,1195
3583,680,18599,1573,13013,59733,5586
18338,593,29433,1397,16555,159664,12878
59200,51,409,532,341,10491,68
6665,302,9201,1534,7389,84992,1812
54549,49,331,671,287,8278,44
3536,13,240,1573,178,14501,62
21420,11,542,1342,355,11024,187
21013,602,13403,1349,8230,158981,5173
42829,25,475,922,359,13185,116
14796,388,11526,1454,8391,78385,3135
39965,203,6691,968,3089,46108,3602
62625,6,240,414,68,4186,172
22137,15,496,1332,323,16238,173
6089,227,8473,1542,4447,83304,4026
32571,62,929,1129,692,11049,237
50747,12,233,751,222,11280,11
3817,54,1510,1570,1092,37773,418
47036,694,8234,872,6049,47842,2185
40748,6,209,956,206,11222,3
26147,10,324,1253,208,9375,116
18877,17,597,1387,474,8068,123
65170,43,552,342,372,5353,180
61573,154,1584,448,1322,13447,262
9975,9,369,1508,256,16045,113
29600,1190,27934,1182,19505,178948,8429
27810,4328,74947,1216,49565,324008,25382
870,66,3190,1595,1983,50765,1207
40657,57,853,958,638,36523,215
51790,12,564,760,334,6714,230
11526,2698,67455,1496,35718,251104,31737
36779,7,86,1036,70,2782,16
49232,112,1447,828,813,37564,634
36959,177,4858,1031,3244,72829,1614
32103,144,1826,1137,1348,21072,478
9837,73,1988,1509,1442,58244,546
56474,373,5344,614,5110,34282,234
4600,32,862,1560,636,18554,226
6383,3150,124939,1538,62734,526389,62205
24545,348,9930,1287,6868,111277,3062
20176,1,94,1364,72,2462,22
22219,261,5174,1331,2963,46311,2211
38755,24,394,984,342,13477,52
18726,145,5109,1390,3829,83741,1280
59070,61,811,536,517,22137,294
17779,4187,112958,1406,76840,678594,36118
60508,508,10656,486,9339,73770,1317
48667,18,185,845,167,9172,18
29710,65,1182,1180,759,6618,423
45469,41,662,891,496,15646,166
22078,19,374,1332,266,7013,108
51929,127,1926,756,1800,18960,126
21602,10990,446369,1339,162345,1569776,284024
44195,11,232,905,178,6093,54
51771,151,1267,760,1190,22311,77
42942,87,1685,920,1477,33080,208
10996,61,1740,1501,1170,18365,570
37040,26,543,1029,451,9568,92
26597,9,103,1242,99,8686,4
25647,10,566,1263,387,12100,179
4011,34,1113,1568,835,23098,278
63209,63,804,400,799,12221,5
21127,111,2902,1347,1987,27130,915
21163,3541,95301,1346,60849,367908,34452
56499,78,1687,613,1050,16456,637
48244,1180,21025,857,13709,224694,7316
26539,124,2936,1244,1831,40790,1105
59552,460,5038,520,4261,48908,777
332,43,1479,1600,808,24083,671
63365,1911,38837,396,27646,259385,11191
48375,8723,101630,854,77672,508453,23958
69821,0,4,197,4,1046,0
70209,388,4746,185,4480,25766,266
53342,35,527,711,452,11161,75
58472,11,119,555,114,8963,5
32180,45,1329,1136,941,21021,388
10128,6,495,1507,369,15533,126
53702,68,817,701,786,14394,31
17827,181,6546,1405,4171,50323,2375
40495,1412,26479,959,16174,231906,10305
49072,111,2001,833,1906,51990,95
17245,98,3090,1416,2134,32495,956
16121,12,339,1435,229,9866,110
4385,512,11242,1563,7119,69750,4123
57312,30,237,591,182,5862,55
24875,706,25231,1280,16117,181677,9114
33566,400,7469,1111,4673,33084,2796
26279,18,1516,1250,670,7251,846
33590,296,8251,1111,5598,79673,2653
49036,25942,567693,834,401035,2529402,166658
63368,7,158,396,121,6862,37
33174,305,4205,1118,2669,48598,1536
8317,66,2117,1516,1230,33554,887
51805,8,70,756,53,3272,17
51994,77,1269,754,1168,29757,101
11085,4227,69587,1500,40127,142121,29460
19362,751,10165,1378,8600,138034,1565
21215,2112,52462,1345,36309,269685,16153
57371,4449,73997,590,47890,373403,26107
59281,45,908,529,460,8394,448
37517,9,438,1015,340,22545,98
1749,109,3869,1589,2673,65394,1196
8331,2337,51008,1516,26729,211124,24279
44457,101,979,902,711,14143,268
18442,7,471,1394,299,6408,172
36202,4,63,1050,44,3430,19
9465,10087,255879,1511,153667,457407,102212
13226,46,753,1476,519,15479,234
4898,28,1094,1556,556,19953,538
52322,4651,87202,742,51916,455975,35286
37613,24,611,1012,394,18198,217
36243,6,184,1049,128,18164,56
27465,15,380,1224,231,3456,149
25581,104,1490,1265,898,17644,592
37048,217,5886,1016,3455,51978,2431
47512,13,180,866,147,7722,33
2332,2833,118786,1584,65126,453513,53660
7642,47,1274,1522,711,40342,563
55184,15,224,651,166,2659,58
49646,10,127,816,98,5026,29
3072,457,10679,1578,7433,132736,3246
4118,21,681,1567,473,19907,208
19677,14,821,1373,571,21764,250
37631,153,3759,1012,1728,51402,2031
59683,291,9470,515,3727,42153,5743
26478,13,221,1246,180,17296,41
49966,28,506,808,456,7004,50
48496,22,435,851,298,31619,137
66685,13,200,301,180,4512,20
51196,5,111,776,89,5924,22
2844,80,3451,1580,2470,26828,981
11965,843,19495,1492,12631,75522,6864
52644,18,238,731,174,17230,64
63702,1942,34930,387,31205,171653,3725
9218,69,1734,1512,1004,11442,730
21946,11,430,1334,311,9279,119
31173,459,12130,1151,9039,39786,3091
4659,14,413,1560,309,6005,104
50917,34,458,784,433,16773,25
48662,52,450,846,326,7663,124
42432,413,5707,929,4751,57517,956
53996,56432,1158374,691,760103,4205302,398271
66513,11,106,307,97,10286,9
14400,224,3909,1459,2709,40045,1200
67721,23,171,268,129,2501,42
17778,107,5133,1406,3406,75460,1727
46760,129,3466,875,1108,21583,2358
31711,161,4422,1143,2645,16066,1777
3096,2768,82066,1577,44251,215429,37815
38299,0,0,854,0,2326,0
67653,3,28,270,24,3269,4
18897,176,5225,1387,3726,63299,1499
37694,1,20,1010,18,2994,2
26298,47,961,1249,675,13868,286
68457,16,120,243,113,2660,7
49719,48,667,815,546,13154,121
22362,147,9481,1329,3971,89903,5510
69636,22,562,204,497,10232,65
30150,20,648,1170,440,8206,208
25701,36,621,1262,508,12799,113
21621,179,5280,1339,3489,51032,1791
14530,70,3862,1457,2514,34323,1348
46672,1968,27289,877,22140,251394,5149
9966,67,3917,1508,2159,18664,1758
23812,13739,503942,1303,228832,2174651,275110
46845,27,263,874,238,7116,25
47327,12764,228483,868,119089,1071747,109394
43081,530,5748,918,4897,58009,851
8236,5805,279127,1516,119218,879611,159909
2336,276,10651,1584,7771,46600,2880
5174,780,40694,1553,19527,207189,21167
28714,3938,93526,1198,62954,613437,30572
63821,1188,15051,384,9797,66046,5254
28863,7,129,1196,97,6385,32
51142,7,45,778,38,4441,7
67970,36,426,259,397,5779,29
27630,99,1965,1219,1251,38806,714
12949,29,1165,1480,679,12455,486
57666,31,367,582,325,10023,42
27587,182,5018,1220,3234,22545,1784
11401,43,2045,1497,1114,51124,931
52147,286,4980,749,2579,42525,2401
28854,8,356,1196,164,12425,192
30986,2475,38027,1154,30129,226551,7898
31654,40,768,1144,621,6668,147
12394,177,1697,1487,1119,27011,578
14675,19,605,1456,365,8114,240
34499,39,3606,1092,733,16767,2873
14527,4,168,1457,107,20980,61
14146,3621,96356,1463,48351,741755,48005
32495,152,2360,1131,1468,13578,892
60046,23,805,503,560,10248,245
13369,183,4817,1474,2490,48718,2327
60051,90,1161,503,742,14010,419
56310,60,862,619,751,20907,111
336,35,1922,1600,1388,73395,534
15795,126,3644,1440,2322,24783,1322
27417,127,1834,1224,1276,19387,558
18120,21,898,1400,539,8661,359
18620,0,0,1392,0,10281,0
32806,28,698,1125,452,7674,246
56837,244,3349,603,2779,43283,570
27706,13,126,1218,88,5744,38
12664,7,287,1484,165,8015,122
61724,0,0,438,0,6078,0
21810,9,248,1336,143,15095,105
54880,20,146,659,144,12459,2
5179,49,1986,1553,1013,13718,973
12491,2654,119325,1486,68443,587508,50882
26859,14,438,1236,361,19865,77
30819,965,20877,1157,14653,62267,6224
24139,171,3175,1296,2217,31376,958
8624,343,5389,1514,3638,45987,1751
9392,70,3688,1511,2522,37557,1166
22812,177,4319,1321,2260,86685,2059
9859,106,2702,1508,1674,20245,1028
9799,764,27067,1509,15511,116889,11556
63223,245,2520,400,2107,36843,413
27632,15,461,1219,316,16787,145
60242,68,747,495,659,13779,88
55077,66,793,653,530,10691,263
32036,53,1001,1137,671,10596,330
55459,29,340,643,298,8358,42
36539,13,361,1040,242,7325,119
59414,62,1262,524,1085,17216,177
11498,140,3843,1497,1790,21983,2053
3033,7,662,1578,212,17058,450
50820,45,688,787,535,8187,153
7220,160,4044,1527,2870,28218,1174
41316,32,434,947,372,8836,62
52338,52,535,742,392,9896,143
8596,49,1386,1514,878,32882,508
53505,76,1269,707,885,21828,384
39012,191,3084,980,1904,17506,1180
10390,133,5972,1505,4165,33601,1807
51296,11,206,774,160,5618,46
32807,67,1048,1125,642,7347,406
40986,90,8070,950,1269,40574,6801
34535,2929,57293,1092,37399,185314,19894
49595,6,306,818,246,19039,60
31593,636,10392,1145,6077,64968,4315
38671,49,736,985,555,20227,181
26332,421,8695,1249,5950,62826,2745
20802,83,2698,1353,1920,18436,778
24322,3,145,1292,96,6988,49
305,232,16540,1600,8150,134006,8390
10114,18,879,1507,437,8624,442
58058,88,1235,569,1029,24232,206
56705,255,3046,607,2453,30711,593
9855,119,3099,1508,2350,31237,749
60598,19,457,483,173,8147,284
52248,4471,269591,745,48912,1388106,220679
63063,41,395,404,385,8021,10
817,365,28190,1596,17639,266776,10551
3519,137,2857,1573,1724,19419,1133
5832,6,229,1545,144,5516,85
15951,49,1063,1438,686,34537,377
34606,1,71,1090,46,3775,25
6097,40,694,1542,497,19052,197
67935,5,78,261,58,6784,20
9271,35,1334,1512,791,11969,543
34935,1360,45393,1082,17277,238601,28116
41804,25,468,939,303,15833,165
30618,5,91,1161,63,11970,28
56031,188,2726,627,2538,41526,188
5956,133,8365,1544,3209,78378,5156
49059,45,674,833,610,12813,64
23333,28,1238,1312,660,18728,578
9671,142,2457,1510,1746,9862,711
56738,53,507,606,484,11454,23
46320,798,24081,881,12536,146948,11545
32616,9,658,1129,384,37159,274
60840,250,2801,473,2794,43088,7
30913,620,15989,1155,10201,87281,5788
23167,6,148,1315,118,4187,30
51794,125,1338,760,1099,10064,239
20776,14,808,1354,626,22839,182
3284,98,5711,1575,1021,28309,4690
4318,12,645,1564,507,34267,138
9484,33,790,1511,383,11300,407
13380,0,0,1474,0,5021,0
36918,74,1279,1033,912,11306,367
23470,177,3560,1310,2589,23289,971
54373,26,247,678,220,10134,27
3614,34,2039,1573,1159,60767,880
67277,9,93,281,84,4610,9
1564,7,75,1590,44,4105,31
36177,4690,117439,1051,81493,448451,35946
3497,3,124,1574,75,6331,49
60953,27,501,469,455,9626,46
29815,2359,43567,1177,27899,299226,15668
27840,303,6579,1215,5216,40372,1363
54336,28,262,679,208,9901,54
62778,22,175,411,132,4235,43
33417,23,346,1114,246,6175,100
38345,47,896,994,767,33386,129
18272,5583,105453,1398,73420,380394,32033
33758,8,454,1107,143,3771,311
56725,62,1041,607,850,17283,191
57622,21,298,583,284,6330,14
29271,5,207,1187,148,11107,59
35876,26,672,1059,488,26621,184
529,18,1087,1598,741,8323,346
53872,7492,124581,695,100583,488683,23998
62141,3,40,428,32,2090,8
10893,31,1464,1501,1004,36653,460
441,697,24966,1599,13884,125377,11082
35738,35,899,1063,539,9077,360
12389,10,206,1487,108,7317,98
1568,4,150,1590,105,8881,45
21844,143,2877,1336,2236,66965,641
50753,567,8061,789,6659,50868,1402
31644,66,2756,1133,1393,32022,1363
30400,5,220,1165,111,8202,109
3701,5,469,1571,266,33027,203
17549,10,941,1411,272,19103,669
5749,9,952,1546,738,18758,214
203,39,2137,1602,1225,29288,912
67899,10,79,262,70,2464,9
10277,10087,476592,1506,163881,2087618,312711
38083,68,778,1000,702,15746,76
14310,1,78,1461,53,19033,25
25041,6,124,1276,112,5929,12
19030,286,12931,1384,9290,63868,3641
30610,40,1288,1161,933,24181,355
21987,161,3820,1334,2382,17861,1438
61654,24,416,446,304,6395,112
44837,41,913,898,725,20306,188
50719,810,10679,790,8382,71953,2297
9057,29,1785,1512,1119,16768,666
61800,11,120,441,101,6916,19
26018,16,180,1255,153,17289,27
48891,16,177,839,122,4187,55
18522,44,2168,1393,1138,17949,1030
40154,301,6906,965,6148,51850,758
68082,13,435,256,408,11932,27
55429,10,135,586,114,7772,21
2969,14,448,1578,297,12214,151
23713,899,46164,1305,30748,127964,15416
20054,3174,97843,1366,56171,329756,41672
53532,128,2041,706,1509,17685,532
55105,4,42,652,30,4640,12
50441,2946,40168,796,21519,150627,18649
37489,1584,21810,1016,17279,91239,4531
37488,39,731,1016,492,12014,239
34749,225,6527,1086,4356,72230,2171
34107,499,18599,1100,12471,49394,6128
29672,10,519,1181,262,20060,257
54365,11,128,678,88,3919,40
9309,15,547,1511,294,9021,253
58767,66,1925,546,1308,22291,617
54019,66,1123,690,851,26759,272
15237,0,0,1449,0,15647,0
18635,26,821,1391,596,28768,225
1972,24,1005,1587,422,21123,583
53296,119,1771,712,1198,17832,573
6843,81,1088,1532,908,11122,180
29663,31,748,1181,502,5713,246
55514,3,50,641,45,3305,5
37830,106,1948,1007,1312,14962,636
64352,924,20776,367,15796,94309,4980
56933,131,1449,601,1128,19823,321
23491,136532,3052596,1309,1236838,5320879,1815758
33714,91,1448,1108,879,12747,569
11782,129,5298,1494,3080,36641,2218
37956,237,4822,1004,3035,36782,1787
651,6,132,1597,78,8218,54
50411,165,2754,797,2600,24606,154
58169,4,44,566,33,4609,11
9426,3309,114810,1511,67538,307732,47272
65495,36,488,335,440,9840,48
48211,121,1615,856,1322,28861,293
41975,37,602,936,527,15157,75
11760,111,2663,1494,1544,30241,1119
57096,36,476,596,408,16484,68
581,148,7007,1598,3690,113850,3317
1538,653,16208,1591,10848,61429,5360
26577,144,3825,1243,2320,46958,1505
23157,35,2315,1315,774,16512,1541
32585,9,215,1129,146,5527,69
27625,28,897,1219,489,10897,408
51714,63,738,762,597,15468,141
42556,64,1359,927,987,20684,372
16497,13,298,1429,193,11997,105
16023,7,230,1436,154,9568,76
43012,15,250,919,180,12645,70
18297,38,915,1397,734,49630,181
20782,119,4751,1354,2834,69161,1917
63969,87,1092,379,758,31154,334
14669,9,460,1456,335,11898,125
34207,386,9329,1098,7028,98948,2301
46575,564,6900,878,5744,38021,1156
22742,151,3713,1322,2713,33889,1000
48495,16,352,851,224,16956,128
35673,584,9009,1064,5812,89263,3197
49371,305,4446,824,3490,98784,956
42238,151,2137,932,1925,22743,212
33260,161,3544,1117,2255,24015,1289
14747,165,2410,1455,1544,22665,866
28528,24,1446,1202,963,36784,483
62422,436,4783,420,3283,59226,1500
67703,23,152,268,129,2911,23
51890,21,290,757,178,11202,112
24569,16,407,1287,289,9321,118
88,2040,88320,1603,35760,408965,52560
29631,15748,381862,1181,221261,900703,160601
66464,11,194,308,191,7118,3
60279,4,191,494,135,10731,56
61462,21,278,452,250,4198,28
19622,2079,74213,1374,41165,436172,33048
53499,106,1581,707,1377,23851,204
14398,460,18619,1459,13345,204195,5274
53490,13,286,707,231,7179,55
51917,22,167,757,132,3635,35
63406,3,23,395,19,2505,4
42078,2,93,934,88,10066,5
67454,16,112,276,107,4382,5
7078,100,2570,1529,1594,22939,976
53681,341,4528,701,3345,45925,1183
24884,39,724,1279,483,13946,241
66518,78,999,307,971,13000,28
13478,50,1152,1473,684,12527,468
6867,8,404,1532,286,8135,118
27566,15,174,1221,112,4019,62
7289,28,1234,1526,962,40880,272
56131,179,1634,624,1413,13954,221
26503,467,16807,1245,11619,126109,5188
20343,1575,60797,1361,38444,199594,22353
18741,105,2264,1389,1487,35043,777
22810,23,1028,1321,715,35551,313
26515,17,790,1245,494,8082,296
50542,6,199,793,169,4096,30
50455,13,217,796,178,10756,39
52339,38,486,742,417,12708,69
34498,7,132,1092,89,3570,43
50910,116,1671,785,1368,15587,303
69350,5,42,213,42,2612,0
18576,34,1604,1392,1172,33388,432
27235,48,1677,1229,967,37340,710
2230,16,453,1585,327,13627,126
43565,16,322,912,252,9146,70
898,73,1555,1595,1203,78745,352
33638,0,34,1110,28,4704,6
13354,126,5427,1474,2929,60318,2498
60782,3,46,475,25,2762,21
49714,66,421,815,349,16870,72
7809,37,1398,1519,933,41419,465
63819,231,3209,384,3145,35932,64
62316,8,132,424,130,3705,2
53074,107,2464,717,1901,27059,563
24002,66,2397,1300,1596,38793,801
8534,28,1141,1515,902,14383,239
55301,6,120,647,60,4801,60
64862,74,1448,351,1049,15609,399
10760,12,215,1502,134,5007,81
33959,6791,100559,1104,58614,437136,41945
20822,177,5780,1353,4165,51163,1615
27791,606,12162,1216,8359,55037,3803
59512,42,539,521,512,10278,27
57423,24,308,588,236,9393,72
70111,26,396,188,346,6152,50
52281,24,395,744,302,6244,93
59893,223,3207,508,2930,20383,277
16855,289,9283,1423,7250,229849,2033
40405,7,122,961,91,9438,31
33070,2368,41079,1120,32405,162682,8674
11167,62,1759,1499,1047,24370,712
28148,19,820,1209,575,10793,245
58114,21,451,568,339,6395,112
47265,139,1781,869,1277,21069,504
32960,43,1024,1122,622,11927,402
61499,135,1083,451,768,18856,315
19275,27,1330,1380,807,23971,523
10011,150,2703,1507,1895,29000,808
32642,117,3012,1128,2178,18263,834
2365,966,45037,1584,22755,323242,22282
60586,8,130,483,104,4470,26
12442,119,2845,1487,1562,32454,1283
50597,18,228,792,184,4686,44
59955,0,42,506,38,2065,4
68895,9,249,228,233,6940,16
20813,62,1755,1353,1245,23257,510
40237,9,279,964,226,7979,53
51101,45,715,779,594,8152,121
61449,18,184,452,164,5370,20
30733,468,11649,1159,7664,137340,3985
20090,24,949,1365,650,28135,299
64249,560,7414,369,7307,58340,107
31845,36,635,1141,353,12238,282
49784,23949,455377,812,278376,2084690,177001
28569,72,1696,1201,1139,10530,557
56672,11,180,608,145,7131,35
11783,10,590,1494,185,9062,405
37500,681,24458,1016,7087,157908,17371
56418,133,1968,616,1086,16256,882
58432,19,149,557,132,7440,17
19702,33,2186,1372,1132,20567,1054
20303,85,2077,1362,1541,33609,536
61773,40,427,441,414,55588,13
24068,84,4365,1298,2995,11158,1370
28456,136,2900,1203,2392,38925,508
30122,44,1582,1171,1027,15885,555
4274,6,245,1565,184,11127,61
2950,66,2008,1579,1310,21683,698
24010,41,803,1300,595,12856,208
16969,32,860,1421,690,23158,170
67916,95,1634,258,1418,25247,216
61341,8,83,455,81,5111,2
32051,57,1123,1138,718,11271,405
43337,535,6929,915,5702,38269,1227
11987,55,3258,1492,1897,30680,1361
33516,21,454,1112,315,8055,139
34997,24,444,1080,332,11231,112
58822,194,1699,544,1607,17426,92
61829,8,191,440,165,6053,26
63862,14,207,383,182,5965,25
63709,59,806,386,412,7990,394
1946,881,37744,1587,18408,157281,19336
30134,192,3848,1170,2658,28438,1190
49372,31,529,824,432,7712,97
28559,70,2769,1201,1692,26025,1077
1734,24,3262,1589,913,20266,2349
53691,0,277,701,230,7166,47
50209,30,627,802,471,15080,156
63103,27,519,403,492,11472,27
37402,207,506,1018,438,16483,68
32942,27,466,1123,288,4186,178
35443,470,9955,1069,8022,128255,1933
11155,18,804,1499,317,9141,487
60412,2566,27542,490,22634,117959,4908
36858,92,2101,1035,1377,19148,724
63938,6,37,380,35,1602,2
61013,6300,162903,465,84673,790745,78230
59367,52,1714,526,743,13298,971
12561,198,3877,1485,2362,25827,1515
55858,39,283,632,243,7749,40
25014,282,4151,1276,2334,32039,1817
13203,7,333,1477,200,5897,133
69565,11,177,207,133,2708,44
35124,227,3585,1071,2350,31874,1235
67510,32,441,274,345,7305,96
12510,207,4439,1486,2416,39139,2023
64072,22,324,375,249,4951,75
60226,46,810,496,650,32832,160
29971,20,500,1174,356,8137,144
12021,790,29373,1492,17187,179571,12186
54488,18,260,674,174,8158,86
7402,6,429,1525,294,15154,135
11866,25,1165,1493,591,17395,574
31102,997,31826,1152,18791,189069,13035
28505,52,1673,1202,787,39792,886
55990,29,484,628,354,4423,130
13365,5,398,1474,216,8848,182
15155,678,18504,1450,13280,204178,5224
2864,1,92,1580,65,7545,27
1083,36,2977,1594,2258,88059,719
31423,149,3905,1147,2589,32640,1316
20414,79,1029,1360,647,10819,382
29413,31,1236,1185,756,29914,480
26821,5,206,1237,122,18001,84
32705,15,443,1127,245,7483,198
57878,13,195,575,151,12944,44
43385,17,242,914,192,8170,50
3384,0,158,1575,120,17032,38
57410,8,153,589,123,7008,30
67791,53,744,265,722,16436,22
8084,21,624,1517,406,18698,218
4992,6,190,1555,95,13260,95
24054,15,336,1298,265,10148,71
35997,109,1558,1056,1319,22847,239
6462,188,7723,1537,5390,53143,2333
60960,19,249,468,155,6225,94
17284,7,129,1416,77,11491,52
18088,43,1546,1401,838,10750,708
53705,4960,70861,700,50122,379690,20739
24324,21,780,1292,448,10180,332
1407,33,1331,1591,953,22518,378
42606,19,219,926,182,5936,37
63788,289,6058,385,3606,37996,2452
44698,70,1366,900,864,10066,502
44617,2,128,901,101,8739,27
49879,4,126,810,113,5797,13
33019,66,1164,1121,855,17934,309
67979,25,325,259,261,4560,64
25433,31,761,1268,413,6795,348
737,211,13472,1596,5459,123807,8013
12162,2,413,1490,163,38331,250
33950,52,830,1104,558,13866,272
44377,75,1244,903,1107,19179,137
22564,2,140,1325,104,9064,36
25608,1095,26014,1265,15577,201811,10437
8510,384,7414,1515,5069,28743,2345
29551,2120,31443,1183,22060,157762,9383
37512,181,5862,1015,3643,38899,2219
50589,738,8802,792,8430,94055,372
10963,49,939,1501,372,13004,567
6699,6,165,1534,126,5461,39
48355,77,2322,855,1849,19736,473
36818,323,8317,1035,5570,81082,2747
10527,2843,112225,1504,62526,333394,49699
13573,384,22533,1471,10833,104443,11700
53418,6,86,708,70,4633,16
22259,15,244,1330,214,8514,30
9385,31514,579534,1511,367012,1177033,212522
10056,3207,72932,1507,42275,162622,30657
7588,115,3340,1522,2438,47958,902
30877,1088,17683,1156,10003,66368,7680
9941,78,1637,1508,909,14965,728
28171,2,58,1209,38,7600,20
17857,146,3271,1405,2258,123883,1013
33210,343,4152,1118,3197,32223,955
50378,532,6745,798,5008,78328,1737
1084,148,5071,1594,2536,56521,2535
48153,34,545,858,406,16612,139
60489,100,1057,486,1001,21751,56
188,226,5352,1602,3699,29878,1653
18150,141,4110,1400,2687,71787,1423
40192,13,137,964,118,5848,19
55002,13,87,655,60,6550,27
30412,43,1104,1165,651,11607,453
24966,23,470,1278,259,4827,211
25400,9,269,1269,219,16297,50
2198,312,21749,1585,12042,175160,9707
54020,17,400,690,303,9857,97
25306,62,2761,1271,788,18008,1973
29110,40,2386,1191,1540,36620,846
12562,343,6250,1485,4300,23079,1950
27287,52,1198,1227,937,28180,261
66357,6,154,312,140,2889,14
38024,41,1245,1002,1094,19332,151
35397,53,1510,1070,1124,19157,386
31430,100,1782,1147,1308,29225,474
35041,128,2960,1079,2418,20595,542
39214,8,315,978,167,8773,148
8312,18,1075,1516,640,28365,435
56134,96,1506,624,1319,14298,187
46767,79,831,875,700,22845,131
24309,6,202,1293,142,13020,60
66812,0,14,297,14,2611,0
10835,31,2534,1502,1519,16179,1015
28135,105,2149,1209,1066,23831,1083
16986,73,2099,1421,1218,20133,881
68558,204,3459,240,3205,50306,254
24636,0,0,1285,0,2436,0
70608,19,336,171,313,7524,23
59215,2,70,531,19,3594,51
30936,73713,3075863,1155,1130961,18536622,1944902
39065,43,839,979,706,14078,133
19615,6,290,1374,216,8704,74
37289,13236,245869,1021,148713,1326988,97156
55277,30,332,648,251,7179,81
29967,53,933,1174,687,15053,246
16709,18,2019,1426,1145,14583,874
33457,3,138,1113,89,6498,49
52356,96,1399,742,1087,40041,312
65140,106,800,343,772,8405,28
67707,25,377,268,372,3836,5
61812,91,1243,431,1034,21079,209
37952,24,227,1004,159,9967,68
8749,33,1078,1514,703,7303,375
17754,1077,52666,1407,24254,122414,28412
27686,16,667,1218,431,16129,236
36408,36,754,1044,607,13977,147
50508,64,824,794,729,24089,95
24486,39,1199,1289,792,20076,407
28164,28,483,1209,345,7505,138
50940,23,352,784,330,13913,22
13844,111,1560,1468,937,23288,623
36159,688,11117,1051,6452,103347,4665
1174,19,541,1593,391,23651,150
32873,106,1888,1124,1284,23800,604
63211,15,306,400,255,9824,51
10509,654,22908,1504,14860,114465,8048
35974,18,402,1057,311,19234,91
905,671,22716,1595,13091,68964,9625
29260,29,1032,1188,671,17352,361
20384,91,2591,1361,1869,25876,722
49010,304,4893,835,3595,30776,1298
34214,9,274,1098,187,6066,87
46440,19,316,880,284,12082,32
30695,125,2699,1159,1504,32782,1195
19981,48,1014,1367,722,45768,292
29024,1,23,1192,16,4118,7
26077,31,626,1254,445,22604,181
71,769,31775,1604,16328,202545,15447
42073,31,381,934,286,3878,95
8282,90,5675,1516,2976,49140,2699
61501,29,456,451,404,8451,52
16195,121,3663,1434,2425,31972,1238
17963,636,27306,1403,13796,108114,13510
2789,46,1321,1580,610,19201,711
9286,55628,2430737,1512,600058,9191893,1830679
22671,11,531,1323,360,6316,171
51975,45,906,755,732,22139,174
36797,23,336,1036,281,9690,55
12685,16,3317,1484,916,15163,2401
33002,2590,120877,1121,44102,409449,76775
10711,53,1765,1503,1236,37943,529
66232,19,1028,315,748,7320,280
9646,152,5070,1510,2191,25512,2879
2060,1625,40586,1586,18857,186724,21729
4616,26,641,1560,461,8338,180
7177,34,1861,1527,770,12787,1091
46773,193,5372,875,4205,80561,1167
13507,12,805,1472,443,18958,362
23805,490,6894,1303,5036,62699,1858
59259,8,197,530,175,8107,22
31088,3146,42332,1152,29412,134072,12920
66328,16,269,312,219,4177,50
35672,4,183,1064,101,4773,82
25939,13,129,1257,121,5232,8
6739,212,4224,1534,2428,20742,1796
26263,18,481,1250,294,9530,187
30133,296,8894,1170,6555,59404,2339
10971,121,4725,1501,2586,23219,2139
32309,1365,29760,1134,21217,70280,8543
41759,3,273,939,32,5091,241
58247,202,3627,563,3431,22187,196
10589,11,444,1504,281,17429,163
54968,11,329,656,156,5694,173
13997,322,10945,1465,6256,132096,4689
14218,51,2909,1462,1874,77974,1035
45129,14,137,895,111,4738,26
66563,24,250,305,179,7138,71
12215,0,0,1490,0,7999,0
5399,7,273,1550,218,33262,55
27726,4851,84856,1218,49587,288869,35269
37194,0,0,1024,0,1694,0
2998,421,10045,1578,6254,35643,3791
28991,1727,50282,1193,18075,219319,32207
51309,4,79,774,66,3619,13
51186,11,189,777,115,14373,74
29106,72,1418,1191,734,34982,684
18215,110,5327,1399,2394,63874,2933
20000,8,217,1367,162,4483,55
12789,16,945,1482,377,17009,568
4955,16375,437732,1555,211075,1046105,226657
53898,33,352,694,315,5456,37
37329,15,158,1020,124,7358,34
1233,962,34245,1593,22460,343133,11785
562,2372,185867,1598,85783,651912,100084
14557,16,459,1457,293,21394,166
48317,253,3265,855,2165,16168,1100
26836,26,764,1237,477,3787,287
18006,85,2476,1402,1750,67747,726
1673,0,67,1590,56,13729,11
21969,130,2206,1334,1338,17131,868
21434,8,157,1342,126,17242,31
59024,14,171,538,117,6623,54
17126,95,2768,1419,1941,38469,827
68144,296,6093,254,4449,72803,1644
57713,127,950,581,828,13302,122
18524,18,529,1393,390,8536,139
58447,81,782,555,703,14721,79
10623,353,11515,1504,7817,65029,3698
24935,38,1657,1278,905,18351,752
16669,629,16973,1426,11880,118136,5093
66943,25,246,292,228,7690,18
4544,12,352,1561,245,11350,107
16770,28,1073,1424,794,23751,279
51823,790,18524,759,12374,82861,6150
55510,62,723,641,633,8346,90
39502,7,126,974,114,9194,12
9333,299,12092,1511,7172,66110,4920
12586,62,3013,1485,1472,37288,1541
2610,157,9633,1582,5874,48028,3759
1752,638,35233,1589,21128,193874,14105
20827,67,3123,1353,2261,50977,862
20051,18,322,1366,218,10231,104
34923,18,563,1082,409,6060,154
21486,33,419,1341,309,7102,110
272,790,31500,1601,21156,213158,10344
35311,1236,25896,1072,16320,113819,9576
35762,1448,28283,1062,13969,104125,14314
50337,20,240,799,218,7588,22
27182,803,15219,1230,8302,72591,6917
25964,393,4948,1257,4447,54885,501
63229,29,236,400,206,13817,30
15987,61,1783,1437,1013,18375,770
14799,64,1919,1454,1054,21468,865
54886,251,2083,659,1638,25486,445
13513,2,260,1472,126,17463,134
46688,29,673,876,593,22846,80
33005,4,210,1121,136,4772,74
35092,17808,642923,1078,296548,1886773,346375
3498,177,11592,1574,6084,115295,5508
43175,18,304,916,227,5252,77
2243,49,1622,1585,1022,27033,600
51534,46,569,767,485,6933,84
44849,39,437,898,319,11564,118
36483,7,211,1041,179,6105,32
33736,10,622,1108,356,5520,266
31559,55,3677,1146,1682,47220,1995
51538,4,31,767,23,1621,8
9060,363,5125,1512,3614,66853,1511
18628,7,417,1391,251,13164,166
30888,209,4701,1156,3492,54589,1209
37545,421,9749,1014,7475,75376,2274
36164,37,839,1051,762,45340,77
62578,63,818,416,754,11463,64
12716,707,21819,1483,14051,72271,7768
28979,11,409,1193,256,8839,153
51031,115,1081,778,1022,33884,59
61837,349,5141,440,4974,25793,167
55142,4,46,651,32,4766,14
32592,2041,22845,1129,14669,82729,8176
6552,9,270,1536,196,47362,74
23141,48,1158,1315,829,26991,329
15737,9,540,1441,374,17456,166
4136,5,163,1567,122,8595,41
67310,25,474,280,439,9269,35
8599,29,862,1514,514,8079,348
50639,2,31,791,29,2677,2
4123,32,3602,1567,2097,29336,1505
38044,56,1135,1001,905,36429,230
14844,254,7548,1454,4873,52240,2675
51089,132,2364,779,1395,24044,969
27532,15,305,1222,302,11704,3
20270,5,198,1362,158,8290,40
15785,57,1428,1441,923,10336,505
66747,31,337,299,319,4714,18
28576,120,9405,1201,5332,55470,4073
2581,3925,122968,1582,70630,507053,52338
16631,8,190,1427,107,3780,83
5625,36,2280,1547,1288,36890,992
19029,35,1602,1384,981,67554,621
18421,368,15382,1395,6804,105396,8578
64067,2499,40626,375,37696,327372,2930
31701,590,11068,1143,7975,60713,3093
36784,22,942,1036,253,7914,689
29728,141,3209,1179,1837,29120,1372
27529,423,10520,1222,5057,70913,5463
15313,26,777,1448,514,14906,263
23443,11,301,1310,212,9946,89
26989,7,686,1234,315,18696,371
23048,52,1943,1317,1477,28330,466
62603,945,11036,415,9848,68530,1188
21656,1490,36215,1338,21339,274312,14876
57186,115,1304,594,1149,21539,155
7569,51,1915,1523,1145,24071,770
7155,300,7588,1528,4873,73641,2715
49013,66,1429,835,1316,18633,113
5711,10569,364603,1546,139783,798985,224820
60751,18,479,476,405,8267,74
11146,45,2100,1499,1295,37351,805
38210,22,339,997,220,6865,119
32981,96,817,1122,523,8429,294
37405,278,5624,1018,4674,57538,950
53962,41,539,693,401,10820,138
29741,92,2711,1179,1471,23170,1240
47437,9,166,867,122,5613,44
11048,56,1600,1500,848,17327,752
7585,5,160,1523,124,5421,36
56607,29,500,610,446,4696,54
63319,10,103,397,81,5808,22
59332,10,226,526,219,6526,7
59585,29,312,519,270,8613,42
50745,3,91,789,76,10387,15
58411,13,312,558,234,11164,78
36322,650,9720,1046,6747,56317,2973
28846,209,2580,1196,2217,31648,363
65959,903,14138,323,9807,96801,4331
54964,304,3967,656,3158,21105,809
67340,5,65,279,54,3465,11
8728,2035,87762,1514,52047,432688,35715
8684,426,18328,1514,9767,89126,8561
31176,5,238,1151,141,5720,97
3363,15,178,1575,128,16069,50
3222,64199,1512861,1576,674011,4361934,838850
39397,63,657,976,520,8282,137
9225,32,1397,1512,939,19446,458
20999,6,173,1350,101,12687,72
13139,17,985,1477,519,14339,466
51798,1307,17335,759,13523,195620,3812
3799,7126,143536,1570,87847,348176,55689
59404,14,210,525,174,8233,36
38146,101,2150,998,1357,22881,793
27064,3699,65444,1232,32337,279083,33107
22899,2912,67195,1319,47792,533993,19403
20036,145,4483,1366,2092,63334,2391
52904,97,1281,722,860,9516,421
15060,8,350,1451,244,17044,106
59867,775,23220,509,18401,93614,4819
18116,180,8022,1400,5524,52156,2498
60262,20,236,495,228,20560,8
27246,11,298,1229,250,22407,48
3178,112,6873,1576,4276,49287,2597
62474,17,435,419,425,10399,10
66308,9,107,313,91,5126,16
37994,73932,1534622,996,824527,6499364,710095
36964,62,2502,1031,1822,38638,680
52832,0,17,725,15,2439,2
11259,3249,112505,1499,56652,634989,55853
21765,3095,53541,1337,38044,133466,15497
30799,1,126,1157,86,8309,40
48938,12976,378642,837,271680,998732,106962
14372,16,387,1460,304,10478,83
11337,61,1732,1498,1157,33986,575
33831,18,328,1106,218,9673,110
70037,14,331,190,323,5811,8
50067,1013,13929,805,8995,150669,4934
58037,107,1371,570,1188,19580,183
19411,2,164,1377,135,8314,29
8198,143,2881,1516,1250,21360,1631
62655,607,7444,414,7190,42658,254
61843,59,610,440,413,13594,197
11179,243,4586,1499,2685,29474,1901
4940,22,559,1556,375,16711,184
34055,44,1002,1101,763,32267,239
29840,478,7357,1177,4674,32034,2683
25255,255,9535,1272,6462,45548,3073
26129,746,14296,1253,9114,196141,5182
29475,18,526,1184,291,15910,235
15387,326,8251,1447,5541,114132,2710
23053,40,1114,1317,869,14409,245
50028,3,92,807,87,3616,5
62036,350,7945,433,7620,42549,325
10902,1389,49703,1501,27966,251966,21737
20011,46,2231,1367,1747,33355,484
26376,29,787,1248,391,11420,396
20539,28,1265,1358,817,27052,448
5227,5,279,1552,215,6984,64
37573,70,1628,1013,1093,13853,535
4847,17,816,1557,565,11055,251
8074,710,16159,1517,12758,110511,3401
58597,25,390,551,316,12465,74
57880,21,436,575,183,5026,253
26720,590,9347,1240,6717,129219,2630
23885,33,619,1302,415,13602,204
36502,3,150,1029,109,4864,41
30859,4,88,1156,75,12401,13
59144,32,476,534,391,9084,85
56699,442,7169,607,5923,85534,1246
50693,846,10027,790,8987,57846,1040
50412,39,345,797,334,9325,11
62012,131,1851,433,1640,18831,211
28380,1166,26592,1205,17151,144055,9441
13146,199,9959,1477,4323,45337,5636
20613,0,33,1357,26,4345,7
47300,109,2407,869,1964,29463,443
36791,18,338,1036,230,16474,108
17776,50,1271,1406,764,27288,507
57295,5,63,592,54,3704,9
62861,19,248,409,133,5437,115
27103,53,1789,1231,851,31746,938
51102,19,247,779,196,4160,51
6262,143,2330,1540,1527,92257,803
15411,9736,465109,1446,163583,1016693,301526
9506,51,1842,1510,1244,23853,598
44998,0,42,896,25,1969,17
49126,164,4303,831,2671,40761,1632
30533,10845,201532,1162,138577,750398,62955
19470,392,11806,1377,8141,174033,3665
2327,35,1276,1584,981,48605,295
26448,8,146,1246,121,8730,25
48638,14,426,847,355,18525,71
7672,151,4990,1521,2704,28857,2286
10472,13,1372,1505,462,13025,910
1701,236,7886,1589,5406,90133,2480
29446,178,3304,1184,2071,113838,1233
38492,40,483,989,379,3935,104
60487,16,203,486,179,3482,24
49577,40,595,819,322,14626,273
66027,29,469,321,449,12498,20
22382,1429,40785,1328,18658,311277,22127
8160,263,5572,1516,3803,33040,1769
17838,4,67,1405,56,10609,11
53707,222,3210,700,3013,29192,197
5458,330,13126,1549,8256,70398,4870
24051,14,418,1298,288,23674,130
13412,144,3654,1474,1897,20907,1757
64769,2440,86649,338,53199,432225,33450
54204,107,1399,684,1388,21775,11
17422,23,822,1414,445,13994,377
48537,21,294,850,176,5946,118
1931,2431,68872,1588,39371,252158,29501
24912,87,2743,1279,1815,25248,928
65289,13,221,340,212,8092,9
19916,71,2164,1369,1550,21570,614
24087,79,2583,1297,1678,18206,905
31764,70,2103,1142,1686,20815,417
4911,208,12026,1556,6654,110734,5372
42310,3412,42816,931,34201,213573,8615
20094,123,3003,1365,2143,41443,860
31731,853,19039,1142,8870,53028,10169
24267,101,3178,1294,2176,22765,1002
56870,12,125,602,76,3476,49
3980,59,3428,1568,1486,40308,1942
52100,41,714,750,523,12319,191
56493,10,85,613,69,4484,16
63863,34,514,383,501,13222,13
50930,2439,53832,784,26412,393689,27420
14975,359,11698,1452,7500,86288,4198
28450,503,15030,1203,10566,51598,4464
6027,42,2511,1543,1595,36407,916
17356,7,319,1414,246,9518,73
56432,23,319,615,266,6308,53
45358,88,967,892,840,24002,127
37399,4,125,1018,98,6344,27
42494,93,1217,928,963,19840,254
16884,71,2528,1423,1836,35418,692
1851,1,53,1588,39,3919,14
58696,135,2201,548,1875,13558,326
31012,116,4247,1154,2357,67984,1890
47557,766,10777,865,9116,94140,1661
12777,11,545,1483,210,8407,335
24047,80,3295,1298,2130,36302,1165
36493,71,1166,1041,1114,30832,52
11354,0,0,1498,0,7349,0
34012,53,825,1103,701,8157,124
3446,8,329,1574,237,8371,92
33703,103,1315,1108,1155,9418,160
2967,35,2172,1578,1518,57022,654
61744,127,1727,443,1542,28264,185
56459,125,1342,615,1070,17992,272
450,94,11903,1599,4120,54672,7783
50528,17722,346555,793,231994,1228838,114561
22273,882,16860,1330,12211,42529,4649
8200,1072,39531,1516,18409,137587,21122
24668,337,10157,1284,4842,55557,5315
17994,3,716,1402,190,12156,526
9920,138,3121,1508,2076,23183,1045
52057,2514,33348,752,23922,244904,9426
3984,7,296,1568,214,37445,82
37371,34,404,1019,320,10824,84
24470,8,208,1289,170,11689,38
35765,22,1825,1062,366,8102,1459
38282,53,735,995,607,21546,128
17664,1995,55682,1409,35819,485108,19863
39299,120,2865,977,2666,28323,199
9723,410,10197,1509,6198,31208,3999
58605,76,1547,551,1289,29779,258
61201,6,66,460,60,4518,6
66483,45,532,308,532,9291,0
11610,80,2375,1496,1429,56827,946
29563,703,12726,1182,8563,91992,4163
59819,41,408,510,303,12432,105
62494,43,749,419,629,11658,120
62923,20,214,407,169,5315,45
59618,9,109,517,81,2489,28
47170,85,1200,870,1049,27028,151
30966,38,654,1154,475,17158,179
12266,7,814,1489,290,10868,524
64587,4,50,360,40,1544,10
64673,15,164,357,153,3403,11
5751,49,1594,1546,1149,24432,445
60577,20,273,483,234,5101,39
53436,20,245,708,210,8102,35
34340,132,6786,1095,4777,77369,2009
20067,55,2216,1366,1456,19466,760
27260,14,259,1228,165,5290,94
18831,1,129,1388,96,6987,33
54531,130,4909,672,4631,25927,278
485,3,159,1599,102,9281,57
49004,40,869,830,788,25389,81
10573,8223,177802,1504,97896,584291,79906
24715,10,255,1283,177,11241,78
19566,7,805,1375,582,9487,223
17309,42,519,1415,279,7709,240
21523,6,314,1340,227,16540,87
29408,12094,389502,1185,214691,1486336,174811
7328,972,29567,1526,16796,154373,12771
5934,39,1171,1544,757,18189,414
6114,57,1692,1542,1106,48230,586
17426,358,9534,1413,6172,57944,3362
39455,33,640,975,514,14769,126
15304,37,1002,1448,695,10119,307
57905,80,1274,574,1135,20641,139
54189,5,51,685,37,2886,14
5974,23,999,1543,747,17896,252
1667,14,501,1590,302,17175,199
57047,13,280,598,234,18989,46
30833,4023,63508,1157,38389,273436,25119
52208,193,2171,747,1956,29308,215
11050,10172,335832,1500,161963,1418261,173869
49723,2236,38184,814,20403,160883,17781
45122,0,0,895,0,32814,0
30902,24,1012,1156,636,9397,376
3900,28,973,1569,771,11771,202
423,0,1962,1599,1049,22990,913
57571,6,113,585,79,3200,34
62988,12,218,406,180,8340,38
23179,6539,132564,1315,81989,415226,50575
32433,715,16807,1132,11367,200841,5440
59085,386,8635,535,5952,55605,2683
15926,104,2202,1438,1414,16576,788
50855,2749,52265,786,41179,285388,11086
471,228,2939,1599,1892,18723,1047
4424,555,24482,1563,12219,155670,12263
45599,29,580,890,439,6494,141
36376,97,2128,1045,1694,19075,434
67265,21,194,282,160,3626,34
873,159,11997,1595,6430,108754,5567
21335,85,2620,1343,1591,55928,1029
64950,18,244,348,191,7362,53
37913,31,704,1005,527,9745,177
65689,4,22,330,19,3115,3
7020,26,932,1530,692,42514,240
28847,125,2202,1196,1790,36893,412
20412,180,8519,1360,5437,60486,3082
22743,227,7881,1322,4144,93875,3737
11608,201,13148,1496,5930,108652,7218
17818,31,964,1405,689,18350,275
36092,11,487,1053,436,12791,51
25315,398,10995,1270,6578,68044,4417
40229,47,854,964,574,19789,280
21544,444,15773,1340,7352,89940,8421
21080,169,3549,1348,2245,31821,1304
14717,19,1189,1455,743,10191,446
49905,577,7993,800,7396,57658,597
33079,12,277,1120,240,8316,37
64551,1,21,361,21,1993,0
50437,5,118,796,58,2920,60
18716,16,417,1390,337,34504,80
51922,1,24,757,15,3727,9
31313,3,47,1149,39,5133,8
37846,2918,73021,1006,41561,438666,31460
19602,9,257,1374,147,6662,110
8518,17,239,1515,184,12432,55
1755,79,2484,1589,1657,34668,827
36128,135,2377,1052,1357,25263,1020
26116,1767,26563,1253,20320,80584,6243
37180,6,122,1025,109,7115,13
58274,29,370,404,366,6645,4
33576,692,16983,1111,12070,87446,4913
1541,31,1107,1591,720,28774,387
54540,2321,32928,670,18081,137829,14847
59079,40,528,536,495,16836,33
63354,2540,39734,393,38809,487896,925
16351,9196,321254,1431,157443,973476,163811
50200,163,1744,802,1553,22125,191
17889,54,1398,1404,1078,23374,320
52463,44,912,737,597,17189,315
42570,9,311,927,196,9269,115
3415,55,2436,1574,1567,32059,869
2979,3610,105035,1578,62386,192908,42649
23863,28,591,1302,443,9115,148
2819,2607,62625,1580,35211,287336,27414
42548,3,52,927,38,4336,14
9147,21,370,1512,232,10633,138
23237,2,101,1314,82,5301,19
33419,159,2827,1114,1971,16745,856
40236,73,1531,964,1247,9399,284
33447,6,130,1113,116,7748,14
13870,36,1363,1467,806,13794,557
19124,10,323,1382,289,33701,34
19679,11,611,1373,454,8809,157
11774,147,4432,1494,1906,16461,2526
47082,72,1458,872,684,15528,774
50044,72,827,806,651,7993,176
22075,4,215,1332,135,4525,80
7670,30,444,1521,278,12302,166
51921,136,2667,753,2365,30305,302
56266,16,251,620,243,3736,8
4764,1409,56272,1558,24500,166995,31772
8133,90,2176,1516,1365,13229,811
10397,95,2810,1505,1523,27895,1287
33674,2305,56075,1109,25995,297097,30080
17813,153,6167,1406,3100,35771,3067
12012,13,797,1492,430,16831,367
29730,3845,82798,1179,52842,316814,29956
3492,164,5711,1574,4070,75996,1641
49029,139,2173,834,1807,37033,366
52085,50,497,751,377,12216,120
3871,10295,563450,1569,267422,2250902,296028
21794,3,125,1336,88,4934,37
54348,14,122,679,111,10744,11
25737,45,2143,1262,1128,27983,1015
63448,10,108,394,87,3344,21
57260,377,11556,592,6908,47841,4648
20640,46,1267,1356,936,20910,331
50543,13,258,793,208,11740,50
34930,675,15300,1082,12596,68277,2704
19262,116,2248,1380,1634,41859,614
56063,188,2123,626,1920,12538,203
34275,12,428,1096,327,4484,101
58787,226,4112,545,2586,87463,1526
49313,84,972,825,703,15071,269
58649,99,897,549,788,13805,109
7882,215,11098,1518,6479,111972,4619
58180,0,58,565,37,4793,21
18389,14,819,1395,662,16232,157
8258,3935,192412,1516,108560,643728,83852
66647,10,142,302,136,7428,6
33323,5001,88915,1115,59680,297420,29235
53858,22,267,696,187,9491,80
50265,631,8261,801,7595,68059,666
32307,88,2276,1134,1405,30937,871
19647,21,454,1373,327,11450,127
27304,363,7499,1227,4810,121513,2689
26587,35,1066,1243,628,12831,438
17928,39,951,1403,688,12947,263
44051,158,3061,907,2876,31899,185
6951,450,13213,1531,7865,173387,5348
41524,3609,48136,944,35559,275453,12577
1242,1,107,1593,79,17040,28
24413,31,794,1290,440,18920,354
66211,13,169,315,139,11825,30
20615,10,895,1357,549,5463,346
9892,546,21796,1508,12548,102607,9248
7679,63,3480,1521,2125,42161,1355
25617,38,1657,1264,992,29691,665
26670,23,605,1240,389,24363,216
30363,19,290,1166,187,6242,103
14970,51,1130,1452,661,14851,469
28373,34,256,1205,207,6773,49
8608,123,5382,1514,3236,61001,2146
50931,115,2010,784,1702,33583,308
25257,10,301,1272,230,13715,71
25786,157,1663,1261,1233,10672,430
909,5,537,1595,363,21705,174
8128,7737,198941,1516,119898,450203,79043
22636,3,117,1324,69,12051,48
54890,375,6106,658,4478,44938,1628
31594,156,6011,1145,3255,41212,2756
22744,52,1257,1322,762,9608,495
10453,125,1816,1505,1318,17662,498
49691,19,342,815,286,16657,56
55718,1182,16825,636,14261,113970,2564
62187,27,145,427,142,5133,3
1035,58,1955,1594,1419,46439,536
26079,15,257,1254,177,9777,80
16660,911,27236,1427,18842,190951,8394
32821,1076,13876,1125,10194,69916,3682
53933,16,171,694,130,15278,41
23664,680,23348,1306,14003,69559,9345
34147,10365,214998,1100,118687,850822,96311
57351,26,425,590,318,13704,107
50344,5,77,799,70,3072,7
54158,8,73,686,66,5534,7
31661,12,182,1144,146,5642,36
20182,17,488,1364,366,22609,122
55258,10,106,648,92,4215,14
5644,1162,35685,1547,20298,306882,15387
4426,195,6821,1563,5310,35166,1511
56406,5,92,616,83,5262,9
14337,0,0,1460,0,9575,0
5077,22,1789,1554,1136,19447,653
65227,153,1983,341,1742,15700,241
34007,761,12812,1103,8828,123379,3984
43123,9019,140136,913,112000,671346,28136
24987,22,965,1277,701,11201,264
9571,3064,151306,1510,75964,294855,75342
8636,506,27842,1514,16104,95895,11738
23363,108,1849,1312,1216,26096,633
12049,32,1012,1491,567,5906,445
34996,5343,87454,1080,54992,341810,32462
27739,79,966,1217,644,14752,322
34804,162,2388,1083,1860,49701,528
51599,24,323,765,275,33206,48
33537,24,505,1112,265,13391,240
9226,4,251,1512,165,11429,86
23567,46,718,1308,531,15077,187
51048,14,192,781,137,9832,55
21452,76,2092,1341,1258,36683,834
52126,73,1875,749,1418,14054,457
27676,1498,30403,1218,18071,225628,12332
27588,335,4952,1220,2806,39647,2146
49812,97,2172,812,1879,19878,293
23484,4,167,1310,116,6665,51
10336,1934,48514,1505,30183,202584,18331
4332,75,844,1564,599,13088,245
52853,5274,108619,724,63760,415775,44859
23249,225,6212,1314,4468,49424,1744
34815,227,3206,1084,2517,19057,689
19556,1635,39385,1375,23087,125062,16298
11685,24,1418,1495,713,11089,705
17554,81,1977,1411,1380,20185,597
31041,151,3001,1153,2297,57963,704
62582,16,133,416,115,3591,18
35543,14,265,1066,209,8718,56
48965,406,6664,836,4449,79791,2215
14509,5646,95390,1458,58112,292176,37278
6701,1323,33370,1534,22969,192392,10401
20960,1,109,1350,88,6875,21
54085,2056,31647,688,14799,112792,16848
18403,5,373,1395,266,14094,107
67435,75,1355,277,687,17415,668
10085,305,6635,1507,3575,45388,3060
35109,99,2585,1077,1728,31891,857
16245,11,235,1433,196,19281,39
39917,723,10176,969,9920,139317,256
48678,28,437,845,371,8783,66
60659,22,367,480,265,11620,102
10786,0,376,1502,218,14844,158
28170,31022,553562,1209,312489,1177309,241073
11935,84,2198,1492,1302,14264,896
13341,31,1341,1475,842,34842,499
28607,209,4915,1201,3382,15423,1533
42209,185,2655,933,2288,26818,367
4580,41,1122,1561,733,12948,389
50297,0,45,800,34,2958,11
22379,88,2627,1328,1521,39915,1106
793,33,761,1596,579,11640,182
18459,473,8461,1394,5070,76354,3391
8792,39,1798,1514,1186,46684,612
10216,958,25035,1506,15836,114846,9199
2845,3255,92647,1580,46933,258349,45714
51549,1,12,767,10,2313,2
62885,10,265,408,190,6917,75
9327,22,879,1511,540,10610,339
20861,1208,18106,1352,12959,87852,5147
38482,40,656,990,479,10768,177
60826,17,163,472,150,6979,13
54860,73,772,659,631,13440,141
28041,6,108,1211,100,8686,8
40685,153,2663,956,2295,55980,368
36342,19,447,1046,375,9684,72
14446,9,1027,1458,597,6928,430
26019,393,9884,1255,5551,44408,4333
63703,6,142,387,135,14087,7
26390,18,642,1247,445,4059,197
8648,137,6392,1514,4650,27226,1742
59493,22,301,522,260,5498,41
4767,43,1218,1558,685,15669,533
24642,25,812,1285,553,12314,259
7833,95,4010,1519,1887,32167,2123
35542,10,189,1067,146,14587,43
54307,22,436,680,220,9358,216
51585,123,1864,766,1576,27549,288
19303,2402,44811,1379,22958,139346,21853
62327,59,745,423,731,12270,14
50862,102,1244,786,948,21731,296
22029,10,157,1333,117,6857,40
25665,57,1522,1263,919,13170,603
63584,9,87,391,66,2444,21
32146,29,598,1137,355,9152,243
68620,119,2717,237,2490,30922,227
28767,5,277,1198,178,3726,99
37380,1,22,1019,19,1962,3
26591,0,0,1243,0,10136,0
20934,20,535,1351,344,13621,191
40329,33,765,963,662,24597,103
51383,291,9120,771,7947,30205,1173
5332,11,775,1551,342,18178,433
58108,3,180,568,121,3457,59
50460,520,7535,795,6616,76213,919
5320,12,571,1551,347,22878,224
9603,21,460,1510,314,6817,146
51330,2312,55485,773,32702,125432,22783
38316,3,129,994,93,6520,36
23672,4,175,1306,145,13673,30
34527,202,4509,1092,3314,30825,1195
34855,55,1247,1083,817,13465,430
59670,22,190,516,149,11117,41
46933,32,340,873,258,8790,82
37,30,1612,1605,1145,26710,467
36438,72,777,1043,668,17983,109
6633,217,7043,1535,4721,38807,2322
27808,430,7744,1216,5428,60010,2316
18357,18,702,1396,504,24907,198
52499,25,237,737,229,6431,8
34669,55,962,1088,711,7057,251
38409,2842,55093,992,41613,508614,13480
11519,167,2592,1496,1811,16160,781
54330,35,371,680,339,6263,32
16296,104,5341,1432,2894,32970,2447
3441,49,1555,1574,652,14500,903
21338,11,540,1343,454,12130,86
18448,79,2152,1394,1542,12776,610
51440,1,69,770,43,2182,26
33312,15,696,1116,383,10419,313
15059,3,309,1451,228,22602,81
68134,18,146,254,145,5886,1
20369,506,13422,1361,5598,106763,7824
20755,17,515,1354,402,18966,113
3693,2523,77253,1571,43704,152135,33549
62676,802,23852,413,13279,107879,10573
16103,3476,75047,1435,55081,505117,19966
34832,26,1166,1084,707,7428,459
8146,13,412,1516,254,14883,158
13224,152,2978,1477,1870,35405,1108
12052,1,223,1491,127,3429,96
18960,56,603,1386,502,20070,101
49228,29,1144,828,323,17799,821
59269,415,9742,529,8594,105207,1148
52503,41,637,736,622,26597,15
33121,2650,86074,1120,34939,447520,51135
27020,15,664,1233,361,9389,303
55397,33,369,644,292,7470,77
27303,322,6229,1227,5548,72241,681
53937,405,11467,693,5447,96623,6020
57993,75,695,572,625,11978,70
61620,125,1565,446,1246,19006,319
54163,863,8618,686,6938,203353,1680
29554,430,4286,1183,3544,27812,742
22651,157,1801,1324,1224,23002,577
48497,256,4121,846,4064,43824,57
49724,20,228,814,205,5078,23
17176,73,1072,1418,693,21389,379
14200,7,285,1462,185,15710,100
7611,69,2267,1522,923,35811,1344
55832,5,55,633,51,4896,4
19226,130,4348,1381,3026,50778,1322
61370,28,329,454,312,8881,17
64707,106,1287,356,1242,16683,45
62992,52,728,406,620,23729,108
5679,83,2245,1547,1612,24030,633
13166,2093,88140,1477,22631,306392,65509
8915,94,1729,1513,1210,17854,519
216,60,2134,1601,1019,20263,1115
16109,11,458,1435,318,10536,140
38387,15,283,992,209,9006,74
24787,22,735,1282,516,9581,219
32314,17,361,1134,216,7178,145
25493,1621,47750,1267,22833,228603,24917
50141,92,638,804,450,11716,188
1082,184,5475,1594,3057,47280,2418
18125,80,4790,1400,2273,20175,2517
58487,104,654,554,616,8156,38
46301,54,473,882,385,10396,88
52438,20,221,739,170,2834,51
15763,5,144,1441,86,4367,58
23214,20,426,1314,266,14135,160
62041,94,842,433,771,16800,71
3321,93,3614,1575,1588,52570,2026
38125,5,243,999,197,10932,46
63925,4,94,380,88,7117,6
57703,1404,30017,576,15715,121693,14302
26469,93,1857,1246,1211,18879,646
66966,26,280,291,217,6668,63
2014,5,284,1587,247,18372,37
30949,27,949,1155,518,8723,431
15018,87,2710,1452,1012,30399,1698
51057,893,23257,780,18116,122547,5141
21599,16,863,1339,642,9693,221
17489,76,1549,1412,1234,19864,315
375,17,868,1600,670,16762,198
7480,66,2922,1524,1896,34898,1026
17069,38,1267,1420,1087,15232,180
34023,104,1690,1102,1063,26787,627
64285,39,592,368,458,8716,134
6086,3545,120209,1542,78053,317884,42156
43939,41,882,908,804,23291,78
56910,42,773,601,563,9623,210
9996,28,1388,1507,744,39830,644
54636,35,251,668,181,8347,70
11662,4074,118859,1495,62735,507430,56124
12346,62,936,1488,522,9972,414
5346,10,233,1551,164,13198,69
21042,27,546,1349,331,12057,215
38011,122,2083,1002,1653,15743,430
67960,22,240,260,223,9584,17
59774,1785,51560,509,28120,191995,23440
56662,31,522,609,352,12387,170
39815,330,7877,970,5827,96126,2050
26493,27,1533,1245,847,24326,686
9625,352,10921,1510,5171,25687,5750
60321,20,244,493,229,11614,15
15778,37,1130,1441,857,18480,273
2491,91,5016,1583,3476,53452,1540
20428,70,2745,1360,1884,20026,861
56099,364,6578,625,4865,56445,1713
52803,12,159,726,125,3643,34
54505,118,1892,673,1175,35700,717
50170,332,6778,803,3714,39846,3064
6579,14,315,1536,232,8937,83
33603,3815,43558,1110,37157,135339,6401
66804,14,302,297,297,10610,5
11334,1,120,1498,87,5353,33
8616,38,3388,1514,1682,32264,1706
32263,12,324,1135,226,14153,98
14073,100,5353,1464,3294,84173,2059
33870,3,137,1106,104,13876,33
49803,23,248,812,213,6515,35
1592,31,1263,1590,934,46642,329
31150,34,725,1151,389,11289,336
30466,7018,238845,1164,98981,972487,139864
6910,13,201,1532,146,5977,55
51333,39,565,773,519,10818,46
16315,23,289,1432,237,15947,52
4785,87,2369,1558,1557,18027,812
50476,126,1800,795,1550,41292,250
57059,50,1097,597,499,24683,598
40781,67,1826,955,1127,27883,699
22469,70,2138,1327,1538,37440,600
34088,46,1007,1101,683,7263,324
51536,94,1276,767,753,19276,523
49607,22,321,818,238,16104,83
46365,21,349,881,260,8381,89
27873,154,3310,1214,1939,40317,1371
55912,44,559,631,506,16539,53
23202,378,10648,1314,6958,107294,3690
357,41,1767,1600,1163,95107,604
38189,12,361,997,321,11654,40
3299,5,253,1575,176,6515,77
25698,823,27865,1262,13961,133656,13904
5327,67,3549,1551,2218,18113,1331
8161,197,3016,1516,1850,14856,1166
19097,7,357,1383,202,18819,155
58548,331,5276,552,4967,46823,309
28903,129,3320,1195,1847,18252,1473
48334,167,6174,855,4472,70261,1702
7390,137,6735,1525,3397,86910,3338
42518,6,51,928,34,1418,17
56308,11,166,619,138,5365,28
29891,84,2264,1176,1644,26011,620
50800,189,2572,787,2110,18068,462
52507,56,1043,736,774,20466,269
40226,58,1133,964,863,19208,270
65417,53,452,337,339,6422,113
57995,53,618,570,521,13847,97
11261,51,2633,1499,1426,18084,1207
50241,198,2810,801,2475,27426,335
24218,146,3443,1295,2584,54533,859
52782,2,84,727,51,3201,33
27218,5,270,1229,185,5504,85
15195,36,1287,1449,815,22363,472
53100,2685,82606,716,38330,525877,44276
37279,16,570,1021,418,14926,152
21017,3,198,1349,138,8006,60
33664,73,1916,1109,1393,36957,523
1669,3,50,1590,40,3981,10
31295,19,764,1149,556,22414,208
19312,44,1156,1379,877,25882,279
65570,65,1157,333,961,11795,196
35957,225,6265,1057,4694,35343,1571
60578,92,940,410,830,11367,110
52514,10,165,736,145,10927,20
30297,636,25870,1167,14767,170648,11103
62294,93,1361,424,1184,28237,177
10849,101,7911,1502,3975,41924,3936
31664,22,554,1144,349,6705,205
39069,203,1712,979,1437,12700,275
34244,51,781,1098,574,9826,207
28783,80,1978,1197,909,22514,1069
20567,54,1068,1358,881,28819,187
61180,19,366,460,285,5255,81
2372,6,274,1584,161,29745,113
15974,752,17434,1437,12619,140672,4815
60902,5,71,470,57,3960,14
14166,20,456,1463,348,12127,108
69396,339,7644,212,5892,71438,1752
39492,21,223,974,185,3867,38
17323,2,158,1415,113,4128,45
24235,4704,154049,1295,55867,918684,98182
55095,98,1207,653,1143,18422,64
40832,11,152,952,138,18712,14
912,673,18093,1595,11040,139868,7053
7692,544,11494,1521,7526,74567,3968
4259,8704,423384,1565,130651,559527,292733
27467,66,2100,1224,1226,22929,874
58463,98,832,555,677,8982,155
37714,15,134,1010,77,20005,57
56115,922,16661,624,12248,183693,4413
10195,21,925,1506,622,39866,303
862,538,27363,1595,18193,137844,9170
4775,27,756,1558,611,23827,145
37409,556,9689,1018,8227,71042,1462
68003,1,12,258,11,1303,1
33481,30,567,1113,433,14854,134
12486,6,493,1486,254,31182,239
30236,6,587,1168,342,14187,245
65742,70,1893,329,1777,21621,116
50677,101,1151,786,996,16772,155
2639,41,1164,1582,636,19580,528
60897,236,3365,470,2504,33583,861
28138,26,377,1209,273,9853,104
917,250,10008,1595,6172,119815,3836
54066,228,3030,689,2305,43149,725
50007,43,477,807,408,9952,69
21907,16,522,1335,355,25662,167
342,69,2925,1600,1339,40337,1586
2920,152,6042,1579,4030,102866,2012
17578,3,213,1410,153,12229,60
31424,1105,31492,1127,19298,134505,12194
42031,75,1017,935,368,6699,649
3863,351178,10423322,1569,3481538,27149451,6941784
27880,15,770,1214,465,7354,305
25551,287,14109,1266,7060,118939,7049
32238,128,1674,1135,1146,17567,528
31099,3,80,1152,54,2730,26
65331,12,177,339,171,4445,6
14144,16,351,1463,247,11500,104
61413,39,324,453,301,7988,23
24078,18,544,1298,348,20259,196
68149,46,532,254,360,11847,172
35318,2448,48081,1072,38693,222987,9388
22828,0,0,1320,0,3769,0
67910,16,218,261,215,10523,3
61818,3789,80791,440,52445,362582,28346
61821,60,1462,440,1362,18292,100
50506,7,117,794,83,5519,34
15911,269,7600,1438,4800,93467,2800
759,791,95899,1596,26839,580601,69060
65878,8,58,325,57,1670,1
60851,6,62,473,56,1623,6
53337,7,189,711,134,3261,55
66029,21,204,321,174,7100,30
16704,16,367,1426,286,13237,81
57034,46,514,598,460,5946,54
56186,8,78,622,65,4182,13
14615,62,1269,1457,937,15249,332
9744,40,793,1509,527,9697,266
16352,54,998,1431,657,9473,341
10084,1731,93970,1507,47451,356634,46519
55486,105,873,642,605,14451,268
27216,137,1944,1229,1254,15340,690
49727,466,4947,813,3389,49702,1558
68035,172,3248,257,2833,15929,415
39308,4,116,977,103,3158,13
52154,1,97,748,56,6528,41
51566,83,794,766,578,17046,216
3297,60,2953,1575,1368,22846,1585
19268,457,10174,1380,5604,82660,4570
34288,37,768,1096,596,4699,172
30696,24,715,1159,600,14479,115
62804,4,22,410,22,2543,0
26675,47,943,1240,806,7881,137
19996,1,135,1367,97,3439,38
8419,226,8433,1515,5969,40588,2464
2064,65,1956,1586,1330,12705,626
60677,12,97,479,92,6183,5
33058,22,609,1120,436,14008,173
17213,2,708,1417,283,30119,425
13148,437,22220,1477,9393,132776,12827
38018,14,262,1002,173,5470,89
34063,4578,219581,1101,87042,637380,132539
12583,1320,39178,1485,20540,228051,18638
55562,20,226,625,127,9036,99
38458,1464,23753,990,16638,168753,7115
27482,239,6112,1223,4050,44384,2062
8444,1598,80762,1515,48811,317671,31951
57992,37,442,572,338,24335,104
52053,89,1194,752,753,14479,441
4185,161,4462,1566,2642,76535,1820
54665,22,190,666,173,5779,17
58435,37,397,557,380,10090,17
26221,23,453,1251,278,8001,175
50658,187,2275,791,1879,20160,396
3433,82,2420,1574,1832,23787,588
19075,45,1967,1383,1252,42542,715
51567,52,679,766,489,17924,190
2827,25,1341,1580,587,15077,754
18034,20,466,1401,293,10030,173
26396,15,1057,1247,435,17345,622
59899,27,310,508,241,9461,69
65647,28,204,331,196,7771,8
56301,3,70,619,54,4619,16
48991,298,3251,835,2657,40005,594
13746,68,4346,1469,2501,72857,1845
24610,122,6655,1286,4511,66476,2144
47231,157,3050,869,1934,36813,1116
34460,503,7683,1093,5723,58164,1960
36966,9,946,1023,214,9672,732
14202,20,511,1462,299,7765,212
31985,584,9180,1139,5920,125190,3260
60804,1137,24504,474,15901,124481,8603
41311,42,1077,947,904,34061,173
68139,26,188,254,182,4578,6
49040,5338,88393,834,62383,275709,26010
13865,58,1232,1467,801,14146,431
19041,20,832,1384,543,15839,289
58614,19,221,550,178,5234,43
42103,585,20760,932,9869,128148,10891
33472,3,86,1113,54,4969,32
18577,11,272,1392,241,27577,31
30885,59,664,1156,472,6928,192
39128,1778,36928,978,22856,142391,14072
34673,13,168,1088,124,5564,44
30566,70,2526,1162,1091,15336,1435
22317,23,710,1329,411,11802,299
45882,122,2204,886,1422,28577,782
593,244,11707,1598,6459,60231,5248
14766,114,3373,1455,2230,40820,1143
21109,65,3225,1347,2059,37437,1166
15541,17,850,1444,555,15778,295
49342,393,8897,823,6018,70277,2879
62497,53,660,419,620,16148,40
6808,545,13251,1533,8463,46488,4788
13500,1881,44731,1472,27629,327821,17102
8511,38,1232,1515,834,14954,398
56427,2,104,616,75,5234,29
4815,14,696,1557,536,13951,160
61898,10,51,438,46,3442,5
13846,107,5280,1467,2170,39910,3110
58920,28,450,540,394,18091,56
55779,46,433,634,376,17383,57
10732,10,396,1503,282,9366,114
60560,113,798,484,724,9773,74
5676,19,1427,1547,852,20502,575
5272,12,610,1551,485,14761,125
5609,13,503,1548,348,15320,155
64961,7,221,348,202,5043,19
64970,10,164,347,160,4324,4
51508,38,623,768,538,5799,85
64595,8,110,360,95,4335,15
49144,17,535,831,509,5693,26
60293,5,75,494,43,1569,32
22736,5,255,1322,162,5259,93
57447,105,1179,588,1171,13150,8
23847,323,11059,1303,8316,78281,2743
9685,34,998,1509,705,14655,293
16471,1880,47992,1429,32266,199867,15726
25097,9621,226967,1275,134676,786251,92291
28058,0,0,1211,0,4183,0
29448,2005,60995,1184,39640,357695,21355
4541,429,10676,1561,7299,41570,3377
15930,869,43236,1438,17770,223823,25466
65658,172,2863,331,2693,47892,170
29950,1998,49353,1174,30416,303564,18937
9463,784,26549,1511,14385,138708,12164
8998,33,777,1513,636,10368,141
41670,5,130,941,87,13247,43
15289,8,602,1448,409,21208,193
8647,1,127,1514,109,7540,18
3402,7,1071,1574,670,12152,401
3733,663,37835,1571,24860,272788,12975
14798,15,502,1454,336,7239,166
12128,127,4572,1491,2454,40019,2118
61979,310,7157,435,3495,53237,3662
33706,160,2477,1108,1596,28888,881
51523,251,3827,768,3432,66222,395
11153,8,264,1499,140,14708,124
61344,5,97,455,87,5433,10
18274,9,172,1398,143,10464,29
12841,5,245,1482,102,10811,143
10257,9,236,1506,153,7517,83
64791,72,1576,354,1418,18436,158
67928,75,1236,261,1027,9774,209
67296,21,276,280,214,4350,62
10654,46,1930,1503,1157,18791,773
61730,55,473,443,389,9518,84
180,772,53522,1602,26705,302552,26817
25702,76,2209,1262,1348,18278,861
59405,343,6701,525,5578,54287,1123
10158,303,7419,1507,4571,63109,2848
33900,8,279,1105,166,7287,113
65035,168,2054,345,1832,20480,222
10353,359,9484,1505,6769,43239,2715
25254,4,135,1272,108,7886,27
38162,14,242,998,205,11793,37
61361,935,12587,454,11824,158293,763
33999,13,228,1103,212,10638,16
53492,50,791,707,627,7872,164
50514,6,102,794,84,8449,18
30204,68,2343,1169,1431,15710,912
39362,20,365,976,186,6898,179
10801,75,2336,1502,1442,10701,894
23188,39,834,1314,398,13510,436
36898,607,11529,1033,7784,110878,3745
10464,24,1512,1505,928,16902,584
613,3,478,1597,279,11764,199
15878,4599,77863,1439,50468,349692,27395
9380,1586,90614,1511,52401,417991,38213
27945,15,599,1213,362,21060,237
66962,24,495,291,381,14617,114
18067,12,969,1401,682,13230,287
7685,26,1215,1521,776,51172,439
48738,11,266,843,232,8850,34
55812,413,7462,633,6293,51007,1169
18599,18,855,1392,585,30049,270
14102,11,527,1463,273,14880,254
20357,1149,25257,1361,19923,102028,5334
5939,18,908,1544,519,8830,389
32301,22,518,1134,355,5844,163
64823,10,124,353,89,5790,35
24234,7176,169595,1295,84270,854476,85325
64112,6,83,374,81,6936,2
2481,13,358,1583,194,5048,164
28896,14,919,1195,565,26657,354
19466,146,4807,1377,3817,44847,990
65114,13,265,344,175,5516,90
31586,12,612,1145,282,10573,330
20417,316,11757,1360,6169,100400,5588
6987,24,1121,1531,458,9450,663
32139,34,839,1137,556,21043,283
12055,19,713,1491,454,14137,259
48493,13,255,852,172,10389,83
12340,145,4229,1488,2741,37392,1488
38938,23,431,981,376,8375,55
41224,17,429,948,328,11921,101
19231,237,9078,1381,4989,33317,4089
66833,0,9,296,4,2007,5
11886,132,6428,1493,2244,108297,4184
20063,23,642,1366,448,14648,194
53377,3,17,710,16,3055,1
61318,147,3425,456,2115,19926,1310
15305,2472,52459,1448,36198,179945,16261
51856,19,251,758,225,6136,26
53181,97,1238,714,858,11199,380
66282,110,785,314,722,9352,63
58629,15,211,550,164,4714,47
56639,10967,222840,609,142732,712494,80108
484,35,1187,1599,864,43498,323
41515,46,952,943,745,10386,207
21430,53,1747,1342,1181,35218,566
31060,21,612,1152,346,6193,266
38271,3,64,995,54,2324,10
21758,124,3639,1337,1680,36756,1959
56218,9,132,622,122,5210,10
296,3297,175831,1600,96055,382125,79776
2433,26,541,1583,431,12753,110
67322,9,251,280,188,6703,63
31749,36,684,1142,466,16237,218
7179,3,152,1527,115,7270,37
65176,76,1968,342,1136,30711,832
47787,97,1686,862,1295,31174,391
4340,6,119,1564,92,10823,27
57961,70,1326,573,1068,18985,258
14320,3171,80361,1460,41561,297516,38800
17580,23,897,1410,612,36772,285
54623,2038,23681,668,18263,71423,5418
1159,66,3893,1593,2117,43866,1776
50712,128,1677,790,1600,18816,77
21778,253,6805,1336,4537,53261,2268
53562,20,352,705,266,12267,86
16552,35,659,1428,486,12098,173
14836,12,361,1454,284,14948,77
54805,1249,15222,661,13076,76146,2146
37435,56,1136,1017,925,20160,211
53980,13,122,692,113,5472,9
19270,5317,166496,1380,83360,576710,83136
12519,17,1117,1486,431,17728,686
45026,36,532,896,338,4003,194
31328,442,12630,1149,6285,105790,6345
34515,748,9325,1092,7359,44936,1966
21332,283,4187,1344,3430,25734,757
29046,18,922,1192,492,7467,430
40842,50,683,954,630,15269,53
17502,11,294,1412,220,7363,74
63939,14,82,380,81,4105,1
18575,4110,109917,1392,63399,731688,46518
38923,382,8178,981,6508,133919,1670
36052,143,1832,1054,1437,21207,395
29335,561,20118,1186,7260,90694,12858
1799,57,1387,1589,822,14119,565
43891,510,12630,909,6544,150090,6086
29132,14,515,1190,311,5355,204
25817,173,4186,1260,1992,28953,2194
25978,12,183,1256,140,7436,43
66198,10,297,315,203,5590,94
7395,381,7039,1525,4323,45169,2716
31820,602,6061,1141,4473,32965,1588
8849,522,8916,1513,6278,38952,2638
12637,2689,91633,1484,52445,257802,39188
16028,7074,152556,1436,90103,758525,62453
7634,135,5208,1522,1431,21916,3777
391,175,4755,1599,2542,31139,2213
50151,42,527,804,447,6928,80
1955,88,3129,1587,2048,43117,1081
52594,13,191,733,110,7907,81
25477,33,726,1267,536,9479,190
40186,18,239,964,176,6807,63
30707,33,816,1159,445,7976,371
67591,2,79,271,70,3596,9
10723,223,10501,1503,7307,51153,3194
19163,228,5800,1382,3511,52673,2289
62214,17,293,427,234,10582,59
22697,15,321,1323,194,7813,127
12558,1280,17182,1485,10024,72410,7158
18868,19,1178,1387,748,11643,430
45934,35,1376,886,624,7606,752
36398,11,245,1044,190,10302,55
59999,156,1729,504,1411,14085,318
57187,5,41,594,38,4856,3
29788,14,436,1178,314,10959,122
163,3,234,1602,125,11023,109
16847,146,16308,1423,9215,68899,7093
18892,0,14,1387,13,2783,1
7754,163,8947,1520,5775,76318,3172
62476,6,118,419,105,2904,13
58249,31,212,563,188,3677,24
30905,662,11254,1155,7009,52293,4245
25393,1294,23438,1269,12381,148326,11057
1231,5,307,1593,220,21720,87
64822,316,5974,353,4385,52423,1589
32608,124,1420,1129,955,10436,465
16366,152,2508,1431,1806,32116,702
54220,24,340,683,193,4981,147
27984,0,0,1212,0,11518,0
22144,14,302,1332,214,6874,88
32477,63,2360,1131,1851,62373,509
7014,11,323,1530,199,8338,124
35104,10,173,1077,126,5518,47
53334,20,266,710,237,9354,29
64385,62,1809,366,767,17355,1042
16548,3,60,1428,44,10598,16
12895,145,3386,1481,2066,26424,1320
52778,77,1384,727,1335,20334,49
16152,2,134,1434,85,24877,49
12444,1,130,1487,78,5355,52
58932,42,459,540,420,10947,39
29772,34,419,1178,280,9519,139
57518,11,229,587,123,9163,106
16328,0,73,1432,50,6856,23
27001,177,7910,1233,5354,75418,2556
12784,14,871,1482,443,8355,428
34,4289,184015,1605,95983,763060,88032
59294,149,1594,528,1313,16224,281
65033,395,5744,345,4869,33167,875
54694,7,171,666,123,3066,48
11112,74,2751,1500,1601,33233,1150
35608,1787,34155,1065,21791,113922,12364
6682,65,2042,1534,1452,21831,590
20302,25,2654,1362,1431,24495,1223
6395,489,25029,1538,10642,194033,14387
17830,102,3065,1405,2345,41940,720
58667,4,51,549,38,4694,13
20474,40,673,1359,482,16293,191
64651,6408,111940,358,80110,708170,31830
65348,36,319,338,292,4449,27
61020,13,264,467,239,11207,25
14870,31,1088,1454,796,16303,292
53999,15,142,691,93,4159,49
49614,920,19223,817,11887,106974,7336
9084,31,1660,1512,1073,20414,587
35471,898,28572,1068,21573,128112,6999
53823,10,174,697,152,7250,22
2330,14,592,1584,417,12458,175
64741,26,244,356,199,4970,45
22388,77,2322,1328,1265,27577,1057
37035,3,248,1029,199,9734,49
25123,11,398,1275,301,19003,97
3709,8,194,1571,117,10018,77
35193,8,97,1075,72,2072,25
35863,929,15183,1056,13282,144397,1901
5573,12,430,1548,255,10432,175
55432,261,3756,636,3099,62384,657
447,25,632,1599,513,31902,119
56396,48,631,616,563,14679,68
50113,102,2194,804,1807,15552,387
16372,203,5506,1431,2532,22057,2974
36086,14,249,1053,192,16717,57
24258,68,2530,1294,1512,29699,1018
14504,2001,78928,1458,23413,272366,55515
36365,797,18127,1045,14536,109813,3591
38156,47,1207,998,914,19024,293
21229,2,285,1345,167,16007,118
42524,4,56,928,42,2861,14
9278,39,1844,1512,1191,21558,653
27667,21,1013,1219,791,30883,222
21655,246,6494,1338,4337,42489,2157
22889,20,258,1319,197,24770,61
58256,11,119,563,88,8344,31
20161,115,6293,1364,3610,70844,2683
6308,131,5924,1540,2608,51447,3316
39055,150,2512,979,2171,34747,341
1459,214,6870,1591,4247,68426,2623
57035,106,2640,598,2163,36782,477
54075,225,1920,688,1621,42827,299
66360,12,107,312,73,3113,34
32126,2622,48678,1137,33684,324417,14994
6734,6,275,1534,169,14170,106
24104,43,422,1297,335,7372,87
690,640,10456,1597,6626,73623,3830
43143,202,1196,917,911,16039,285
12222,18,647,1490,358,5978,289
8990,147,3539,1513,2274,15941,1265
43971,1401,35232,908,18055,239353,17177
17499,560,12407,1412,9199,60099,3208
36728,960,16438,1037,11691,88127,4747
22231,14,542,1330,374,12377,168
3605,445,11783,1573,7286,44498,4497
67005,45,798,289,613,7024,185
2700,25589,846279,1581,384543,3019878,461736
32864,190,2294,1121,1760,33682,534
61071,27,366,464,280,9826,86
16153,36,1035,1434,654,38728,381
26849,90,2939,1237,2193,39039,746
17910,16,1049,1403,882,10197,167
28879,2762,77543,1195,40402,291888,37141
24603,300,7849,1286,4785,47395,3064
21711,17,895,1337,641,20419,254
53014,260,3249,719,2763,24136,486
67008,203,3496,290,3348,48166,148
2738,1474,78337,1581,36119,495994,42218
56267,15,156,620,113,2663,43
69266,211,6293,216,2660,37108,3633
62588,35,590,416,518,14973,72
431,3,197,1599,115,14461,82
16561,8,518,1428,370,16407,148
19179,116,4147,1382,2615,19329,1532
69676,401,8412,203,7009,68219,1403
32174,6,425,1136,227,7828,198
51376,110,1129,771,849,22866,280
12455,101,2382,1487,1488,32569,894
18879,23,694,1387,392,21997,302
22467,18,927,1327,705,17724,222
64415,12,251,365,131,7030,120
29431,250,10095,1185,6007,47812,4088
37120,25,404,1026,289,13379,115
13710,31,562,1469,403,17679,159
64040,48,638,376,576,11097,62
13156,56,1970,1477,1125,29139,845
36269,76,1258,1048,745,19998,513
19773,132,3548,1371,1933,58299,1615
38651,391,5704,985,3285,46738,2419
52214,51,859,747,738,14332,121
11204,6,84,1499,56,4880,28
5933,92,2734,1544,2319,58825,415
51774,53,690,760,575,11365,115
41591,12,199,942,175,6190,24
68549,4,130,240,109,4505,21
29449,32,1000,1184,572,28910,428
56836,25,237,604,189,4367,48
26686,30,717,1240,448,12008,269
32378,1911,61239,1133,25212,121343,36027
49613,19,419,818,375,11210,44
2363,23,866,1584,644,24639,222
1614,91,3894,1590,2618,29143,1276
27779,713,16844,1217,12945,47364,3899
13008,89,2116,1479,1335,18314,781
41207,404,14740,949,7637,44843,7103
21965,76,2429,1334,1683,27012,746
35970,139,1952,1057,1430,17040,522
60258,92,1663,495,1458,23343,205
2657,70,2802,1582,1319,106548,1483
30800,31,1035,1157,479,11755,556
9733,1684,41904,1509,30021,186282,11883
49102,811,18228,831,13548,336587,4680
2688,374,39464,1581,9289,114278,30175
53758,43,732,699,595,7614,137
37024,81,1236,1029,1024,18028,212
23529,76,2806,1309,1651,24175,1155
52400,208,2365,740,2084,12494,281
879,14,886,1595,496,32984,390
12384,15,707,1488,388,41941,319
52224,257,2515,746,2393,34681,122
37453,53,1149,1017,847,44566,302
52884,117,1400,723,1341,15958,59
21464,4,182,1341,159,24298,23
40564,30402,903660,959,412552,2065712,491108
62851,50,567,409,471,6904,96
14561,548,21017,1457,14740,75225,6277
53618,15,202,703,169,15753,33
11370,13377,303087,1498,178877,910575,124210
5782,35,1726,1546,1156,10329,570
11031,0,125,1500,83,5066,42
32250,37,910,1135,634,17545,276
67165,45,480,285,349,6141,131
44874,25,626,898,509,13585,117
16807,37,1787,1424,1245,34749,542
37379,993,14300,1019,11956,124375,2344
58536,1558,69905,552,33040,262817,36865
29634,54,1147,1181,640,11042,507
30179,4710,135630,1169,75245,462492,60385
1710,250,5868,1589,3805,58635,2063
24273,30387,827689,1294,380328,2556577,447361
68865,54,407,229,338,9379,69
17236,99,2130,1417,1670,42088,460
51115,44,488,779,420,4382,68
24475,1014,17820,1289,11647,109851,6173
8309,154,5571,1516,3538,36839,2033
17525,13,537,1411,400,12803,137
28719,19,593,1198,378,15715,215
37394,92,1849,1018,1172,15016,677
40934,82,878,952,602,19927,276
65557,27,309,334,247,7349,62
33449,17,268,1113,194,4351,74
31791,299,8311,1142,3687,34689,4624
27487,72,2206,1223,1642,21958,564
64709,8,156,357,151,2665,5
7462,86,3400,1524,2392,39713,1008
61315,34,428,456,414,9478,14
20339,13,632,1361,426,14954,206
23671,9,293,1306,208,3451,85
25626,87,1709,1264,942,8472,767
23099,2181,58483,1316,31367,302737,27116
61297,69,974,456,911,18737,63
14313,6,183,1461,94,7318,89
28428,15720,442851,1204,229673,1610667,213178
20780,976,21621,1354,15388,240338,6233
18603,6,257,1392,200,14023,57
40123,30,397,965,339,6876,58
66336,43,811,312,772,11082,39
35380,40,585,1070,409,9086,176
29881,96,1979,1176,1452,11065,527
64277,56,1040,368,1007,16121,33
23163,10,427,1315,303,10586,124
21812,474,10561,1336,7593,43183,2968
38559,165,3338,987,2769,30436,569
47364,46,1001,868,948,49038,53
8489,4532,118156,1515,81519,427442,36637
19956,103,1418,1368,988,47362,430
15214,6,170,1449,129,12294,41
3265,1559,70142,1576,35183,234252,34959
32948,324,9572,1123,3010,97987,6562
37439,50,1001,1017,804,18156,197
51576,98,1578,766,1414,15131,164
50214,3212,83307,802,40642,714225,42665
8744,333,9593,1514,5881,48801,3712
51443,72,990,770,609,8684,381
34545,16,400,1092,263,9967,137
16150,58,1159,1434,782,15757,377
16090,1957,37274,1435,24626,167681,12648
44636,329,3927,900,2587,75968,1340
64517,8,74,362,57,4922,17
22383,121,4899,1328,3399,47784,1500
24709,1934,60250,1283,32398,519163,27852
22675,10,325,1323,244,8640,81
11274,0,0,1498,0,11989,0
33247,473,12444,1117,9147,98830,3297
38215,24,307,997,202,5473,105
39353,5,112,976,88,8791,24
24376,92,2656,1291,1969,35302,687
24722,2,188,1283,142,18044,46
66129,73,654,282,482,8236,172
12735,22,1230,1483,629,18497,601
8480,112,1726,1515,1149,20291,577
52284,53,711,744,573,8959,138
11733,14,332,1494,156,18648,176
63049,69,1732,404,602,12089,1130
68285,17,364,250,205,4861,159
19443,542,9432,1377,6170,100110,3262
19790,9,332,1371,237,7733,95
24542,35,1638,1287,1100,18769,538
62917,3,131,408,89,13633,42
22375,14,381,1328,294,16610,87
8784,339,12648,1514,6973,87298,5675
46190,15,229,883,141,3256,88
22302,41,1660,1330,1145,16949,515
25388,6,207,1269,139,12003,68
33877,448,6964,1106,5554,31252,1410
50164,30,714,803,499,19182,215
28265,145,6551,1207,3111,70908,3440
41003,38,889,951,709,12702,180
1368,729,27498,1592,13130,125170,14368
18702,25,804,1390,545,14900,259
20632,34,490,1356,355,16323,135
28858,246,7620,1196,4836,65447,2784
53587,5,81,705,61,4374,20
27277,882,12669,1228,7897,45977,4772
26370,9,490,1248,288,10774,202
28218,41,742,1208,495,27598,247
27867,566,12908,1214,9022,102051,3886
1431,59,2111,1591,1469,16225,642
55243,66,582,649,559,12963,23
42218,214,4379,932,3558,41321,821
51077,4304,46213,778,36256,217432,9957
39063,34,1103,979,499,9536,604
30459,207,6917,1164,3930,28238,2987
12399,198,8915,1487,3834,54292,5081
32189,82,894,1136,632,8296,262
8324,542,34255,1516,14605,100060,19650
24194,12,463,1295,157,11417,306
54427,6,44,676,39,1845,5
1488,14,307,1591,222,8233,85
16329,2,101,1432,64,15502,37
39504,14,247,973,217,7803,30
12859,237,6795,1481,3262,34943,3533
52170,1,17,748,17,2805,0
26760,53,1673,1239,1336,42145,337
35698,53,1232,1064,1029,8282,203
10012,27892,573548,1507,311048,1024332,262500
19277,70,1413,1380,784,20592,629
2569,183,7040,1582,4484,54445,2556
31810,33,790,1141,496,12817,294
27989,51,767,1212,592,6732,175
15965,2,78,1437,53,16618,25
976,46,2571,1595,1490,55002,1081
65014,12,126,346,104,2913,22
6195,9,955,1541,363,10193,592
13059,810,12481,1478,8739,99587,3742
17784,878,77892,1406,23049,160039,54843
31481,55,2498,1146,1305,17663,1193
12968,239,6635,1480,4047,108878,2588
24805,5634,137458,1281,81200,258524,56258
28638,86,1332,1200,1136,36289,196
61035,11212,213186,465,165488,940981,47698
52993,79,1695,720,976,19193,719
9408,79,1474,1511,780,9587,694
64610,12,115,359,79,3346,36
26926,38,963,1235,823,25776,140
34030,21,492,1102,398,25354,94
37070,1164,17063,1028,12239,225442,4824
38778,496,4538,983,3373,50031,1165
66988,77,946,289,872,19040,74
29304,106,1396,1187,961,20190,435
960,213,6641,1595,4119,46078,2522
10333,14,785,1505,462,13904,323
32173,7,153,1136,94,5550,59
58912,6,94,541,81,3993,13
18945,15,1089,1386,733,29566,356
19610,41,711,1374,446,12712,265
19960,49,1016,1368,797,13014,219
1251,40,1521,1593,1020,12876,501
43117,322,4311,917,3751,38006,560
12127,0,0,1491,0,9291,0
26875,24,806,1236,640,13789,166
56650,46,347,609,271,13557,76
22895,202,4048,1319,2482,40132,1566
8771,178,4072,1514,2444,31071,1628
29204,237,10985,1189,6013,118668,4972
38514,153,4375,989,2754,47744,1621
66819,1061,13621,296,12841,87121,780
19809,0,0,1370,0,9799,0
8306,21,1033,1516,621,12007,412
20150,22,592,1364,457,6556,135
51219,8,163,776,138,7813,25
3983,322,13306,1568,8387,148647,4919
45208,45,906,894,695,16765,211
128,412,19385,1603,10954,112083,8431
4476,542,12411,1562,8925,84424,3486
52134,103,975,749,925,10844,50
57031,48,1340,598,976,41723,364
46050,72,1136,884,744,16916,392
29327,3,200,1186,95,4773,105
63123,10,343,403,303,10157,40
5684,60,2172,1547,1181,30382,991
31205,106,2368,1150,1591,12979,777
42370,11793,336861,923,198376,955942,138485
30979,329,4712,1154,3650,26533,1062
26569,54,1302,1243,676,16410,626
27468,119,2102,1224,1514,28407,588
24015,1180,30144,1299,20051,165674,10093
53537,6,342,706,325,8503,17
20331,14,441,1361,342,5850,99
23448,82,2571,1310,1427,45210,1144
3398,112,2648,1575,1985,24371,663
42656,4265,137290,925,69687,406762,67603
52341,39,452,742,398,11755,54
49846,36,906,812,810,14855,96
45299,4,48,893,42,4769,6
918,24,1325,1595,900,32615,425
56476,16,221,614,193,6207,28
45952,6,332,885,192,6721,140
58866,16,152,543,124,5399,28
13462,296,10475,1473,3819,94697,6656
37678,113,2415,1011,1809,23408,606
20316,44,843,1362,550,10806,293
58106,123,1722,568,1099,28430,623
12265,3,263,1489,145,5700,118
21535,576,13650,1340,8635,86784,5015
1520,92,2173,1591,1338,58074,835
34663,11,350,1088,226,6756,124
28524,15,404,1202,292,12642,112
13889,80,3375,1467,2089,22059,1286
27101,70,1883,1231,1267,39598,616
62665,2228,33623,414,28279,129882,5344
32722,43,1405,1127,725,31414,680
18397,0,0,1395,0,20854,0
22631,195,8280,1324,6194,37314,2086
4322,314,12677,1564,7035,63493,5642
3651,14,487,1572,330,29886,157
61932,17,243,436,193,7728,50
49907,12,205,810,169,2967,36
37184,20,399,1024,359,8419,40
62556,521,7919,417,6963,58491,956
15350,85,4473,1447,1378,19710,3095
31913,7,172,1080,120,5815,52
2321,378,9708,1584,5952,48514,3756
39368,57,807,976,621,10837,186
22943,18,661,1318,470,9020,191
36303,51,933,1047,641,13262,292
25282,336,4392,1271,2670,28688,1722
12991,0,0,1480,0,8219,0
58332,22,941,560,525,17016,416
23318,272,7149,1313,4260,43054,2889
6585,134,3201,1535,1977,51484,1224
67981,290,6497,259,5345,36002,1152
3718,31,716,1571,533,23672,183
31885,185,3859,1140,2689,18926,1170
37255,13,258,1022,216,6482,42
18264,697,12929,1398,9758,55722,3171
38181,10,135,998,93,2479,42
63366,8,139,396,100,9044,39
4374,8095,165427,1563,105216,728306,60211
43468,32,352,913,293,5859,59
24734,27,453,1283,285,4703,168
16311,1983,42153,1432,23572,269464,18581
55351,56,867,646,768,8449,99
18526,2891,40919,1393,30462,238929,10457
36891,1969,31683,1027,25484,201184,6199
18223,14,1385,1398,845,37483,540
46729,97,2754,876,1797,31198,957
61005,152,1455,467,1397,23985,58
17345,14,266,1415,205,8357,61
59963,30,487,506,431,6657,56
18487,62,1204,1394,987,17484,217
32552,28,786,1129,213,4705,573
17975,12,486,1402,261,6797,225
20397,34,1252,1360,847,19794,405
10513,32,2095,1504,1396,35818,699
49439,4,42,822,35,2427,7
30868,70,6835,1156,2995,34055,3840
15065,12,798,1451,562,31723,236
28624,152,5730,1200,3959,71122,1771
56269,82,1701,620,1252,20984,449
2662,78,5512,1582,2407,37502,3105
37699,2172,32584,1010,18522,115192,14062
38841,86,1284,982,966,21408,318
7710,65,2262,1521,1581,44119,681
6744,1,160,1533,129,33427,31
63688,16,258,387,113,6365,145
13349,48,1526,1475,878,10687,648
10588,2,60,1504,31,4256,29
2275,12057,471903,1585,220038,1237476,251865
38641,40,754,985,572,9424,182
49925,5,155,809,128,9085,27
56297,13,251,619,182,4891,69
66700,26,776,301,776,18876,0
705,2610,99371,1597,52551,221548,46820
36489,26,330,1041,298,8823,32
28000,4,223,1211,137,5743,86
48470,4901,70613,853,51899,462852,18714
12192,150,5834,1490,3262,34330,2572
12058,411,18194,1491,11139,139274,7055
8162,617,12549,1516,8195,42370,4354
52618,83,891,732,818,9047,73
49574,15,171,819,157,5099,14
29908,28,981,1175,569,15589,412
52030,37,420,753,394,11908,26
7237,41,1674,1527,1129,27844,545
22915,20,955,1319,670,33819,285
54014,157,1545,690,1270,26535,275
25747,22,312,1261,189,6140,123
20338,107,3573,1361,2441,71002,1132
12616,20,1590,1485,970,32962,620
44467,107,1426,898,1203,54714,223
15095,808,31641,1451,16081,156869,15560
31360,1176,20565,1148,16674,78707,3891
8839,4,210,1513,97,9006,113
11506,92,4349,1497,2451,39520,1898
54913,31,214,658,190,6388,24
61866,14,125,439,112,7821,13
60635,86,1669,481,1542,23160,127
53771,261,8489,699,2086,32712,6403
48969,4,131,836,110,16518,21
15163,33,694,1450,443,13697,251
52843,13,166,724,134,6831,32
64875,543,7519,314,5455,136422,2064
13508,89,4258,1472,1442,42343,2816
34925,1988,46802,1082,18628,178133,28174
40646,211,5723,958,2715,50127,3008
1141,1,253,1593,140,19089,113
20985,76,2221,1350,1584,44043,637
54184,53,754,684,737,14462,17
1037,1770,56427,1594,29718,158193,26709
41653,29,720,941,532,9324,188
33020,937,17397,1121,11463,155141,5934
47616,12,178,865,141,6755,37
12006,894,22121,1492,12190,116972,9931
62425,2569,66715,421,35151,165319,31564
22314,221,4685,1329,3516,39785,1169
19522,85,2920,1376,1687,68069,1233
24114,22,852,1297,530,12348,322
49339,572,11647,824,7262,78456,4385
58488,258,12241,554,4696,107372,7545
43932,51,489,908,438,16376,51
30301,19,761,1167,452,14981,309
60309,70,830,477,717,10251,113
58756,8,71,546,56,4169,15
11644,146,7323,1495,4329,51290,2994
48478,120,1063,852,893,11635,170
58072,21,170,569,167,10851,3
15817,7,141,1440,107,17531,34
34410,125,2314,1094,1847,13984,467
56378,89,1005,617,821,8374,184
15543,39,1123,1444,698,34654,425
34259,17,1103,1097,581,31177,522
33050,74,2708,1121,2006,37709,702
20837,0,0,1353,0,9246,0
20194,23,643,1364,467,24581,176
2126,30,1852,1586,1258,27525,594
63933,130,2018,380,1379,22397,639
11514,7,749,1496,449,21108,300
8559,65,2417,1515,1793,47187,624
14134,726,6167,1463,4546,60696,1621
38545,192,3603,988,2883,56784,720
66531,17,188,306,145,18485,43
28461,242,5422,1203,3962,75854,1460
35519,12,275,1067,164,5673,111
52313,48,1696,743,427,23956,1269
7064,16,413,1529,294,10659,119
30359,8,598,1166,338,8330,260
65122,3,73,343,68,2248,5
62149,771,16045,428,13099,109587,2946
788,21,1160,1596,777,17282,383
19344,300,4366,1379,2773,60349,1593
57182,336,4296,594,3319,42384,977
64640,8,173,358,95,9234,78
2037,99,2299,1587,1757,34222,542
22413,19,761,1328,574,16698,187
18715,56,1419,1390,1157,38742,262
21297,73,4346,1344,1537,36867,2809
45362,225,3118,892,2731,29847,387
39269,8,95,977,92,5719,3
23170,2772,121920,1315,42853,627033,79067
33922,292,4338,1105,3267,31206,1071
2442,31,1779,1583,1244,34122,535
38238,462,5461,996,3360,36972,2101
32669,1126,30764,1128,23438,311004,7326
49379,18,200,823,167,6961,33
53046,43,784,718,478,21287,306
65194,31,562,342,526,9564,36
17825,28,805,1405,593,15222,212
24226,248,4784,1295,3557,50299,1227
51319,1656,35824,773,24248,340235,11576
15309,645,24558,1448,14895,99691,9663
29259,452,9199,1188,7134,75568,2065
49285,4146,70088,826,55711,328559,14377
7184,2816,50180,1527,31688,380838,18492
10605,43,2356,1504,1389,49436,967
22304,14,1047,1330,630,8734,417
11082,167,4306,1500,2909,26556,1397
37600,3,126,1013,104,5418,22
63205,12,136,400,89,3896,47
6339,20,430,1539,306,8503,124
100,4462,161546,1603,108547,475336,52999
65556,4,54,334,40,3960,14
20305,2084,64231,1362,44631,476785,19600
11897,87,4283,1493,2113,21136,2170
1714,7,278,1589,190,17945,88
62872,10,173,409,121,4116,52
1295,354,9723,1592,4679,89129,5044
871,45,1342,1595,865,35158,477
42043,3871,95830,935,42477,363868,53353
66540,33,615,306,524,7587,91
54161,3,54,686,34,6120,20
41072,132,2568,950,1880,53553,688
52038,0,49,753,39,2707,10
65007,15,116,346,93,3425,23
14020,739,28040,1465,15873,157935,12167
29965,278,7458,1174,4626,46735,2832
62833,77,707,410,576,6106,131
15972,1395,37801,1437,21390,152810,16411
54908,1864,36999,658,21556,252104,15443
48019,37,421,860,317,5188,104
53695,19,205,701,169,8899,36
9504,9063,321445,1510,123810,689915,197635
20538,27,718,1358,596,45938,122
34696,332,8791,1087,6136,40936,2655
22528,62,2492,1326,1498,48178,994
60716,34,893,478,769,12067,124
3669,6,578,1572,422,14073,156
14389,14,491,1459,334,6274,157
20032,44,1297,1366,923,24725,374
30060,59,2016,1172,1315,20096,701
22472,18,561,1327,380,11549,181
34163,42,1796,1099,583,6662,1213
65674,10,66,330,62,2171,4
3637,34,1334,1572,925,33284,409
21075,54,1371,1348,632,23004,739
15830,45,1280,1440,926,19984,354
4075,15,661,1567,471,12790,190
50562,3,48,793,43,2756,5
46561,59,1086,878,984,20964,102
12113,27,1162,1491,647,10799,515
3865,1025,38412,1569,20942,258104,17470
40100,3,141,966,58,4965,83
50538,233,2855,793,2813,52334,42
17739,16,357,1407,266,12898,91
12845,854,15155,1482,9400,49093,5755
13833,16,448,1468,264,19648,184
63870,11,177,382,154,4787,23
60631,77,1193,481,1115,17066,78
23498,38,2068,1309,1250,13140,818
24269,0,77,1294,52,3801,25
31182,115,2076,1151,1336,19691,740
29319,100,8444,1187,3860,31031,4584
24863,115,4141,1280,2577,34483,1564
83,667,24984,1604,12356,71178,12628
6085,7575,435318,1542,104826,1204790,330492
30693,91,1346,1159,927,9708,419
22085,27,690,1332,493,39966,197
10510,428,14667,1504,9837,112599,4830
62797,294,5168,411,4441,39615,727
28674,40,684,1199,483,16108,201
14175,170,2909,1463,1861,40437,1048
37610,0,23,1012,18,2553,5
6539,553,10804,1536,7717,68806,3087
19906,12,695,1369,426,8518,269
10855,354,14186,1502,9367,80370,4819
7059,11022,352937,1529,171857,1283199,181080
62597,7,65,416,57,4474,8
64735,65,1081,350,724,13162,357
9687,650,15759,1509,8971,59883,6788
27953,120,1788,1212,1150,19837,638
17394,6,231,1414,133,6918,98
31568,780,18246,1145,12918,245443,5328
40893,115,2062,953,1662,22070,400
17135,14,336,1418,258,7522,78
10387,82,1435,1505,898,13034,537
62125,1697,32305,429,24915,167839,7390
55256,12,130,646,99,10287,31
5921,30,1086,1544,764,79120,322
10699,0,3014,1503,2080,16828,934
11018,867,27095,1500,13381,90093,13714
19815,180,9448,1370,5715,77828,3733
20332,1,102,1361,79,3767,23
30311,5,373,1167,272,9396,101
38315,41,414,995,309,5786,105
21517,603,21057,1340,11157,94431,9900
36762,219,2808,1037,1657,78192,1151
50351,8,161,799,132,2594,29
11357,147,7749,1498,3842,66274,3907
295,124,8717,1600,3506,179320,5211
13410,102,3567,1474,2319,62397,1248
29555,39,545,1183,375,13626,170
1620,418,14855,1590,6727,126955,8128
8505,1067,25344,1515,16760,89218,8584
11705,10,508,1495,222,4560,286
34277,29,722,1096,547,7173,175
14732,53,2830,1455,2066,26019,764
21572,8226,231629,1339,116551,1267734,115078
40043,1252,42080,967,15569,189634,26511
38151,7658,102280,998,54085,425393,48195
28222,64,1505,1208,921,15469,584
49804,141,2121,811,1968,35506,153
16994,20,246,1421,177,8994,69
25051,83,1912,1276,1259,29485,653
31660,9,309,1144,244,5673,65
46107,15,322,884,232,10973,90
27549,7,533,1221,311,16488,222
21481,55,2195,1341,1587,24085,608
38171,33,421,998,338,8152,83
22722,525,7108,1322,5950,110667,1158
24120,35,523,1297,351,6762,172
53069,457,4411,655,3809,61461,602
58098,17,186,568,164,4911,22
67024,3,81,290,23,3777,58
26657,79,1087,1241,892,19294,195
49398,36,574,823,487,20505,87
23998,62,1488,1300,959,15346,529
30654,49,1044,1160,641,14266,403
9477,36,901,1511,556,13935,345
30282,888,15107,1168,11352,96554,3755
210,1184,36752,1602,17582,76493,19170
50988,262,5196,782,3009,60249,2187
30059,139,2652,1172,1953,51153,699
9755,1244,93167,1509,38260,272286,54907
49349,164,1985,824,1409,33155,576
16317,9,246,1432,153,16425,93
38645,195,5478,985,3192,66491,2286
21839,4975,139138,1336,68406,425999,70732
54702,39,390,665,294,9904,96
34739,69,911,1086,637,16532,274
26207,445,10243,1252,6319,64004,3924
23543,60,1811,1309,1026,39594,785
14855,84,2641,1454,1387,14156,1254
33988,75,1059,1103,873,16223,186
38889,30,719,982,492,12361,227
1630,35,1190,1590,627,19592,563
32968,3,34,1122,18,4617,16
9066,186,6810,1512,3604,41563,3206
30775,55,1750,1158,1005,45853,745
11639,150,6064,1495,4062,43981,2002
37304,137,3709,1021,3069,35870,640
58000,43,449,571,323,9712,126
17714,75,3515,1408,1992,14875,1523
26097,53,4068,1253,2979,9791,1089
9049,82,2359,1512,1748,19436,611
54292,43,596,681,470,10949,126
32320,11,288,1134,210,9717,78
10892,192,5066,1501,3127,35478,1939
4021,29,928,1568,642,17026,286
2202,29,861,1585,625,11170,236
1219,6,674,1593,344,18540,330
24253,4446,152475,1294,78230,646242,74245
48858,2189,40666,840,37399,184235,3267
15145,65,1525,1450,831,8723,694
59611,118,1653,518,1508,34972,145
26253,496,11057,1251,6652,81788,4405
12687,7583,296145,1484,93905,1080019,202240
32404,516,11318,1132,7068,83091,4250
59232,31,617,531,479,15543,138
14760,5,184,1455,130,7460,54
42302,125,1806,931,1266,30201,540
54206,101,1361,681,1058,37521,303
16761,156,3843,1425,2601,32216,1242
19730,6840,194298,1372,82497,461140,111801
44257,18,465,904,384,9862,81
53193,3,67,714,53,4099,14
14618,30,816,1456,575,18759,241
11893,8,422,1493,194,7825,228
64008,30,297,377,258,5895,39
54966,357,4553,656,4138,54308,415
2325,773,24251,1584,15264,69727,8987
9953,232,17210,1508,8762,136163,8448
20499,85,4734,1359,3344,38092,1390
33697,124,3738,1108,1796,23761,1942
42803,22,311,922,258,9656,53
54065,215,2027,689,1437,18967,590
44133,104,967,906,717,24666,250
12071,136,8498,1491,3598,53686,4900
19994,6,275,1367,186,20066,89
60587,18,251,483,184,4326,67
64099,41,264,374,255,4462,9
12703,66,1188,1484,589,19746,599
8343,194,6830,1516,4425,45615,2405
28332,0,58,1205,36,8789,22
20503,35,1529,1359,1057,15043,472
15508,10714,236008,1445,123777,723554,112231
42424,49,454,929,357,4599,97
11772,53,2154,1494,1134,11510,1020
44061,3,39,907,31,3303,8
7027,60,1603,1530,1177,39022,426
46421,43,838,881,660,39584,178
49610,53,787,818,458,10770,329
11176,218,13257,1499,8574,64440,4683
51876,7,168,758,139,7917,29
49921,28,297,809,256,15405,41
12271,31,1235,1489,710,14893,525
27460,39,476,1224,451,12051,25
8890,117,3087,1513,1940,35343,1147
20085,10,740,1365,590,12550,150
4891,42,711,1556,547,16077,164
57963,52,1092,572,817,4822,275
1763,159,5579,1589,3500,46992,2079
23290,11,378,1313,248,5201,130
29556,3,95,1183,91,13633,4
13767,2,220,1469,92,7211,128
10159,223,7736,1507,5064,69934,2672
25122,78,1659,1275,1060,30956,599
32346,53,1913,1134,1277,39916,636
1999,97,2020,1587,1560,65719,460
3840,37,1446,1570,1074,32976,372
52164,71,711,748,594,19859,117
23972,823,19671,1300,9480,116640,10191
18,2135,155359,1605,73136,660813,82223
11541,5,188,1496,109,6867,79
16268,2,375,1433,128,14896,247
18763,4856,190491,1389,107002,685775,83489
33066,29,640,1120,434,20222,206
26203,51,640,1252,410,8354,230
49594,14,615,818,370,32887,245
56809,4,60,604,53,2977,7
34470,41,936,1093,602,11854,334
35195,65,1952,1072,1552,30606,400
34655,100,2699,1088,1873,20195,826
34874,14,714,1083,455,16756,259
23382,37,940,1311,415,8727,525
32329,4866,201688,1134,67739,991115,133949
65240,34,226,341,196,5512,30
44337,97,1354,903,1045,7158,309
11478,347,9939,1497,6185,55610,3754
4319,33,846,1564,638,18976,208
63454,248,6001,393,1968,33824,4033
15528,17,476,1444,378,21093,98
13049,14445,342543,1479,182879,1155856,159664
25769,20,937,1261,523,11438,414
8860,86,3945,1513,1789,41066,2156
67036,15,174,289,167,4144,7
15124,9,548,1450,403,37336,145
37355,442,9527,1019,7142,71295,2385
9704,8,409,1509,259,10082,150
63357,30,1059,396,763,18648,296
22334,6,325,1329,249,18048,76
6550,1,50,1536,41,6556,9
36283,3,60,1048,46,4163,14
51824,24,393,704,293,16465,100
50585,9,121,792,90,9167,31
9816,1,55,1509,48,8868,7
54337,298,4423,679,1650,27145,2773
6930,12,423,1531,297,18405,126
66860,67,1379,295,1241,17108,138
3478,4,89,1574,60,17403,29
31735,87,1187,1142,1061,46920,126
25890,58,710,1258,378,15046,332
42084,2257,39185,930,21983,247838,17202
56125,10,122,624,94,8082,28
48665,0,92,845,53,4283,39
13795,111,1523,1468,933,16805,590
1053,2,88,1594,54,7718,34
59594,139,3509,518,1550,24387,1959
10591,508,10878,1504,6419,47438,4459
25857,76,1896,1259,1165,14727,731
15010,14,199,1452,142,6973,57
18592,14,339,1392,224,17009,115
53602,1458,30969,704,11700,132133,19269
41012,14,461,951,280,8946,181
13969,692,23680,1466,15371,97500,8309
8974,32,844,1513,536,9150,308
30712,23,1327,1159,887,17038,440
1126,11,562,1593,380,18370,182
12057,36,1752,1491,905,37487,847
20360,104,2896,1361,1921,42133,975
16464,2134,70920,1429,39634,305754,31286
18753,481,12773,1389,8781,162924,3992
12691,12,839,1484,459,10247,380
25770,4,262,1261,161,18254,101
18509,29,706,1393,438,9782,268
53875,70,1038,668,869,10733,169
42732,2,80,923,60,10903,20
38396,13,252,992,193,6450,59
58122,239,3547,567,3537,16419,10
1986,44,1261,1587,836,34094,425
24915,35,1162,1279,738,10079,424
59706,16,198,514,196,5975,2
17443,0,0,1413,0,3639,0
57909,6545,116939,571,74618,711088,42321
22928,56,1019,1319,669,26026,350
60706,193,3466,478,2569,15591,897
14726,2,47,1455,43,7913,4
1450,438,12891,1591,6699,77615,6192
6340,12,299,1539,222,20705,77
9944,10,600,1508,353,12000,247
42644,185,7628,925,5256,43046,2372
6074,33,916,1542,728,21313,188
29508,30,1340,1183,762,13017,578
2102,40,1478,1586,1045,29585,433
31246,25,802,1150,491,14036,311
17469,9,363,1413,278,6832,85
517,26,761,1598,478,22955,283
2109,9,423,1586,312,16706,111
16622,45,1686,1427,1129,27056,557
48710,104,1350,844,882,12446,468
47068,4,64,872,55,3781,9
4890,15,1057,1556,670,18625,387
49451,0,0,822,0,3791,0
61933,16,131,436,93,3545,38
32154,137,4258,1136,2588,68356,1670
27242,84,3640,1229,1219,18144,2421
49709,5,92,815,76,11260,16
57282,12,247,591,203,8613,44
3076,11,177,1578,122,15448,55
11221,5,324,1499,173,6063,151
49815,34,344,812,315,4641,29
53966,18,103,692,94,5301,9
56633,91,919,610,762,8225,157
26118,40,1181,1253,767,23340,414
9343,205,4003,1511,2876,25441,1127
25065,23,811,1275,582,34967,229
51806,21,198,759,173,7217,25
51966,18,270,755,240,7594,30
29762,77,1316,1178,831,10400,485
10753,52257,1372220,1502,620583,2369205,751637
34031,1053,18227,1102,12931,77858,5296
5438,5,88,1549,79,4535,9
58087,36,528,568,484,9374,44
15142,135,12378,1450,6763,45161,5615
41273,539,12079,948,8750,110990,3329
68087,4,120,256,99,5124,21
24471,2,226,1289,162,7336,64
5824,15,414,1545,256,6321,158
10087,248,7653,1507,4579,60401,3074
35384,39,396,1070,323,5343,73
23613,207,3588,1307,2559,83145,1029
9279,787,25771,1512,11173,449568,14598
13849,172,7587,1467,4454,59728,3133
11796,13,1788,1494,667,9465,1121
28012,330,8635,1211,3686,98099,4949
18248,147,2898,1398,1984,45200,914
20079,0,137,1366,114,9304,23
22217,145,2768,1331,1691,27498,1077
27204,37,720,1229,467,9756,253
29376,15,431,1186,363,26237,68
34438,1891,41730,1094,26235,245775,15495
50902,953,11196,785,10388,49557,808
61402,14,260,454,249,7806,11
58210,140,4219,564,3039,39675,1180
22002,68,1771,1333,1228,18527,543
15003,178,3468,1452,2496,26070,972
22107,32,815,1332,688,22375,127
26758,2,117,1239,79,5435,38
27827,24,1581,1215,787,38446,794
51511,0,2019,768,1726,9869,293
36222,687,17817,1050,13024,63893,4793
13910,310,10543,1467,5917,122342,4626
26580,186,6413,1243,3676,30624,2737
30789,11,218,1157,144,4542,74
26617,1356,25052,1242,16428,162163,8624
14817,5,274,1454,177,7605,97
27718,9,135,1218,95,3320,40
2605,3,166,1582,117,11680,49
25664,791,14709,1263,9577,94716,5132
68109,31,326,255,269,3135,57
28350,27,1131,1205,510,8014,621
37081,804,20461,1028,15102,101335,5359
23895,9,341,1302,273,35966,68
43289,17,412,915,300,16468,112
34571,31,513,1090,356,10050,157
12770,824,33967,1483,18045,115529,15922
32632,41,709,1128,504,9638,205
18957,85,1034,1386,878,50791,156
38141,301,6840,999,5660,56346,1180
50109,2007,37948,801,21279,126894,16669
15995,13,386,1437,279,12757,107
3306,4335,123650,1575,74359,322715,49291
63916,14,293,380,203,5578,90
58975,89,1147,539,976,8536,171
52199,7,115,747,98,4888,17
56918,3,50,601,49,4604,1
23354,1183,31547,1312,16633,184034,14914
55922,63,781,630,697,10825,84
55644,576,7648,637,5894,50414,1754
34143,21,628,1100,464,16219,164
33090,44,661,1120,590,10460,71
23765,4258,136208,1304,75463,1008190,60745
65213,73,1766,341,1282,24912,484
5677,221,10102,1547,6227,109858,3875
9362,92,2037,1511,1429,35224,608
39370,18,356,976,303,11405,53
66954,6,97,292,73,5678,24
65151,23,367,343,243,8450,124
46756,34,411,875,395,10089,16
39248,5,143,977,125,6293,18
387,541,12366,1599,8335,46458,4031
26759,7,281,1239,178,5863,103
15855,521,12209,1439,7796,152017,4413
38136,38,793,999,706,17745,87
12263,1,391,1489,181,15126,210
24259,13,414,1294,244,9168,170
32776,23,521,1126,329,16948,192
64030,59,366,377,332,6165,34
28709,45,1017,1198,673,9977,344
1389,15,471,1592,339,19441,132
68860,44,785,229,627,11453,158
7583,8486,223900,1523,132136,781755,91764
45530,974,11472,890,10045,169832,1427
11704,320,4636,1495,3275,24924,1361
59235,152,1172,531,993,8879,179
59755,66,677,513,616,10538,61
35013,3,28,1080,23,3442,5
14180,21,1033,1463,579,9434,454
54256,19,195,682,151,4110,44
15764,21,966,1441,718,31233,248
55839,42,312,633,308,18828,4
60660,881,13587,480,11450,108386,2137
37011,15,467,1030,313,10306,154
42925,0,430,920,363,22246,67
27167,25,931,1230,551,6508,380
25340,5,272,1270,182,24570,90
54343,98,1231,679,1175,19586,56
7165,9,316,1528,206,8693,110
25059,0,58,1275,43,6752,15
24395,33,1020,1291,728,13010,292
57362,16,233,590,169,6801,64
38757,38,792,984,643,13412,149
50826,13,174,787,161,6119,13
577,93,4472,1598,2730,51568,1742
36798,147,4255,1032,2426,23586,1829
50583,7,50,792,45,4006,5
30212,30951,629293,1169,293229,1489819,336064
11824,45,805,1494,458,25149,347
37200,80,1434,1024,1323,16640,111
36491,338,4604,1041,3529,32958,1075
17609,8197,224085,1410,131034,784239,93051
21323,38,954,1344,685,12812,269
42104,117,1398,934,1033,14837,365
13791,70,1232,1468,781,7920,451
3200,553,13569,1576,5962,52030,7607
31086,3,51,1152,36,3446,15
13734,25,1103,1469,677,17890,426
13274,862,13588,1476,10418,85290,3170
50486,25,539,795,478,11359,61
54152,85,514,686,459,13491,55
33340,52,848,1115,557,8703,291
15745,2,124,1441,43,2673,81
34970,20,356,1080,236,11068,120
17665,11,341,1409,210,14726,131
49669,552,8496,816,5954,126728,2542
61626,5,42,447,32,1993,10
17439,8,346,1413,266,15080,80
42684,24,415,924,333,8323,82
36703,113,737,1038,599,14320,138
54479,3559,44125,674,32771,262791,11354
53664,352,3046,702,2394,22713,652
24064,0,19,1298,12,4485,7
30602,484,3509,1161,2725,29893,784
46741,1606,34598,876,28795,91885,5803
2260,3228,126550,1585,52053,546051,74497
20707,135,2483,1355,1635,35166,848
59274,112,1206,529,983,9626,223
34177,26,968,1099,585,18207,383
1428,426,26543,1591,13293,246166,13250
31525,18,478,1146,378,9182,100
7440,42,1340,1525,818,17173,522
11534,4014,112252,1496,60289,400421,51963
54744,1391,13349,664,9771,122736,3578
63020,62,856,405,695,5722,161
57155,66,752,595,655,22299,97
54613,135,1895,669,1579,18798,316
52277,689,9721,745,8800,65360,921
56053,25,294,626,229,5981,65
51221,23,343,776,279,3877,64
49756,9277,133786,813,107230,627644,26556
8772,1775,39389,1514,23415,228550,15974
27132,523,9552,1231,6879,100476,2673
52635,120,1508,731,1211,12464,297
8227,211,4672,1516,3276,29629,1396
50913,2,54,785,44,2137,10
36073,210,2674,1054,2566,23126,108
47223,19,627,869,537,26324,90
21836,135,3637,1336,2519,32683,1118
51151,20,252,778,208,6260,44
2766,839,56199,1581,21125,349296,35074
1055,29,693,1594,540,18503,153
37618,40,572,1012,469,18300,103
44014,1853,38545,907,30632,185478,7913
49962,51,520,809,472,13214,48
50357,1009,36408,798,20609,135193,15799
18682,24,842,1391,646,25712,196
10016,8,322,1507,213,9628,109
52283,3699,47986,744,32784,458128,15202
18978,329,7971,1385,5474,59185,2497
23859,3,119,1303,91,11325,28
67478,1268,31552,275,30538,167759,1014
36770,101,1088,1036,799,16787,289
6477,7,388,1537,228,4960,160
57427,219,10305,589,7447,60375,2858
39526,2,41,974,34,1787,7
10719,9,488,1503,329,6481,159
3057,15,628,1578,491,10046,137
53910,55,920,694,729,15198,191
60605,22,175,482,136,4906,39
67963,1,22,260,22,2183,0
35448,121,2602,1064,2080,22635,522
3921,83,2403,1569,1813,38891,590
8756,19,744,1514,475,9693,269
16017,648,22660,1436,12310,147800,10350
63689,34,357,387,353,5993,4
3626,12,268,1572,201,11104,67
34473,194,3627,1093,1680,30901,1947
22071,360,9051,1333,6344,59893,2707
7533,47,3199,1523,1947,71707,1252
4260,5915,191056,1565,87464,323177,103592
10351,43,2109,1505,1318,61040,791
20618,1947,79167,1357,34923,491345,44244
37009,11,191,1030,175,4584,16
15173,14,590,1450,251,18758,339
20222,5,113,1363,82,7260,31
29985,176,7258,1174,5208,23519,2050
18799,10828,308104,1388,168887,722372,139217
10884,8,610,1501,356,20291,254
62388,8,345,422,214,8931,131
2638,19,1645,1582,1114,35055,531
3130,0,154,1577,119,14980,35
9885,148,3421,1508,2139,43824,1282
8730,48,1094,1514,798,26029,296
46152,71,897,884,820,26599,77
20886,55,1557,1352,944,36714,613
90,88,2605,1603,1660,47136,945
13971,260,7889,1466,5431,46999,2458
20424,28,912,1360,544,14155,368
8676,609,42748,1514,19566,312331,23182
21318,26,462,1344,245,13102,217
38229,140,3147,996,2251,49777,896
68588,16,214,238,211,7417,3
64952,11,163,348,152,2866,11
29698,47,3191,1180,1869,21864,1322
3809,11802,704434,1570,310269,2430461,394165
28308,5,223,1206,155,14722,68
22281,33,731,1330,518,11412,213
25510,69,1912,1267,1197,13255,715
26254,47,2451,1251,1482,27394,969
32565,3,119,1130,71,4397,48
60340,1150,13295,492,11113,65636,2182
55441,14,157,643,120,8097,37
23387,296,7066,1311,3191,100068,3875
12298,327,8793,1489,6399,35544,2394
26355,1516,18004,1248,12681,73980,5323
7802,19,738,1519,474,45320,264
399,22,1070,1599,747,23632,323
12438,108,1775,1487,1071,18518,704
61147,20,316,461,310,8739,6
21542,2148,191934,1340,20893,203420,171041
61775,22,270,442,234,9412,36
15918,32,649,1438,424,14438,225
37759,22,367,1008,320,6770,47
5606,76,2458,1548,1586,16766,872
28352,81,1305,1205,741,19967,564
20925,2276,173895,1351,39394,1027244,134501
34354,119,2036,1096,1621,29064,415
37423,3,179,1018,84,2818,95
5578,61,1290,1548,901,35946,389
26067,6,303,1254,206,10890,97
2524,687,34033,1583,18822,82936,15211
33164,6202,116407,1119,81738,385007,34669
66735,24,328,299,315,7111,13
13437,185,2591,1473,1464,20559,1127
4063,25,1415,1567,743,15311,672
29517,47,1869,1183,1082,15206,787
38455,12,238,990,132,4182,106
2002,178,5901,1587,3776,60477,2125
50857,347,3224,786,2327,33160,897
48997,150,2395,835,1917,44183,478
23044,235,4470,1317,3347,34242,1123
13406,372,12897,1474,6367,135108,6530
10874,5,366,1501,183,10815,183
54353,9,23,679,21,3262,2
3097,189,4128,1577,2522,36093,1606
10981,2,236,1501,133,6712,103
10757,14,735,1502,403,12888,332
21079,73,3590,1348,1658,50306,1932
29355,238,4268,1186,2729,36806,1539
13915,5,504,1467,296,9399,208
56222,16,183,621,120,7686,63
67539,28,432,273,334,4222,98
57858,1037,14497,575,9363,117417,5134
52787,146,2504,726,1959,22323,545
67196,57,1356,284,879,19736,477
34335,60,1178,1096,673,31744,505
55361,112,1207,645,880,10990,327
53330,292,3013,711,2624,28740,389
21520,34,796,1340,626,15882,170
54595,50,495,669,417,17272,78
12315,12,469,1488,309,29257,160
17831,25,661,1405,504,9346,157
62144,353,4901,428,3981,53792,920
35177,104,1388,1075,966,18508,422
15873,8,557,1439,102,11104,455
59276,33,427,529,405,10422,22
1862,7,455,1588,320,17801,135
13708,4,377,1469,242,14833,135
29185,1730,35581,1189,17503,111991,18078
7098,11,516,1529,311,35601,205
22623,185,4113,1324,2734,21527,1379
25190,73,1926,1273,1410,45534,516
6474,15,454,1537,339,12922,115
4986,41,965,1555,657,24154,308
20341,148,5112,1361,3535,26451,1577
32712,203,5016,1127,2765,30694,2251
12836,192,3993,1482,2363,31493,1630
12216,4,327,1490,133,9881,194
51140,27,222,778,192,4899,30
2176,579,50094,1585,18461,286523,31633
13167,29,489,1477,266,9318,223
8455,11,414,1515,270,7146,144
64282,0,1206,368,1170,47044,36
11032,47,2157,1500,1035,31719,1122
33421,142,3052,1114,2535,18466,517
22625,223,7658,1324,4566,67648,3092
23280,54,1066,1313,732,16037,334
47781,10,370,862,131,3455,239
28278,35,1126,1207,677,11310,449
14720,43,1780,1455,1284,16446,496
24988,19,439,1277,384,19386,55
63305,11,152,398,114,4588,38
32987,83,2003,1121,1221,17589,782
55398,1992,25750,644,22683,130840,3067
64864,13,192,351,153,7169,39
141,85873,4861309,1603,1463600,10581618,3397709
36023,9,221,1055,190,12001,31
63245,38,395,399,332,5139,63
66796,732,10068,297,8864,40826,1204
17839,5,127,1405,101,6937,26
14950,78210,2113378,1453,863492,5130798,1249886
10512,10,273,1504,178,10341,95
5164,4681,176110,1553,86017,422867,90093
37676,170,6331,1011,4072,33021,2259
31892,112,1507,1123,1102,21143,405
51513,51,1104,768,968,20977,136
65111,2,25,344,20,5558,5
4838,22,1076,1557,782,9559,294
20633,15,570,1356,408,26195,162
63632,11,167,389,145,4353,22
22544,16,1108,1326,835,21521,273
5073,20,508,1554,375,9507,133
5161,29,600,1553,384,13707,216
19060,62,1759,1384,1230,74810,529
34523,12,180,1092,132,9269,48
50073,14,240,805,180,12866,60
63548,9,98,392,90,1865,8
56317,134,1655,618,1576,15121,79
33374,6,262,1115,152,8783,110
36776,739,11179,1036,8665,95150,2514
55098,97,730,652,559,17398,171
24338,35,801,1292,437,7680,364
20443,13,336,1359,261,13214,75
37412,40,645,1015,483,24033,162
34648,19,195,1088,195,7526,0
10124,10,332,1507,179,5660,153
40950,198,3127,952,2585,27031,542
20486,0,111,1359,68,8067,43
1135,33,960,1593,714,23706,246
4227,8,155,1566,105,8263,50
38775,8,183,983,155,16116,28
32007,883,20668,1139,15705,80653,4963
29911,0,360,1175,247,6970,113
6468,422,7456,1537,4898,70860,2558
24124,499,18972,1297,8703,130365,10269
11244,1,149,1499,63,2809,86
2030,12,448,1587,333,21348,115
40222,26,486,964,331,15808,155
17462,39,804,1413,475,14783,329
26272,11,237,1250,144,6912,93
51307,48,831,774,756,25034,75
32254,47,1086,1135,763,30799,323
20698,50,1663,1355,1244,16279,419
28220,67,1781,1208,990,22999,791
63754,46,2052,386,483,22082,1569
21150,51,1700,1346,1303,12993,397
56716,25,240,607,192,10535,48
18217,43,1725,1398,1207,23706,518
58970,100,1614,539,1215,15191,399
23763,45,1411,1304,1006,31218,405
12696,17,1180,1484,532,15422,648
4530,25,587,1561,460,18724,127
20939,497,18644,1351,8905,85136,9739
29218,51,1599,1188,1184,23284,415
20495,69,1097,1359,728,11900,369
31447,189,4914,1147,3079,38027,1835
11564,24,744,1496,448,28766,296
9360,0,1,1511,1,10077,0
53089,77,1568,717,941,16810,627
26810,5,168,1238,112,15279,56
3659,19,424,1572,310,11434,114
5664,62,2608,1547,1632,17486,976
33196,4277,64774,1118,42315,304002,22459
29308,22,592,1187,303,23610,289
13438,2,136,1473,74,6873,62
56055,21,394,626,337,11074,57
19208,183,5984,1381,3877,67177,2107
8286,20,1032,1516,734,23331,298
4882,65,1421,1557,1122,33750,299
30553,44,1602,1162,1159,27899,443
58222,10,135,564,115,9637,20
26873,611,14890,1236,11918,35768,2972
14358,14,553,1460,362,15434,191
50685,815,11580,790,8644,94623,2936
6142,17,605,1541,376,7201,229
14938,130,2627,1453,1710,27330,917
31237,73,1629,1150,836,16799,793
48475,17,360,852,315,6529,45
61432,4,106,453,74,4753,32
107,94,1787,1603,1104,19616,683
46186,34,481,883,374,6725,107
54073,248,3055,688,2375,67826,680
23959,319,11578,1301,8193,42610,3385
41897,81,1825,937,1545,54471,280
19205,76,1317,1381,584,9072,733
28977,27,748,1193,518,4036,230
26246,74,2044,1251,1579,14983,465
47173,1786,28774,869,19341,123246,9433
65281,11,181,340,160,5051,21
66092,0,12,319,7,3546,5
34830,2,128,1084,109,11596,19
23545,20,556,1309,413,9428,143
31955,267,3443,1139,2324,51779,1119
66031,11,358,321,229,7549,129
35941,154,2770,1057,1495,48994,1275
16786,67,1501,1424,1040,40135,461
49249,2,16,827,12,2373,4
6062,72,1389,1542,734,14595,655
14825,95,3032,1454,1882,29374,1150
17654,10,487,1409,340,11829,147
13615,18,1313,1471,690,23873,623
63393,4,43,396,37,2465,6
27621,450,12643,1219,7726,80563,4917
55046,49,426,654,345,5162,81
42850,24,795,921,534,15795,261
4809,93,2477,1557,1746,35726,731
8836,53,1163,1513,793,16784,370
60927,58,715,470,691,15580,24
36317,3443,71623,1046,47755,339712,23868
16506,3906,141060,1429,65506,349186,75554
33140,4,37,1119,33,1994,4
25043,7,124,1276,79,4760,45
22215,2,124,1331,91,4792,33
35813,290,5513,1061,4619,119740,894
13850,5574,150717,1467,69904,494587,80813
10987,41,1228,1501,729,46096,499
61943,7,47,436,35,3291,12
8892,636,19727,1513,9467,130836,10260
28800,82,4876,1197,2386,30904,2490
32624,13,595,1123,340,10003,255
10788,0,372,1502,248,13246,124
37697,262,3317,1010,3124,25874,193
53775,30,644,699,423,9234,221
26775,67,1047,1239,777,12856,270
7486,171,11150,1524,5794,40098,5356
229,45,3078,1601,2005,34352,1073
41606,9,85,942,73,6054,12
32152,5,171,1137,106,11831,65
12701,4,476,1484,222,5647,254
45487,210,2582,890,1668,26355,914
5314,86,3480,1551,2576,50613,904
59490,118,1554,522,1414,23392,140
18791,4,90,1388,66,14499,24
37416,171,2333,1018,1361,17457,972
14925,8,253,1453,127,4117,126
36848,87,2110,1035,1413,36883,697
13140,200,14897,1477,7195,52198,7702
22652,90,2863,1324,1983,32958,880
47919,8,218,861,150,3056,68
23456,52,1000,1310,719,21561,281
26225,165,3349,1251,2940,30023,409
19750,216,4458,1372,3093,46078,1365
15596,140,2349,1443,1695,44303,654
15687,28,1970,1442,1162,22062,808
31553,7,161,1145,99,7590,62
37725,142,2228,1009,2223,24081,5
30407,226,6583,1165,4563,71946,2020
25826,8,590,1260,364,25319,226
30584,60,1267,1162,846,16083,421
33798,61,1122,1107,876,24412,246
23542,53,1095,1309,733,21090,362
49066,6,60,833,53,4665,7
32623,57,753,1129,528,13134,225
36494,2,196,1041,156,7945,40
6748,119,5147,1533,3378,106674,1769
5467,5,160,1549,103,27136,57
3689,49,1043,1571,702,18371,341
37191,103,3066,1024,1882,32632,1184
9245,78,2240,1512,1389,24544,851
17978,676,10244,1402,7189,59004,3055
50324,1373,19191,799,12261,80871,6930
4942,146,7408,1556,2742,50150,4666
61962,233,8588,436,5565,53216,3023
23561,35,545,1308,390,13401,155
17972,27,899,1402,678,17377,221
36467,14,278,1042,238,9738,40
29637,2,171,1181,91,6184,80
12088,43,1491,1491,987,17493,504
37695,126,3335,1010,2615,57656,720
3283,76,2452,1575,1760,24124,692
10103,30,1203,1507,784,22804,419
9752,13448,475704,1509,213477,1974047,262227
33534,55,1306,1112,942,8205,364
29333,15,246,1186,235,9711,11
18710,5,518,1390,361,14610,157
16585,30,624,1428,454,17964,170
12449,179,3602,1487,2204,45663,1398
18207,59,1217,1399,1008,23392,209
9828,61,906,1509,563,10940,343
20235,88,1922,1363,1348,27059,574
58530,112,1434,553,1322,30192,112
20720,40,1123,1355,789,23654,334
31007,21,801,1154,565,8399,236
53808,29,356,698,307,12505,49
7249,57,1635,1526,1064,18378,571
4739,13,558,1558,407,15902,151
30028,19,626,1173,339,8492,287
50726,178,5050,790,3130,67336,1920
24904,59,1647,1279,1207,25686,440
35935,33,723,1058,476,11701,247
3527,6,116,1573,92,10385,24
27157,4,289,1230,187,16603,102
57105,52,1046,596,974,9602,72
27528,27,540,1222,328,5298,212
64936,17,232,349,198,5185,34
52131,35,325,749,242,3418,83
15437,259,8113,1446,6157,76447,1956
28516,56,2311,1202,1469,50823,842
7504,158,4171,1524,3014,38257,1157
35579,3,40,1066,32,4902,8
7871,681,18842,1518,13808,134281,5034
679,1772,101456,1597,61567,315679,39889
34548,52,1411,1091,1149,18627,262
41790,13,335,939,163,5030,172
39873,54,1525,969,958,22185,567
62971,177,3234,406,1855,42295,1379
390,2,222,1599,172,9898,50
5254,10,459,1552,311,18817,148
67019,17,155,290,115,3696,40
53064,16,346,718,216,10841,130
55734,25,375,635,334,8241,41
18970,535,13704,1385,9002,84172,4702
35078,234,5011,1078,3609,82373,1402
20116,33,593,1365,389,19359,204
9201,10163,309054,1512,183797,867740,125257
19338,3,132,1379,90,5600,42
29223,383,5865,1188,4696,25914,1169
13281,1576,69308,1476,34080,373874,35228
35899,1499,35382,1059,27723,214862,7659
59146,487,7136,534,5146,34353,1990
5128,113,3304,1553,1873,24831,1431
6852,8,277,1532,218,7216,59
60034,27,168,503,140,5312,28
17828,50,2059,1405,1301,32755,758
63570,7,37,391,36,3002,1
32891,77,1004,1124,741,11289,263
57834,30,467,576,410,11019,57
50850,16,385,786,229,10376,156
69133,7,140,219,129,8945,11
2946,27,690,1579,473,23616,217
28116,9,197,1210,147,8732,50
16708,74,4435,1426,2844,27553,1591
2294,210,11738,1584,5569,83678,6169
4666,37,2239,1559,1272,40216,967
12528,69,2571,1486,1400,17009,1171
16529,5,315,1429,233,9002,82
49191,47,762,829,608,23541,154
22491,37,1477,1327,1025,12403,452
34862,133,2464,1083,1675,25768,789
334,479,13387,1600,8585,76076,4802
53950,1925,24873,693,21286,141132,3587
39662,10,227,972,116,5128,111
34226,58,721,1098,557,8523,164
59340,2806,48888,527,39204,197098,9684
52833,441,5474,725,4650,100537,824
65676,1,50,330,16,3276,34
6577,9,378,1536,279,15827,99
23599,31,388,1308,298,5616,90
18234,232,4514,1398,3495,49157,1019
55464,27,199,643,180,5003,19
21986,13,600,1334,366,4644,234
45199,43,841,894,659,13924,182
10918,6,222,1501,135,21193,87
3904,106,6635,1569,3199,92820,3436
16745,594,13610,1425,9917,117998,3693
52282,168,2730,744,1812,20853,918
3843,3,222,1570,138,9595,84
28262,182,5449,1207,4003,48958,1446
25136,246,4458,1274,2755,43051,1703
34639,54,1251,1089,957,24122,294
22526,84,2748,1326,1397,66798,1351
49045,171,2458,834,1683,22783,775
12430,206,5384,1487,2692,41791,2692
14113,229,7078,1463,4176,83086,2902
36315,33,339,1047,291,11170,48
6745,1970,47938,1533,28969,355407,18969
57221,350,4154,594,3491,27363,663
36842,9,273,1035,243,20242,30
19375,285,5255,1378,3571,22523,1684
37494,57,1576,1016,1299,28685,277
62493,3037,58044,413,44050,303076,13994
13107,15,1509,1478,637,12745,872
27380,7,487,1226,248,29070,239
59025,3,56,537,29,2331,27
33207,23,498,1118,330,8333,168
24738,45,1632,1283,1133,20190,499
38150,9,170,998,151,12022,19
13129,146,5059,1477,2740,31194,2319
37730,30,620,1009,508,14798,112
3152,127,3342,1577,2184,19465,1158
13136,232,9660,1477,5629,73083,4031
58835,2,28,544,24,4947,4
60436,81,1120,489,920,25025,200
69735,8,258,201,245,5415,13
6478,83,3242,1537,1351,22204,1891
62090,1034,17275,431,15048,136085,2227
58572,31,344,552,302,6506,42
51981,26,475,755,384,13280,91
37927,246,6058,1005,4259,111663,1799
3460,1132,33846,1574,18975,154206,14871
38327,8,187,994,136,6320,51
64228,33,292,370,288,6909,4
24843,193,5723,1281,4054,97172,1669
15744,5,211,1441,149,19937,62
24213,39,986,1295,684,16027,302
37530,12,168,1015,129,6056,39
49404,25,383,823,377,13338,6
3371,35,1097,1575,757,33983,340
7694,88,6427,1521,4397,44914,2030
25804,138,2747,1260,1894,28197,853
47158,93,988,870,727,12375,261
50979,14,168,783,145,7162,23
58631,17,224,550,219,7319,5
1615,8,212,1590,162,9718,50
6433,7,246,1538,174,7599,72
14334,4,163,1460,113,7418,50
24776,16,166,1282,142,12614,24
7606,10,491,1522,293,10569,198
20010,27,678,1367,449,9773,229
30674,38,1887,1160,1009,21092,878
34676,72,1585,1088,974,9530,611
19693,3,70,1372,39,5457,31
29389,18,1136,1185,916,34469,220
25104,72,1611,1275,1005,23717,606
64201,1808,34011,371,22549,261698,11462
26506,111,2131,1245,1432,15644,699
22470,13,1650,1327,1063,36979,587
33668,7,237,1109,198,15311,39
5020,56,1695,1555,1265,26015,430
49432,83,959,822,875,18635,84
34511,6,263,1092,160,11261,103
23486,7,261,1309,195,6552,66
43141,37,902,917,773,11002,129
53651,22,235,702,138,7204,97
34684,26,660,1087,447,35694,213
61378,1,30,454,21,3807,9
24090,434,10203,1297,5748,90820,4455
51871,919,20260,757,9143,89745,11117
3444,13,289,1574,240,11534,49
23168,118,1228,1315,848,15758,380
60765,7,117,476,77,3630,40
35896,29,1145,1059,906,21575,239
30596,3,43,1161,31,3280,12
13806,31,1719,1468,1048,19540,671
5886,13,330,1545,254,4331,76
30501,704,20297,1163,9094,188403,11203
29782,12665,405782,1178,273329,1165213,132453
24656,47,857,1284,643,14027,214
51941,68,968,756,742,14671,226
14645,25,1052,1456,722,25207,330
50444,45,746,796,581,9628,165
11828,94,2824,1494,1702,33737,1122
31020,29,1154,1153,628,14878,526
35546,5,147,1066,104,4389,43
23497,0,0,1309,0,23401,0
27673,364,5725,1218,4113,73725,1612
44882,61,1040,898,749,16163,291
26193,46,1224,1252,758,13730,466
30162,179,2807,1170,1527,29978,1280
3241,38,2342,1576,1237,28898,1105
29384,4,213,1186,157,8268,56
37570,25,637,1013,479,13651,158
1850,16,816,1588,378,18446,438
14249,0,0,1461,0,10460,0
40031,27,424,967,301,11943,123
14776,102,1279,1455,971,18996,308
36889,97,1575,1034,1045,16849,530
40056,16,283,966,247,10192,36
61584,55,756,448,677,12103,79
53085,23,275,717,197,8806,78
16459,6,528,1429,388,21693,140
30172,70,1185,1170,759,18419,426
28796,499,6133,1197,5534,82715,599
40712,362,4726,957,3602,29710,1124
35500,133,2366,1068,1939,13559,427
37667,8,125,1011,116,9968,9
9359,2087,77484,1511,39946,326561,37538
6422,148,3871,1538,2061,28778,1810
50889,28,470,784,367,10047,103
6199,133,3741,1541,2345,28561,1396
7728,113,1803,1520,1097,14277,706
40560,11,156,959,105,8810,51
53201,51,1329,714,407,12280,922
19495,67,3723,1376,2266,46389,1457
30809,22,480,1157,361,17221,119
12485,25,1924,1486,1024,20663,900
35806,100,1829,1061,1400,38291,429
32618,2,74,1129,49,4215,25
4735,978,40339,1558,23005,181338,17334
34058,46,589,1101,418,19563,171
18559,14,546,1393,403,10818,143
3509,9,874,1573,546,18202,328
38076,53,737,1000,718,12813,19
14573,3,303,1457,217,14128,86
50843,5,43,786,34,3434,9
313,215,12120,1600,6514,122614,5606
34982,137,3333,1080,2231,45610,1102
10304,1171,19579,1506,15182,141792,4397
35006,287,6992,1080,5277,77620,1715
29045,107,2876,1192,1904,29715,972
61887,20,259,438,214,8137,45
56720,873,11985,607,9902,151133,2083
26486,2503,58545,1246,40587,309529,17958
6737,31,695,1534,538,16591,157
39349,290,5464,976,4953,42157,511
6127,5,211,1541,165,11957,46
42742,6,180,923,142,7192,38
26568,756,19453,1243,11209,106393,8244
13906,0,0,1467,0,18199,0
42364,340,4495,927,4008,60087,487
596,3308,115485,1598,70740,404191,44745
11676,28,1064,1495,580,27974,484
16416,41,1074,1430,773,32738,301
64506,34,498,362,492,18640,6
36523,4,206,1040,129,20857,77
34710,52,930,1086,636,14245,294
13083,54,2322,1478,1563,26013,759
64010,10,102,377,64,6225,38
13251,21,1185,1476,671,16186,514
50667,58,808,791,678,11238,130
5425,51,3023,1550,1989,67004,1034
19224,17,1277,1381,840,16751,437
32287,21,659,1134,384,10561,275
21044,38,1229,1349,878,33257,351
37297,36,370,1021,287,10508,83
52903,7,100,722,85,12320,15
22018,357,3898,1333,2715,43768,1183
6726,52,2618,1534,1597,42680,1021
54460,38,350,674,336,11582,14
49032,3667,56895,816,45919,388231,10976
33021,36,1018,1121,667,10365,351
42169,10323,248131,933,134261,1137643,113870
58213,183,1259,564,1100,9197,159
40088,1049,26972,966,12875,191601,14097
27513,5,177,1222,126,3423,51
26693,1512,30615,1240,19767,121058,10848
1688,602,12069,1589,8478,50023,3591
33620,46,946,1110,496,24896,450
24740,943,18208,1283,14048,58290,4160
50776,78,1323,788,1000,13611,323
14733,152,3929,1455,2193,32814,1736
15641,3001,68402,1443,49098,337401,19304
34805,1,32,1085,27,2341,5
14153,307,5522,1463,4327,31614,1195
860,6,177,1595,93,10699,84
38917,942,26829,981,12648,187406,14181
11907,184,5426,1493,3037,19294,2389
56582,24,280,611,229,7582,51
5076,351,7226,1554,5238,40157,1988
4801,16,984,1558,633,26993,351
33914,24492,606799,1105,322823,1939087,283976
33161,354,3554,1119,2731,24629,823
35730,90,2540,971,1630,53766,910
27893,5,186,1214,134,15534,52
59456,7,112,523,107,5294,5
27614,1300,43391,1219,31773,207557,11618
18129,68,2336,1400,1098,11822,1238
29557,49,994,1183,705,18677,289
24438,71,2388,1290,1523,66984,865
68164,15,170,253,142,2777,28
58854,42,435,543,364,10569,71
56707,23,282,607,230,8220,52
54905,22,1079,658,850,5418,229
673,38,1278,1597,806,57321,472
10656,130,5487,1503,2466,58592,3021
8190,113,2685,1516,1784,33135,901
52305,8,97,743,79,5015,18
59358,37,506,526,445,9237,61
15205,359,12500,1449,7848,48163,4652
38538,1,23,988,15,1805,8
35736,9,230,1063,165,8149,65
36712,277,5973,1037,4917,42283,1056
49007,144,1920,835,1535,15868,385
27498,105,2976,1223,2054,38385,922
57816,91,1316,577,1247,31803,69
14736,3,95,1455,71,9503,24
3688,21,716,1571,444,17022,272
49946,22,294,809,278,21885,16
9387,1270,51536,1511,29877,326642,21659
63265,75,1206,399,1126,14131,80
9616,15,439,1510,296,6672,143
12604,108,1822,1485,1325,19464,497
47188,8,190,870,164,9203,26
37754,121,3407,1008,2227,32461,1180
52671,102,1046,730,818,11763,228
29067,14,469,1191,301,7703,168
29053,9,756,1192,501,8414,255
27716,73,1617,1218,887,11081,730
49505,67,885,820,625,24913,260
24820,37,849,1281,544,20026,305
48535,33,698,850,450,20257,248
52362,11,149,742,130,8948,19
50935,28,277,784,231,7011,46
35952,93,5311,1057,2619,38346,2692
4473,2185,62169,1562,35878,167688,26291
43709,331,6967,910,6012,62858,955
22170,0,0,1331,0,1324,0
25419,388,11462,1269,8528,100295,2934
58476,6,111,555,86,4176,25
62232,31,536,426,411,10908,125
28215,35,1036,1208,683,19702,353
32412,158,2248,1132,2079,21598,169
55491,11,181,642,142,5357,39
5734,55,1582,1546,1058,14195,524
12705,420,21772,1484,13535,104060,8237
31863,2,72,1141,56,3573,16
5373,32,740,1550,513,16085,227
18685,275,5924,1390,4007,61232,1917
36014,162,3855,1056,3417,31451,438
63287,69,726,398,649,14270,77
51575,815,14503,766,10009,129370,4494
42562,4,81,927,50,3082,31
7162,25,765,1528,388,15240,377
66813,3,23,297,18,3404,5
33799,278,6400,1107,4706,65319,1694
22492,26,651,1327,421,14374,230
58646,443,5579,549,5299,102309,280
36022,31,495,1055,412,9145,83
1883,11,535,1588,234,20975,301
1188,414,9113,1593,4695,31772,4418
18798,55,2136,1388,1553,11680,583
30713,350,8531,1159,6442,60952,2089
11678,234,11042,1495,5987,77255,5055
10163,343,7310,1507,4424,59530,2886
24913,45807,1292787,1279,618314,4842258,674473
19232,0,0,1381,0,9616,0
33043,13,358,1121,155,7215,203
16437,56,733,1430,661,17351,72
54231,14,169,683,129,4254,40
6275,39,573,1540,430,11404,143
2677,65,1632,1581,1056,21221,576
10035,607,9536,1507,7073,40965,2463
53430,12,115,708,100,4365,15
26766,1301,38412,1239,21380,129064,17032
13307,763,18374,1475,13041,139110,5333
59604,11,282,517,125,9274,157
20260,8,251,1363,191,7266,60
26752,84,2603,1239,1834,58806,769
18252,5,104,1398,83,16794,21
2963,10,139,1578,93,5493,46
4428,394,8304,1563,5278,49363,3026
47532,215,5846,866,4371,59442,1475
49942,47,537,809,408,15519,129
65269,51,816,340,789,11949,27
23160,39,2230,1315,1626,43928,604
32334,8,485,1134,267,18424,218
37524,112,1329,1015,1002,14636,327
32155,5294,90709,1136,67142,360637,23567
49492,65,963,821,734,16789,229
35987,4,76,1056,59,5493,17
15621,83,2007,1443,1388,29503,619
16026,23,1176,1436,751,19967,425
20481,24,550,1359,410,7941,140
28833,25,1028,1196,683,34179,345
29167,7487,135158,1189,73936,516107,61222
60632,40,704,481,463,6360,241
28966,52,2286,1193,1400,35859,886
65779,7,81,328,77,7354,4
29455,5,225,1184,148,7782,77
35737,0,653,1063,562,3698,91
26450,49,814,1246,540,17162,274
59272,522,6769,529,6272,55524,497
13903,257,9179,1467,4009,47110,5170
31945,74,2234,1140,1343,25270,891
35599,14,266,1065,227,9687,39
28527,451,19652,1202,10128,51508,9524
8383,137,5587,1515,3575,41023,2012
2199,17,380,1585,294,59297,86
50042,78,739,806,702,20099,37
58722,22,217,547,168,6927,49
29032,12,336,1192,194,8390,142
53856,17,333,696,299,8849,34
65874,20,655,325,550,12964,105
20309,71,1711,1362,1212,28105,499
23092,65,2009,1316,1374,36752,635
2040,15,681,1587,479,16457,202
55647,17,178,637,133,10386,45
24837,240,5056,1281,3682,46132,1374
18530,107,3185,1393,2404,38590,781
16214,1125,20788,1433,13763,103422,7025
34752,120,1754,1086,1413,9103,341
31836,11,670,1141,321,12781,349
19468,93,3373,1377,2420,21619,953
21246,2,156,1345,101,6237,55
20082,62,1006,1365,613,18529,393
62886,286,4359,408,4308,34888,51
31992,57,1026,1139,739,15936,287
31650,80,2969,1144,1842,14772,1127
56504,25,456,613,236,4037,220
23392,100,2778,1311,2144,19728,634
61719,1023,31044,444,24949,129762,6095
2824,3,302,1580,158,10986,144
33817,13,1003,1106,731,25185,272
13991,19,526,1465,347,13971,179
62062,30,572,432,395,12274,177
62513,117,2241,418,1458,21889,783
37867,1110,34394,1006,15654,257703,18740
35868,37,522,1058,375,5944,147
18079,8,132,1401,100,11056,32
55745,8,182,635,182,6338,0
3950,7,929,1569,146,29796,783
15455,93,2560,1446,993,52032,1567
17648,398,6319,1409,4432,64117,1887
42572,32,852,927,719,19227,133
15443,29,887,1446,506,7987,381
4744,471,37794,1558,21783,243610,16011
43857,27,331,909,295,8919,36
37136,39,1344,1019,909,17213,435
25239,575,7301,1272,5050,50821,2251
46445,107,1528,880,1504,20519,24
26199,20,568,1252,409,26237,159
2720,76,3616,1581,1916,26644,1700
9247,14446,444027,1512,227021,1543361,217006
1401,48,1534,1592,1075,23859,459
27127,4,317,1231,194,10168,123
25590,145,7109,1265,3902,69913,3207
63157,23,185,401,165,8877,20
27270,109,2079,1228,1395,14990,684
33370,398,29780,1115,4464,37088,25316
67741,626,7580,267,7346,43231,234
35244,89,945,1074,756,34284,189
6197,21,472,1541,375,9496,97
30111,3,234,1171,124,4420,110
28718,2,476,1198,274,12249,202
16594,0,0,1428,0,9808,0
26690,8,109,1240,76,5222,33
53745,1299,17378,698,13787,140771,3591
42203,12,274,933,200,8354,74
22642,126,1905,1324,1282,13901,623
58478,2719,89473,551,45533,280306,43940
16130,271,7910,1435,4820,134933,3090
49161,252,2480,830,2226,29876,254
32852,37,1508,1124,986,14131,522
4841,7,400,1557,194,7073,206
10807,92,3765,1502,1850,13898,1915
29377,136,4296,1186,3025,70535,1271
678,73,1517,1597,1112,28168,405
7729,242,3980,1520,2884,19943,1096
64333,0,49,367,44,3146,5
17373,1,70,1414,56,6494,14
28119,125,3331,1210,2004,21584,1327
59652,46,878,516,611,16116,267
61110,1140,17558,463,15303,56552,2255
42153,15,256,933,181,12945,75
15045,631,34839,1451,15468,206362,19371
178,73,6882,1602,3437,20183,3445
33179,548,18149,1118,8875,169151,9274
30741,263,10037,1158,3898,64586,6139
21018,95,1566,1349,1117,17103,449
38866,4,104,982,91,8366,13
15753,24,934,1441,595,21283,339
39804,2,76,970,45,5203,31
64826,18,251,353,236,10122,15
14363,165,2381,1460,1763,30450,618
9854,6,292,1509,207,7035,85
58034,13,188,570,175,6273,13
30961,6,304,1154,169,11042,135
63045,8,190,405,103,7600,87
22990,72,1814,1318,1457,56517,357
26561,77,2984,1243,1874,23553,1110
4471,480,52132,1562,17279,166360,34853
30542,14,197,1162,113,6961,84
19531,3,121,1375,58,9434,63
55891,31,163,631,141,3995,22
35733,259,4089,1063,3122,41663,967
6776,7,111,1533,87,12139,24
2708,24,892,1581,545,20096,347
5446,4,394,1549,294,7475,100
15624,15,985,1443,543,14039,442
48701,342,5903,844,3709,40307,2194
28147,6641,260984,1209,106343,862690,154641
55965,88,667,629,582,15155,85
48231,31,496,857,468,9470,28
5979,32,1190,1543,858,35620,332
53892,88,2212,694,1585,18846,627
63409,26,234,395,193,4854,41
35750,70,783,1062,522,21911,261
49299,115,1497,825,1277,17228,220
62572,69,1089,416,986,16180,103
27508,31,657,1222,371,6897,286
36458,39,1247,1040,632,34912,615
51348,18,608,772,524,12133,84
26999,24,1060,1233,874,18052,186
31388,237,5433,1148,3493,42726,1940
29745,155,5923,1179,3074,34427,2849
67194,82,1390,277,1345,14345,45
20622,87,2973,1357,1621,28518,1352
21635,0,36,1338,23,2770,13
40683,503,11549,957,9640,58274,1909
17492,15,286,1412,227,8763,59
20457,18,659,1359,452,14745,207
56058,38,534,626,368,7119,166
5808,3,183,1545,86,3250,97
18059,746,18480,1401,13644,164715,4836
64198,64,554,371,535,14925,19
28132,8,562,1209,384,21575,178
48342,55,868,855,598,11178,270
56670,1695,44939,608,22578,188266,22361
40592,2819,39507,958,24695,231043,14812
20875,41,1563,1352,1075,19606,488
57565,13,150,585,137,3397,13
59536,4,53,520,42,6439,11
54621,54,536,668,396,16536,140
3131,136,5418,1577,3466,73923,1952
11405,318,11640,1497,7545,35524,4095
52334,25,368,743,293,11417,75
65987,16,330,323,304,3489,26
28043,472,22639,1211,8529,142984,14110
51179,103,1879,777,1548,34633,331
49996,345,3756,798,3097,34500,659
3276,7,544,1576,372,34075,172
67121,0,15,287,11,7298,4
65234,14,235,341,182,6806,53
23294,15,356,1313,228,5560,128
57483,33,407,587,300,9226,107
40610,526,8838,958,6699,99411,2139
56573,169,2693,611,2046,21140,647
16310,9,269,1432,215,5813,54
55507,86,1239,641,1157,15653,82
4082,204,5916,1567,4323,27155,1593
2987,0,76,1578,57,7322,19
5430,6,167,1550,110,6428,57
62610,63,731,415,726,12606,5
63100,0,36,403,32,2369,4
29896,8,144,1175,139,13694,5
64972,2,20,347,19,2074,1
11077,103,3184,1500,1992,19591,1192
21811,6,176,1336,126,3588,50
4858,46,823,1557,594,9990,229
50977,304,3265,783,2495,29730,770
56139,31,391,624,341,14518,50
56723,12,223,607,161,7949,62
61221,8,106,459,86,4784,20
39802,26,330,971,322,10554,8
46712,211,3542,876,2938,93146,604
62673,49,628,413,541,13655,87
52580,20,403,734,347,10792,56
65136,103,736,343,731,7232,5
64792,0,43,354,33,4279,10
26737,20,539,1239,325,14893,214
32563,220,3920,1129,1386,21073,2534
792,3,301,1596,239,9856,62
34983,211,2827,1080,2268,72491,559
54496,7,132,673,105,6301,27
22937,4805,160169,1318,100179,714242,59990
53510,3,76,707,62,4491,14
21114,735,22988,1347,13574,133044,9414
17916,721,15700,1403,8404,134799,7296
16658,2443,60827,1427,41206,512261,19621
15634,53,741,1443,552,23090,189
33630,23,328,1110,277,4000,51
37393,20,391,1008,334,16251,57
30810,98,2569,1156,1924,28375,645
57921,13,183,574,145,6594,38
31068,19,967,1152,373,9626,594
30981,9,487,1154,264,10981,223
42001,343,5973,935,5043,106474,930
65527,939,19614,335,19018,111779,596
44831,12,236,898,198,6285,38
56671,12,233,608,209,10733,24
51671,1,54,763,41,5789,13
54127,301,4486,686,3783,41732,703
13305,239,7677,1475,4228,57476,3449
17143,28,627,1418,503,10032,124
7137,75,2807,1528,1890,50782,917
29429,88,1325,1185,906,11432,419
44818,439,6468,898,5709,84036,759
24085,100,2894,1297,1754,32194,1140
25835,185,3262,1260,2335,29501,927
60644,68,1196,480,1062,47944,134
43689,106,1759,910,1463,15468,296
50035,87,1080,806,884,18012,196
58412,23,181,557,148,6105,33
21726,48,1012,1337,720,11688,292
20546,36,1099,1358,801,53053,298
32321,7,219,1134,137,9410,82
60622,11,183,481,140,11867,43
39071,205,4838,979,3821,92871,1017
6186,184,6557,1541,3891,45439,2666
15290,1,91,1448,65,4351,26
5397,425,12370,1550,8259,141521,4111
58425,39,490,557,343,12043,147
25903,96,2587,1258,1758,12130,829
7819,303,12869,1519,7203,92542,5666
1317,42,2169,1592,1315,14466,854
17130,178,4646,1419,3515,33336,1131
21560,6,1132,1339,780,19186,352
58242,417,12037,563,7420,50919,4617
22257,64,951,1330,866,24375,85
53794,24,185,698,156,10001,29
14430,101,1797,1459,1317,26973,480
12446,0,0,1487,0,9900,0
34080,384,9454,1101,7445,70833,2009
34205,61,816,1098,644,17051,172
30121,2460,35188,1171,27953,139086,7235
11173,6158,443191,1499,169620,985029,273571
12377,283,8911,1488,4968,116579,3943
31193,63,1265,1151,691,12104,574
11906,12,485,1493,264,6721,221
31507,19,307,935,277,5934,30
28369,53,1630,1205,1022,24799,608
32869,14,380,1124,171,14098,209
1175,56703,1730952,1593,650963,3832699,1079989
15554,1,129,1444,82,20944,47
53557,488,5705,706,4221,60555,1484
22032,65,2066,1333,1277,18475,789
15440,14,544,1446,372,8974,172
42688,10,222,924,175,4005,47
23431,1053,11552,1310,8396,72969,3156
51397,0,31,771,30,2936,1
48810,23,309,841,259,16458,50
16630,40,1270,1427,700,9662,570
39757,4,114,971,87,9385,27
63779,8,95,385,80,4741,15
17134,120,2796,1418,1990,22436,806
5279,25,1101,1551,633,19918,468
49808,1002,20181,812,15507,66257,4674
4959,8,263,1555,195,14846,68
20518,48,1196,1358,844,21086,352
24659,369,5172,1284,3344,53464,1828
55613,1019,14643,638,11864,63987,2779
1985,26,844,1587,504,34545,340
11821,267,7034,1494,3443,30265,3591
23739,41,1402,1305,971,23636,431
21729,7,285,1337,223,4875,62
9942,29,1024,1508,578,8160,446
12075,3,173,1491,83,10817,90
25048,56,1082,1276,669,25542,413
17601,114,1653,1410,1421,13793,232
41842,23,2082,938,896,13890,1186
28146,45,860,1209,626,14430,234
2205,14,1286,1585,840,102263,446
66162,6,85,317,74,6549,11
52316,51,646,743,371,30563,275
51865,47,641,758,509,13906,132
27752,20,483,1217,346,24143,137
3010,144,3688,1578,2003,36704,1685
49460,42,557,822,468,14111,89
7101,7,322,1529,198,12119,124
5122,9,132,1553,84,20896,48
36385,167,2171,1045,1816,25233,355
33423,56,1472,1114,1004,27312,468
36710,1,53,1037,35,3545,18
31087,3458,65523,1152,43534,172804,21989
10357,2404,112194,1505,52945,544812,59249
38225,9,229,997,206,7715,23
60816,0,0,298,0,3886,0
34750,9,263,1086,65,6018,198
55653,39,448,637,429,8869,19
41308,397,5241,947,4080,20207,1161
67674,15,406,269,296,4387,110
33460,24,1124,1113,644,13487,480
8548,116,2031,1515,1380,11490,651
15720,8,823,1442,419,15221,404
50848,143,3288,786,2436,14870,852
47123,140,2600,871,1888,17870,712
2142,54,3265,1586,1442,31149,1823
3855,104,3849,1570,2154,43421,1695
52357,19,359,742,327,17275,32
6184,59,1747,1541,1175,10287,572
1069,473,9823,1594,7203,111512,2620
55699,6477,160354,631,134605,456555,25749
32424,338,12921,1132,5623,80681,7298
30279,1599,27925,1168,17634,161486,10291
38566,417,5957,858,5576,36111,381
41859,33,371,937,287,10208,84
20452,9,216,1359,144,12393,72
32305,60,789,1134,554,12036,235
26304,33,1499,1249,869,19645,630
51112,982,16834,779,11482,152294,5352
45348,57,751,892,589,24639,162
34247,8,484,1098,239,10153,245
20862,238,6733,1352,4838,48645,1895
12103,52,1118,1491,644,15361,474
28277,34,1170,1207,642,23813,528
45905,40,1166,886,607,9210,559
33351,41,737,1115,520,9230,217
54344,1384,15278,679,13573,131380,1705
36778,1,332,1036,106,14661,226
27674,10,210,1218,119,6041,91
7280,21,479,1526,336,13342,143
319,116,6013,1600,3451,81218,2562
51613,33,349,765,296,10960,53
15150,6,566,1450,462,10226,104
55502,244,4177,642,3163,32762,1014
11136,27,907,1499,513,16208,394
60357,18,204,491,161,6207,43
47989,5667,103834,860,62552,692360,41282
801,638,26346,1596,11964,117408,14382
65839,1687,24446,326,19708,187976,4738
57095,9,70,596,61,5433,9
20451,61,667,1359,464,11112,203
38504,16,165,989,162,5683,3
48069,40,349,859,223,4184,126
12492,176,10955,1486,4907,53973,6048
28315,182,2981,1206,1334,20278,1647
57770,31,605,579,543,17045,62
53684,38,429,701,311,12269,118
69349,3,24,213,21,2141,3
14135,441,3518,1463,2638,33882,880
1832,53,878,1588,650,11332,228
17107,49,1832,1419,1310,28650,522
40110,84,1626,965,1440,23390,186
16426,12,259,1430,198,5642,61
56742,21,433,606,230,11041,203
12524,24,995,1486,598,31476,397
20112,39,1351,1365,931,79116,420
10954,9,213,1501,111,5360,102
31339,20,537,1148,261,6853,276
42734,43,537,924,502,16062,35
4944,12,249,1556,143,21798,106
64167,30,186,372,179,5968,7
61957,17,194,436,160,5491,34
25370,2412,71489,1269,51117,308140,20372
35095,50,1541,1072,922,16600,619
1857,16,376,1588,267,9388,109
18608,47,1155,1392,847,17495,308
29545,135,4418,1183,2555,24563,1863
31714,28,459,1143,330,6319,129
64141,290,4672,373,3432,31030,1240
70168,3,34,186,31,3993,3
8581,7,339,1515,160,5620,179
8582,0,0,1515,0,7854,0
33169,302,4945,1118,3184,63343,1761
29108,4,307,1191,190,6576,117
1437,31,718,1591,542,12668,176
33081,105,2504,1120,1834,66213,670
34179,13,483,1099,317,6288,166
9237,24,456,1512,279,4675,177
31223,91,1991,1150,1230,28434,761
40077,24,287,966,173,3600,114
59174,4777,91603,533,49987,342787,41616
6029,49,1808,1542,1066,41528,742
13921,199,9634,1466,6292,97076,3342
15757,60,1582,1441,1040,21974,542
35470,20695,393331,1068,206921,1900806,186410
23869,39,971,1302,682,20642,289
23357,0,0,1312,0,3204,0
34129,103,2484,1100,1819,23427,665
27021,10,396,1233,233,10079,163
15719,490,8695,1442,5158,83183,3537
60949,115,1343,469,1218,11283,125
16918,27,1000,1422,696,38096,304
58312,12,345,561,305,7444,40
55357,29,871,645,513,23148,358
65617,12,129,332,128,6850,1
59971,3,70,505,39,8986,31
35265,40,930,1073,672,20200,258
35402,15,306,1070,193,3728,113
6288,52,1926,1540,1307,18025,619
30796,14,469,1157,289,7576,180
31323,1,118,1149,77,4915,41
32171,21,621,1136,364,23087,257
21456,470,12599,1341,8590,83051,4009
25425,28,1287,1268,896,17550,391
59185,96,940,533,815,9529,125
32108,123,1571,1137,1150,11214,421
34181,142,2604,1099,1905,22188,699
2046,351,7891,1587,4506,89037,3385
30073,710,12722,1172,9408,89016,3314
7791,97,1565,1520,1004,14041,561
50236,12,170,801,139,2650,31
19857,2,189,1370,139,10020,50
26080,139,4824,1254,3484,41209,1340
67190,27,702,284,435,22088,267
50163,3,81,803,60,6461,21
3690,21,794,1571,377,19567,417
64546,26,833,361,676,12712,157
52110,27,303,750,256,5472,47
21528,37,2644,1340,1729,22740,915
20676,13,561,1356,407,9277,154
20796,53,1401,1354,1065,28716,336
51802,22,188,759,169,10951,19
28850,1794,39083,1196,19397,159672,19686
2600,167,3563,1582,2307,28061,1256
1207,5,639,1593,415,10408,224
35716,14,244,1063,191,8949,53
14786,718,15490,1455,12313,129991,3177
23146,48,2790,1315,860,27513,1930
4720,113,4577,1559,2658,28877,1919
60789,1454,28506,475,19526,166101,8980
17183,0,279,1417,196,9235,83
24848,38,568,1280,509,8224,59
11009,326,10397,1500,7214,43024,3183
33684,67,1323,1109,1016,22437,307
21054,2,82,1349,64,10739,18
40571,69,1282,959,889,13573,393
12632,23,823,1484,523,9759,300
52692,28,427,729,355,14790,72
19237,54,1319,1381,651,10124,668
34903,203,3931,1082,2952,81414,979
22,80,2885,1605,2126,34137,759
24216,38,1089,1295,727,8170,362
21355,8,119,1343,85,14372,34
14511,5,348,1458,250,11708,98
24497,89,1883,1288,1168,13161,715
33126,53,1237,1119,830,18195,407
10933,33,1828,1501,814,13420,1014
14758,84,1243,1455,862,12755,381
15901,3,164,1438,120,13397,44
3818,2,267,1570,215,22488,52
11527,120,3869,1496,2474,23953,1395
60027,10,152,504,149,10419,3
21807,98,3730,1336,2410,52087,1320
28992,270,5287,1193,3156,28558,2131
35361,364,9275,1070,6243,76564,3032
12259,542,41357,1489,14618,249144,26739
812,15,430,1596,329,28842,101
62789,70,880,411,841,16508,39
6975,174,3616,1531,2383,60812,1233
41047,147,4600,951,2641,24003,1959
18749,8,581,1389,364,18855,217
19768,134,4835,1371,3607,46105,1228
30053,95,2682,1172,1894,22366,788
53876,198,2819,695,2253,23581,566
34730,571,12075,1086,9727,71797,2348
10659,13,760,1503,462,11331,298
56901,45,560,602,479,10519,81
43729,134,2045,910,1705,9846,340
13556,2,149,1471,82,15026,67
60145,120,1808,499,1797,14844,11
17416,49167,1144461,1414,620145,2788933,524316
26813,36,1120,1237,637,29072,483
28604,7,167,1201,160,25204,7
2173,62,2586,1586,1484,45309,1102
3140,25,691,1577,520,27387,171
53147,61,538,715,501,8286,37
49986,10,99,808,74,4009,25
49118,6,115,832,104,10316,11
48892,31,303,839,274,5850,29
69333,87,1568,213,1320,12471,248
18629,82,3501,1391,1992,58777,1509
21855,50,1340,1335,898,24887,442
14467,49,1179,1458,622,11969,557
14435,1,131,1458,71,5692,60
10167,3,221,1507,138,8114,83
57966,17,241,572,197,6314,44
60931,9,209,470,155,4677,54
17862,8,191,1405,124,6980,67
61375,16,213,454,139,4118,74
18999,2,69,1385,52,17038,17
52841,5535,76946,723,63651,508388,13295
22646,251,5778,1324,3677,143522,2101
49858,2,18,811,15,2489,3
49888,695,9041,810,5860,44039,3181
17448,4,232,1413,194,29736,38
2308,70,3033,1584,2165,28415,868
51194,216,2007,776,1588,56688,419
48934,251,3120,837,2348,29046,772
8194,1,167,1516,84,18578,83
27544,12,496,1221,308,26741,188
35398,67,1604,1070,1159,14008,445
20275,2,119,1362,93,5915,26
21133,21,937,1347,556,23289,381
37160,9,128,1025,105,9113,23
51339,4003,57794,773,41508,162352,16286
1454,30,1561,1591,967,13866,594
49908,35,316,810,271,10294,45
27911,49,1871,1213,1329,31629,542
9022,360,12035,1513,6862,64077,5173
26781,12,199,1238,132,8271,67
32796,35,878,1126,435,9038,443
66202,12,132,315,111,4612,21
60018,233,3801,504,2593,27762,1208
30048,83,3118,1172,1392,17153,1726
21613,39,1109,1339,658,28969,451
15756,38,1413,1441,974,18299,439
30268,64,1540,1168,1059,28508,481
8705,66,2645,1514,1209,24921,1436
34346,10867,333767,1096,166053,855483,167714
1629,6,140,1590,110,16501,30
42724,24,398,924,327,6079,71
15105,21002,1353992,1451,480454,4104774,873538
6976,148,9983,1531,5863,67360,4120
63581,391,5255,391,5211,70761,44
21065,189,2328,1348,2000,23222,328
19230,1,158,1381,98,4248,60
58422,21,321,557,271,7199,50
54388,17,207,678,135,5152,72
11946,474,28167,1492,12582,177979,15585
38235,5,126,996,72,2185,54
40970,552,12854,952,5345,66901,7509
67788,31,467,265,460,8393,7
3769,12,452,1571,313,20501,139
31286,112,3528,1149,1941,16527,1587
28724,210,4931,1198,3014,73247,1917
5221,14,421,1552,307,8822,114
57576,23,344,572,296,21647,48
31155,12,179,1151,139,11341,40
12908,179,11650,1481,7607,53322,4043
13548,351,6884,1471,4412,47768,2472
17146,36,906,1418,651,22314,255
34469,512,9318,1093,5544,55903,3774
3300,550,16514,1575,8843,98923,7671
50314,51,937,799,785,15594,152
17113,4,198,1419,161,6939,37
34532,30,985,1092,644,11029,341
16856,67,1128,1423,738,19878,390
59653,61,999,516,849,13580,150
32478,22,1163,1131,803,11815,360
28895,15,959,1195,617,11497,342
9748,29,718,1509,522,14106,196
63177,667,9644,400,8470,61715,1174
12118,92,1157,1491,625,11709,532
56618,50,412,610,345,7064,67
36341,19,342,1046,295,8231,47
27221,125,2826,1229,1977,71853,849
57519,43,473,587,337,3960,136
63602,33,387,390,287,7321,100
13637,990,23514,1470,13958,143506,9556
21487,13,810,1341,582,17457,228
22831,2,282,1320,197,20649,85
19891,7,170,1369,131,28341,39
62616,6,88,415,83,3629,5
910,18,896,1595,474,17084,422
61269,3,76,457,75,1827,1
28862,135,3471,1196,1958,50742,1513
38172,16,560,998,416,16965,144
55094,90,1391,653,1164,15771,227
67058,13,173,289,171,5227,2
5543,7,278,1548,179,10146,99
39413,47,1082,975,812,13107,270
35464,92,1186,1068,895,15213,291
38737,838,12924,984,8942,48162,3982
37642,192,3952,1012,3214,84179,738
11240,116,6052,1499,3544,65322,2508
19942,3,162,1368,113,9511,49
10715,19,621,1503,449,6968,172
13262,16,346,1476,171,7586,175
34192,368,7949,1099,4350,99500,3599
24089,8,247,1297,174,12306,73
12957,864,46425,1480,26201,279931,20224
19801,43,1570,1371,1079,11505,491
60232,95,1205,496,1071,18801,134
15439,604,15976,1446,11286,127855,4690
31315,17,334,1149,177,12803,157
51601,164,3614,765,2939,44708,675
37598,83,1070,1012,595,20276,475
23854,323,7221,1303,4387,40314,2834
60038,12,208,503,199,7021,9
22340,35,297,1329,199,9160,98
6634,16,521,1535,358,13223,163
19402,34,661,1378,487,19944,174
35375,23,498,1071,471,15658,27
12798,16242,810016,1482,334159,1718371,475857
49633,346,10766,817,8186,164693,2580
3731,18,1026,1571,527,49194,499
30449,18,682,1164,436,6749,246
58384,6,40,558,27,5928,13
5387,2,22,1550,21,3030,1
44274,25,295,904,264,8721,31
54689,310,2674,666,2224,39586,450
64529,2,66,362,53,10685,13
18062,3,131,1401,95,7501,36
12557,80,1970,1485,1086,19908,884
22012,33,1061,1333,687,25391,374
27505,407,17494,1222,5794,134072,11700
21118,164,2961,1347,2268,20633,693
14725,118,3190,1455,1818,65965,1372
17577,353,11043,1410,7013,41719,4030
4058,169,2954,1567,2677,18632,277
23910,11,180,1302,128,12291,52
60492,172,1506,486,1500,20076,6
65133,5,72,343,50,4717,22
66568,135,1360,304,1127,21095,233
12584,25,669,1485,420,25979,249
50832,6,67,787,57,2784,10
10255,510,11730,1506,6455,69759,5275
43301,41,906,915,721,10103,185
59749,16,157,513,134,9736,23
4142,4752,275599,1567,140050,1106773,135549
38543,36,636,988,462,12088,174
8123,84,1587,1516,1091,22877,496
49543,232,3347,819,2040,28539,1307
12591,20,473,1485,236,16012,237
32393,4,266,1133,165,3224,101
69745,1,18,200,16,2344,2
58471,211,3524,555,2893,35030,631
12760,117,3222,1483,1179,28759,2043
10437,234,6431,1505,3182,64306,3249
65529,9,83,334,59,2507,24
4310,15,379,1564,205,4374,174
30475,26,1062,1163,625,11112,437
4751,16,386,1558,273,12251,113
29776,50,2421,1178,1554,57483,867
10127,64,2118,1507,1329,18553,789
55802,97,1705,634,1308,25531,397
20926,2031,32946,1351,21254,101623,11692
66137,4,76,318,61,4229,15
49201,131,1521,829,903,17905,618
41009,379,4502,951,4334,55406,168
6566,294,6324,1536,3152,50317,3172
14556,0,0,1457,0,7588,0
36099,496,6745,1053,5740,64139,1005
11955,29,641,1492,321,6414,320
24794,485,12902,1282,8926,112246,3976
41307,27,488,947,404,9496,84
57238,48,436,593,367,7078,69
6018,11,230,1543,180,9328,50
62031,24,384,433,295,10384,89
18500,67,1667,1393,1212,46503,455
68072,2,87,256,73,5486,14
32554,2364,54046,1130,27537,330149,26509
6680,18,387,1534,296,7701,91
56977,33,585,599,451,10658,134
8035,342,10201,1517,6808,68092,3393
63120,75,793,403,724,14642,69
11988,24,735,1492,259,10511,476
38350,69,854,994,709,17981,145
24039,254,8284,1299,5784,73112,2500
68477,68,1342,243,830,10156,512
61777,53,1524,442,1204,41961,320
25387,534,9780,1269,4299,37168,5481
3609,8,212,1573,167,10361,45
8561,251,11494,1515,5316,118872,6178
21832,44,597,1336,466,13369,131
24444,3178,86758,1290,48167,494281,38591
13732,3813,109051,1469,56048,409423,53003
17365,136,2775,1414,2081,16016,694
8729,870,41453,1514,21588,171140,19865
27930,253,7953,1213,5355,58609,2598
18687,132,3339,1390,2354,38684,985
12837,12,449,1482,231,6562,218
24003,72,3393,1300,2252,53469,1141
31552,70,2384,1146,1679,43056,705
42392,424,5853,930,5390,35350,463
19355,47,949,1378,689,19769,260
37942,1355,22337,1004,19971,206810,2366
230,2,150,1601,96,12419,54
68654,44,598,236,507,9601,91
16621,203,4275,1427,2600,32999,1675
18074,15,993,1401,282,25659,711
16747,12,458,1425,290,19608,168
60612,82,1051,482,1027,15099,24
35274,16,445,1073,323,13425,122
59217,0,3,531,3,1859,0
16956,27,1867,1421,1350,14251,517
34540,4,108,1092,66,5966,42
49696,115,1535,815,1417,22183,118
20344,48,1251,1361,983,29353,268
9895,255,7216,1508,4601,73578,2615
28417,164,7406,1204,4709,23373,2697
55927,115,1344,630,1239,24505,105
11387,267,10329,1498,6291,130132,4038
40209,384,4257,964,3224,40004,1033
50485,15,238,795,189,4654,49
65242,5981,92500,341,88637,769887,3863
34834,9188,207000,1084,131403,883733,75597
58691,25,271,548,246,8022,25
68418,53,534,245,523,6747,11
1239,137,2951,1593,2271,71202,680
1383,15,353,1592,267,29175,86
31972,149,2990,1139,1849,22294,1141
51400,19,341,771,231,9008,110
2361,71,1208,1584,931,35067,277
12580,1319,22866,1485,14759,81660,8107
35163,134,2744,1076,2244,48709,500
36510,35779,780776,1040,447796,2453360,332980
59881,9,70,508,69,4364,1
1451,337,20172,1591,9708,96512,10464
57599,176,2311,584,1845,20837,466
30300,55,1597,1167,1145,17280,452
1202,21,642,1593,415,15748,227
25428,83,1590,1268,855,22682,735
22597,9,234,1325,171,10377,63
15695,0,0,1442,0,5465,0
8323,256,13067,1516,7648,63045,5419
17650,15,432,1409,288,19130,144
51080,71,877,780,677,13843,200
32079,33,802,1138,506,31053,296
12314,195,3473,1488,2080,22922,1393
38374,924,13829,993,11731,67456,2098
7300,371,14643,1526,5661,86143,8982
61398,64,2338,454,906,16515,1432
54491,51,380,673,288,9832,92
29302,6,264,1187,176,12318,88
24354,89,2511,1292,1451,17211,1060
12575,219,5000,1485,2570,38366,2430
32542,83,1298,1129,949,8862,349
27185,9,340,1230,219,5173,121
5879,259,8819,1545,4769,42401,4050
65653,11,613,331,395,7511,218
17484,16,322,1412,260,12150,62
5147,7,369,1553,224,24207,145
11636,34,758,1495,433,6838,325
19904,663,28849,1369,14447,246048,14402
12246,164,7767,1489,4323,31805,3444
35534,40,877,1067,566,10381,311
64230,180,2133,370,2100,37745,33
35414,3,114,1070,78,13214,36
8911,62,1818,1513,1326,15804,492
8094,239,18036,1516,7963,132648,10073
49405,1499,39767,823,30726,306588,9041
11132,26,602,1499,371,8185,231
53251,215,4073,713,3931,71590,142
19314,0,0,1379,0,14149,0
58345,53,857,560,658,11570,199
1322,492,12983,1592,8444,146179,4539
57038,37,695,598,614,13396,81
55239,64,887,644,853,10956,34
59666,57,460,516,354,5988,106
23758,3,78,1304,67,9529,11
40320,20,301,963,244,14966,57
31563,42,1321,1146,953,8725,368
20132,166,3702,1365,2809,24294,893
42089,3014,69377,934,47754,221060,21623
55320,133,1514,646,1473,19962,41
23967,28,1081,1300,685,19355,396
6642,12,372,1535,265,20970,107
17619,157,2529,1410,1917,18111,612
39154,39,570,978,428,7806,142
58499,7,90,554,74,2219,16
2083,58,1849,1586,1171,44709,678
61037,53,413,466,339,7804,74
44421,136,2879,902,2033,48550,846
27624,37,1076,1219,636,15754,440
43425,73,2330,914,1518,38050,812
19958,20,998,1368,759,19954,239
52999,15,353,720,284,18659,69
53308,45,696,711,621,7805,75
17123,8,200,1419,152,7201,48
62577,25,239,416,167,7474,72
21833,9,397,1336,266,10358,131
17767,36,1387,1407,638,21724,749
37576,2723,55115,1013,46278,336289,8837
9252,45,644,1512,446,6916,198
10544,29,1430,1504,892,29057,538
60103,18,147,501,128,5672,19
49900,12,107,810,93,5080,14
49146,64,714,831,507,13459,207
31834,10,218,1141,174,6002,44
55893,62,1264,631,1005,13637,259
38579,74,1818,987,1258,16353,560
1956,683,34342,1587,15081,95509,19261
21076,4,216,1348,160,7094,56
18694,4,219,1390,199,8658,20
14371,60,1933,1460,1160,27317,773
3123,15,527,1577,372,22020,155
24310,724,28424,1293,12590,215518,15834
24952,51,1363,1278,802,18151,561
3006,1052,33991,1578,20474,211854,13517
19779,39,830,1371,631,15442,199
60223,61,678,496,665,6602,13
46687,41,561,876,446,8841,115
50875,5034,131070,785,106270,495590,24800
2939,38,1417,1579,947,19470,470
12665,89,2169,1484,1284,30771,885
26005,10,723,1256,465,14750,258
1658,122,2590,1590,1917,21531,673
28502,133,2758,1202,1954,68900,804
22162,17,327,1331,271,6110,56
17501,74,2846,1412,1952,27846,894
3707,226,5045,1571,3663,63881,1382
53931,85,705,694,600,10453,105
35030,32,689,1079,430,10363,259
1212,504,15676,1593,10696,83898,4980
4277,461,21877,1565,10180,75035,11697
21575,137,1816,1339,1277,21261,539
41320,148,2230,947,1921,15725,309
56817,9,145,604,141,5215,4
50853,0,30,786,30,2894,0
49308,4,34,825,32,5483,2
49638,373,10564,817,5417,86919,5147
51843,220,2546,758,1362,26075,1184
34771,19,690,1085,517,11021,173
63795,44,872,385,553,9208,319
16715,380,11604,1425,7427,111443,4177
3194,1,84,1576,62,6275,22
34131,335,6933,1100,4648,54161,2285
23303,27,595,1313,472,18326,123
5229,118,2509,1552,1872,24721,637
236,85,5037,1601,3742,56396,1295
55977,6,159,629,83,6897,76
20731,19,715,1355,427,26161,288
57547,179,2849,586,2153,20915,696
64526,17,180,362,162,5023,18
5735,46,1236,1546,820,42044,416
18296,1346,35474,1397,24929,365998,10545
35667,45,784,1064,531,15093,253
14041,11,362,1464,221,14090,141
12417,15,708,1487,280,11491,428
17339,1997,38910,1415,24970,203373,13940
956,556,24644,1595,14708,126287,9936
41466,482,8179,943,5280,79238,2899
18743,39,1284,1389,783,19500,501
61042,6,76,466,62,5583,14
59478,21,246,522,206,10227,40
47427,160,1425,867,1169,12368,256
65290,7,114,340,113,3234,1
18997,3903,263144,1385,81830,906944,181314
13861,33,2028,1467,1353,19906,675
2699,3119,164064,1581,79730,559024,84334
26778,32,1283,1238,535,10826,748
8666,182,11086,1514,6308,106153,4778
49399,25,351,823,290,6779,61
11605,5,167,1496,95,4105,72
53572,20,234,705,197,11135,37
38371,94,2811,993,2148,36709,663
27606,20,1269,1220,585,31232,684
32206,33,1446,1135,762,17401,684
5554,196,2931,1548,1568,27295,1363
24145,182,3698,1296,2496,41314,1202
56819,17,215,604,164,5685,51
48806,84,1138,841,799,15667,339
11862,745,14237,1493,9161,52504,5076
1542,278,5835,1591,4002,45288,1833
12203,17,507,1490,346,10711,161
5481,372,11826,1549,6330,94931,5496
14685,33,434,1456,242,11373,192
18619,0,0,1392,0,11961,0
29692,24,774,1180,421,13518,353
24902,11,482,1279,271,9519,211
58110,2271,27556,568,21667,133773,5889
41677,17,257,941,224,11631,33
18376,42,2751,1396,2059,51391,692
33206,142,4721,1118,2624,31316,2097
51137,174,1884,778,1681,22303,203
4658,12,793,1560,592,16752,201
64829,35,262,352,220,14402,42
32756,460,10737,1126,6293,73557,4444
30074,12,478,1172,338,18174,140
31202,3102,64578,1150,40594,165127,23984
1789,49,1907,1589,1418,18952,489
51537,114,1236,767,1011,20590,225
68505,6,77,242,55,3624,22
16530,11,426,1428,303,13742,123
8501,720,25693,1515,16858,88731,8835
482,431,10015,1599,5248,75571,4767
35826,618,8477,1060,5523,62224,2954
7341,3,139,1526,103,11557,36
45243,13,219,893,182,6746,37
28280,0,17,1207,14,3585,3
57870,9092,150587,575,123611,746582,26976
22409,154,11739,1328,6705,63723,5034
27377,2037,38025,1226,21911,135474,16114
9832,34,1465,1509,790,17132,675
4465,7,282,1563,223,16035,59
32234,458,17932,1135,10114,154155,7818
48101,252,3660,859,3101,45184,559
55587,313,6054,639,4924,65604,1130
22408,28,707,1328,497,15475,210
34829,161,4416,1084,3560,87343,856
15752,94,3580,1441,2742,77853,838
62835,245,3482,409,2556,25983,926
16112,280,7183,1435,5490,72691,1693
41408,13,228,946,200,7860,28
33409,10,525,1114,312,5782,213
39052,6,134,980,122,9635,12
31252,231,2404,1150,1577,38293,827
1698,7,178,1589,135,16837,43
9194,140,2103,1512,1222,13785,881
35263,76,1813,1073,1254,13772,559
40769,34,319,956,258,4692,61
18280,20,582,1397,336,27204,246
58296,3175,34907,560,29747,166690,5160
18926,29,1407,1386,856,21385,551
58324,37,358,560,294,11734,64
41356,50,1008,946,906,21740,102
5252,58,2853,1552,1834,15812,1019
12606,9,579,1485,273,4630,306
10759,11,1108,1502,618,17196,490
65786,544,5237,328,3888,44664,1349
51496,181,6897,768,3504,18376,3393
23821,10,328,1303,249,8234,79
60202,4,40,497,33,5405,7
4976,4,190,1555,149,12230,41
21068,6,441,1348,266,7514,175
20665,84,5675,1356,2995,36707,2680
30708,15,516,1159,354,24215,162
18658,95,1688,1391,1231,21778,457
64512,6,129,362,83,5689,46
50152,275,4979,804,4368,41830,611
15438,3750,133584,1446,89035,640015,44549
40633,68,2039,958,1732,27882,307
68611,8,82,238,62,5481,20
61082,276,11193,464,9378,77285,1815
28149,22,522,1209,388,7092,134
59850,22,383,510,377,16761,6
15953,773,10738,1438,6724,88516,4014
31843,225,3134,1141,2110,17484,1024
5928,7,504,1544,369,19343,135
50192,14,193,803,169,9037,24
26865,30,459,1236,310,10782,149
20232,76,2824,1363,1940,14788,884
67852,134,3928,263,2260,34084,1668
26476,14,417,1246,282,5875,135
8301,103,1144,1516,787,10245,357
35447,1,87,1069,44,4593,43
58355,23,457,559,282,8628,175
66283,4,64,314,52,4303,12
34148,626,8549,1100,6276,56082,2273
54464,37,411,674,314,26202,97
14584,0,1442,1457,943,29598,499
34355,10,200,1096,152,6961,48
5741,11,418,1546,253,5549,165
9062,87,4285,1512,2756,24633,1529
17352,16,642,1414,457,27548,185
54273,29,291,681,277,7618,14
8357,35,626,1516,419,6165,207
49596,5,120,818,93,11721,27
66209,20,202,315,171,20925,31
21347,0,17,1343,16,4473,1
25693,55,1458,1262,1139,11918,319
66139,17,201,318,180,5374,21
56906,19,409,601,187,6158,222
53450,38,352,708,322,6659,30
38046,4,101,1001,82,10497,19
63889,38,376,381,302,6090,74
68974,20,256,225,147,7717,109
29051,0,37,1192,22,5754,15
832,67,7387,1596,2793,55579,4594
25081,226,7666,1275,5702,59920,1964
30928,173,2141,1155,1337,14176,804
16557,6,341,1428,180,14224,161
52271,23,207,745,150,7568,57
14690,21,804,1456,560,14981,244
51070,24,185,763,122,5690,63
31163,102,2495,1151,1706,80138,789
20068,39,1177,1366,771,18755,406
2288,290,5770,1585,3426,74357,2344
31227,242,6228,1150,4312,151141,1916
8777,15,503,1514,272,20247,231
62196,293,9665,427,7006,68697,2659
40479,53,1127,960,795,14468,332
18835,65,1859,1388,1340,66721,519
3758,176,7029,1571,5000,67156,2029
37902,818,16772,1005,13164,138271,3608
28182,2,32,1209,18,2874,14
5802,25,1869,1545,944,18473,925
18979,7,224,1385,139,8829,85
5419,11,434,1550,298,20959,136
30847,9,255,1156,164,6946,91
17761,260,5645,1407,4170,34968,1475
34034,123,1756,1102,1024,28150,732
47673,17,195,864,176,3117,19
27416,18,815,1225,501,6307,314
48117,140,1338,859,1174,12378,164
33228,24,470,1117,325,7972,145
58776,92,1280,545,804,18510,476
52513,415,3774,736,3439,41207,335
4025,19,526,1568,290,28133,236
16698,70,1839,1426,1130,20963,709
15236,1035,34213,1449,16727,104247,17486
53194,17,198,714,162,7705,36
61864,82,1045,439,834,16474,211
36252,3247,90653,1049,50204,386479,40449
61520,367,7748,450,6398,58507,1350
11701,121,3329,1495,1626,28769,1703
45424,637,9926,892,8938,43983,988
13647,39,1707,1470,1113,46096,594
8341,853,23107,1516,16361,252740,6746
15109,466,9693,1450,6309,91485,3384
68939,15,159,226,132,4573,27
1948,33,589,1587,314,12434,275
12135,125,5763,1491,2642,100887,3121
2016,45,1635,1587,1115,22645,520
39782,8,138,971,107,3688,31
20753,20,842,1354,546,15239,296
4172,23,1520,1566,1115,32125,405
10585,116,2727,1504,1744,19398,983
41574,6,122,943,93,4553,29
39789,450,6864,971,4642,36594,2222
28814,30,636,1197,505,12795,131
6900,16,292,1532,168,6313,124
11151,32,718,1499,522,7937,196
5440,131,3525,1549,2047,62401,1478
15701,926,13333,1442,10274,66509,3059
20005,17,1270,1367,903,28726,367
20711,8,172,1355,129,7052,43
52962,21,628,721,384,20438,244
31450,2393,40187,1147,21387,195075,18800
66215,2,69,315,56,3118,13
22711,107,1602,1323,1088,12693,514
23694,411,6404,1306,4256,36064,2148
25074,23,697,1275,522,12600,175
23192,20,609,1314,529,54561,80
26645,5,256,1241,164,8365,92
37490,16,280,1016,192,4582,88
49941,0,529,809,411,13895,118
23030,1944,39363,1317,27167,176352,12196
61294,70,887,456,782,16526,105
30779,4,191,1158,106,5032,85
12677,20,1031,1484,372,8439,659
55631,7,74,638,64,5132,10
52668,42,536,730,458,14081,78
57409,24,253,588,249,13720,4
29258,5818,146992,1188,102662,505576,44330
57896,5,50,574,46,2389,4
1978,84,1809,1587,1093,53948,716
10214,687,43621,1506,26878,241478,16743
23389,59,1892,1311,1263,35584,629
61735,23,311,443,247,5881,64
49147,121,2647,831,2376,39641,271
21232,1659,43157,1345,26404,190244,16753
5307,585,17782,1551,10887,89512,6895
5510,342,10581,1549,7386,84143,3195
67782,7,103,265,85,8798,18
17844,18,577,1405,511,40045,66
26382,1345,31855,1247,23603,276205,8252
22817,1,145,1321,108,11046,37
24556,17,497,1287,346,6157,151
13457,16795,482129,1473,292764,1454040,189365
28253,6,123,1207,84,8438,39
22248,10,267,1330,181,4260,86
27531,8065,135058,1222,88419,388071,46639
59882,4,22,508,21,1776,1
22186,383,5205,1331,3124,35183,2081
29170,181,5214,1189,3224,32647,1990
19011,40,3716,1385,2216,15085,1500
67173,6,148,284,124,7183,24
49606,43,1247,818,553,17171,694
1200,1533,77705,1593,50916,299199,26789
19985,4,266,1367,197,12765,69
6249,2778,112004,1540,61326,641019,50678
27773,737,24057,1217,13614,96964,10443
50731,798,22474,789,13177,136852,9297
2651,133,4746,1582,2838,104866,1908
37159,86,2032,867,1343,30596,689
42686,13,264,924,211,15483,53
58043,143,1254,570,1103,9353,151
15772,19,853,1441,588,23304,265
7159,612,18749,1528,10602,157829,8147
55940,13,275,630,217,11099,58
23331,14,458,1312,338,12590,120
19176,56,1693,1382,1158,14223,535
64276,168,2672,369,2557,95225,115
12017,674,23104,1492,13443,92877,9661
33865,52,1405,1106,586,26826,819
6994,19,388,1530,295,14175,93
58502,174,1748,554,1615,18883,133
26153,1,88,1253,58,4602,30
1743,13,765,1589,475,41815,290
50738,11,182,789,125,6129,57
58972,28,212,539,159,4545,53
35607,10,437,1065,307,5573,130
59168,5,228,533,64,5653,164
50973,18,279,783,237,7146,42
29253,8898,277990,1188,135612,552086,142378
4487,20,600,1562,420,20643,180
54639,147,2310,654,1982,22091,328
61660,12,92,446,72,2602,20
44767,13,192,899,138,12998,54
54760,373,4813,663,3118,19484,1695
28609,3,109,1201,66,8132,43
938,68,3861,1595,2322,26925,1539
25325,126,3231,1270,2024,33381,1207
32676,612,8794,1128,6467,48788,2327
31130,64,1482,1152,1006,27949,476
52555,10,227,735,127,4419,100
14658,8,243,1456,201,20715,42
60834,46,819,473,523,21157,296
29939,25,1131,1175,542,10077,589
70260,1067,19989,183,19096,68933,893
48563,508,11006,848,8567,153432,2439
38640,67,477,985,440,8858,37
29477,63,1754,1184,1272,29702,482
53158,9,193,715,175,3413,18
9283,12,350,1512,242,13005,108
34421,47,754,1092,532,13707,222
61975,298,4468,435,3392,27557,1076
58302,8,133,561,117,20002,16
8431,783,17298,1515,10391,75702,6907
38317,41,940,993,670,25941,270
18065,4,460,1401,319,35199,141
6157,306,6943,1541,4704,105953,2239
12572,35,2370,1485,1291,33168,1079
1825,11,763,1588,468,29105,295
1461,41,1682,1591,939,28369,743
65239,33,679,341,678,15737,1
51594,128,1903,765,1622,25804,281
59063,3,44,537,35,2046,9
32077,124,5957,1138,4071,39492,1886
18535,11,182,1393,137,12594,45
48180,34,327,858,306,13626,21
37271,132,1821,1022,1137,29276,684
46169,3,212,883,102,12196,110
50329,954,13989,799,12413,105635,1576
12773,70,2606,1483,1108,17691,1498
28751,298,5683,1198,3449,37218,2234
44115,1057,13579,906,11119,56731,2460
5745,375,29122,1546,14387,172919,14735
21548,19,219,1340,183,5967,36
30657,54,522,1160,379,9925,143
17151,131,4130,1418,2753,46466,1377
30446,108,1288,1164,1011,20010,277
64699,437,8632,357,5275,100721,3357
55076,564,11037,653,8896,81113,2141
48872,15,360,839,309,6319,51
31976,5,156,1139,111,6106,45
40522,41,363,959,306,6962,57
12339,16,689,1488,343,24053,346
55217,16,166,650,138,6555,28
48685,490,10621,844,10012,64800,609
51466,2,59,769,37,14552,22
64296,174,2447,368,1841,26777,606
66392,16,227,310,204,6752,23
67815,0,27,264,27,3059,0
10912,116,5542,1501,3343,125773,2199
53004,250,3068,720,2583,51741,485
62233,152,3975,426,3660,43148,315
4842,205,4756,1557,3228,24484,1528
11511,829,19338,1496,13017,63149,6321
54973,1395,20624,656,15271,148929,5353
51732,2,135,762,60,4161,75
36392,81,1283,1044,1144,18908,139
25020,836,56054,1276,30895,216551,25159
61763,5,74,442,62,7417,12
7872,5,376,1518,171,14549,205
27869,752,19986,1214,11095,166202,8891
54945,20,143,657,114,6891,29
51058,5,121,780,96,9783,25
59627,1052,22894,517,13699,134721,9195
62053,60,697,432,678,12272,19
60888,179,3746,471,2815,62763,931
8523,119,3339,1515,2084,32511,1255
53538,75,540,706,442,15316,98
64023,79,3008,377,2873,34139,135
26452,270,13373,1246,6630,82089,6743
53920,5,51,694,38,5597,13
29543,24,793,1183,414,10056,379
49353,2,39,824,33,3593,6
48259,254,4448,857,2749,102996,1699
50114,34,646,804,354,11554,292
46284,293,4844,882,3626,100686,1218
47904,9,184,861,132,11914,52
37606,34,619,1013,463,7580,156
14327,271,6678,1460,4829,59033,1849
61765,31,403,442,252,4845,151
22774,777,18429,1321,13312,171092,5117
49312,36,2518,825,902,28326,1616
33239,140,4655,1116,3393,85119,1262
67850,3,102,263,76,5184,26
36440,48,1100,1043,756,10867,344
31336,19,734,1148,336,28117,398
39137,13,209,978,181,10391,28
3503,19,531,1573,351,20863,180
22187,8,394,1331,270,8623,124
34090,9,400,1101,230,6386,170
54791,97,1381,662,1015,28404,366
21157,173,5212,1346,3818,64653,1394
34487,18,201,1093,95,7768,106
3846,72,1527,1570,1005,43218,522
6799,17,555,1533,419,32444,136
45970,10300,188576,885,139614,878693,48962
31922,22,303,1140,187,3779,116
15033,37,839,1451,566,14707,273
27495,43,955,1223,604,6984,351
62922,1,9,407,7,2054,2
62071,257,4543,432,2504,43162,2039
66691,44,524,301,357,4851,167
32042,8,197,1138,126,6272,71
19473,131,4175,1376,3158,122803,1017
65422,6,103,337,92,5700,11
10679,0,81,1503,56,2902,25
13520,685,16826,1472,10892,172045,5934
58990,397,6933,538,4342,42401,2591
56766,6,97,606,92,5420,5
49488,62,560,821,528,11758,32
222,206,3038,1601,2015,29425,1023
3986,48,914,1568,575,19408,339
13901,745,19569,1467,11384,59631,8185
9126,41,1410,1512,879,35034,531
11780,0,0,1494,0,7076,0
70470,6,151,176,128,6515,23
14651,904,42211,1456,19526,287372,22685
1765,96,2983,1589,2079,68530,904
53128,33,572,715,513,38193,59
37334,231,3207,1020,2142,48184,1065
30193,5,333,1169,208,4418,125
30005,11,250,1173,149,12622,101
49822,11,193,812,164,9095,29
11079,56,1278,1500,811,19750,467
59257,5773,224935,509,76352,1219754,148583
27843,40,2065,1215,1090,29541,975
36356,4220,67784,1046,46085,398897,21699
21643,219,5025,1338,3100,55774,1925
55107,46,991,652,828,18167,163
6892,9,550,1532,419,25281,131
69699,13,161,202,153,3794,8
16789,12,361,1424,251,12627,110
27939,11,475,1213,389,28369,86
20783,10,233,1354,193,11639,40
18756,46,700,1389,452,14742,248
9957,858,18909,1508,8908,124728,10001
21026,88,3701,1349,2539,26159,1162
19167,35,927,1382,785,54760,142
36913,6881,115513,1001,83088,521765,32425
9402,138,3015,1511,1950,13378,1065
57280,25,286,592,150,4141,136
65926,92,1073,324,1023,25397,50
29974,9,381,1174,241,24294,140
59521,30,427,521,329,12598,98
17121,48,1463,1419,971,19934,492
52978,17,355,720,285,10256,70
56299,2,78,619,46,7604,32
27491,12,260,1223,163,12532,97
60445,6791,120154,488,63012,403206,57142
54096,37,601,687,474,9303,127
46829,447,7198,874,6507,86483,691
31538,183,4835,1146,4157,79236,678
52964,171,2501,721,2061,20239,440
3939,70,1464,1569,1103,40481,361
43924,36,729,909,707,20371,22
60874,24,152,472,134,3685,18
55807,14,169,633,142,9175,27
26952,769,15326,1234,11346,183851,3980
35982,11,230,1057,180,6940,50
3246,0,290,1576,228,25155,62
17228,243,6353,1417,4134,51047,2219
15661,24,914,1442,502,21268,412
27812,266,6403,1216,3332,68533,3071
35487,11,205,1068,123,3340,82
28241,42,1076,1207,763,17257,313
20927,161,5259,1351,3716,86772,1543
284,20,696,1600,467,74945,229
35681,9,340,1064,148,5675,192
28455,83,2813,1203,1913,36702,900
22883,5,179,1320,162,12965,17
9268,4,187,1512,136,7197,51
6203,33,740,1541,539,18026,201
39358,52,718,976,568,21767,150
49712,36,589,803,551,14981,38
29162,10,312,1189,206,21211,106
22549,5,130,1326,93,7195,37
19900,35,966,1369,384,9655,582
32702,5,214,1127,146,10985,68
20231,8,291,1363,228,22584,63
20426,8,265,1360,223,8735,42
31251,13,353,1150,260,14749,93
14768,41,869,1455,581,22148,288
24934,28,577,1278,391,11062,186
17261,36,531,1416,335,14811,196
42790,8,268,922,190,10996,78
47901,36,520,862,391,13222,129
22902,6,416,1319,317,13036,99
48612,9,156,847,122,6704,34
50264,31,507,801,366,9396,141
50746,16,392,789,326,11719,66
67770,45,1386,266,1108,21651,278
37647,77,897,1012,703,17145,194
3789,52,1116,1570,807,28049,309
37318,4,38,1021,34,2919,4
39329,15,340,976,314,7500,26
10380,712,27112,1505,17851,176949,9261
64303,961,19142,368,17480,156328,1662
68665,57,588,236,586,16112,2
52303,41,473,743,342,10410,131
42454,103,1975,928,1425,8554,550
36182,104,998,1051,796,9347,202
1579,339,5300,1590,3318,26089,1982
38366,91,1126,993,957,14652,169
64383,66,1120,366,1077,33192,43
49827,3500,50557,812,34422,609206,16135
52136,62,699,749,619,17599,80
3775,125,4238,1570,2436,87719,1802
21040,197,3404,1349,2502,22599,902
9440,10,599,1511,301,6810,298
47733,181,2514,863,2116,15478,398
40394,27,277,961,208,4456,69
30930,474,6759,1155,4318,37816,2441
12754,196,9956,1483,5569,62377,4387
21994,134,3061,1334,2246,33762,815
17717,256,5100,1408,3473,33550,1627
24334,100,3730,1292,2360,19470,1370
48859,3,63,840,48,3484,15
47640,5,93,864,71,9828,22
52908,38,662,722,385,18854,277
34059,36,786,1101,420,8868,366
23783,53,1729,1304,1151,20885,578
34264,18,451,1096,351,4178,100
14007,11171,348440,1465,165869,949538,182571
3783,58,1358,1570,860,19573,498
41982,261,3847,929,2721,37640,1126
52885,52,456,723,385,7089,71
22064,4,27,1333,23,7530,4
27804,27,595,1216,512,9053,83
18431,54,1463,1395,1043,25849,420
42690,288,1798,924,1462,18735,336
10170,2224,63509,1506,36833,233671,26676
13073,97,4383,1478,2724,30997,1659
18736,37,1921,1389,1321,25516,600
52261,63,1198,745,820,26314,378
34210,13,529,1098,399,18560,130
63470,29,375,393,336,6721,39
67830,135,2681,264,2051,39586,630
51918,39,677,757,453,6513,224
65061,985,16945,339,9507,111925,7438
46014,13,281,885,168,6222,113
8298,2611,51993,1516,25297,119921,26696
32085,26,646,1137,385,12273,261
30354,41,1118,1166,909,17492,209
1301,13,675,1592,495,17326,180
36508,75,1517,1041,877,20789,640
61017,72,715,467,710,10382,5
21882,20,721,1335,517,15282,204
49132,12,152,831,135,3195,17
14833,7,710,1454,527,19422,183
54536,31,270,672,198,9737,72
60850,155,1862,473,1453,19522,409
7269,76,3675,1526,1837,37985,1838
23016,21,423,1317,324,7809,99
388,94,3283,1599,2357,56102,926
16360,8,357,1431,230,14504,127
12762,54,1897,1483,1133,21887,764
14643,157,4997,1456,2529,20006,2468
17799,4,150,1406,127,7585,23
51737,47,553,761,481,10089,72
23931,113,1705,1301,1324,39018,381
63816,11,169,384,151,2673,18
52239,9046,138498,746,99676,470161,38822
6428,236,11292,1538,7695,68989,3597
2529,16,482,1583,324,46793,158
66583,105,1757,304,1615,16722,142
68009,194,2740,258,2470,19341,270
35505,18,622,1068,423,6345,199
51249,46,519,775,349,7170,170
58366,1277,20799,557,13173,82589,7626
48509,16,241,851,166,12547,75
68371,4,54,247,44,8037,10
25312,57,2137,1270,1496,24500,641
61321,4,166,456,129,6887,37
49037,29,339,834,239,7621,100
10873,222,8090,1501,3998,38789,4092
764,2,124,1596,73,14785,51
2727,910,63959,1581,33547,255504,30412
39879,4,202,969,177,12218,25
17479,6,324,1412,190,14897,134
34411,36,1045,1094,698,19277,347
29406,92,2886,1185,1967,101641,919
4038,40,492,1568,369,14897,123
33245,87,2643,1117,1769,30756,874
24060,28,568,1298,381,16524,187
50340,128,2748,799,983,35873,1765
17476,7,65,1412,52,7521,13
49186,3,68,829,53,6881,15
50119,323,5022,804,4056,120242,966
12090,30,857,1491,441,6715,416
59381,25,335,525,317,7753,18
14457,1848,35791,1458,24678,137586,11113
6514,134,3113,1536,1770,45043,1343
21295,178,4607,1344,2340,29515,2267
49916,5,65,809,52,3051,13
24105,210,4426,1297,3297,43946,1129
31853,121,5001,1141,3629,39636,1372
61105,2,40,463,18,7249,22
21894,656,17199,1335,10722,58413,6477
803,24,756,1596,521,37256,235
59482,40,659,522,515,19481,144
55789,26,232,633,214,7984,18
35718,2930,38281,1063,31322,118156,6959
46843,13,113,875,86,5345,27
28734,4,474,1198,299,11788,175
7043,8,268,1530,152,9337,116
14021,189,5554,1465,3961,53113,1593
40666,99,918,958,755,9367,163
49730,60,588,814,504,15954,84
37669,75,1215,1011,1097,27016,118
52583,8055,88626,734,76922,430041,11704
65973,210,4098,323,1707,17602,2391
52561,0,940,734,813,10231,127
50615,132,2052,792,1807,40881,245
66896,95,1726,294,1588,21200,138
31580,8,199,1145,155,17526,44
29398,306,7718,1185,4936,38402,2782
69423,102,1481,211,1323,15122,158
120,1451,79540,1603,41174,381034,38366
17055,10,150,1420,128,9369,22
32214,145,2363,1136,1557,15597,806
39742,1201,21537,971,13174,158048,8363
22696,175,7908,1323,3984,34048,3924
41123,127,1371,949,1160,17924,211
55465,307,3729,643,3234,54064,495
6664,97,4551,1535,2693,34260,1858
4456,65,3023,1563,1966,42289,1057
41545,36,566,943,468,8835,98
59492,30,321,522,306,7869,15
10036,22,1171,1507,681,12238,490
26901,67,1626,1236,997,11329,629
21183,394,6160,1346,2586,34771,3574
28155,77,1606,1209,1027,14393,579
20062,32,1210,1366,809,10312,401
53104,6,101,716,80,5981,21
28040,31,783,1211,473,11278,310
67468,21,446,274,431,8353,15
52680,71,1317,730,650,12642,667
50307,4454,66875,800,60041,220493,6834
44445,237,3851,902,3103,34267,748
18863,560,14838,1387,10770,130500,4068
33076,14,336,1120,202,21010,134
25426,780,23686,1268,12561,190880,11125
17397,10,429,1414,290,13114,139
36216,7,167,1048,135,9002,32
59383,48,691,525,646,18443,45
19174,0,0,1382,0,5554,0
10202,133,3493,1506,1935,45968,1558
30265,0,79,1168,64,3433,15
29915,2,176,1175,107,6086,69
50751,35,517,789,430,11305,87
7587,6494,248298,1522,107202,711633,141096
33473,1522,26545,1113,16522,165774,10023
9207,794,19103,1512,15061,52526,4042
13352,197,6109,1474,3756,49259,2353
458,15,1341,1599,693,26964,648
13811,5274,208848,1468,105422,581459,103426
2794,102,2212,1580,1146,55730,1066
56375,6,59,617,47,2783,12
30302,44,1335,1167,960,19588,375
11417,6,852,1497,317,10214,535
12150,76,3485,1490,1777,17976,1708
12860,41,2334,1481,1331,57749,1003
14937,4,285,1453,95,6095,190
60907,11,255,470,225,12256,30
64869,18,903,351,310,7405,593
37581,5,84,1013,75,6386,9
33881,65,1223,1104,856,7119,367
54172,1975,53618,685,26912,182372,26706
25999,313,8932,1256,4988,42629,3944
6658,29,889,1535,694,13016,195
60289,95,1447,494,1262,26882,185
20831,62,1688,1353,1279,37249,409
512,18,745,1598,483,13027,262
61023,33,768,466,624,16185,144
14120,10,557,1463,408,18083,149
35804,587,10651,1061,7803,45586,2848
23121,435,6478,1316,4733,42933,1745
4483,356,27236,1562,8452,143891,18784
66267,60,1411,314,1045,47697,366
53900,0,281,694,246,13700,35
11143,2730,64615,1499,37630,399547,26985
32397,14,180,1133,116,3988,64
57608,27,229,584,218,5536,11
67308,11,113,280,90,5057,23
10250,3,330,1506,245,9979,85
4729,2100,25660,1558,16614,68378,9046
12820,8,589,1482,354,21477,235
8476,35,1764,1515,793,26848,971
54539,229,2542,672,2236,22203,306
5108,21,425,1553,306,10806,119
34575,115,1475,1091,981,16407,494
54108,64,546,687,436,12580,110
25872,564,9708,1259,6050,74831,3658
27088,7,333,1232,225,13266,108
25606,9,432,1265,258,10253,174
18033,50,2391,1401,1750,31122,641
67549,12,208,273,164,8355,44
54109,310,2388,687,1903,15259,485
29542,64,535,1183,392,5577,143
17168,8128,250998,1418,153267,714931,97731
8468,107,3341,1515,1472,49586,1869
22278,34,712,1330,553,21374,159
37574,5,85,1013,72,5152,13
48774,51,1269,842,936,27262,333
23510,15,511,1309,353,13893,158
26172,0,120,1253,83,9345,37
40315,124,3124,963,2154,28695,970
35822,21,438,1061,355,15238,83
61130,18,155,462,128,4185,27
32801,88,1548,1126,931,47390,617
51377,14,247,771,198,9616,49
53281,56,867,712,758,8701,109
18839,391,8728,1387,7069,81257,1659
23592,48,934,1308,693,18030,241
11513,61,2984,1496,1680,27038,1304
28432,129,4347,1204,3021,48679,1326
56154,28,342,623,318,5933,24
49814,340,3657,812,2845,54779,812
66373,4,49,311,48,3184,1
49472,4838,76037,821,59398,334282,16639
59022,42,397,538,366,7434,31
33145,13,431,1119,160,9556,271
52440,928,15182,739,14059,98806,1123
24721,15,515,1283,364,10484,151
64521,6,64,362,55,5561,9
62334,5,37,423,36,2563,1
26218,8,621,1251,318,6212,303
40241,33,478,964,400,18315,78
55066,26,242,653,200,5357,42
36061,1550,25310,1054,17383,145237,7927
65764,36,642,328,550,12117,92
7135,54,2590,1528,1686,68145,904
62963,24,188,406,156,6237,32
51861,5,194,758,113,5944,81
13248,473,9492,1476,5785,63312,3707
62045,2260,65384,432,40132,430257,25252
49231,571,10360,827,6254,53799,4106
64210,87,2043,371,1930,40289,113
33256,885,13786,1117,10495,60485,3291
28483,3,71,1203,49,5444,22
65920,10,223,324,193,8833,30
35310,11,431,1072,179,6842,252
4923,66,1865,1556,1278,52749,587
63158,200,2373,401,1921,32371,452
33980,23,435,1103,265,9277,170
67329,6,86,280,81,2782,5
40018,34,868,967,539,38847,329
19298,43,1166,1379,596,21314,570
53890,143,1361,694,1222,7664,139
6753,0,88,1533,61,12983,27
11742,24,549,1494,311,15588,238
24986,20,580,1277,440,19295,140
7558,95,4731,1523,1941,50391,2790
30078,23,1081,1172,673,29952,408
26480,15,381,1246,230,7896,151
59422,72,6602,522,843,10827,5759
9777,17,1178,1509,801,15517,377
25424,390,6208,1268,4112,20588,2096
37057,778,10958,1028,7701,60408,3257
41919,592,11317,936,8319,109031,2998
20149,5,212,1364,170,6900,42
55218,13,358,649,223,12781,135
59544,3265,65986,520,48157,472388,17829
58576,68,1191,552,890,17736,301
32003,268,9297,1138,6461,69173,2836
21586,56,2465,1339,1186,12731,1279
31889,14,538,1140,336,4917,202
27710,312,4440,1218,3180,19336,1260
23607,9,212,1308,144,7037,68
50847,717,10957,786,8331,63906,2626
20047,18,405,1366,295,9240,110
34753,0,5213,1086,3293,41339,1920
48750,0,0,843,0,18043,0
34046,31,742,1102,525,13045,217
16750,194,3504,1425,2413,26339,1091
29934,456,11061,1175,7423,96279,3638
29690,1599,67968,1180,42530,217829,25438
2073,182,3319,1586,2012,22024,1307
55753,92,1419,635,1159,18187,260
2936,98,1792,1579,1177,23951,615
10361,249,5949,1505,3554,83492,2395
60869,64,903,472,767,18893,136
15341,161,4314,1447,3133,50940,1181
62942,35,241,407,210,4611,31
32710,83,1310,1127,880,16553,430
59101,45,414,535,396,12262,18
28652,57,695,1199,523,18539,172
57609,44,947,584,676,17218,271
10693,126,2746,1503,1797,34497,949
56103,25,159,625,132,3926,27
7461,171,6108,1524,4053,55598,2055
3748,141,6025,1571,3374,101720,2651
38485,15,372,989,305,10702,67
16002,385,6367,1437,4595,68354,1772
16643,84,3426,1427,2156,15798,1270
24292,84,1736,1293,1182,17065,554
50774,67,842,788,741,24309,101
62087,30,334,431,296,6112,38
64840,1047,11453,352,9151,67869,2302
20217,601,11904,1363,8717,95058,3187
1446,52,1557,1591,868,31650,689
10191,47,1737,1506,1098,34373,639
4554,11692,507958,1561,213308,1707456,294650
17136,156,2146,1418,1765,23329,381
19805,61,1891,1370,1314,11250,577
50876,98,1741,785,1480,33647,261
37153,34,1103,1026,882,22183,221
57042,10,75,598,62,2592,13
54299,53,724,681,676,16877,48
13064,841,15952,1478,11766,48410,4186
43601,9,111,911,105,6571,6
69874,32,472,196,342,8305,130
56524,226,4230,612,3924,33524,306
16947,4,148,1421,82,4218,66
8014,40,815,1517,497,33367,318
55852,41,351,632,282,8705,69
41525,11,508,944,330,14513,178
28057,60,870,1211,577,9028,293
4055,27,820,1568,536,7699,284
1565,40,1355,1590,1008,51622,347
16959,7,126,1421,98,13845,28
28370,39,1383,1205,869,13959,514
34387,3,390,1088,168,10850,222
6906,174,2433,1532,1744,18814,689
7431,84,2492,1525,1916,27311,576
57935,197,3165,573,2348,30887,817
32480,36,1465,1131,1002,23194,463
6872,23,484,1532,351,8984,133
29695,394,11311,1180,5714,46111,5597
58644,41,391,548,305,7037,86
33667,8,273,1109,183,7864,90
31950,51,877,1140,605,14325,272
62367,59,777,422,594,7416,183
27536,383,9487,1222,4725,121211,4762
43549,3,166,912,140,10197,26
54459,18,170,672,124,8121,46
18553,12,680,1393,493,13704,187
5096,13,541,1554,378,19398,163
1601,10700,839573,1590,268725,3783526,570848
18435,48,1882,1395,1189,62404,693
43373,20,319,914,244,9695,75
34494,304,3170,1092,2248,24930,922
15030,151,4548,1452,2730,24186,1818
49428,66,524,822,400,10372,124
37681,272,4402,1010,3324,58658,1078
55676,19,243,637,212,6263,31
3797,108,2292,1570,1698,15036,594
52077,265,3321,751,3085,58189,236
49268,12,252,827,193,5335,59
21257,19,286,1345,143,5964,143
54656,100,1236,667,860,11219,376
2578,20,1470,1582,800,28593,670
32458,3835,80652,1131,39920,476824,40732
52446,63,1033,739,824,24627,209
45234,73,883,894,664,14340,219
50063,63,574,806,531,14821,43
32020,10,380,1132,252,32577,128
29497,34,1074,1184,689,13218,385
3166,13,362,1577,216,6308,146
23405,17,581,1311,345,12164,236
9749,114,2782,1509,1012,30969,1770
51775,33,505,693,415,12730,90
24077,22,523,1298,363,9964,160
4758,194,6698,1558,4882,211732,1816
19870,39,1218,1369,863,21053,355
28675,125,4076,1199,2456,49421,1620
8592,27,1403,1515,900,24821,503
35986,464,10364,1056,6857,56231,3507
42694,157,1480,924,1155,14900,325
2587,75,3055,1582,1831,24827,1224
61674,79,776,445,653,8834,123
24320,159,2517,1293,1603,20665,914
6109,0,75,1542,48,20081,27
7375,111,3573,1525,2025,49543,1548
55864,2,36,632,26,3086,10
23391,10,547,1311,372,26555,175
3717,382,17501,1571,11624,96169,5877
10969,2,248,1501,131,9105,117
52096,32,1031,750,640,12155,391
28493,166,2636,1203,1765,39157,871
49875,67,774,811,619,12607,155
24251,26,938,1294,570,19068,368
23324,150,4452,1313,2320,88746,2132
12552,316,10377,1485,5304,65863,5073
10236,22,816,1506,449,14007,367
5696,28828,1067418,1547,406816,4456915,660602
53143,11,167,715,125,5719,42
69367,4,27,212,26,1018,1
56926,335,6143,601,5740,77794,403
68053,270,4479,257,3909,41074,570
7646,54,1275,1522,711,28770,564
29228,99,3357,1188,1354,30233,2003
56590,28,346,610,265,7690,81
10643,54,1793,1503,1039,24387,754
21567,28,678,1339,424,33846,254
24126,29,768,1297,533,9411,235
39202,558,13160,977,6885,37161,6275
24995,156,4088,1277,3004,43643,1084
51619,118,1785,765,943,18929,842
63915,76,869,381,785,26430,84
47150,2,30,871,25,3809,5
4837,9,329,1557,240,10536,89
14174,43,1254,1463,704,9711,550
51276,4,112,774,94,15355,18
26472,10,688,1246,366,15632,322
12857,22,716,1482,377,8788,339
14059,7,117,1464,90,3609,27
35381,4,115,1070,76,3414,39
35972,24,343,1057,291,17318,52
62506,2045,27937,418,19658,98887,8279
20563,17,756,1358,509,21470,247
38668,71,527,985,456,6407,71
55634,2,58,638,53,6081,5
38442,19,313,991,237,10957,76
45203,113,1432,894,981,25281,451
41832,218,5269,938,2928,29060,2341
17259,409,7881,1416,5683,85779,2198
27039,72,1264,1232,893,15721,371
49974,615,10203,808,9281,130827,922
534,990,45084,1598,25063,113104,20021
27556,4,94,1221,57,9820,37
1198,22,740,1593,593,21130,147
40884,1,28,954,22,5671,6
31,130,4998,1605,3672,101214,1326
33677,181,4437,1109,3390,91236,1047
21078,1,131,1348,91,8764,40
13841,211,3077,1468,1939,21103,1138
22545,1933,80466,1326,41986,398019,38480
25310,4319,73407,1271,55887,199598,17520
13476,31,1721,1473,673,14634,1048
14862,9,504,1454,358,29111,146
30132,262,6933,1170,5812,53358,1121
69436,30,378,210,315,8010,63
34293,264,9188,1097,4697,78013,4491
2302,35,3039,1584,1741,33967,1298
57956,11,240,573,120,4954,120
20395,21,880,1360,659,23351,221
55265,23,124,648,96,3523,28
52794,303,2609,726,2369,22621,240
22862,18,735,1320,530,11148,205
35966,3168,53469,1057,40431,314471,13038
37989,415,3746,1002,3151,29758,595
23612,208,7967,1307,4433,89901,3534
34453,11,155,1093,119,6465,36
56747,72,892,606,797,8208,95
19971,118,2996,1368,2083,23676,913
44268,21,377,904,291,5880,86
16759,149,5417,1425,3512,53459,1905
11239,40,1663,1499,945,18510,718
4874,217,7024,1557,4678,61370,2346
50908,34,376,785,246,5346,130
29037,8,554,1192,331,10521,223
3712,41,1743,1571,1163,39682,580
37095,33,579,1027,452,7508,127
56329,263,3404,618,2689,31780,715
41432,13,335,945,292,19111,43
64914,19,237,350,232,3726,5
44086,22,473,906,386,31183,87
48650,167,1640,846,1204,30484,436
35405,216,3709,1070,2524,34587,1185
36228,5,123,1050,93,6751,30
32294,115,3156,1134,1834,20559,1322
23278,42,1767,1313,1265,49605,502
66200,90,2231,315,2128,25536,103
21198,103,3367,1346,2144,24864,1223
50679,2,69,791,52,2162,17
38169,88,1451,998,1347,18286,104
13977,32,484,1466,218,6550,266
6160,54,4019,1541,2585,27846,1434
27687,50,1905,1218,1153,24035,752
31645,30,436,1144,320,6820,116
62269,133,1135,425,1045,17298,90
8634,764,14748,1514,10198,91815,4550
31710,7,204,1143,181,7400,23
18837,373,8300,1387,6079,76838,2221
42360,4545,85181,928,54565,408736,30616
3043,17,1023,1578,550,10622,473
4146,14,467,1567,169,8680,298
49064,1,125,833,95,14953,30
30306,31,1166,1167,632,33608,534
22135,263,7127,1332,5032,25369,2095
38002,11,156,1002,109,13163,47
50263,440,4770,800,3395,46162,1375
50244,3543,38146,801,29710,691117,8436
31219,334,8576,1150,4981,53724,3595
6690,322,8565,1534,5436,40824,3129
56044,29,281,627,259,4522,22
28595,73,1287,1201,788,15975,499
53646,85,649,686,551,11784,98
52383,11,101,741,73,4843,28
26418,37,743,1247,485,21473,258
1503,20,709,1591,395,26091,314
13237,16,1063,1476,412,12797,651
13832,23,794,1468,590,25190,204
60318,4,49,493,42,5729,7
25859,70195,1420388,1259,852620,4829165,567768
9945,7,123,1508,74,10368,49
31235,6,365,1149,325,11832,40
65027,8,137,345,132,7411,5
44367,34,760,903,569,21289,191
52021,55,557,753,473,12761,84
12076,172,7316,1491,3979,43606,3337
54982,452,4546,623,3773,43725,773
8454,146,7626,1515,4753,175870,2873
46121,1996,42165,884,22625,208502,19540
5322,103,2307,1551,1617,18958,690
13121,157,2973,1478,2097,25662,876
62599,15,270,416,198,8199,72
30258,160,3122,1168,2158,30191,964
59916,27,293,507,271,3585,22
15021,181,5094,1452,3196,54281,1898
5850,181,8100,1545,5708,131887,2392
23835,86,2402,1303,2086,46943,316
6336,18,446,1539,313,17976,133
8034,33,1039,1517,580,7370,459
7348,61,1279,1526,804,10528,475
55240,5311,80828,649,64415,266537,16413
65832,3,36,327,25,4398,11
54841,939,10271,660,7204,96350,3067
32445,38,726,1132,372,9484,354
16624,12,517,1427,383,12726,134
60376,194,6423,491,2445,31006,3978
64182,28,373,372,322,11294,51
51028,32,588,781,491,10640,97
48489,23,269,852,193,8802,76
60195,12375,351663,493,172338,1645707,179325
1875,11261,398778,1588,206547,2094148,192231
40512,8190,289757,959,127776,833508,161981
2471,300,7316,1583,5218,84925,2098
47759,10,183,863,162,2945,21
11971,68,1305,1492,733,12790,572
60249,7,167,495,138,10584,29
64820,3109,49160,352,44363,207426,4797
3765,908,21514,1571,11755,135640,9759
52165,23,364,748,244,7154,120
19629,37,1228,1374,723,17731,505
51132,30,277,778,260,2973,17
17388,2,122,1414,93,7219,29
27801,0,0,1216,0,20710,0
24168,34151,1008917,1296,456178,2534428,552739
22898,5,249,1319,183,10933,66
58852,115,1615,543,1377,18388,238
53103,33,347,716,243,6200,104
42530,5,64,928,57,4677,7
13099,140,5290,1478,2815,41793,2475
14795,4,46,1455,37,4860,9
49757,39,403,813,395,11518,8
18294,13,454,1397,338,27127,116
26891,39,1289,1236,714,18801,575
24725,68,2216,1283,1606,26333,610
22480,12,577,1327,361,8966,216
39475,72,1792,974,1229,39484,563
20473,531,6771,1359,6020,105124,751
64883,27,222,351,194,5314,28
58061,772,20737,569,13370,65568,7367
28439,21,267,1204,173,4952,94
433,18,332,1599,258,14600,74
25968,1406,35558,1256,20868,217965,14690
22842,208,4787,1320,3056,50878,1731
17733,92,3289,1407,2303,57085,986
51476,331,5806,769,4872,45615,934
53474,3,44,708,41,3258,3
44506,58,1352,902,986,35377,366
17038,33,1827,1420,1259,44580,568
29417,19,550,1185,319,7702,231
1960,37,883,1587,654,28159,229
54390,173,2489,677,1970,35873,519
14246,412,13067,1461,9156,75473,3911
62570,53,727,416,649,7099,78
17504,32,1333,1412,1042,23280,291
58927,93,2120,540,1546,30042,574
17558,8,177,1411,151,15578,26
51084,23,543,779,408,20100,135
13454,661,14244,1473,9031,49102,5213
57557,32,273,585,241,6689,32
18916,33849,1250579,1386,456421,2273591,794158
17347,88,2911,1415,2175,63358,736
28083,13,335,1210,213,6156,122
8818,40,1073,1513,750,6401,323
30801,16,654,1157,414,21924,240
6437,4,116,1538,87,6712,29
53778,14,362,699,252,10663,110
67657,23,163,269,163,2453,0
61816,23,575,440,513,17441,62
53880,77,553,695,378,7429,175
49436,71,858,822,587,18065,271
2820,92,5437,1580,2101,33154,3336
15958,378,3920,1437,2923,32623,997
20425,16,279,1360,247,11381,32
8368,18,639,1515,425,9118,214
63164,77,767,401,536,17834,231
62594,80,715,416,620,10312,95
22762,4,495,1322,181,9223,314
29015,9,354,1192,211,5451,143
57025,58,676,599,541,8758,135
54727,18,183,665,131,4052,52
64366,31,552,366,528,18074,24
32195,19,458,1136,320,17551,138
65760,4,77,328,73,7184,4
34727,627,15211,1083,8355,126850,6856
15263,36,1137,1448,797,28855,340
10746,1222,20374,1503,13018,116946,7356
30391,41,1161,1165,752,16036,409
10946,202,9528,1501,3892,33490,5636
21161,16,682,1346,388,23925,294
29313,426,8369,1187,4343,51045,4026
15978,4,437,1437,269,8570,168
20469,91,2617,1359,1830,34616,787
14979,11,533,1452,344,15976,189
2466,17,257,1583,205,5189,52
38445,10,184,991,126,6119,58
11217,13,295,1499,166,6257,129
27745,19,668,1217,356,13021,312
5026,18,834,1554,422,21712,412
24009,31,505,1300,377,8214,128
25709,700,22736,1262,11269,156242,11467
20631,25,521,1356,374,9012,147
54487,85,755,674,664,21388,91
1757,84,3582,1589,2186,37770,1396
54366,41,548,678,364,8438,184
58136,129,1895,567,1682,31037,213
4048,13,829,1568,533,40355,296
41093,48,1400,950,969,27612,431
11887,78,1707,1493,843,15689,864
65603,3,66,333,47,3321,19
17835,2124,52982,1405,27728,245769,25254
13533,17,875,1472,519,8986,356
31948,38,1188,1140,690,14072,498
19912,92,1577,1369,975,37361,602
21185,39,1389,1346,939,14125,450
35753,9,329,1062,250,8462,79
32693,11,345,1128,250,25982,95
17641,159,1693,1409,1136,14650,557
17408,3,112,1414,88,3698,24
48641,291,6899,846,6376,54376,523
13623,333,10029,1471,6893,95404,3136
41290,5,413,947,316,13344,97
2110,52,2890,1586,1916,77964,974
29537,5,253,1183,116,6471,137
22575,316,5694,1325,3950,39564,1744
34928,1515,43489,1082,26692,242275,16797
29610,36,727,1182,641,16987,86
8157,6166,181043,1516,85400,504304,95643
57210,21,243,594,219,10804,24
57508,29,214,587,176,4069,38
22151,85,3522,1332,1352,19197,2170
2084,1029,48801,1586,27811,137147,20990
24377,244,7971,1291,3259,107934,4712
57790,49,670,578,586,12027,84
42920,17,547,920,427,10044,120
17218,413,11304,1417,7167,54883,4137
30807,86,1751,1157,1106,24241,645
49061,74,1288,833,1111,15653,177
1289,66,2660,1592,1848,36047,812
7792,99,3872,1520,2186,45826,1686
6855,26,482,1532,383,30073,99
11769,588,13573,1494,7742,51733,5831
3286,34,949,1575,587,16122,362
39206,7,467,978,366,15259,101
24371,228,7541,1291,2965,86648,4576
36708,50,555,1038,435,10237,120
27095,4043,92572,1231,52226,186547,40346
18314,34,298,1397,262,10169,36
32031,110,3456,1138,2528,31017,928
10916,0,22,1501,17,9140,5
25323,83,809,1270,517,7040,292
56046,43,661,626,602,5611,59
16381,1718,36946,1431,21655,490402,15291
48747,122,2708,843,1957,26800,751
50311,60,987,799,858,28514,129
64308,97,2353,368,1258,14982,1095
11442,107,7342,1497,3652,36868,3690
60914,11,133,470,124,5822,9
45458,6,159,891,137,10224,22
54187,132,2019,685,958,20418,1061
21191,45,939,1346,674,15837,265
67934,9,140,261,116,3311,24
67216,6,215,283,172,17785,43
19484,20,286,1376,231,6747,55
43921,4330,74165,904,50774,332462,23391
19708,21,973,1372,651,38663,322
57346,202,3894,590,3514,34581,380
42460,4,144,928,103,3795,41
27179,11,454,1230,234,10507,220
3395,956,30434,1575,17111,201334,13323
54767,143,1894,663,1285,24704,609
60965,70,997,468,896,9469,101
65759,199,2451,329,2025,38039,426
12158,4,271,1490,125,5069,146
26722,533,10433,1240,4907,50521,5526
53198,4,98,714,77,9138,21
6883,77,4315,1532,1814,18869,2501
1739,188,12439,1589,5734,92972,6705
41684,8,252,940,194,20285,58
62266,35,592,425,489,13652,103
5242,34,495,1552,328,9253,167
25662,93,1603,1263,1399,28911,204
51129,115,1159,778,791,21076,368
30219,10,285,1169,160,7371,125
12459,30,680,1487,348,8639,332
35245,113,2045,1074,1188,23073,857
53927,66,662,694,421,7285,241
1974,2,339,1587,238,20419,101
20860,6,594,1352,369,14063,225
37842,134,1918,1007,1739,23186,179
3819,400,6347,1570,4530,31695,1817
9288,373,9409,1512,5021,62529,4388
30375,37,2034,1166,1313,21189,721
64649,74,1115,358,884,14278,231
20191,55,2684,1364,1918,22906,766
23868,19,510,1302,361,10011,149
42428,31,819,929,684,17850,135
22136,26,1585,1332,1002,23158,583
31268,3038,52264,1149,30312,162531,21952
60679,45,623,479,451,12792,172
14913,558,12783,1453,9244,135786,3539
52347,15,317,742,246,10627,71
30559,0,67,1162,20,3398,47
26297,28,468,1250,385,15006,83
28715,286,7492,1198,5519,38041,1973
57326,50,822,591,762,9734,60
51408,45,522,771,329,10084,193
29868,476,16046,1176,10569,79243,5477
1285,19,823,1592,562,10519,261
3831,26,748,1570,559,19815,189
13230,3360,89353,1476,58241,617768,31112
15842,814,27363,1440,16627,126114,10736
34607,805,23407,1090,12799,78466,10608
29117,210,4260,1190,3058,29060,1202
62856,1800,36396,409,32381,252513,4015
32636,18,518,1128,338,10762,180
16582,25,634,1428,421,12868,213
15579,331,6424,1444,4530,85908,1894
2956,6,356,1579,141,11181,215
49549,75,610,819,479,17158,131
32689,122,2134,1128,1570,40182,564
37129,1052,20386,1026,15164,250471,5222
51606,336,4996,765,4616,40847,380
12965,53,2636,1480,1444,12450,1192
31514,28,478,1146,283,10236,195
9366,2190,44212,1511,29182,155606,15030
30131,222,7816,1170,5092,49687,2724
16462,5,188,1429,138,14085,50
57236,1280,30742,593,22609,108815,8133
63483,0,0,393,0,4091,0
52368,70,498,741,410,5657,88
44959,160,2142,896,2019,44462,123
64478,15,111,363,104,5954,7
13642,138,3408,1470,2004,48237,1404
7286,13,384,1526,284,12221,100
23181,0,0,1314,0,14515,0
15563,14,655,1444,487,23055,168
21340,10,744,1343,431,38793,313
6183,91,3642,1541,2599,17171,1043
53938,133,2571,693,1719,66484,852
36384,356,4264,1045,3426,40232,838
29137,3812,117629,1190,61195,553711,56434
53408,20,254,708,205,8240,49
56545,452,3630,612,3244,30470,386
3127,43,1274,1577,1032,12530,242
18271,11,470,1398,360,14290,110
5231,1108,24169,1552,12597,78990,11572
48752,24,415,843,365,9068,50
60903,4326,80598,470,70357,480663,10241
8442,5,219,1515,150,10634,69
48962,14,185,836,137,3672,48
26697,9,247,1240,158,5528,89
49582,34,242,819,198,4206,44
51501,89,1309,768,1027,20551,282
3129,46,3268,1577,2256,58101,1012
34861,5,319,1083,289,16907,30
1868,2,269,1588,197,17792,72
50024,22,381,807,238,7402,143
1797,866,22719,1589,12949,99779,9770
13168,0,151,1477,81,6397,70
62153,1354,15347,428,11573,60370,3774
10364,6,273,1505,178,6611,95
31500,68,852,1146,589,12898,263
2706,2843,54648,1581,36927,165758,17721
30153,48,1577,1170,985,30827,592
6016,27,798,1543,460,14349,338
45430,6,252,892,150,9180,102
16220,3,139,1433,86,5929,53
2643,22,728,1582,414,17936,314
771,21,324,1596,253,13334,71
62571,41,289,416,282,4896,7
20653,4,195,1356,166,22798,29
1236,92,7180,1593,4099,89505,3081
6423,41,1496,1538,958,14362,538
16029,43,1290,1436,837,19398,453
58751,53,743,546,697,9479,46
25192,210,5768,1273,3879,52454,1889
47988,234,3340,861,2893,33255,447
40575,45,1332,959,909,18364,423
19066,219,3732,1384,2302,31413,1430
8229,492,12790,1516,9040,109122,3750
38479,2759,41713,990,26168,133485,15545
41036,177,1497,951,1199,33499,298
31693,90,3210,1143,2503,36514,707
46192,23,294,883,231,11901,63
62359,5,62,422,54,5549,8
27275,29,1380,1228,678,14351,702
27578,734,17783,1220,9827,86739,7956
3874,252,5583,1569,4053,27687,1530
58339,68,1209,560,1135,18129,74
26197,31,1425,1252,887,13055,538
54195,11,168,684,127,13229,41
55556,23,140,640,122,9813,18
356,64,2449,1600,1851,36670,598
16418,1,150,1430,93,15610,57
52410,8,109,740,92,4757,17
54398,180,1437,677,1218,16263,219
30401,596,18305,1165,9840,62911,8465
64705,23,340,357,287,4499,53
28050,3,293,1211,170,7680,123
57467,1830,28427,588,23999,210229,4428
17546,6,191,1411,135,17729,56
33305,216,6890,1116,5136,58132,1754
63872,16,200,382,142,9895,58
23467,10,573,1310,413,10313,160
68844,16,417,230,299,12970,118
4261,21,1204,1565,760,16793,444
41364,25,285,946,209,13595,76
20402,109,2231,1360,1874,19271,357
2254,232,3450,1585,2178,41181,1272
10701,0,184,1503,112,5904,72
25380,259,5258,1269,3588,39191,1670
30278,88,2673,1168,2045,45765,628
39671,603,4970,972,4001,34437,969
19747,53,1292,1372,940,10585,352
36174,59,746,1051,564,14619,182
49570,1,41,819,33,2314,8
60717,28,432,478,315,8606,117
37774,5726,135754,998,64512,462574,71242
60963,1394,13129,468,10998,45939,2131
368,590,17660,1600,9367,90356,8293
35428,569,6311,1069,6193,45380,118
39991,30,847,968,614,9219,233
6362,590,16361,1539,9631,126403,6730
10545,70,2156,1504,1642,54383,514
36457,730,11579,1043,8348,33862,3231
20856,8,292,1352,200,13458,92
22109,40,958,1332,602,32237,356
32168,19,1637,1136,1066,29669,571
69827,20,377,197,313,4634,64
30684,2135,68975,1160,40046,241059,28929
62333,10,167,423,137,6459,30
14241,6,227,1462,180,7467,47
20959,98,1834,1350,1221,24555,613
29902,13,346,1175,232,27221,114
60496,29,341,486,269,15619,72
51131,1169,64508,778,14918,178803,49590
67818,627,9440,264,9277,89191,163
51577,144,1185,766,1148,20688,37
8566,542,23763,1515,9413,164785,14350
58544,71,762,550,650,16361,112
4018,97,3411,1568,2470,44762,941
64756,59,1478,355,982,9933,496
56536,72,652,612,594,13548,58
52793,7,168,726,140,12871,28
54649,5,72,667,55,8185,17
6480,33,929,1537,591,7886,338
58880,37,645,542,580,12342,65
21800,15,521,1336,249,19097,272
29667,62,1889,1181,755,27479,1134
68313,4,32,249,24,1499,8
64080,2,38,375,30,1597,8
2853,16,1254,1580,872,53679,382
66400,45,997,259,347,12299,650
4219,84,2017,1566,1776,36149,241
5932,2396,41263,1544,31765,238862,9498
51270,1296,15789,775,11812,67598,3977
36823,78,1369,1035,1362,15293,7
27146,381,7350,1230,5371,68613,1979
52049,554,6966,752,5169,90071,1797
67548,53,820,272,638,16037,182
7774,119,4782,1520,3409,54164,1373
34070,35,605,1101,411,11200,194
34342,237,8755,1095,3068,72740,5687
63079,3,34,403,23,1836,11
66878,93,1330,294,1199,30097,131
41440,32,263,945,172,5073,91
29439,365,9665,1184,6635,49632,3030
6163,234,7047,1541,5429,66208,1618
34939,157,2949,1081,2327,14962,622
49547,1541,38751,819,21287,287011,17464
22505,50,2663,1327,1526,40637,1137
31600,34,889,1145,463,22101,426
15337,56,1924,1447,1258,13177,666
16066,64,1187,1435,798,44282,389
8003,9007,282813,1518,132917,921671,149896
54241,33,215,683,191,3301,24
59088,30,476,536,368,5334,108
6167,3,337,1541,160,14406,177
25364,107,1479,1269,956,15912,523
12829,1,190,1482,59,7351,131
4845,89,2674,1557,1795,59747,879
25399,67,1849,1269,1097,28199,752
10101,56,915,1507,630,19631,285
15545,703,12978,1444,8682,128377,4296
50810,16,261,787,222,6360,39
11752,24,1281,1494,656,27085,625
30614,126,3224,1161,2243,39082,981
39986,38,456,968,359,13150,97
22760,63,1331,1322,1030,33909,301
7562,81,3795,1523,2674,60227,1121
62185,140,2329,427,2224,13165,105
29288,4,98,1187,79,11338,19
4987,49,1491,1555,1029,47496,462
12748,63,1765,1483,843,12999,922
57358,50,1020,590,824,17110,196
7391,106,5194,1525,3443,79441,1751
30636,3050,66206,1161,41375,136467,24831
30215,14,421,1169,286,4679,135
54955,573,6503,657,6234,51870,269
21258,20,1023,1345,651,13592,372
36107,62,544,1053,417,6642,127
8584,1,214,1515,133,8420,81
52206,41,362,747,314,13820,48
54902,32,362,658,273,10479,89
7761,76,4337,1520,2393,55556,1944
13694,8,306,1470,177,14072,129
37022,3972,94540,1029,50507,349359,44033
5615,81,1837,1547,1269,17594,568
33219,5805,116851,1118,76019,564777,40832
16132,133,1757,1435,1299,17567,458
8390,9,502,1515,228,12481,274
65455,17,314,336,314,11083,0
9111,110,2956,1512,1842,32020,1114
2197,36,3329,1585,2329,50920,1000
15944,48,794,1438,442,10539,352
62021,14,325,433,294,6080,31
20433,753,22934,1360,11867,159158,11067
47047,17,228,872,195,10465,33
3165,578,13625,1577,8327,90623,5298
58873,1077,26139,542,16006,156301,10133
23971,1040,13602,1300,9931,74843,3671
32074,35,1082,1137,593,12946,489
32567,68,702,1129,565,12213,137
23897,27,770,1302,509,13091,261
62628,106,1493,414,1443,15567,50
61171,19,616,461,435,15165,181
67026,5,114,290,94,3831,20
30804,701,10985,1157,7461,36243,3524
25044,11,476,1276,317,19502,159
54572,419,4881,670,4433,40664,448
51804,27,425,759,266,8321,159
819,51,2645,1596,1330,30511,1315
11243,34,1479,1499,831,25771,648
52851,62,729,719,540,8519,189
8201,6,308,1516,176,5388,132
19486,235,3558,1376,1802,31923,1756
15799,427,6956,1440,4987,58076,1969
11836,1347,34576,1493,19051,170524,15525
1162,33,911,1593,568,40209,343
67326,76,1162,279,876,14821,286
6793,15,918,1533,330,8616,588
17265,15,333,1416,280,6467,53
57477,27,221,588,189,11148,32
19650,99,2379,1373,1291,29210,1088
7161,19,364,1528,254,9524,110
66577,15,186,304,186,6643,0
69829,11,156,197,152,5396,4
35100,90,1572,1078,1125,14313,447
41547,26,411,943,343,11596,68
16419,45,1639,1430,1131,20875,508
28950,2099,75974,1194,51990,476682,23984
3918,84,5940,1569,1551,59657,4389
7513,20,565,1523,420,23836,145
20996,13,277,1350,151,7113,126
12553,7221,293843,1485,128936,989246,164907
2971,2188,135104,1578,79657,863800,55447
25768,68,1939,1261,1173,17033,766
8047,51,1134,1517,669,8582,465
49862,15,178,811,124,7102,54
9621,1241,27033,1510,16902,105040,10131
19272,19,307,1380,209,13152,98
56024,359,5357,627,4824,45830,533
17651,238,6652,1409,3847,65265,2805
46912,35,871,874,672,15863,199
55460,3217,76284,643,41505,401992,34779
27851,13,393,1215,223,11430,170
50093,474,5436,805,4804,65518,632
59362,876,19889,526,10699,120967,9190
33916,1910,24173,1105,18710,76629,5463
59480,62,1607,522,1221,13251,386
6077,5,168,1542,104,6457,64
36503,29,434,1041,310,10464,124
17550,114,2477,1411,1709,25709,768
12163,1327,64481,1490,32932,280779,31549
20717,2,264,1355,194,4397,70
6356,233,13767,1539,8050,84011,5717
20193,32470,932262,1364,499048,1810051,433214
64189,113,2247,372,1934,14276,313
23304,109,2923,1313,1749,27796,1174
14964,33,1095,1452,764,8265,331
4746,116,6254,1558,2861,64402,3393
4323,4931,269468,1564,130368,1064949,139100
19541,139,3085,1375,2312,38020,773
4298,5,151,1565,106,18845,45
35019,25,793,1079,506,22181,287
49904,0,5,810,5,2155,0
17199,4,98,1417,80,19181,18
27775,227,4683,1217,3153,48954,1530
66740,9,127,299,98,5064,29
56013,56,1092,628,795,30462,297
49130,3157,39531,831,33639,315097,5892
28296,121,3667,1206,2413,57753,1254
30441,279,8696,1164,4951,45768,3745
35521,194,3905,1067,2406,94009,1499
62174,11,244,428,208,6747,36
61460,2687,32015,452,29662,139149,2353
20154,6,215,1364,171,8567,44
5592,3,326,1548,220,17233,106
21512,1052,27208,1340,16483,155226,10725
10009,65,1404,1507,721,8664,683
15789,15,251,1441,180,7432,71
2988,201,7211,1578,5214,58304,1997
56015,33,484,627,407,7424,77
59315,16,105,527,93,4801,12
13763,138,3267,1469,1584,25238,1683
4430,29,1180,1563,715,19666,465
44452,12,95,902,81,10990,14
52375,83,983,741,878,26340,105
15598,15,519,1443,401,10699,118
36040,1,128,1055,82,2081,46
26815,45,729,1237,526,11095,203
40632,129,1909,958,1463,24512,446
56960,79,1060,600,955,13605,105
65852,135,2950,326,2898,29896,52
16487,35,739,1429,428,8312,311
63878,71,422,382,325,6571,97
63208,24,225,400,194,7872,31
58145,121,4678,567,3321,36127,1357
41225,19,394,948,385,7400,9
57841,1035,13464,576,12802,102974,662
57646,1195,31736,583,20115,194792,11621
31965,21,588,1139,409,7007,179
17257,2503,58392,1416,35969,113334,22423
4409,448,22012,1563,15213,119274,6799
48366,1155,14049,855,10152,122675,3897
52835,871,9038,725,7642,172347,1396
64,16,1003,1604,582,19486,421
7867,117,5748,1518,1982,59278,3766
26133,9,197,1253,131,5380,66
51870,296,2012,758,1794,24421,218
61762,93,2262,442,2076,66191,186
53784,7,92,698,89,7194,3
62051,28,343,432,341,8182,2
22800,2325,51546,1321,34526,163398,17020
5330,22,1345,1551,787,23923,558
19651,152,4443,1373,3223,40158,1220
240,347,26523,1601,12635,130613,13888
29421,10,243,1185,191,22055,52
58042,7,102,570,94,5191,8
17441,2,212,1413,156,11074,56
52127,231,2048,749,1766,38574,282
34791,24,702,1085,474,5481,228
4899,126,3718,1556,2747,64208,971
3620,402,26440,1572,11852,306330,14588
13964,36,497,1466,381,20074,116
12520,43,1959,1486,947,42053,1012
10595,26,1134,1504,781,29474,353
53716,884,13580,700,8374,100835,5206
24499,39,968,1288,818,25140,150
59356,93,1397,526,1293,20528,104
47445,71,1409,867,1231,14087,178
46685,350,6515,876,3623,44244,2892
13301,3,209,1475,59,8515,150
2871,7,365,1579,266,7545,99
31168,613,12515,1151,6970,125964,5545
24308,2,175,1293,93,7282,82
1696,18,1019,1589,637,14768,382
18842,21,1309,1387,940,39927,369
29678,66,1800,1181,1220,40102,580
28320,9,429,1206,260,9630,169
28376,18,705,1205,473,4836,232
25954,9,415,1257,229,10017,186
52969,31,236,721,216,3117,20
32439,5,144,1132,98,3393,46
15266,2,111,1448,49,6845,62
18036,58,2018,1401,1308,20895,710
67429,174,3333,277,2897,45613,436
25765,71,1202,1261,831,11613,371
18385,11,275,1395,191,9835,84
65221,42,522,341,393,8958,129
22331,487,18106,1329,10920,128326,7186
23962,945,32073,1301,17092,195231,14981
507,236,6102,1598,1746,281404,4356
54058,513,5758,689,5032,50732,726
38730,4,195,984,160,7785,35
47343,15,213,868,167,6746,46
10374,37,2088,1505,1363,26602,725
18529,113,3255,1393,2154,27587,1101
33676,44,1243,1109,471,12102,772
14633,23,506,1456,346,14707,160
53153,179,2034,715,1731,25158,303
20224,76,1834,1363,1311,31245,523
41662,678,9709,941,8000,43793,1709
48780,315,9126,842,6034,102505,3092
80,736,17353,1604,10541,125622,6812
23993,291,12295,1300,8340,89633,3955
65304,57,1208,340,1038,17773,170
34431,0,0,1094,0,4293,0
23639,152,3922,1307,2244,45573,1678
61681,13,89,445,73,3466,16
55297,2,45,647,38,4796,7
51183,3,31,777,31,2552,0
57292,16,341,590,308,9043,33
449,7,308,1599,222,24932,86
53302,37,576,711,477,14158,99
58273,9,102,562,100,6620,2
25496,17,316,1267,231,14241,85
37911,259,4137,1005,3309,74802,828
23493,1,58,1309,50,7219,8
5356,15,284,1550,177,8672,107
66105,383,9406,319,6240,122660,3166
2163,5,577,1586,404,6860,173
52642,44,691,731,503,20269,188
24806,239,8057,1281,5609,72844,2448
1536,33,1605,1591,1142,37066,463
47264,182,3227,869,3014,31362,213
33101,229,5425,1120,4103,56966,1322
43429,6,336,913,183,11494,153
49056,708,7759,833,6883,41164,876
4336,82,2552,1564,1723,19776,829
54609,658,5696,428,5408,51369,288
30658,187,7480,1160,4764,23798,2716
5548,67,2311,1548,1480,13724,831
1348,87,4775,1592,3427,36971,1348
58836,32,289,544,256,4241,33
20470,138,3846,1359,2736,31716,1110
24747,429,12281,1282,7424,122558,4857
20178,6,221,1364,171,13708,50
51553,47,594,767,507,12446,87
49009,45,322,835,276,4871,46
63895,248,5752,381,3779,36630,1973
28488,647,40883,1203,14733,150945,26150
63919,32,541,380,445,4697,96
28995,175,5607,1193,3829,112999,1778
60422,13,157,489,109,4160,48
20291,43,1199,1362,1041,41080,158
11762,7,477,1494,237,22377,240
14508,1,74,1458,43,4369,31
65222,124,5378,341,2222,19441,3156
55065,443,5274,653,4130,36784,1144
29187,18,924,1189,509,16987,415
33144,1934,44930,1119,30011,374719,14919
8532,48,1926,1515,1290,20816,636
55686,32,434,637,394,9214,40
39400,2610,39398,976,26346,295083,13052
60910,3337,46373,463,33315,268105,13058
33519,74,1703,1112,1099,14383,604
24333,60,830,1292,526,7808,304
10133,7,216,1507,136,20869,80
6561,23,1016,1536,730,27649,286
35649,32,479,1063,342,8513,137
52823,149,1927,725,1843,20879,84
2834,17,175,1580,124,6101,51
66323,20,306,313,206,7262,100
42233,93,3764,932,1921,27913,1843
1281,130,1823,1592,1198,13794,625
787,16,945,1596,614,13221,331
68247,3,27,251,27,3252,0
33028,188,4853,1121,2514,44473,2339
21443,322,9808,1341,6369,77283,3439
29219,33,1081,1188,607,32344,474
13752,191,6805,1469,4569,79398,2236
14361,80,1363,1460,933,13751,430
28656,18,611,1199,400,9827,211
23690,293,5019,1306,3300,35679,1719
44414,2,19,902,16,2411,3
16481,2306,84387,1429,40694,414229,43693
16261,3,114,1433,85,18125,29
13183,64,2815,1477,1308,17171,1507
66182,0,0,316,0,3153,0
28901,183,2512,1195,1698,14968,814
64113,12,225,374,171,3650,54
59896,53,619,508,572,9072,47
62701,2180,28562,413,28210,103817,352
37841,17,330,1007,288,9681,42
47765,119,1942,863,1559,22620,383
24454,75,2269,1289,1324,26413,945
33943,19,196,1104,126,6640,70
30497,26,646,1163,488,5018,158
58418,3893,85980,547,68719,414061,17261
61808,957,16897,440,12513,75469,4384
36072,13,439,1054,344,5333,95
20027,108,3858,1367,2965,30661,893
13145,226,13500,1477,3360,70469,10140
45235,2512,53718,894,34787,355176,18931
14062,302,8256,1464,4841,64407,3415
7202,279,11413,1527,5839,55518,5574
36431,2435,54329,1043,29716,305718,24613
5983,15,345,1543,269,13006,76
35169,13,150,1076,120,5758,30
13885,86,1776,1467,1101,13917,675
24882,22,734,1279,514,17649,220
56472,36,630,614,517,16269,113
25449,11,574,1268,270,5892,304
37296,18,425,1021,358,4818,67
43955,16,105,908,82,7432,23
42504,7,215,928,168,7827,47
45539,55,872,890,729,14287,143
18948,49,971,1386,696,17025,275
67929,13,180,261,159,4258,21
11373,18,1153,1498,614,17864,539
64114,9,135,374,123,4157,12
10922,3,81,1501,62,13429,19
52300,11,117,743,70,3634,47
5442,143,5038,1549,1518,52927,3520
12683,1184,58695,1484,20341,282004,38354
11480,27,891,1497,574,19787,317
15107,132,2647,1451,1816,26437,831
3650,15,728,1572,498,21577,230
66524,6,69,306,42,4653,27
26166,223,2728,1253,1861,22787,867
37449,41,854,1017,689,16328,165
19340,4914,87968,1379,54073,274552,33895
22806,87,2723,1321,1304,23265,1419
15494,8819,247309,1445,150796,1085233,96513
58021,27,459,571,353,11419,106
13252,114,5661,1476,3024,25655,2637
12987,1318,49798,1480,26340,319437,23458
28654,14,105,1199,62,3219,43
63220,35,555,400,493,13038,62
68085,14,274,256,199,6562,75
66158,3,45,317,31,3073,14
56832,22,411,603,353,8376,58
483,4,208,1599,142,12473,66
37933,6,92,1005,55,13444,37
20746,99,5015,1355,2733,76455,2282
21008,158,4059,1349,3047,77903,1012
29612,93,3073,1182,1928,16453,1145
49787,62,1131,734,1021,23488,110
60649,219,3796,480,3381,51301,415
62192,312,2319,427,1899,24248,420
13855,5,235,1467,132,8692,103
40579,1289,36881,959,25632,107452,11249
51993,59,810,754,675,11161,135
26200,27,1608,1252,884,6874,724
19498,14,526,1376,373,31906,153
25040,5,480,1276,308,18597,172
20836,1344,37679,1353,26638,388183,11041
17010,1326,42670,1420,14380,157762,28290
53457,54,431,708,320,9958,111
147,18,1055,1602,623,24076,432
61558,38,372,449,260,10290,112
29756,673,15619,1179,12962,39577,2657
57439,2,33,588,33,2998,0
17704,6526,267904,1408,114622,1112559,153282
30783,45,625,1158,540,12323,85
1786,22,638,1589,371,18081,267
3360,38,1108,1575,840,24737,268
19977,84,1260,1367,774,12446,486
31683,1812,52353,1143,22719,138461,29634
439,11,214,1599,158,15983,56
20768,18,807,1354,594,32183,213
44743,93,964,899,778,9578,186
36960,793,11892,1031,8316,103027,3576
4091,79,1924,1567,1173,23703,751
35587,26,729,1066,605,25138,124
55139,58,789,651,647,15608,142
11921,20,804,1492,504,44167,300
12780,8,163,1483,96,5983,67
69230,119,7101,217,6090,28387,1011
27678,93,3711,1218,2054,25792,1657
48224,128,1889,857,1637,14411,252
52679,26,333,730,212,10750,121
2183,53,1342,1585,824,20222,518
11372,30,1553,1498,756,18197,797
37132,16,308,1026,280,23955,28
34715,273,7248,1086,4912,99052,2336
14698,305,10062,1456,7212,127889,2850
13670,91,1510,1470,875,10391,635
15118,40,730,1450,488,10197,242
68610,46,499,238,376,3306,123
67062,18,264,289,195,8437,69
16051,5,160,1436,135,34199,25
2054,1024,29514,1587,18127,105238,11387
18045,25819,555015,1401,288575,1617768,266440
1816,56,3885,1588,2669,86497,1216
18888,39,1803,1387,1220,38112,583
57711,23,274,581,202,10190,72
47993,912,13656,860,11948,165715,1708
41361,6,100,946,84,7190,16
21218,30,1283,1345,765,9361,518
17450,121,2329,1413,2024,39738,305
52461,3,71,738,60,4702,11
24215,97,2384,1295,1452,10440,932
6570,23,659,1536,337,18351,322
67343,37,455,279,441,12249,14
54520,237,3762,672,3132,28860,630
3353,5,385,1575,279,7042,106
64856,571,23002,352,12479,97265,10523
36198,27,994,1051,715,29085,279
51626,79,1773,764,588,21338,1185
320,8,674,1600,484,40558,190
9563,356,11394,1510,6871,57086,4523
34382,46,1035,1095,667,12993,368
14127,0,316,1463,233,16377,83
34857,12,250,1083,111,10141,139
27815,9091,274654,1216,142278,929055,132376
67382,11,136,278,123,5325,13
58257,512,8066,562,6605,59748,1461
61702,24,271,444,233,6041,38
49311,53,582,825,448,19398,134
20307,5,142,1362,120,7480,22
63554,3,76,392,76,7752,0
17330,22,1014,1415,660,20482,354
38312,142,1806,995,1436,21384,370
25514,243,4796,1267,3509,32607,1287
30560,11,248,1162,164,2850,84
60613,51,615,482,505,12368,110
45322,169,3230,893,2260,51409,970
29022,3,123,1192,84,4691,39
10851,10,292,1502,208,24532,84
397,232,14853,1599,6761,193191,8092
33655,121,3426,1109,2220,38493,1206
38390,8,272,992,208,10181,64
30777,204,6037,1158,3521,19385,2516
29175,2299,35156,1189,13732,327647,21424
66098,62,858,319,693,10034,165
69178,44,732,218,672,10360,60
15200,27,1019,1449,728,21040,291
56072,4,279,626,104,6199,175
17832,78,3045,1405,1460,27264,1585
9223,170,3000,1512,1983,35724,1017
34886,1078,14533,1082,10426,99654,4107
40540,20,456,959,364,7522,92
19941,69,1977,1368,1432,22661,545
30208,51,3681,1169,1061,14492,2620
63760,158,1788,386,1701,9186,87
66696,2,23,301,19,2462,4
18158,219,3446,1400,2675,34794,771
30669,18,413,1160,269,4979,144
24562,4,239,1287,172,7620,67
59945,478,7279,506,6979,65903,300
26968,81,3515,1234,2318,23420,1197
35151,2,119,1076,73,5106,46
6421,12,485,1538,336,15993,149
30025,11,1193,1173,495,14083,698
26189,106,1437,1252,982,9345,455
8832,548,14915,1513,8745,75148,6170
16679,190,6307,1426,3546,70036,2761
8763,32,2358,1514,581,20054,1777
8885,76,2154,1513,694,13252,1460
28197,29,950,1208,559,6328,391
4693,19,457,1559,350,28776,107
21886,138,3989,1335,2590,27869,1399
61233,786,10582,458,10428,55041,154
20830,39,976,1353,665,14185,311
21715,99,3378,1337,1949,68585,1429
9585,92,1512,1510,895,20551,617
68885,2,65,228,36,6920,29
21788,39,763,1336,578,24140,185
55415,0,0,644,0,4806,0
13931,15621,383870,1466,196297,1111585,187573
30248,206,8209,1168,4807,63668,3402
12901,80,2130,1481,1231,20463,899
54282,32,344,681,290,8293,54
7201,275,14606,1527,7781,102237,6825
60060,60,1297,502,1058,25749,239
55010,6,41,655,29,3146,12
41090,32,638,950,505,15094,133
5756,53,2327,1546,1272,48916,1055
10439,20,998,1505,625,14632,373
29322,27,423,1187,339,6609,84
17537,16,570,1411,316,21810,254
35341,36,967,1071,646,10156,321
61029,13,231,466,192,6802,39
15154,3,148,1450,110,9263,38
38725,415,7733,984,6191,34800,1542
58331,313,5305,560,4576,52339,729
62106,57,862,430,663,24400,199
25223,117,2861,1273,2049,21881,812
9036,36,872,1513,571,9290,301
49847,685,9614,812,7991,61640,1623
52455,237,3580,738,3220,17066,360
12578,127,4619,1485,2673,48033,1946
5191,11,569,1552,453,13126,116
12542,138,7899,1486,3505,27167,4394
35085,12,174,1078,122,7128,52
50709,14,85,790,74,3659,11
43115,169,2346,917,2134,30166,212
11187,2647,97657,1499,54409,575804,43248
60982,64,473,468,446,10407,27
8441,57,1280,1515,877,14604,403
32919,128,4481,1122,3350,48592,1131
60106,38,553,501,459,9214,94
11737,14,927,1494,485,20057,442
34682,2,104,1088,60,3543,44
14785,1,69,1455,46,7125,23
11901,19,1141,1493,499,13732,642
42284,59,1436,932,1225,13007,211
44501,11,197,902,124,7654,73
49848,72,854,812,655,8686,199
22845,8,422,1320,294,7244,128
27159,26,1453,1230,954,29854,499
53272,5,148,712,50,3057,98
10334,10,521,1505,373,8967,148
27108,337,13904,1231,7258,148659,6646
16412,354,12184,1430,9401,79171,2783
64053,11,131,376,96,8568,35
37229,94,1244,1023,834,21896,410
7347,483,19108,1526,8581,104726,10527
24159,112,2431,1296,1349,20851,1082
58344,70,606,560,551,12726,55
61055,6,80,465,67,7279,13
39385,52,438,975,358,10075,80
14269,25,1236,1461,439,34112,797
26970,0,54,1234,45,7021,9
68235,27,355,252,291,9729,64
63457,6,98,394,73,4984,25
13866,72,3686,1467,1996,46169,1690
10263,14,832,1506,507,13767,325
5433,48,3958,1550,2460,49148,1498
26965,11,491,1234,327,7321,164
13886,0,0,1467,0,12903,0
17193,23,529,1417,385,6050,144
35306,40,658,1072,471,10191,187
6335,4033,108048,1539,55868,285480,52180
17748,17,126,1407,87,5669,39
31812,3,78,1141,59,6456,19
35491,29,293,1068,233,4942,60
30652,17,513,1160,351,16624,162
13772,11,265,1469,165,10711,100
7242,36,1579,1527,1048,21492,531
35221,22,394,1074,382,6153,12
10145,8,240,1507,175,44151,65
56431,74,1126,615,924,23632,202
10771,145,3860,1502,2594,35562,1266
18711,10,852,1390,559,14577,293
2247,27,599,1585,250,13718,349
50874,19,284,786,216,6632,68
48329,520,6382,855,4955,178356,1427
13056,455,14896,1478,8421,76434,6475
6279,99,8017,1540,3928,39760,4089
43177,397,8988,916,5874,61362,3114
41275,88,1938,947,1495,23534,443
61207,86,1097,352,797,11555,300
26352,1355,33952,1248,19498,201391,14454
41643,32,813,941,661,12908,152
11871,6152,361238,1493,142434,1313574,218804
11200,59,1150,1499,752,10382,398
60763,1065,19123,476,15009,133045,4114
7016,39,855,1530,593,10746,262
8193,460,18414,1516,9372,78491,9042
19435,206,3500,1377,2728,43475,772
6173,3357,249798,1541,103032,831617,146766
30220,7,243,1169,162,16359,81
58708,4740,111222,547,79548,670589,31674
58410,7,117,558,35,4053,82
41794,79,1631,939,1409,33669,222
60369,29,309,491,295,8970,14
53615,123,2485,703,1900,24891,585
22648,317,7614,1324,5626,35029,1988
18361,68,1446,1396,960,24300,486
23614,738,21079,1307,15098,82309,5981
51627,62,909,764,833,15697,76
33834,6,130,1106,92,5363,38
62140,113,1061,426,898,13979,163
9423,977,25487,1511,16355,131591,9132
22227,28,1018,1330,626,18600,392
66679,0,10,301,10,4554,0
26127,158,4026,1253,2358,17430,1668
1768,2,305,1589,220,25382,85
9586,37,418,1510,230,9840,188
13002,2,221,1479,107,6749,114
11551,328,8447,1496,4973,37491,3474
57166,28,340,595,278,7293,62
10410,200,7111,1505,4388,79948,2723
37962,421,6996,1003,5410,95959,1586
40105,131,1685,966,1406,14777,279
19241,25,910,1380,623,9986,287
61077,77,3141,464,1975,24734,1166
20591,32,1427,1357,939,10314,488
2394,412,12235,1584,7614,100995,4621
10448,23,988,1505,661,36435,327
22924,175,4528,1319,3332,43866,1196
49571,25,352,819,333,10669,19
34955,597,9267,1081,6237,43707,3030
15837,146,4040,1440,2656,54208,1384
50129,95,1485,804,1092,27420,393
35832,40,585,1060,431,6794,154
12462,9,826,1486,476,11163,350
46426,15,194,880,163,6849,31
15707,445,14186,1442,8022,56574,6164
12758,34,1008,1483,582,11179,426
30186,47,852,1169,699,28139,153
55483,1,97,642,54,3887,43
28365,47,528,1205,506,6958,22
2317,5408,115920,1584,58295,217648,57625
6285,109,7007,1540,4494,55365,2513
2990,40,815,1578,600,16853,215
57569,76,1055,585,842,18361,213
20435,24,442,1360,288,7248,154
3864,16,451,1569,253,16983,198
10725,26,1070,1503,697,25306,373
35212,19,441,1074,287,19364,154
43381,1394,39018,909,16458,235230,22560
22866,36,985,1320,836,28679,149
23977,398,15000,1300,7970,149273,7030
7028,145,2268,1530,1510,12697,758
57855,49,479,575,428,3442,51
64274,61,758,369,659,8097,99
56009,11,153,628,121,5914,32
16868,32,1151,1423,744,20804,407
23777,14,693,1304,433,22791,260
52976,276,4629,720,3538,73064,1091
19193,964,32351,1381,18890,257947,13461
15431,1657,48632,1446,23807,206490,24825
11791,172,4637,1494,2076,25327,2561
39042,33,501,980,371,7132,130
57435,163,1112,588,760,27712,352
49067,32,372,833,309,6396,63
12415,11,617,1487,336,11719,281
63904,64,948,381,858,23565,90
10629,109,3136,1503,2204,39715,932
1889,73,2056,1588,1468,30137,588
24990,42,1304,1277,866,8107,438
20984,112,2075,1350,1510,41331,565
24446,452,8601,1290,5641,31432,2960
40680,0,560,958,421,5961,139
10820,62,3212,1502,2119,15379,1093
30701,18,590,1159,376,10608,214
54440,43,542,675,374,12991,168
47975,22,324,861,265,15735,59
57079,31,326,597,282,3604,44
20264,9,335,1363,271,34742,64
8927,39,1562,1513,1022,10380,540
14583,4,168,1457,126,10844,42
25141,16,189,1274,134,4675,55
63506,42,454,392,433,9744,21
61075,1960,42980,464,27239,229070,15741
11471,159,2795,1497,1941,15422,854
3796,12,375,1570,271,24827,104
57955,5,113,573,62,8899,51
53635,5,50,703,38,2806,12
57495,1,20,587,17,4498,3
62521,30,492,418,469,6426,23
3573,216,5112,1573,3515,64536,1597
15679,24,644,1442,434,8980,210
20685,25,744,1356,545,12702,199
34751,52,1449,1086,1003,7363,446
13137,135,5161,1477,3372,43349,1789
37638,375,7146,1012,4121,29087,3025
55474,684,4716,642,4503,31496,213
2964,64,2539,1578,1569,46869,970
7407,2,51,1525,44,3333,7
62102,12,76,430,73,6645,3
40976,6,72,952,62,8475,10
53807,8,189,698,111,13549,78
13800,260,6384,1468,4581,41237,1803
53005,28,213,719,201,13620,12
7343,33,927,1526,669,43572,258
10943,55,2528,1501,1441,55997,1087
12131,25,1194,1491,587,32557,607
21370,34,311,1343,253,25550,58
13550,82,2225,1471,1122,11982,1103
30975,26,416,1154,222,5406,194
11063,41,1326,1500,863,11538,463
29255,39,961,1188,591,15866,370
12229,29,1550,1490,904,13289,646
52129,8,168,749,73,8542,95
7693,110,5765,1521,3001,95565,2764
15159,1,107,1450,85,9403,22
50833,4,287,787,154,11542,133
2884,10,288,1579,213,16723,75
1303,44,1413,1592,990,16556,423
3530,30,887,1573,708,23064,179
8633,32,728,1514,471,10167,257
28463,166,15835,1203,9626,55581,6209
38275,30,531,995,452,16779,79
18276,118,3622,1398,2394,17590,1228
65913,40,352,325,344,7762,8
12332,24,2796,1488,1009,30599,1787
52626,25,271,732,234,8965,37
53913,61,827,694,760,12534,67
4667,6,556,1559,286,21464,270
10821,20,1005,1502,665,14904,340
15717,12,301,1442,256,17324,45
24525,93,2016,1288,1171,22910,845
59577,17,136,519,119,7924,17
2497,167,4796,1583,3294,48280,1502
1347,54,4797,1592,1682,82780,3115
60995,3,136,467,123,3619,13
7443,51,906,1524,754,56848,152
11269,0,0,1499,0,32666,0
20765,37,965,1354,698,47488,267
65264,9,114,340,82,5573,32
21472,33,754,1341,504,9583,250
54210,16,204,684,179,10188,25
25230,39,526,1273,345,8546,181
11937,14,466,1492,229,24941,237
41535,44,1278,944,1103,19182,175
33319,72,1805,1108,1034,12640,771
835,17,1134,1596,582,17529,552
41291,310,4425,947,3559,31168,866
9052,79,1702,1512,757,16917,945
57975,91,1122,572,1052,18424,70
11301,53,2220,1498,1284,14281,936
20135,5,286,1365,212,15686,74
6525,15,331,1536,268,22883,63
9746,5,128,1509,94,8240,34
50620,15,143,792,133,7491,10
57567,4,176,585,48,6211,128
19599,48,1360,1374,967,12242,393
24781,28,440,1282,353,16688,87
29352,16,539,1186,364,14069,175
31978,108,2711,1139,1870,37913,841
19348,2154,36222,1379,21713,281857,14509
26520,3,193,1245,144,7126,49
13936,21,2829,1466,1534,41872,1295
20620,262,3956,1357,2821,19053,1135
4373,26,700,1563,512,11887,188
37833,70,1671,1007,1334,18942,337
58334,997,25161,560,18019,105276,7142
16617,1451,31002,1427,21395,146492,9607
36199,7,140,1051,117,7680,23
49886,46,1119,810,660,22996,459
60810,35,375,474,294,9321,81
50225,345,6203,802,5180,47814,1023
30970,7,154,1154,104,10553,50
36345,55,763,1046,613,12569,150
13303,24,540,1475,217,8163,323
34736,384,7676,1083,3870,86645,3806
27891,11,298,1214,224,17982,74
28689,84,1657,1199,1060,17867,597
56932,1,22,601,16,2530,6
24224,908,11420,1295,7639,74761,3781
5508,279,12220,1549,6692,100948,5528
63556,452,6771,392,5512,27088,1259
23562,8,480,1308,360,8315,120
58583,5,100,551,77,4064,23
54839,111,800,660,711,8417,89
9858,13,1366,1508,703,15356,663
2436,24,836,1583,638,20532,198
4141,11595,439090,1567,214133,1342089,224957
36349,22,294,1046,228,16074,66
35279,109,2699,1073,1850,35279,849
16983,1130,40597,1421,24228,285544,16369
35445,36,456,1068,359,4692,97
2463,57,2162,1583,1544,49984,618
10475,1,143,1504,97,6775,46
66258,8,97,314,74,4702,23
64213,58,710,371,613,11581,97
12507,141,3458,1486,1928,44656,1530
4787,0,0,1558,0,28141,0
59506,291,5942,521,4287,38174,1655
20453,3846,136750,1359,82635,744259,54115
35567,46,222,930,204,26749,18
25592,31,1216,1265,726,16973,490
24898,2820,103059,1279,61222,305164,41837
14227,34140,972171,1462,514455,2319297,457716
41279,312,5383,947,4714,57205,669
20165,9,416,1364,300,25716,116
37300,2,35,1020,34,3101,1
19175,8,494,1382,294,10821,200
62710,90,891,413,882,11691,9
9353,85,2386,1511,1292,31878,1094
32406,12,153,1132,117,13047,36
60329,181,2741,493,1974,31642,767
5475,29,930,1549,660,33367,270
23262,13,301,1313,271,18635,30
29437,23,680,1184,487,35478,193
10977,11,499,1501,305,10290,194
48983,14,281,836,221,5817,60
1045,69,1694,1594,1245,21499,449
61443,135,1597,452,970,27841,627
20735,80,4196,1355,2305,50485,1891
51030,134,1533,781,1455,17787,78
51094,1344,12416,779,10049,91266,2367
65530,43,785,335,702,15633,83
40589,23,367,959,299,9718,68
29890,8,703,1176,396,12155,307
53318,609,8394,711,7435,78776,959
55561,1,52,640,26,2994,26
43641,1549,26937,911,19197,194512,7740
9972,278,5163,1508,3720,36980,1443
29105,301,7863,1191,5145,66779,2718
18829,13,623,1388,449,11866,174
14302,8,1355,1461,419,10408,936
10447,5,164,1505,114,7619,50
11908,218,19404,1493,6669,149184,12735
51407,10,194,770,157,8810,37
21050,11,447,1349,270,8593,177
1195,41,1685,1593,1150,15786,535
6959,77,5573,1531,1392,37783,4181
7731,9,303,1520,210,11384,93
28276,84,2713,1207,1726,18108,987
68928,167,2676,227,2572,33760,104
43063,261,4133,918,2564,29471,1569
10015,35,1190,1507,821,21216,369
54784,243,2295,662,1579,38592,716
14734,5,133,1455,68,9266,65
36144,8,393,1052,302,16349,91
51641,0,24,764,19,2759,5
62873,10,154,409,133,8351,21
34313,90,1196,1097,764,17872,432
18063,6,234,1401,182,14211,52
49706,59,843,815,729,13358,114
24237,102,1468,1295,1137,20356,331
46299,14,269,882,199,9681,70
26144,19,517,1253,360,8553,157
53709,3,36,700,24,3893,12
30226,14,336,1169,256,10567,80
26260,44,1568,1251,861,18366,707
67628,6,49,269,37,2563,12
48480,1154,23212,852,15488,186092,7724
16186,144,5231,1434,3371,73671,1860
60575,196,3456,483,2427,33771,1029
41594,49,433,942,398,8499,35
45740,64,783,888,693,34823,90
30554,1577,32391,1162,23521,169076,8870
38148,1039,19841,998,14403,73557,5438
70195,4,47,185,33,2308,14
13860,1885,51083,1467,30986,186109,20097
4085,1621,29262,1567,18934,134653,10328
48990,106,1419,835,1232,31060,187
18544,1150,41619,1393,26795,141035,14824
43213,268,2660,916,2334,16346,326
27976,16,285,1212,184,6348,101
10965,66,1737,1501,1144,29147,593
1254,3,223,1593,153,33912,70
316,25,989,1600,780,25712,209
21782,26,724,1336,371,9253,353
26445,2394,47957,1246,26989,234582,20968
43409,249,3896,914,3456,28647,440
60382,157,1984,491,1689,36567,295
32721,44,1893,1127,1217,24334,676
31221,2452,53466,1150,36799,197982,16667
5031,22,760,1554,417,26022,343
10824,717,17132,1502,11009,92034,6123
6582,66,1882,1536,1333,33839,549
41874,151,1659,937,1200,17708,459
4865,126,3293,1557,2356,71689,937
23756,24,433,1304,317,22210,116
2710,135,7498,1581,3753,96512,3745
50700,21,224,790,222,14375,2
24724,38,1428,1283,1015,21656,413
29392,170,4730,1185,3265,71239,1465
53129,282,3297,695,2593,64359,704
30604,99,764,1161,626,13956,138
51268,9,121,775,108,7487,13
53904,36,230,694,193,6463,37
5596,8,1166,1548,625,23567,541
57485,15,109,587,97,4004,12
5109,117,4846,1553,3236,22816,1610
58566,271,5431,552,4082,69345,1349
55658,544,4390,637,3459,32469,931
1248,1632,60257,1593,37182,144813,23075
7458,95,9928,1524,4997,75866,4931
6430,12,185,1538,138,9902,47
17050,89,2275,1420,1734,37348,541
36118,154,3371,1053,3021,32057,350
5811,927,39507,1545,21746,122263,17761
48841,4,50,840,42,1822,8
51300,461,16733,774,9795,119559,6938
27550,4,47,1221,44,5846,3
2865,12,379,1580,276,21809,103
37141,407,6026,1026,4549,46851,1477
13005,1136,37783,1479,20827,114211,16956
37719,602,13727,1009,8891,53859,4836
5538,19,441,1548,369,12082,72
10017,37,1201,1507,814,16733,387
59450,2875,35564,424,28112,156463,7452
68021,4,84,258,64,4379,20
52296,3752,76548,744,39553,230577,36995
58859,84,699,543,546,9919,153
14145,31,757,1463,548,13364,209
13653,22,946,1470,479,5152,467
68889,11,120,228,112,2816,8
48551,53,1047,842,883,26346,164
27999,87,2675,1211,1565,21101,1110
27917,199,3929,1213,2657,37873,1272
9399,71,3342,1511,1429,39311,1913
19177,84,2172,1382,1450,39988,722
50754,126,1520,789,1277,18860,243
51532,22,172,768,150,10732,22
19456,193,8290,1377,5142,37051,3148
64994,118,2368,347,1830,29266,538
59102,8,59,535,52,2858,7
41818,26,251,938,198,6412,53
69369,9,67,212,63,2586,4
5963,6,144,1543,103,7903,41
13003,128,5849,1479,3149,64401,2700
22963,10,452,1318,275,12128,177
21650,764,35146,1338,13401,187106,21745
25852,21321,496139,1259,265238,2499073,230901
20086,9,261,1365,199,7099,62
53202,10,130,714,104,5190,26
57570,36,416,585,352,9894,64
2973,6246,181071,1578,102320,556803,78751
16211,10,343,1433,233,44123,110
55650,18,205,637,160,5166,45
48250,80,1647,857,1397,16855,250
42098,9,106,934,105,2234,1
35816,1,32,1061,27,2759,5
54833,10,52,660,45,7847,7
17749,0,99,1407,86,8150,13
10492,32,1210,1504,883,16714,327
2674,28098,1335764,1581,528941,2907719,806823
17849,3458,96025,1405,61639,275462,34386
21971,100,1730,1334,1284,10210,446
40642,24,733,958,561,10645,172
53879,1895,35554,695,18564,107618,16990
12529,52,1312,1486,772,19782,540
18993,186,5068,1385,4043,66655,1025
32594,371,24385,1129,11363,87591,13022
58337,32,441,560,361,5265,80
29781,12,172,1178,128,7091,44
29819,12,708,1177,474,27972,234
10744,82,3623,1503,2003,40239,1620
12825,2,123,1482,75,10176,48
14577,4,291,1457,173,11769,118
55215,1384,15753,650,13486,147223,2267
33717,104,2591,1108,1542,25321,1049
23557,3433,61399,1308,47131,223321,14268
32319,5,305,1134,178,5511,127
67949,2,89,260,86,7745,3
4515,28,1390,1562,1047,22808,343
20162,86,2800,1364,1920,27162,880
50242,2,39,800,18,4120,21
14351,3577,73477,1460,46780,292881,26697
26106,63,1227,1253,676,19369,551
4088,16,903,1567,397,16465,506
27228,19,547,1229,341,5127,206
4372,4,640,1564,364,6669,276
29208,2,193,1189,129,5408,64
63596,134,2470,390,1667,32975,803
102,18,965,1603,513,34373,452
1607,2,115,1590,84,19208,31
63145,20,273,402,259,6636,14
47191,52,816,870,482,22264,334
40731,378,8221,954,4438,59368,3783
59090,307,4233,520,2952,35783,1281
18404,6,337,1395,203,7303,134
712,499,13283,1597,8263,111692,5020
23463,44,1176,1310,865,19118,311
36189,1499,15877,1051,14680,147219,1197
51997,32,464,754,329,8036,135
6832,5,178,1533,131,17962,47
65067,8,96,344,63,5980,33
40285,49,544,963,480,5622,64
52257,118,1131,745,1064,38029,67
48910,272,4793,838,3231,61594,1562
44798,33,403,898,249,6187,154
58554,344,3541,552,2534,20010,1007
6309,6,57,1540,53,7059,4
15402,0,0,1446,0,2233,0
58329,1229,39256,560,19120,155857,20136
2989,6,136,1578,111,16460,25
37815,100,1560,1007,1119,18331,441
11084,12,1103,1500,664,22832,439
21378,699,15761,1343,9863,103247,5898
46911,54,1107,874,878,10829,229
50808,93,1651,787,1192,33413,459
52951,6,136,721,114,3787,22
63552,1749,26044,392,20705,208006,5339
14998,47,1754,1452,1161,22855,593
51617,959,11972,764,10005,73888,1967
42,272,15002,1604,7101,243045,7901
11553,15,544,1496,256,10330,288
7840,94,1658,1519,1108,16872,550
1684,17,373,1589,241,8980,132
29207,188,4467,1189,3068,27452,1399
65685,82,1732,330,1475,18559,257
34951,227,2960,1081,2020,50009,940
35944,58,1527,1057,831,13726,696
56729,183,3692,607,2608,33994,1084
21388,274,6051,1342,2227,24246,3824
26100,7,96,1253,81,8972,15
57160,1180,16172,595,13378,100175,2794
17673,35,991,1408,806,26287,185
54937,71,739,657,622,10288,117
23928,346,8504,1301,5250,61911,3254
39959,10215,224406,968,136406,999185,88000
549,601,22023,1598,12487,134265,9536
52389,45,911,741,697,14569,214
11960,0,0,1492,0,8575,0
30369,6,124,1166,95,4073,29
3015,51,2636,1578,1729,47354,907
6487,147,4001,1537,2548,56889,1453
32628,200,7229,1129,3762,51497,3467
28563,37,842,1201,564,32724,278
12765,23,2246,1483,1032,18693,1214
35474,13473,439352,1068,179105,2376291,260247
12284,0,0,1489,0,6886,0
59778,52,730,512,670,15782,60
22290,203,3422,1330,2100,23807,1322
55127,1,64,652,50,3414,14
64349,5,74,367,70,6709,4
20771,135,2945,1354,2090,39634,855
57974,21,247,572,217,10394,30
30770,1591,59264,1158,25884,388245,33380
26818,106,3359,1237,1411,57269,1948
26892,71,2893,1236,1099,17327,1794
16515,24,545,1429,339,14178,206
50762,258,3584,789,2668,55351,916
10208,269,4987,1506,3402,40502,1585
21757,36,1271,1337,787,13263,484
59758,55,710,479,593,20076,117
60399,79,895,490,640,15950,255
23495,96,3173,1309,1496,32111,1677
49241,218,5358,827,2311,32673,3047
55249,2,27,649,20,2596,7
44912,94,1626,897,1372,20461,254
411,30,701,1599,464,11803,237
23087,3757,76906,1316,56288,344807,20618
33559,179,3802,1111,2574,29282,1228
7200,43,1321,1527,877,44475,444
9469,50,604,1511,502,7097,102
61304,10,140,456,100,4885,40
36259,47,1430,1049,1126,23966,304
35200,1321,30181,1066,19452,192613,10729
55593,117,1523,639,1108,14685,415
38208,287,3540,997,2959,29458,581
48692,1,156,845,84,6802,72
62007,22,425,434,400,4757,25
69323,16,228,214,188,3378,40
20096,18,931,1365,701,10991,230
39289,494,9871,977,7387,57019,2484
35693,931,11904,1064,9689,50492,2215
38468,51,1545,990,1146,25044,399
43077,95,1141,918,934,9679,207
17242,68,2501,1417,1698,18501,803
19032,16,730,1384,411,15575,319
54765,7,103,663,72,9540,31
16533,197,5073,1428,3545,58419,1528
36215,128,2602,1050,2059,40006,543
4383,60,2082,1563,1254,20213,828
3598,151,5639,1573,3774,36811,1865
35840,8,264,1060,211,7168,53
22179,9,581,1331,431,28456,150
1532,12,335,1591,240,19590,95
49012,39,569,835,498,15359,71
15087,78,1935,1451,1416,17180,519
20024,22,685,1367,480,16980,205
4406,293,15203,1563,6457,74922,8746
25895,119,1897,1258,1165,24102,732
52118,8,184,750,86,6144,98
11851,42,2224,1493,1115,17021,1109
40391,63,869,961,658,14330,211
24134,25,1293,1296,835,25560,458
11980,3,319,1492,177,12980,142
58949,13,133,540,122,4667,11
29344,1,56,1186,36,3598,20
34543,140,4177,1092,3856,52567,321
52491,499,9480,737,6074,98726,3406
49501,42,590,821,463,25092,127
35160,23,513,1076,355,11516,158
2511,127,3000,1583,2006,51185,994
55548,1017,16833,640,15322,100603,1511
60567,107,1372,457,1308,16464,64
4909,4,220,1556,153,27068,67
38785,1152,17075,983,13938,192883,3137
25586,37,776,1265,390,8681,386
24402,2953,83893,1291,57798,277554,26095
57585,0,0,585,0,9271,0
42388,45,304,930,257,9574,47
38836,39,796,982,642,9359,154
13335,342,15011,1475,9435,47557,5576
6645,38,724,1535,434,15716,290
23951,105,4123,1301,2453,59192,1670
66864,3,18,295,15,1675,3
58860,57,475,543,442,15151,33
25696,3489,109452,1262,60032,510234,49420
48739,36,927,843,510,13315,417
47837,5,126,862,99,2689,27
19359,169,5915,1378,3390,41793,2525
63053,27,347,404,289,7081,58
31884,261,8421,1140,4329,26361,4092
40964,50,664,952,381,7483,283
15069,19,555,1451,381,16956,174
56746,76,998,606,641,11602,357
63716,23,222,387,191,5183,31
19162,4,101,1382,86,8755,15
18450,500,12217,1394,9317,44933,2900
7518,8,541,1523,264,4707,277
6923,7685,429648,1531,150724,1028626,278924
27551,13,264,1221,171,17484,93
2206,46,1611,1585,1162,17807,449
5271,232,4220,1551,3063,28960,1157
38569,22,522,987,409,21056,113
8560,195,4979,1515,3215,21439,1764
1935,5325,290892,1588,130339,1183136,160553
25715,13,188,1262,184,6641,4
27656,40,2168,1219,881,15906,1287
30838,16,782,1156,415,10210,367
57709,5,83,581,64,7077,19
34125,21,640,1100,444,10639,196
54618,26,140,668,92,4856,48
19520,82,1679,1376,1052,16976,627
34835,112,2468,1068,1904,26464,564
30919,155,2437,1155,1635,24655,802
17184,76,1901,1417,1450,39620,451
37874,1068,18471,1006,12729,121724,5742
5219,18,2029,1552,1121,21983,908
53683,9,80,701,73,5449,7
36459,3368,53483,1042,36541,355425,16942
56029,0,0,625,0,8102,0
41328,13,319,947,235,7493,84
19761,43,1464,1371,471,34747,993
4305,16,1005,1565,703,59746,302
1499,20,666,1591,506,21127,160
17520,152,2856,1411,2074,24929,782
39430,13,466,975,309,7656,157
6290,391,14882,1540,9196,109892,5686
24528,2,133,1288,108,20833,25
62014,30,614,433,579,6385,35
2127,633,15861,1586,10985,88561,4876
22426,73,4529,1328,651,35893,3878
65575,19,178,333,148,7175,30
50878,107,1470,785,1131,22519,339
12083,17,832,1491,439,15777,393
49369,5287,89017,823,70053,449507,18964
49030,9,172,834,157,5201,15
20119,3,269,1365,206,19610,63
29524,60,1492,1183,921,28346,571
30296,11,743,1167,459,28003,284
6844,76,3508,1532,1368,51651,2140
28190,567,15960,1208,8767,148827,7193
46548,50,585,878,456,14030,129
18270,27,696,1398,538,15845,158
42474,12,206,928,182,17037,24
29856,2,111,1176,62,4750,49
61652,136,1615,446,1062,19868,553
17973,3,162,1402,130,6663,32
1106,31,2296,1594,1292,54444,1004
18471,123,4081,1394,2292,42425,1789
52517,2,57,736,39,4219,18
33652,226,3775,1109,2086,44060,1689
29687,1050,33555,1180,17159,267977,16396
25622,364,8650,1264,5380,61038,3270
51655,566,7743,749,7552,43469,191
29345,18,414,1186,282,18067,132
4769,149,7603,1558,2031,28891,5572
54680,144,1081,666,961,23077,120
36729,9,106,1037,89,2355,17
20904,135,2791,1351,1518,21137,1273
8798,0,107762,1514,70797,208430,36965
29507,383,7643,1183,4307,37001,3336
26468,1337,26264,1246,12611,176251,13653
286,9,335,1600,253,17162,82
8543,368,8637,1515,5728,46457,2909
55298,7,143,647,112,7324,31
70349,4,61,181,60,1322,1
16221,80,2900,1433,1687,24062,1213
36276,32,671,1048,558,8553,113
10707,45,2415,1503,1463,44390,952
35856,1,68,1060,56,5275,12
3349,81,1870,1575,1034,22901,836
35593,13,214,1065,175,4854,39
17340,14,292,1415,224,20089,68
17025,310,7306,1420,5314,51143,1992
54275,57,715,681,489,12550,226
57081,54,704,597,642,13132,62
55257,16,155,648,144,5459,11
7846,34,2031,1519,1352,61341,679
659,4,806,1597,468,28899,338
37087,20,295,1028,258,8274,37
20382,123,5843,1361,3691,58039,2152
66676,10,197,301,188,8876,9
60806,28,312,474,244,12080,68
18374,70,1519,1396,1050,24769,469
54069,5,49,688,41,2771,8
4779,980,24295,1558,16910,145634,7385
15022,27,747,1452,548,11487,199
59119,238,4639,534,3781,24614,858
37963,432,23160,1003,7379,75795,15781
23851,0,0,1303,0,13799,0
10239,145,4903,1506,3266,52859,1637
25926,9,557,1258,346,8676,211
13120,75,2346,1478,1334,22503,1012
1810,401,8384,1588,5427,51846,2957
62806,57,886,410,724,12219,162
21120,10742,381922,1347,190982,1306674,190940
9103,56,1464,1512,937,19847,527
30138,106,4632,1170,2305,67129,2327
51892,103,1525,757,1149,32513,376
19619,14,616,1374,449,14293,167
35680,73,1159,1053,1027,14730,132
62960,299,5275,407,4190,78119,1085
50377,4024,66889,798,48653,381534,18236
69009,1,41,224,32,1394,9
16143,68,1657,1434,1149,31420,508
61034,118,2649,466,1916,23842,733
34945,9,330,1081,218,14646,112
6402,97,1495,1538,1094,25595,401
23696,130,4012,1306,2653,19580,1359
6932,44,1713,1531,1170,32922,543
21721,203,3206,1337,1813,41986,1393
35892,337,5504,1059,4834,76466,670
44952,2,70,896,51,10427,19
22703,392,10327,1323,5614,26634,4713
52288,5,36,744,30,2638,6
17724,55,5376,1407,2632,34685,2744
13955,7,511,1466,283,19769,228
292,72,2971,1600,1996,29715,975
55651,54,484,637,447,10206,37
51850,45,1033,758,869,16407,164
49364,9,291,824,232,5742,59
56014,30,243,627,170,9542,73
37056,6,396,1028,269,8869,127
13703,50,2042,1470,1254,18733,788
35080,334,2899,1078,2447,30665,452
59834,17,116,510,95,5496,21
3092,2,119,1577,85,4959,34
60724,15,182,477,149,6059,33
6445,5,168,1537,132,17302,36
54084,100,1615,688,1095,21771,520
7011,297,8052,1530,4663,43793,3389
35157,8,132,1076,87,9428,45
31862,74,2259,1141,1379,18844,880
11025,1290,15160,1500,8744,50594,6416
367,529,26477,1600,16213,91320,10264
21503,158,6955,1340,3748,36954,3207
29550,199,4581,1183,2935,29930,1646
5611,87,2777,1547,1874,31185,903
38911,36,871,981,648,11375,223
14589,0,2919,1457,1758,35646,1161
5948,144,10027,1544,4315,49406,5712
11485,408,28312,1497,12735,155012,15577
34401,2,110,1094,87,5772,23
38440,2602,49061,991,33834,109064,15227
36794,211,3517,1036,3084,40578,433
9361,24,1003,1511,688,18279,315
66342,5,58,312,49,11542,9
46542,6,92,878,80,11432,12
49168,1606,33106,830,27384,106372,5722
19107,2368,49175,1383,31860,213332,17315
61742,13,187,443,176,3377,11
22031,59,2865,1333,1791,33920,1074
11794,9,283,1494,134,9672,149
46141,49,551,881,419,14836,132
56082,101,1400,626,912,12496,488
24922,28,1483,1279,997,62351,486
17527,26,1146,1411,867,14168,279
32519,14,606,1130,411,17269,195
2958,134,3285,1579,2114,26897,1171
63891,16,100,381,84,4004,16
7345,4,189,1526,135,6880,54
46142,941,10641,884,8255,45465,2386
1784,52,1987,1589,1418,31903,569
1715,71,3893,1589,1939,23253,1954
54553,262,6157,671,5113,42462,1044
68210,14,149,252,126,4156,23
30478,30,443,1163,319,5712,124
39416,19,294,975,211,4194,83
15533,153,6083,1444,3527,70849,2556
2842,63,3441,1580,1847,17427,1594
9533,1312,59321,1510,36178,201114,23143
7041,533,13472,1530,8131,57382,5341
47133,24,208,871,172,7457,36
65102,10,345,344,317,12364,28
28723,17,566,1198,376,8119,190
54738,273,1561,664,1266,25582,295
12927,0,0,1481,0,5988,0
1682,9,289,1589,156,14233,133
8186,295,5165,1516,3464,17738,1701
31585,68,1246,1145,713,21821,533
28959,93,2463,1193,1639,28523,824
9406,99,4986,1511,2156,46679,2830
9826,53,2396,1509,1515,14995,881
814,6571,174595,1596,100782,621355,73813
6814,171,8093,1533,3355,49819,4738
64108,1,40,374,34,2467,6
21488,1189,29043,1341,21007,199692,8036
28826,24,443,1196,353,19456,90
62722,686,13043,408,7228,98804,5815
5618,42,1392,1547,835,15875,557
7609,72,4845,1522,1699,75557,3146
13214,125,5123,1477,2396,93339,2727
67206,10,74,283,66,3145,8
38548,894,12161,988,11330,116475,831
60743,15,164,476,134,6266,30
13679,239,8093,1470,4441,54677,3652
53525,167,2036,706,1784,57965,252
60122,1106,19038,500,14960,96690,4078
38244,26,329,996,254,4758,75
8204,21,343,1516,278,5988,65
36948,1,20,1032,19,5925,1
6758,24,570,1533,415,9602,155
67044,1,70,289,61,3549,9
61969,48,926,435,905,35913,21
550,12,1200,1598,770,9791,430
7652,33,978,1522,711,17859,267
6217,14,472,1540,122,4389,350
5898,10651,493005,1544,202527,1517324,290478
24651,22,427,1285,315,13189,112
20895,5,163,1351,113,6071,50
57476,10,100,588,75,4249,25
59160,0,11,533,11,1993,0
513,6,271,1598,187,26132,84
1185,15,498,1593,323,25757,175
51106,63,1143,779,856,11135,287
58374,411,5813,559,5311,48726,502
502,13,509,1599,259,22844,250
17503,365,15195,1412,11428,102256,3767
57099,7,154,596,121,9173,33
37073,140,1469,1028,1115,19386,354
32614,293,5193,1129,3886,97622,1307
15316,145,2342,1448,1291,19716,1051
62411,1011,17731,421,12685,185565,5046
34302,375,4690,1097,3847,29962,843
36293,14,311,1048,256,13813,55
33666,17,586,1109,383,9811,203
13057,806,12443,1478,8856,103840,3587
46537,20,416,878,321,7909,95
33453,100,4355,1113,1616,61924,2739
20935,112,2739,1351,1652,27014,1087
58271,14,210,562,156,3553,54
637,52,1898,1597,1066,25915,832
50217,1175,22564,802,14613,89744,7951
17820,322,9442,1405,6607,108262,2835
31354,302,5849,1148,3638,74309,2211
38679,0,18,985,15,2052,3
12126,14,593,1491,359,16553,234
29544,10,288,1183,174,7186,114
63046,1,10,405,10,1203,0
35353,4,239,1071,162,9223,77
42596,6,144,926,92,4412,52
34138,64,1140,1100,759,28107,381
53168,40,392,714,302,14893,90
35063,159,2763,1079,1876,24227,887
20936,23,499,1351,313,14762,186
43405,29,430,914,329,9415,101
41693,14,338,940,290,8031,48
38703,26,698,984,480,7341,218
25844,94,2248,1260,1662,37214,586
50189,35,563,802,412,7207,151
19295,17,694,1379,528,14955,166
20681,1118,28336,1356,17597,216836,10739
12917,2,167,1481,64,8590,103
32503,149,2101,1130,1570,36422,531
22672,21,654,1323,454,10193,200
29903,7,237,1175,194,8429,43
32043,32,849,1138,527,6415,322
11933,144,5020,1492,3401,45987,1619
12819,148,4057,1482,1836,44453,2221
4520,9,440,1562,271,11337,169
10772,80,2390,1502,1536,28361,854
32739,287,8841,1127,6780,43649,2061
5513,12,239,1549,139,10939,100
26224,69,759,1251,552,8416,207
32708,96,1974,1127,1376,12243,598
30925,126,2640,1155,1503,31582,1137
15084,0,0,1451,0,6400,0
54518,29,427,672,319,14404,108
4162,640,14989,1566,9451,72730,5538
29829,199,3147,1177,1921,45428,1226
11106,92,2517,1500,1532,19679,985
21259,113,4576,1345,3196,36676,1380
11670,16,503,1495,299,20918,204
52496,317,5879,737,4828,47482,1051
270,34,1354,1601,740,66675,614
4562,34,2888,1561,1547,69109,1341
981,3148,103747,1594,50991,639252,52756
20209,211,3991,1363,2908,93548,1083
48870,21,297,839,274,6679,23
15982,139,3999,1437,2651,73862,1348
55368,434,6044,645,5645,82253,399
43987,227,5252,907,3066,60777,2186
19093,14,443,1383,327,10818,116
8594,176,5487,1514,3526,31486,1961
43229,7,107,915,68,6202,39
54198,268,2315,684,2180,20794,135
11510,27,1423,1496,745,20900,678
29447,898,15027,1184,11121,71805,3906
15615,33,768,1443,497,20036,271
28281,15,229,1207,143,4619,86
66280,10,100,314,89,3112,11
8747,12,398,1514,239,5666,159
30339,2659,47015,1166,34674,210842,12341
23803,71,1282,1303,893,16756,389
40688,8,458,957,417,13940,41
400,465,19452,1599,11183,66127,8269
63810,13,272,384,230,8252,42
6307,149,2813,1540,2040,23414,773
37097,27,346,1027,270,8737,76
37784,10,168,1008,132,2635,36
57848,43,1005,576,837,20461,168
5205,285,9926,1552,6318,82817,3608
54093,15,165,687,119,6490,46
45847,24,502,887,356,3977,146
23401,83,2451,1311,1381,60701,1070
57497,14,264,587,90,3871,174
25484,386,18996,1267,12412,63560,6584
65258,125,2439,339,1902,22634,537
64007,15,136,378,134,5404,2
4771,46,1208,1558,911,21422,297
16692,53,637,1426,559,5387,78
4696,16,423,1559,313,7321,110
48571,30,361,848,259,9403,102
35399,27780,661609,1070,277919,1717608,383690
24263,336,8743,1294,5893,67840,2850
62016,39,1559,433,778,43639,781
27963,0,0,1212,0,6002,0
42404,2439,68113,929,29552,193605,38561
8905,749,15569,1513,11366,72137,4203
2915,129,3840,1579,2307,43434,1533
4488,0,12323,1562,7724,97485,4599
21300,14,314,1344,239,13428,75
30143,62,1383,1170,908,17444,475
67893,1,26,262,19,2102,7
45308,4,62,893,51,6119,11
32121,8,177,1137,120,9716,57
58888,54,556,542,455,10653,101
41902,503,5951,937,5047,54562,904
15731,21,575,1441,328,11263,247
46932,608,4135,873,3467,35031,668
53521,585,6756,706,6306,60473,450
19337,79,1192,1379,849,16923,343
35797,49,988,1061,710,11262,278
21993,45,1141,1334,620,9615,521
36420,50,1428,1044,1152,17792,276
23591,68,2036,1308,1601,27874,435
35021,31,442,1079,358,8350,84
9481,2,119,1511,79,12104,40
52469,21,535,737,288,8852,247
27022,26148,712199,1233,429689,1796702,282510
14887,845,22802,1454,9991,97679,12811
12948,60,1592,1480,936,21696,656
61376,9,213,454,180,6976,33
61319,26,400,456,369,6627,31
5363,99,3498,1550,2890,27815,608
27463,8162,271653,1224,151012,1055625,120641
54780,9,96,663,68,3360,28
23375,1146,26877,1311,16503,131437,10374
23622,57,947,1307,523,6772,424
49954,1,98,809,58,8523,40
3613,248,14663,1573,7311,143000,7352
26237,3,195,1251,111,4398,84
61065,96,707,465,582,6375,125
21090,395,13429,1348,9097,45189,4332
30033,1964,57939,1173,35758,337643,22181
28936,1897,40064,1194,24532,252393,15532
19846,48,549,1370,456,31140,93
57854,239,4725,575,3811,54462,914
56109,144,1341,625,1188,11611,153
34481,140,3806,1092,2677,27700,1129
18735,4,123,1390,94,24488,29
35973,17,472,1057,324,6236,148
7446,140,5876,1524,3220,21579,2656
24582,6,317,1286,281,7279,36
3189,5,368,1576,278,10368,90
25168,1,22,1274,22,5742,0
60222,729,17028,496,6826,76775,10202
13452,1,94,1473,57,4570,37
30136,137,4090,1170,2926,99903,1164
55654,45,383,637,281,8346,102
56997,21,215,598,177,5915,38
55114,55,1487,652,773,16696,714
18666,24,896,1391,590,16149,306
46403,3,137,881,113,5569,24
59287,37,265,528,234,7016,31
23729,72,1828,1305,1313,20180,515
57494,12,236,587,194,7985,42
59286,96,1620,529,1160,19618,460
27428,9,143,1224,109,7024,34
22882,47,1300,1320,898,18968,402
2498,125,3168,1583,2313,50480,855
22678,182,5695,1323,3289,21722,2406
18549,99,1465,1393,797,20958,668
18891,1,107,1387,81,6453,26
60696,27,160,478,152,6899,8
15368,14,930,1447,683,27135,247
27092,6517,197910,1232,68232,571134,129678
9936,2293,188790,1508,69552,609352,119238
16178,315,8246,1434,4635,47490,3611
29594,3,99,1182,94,3774,5
2539,50,1921,1582,1198,16698,723
19661,78,2489,1373,1609,41475,880
54192,2,18,684,10,3674,8
6679,117,3183,1534,2173,36965,1010
5157,71,2223,1553,1531,37788,692
55312,104,934,646,751,12769,183
6623,118,7518,1535,4306,91143,3212
49821,0,1639,812,1185,8454,454
26681,13,242,1240,168,13264,74
22692,85,1046,1323,739,8681,307
18202,590,30697,1399,21284,186294,9413
5961,229,7846,1544,4645,27260,3201
48867,338,3579,839,2678,36053,901
36059,1220,14323,1054,10155,56096,4168
1293,87,4532,1592,2638,42613,1894
24816,69,1170,1281,670,22683,500
35707,96,2537,1063,1947,27637,590
978,175,2994,1595,2210,27827,784
52988,184,3621,720,2956,42670,665
56354,182,1270,618,1104,12817,166
44212,1215,23056,904,15165,182138,7891
200,50,4852,1602,2835,36565,2017
14417,38,717,1459,520,12959,197
52365,57,904,742,750,22964,154
2549,24,942,1582,633,23741,309
51334,54,598,773,486,11657,112
19978,50,1382,1367,980,8567,402
32137,83,1318,1137,762,8090,556
12151,22,618,1490,368,20857,250
45072,1,56,895,48,3115,8
7659,63,2093,1521,1158,11199,935
23571,249,5746,1308,4042,21179,1704
39979,32,476,968,404,22235,72
15546,93,2923,1444,2093,62095,830
5208,124,2581,1552,1839,29902,742
259,876,33175,1601,19137,132381,14038
35042,29,400,1079,330,12927,70
4855,17,711,1557,487,19168,224
54963,89,1540,656,1070,19550,470
14026,639,9999,1465,6740,115010,3259
34065,9,374,1101,259,8040,115
43873,128,1761,909,1431,16077,330
28716,4,428,1198,243,12045,185
2043,949,23923,1587,13104,84917,10819
56927,22,442,601,388,15201,54
17234,18,477,1417,377,14366,100
52633,1055,23736,732,18559,197169,5177
32860,16,421,1124,292,8373,129
29883,17,888,1176,517,30175,371
18637,2,70,1391,60,5595,10
38824,5,83,982,75,3099,8
29356,468,8367,1186,6081,89421,2286
47807,387,4316,862,3720,33287,596
12590,71,1845,1485,1238,12124,607
12070,5644,239296,1491,81054,1081603,158242
41735,782,24725,940,15212,238526,9513
11888,23,1766,1493,816,46471,950
30000,119,2362,1173,2063,38681,299
56598,7,103,610,89,4984,14
24855,10,215,1280,184,6936,31
67249,348,18534,277,12725,109575,5809
35609,1384,21317,1065,17935,77792,3382
40750,32,415,956,364,16560,51
32746,4,128,1127,45,1685,83
11290,31,897,1498,542,18659,355
34258,247,4954,1096,4164,29932,790
1737,113,2516,1589,1705,40820,811
13568,54,2198,1471,990,38050,1208
33821,661,8652,1106,7684,108097,968
33450,46,910,1113,777,9826,133
56482,32,416,614,317,10500,99
9494,25975,1189416,1510,520685,3643482,668731
49250,0,42,827,18,2588,24
37562,21,223,1014,146,4375,77
47769,26,353,862,305,23275,48
16331,7,129,1432,83,8113,46
16511,186,5015,1429,3209,68962,1806
7127,5818,630655,1528,199585,1423183,431070
58082,25,498,569,430,14515,68
10698,428,11286,1503,6945,41164,4341
19946,39,1157,1368,922,59898,235
53650,126,1417,702,1134,21737,283
33598,3121,58318,1107,50037,330533,8281
36125,21406,523878,1053,316506,1446510,207372
21587,17941,451622,1339,236297,1713552,215325
61924,16,104,437,75,2796,29
56601,69,1364,610,1239,12904,125
37599,154,2024,1013,1625,17147,399
11000,12,142,1500,98,10770,44
2057,301,24915,1587,13089,175691,11826
9074,14,923,1512,487,17637,436
6935,153,4125,1531,2528,74571,1597
4496,79,2202,1562,1574,82335,628
24981,14,304,1277,259,8333,45
55230,508,6359,649,6084,47511,275
56425,8,112,616,91,3440,21
66852,14,283,295,229,6637,54
19382,5,230,1378,169,9246,61
50471,10002,132479,795,99725,534251,32754
21303,0,77,1344,46,6957,31
67301,0,15,280,15,3512,0
28942,33,1485,1194,1070,28522,415
60983,157,3670,468,2094,41313,1576
2520,59,1899,1583,1019,12665,880
51116,8,147,779,120,6666,27
16004,25,683,1437,449,27384,234
19780,35,833,1371,715,42108,118
48449,110,1074,853,854,22919,220
9152,44,764,1512,567,9044,197
26400,36,1874,1247,1160,34221,714
21015,77,1355,1349,1000,12750,355
51711,305,4991,762,3854,51608,1137
21394,321,4823,1342,3778,41962,1045
55242,13,148,649,110,7860,38
48257,389,8251,857,5281,53723,2970
49519,167,2467,820,2114,38033,353
52298,507,6345,743,5716,90519,629
26709,3,283,1240,142,11954,141
57891,19,194,574,172,5828,22
62969,2,21,406,14,2538,7
1127,32,1164,1593,791,26896,373
39625,3171,59410,972,37737,291918,21673
64583,71,1126,360,896,21230,230
38053,14646,357331,1001,197268,1515631,160063
16277,7,409,1433,294,28580,115
28657,3,47,1199,39,4559,8
12086,32,1526,1491,778,9311,748
3601,4,100,1573,64,6824,36
46555,370,13627,878,6628,79873,6999
38234,253,6239,996,3429,34711,2810
30730,0,86,1159,68,17108,18
34134,32,1031,1100,763,17819,268
14215,327,6075,1462,4343,44098,1732
9177,2,82,1512,52,8470,30
35022,46,1285,1079,908,13209,377
47323,65,1834,868,1428,25927,406
27174,3,90,1230,56,2151,34
34045,64,2080,1102,1350,34099,730
48852,37,704,840,578,8535,126
28470,5,212,1203,97,14172,115
5935,9,331,1544,137,21032,194
3180,178,3991,1576,2307,31376,1684
39266,0,32,977,28,3432,4
55178,42,464,651,330,9611,134
68454,639,11652,218,11587,88456,65
2472,69,2205,1583,1542,57248,663
31278,290,6110,1149,2665,47174,3445
20007,17,339,1367,259,8365,80
17165,142,3455,1418,2413,52604,1042
17760,36,1184,1407,609,27913,575
28904,131,3417,1195,2015,20283,1402
5736,33,1416,1546,829,20270,587
17867,0,83,1404,62,11143,21
29454,13,221,1184,140,3430,81
37080,16,297,1028,280,5914,17
3348,9,298,1575,228,29644,70
46867,5,74,874,67,8821,7
1355,112,3996,1592,2690,35618,1306
15940,139,3511,1438,2040,42126,1471
52388,18,242,741,206,11652,36
23533,65,1228,1309,808,17361,420
15814,10,294,1440,196,8124,98
12939,39,904,1480,450,13556,454
57065,110,1940,597,1685,60393,255
6270,19,475,1540,363,14372,112
42338,35,539,931,419,17755,120
34573,62,1285,1091,457,26286,828
49187,153,1833,829,1765,36179,68
31811,115,3013,1141,2263,23351,750
23899,450,11387,1302,8733,49322,2654
15089,46,2859,1451,1790,19572,1069
19043,8,350,1384,209,7189,141
1282,52,1210,1592,908,32403,302
25798,20,953,1260,626,19470,327
775,108,4394,1596,3223,41840,1171
37146,696,9101,1026,7981,87845,1120
9350,37,422,1511,318,12985,104
8983,14,1285,1513,642,14680,643
55317,0,24,646,20,1852,4
63813,144,1719,384,1331,14914,388
68015,59,1188,258,873,18712,315
8632,22,319,1514,220,5712,99
10431,1217,36656,1505,19417,193992,17239
5550,50,2012,1548,1315,18877,697
55275,0,0,648,0,5322,0
45212,426,7106,894,6563,43983,543
37775,57,865,1008,639,10403,226
1780,72,1316,1589,1023,10396,293
48984,139,1747,836,1462,26084,285
11614,556,15711,1495,9233,105895,6478
5006,39,1729,1555,1153,24515,576
67905,29,270,262,226,4467,44
48897,28,579,838,419,5834,160
40298,41,580,963,468,6156,112
24664,5555,348361,1284,97345,1341515,251016
56110,20,245,625,191,14430,54
11930,553,40551,1492,14474,195518,26077
61493,24,341,441,223,8128,118
39193,44,1293,978,1049,20775,244
48835,81,833,840,619,18122,214
21468,15,401,1341,354,27124,47
67879,6,85,262,72,9690,13
30069,490,8033,1172,4977,84890,3056
54700,126,1117,665,928,15422,189
21160,90,2455,1346,1804,28274,651
48754,0,43,843,21,5413,22
54679,3474,36052,666,26688,131710,9364
52505,226,1873,736,1404,16462,469
22635,11,300,1324,197,3329,103
55938,56,609,630,505,8438,104
60732,36,513,477,454,11798,59
18182,41,1224,1399,805,20932,419
23767,76,1364,1304,1016,23896,348
56311,7,173,619,138,5002,35
33866,1,85,1106,62,14916,23
13822,23,656,1468,377,30912,279
52150,115,1175,749,1129,26605,46
12273,29972,1098973,1489,409651,3600986,689322
30567,4,88,1162,55,2052,33
24176,74,2839,1296,1593,38234,1246
3833,61,2320,1570,1014,26715,1306
52342,2,37,742,19,3155,18
42870,27,784,921,637,9434,147
28210,20,468,1208,295,22545,173
21209,55,1512,1346,982,17004,530
29714,51,1374,1180,600,7914,774
39809,45,775,970,678,13620,97
842,40,1521,1596,1098,30603,423
57819,48,706,577,515,11610,191
19833,500,12349,1370,8169,80318,4180
6161,2030,69980,1541,37663,219448,32317
5624,4512,127032,1547,74588,450926,52444
33526,59553,1468675,1112,946928,3352526,521747
55966,89,1043,629,971,14243,72
3121,780,16403,1577,11278,132475,5125
59003,4,77,538,66,5286,11
27771,20,317,1217,205,7643,112
50391,19,208,798,172,5806,36
9623,418,15770,1510,8367,73276,7403
9841,22,682,1509,454,9642,228
17,3454,162884,1605,94517,489690,68367
35969,79,1589,1057,1276,35689,313
30469,1850,44962,1164,32006,263107,12956
50551,2,96,793,69,9490,27
37204,2411,50897,1021,28285,428945,22612
35133,33,613,1077,481,16477,132
46693,3486,43390,876,30753,182209,12637
29013,239,10120,1193,5401,61312,4719
48861,617,10363,840,6822,28843,3541
56491,37,447,613,352,6120,95
43119,163,2957,917,2414,30713,543
27720,15,317,1218,206,9321,111
55952,1035,12084,630,7960,76031,4124
35017,74,1252,1080,846,26902,406
27905,13,504,1214,188,6632,316
64058,18,328,376,274,6087,54
2625,13,793,1582,348,26679,445
2006,2540,62590,1587,37869,252938,24721
63599,20,344,390,322,11991,22
18664,95,2761,1391,2214,35573,547
3581,58,1500,1573,960,16736,540
11449,24,1913,1497,1167,18230,746
21495,33,412,1340,319,6696,93
66461,20,492,309,366,8180,126
17315,2,142,1415,127,15069,15
23478,6,280,1310,118,8135,162
28402,16,609,1204,336,38390,273
4670,1036,28441,1559,15809,107164,12632
15310,365,9214,1448,5579,76988,3635
2445,361,11497,1583,5686,101070,5811
16832,50,1130,1424,799,28652,331
23051,2,84,1317,71,31677,13
12048,9,235,1491,145,7281,90
60906,2672,32974,470,29553,129303,3421
20992,114,4387,1350,2873,60188,1514
30115,110,1777,1171,1011,11822,766
55926,6,33,630,20,4538,13
27811,55,897,1216,636,9155,261
3658,13,683,1572,456,10711,227
31528,31,905,1146,497,15212,408
4119,36,1646,1567,1122,54178,524
59337,55,746,527,672,13877,74
13202,8559,207748,1477,128294,463416,79454
1367,703,33853,1592,18381,137461,15472
14837,9,347,1454,255,15882,92
10028,10,556,1507,322,9927,234
23726,142,2746,1305,2085,38742,661
498,16358,635603,1599,363834,1644670,271769
16080,6,279,1435,208,11203,71
7367,47,2693,1525,1333,29555,1360
63861,14,188,382,145,7156,43
48923,52,499,837,451,10921,48
16088,7,91,1435,81,9145,10
12636,23,1765,1484,715,14907,1050
27016,609,17325,1233,7160,90551,10165
44368,14,496,903,388,21471,108
16990,2,125,1421,106,11832,19
54314,656,7496,680,5864,30016,1632
47632,0,69,865,67,11128,2
12030,22,736,1491,409,19934,327
49343,39,334,824,316,8685,18
24474,2874,57081,1289,40699,409529,16382
52502,115,2757,736,1277,58846,1480
19385,23,1061,1378,730,9884,331
16898,6,452,1422,316,9632,136
60916,1169,22815,469,13996,126109,8819
55809,19,320,633,230,10968,90
64287,10,253,367,232,7590,21
23849,26,1339,1303,926,18539,413
59863,18,208,509,129,5025,79
52662,0,17,731,10,1187,7
38508,24,520,989,389,14853,131
18541,7,453,1393,379,7617,74
5547,325,15024,1548,7697,48020,7327
17371,167,4304,1414,3188,52313,1116
59656,1,19,516,16,4275,3
52465,48,352,737,291,5562,61
11226,20,1289,1499,633,19032,656
58348,156,1169,560,1111,9568,58
53979,99,1297,692,1159,32989,138
16723,34,731,1425,511,13749,220
56420,316,6696,616,6116,72341,580
49159,62,1331,830,987,20935,344
34408,204,5990,1094,4410,59389,1580
14199,15,305,1462,230,7460,75
36760,31,427,1037,323,27439,104
23319,3,140,1313,105,6954,35
25790,1257,24266,1260,15831,117160,8435
18117,8,722,1400,510,15012,212
49423,106,1063,822,963,8262,100
43440,304,3881,913,3208,22358,673
29797,66,1812,1178,1533,26497,279
67440,4,45,276,41,2797,4
56164,254,4789,623,3653,28312,1136
17129,26,356,1419,257,8343,99
25559,5,322,1266,201,8417,121
60762,220,2577,476,2176,30263,401
5340,90,2474,1551,1309,38582,1165
32990,18,301,1122,206,26711,95
7337,299,23299,1526,15709,83082,7590
33348,155,3535,1115,2046,32627,1489
64697,288,3121,357,3114,17091,7
35954,2,47,1057,37,1487,10
12982,29,1165,1480,692,36355,473
32183,46,1676,1136,1047,21604,629
56395,1249,16199,611,14874,197416,1325
30893,22,948,1156,626,12092,322
8565,4556,171951,1515,75095,320692,96856
12358,416,8295,1488,4947,37835,3348
51229,175,3538,776,1695,32442,1843
9135,16,300,1512,146,7060,154
68878,26,268,228,194,3122,74
16438,50885,1239113,1430,600861,3114232,638252
49662,8,120,816,99,6913,21
65622,18,345,332,281,7267,64
68497,234,6881,242,4797,56015,2084
16171,92,3199,1434,2032,60053,1167
10412,12,219,1505,145,5289,74
64834,8,65,352,64,1598,1
48708,36,369,844,288,7575,81
61999,22,287,434,245,10870,42
4988,68,2991,1555,2122,52806,869
15899,437,9656,1438,5296,40938,4360
18615,0,0,1392,0,8559,0
22832,31,577,1320,396,13178,181
30714,91,2100,1159,1701,36754,399
20400,81,1212,1360,871,11354,341
18265,2,84,1398,65,8165,19
67812,629,11549,264,10274,95307,1275
22079,35,812,1332,556,11438,256
49759,427,5314,813,4108,50933,1206
7425,8,284,1525,187,21263,97
21724,505,17003,1337,8733,102804,8270
55306,193,1781,647,1683,16836,98
35715,32,936,1063,592,22127,344
12106,893,27007,1491,13986,272375,13021
40349,8,94,962,75,6013,19
6651,21,1018,1535,688,46333,330
38039,328,3932,1001,3272,46136,660
15496,12,116,1445,97,3975,19
9987,27,1186,1508,720,21122,466
33313,0,123,1116,76,3411,47
24680,434,17426,1284,13130,120996,4296
23313,28,634,1313,442,13210,192
63339,22,130,394,124,4084,6
38174,6,209,998,112,11260,97
31272,110,3371,1149,2055,39792,1316
22141,58,1596,1332,1243,23198,353
29892,37,878,1176,529,8836,349
14515,41,1166,1458,850,27697,316
21637,61,1606,1338,1045,62960,561
60672,10,113,479,98,8217,15
64745,2,62,355,45,4573,17
11435,97,2050,1497,1400,12337,650
17307,372,10599,1415,6381,84439,4218
22984,30,1008,1318,696,11058,312
24389,134,4177,1291,2718,30905,1459
17080,21,1724,1419,491,16829,1233
61349,19,215,455,173,2138,42
12725,59,1664,1483,946,32017,718
8289,56,1354,1516,779,18417,575
51643,47,761,764,670,21486,91
55951,25,272,629,224,9497,48
2992,652,29976,1578,16473,102210,13503
6691,12,313,1534,200,16185,113
39296,15,155,977,115,4169,40
31799,5358,164788,1141,59620,248207,105168
5566,8,231,1548,156,11557,75
66089,56,1149,319,1059,17064,90
54463,27,351,674,246,12187,105
3999,1,161,1568,66,17246,95
31646,5,134,1144,99,5845,35
19458,82,2698,1377,1840,23290,858
60267,20,249,495,176,6580,73
66527,23,560,306,435,10601,125
2634,58,1148,1582,736,62006,412
19783,83,1693,1371,1147,10941,546
29044,16,1083,1192,547,20132,536
21725,271,10064,1337,5676,106630,4388
54060,18,187,689,150,10294,37
50622,1161,14536,792,13471,167808,1065
11271,20,487,1499,337,29030,150
15665,23,772,1442,639,17127,133
17638,73,1556,1409,1138,12854,418
22364,546,69442,1329,12923,164926,56519
9134,72,2021,1512,1104,20933,917
26932,24,224,1235,173,11537,51
25060,0,0,1275,0,13191,0
11949,94,7240,1492,2937,51080,4303
17674,25,664,1408,492,19469,172
35102,204,4615,1077,3552,25236,1063
58833,21,192,544,182,5483,10
1910,1,70,1588,55,6305,15
55250,91,2520,649,1601,23080,919
53624,14,109,703,105,10585,4
54001,60,578,691,518,18232,60
1546,8985,255832,1590,148111,589908,107721
20721,2453,73819,1355,31043,542690,42776
68485,27,321,243,321,8128,0
60183,25,338,498,285,8868,53
43273,30,457,915,347,15699,110
8758,192,4630,1514,2709,29306,1921
58362,32,559,559,423,10922,136
23507,28,939,1309,832,21602,107
45295,129,2253,893,2116,26829,137
30355,53,1133,1166,792,21687,341
29842,1,189,1177,133,3177,56
33905,257,7830,1105,4029,46342,3801
3488,1292,39131,1574,26951,184587,12180
64039,18,188,377,160,7540,28
20938,33,603,1351,352,34614,251
33159,7,204,1119,148,8961,56
6968,30,803,1531,669,11274,134
47253,25,530,869,492,11343,38
2097,309,5000,1586,3181,29120,1819
2632,1022,28739,1582,21718,69190,7021
56531,18,215,612,196,6280,19
52004,953,13930,754,11395,85783,2535
19361,25,436,1378,301,9964,135
7887,26145,1556059,1518,558335,3333693,997724
7827,36,970,1519,597,32020,373
41626,829,13863,942,8766,65828,5097
54112,0,24,687,19,2679,5
8970,25,621,1513,418,6774,203
5421,9,1007,1550,520,36236,487
64768,12,117,355,91,2414,26
32479,9,441,1131,268,15358,173
20346,5,207,1361,163,13188,44
14518,26,567,1458,416,9844,151
41830,241,4984,938,3776,38627,1208
22339,67,1714,1329,891,32137,823
16655,85,2989,1427,1534,61881,1455
32604,3,43,1129,38,6983,5
45867,3,71,887,44,2956,27
46468,0,18,880,15,3237,3
47395,35,522,867,429,14039,93
10484,53,1554,1504,994,15743,560
16601,109,2285,1428,1636,18089,649
15481,22,552,1445,378,7712,174
36382,8,182,1045,142,18480,40
20821,67,972,1353,638,13102,334
14532,1283,36975,1457,25278,107363,11697
19015,74,3007,1385,2133,68677,874
32620,2,233,1128,145,11775,88
41325,4,104,946,88,4063,16
5234,78,3147,1552,1815,35128,1332
67534,41,320,273,302,6769,18
67761,8,108,266,95,2847,13
17399,132,2350,1414,1521,9761,829
59835,24,404,510,253,4984,151
25794,1752,52110,1260,34203,203438,17907
2055,111,6021,1587,3446,38024,2575
12986,6,246,1480,124,9716,122
15432,74,1506,1446,913,10774,593
62345,6,87,423,78,8004,9
61057,7,92,465,92,7477,0
57363,865,16150,590,12063,118627,4087
51124,90,1316,778,1179,13178,137
49798,235,4791,812,3653,45268,1138
65712,0,0,329,0,1689,0
12833,0,58,1482,23,6987,35
4066,57,3911,1567,1817,50808,2094
15071,18,950,1451,684,37173,266
59172,65,739,533,551,9330,188
11439,830,37239,1497,18944,295125,18295
51445,669,6464,770,5273,27865,1191
10320,12,415,1506,266,36900,149
23335,24,646,1312,437,16961,209
2289,19,625,1585,387,9657,238
58716,169,2304,547,1936,20653,368
48776,1207,14949,842,11174,113035,3775
35639,36,689,1065,525,8154,164
54129,5,51,686,38,4674,13
50892,3300,65708,785,50333,336344,15375
33052,162,5480,1121,3735,29671,1745
20531,16,460,1358,337,5866,123
21379,9,859,1343,459,42112,400
36255,55,551,1049,457,6483,94
16793,3,185,1424,127,7521,58
48543,97,2290,849,1067,39384,1223
9455,251,6159,1511,3935,22317,2224
25865,102,2169,1259,1442,37424,727
33569,4,65,1111,33,1888,32
8397,96,1121,1515,792,11181,329
42280,8393,158694,932,120926,701552,37768
10834,456,14147,1502,7218,138878,6929
22213,41,906,1331,532,36588,374
23028,18,656,1317,372,11551,284
58561,37,486,552,483,11042,3
59519,1001,14314,521,9472,73878,4842
34530,12,433,1092,242,11600,191
37046,393,8221,1029,5715,53944,2506
6045,8,528,1542,312,18613,216
44078,400,6045,906,4865,67872,1180
56942,14,334,600,272,6026,62
14503,268,8013,1458,5500,126043,2513
29476,12428,221043,1184,131667,921004,89376
57554,16,571,586,314,6773,257
27240,1,62,1229,55,10721,7
39850,2,106,970,68,3423,38
10330,26,678,1505,404,20122,274
46538,75,1758,878,1406,34000,352
9400,569,19475,1511,9223,132861,10252
52560,13,202,735,191,12139,11
63641,133,2575,388,1913,31120,662
10606,8,163,1504,117,8674,46
40284,34,506,963,424,9948,82
56328,226,3826,618,3289,56361,537
19422,25,400,1377,335,18463,65
23880,69,1323,1302,966,14887,357
35357,19,295,1071,206,6285,89
9,28,1539,1606,869,58640,670
50674,698,11770,791,9335,130250,2435
33125,89,3276,1119,2015,51818,1261
52603,17,107,733,81,4128,26
23846,11,263,1303,237,6417,26
7110,70,3684,1529,1505,34528,2179
37207,0,728,1024,651,18219,77
14976,8878,191430,1452,87459,587141,103971
19957,8,159,1368,145,20075,14
36900,28,390,1033,286,12675,104
50651,3,78,791,69,4466,9
22751,89,1759,1322,1389,15902,370
8011,13,848,1517,422,23846,426
26729,167,2075,1239,1087,59469,988
6145,2,141,1541,99,5041,42
32994,14,320,1122,185,3275,135
27845,1372,23677,1215,16429,113191,7248
18360,123,3764,1396,2353,43072,1411
16236,318,5959,1433,3343,21997,2616
49083,70,1874,832,996,20511,878
58020,7,88,571,87,7130,1
42698,23,390,924,296,13203,94
21389,105,1082,1342,874,11387,208
55724,16,185,636,144,8580,41
61323,20,261,456,257,11455,4
53719,239,2371,700,1313,33072,1058
9788,26,751,1509,486,22715,265
29346,4,112,1186,81,11744,31
33998,109,1924,1103,1116,11485,808
10213,499,16879,1506,11233,86975,5646
62234,17,195,426,165,8214,30
4524,232,9048,1562,6307,113949,2741
37244,1129,11729,1022,9511,65486,2218
61648,131,1725,446,1419,26020,306
69645,1,35,204,31,3197,4
29115,25,882,1191,547,8041,335
20943,8,653,1350,455,23657,198
53751,497,5904,699,5395,56608,509
17393,12,149,1414,113,9049,36
29083,3,137,1191,87,7514,50
23402,45,1303,1311,884,13753,419
55935,22,215,630,202,9306,13
64459,29,256,363,248,9734,8
32644,1533,85433,1128,40606,221349,44827
30548,54,1215,1162,758,16346,457
10242,7,187,1506,118,4965,69
11989,122,4670,1492,2791,38747,1879
54309,521,5328,680,4225,58350,1103
21532,10,415,1340,309,11932,106
54322,2327,40430,680,25297,121655,15133
65266,8,170,340,149,6396,21
36208,45,522,1050,451,5842,71
37516,477,10921,1015,8038,56326,2883
13567,275,11910,1471,4375,104024,7535
4981,232,8248,1555,4161,52837,4087
52116,34,410,750,312,12258,98
3063,15,608,1578,449,15650,159
31273,299,4531,1149,3604,29526,927
22826,4,223,1321,163,14635,60
53047,2086,35431,718,18618,224687,16813
30626,123,2124,1161,1183,29260,941
35690,25,372,1064,325,12372,47
55223,20,272,649,205,8292,67
56764,46,465,597,432,5826,33
21412,34,1311,1342,998,27322,313
16851,447,16762,1423,10767,358334,5995
17552,70,3313,1411,2310,39234,1003
16304,41,1729,1432,1345,82437,384
27387,430,12028,1225,6473,94550,5555
54362,1709,47531,678,19680,303140,27851
30436,10,423,1164,349,14120,74
20749,72,2787,1354,2083,17675,704
40740,444,7193,956,6717,105132,476
32707,65,2503,1127,1415,17903,1088
17608,109,3242,1410,2231,33098,1011
4264,49,1519,1565,1017,13995,502
68425,3763,112048,245,102497,961698,9551
10951,19,634,1501,447,15304,187
60653,25,336,480,314,19466,22
16391,184,2651,1430,1693,24262,958
57375,10,75,590,52,4137,23
32147,4,156,1137,104,14999,52
16024,24,668,1436,474,12754,194
3008,58,3391,1578,1934,47444,1457
68788,84,1612,232,1507,25151,105
56987,72,795,599,733,8499,62
60292,529,9251,494,9216,72220,35
53986,632,5654,691,5212,34003,442
33029,73,1733,1121,1195,27649,538
8876,5,142,1513,95,5170,47
10836,4340,176855,1502,86487,447952,90368
47467,26,349,867,276,8173,73
62844,3787,100518,409,61494,616506,39024
25495,1374,26506,1267,20775,102036,5731
52180,9,120,748,90,2827,30
609,135,6339,1597,2065,52070,4274
52936,92,1392,722,1329,16149,63
7481,6,315,1524,233,36938,82
52289,130,824,744,715,15751,109
57741,937,8773,580,7834,84489,939
61971,30,363,434,350,7135,13
11917,167,4921,1493,2775,29519,2146
56547,210,3508,611,2880,29153,628
50900,113,1717,785,1064,16184,653
52743,59,1020,728,723,18406,297
55050,23,258,654,190,7445,68
22070,43,1883,1333,1276,25549,607
9421,4075,251833,1511,87649,702467,164184
14764,0,0,1455,0,6372,0
23549,16,310,1309,262,11784,48
28876,82,1712,1195,1075,10965,637
57979,1050,21391,572,14242,109824,7149
32441,18,810,1132,518,8429,292
2194,566,10307,1585,6860,45050,3447
51487,8,111,769,98,2779,13
30851,43,1492,1156,976,11363,516
37980,38,843,1003,657,41192,186
59417,788,13656,524,11651,103105,2005
12567,143,2666,1485,1619,12488,1047
8870,48,2081,1513,1034,18837,1047
13926,15,690,1466,442,12070,248
21991,742,23026,1334,15253,104249,7773
36731,1,68,1037,58,7339,10
7751,15,649,1520,376,19094,273
34433,2542,80544,1094,35818,364625,44726
10674,9,271,1503,178,14267,93
43139,2,108,917,87,5741,21
6435,6,196,1538,136,17634,60
29686,324,9417,1180,6289,66475,3128
12469,70,2172,1486,1036,13975,1136
14804,37,1837,1454,1264,16945,573
63731,420,6673,372,4805,61344,1868
19243,122,2548,1380,1765,34351,783
12866,6889,233409,1481,131821,595966,101588
66915,1216,24506,293,19009,172948,5497
33963,244,1882,1104,1237,20835,645
16086,8,373,1435,237,14750,136
1808,10,349,1588,257,10733,92
1976,2,136,1587,98,22067,38
35712,114,1245,1063,1078,14371,167
26684,9,387,1240,243,7488,144
31636,37,1013,1144,521,16859,492
34057,36,533,1101,364,9643,169
29124,32,1614,1190,879,20056,735
16886,2153,32618,1423,18933,155013,13685
53998,11,180,691,153,7034,27
55137,33,608,652,434,6579,174
32272,20,596,1135,392,5588,204
31975,57,909,1139,562,13762,347
52657,62,759,731,534,27901,225
9549,13,725,1510,295,12057,430
18286,10,353,1397,241,8507,112
487,107,4515,1599,2753,57063,1762
56525,13,129,612,109,12826,20
37483,281,4790,1012,4049,49726,741
26422,44,2204,1247,1124,19963,1080
56423,8,141,616,121,5228,20
49956,53,1086,809,605,19284,481
28786,109,2492,1197,1357,31636,1135
10742,45,1392,1503,776,18924,616
13179,170,6560,1477,3357,84471,3203
38653,204,3212,985,2791,22483,421
65598,153,1728,333,1701,20699,27
33551,14,174,1111,158,12357,16
27638,103,3579,1219,1236,21211,2343
63835,9,210,383,174,8071,36
59103,42,479,535,380,15463,99
274,35,422,1600,267,25240,155
43521,237,4484,912,4110,44192,374
13640,37,1073,1470,582,17707,491
14681,24,722,1456,542,20364,180
44601,63,1761,901,1296,19854,465
68089,31,270,256,257,5056,13
12609,12,857,1485,409,9493,448
8954,3895,103919,1513,63757,317146,40162
2139,15,674,1586,388,12761,286
61483,1383,16756,451,12034,126302,4722
55576,654,10157,639,9630,174387,527
15868,4,212,1439,142,4162,70
12426,3345,86346,1487,57079,353406,29267
14570,6,491,1457,319,6018,172
70016,0,19,191,14,1893,5
48476,75,1329,852,968,17505,361
6796,79,4108,1533,1706,38647,2402
68344,45,538,247,475,10123,63
59917,7,47,507,26,10744,21
40874,180,2361,954,1853,20739,508
23210,17,446,1314,405,20562,41
59057,151,1793,537,1547,8861,246
49497,12,316,821,175,8922,141
62154,53,1131,428,782,17822,349
35439,50,972,1069,664,13378,308
16593,105,1857,1428,1317,22200,540
56323,16,268,618,196,9345,72
17452,49,1348,1413,1068,42448,280
7854,38,1087,1519,635,20592,452
21722,46,1481,1337,905,24361,576
36448,1,29,1043,26,1779,3
32925,1,114,1123,73,5022,41
20680,161,4013,1356,2078,32865,1935
30242,1,80,1168,54,10481,26
4262,35,1437,1565,891,27032,546
63338,6,59,397,42,7091,17
9242,80,7092,1512,3245,54742,3847
30738,38,823,1159,804,40965,19
45259,217,1809,893,1689,56037,120
3699,33,633,1571,494,19534,139
13045,17,1393,1479,618,15931,775
4685,69,1360,1559,1067,47388,293
49307,752,8836,825,7554,86015,1282
23855,4,123,1303,93,4347,30
22242,14,697,1330,476,5825,221
7112,73,2119,1529,967,33906,1152
10871,56,1051,1501,645,9458,406
42243,474,8261,932,8242,84507,19
45831,239,2579,887,2234,28859,345
29295,64,1365,1187,815,20253,550
63236,6,87,400,76,7523,11
37476,62,874,1016,743,10566,131
5262,85,1453,1551,1088,36480,365
57616,11,187,584,179,6460,8
35385,22,522,1070,287,7967,235
16441,33,865,1430,640,15402,225
66927,6,70,293,66,4258,4
59705,11,271,514,242,5199,29
57113,519,7109,596,5398,56737,1711
6034,190,7283,1542,4220,93428,3063
53789,52,497,698,419,9306,78
60281,20,383,493,371,4683,12
63991,1263,23329,378,18152,95971,5177
36231,726,18680,1049,15440,171979,3240
37938,11,313,1004,277,10080,36
51064,73,1412,780,916,25049,496
37877,43,626,1006,559,12591,67
55411,71,1006,644,960,7424,46
61846,12,190,440,146,8678,44
5300,98,3510,1551,2262,70994,1248
34235,155,5453,1098,3646,39817,1807
19425,1414,35663,1377,21573,203937,14090
68724,4,45,234,32,3054,13
10853,74,4243,1502,2258,29879,1985
55972,771,8958,629,7433,60344,1525
28810,8,404,1197,192,4753,212
5515,16,242,1549,182,8288,60
37787,0,111,1008,90,6247,21
10335,116,4682,1505,2795,36763,1887
15903,19,474,1438,323,10880,151
52160,40,444,748,403,39332,41
49476,40,1102,821,796,22473,306
7756,27,1885,1520,1080,39573,805
15729,10,338,1441,199,12120,139
13348,11372,384665,1475,209455,1148421,175210
32327,81,2484,1134,1592,21214,892
65100,5,255,344,141,4705,114
42560,46,536,927,434,12147,102
29972,12,464,1174,309,23825,155
37345,73,883,1020,655,19515,228
20517,519,10628,1358,6269,120097,4359
58278,22,186,562,161,8541,25
6779,16,672,1533,401,13821,271
25180,14,256,1274,192,12813,64
26321,847,20600,1249,10782,194099,9818
41836,144,4044,938,2546,61295,1498
11546,1102,54439,1496,34213,278483,20226
22369,2394,47704,1329,31862,188775,15842
50618,10,200,792,115,5526,85
32067,14,451,1138,264,13585,187
16231,663,8640,1433,5757,42125,2883
2170,49,1906,1586,1363,23628,543
38291,48,689,995,576,7249,113
52360,86,1818,742,1203,27125,615
28442,98,1835,1204,1497,42676,338
8601,37218,1178087,1514,601643,2121365,576444
33726,6,372,1108,244,10129,128
35993,35,884,1056,682,34319,202
15396,221,4635,1446,3447,73800,1188
29070,48,1204,1191,689,12291,515
26533,50,1595,1244,525,23756,1070
52519,66,912,725,508,17680,404
3780,1286,29533,1570,18522,191211,11011
4457,4499,145872,1563,74829,267815,71043
59590,9,65,519,58,4295,7
11364,28,489,1498,293,11523,196
4435,22,1361,1563,679,33527,682
50013,6356,96416,807,65350,299523,31066
54851,145,1248,660,1135,15730,113
28587,65,1080,1201,936,12933,144
10174,7,369,1506,254,25828,115
32337,51,1835,1134,877,15287,958
38461,135,3172,990,2757,37334,415
59115,77,1214,535,1191,12313,23
20963,28,500,1350,377,10155,123
23906,59099,1218602,1302,629199,2325341,589403
8234,1097,60674,1516,27111,246828,33563
54257,23,138,682,117,8099,21
24097,138,5707,1297,3086,41014,2621
44429,22,319,902,194,5429,125
24208,6,214,1295,163,8493,51
34496,1748,30867,1092,23035,148719,7832
24557,505,14742,1287,10806,109335,3936
35218,4,93,1074,55,2534,38
28518,493,6025,1202,3863,29199,2162
9605,2148,33866,1510,25929,93550,7937
2557,33,2342,1582,1265,63559,1077
7241,9453,249614,1527,145105,733850,104509
42588,21,246,926,159,6693,87
48602,14,280,847,162,5055,118
57884,34,382,575,301,8821,81
18195,6,363,1399,219,9980,144
29123,4427,164366,1190,60402,709478,103964
62870,11,81,409,68,3985,13
22234,471,11464,1330,8206,65375,3258
63692,12,164,387,141,6238,23
34610,147,3831,1090,2527,26463,1304
14126,218,5262,1463,3067,28319,2195
51848,36,547,758,390,11082,157
10121,0,0,1507,0,5198,0
25685,847,14493,1263,8993,61376,5500
20188,186,4128,1364,2823,41769,1305
44229,6,169,904,143,12727,26
49257,30,899,827,666,7175,233
28771,4,89,1198,48,1748,41
44577,8,160,901,89,7932,71
31401,74,4149,1148,1072,19005,3077
25498,8,223,1267,131,8053,92
20108,31,339,1365,283,27151,56
50005,1216,11175,807,7953,107225,3222
14332,4,256,1460,125,8208,131
57551,90,901,581,891,13745,10
28077,7,332,1210,258,7245,74
14709,2880,74402,1456,53398,410577,21004
12786,28,988,1482,516,7458,472
32394,2296,45852,1133,30829,164808,15023
26039,78,1700,1255,996,20292,704
31417,35,1125,1148,645,23328,480
37967,0,17,1003,16,4858,1
21312,47,1144,1344,763,32523,381
4429,685,39810,1563,12420,208869,27390
14224,21,783,1462,582,11220,201
35493,9,170,1068,129,3002,41
8495,17,440,1515,263,9353,177
63729,41,548,386,496,5229,52
31977,46,1090,1139,744,11245,346
43593,764,14921,911,8476,79573,6445
23407,221,7061,1311,5249,51678,1812
69515,1080,25143,207,23049,215826,2094
25050,25,750,1276,442,11630,308
55677,3949,60557,637,39184,393147,21373
35994,39,601,1056,503,10689,98
56627,20,207,609,175,7211,32
36975,193,2338,1031,2029,29785,309
48570,938,13943,848,12034,135231,1909
49740,144,2808,814,2248,29550,560
50641,61,360,791,290,6858,70
25714,6,492,1262,334,12128,158
12488,268,12457,1486,7602,81407,4855
49292,3160,68162,826,50510,444746,17652
52661,33,765,731,509,16432,256
8916,470,16080,1513,10163,110812,5917
28344,24,394,1205,295,5811,99
13929,617,26440,1466,11919,173524,14521
62078,4,76,431,44,2313,32
39000,132,2269,980,1136,31212,1133
33733,17,485,1108,289,8586,196
23088,16,603,1316,457,13159,146
21081,1202,29234,1348,18842,174229,10392
38649,24077,626782,985,331348,2882295,295434
11872,16,846,1493,445,15464,401
10427,14,750,1505,411,12477,339
29910,42,680,1175,362,7366,318
24813,5,220,1281,131,9204,89
34933,345,7225,1082,5367,27553,1858
22381,43,664,1328,507,12910,157
20699,49,1688,1355,1328,22793,360
23390,52501,1117573,1311,569220,2372547,548353
3145,1259,50383,1577,31313,125935,19070
42885,0,12,921,8,7773,4
10959,7,222,1501,141,15197,81
20420,73,3353,1360,2467,37634,886
34038,362,8441,1102,3534,40937,4907
34197,1,140,1099,76,3134,64
21768,49,1343,1337,940,15170,403
63460,5,70,393,66,5048,4
7820,44,1942,1519,1387,34448,555
30017,755,12842,1173,10194,89459,2648
22366,37,841,1329,557,14278,284
37621,269,4720,1012,3818,31818,902
1297,337,13780,1592,9720,51975,4060
31829,4,272,1141,188,3788,84
23611,11,725,1307,399,14155,326
23932,4,188,1301,135,8726,53
15790,63,1877,1441,1391,54495,486
1834,13,745,1588,462,29208,283
34150,2639,45058,1100,25341,192148,19717
26540,835,28806,1244,20801,132641,8005
64418,18,216,365,197,9310,19
21850,198,4094,1336,2692,50125,1402
34091,3,82,1101,65,2913,17
12946,75,2960,1480,1975,193791,985
6418,95,1137,1538,756,9594,381
12719,15,765,1483,444,6588,321
15516,22,599,1444,416,13823,183
34652,4,128,1088,98,3130,30
69650,9,142,202,121,3017,21
65393,875,19643,336,10022,132135,9621
4514,1857,143966,1562,57613,694961,86353
16252,11,443,1433,315,18245,128
60466,127,2160,487,1874,24591,286
25429,1088,17231,1268,13261,97567,3970
47649,6452,121330,863,71227,757929,50103
48357,2,154,855,116,10467,38
18787,995,27885,1389,14368,233237,13517
53594,43,682,705,606,26699,76
4273,86,8751,1565,3335,38554,5416
19019,6,146,1384,120,16634,26
12156,39,767,1490,523,11323,244
26490,544,12785,1246,7758,73417,5027
66607,25,378,303,339,12217,39
22610,2372,47310,1325,24932,185020,22378
29430,4,307,1185,268,6009,39
34960,7131,161356,1058,113070,682744,48286
28828,17,316,1196,202,14946,114
26426,54,1521,1247,803,30327,718
7563,95,3428,1523,1282,55105,2146
46785,166,1049,875,914,12603,135
61599,44,522,448,411,17018,111
20148,1,135,1364,101,3594,34
24210,84,2625,1295,1274,21543,1351
10149,26,469,1507,318,9039,151
44044,19,378,907,302,10353,76
31532,4,92,1146,62,4021,30
15270,25,884,1448,640,32075,244
29659,51,2571,1181,1511,19866,1060
38356,272,3288,994,3039,20931,249
6452,86,2419,1537,1480,14899,939
48668,31,567,845,400,15101,167
32921,524,7164,1123,5734,69020,1430
30578,821,18402,1162,12787,176935,5615
60488,6,23,486,22,2774,1
30120,359,11061,1171,6836,43627,4225
22372,102,3961,1329,2609,33710,1352
776,1001,57364,1596,29680,151071,27684
6314,5,347,1539,182,23137,165
9517,37,1217,1510,836,35990,381
31996,11,285,1139,182,7465,103
62098,99,1325,430,990,24632,335
52881,72,969,723,913,23671,56
22974,58,1521,1318,967,21133,554
28913,3,179,1194,96,5143,83
32895,1658,33141,1123,19838,87811,13303
49718,0,2620,815,1303,13582,1317
15760,0,0,1441,0,17124,0
23676,13,514,1306,309,9072,205
69718,2,41,201,35,2347,6
46663,50,685,877,533,25481,152
50823,661,7531,787,5475,40383,2056
7417,272,5175,1525,3420,31640,1755
31638,53,1852,1144,1040,31598,812
11616,599,12312,1495,7831,91728,4481
34054,59,1384,1101,958,8873,426
68545,11,111,240,95,6311,16
32902,146,2605,1123,1350,20087,1255
57865,6,89,575,81,3678,8
33613,94,3433,1110,2361,24280,1072
20211,1481,36552,1363,27723,226401,8829
64042,18,414,376,268,17544,146
30972,48,898,1154,667,21372,231
19749,356,7493,1372,4543,65901,2950
42910,172,2786,921,1940,24853,846
6670,16,294,1534,232,6987,62
59289,4,114,529,90,2753,24
19963,2,24,1368,21,3451,3
24086,3,164,1297,119,12203,45
3343,12,355,1575,246,36638,109
37128,49,1155,1026,879,8525,276
11260,55,3308,1499,1590,66018,1718
30141,358,12155,1170,6996,111777,5159
38280,142,1448,995,1111,12282,337
969,12,602,1595,351,13704,251
52,146,10314,1604,4382,72236,5932
16255,6,477,1433,347,34450,130
522,4042,154616,1598,88169,415448,66447
43221,8873,513619,915,218816,703838,294803
21547,41,789,1340,685,19964,104
45309,140,4063,893,1493,41220,2570
57850,23,418,576,292,10326,126
57233,53,595,593,547,8471,48
37218,47,1074,1024,816,27622,258
29616,390,8701,1182,6505,113404,2196
14815,225,4439,1454,2823,32215,1616
53421,26,206,708,189,9390,17
55479,70,932,642,722,26445,210
31255,68574,1284656,1150,672342,3091208,612314
21208,52,1942,1346,1326,16149,616
6769,60,2122,1533,1218,25225,904
14673,56,7657,1456,4435,67663,3222
8774,2,63,1514,43,6275,20
17276,239,4507,1416,3598,48091,909
14427,53,1213,1459,797,10018,416
53951,5,49,693,37,3400,12
53995,1275,14358,691,10603,52835,3755
33862,180,3484,1105,2734,30009,750
10635,38,1218,1503,772,28256,446
22313,344,7032,1330,4761,63045,2271
2721,668,11795,1581,6789,90023,5006
60901,1740,25820,470,22754,125685,3066
4810,30,1306,1557,922,31911,384
56580,38,654,611,485,20290,169
20946,62,1207,1350,737,22984,470
24016,155,5527,1299,3172,48720,2355
13298,4283,86351,1475,48648,258616,37703
17194,133,3577,1417,2376,23443,1201
26291,23,867,1250,507,10609,360
13775,0,0,1469,0,14129,0
38262,33,593,996,478,10253,115
45283,328,5783,893,5065,38323,718
40944,3170,57608,952,37888,137147,19720
46410,544,10766,881,9051,89813,1715
50662,64,558,791,513,10503,45
57947,9,88,573,74,5640,14
42374,0,108,930,52,5824,56
7885,87,2059,1518,1663,31511,396
15591,117,4361,1443,2866,33141,1495
60026,12,175,504,170,6053,5
1914,141,4126,1588,2806,32371,1320
1160,147,4940,1593,3197,26725,1743
3671,15,618,1572,526,15405,92
17186,12,778,1417,458,9138,320
55836,13,315,633,129,9842,186
40094,107,1979,966,1326,13398,653
63592,45,687,390,545,13698,142
26379,9,968,1248,652,30160,316
40201,0,0,964,0,2174,0
22067,798,21274,1333,11045,151451,10229
23630,79,1670,1307,1027,12088,643
19364,21,512,1378,375,14510,137
52638,10,226,731,101,14167,125
54193,4,68,684,51,4253,17
30890,21,965,1156,623,26324,342
70027,1,33,191,33,1473,0
16465,455,11337,1429,8677,104885,2660
61721,35,396,444,375,11424,21
34940,265,6662,1079,3660,42877,3002
4213,30,1319,1566,693,39770,626
17515,394,9092,1411,6801,80553,2291
1341,1,213,1592,112,4215,101
56560,5,86,611,85,10348,1
20386,118,2555,1361,1808,21912,747
32815,324,7166,1125,4646,50837,2520
33660,11,186,1109,161,8827,25
40347,25,433,962,381,9680,52
12267,10,1094,1489,555,8111,539
10792,47,991,1502,518,16586,473
59458,2,120,523,35,6287,85
992,92,2783,1594,1616,50870,1167
37873,18659,345336,1006,214300,864401,131036
49403,8,101,823,74,4852,27
29493,18,435,1184,264,10336,171
9398,7,127,1511,92,5808,35
20105,1,97,1365,82,6726,15
7299,51,1126,1526,796,33227,330
5750,69,1561,1546,982,21092,579
13440,8,456,1473,245,13272,211
35347,16,280,1071,198,6571,82
32140,12,350,1137,232,10042,118
4175,2,130,1566,96,31262,34
44582,81,1912,901,932,11634,980
6898,17,867,1532,659,21403,208
15891,242,4692,1439,3080,51836,1612
11474,66,3670,1497,1915,32292,1755
7627,1045,31035,1522,20253,223952,10782
50990,36,776,782,652,8651,124
16361,13,271,1431,181,8077,90
33001,405,13915,1121,9697,90564,4218
30632,16,433,1161,243,7653,190
34734,4,55,1086,43,5390,12
8645,6,751,1514,430,22942,321
33917,10,116,1104,106,3585,10
56612,58,516,610,408,12497,108
37475,270,8546,1016,3059,49273,5487
19319,2969,80026,1379,47265,491151,32761
56052,33,264,626,246,7232,18
41160,45,1281,949,1131,17410,150
17626,44,1380,1409,1115,53488,265
31189,67,1478,1151,1092,28533,386
54276,109,1207,681,990,17389,217
33513,423,32959,1112,12060,101203,20899
8635,1450,33642,1514,21922,202434,11720
60650,23,473,480,420,10218,53
26024,41,1351,1255,812,39737,539
2684,4,210,1581,152,13239,58
3338,69,4176,1575,2068,58223,2108
48699,14,1277,844,154,15097,1123
30873,19,706,1156,519,3966,187
11963,2265,81405,1492,40951,419087,40454
9004,98,3363,1513,2243,34974,1120
7771,6,234,1520,156,8012,78
58156,79,960,566,864,13373,96
30473,2915,72064,1163,42007,231192,30057
34209,80,1637,1098,1327,36733,310
10342,2713,75661,1505,46953,401949,28708
23223,14,196,1314,118,7950,78
21056,43,1379,1348,883,30581,496
21317,10,292,1344,179,9443,113
56407,21,375,616,353,9303,22
219,30674,948804,1601,446803,2044519,502001
20623,145,4175,1357,2108,36981,2067
20568,7,378,1358,230,15100,148
49334,22,341,825,272,8996,69
28445,113,2542,1204,1724,8830,818
58662,4,160,549,69,11567,91
33006,179,2803,1121,2387,26312,416
31427,54,1084,1147,584,11365,500
30489,10,268,1163,160,5087,108
22264,620,16701,1330,11152,107745,5549
8272,32,699,1516,454,8483,245
48894,606,7249,839,5793,95028,1456
13233,257,9085,1476,5661,60923,3424
3624,245,20706,1572,11178,81163,9528
41800,3,57,939,41,6249,16
40400,5941,70272,961,55620,237390,14652
27116,206,4504,1231,3100,30377,1404
44737,9,128,899,89,4443,39
56180,204,3132,622,2265,38133,867
9754,3,426,1509,224,9199,202
13768,51,1401,1469,817,11657,584
59078,444,9722,536,7936,39432,1786
62584,17,240,416,157,3625,83
14255,4,66,1461,47,3499,19
9983,50,810,1508,532,14503,278
20525,439,8350,1358,5715,86272,2635
14987,12,300,1452,241,19448,59
17141,73,1714,1418,1157,37635,557
4892,24,816,1556,462,27097,354
29442,37,971,1184,614,10246,357
64421,2,18,365,12,2646,6
34977,94,4062,1080,2395,30906,1667
38295,27,269,995,234,6651,35
51736,55,611,762,523,10219,88
25023,25,827,1276,555,11324,272
37776,2,24,1008,19,4983,5
65659,15,188,331,165,9353,23
9274,59,2983,1512,1558,20095,1425
69764,2,81,199,23,2189,58
40381,38,922,961,789,14413,133
50526,46,591,794,497,12435,94
12047,156,5267,1491,3205,28565,2062
25324,171,3987,1270,3104,59291,883
4462,101,4660,1563,2685,102372,1975
61260,119,1859,457,1515,21148,344
16560,6,129,1428,74,3023,55
37443,93,1442,1017,1309,15447,133
59069,26,332,536,329,4648,3
13317,7172,200662,1475,131685,881151,68977
34679,728,20517,1088,11984,110178,8533
48771,21,398,842,299,9949,99
34763,5,67,1085,41,10836,26
1132,60,2334,1593,1558,20544,776
8210,21,600,1516,399,20225,201
24148,7,194,1296,150,8847,44
25525,6,806,1267,469,7686,337
1510,17,286,1591,201,15122,85
30881,17,932,1156,486,11017,446
27526,9,228,1222,128,5173,100
5632,523,15929,1547,9204,74666,6725
1148,1417,39605,1593,26401,313736,13204
1861,6,525,1588,396,22589,129
28973,33,515,1193,356,5049,159
33947,58,1294,1104,969,11134,325
52997,55,1056,720,774,8013,282
12280,0,0,1489,0,8967,0
30822,21,440,1157,288,11096,152
25827,28,353,1260,260,43923,93
51494,11,244,768,139,5634,105
67959,4,56,260,53,6026,3
38826,63,901,982,691,9979,210
20654,101,4061,1356,2837,41236,1224
53520,4,98,707,85,11273,13
32420,106,4560,1132,2277,69335,2283
9251,237,6770,1512,3588,41205,3182
23022,4,105,1317,78,4605,27
62020,76,1114,433,1101,19084,13
4154,77,1497,1566,1045,16613,452
62681,132,1571,413,1170,24254,401
20869,42,348,1352,300,15727,48
23800,29,447,1303,271,12167,176
34036,13,620,1102,365,11223,255
14044,7,439,1464,282,6889,157
25541,35,2226,1266,1453,25314,773
9814,31,1082,1509,774,19083,308
36783,32,288,1036,237,6786,51
3997,34,1788,1568,1326,21482,462
54681,148,1058,666,950,13174,108
64181,8,49,372,43,4609,6
35465,341,7539,1068,2898,90668,4641
50581,10,132,792,103,4200,29
53121,251,6020,715,3536,43350,2484
50830,1,67,787,55,5061,12
60127,223,4205,500,2696,45952,1509
11803,9923,502071,1494,183598,1963239,318473
37755,12,163,1009,135,16168,28
7123,26,1227,1528,879,86737,348
27960,1589,85356,1212,37712,187159,47644
10780,1520,22611,1502,13513,109738,9098
20321,123,3066,1362,1725,13391,1341
36081,228,3143,1054,2769,29597,374
58733,34,505,546,365,8803,140
17589,8,206,1410,140,9459,66
1247,35,1275,1593,623,36527,652
467,211,10646,1599,6606,70071,4040
60071,96,1213,502,608,17703,605
60747,38,488,476,356,7912,132
56457,189,4683,615,3441,26835,1242
53780,6313,117278,699,68003,524324,49275
16348,2,71,1431,55,6286,16
64294,16,120,368,98,6650,22
23007,29,435,1317,288,7864,147
11465,930,31265,1497,17623,96923,13642
64309,49,529,368,496,5631,33
61120,6,39,462,31,4093,8
28932,23,2991,1194,582,14911,2409
56571,20,306,611,255,7026,51
52431,7735,133706,739,101841,659955,31865
28035,9,129,1211,95,2847,34
21190,38,1620,1346,1136,23667,484
48586,445,5864,847,4291,51999,1573
17475,7,123,1412,89,24903,34
37556,1888,47352,1014,29528,106252,17824
33106,794,9061,1120,5830,60644,3231
49412,2,27,823,23,3131,4
37779,218,3507,1008,2985,48618,522
24163,10,519,1296,367,18895,152
8969,104,2225,1513,1636,22101,589
62256,10,163,426,123,3108,40
67551,4,74,273,66,2939,8
49632,5,114,817,87,6624,27
55628,2494,35304,633,28189,162068,7115
49133,573,21541,831,5330,181280,16211
37780,78,1491,1008,1143,37400,348
4765,174,7673,1558,4463,46507,3210
50390,631,8206,798,7584,64012,622
62986,42,343,406,340,7812,3
11049,733,46645,1500,22550,177075,24095
4230,15,374,1566,310,12774,64
35262,203,7515,1073,4337,58125,3178
23745,46,1755,1305,1241,27030,514
29855,26,621,1176,389,13589,232
991,7,284,1594,216,23574,68
34717,7,135,1086,99,7317,36
631,26,1172,1597,536,32548,636
40539,259,4026,959,2886,53696,1140
26249,8,749,1251,447,28477,302
49878,46,509,810,411,13628,98
14436,373,11768,1458,6676,110842,5092
20841,105,1655,1353,1208,17905,447
69743,3,114,200,84,7630,30
26618,21,1127,1242,759,17295,368
43017,266,3540,919,2882,29313,658
19263,929,46555,1380,16817,230829,29738
18917,3,315,1386,214,4826,101
1452,5,236,1591,172,10123,64
5805,10,169,1545,141,7815,28
49071,38,524,833,432,7331,92
55000,31,327,655,231,6446,96
17687,43,988,1408,630,15046,358
31543,85,2761,1146,1934,72643,827
15969,515,14180,1437,10534,139308,3646
6688,42,1514,1534,944,51669,570
35533,12,211,1067,126,5612,85
64446,162,3987,364,3218,53192,769
8415,341,11620,1515,8169,66514,3451
17800,18,492,1406,373,9701,119
32775,256,7522,1126,4123,60458,3399
59393,55,714,525,674,13067,40
59091,3592,84359,535,60830,193681,23529
38550,104,889,988,733,17693,156
48293,237,4550,856,4174,31987,376
16942,150,4056,1422,2687,36710,1369
43653,58,723,911,558,10347,165
15622,132,3493,1443,2847,116260,646
2922,47,3851,1579,1506,61167,2345
58328,152,1986,560,1398,16511,588
32030,114,2341,1138,1354,14468,987
4030,97,4060,1568,1737,28232,2323
38382,8,196,993,119,4246,77
4012,12,197,1568,126,5941,71
67386,30,579,278,425,9833,154
3083,221,5814,1578,4245,37445,1569
18517,8,147,1393,112,9195,35
30650,7,259,1160,159,9058,100
3788,858,55303,1570,27948,224636,27355
24825,8,610,1281,401,27337,209
19432,14,1006,1377,809,10604,197
57127,101,1494,596,874,20965,620
64425,14,230,364,206,7448,24
50835,667,12062,787,9416,172982,2646
12649,95,8599,1484,3939,33975,4660
47553,8,212,865,202,10182,10
55166,623,8489,651,7706,52424,783
34948,325,4910,1081,4092,48361,818
62167,53,1868,428,1101,16958,767
12357,175,5226,1488,2630,22977,2596
18597,728,14229,1392,9821,136667,4408
4453,1,101,1563,38,2044,63
50512,4,108,794,90,4034,18
10430,20,906,1505,344,12448,562
23256,74,1603,1313,1329,39663,274
18028,12243,498548,1402,230664,1849763,267884
8166,4,276,1516,192,18328,84
22057,1130,20941,1333,16142,78684,4799
37688,135,1850,1010,1478,11764,372
8796,227,9820,1514,6558,102331,3262
42462,28,294,928,229,9567,65
52315,9,222,743,201,4217,21
9900,142,3361,1508,3019,23624,342
4501,10,171,1562,129,12011,42
13968,369,10749,1466,6354,121130,4395
3414,50,2424,1574,1738,59901,686
13499,25,2934,1472,1506,34095,1428
15264,278,6469,1448,4613,75752,1856
26615,31,1303,1242,983,12312,320
16209,853,23857,1433,15574,196803,8283
26942,23,580,1235,386,12770,194
55248,167,2201,649,2013,35207,188
38677,918,13463,985,11671,83472,1792
8373,58,1292,1515,937,11216,355
18934,6,676,1386,468,6332,208
4324,3,80,1564,60,13073,20
3723,77,1975,1571,1138,20921,837
10322,73,1520,1506,1065,26385,455
23261,14,603,1313,454,15624,149
21639,231,9992,1338,5755,143187,4237
22811,16,429,1321,158,4754,271
39814,68,1383,970,1338,20184,45
51241,26,314,775,248,13230,66
6391,18,272,1538,177,7756,95
57191,58,633,594,501,11678,132
32939,15,128,1123,79,3339,49
36304,9,168,1047,122,9655,46
28144,9,106,1209,87,3838,19
43853,26,380,909,269,10227,111
26397,75,1823,1247,1370,21881,453
30467,7,314,1164,218,4305,96
6297,22,355,1540,260,7354,95
35951,208,2499,1057,1925,37341,574
26782,92,3420,1238,2397,88903,1023
56150,18,339,623,221,13427,118
31940,20,441,1140,321,13261,120
61532,10,106,450,65,4737,41
5713,39,834,1546,684,10055,150
11484,37,1741,1497,861,20115,880
12779,244,13883,1483,6621,76673,7262
51762,10,342,761,301,14484,41
43617,62,714,911,644,14038,70
1821,36,1568,1588,1146,57827,422
57923,9,118,574,104,2653,14
19814,139,8526,1370,4948,71614,3578
68599,19,270,238,217,9264,53
10050,2501,57687,1507,38496,132084,19191
17464,70,2199,1413,1164,15564,1035
3618,9,233,1572,190,10877,43
515,2145,54042,1598,29786,234442,24256
29786,76,1827,1178,1033,21765,794
28599,227,3404,1201,2081,23159,1323
38633,239,3060,986,2227,36147,833
34507,78,1667,1092,1283,8832,384
10037,10698,388529,1507,157524,1683611,231005
47233,43,780,869,637,6980,143
62061,136,2110,423,1830,14290,280
65261,14,72,341,60,8588,12
31630,20,337,1144,219,5151,118
10955,178,6827,1501,3638,52543,3189
45746,316,4391,888,3648,33409,743
64413,223,2271,365,2112,17526,159
23595,1012,29798,1308,17388,161505,12410
34011,55,1325,1103,971,19802,354
22233,534,18828,1330,11717,121527,7111
27177,42,1859,1230,1236,28125,623
5048,135,8028,1554,4729,60255,3299
7235,14,260,1527,191,10642,69
20057,46,2790,1366,1676,36966,1114
64390,33,869,366,717,13811,152
6301,686,27173,1540,14571,166690,12602
7772,46,1717,1520,1186,47207,531
37169,95,1098,1025,616,15039,482
61338,15,219,455,182,13208,37
13933,364,9343,1466,6346,67847,2997
23802,201,5585,1303,4262,55524,1323
3087,2288,46428,1577,24498,211218,21930
7418,55,1158,1525,795,13574,363
21386,19,481,1342,345,18412,136
4788,62,919,1558,678,13573,241
52207,50,530,747,474,6558,56
3135,216,11261,1577,6500,102991,4761
61593,526,6669,448,6527,61955,142
50202,11,393,802,290,10387,103
23197,29,590,1314,478,12486,112
35853,16,312,1055,223,5645,89
7675,179,4318,1521,2932,45167,1386
35664,186,2182,1064,1820,21798,362
44627,12,268,901,234,6037,34
34352,11,237,1096,159,5464,78
59087,7,114,536,79,6035,35
53508,36,391,707,368,19503,23
51011,1777,22545,782,12488,75919,10057
22849,723,22348,1320,13596,120324,8752
876,18,1295,1595,907,47232,388
32125,49,627,1137,421,15953,206
4367,43,1635,1564,926,17454,709
39730,526,8348,971,5117,112651,3231
33117,3208,86201,1119,45271,331660,40930
60898,11,145,471,134,4570,11
29565,3,122,1182,94,2941,28
33386,41,829,1114,601,16092,228
47374,14,341,868,198,12098,143
10135,860,20495,1507,10787,154466,9708
29654,5,103,1181,71,12509,32
17652,18,263,1409,219,14927,44
7060,67,1432,1529,1060,22426,372
66051,15,207,321,185,8421,22
45183,31,636,894,541,8190,95
47117,10,285,871,265,10470,20
2825,110,6053,1580,3326,59939,2727
66154,11,219,317,196,5426,23
57999,466,5948,571,5797,46364,151
17531,40,2716,1411,1495,26537,1221
18085,5,234,1401,157,4423,77
51574,140,3883,766,2336,55724,1547
17109,284,6175,1419,4561,35625,1614
49917,8,161,809,146,4587,15
18066,27,1107,1401,630,26949,477
40849,36,995,954,488,14473,507
53145,7,118,715,83,9605,35
26083,4,209,1254,121,5905,88
36795,103,1948,1036,1747,30036,201
42288,2,67,932,41,3870,26
13718,56,1522,1469,1011,28243,511
58757,41,448,546,375,9719,73
33511,0,0,817,0,2123,0
12525,22457,655866,1486,298754,1772345,357112
27155,6,1056,1230,635,15081,421
3623,329,8564,1572,6187,55473,2377
55389,2,44,644,38,6360,6
1699,77,3593,1589,2424,101629,1169
60218,68,789,496,686,24068,103
1761,227,8332,1589,5060,46749,3272
28131,628,16284,1209,7083,58507,9201
7832,264,6649,1519,3770,32533,2879
10990,81,3019,1501,1880,38366,1139
572,45,1765,1598,1347,23569,418
32683,72,2127,1128,1613,49531,514
17685,183,6883,1408,4649,56598,2234
67400,6,96,278,80,2590,16
26114,19,1272,1253,792,38539,480
45175,22,373,894,301,12696,72
21767,145,3078,1337,1693,18975,1385
60856,113,1049,472,902,9972,147
43145,798,15581,917,9442,242163,6139
2272,57,2715,1585,1879,40857,836
12130,27,1769,1491,774,14520,995
5946,101,4326,1544,2636,62120,1690
49218,33,427,828,283,9467,144
7625,2461,168565,1522,92116,431059,76449
48851,8,104,840,80,2846,24
31797,15681,334605,1141,182298,976893,152307
16455,1953,40505,1429,23308,221756,17197
35228,122,1989,1074,1651,26468,338
15522,267,18391,1444,7808,116482,10583
31385,3,95,1148,69,16332,26
13878,832,44078,1467,21003,252125,23075
3611,464,19921,1573,11462,108960,8459
58386,6,116,558,111,4048,5
42438,42,918,929,738,14819,180
10523,29,702,1504,490,15029,212
1527,6,294,1591,193,9246,101
64999,50,576,347,545,5210,31
50410,150,3734,797,2789,32534,945
50882,2451,38161,785,25245,234569,12916
557,8,536,1598,382,22318,154
27778,30,675,1217,488,18997,187
25993,54,2678,1256,1450,24408,1228
54007,2339,25825,691,23318,191543,2507
10686,188,6642,1503,3156,42987,3486
16291,291,4956,1432,3104,30650,1852
4723,205,6887,1559,4524,59560,2363
13619,10,657,1471,371,22037,286
21979,15,302,1334,205,23795,97
42768,233,4862,923,4006,50474,856
13570,11,436,1471,268,20420,168
8300,73,2472,1516,1682,13855,790
69870,389,8395,196,6601,76882,1794
3558,44,1576,1573,904,49683,672
237,138,3796,1601,2292,29438,1504
53912,283,4451,694,3526,20631,925
3467,2735,84202,1574,54560,229775,29642
4949,334,7176,1556,5041,40010,2135
34124,171,3103,1100,2036,21481,1067
63253,6,90,399,61,6934,29
25331,736,18366,1270,13101,122589,5265
19526,48,1063,1375,806,8018,257
1354,65,2834,1592,1530,23962,1304
22839,40,906,1320,669,10474,237
48534,9,184,850,167,8554,17
43465,2,50,913,38,5845,12
13464,7,380,1473,169,6250,211
13649,0,0,1470,0,19564,0
24599,16,265,1286,184,9720,81
8102,60,1772,1516,1185,13586,587
30515,16,545,1163,499,11855,46
25224,59,1743,1273,1260,8927,483
2754,51,1791,1581,1170,48479,621
70134,509,10996,186,10490,96539,506
51197,12,110,776,83,3986,27
40786,80,1408,955,1212,16806,196
68861,10,85,229,82,3887,3
57617,1,33,584,27,5037,6
24752,22,494,1282,334,10554,160
17579,21,564,1410,470,12818,94
49443,12,311,822,155,6036,156
2307,16,418,1584,333,7699,85
24661,26,837,1284,530,25068,307
176,229,9014,1602,6134,33066,2880
44834,53,666,897,542,19185,124
37611,3,48,1012,31,3472,17
36416,1275,19625,1044,15617,153901,4008
59236,29,703,531,465,15602,238
53843,25,343,696,338,16759,5
26659,21,631,1241,369,9394,262
5637,5,265,1547,180,8826,85
29917,29,795,1175,684,22609,111
2223,318,11260,1585,7037,100542,4223
5607,65,2882,1548,1917,34661,965
59334,70,1039,527,895,10752,144
14116,40,906,1463,348,18147,558
12185,233,10455,1490,4480,58323,5975
50825,164,5560,787,1629,37528,3931
19572,10,355,1375,251,9472,104
56892,24,547,602,360,13522,187
23492,40,896,1309,643,18027,253
619,12,569,1597,311,19812,258
7777,7,451,1520,223,27264,228
62197,7,181,427,145,5709,36
54987,23,179,656,105,3976,74
15882,56,969,1439,732,23616,237
19092,123,3381,1383,2439,33068,942
39828,19,438,970,401,16065,37
3500,10,282,1574,203,19997,79
24971,66,1955,1278,1115,18048,840
7552,708,47236,1523,20313,193063,26923
25275,1,143,1271,132,27821,11
5047,5,305,1554,60,321455,245
19939,13,489,1368,292,28982,197
12044,5,320,1491,182,14446,138
16796,137,2452,1424,1772,29990,680
53048,16,252,718,169,8626,83
56867,35,408,602,366,10400,42
17444,28,592,1413,491,20798,101
9480,2,165,1511,86,7262,79
65667,53,714,330,680,12462,34
58477,81,736,555,605,7793,131
64358,4,58,366,40,4553,18
7075,75,2125,1529,1572,53931,553
55121,457,5701,652,5485,36852,216
31713,11,617,1143,348,13402,269
46902,1136,21939,874,15544,152074,6395
67407,1,54,277,51,6575,3
24358,8,125,1291,93,7498,32
12084,71,2658,1491,1462,28051,1196
53185,26,421,714,260,7731,161
19719,37,1625,1372,823,39510,802
16590,11,176,1428,132,7219,44
11682,63,1054,1495,681,23732,373
52871,9657,150897,723,124019,872930,26878
49800,57,1263,812,705,24518,558
61347,57,1682,455,842,26914,840
63532,225,4617,392,3318,44780,1299
50626,9,131,792,120,8143,11
26708,129,3561,1240,1622,24620,1939
24932,9,356,1278,208,10470,148
63349,645,8227,396,6469,85227,1758
52024,14,341,753,244,12067,97
763,10,423,1596,293,13089,130
32408,546,8380,1132,5928,145583,2452
50511,36,541,794,482,9536,59
36756,154,3597,1037,791,21564,2806
66903,11,124,294,111,3570,13
56183,63,638,622,497,9030,141
1530,9,1448,1591,574,19712,874
69571,13,245,206,207,6969,38
5298,21,531,1551,234,8112,297
50026,4,35,807,35,2324,0
18210,48,930,1399,672,15390,258
46366,44,477,881,365,7093,112
7457,2,252,1524,169,9017,83
402,110,4206,1599,2440,61350,1766
108,8,442,1603,274,15715,168
69478,1,55,209,27,1803,28
41908,250,3140,936,2373,34761,767
17278,10,291,1416,240,11030,51
13269,5,242,1476,129,14600,113
28282,1075,26506,1207,18127,221153,8379
14876,47,949,1454,626,8165,323
4629,28,1830,1560,989,50414,841
4369,137,2913,1564,1732,21307,1181
45796,368,4908,887,4282,39631,626
68261,7,86,250,76,3114,10
1376,304,17344,1592,8096,192772,9248
3686,161,5911,1572,3825,25564,2086
35907,3,76,1058,61,4620,15
37511,0,56,1015,41,3591,15
32387,10,228,1133,178,7762,50
40190,4950,106189,964,66567,316619,39622
26327,53,891,1249,747,54186,144
299,20,1336,1600,320,46539,1016
25127,125771,2645514,1274,1131126,4361021,1514388
12195,238,11448,1490,7373,81218,4075
39317,42,638,976,537,13043,101
37178,15,396,1025,312,11940,84
36769,346,4816,1036,4165,39781,651
1798,73,2236,1589,1187,17655,1049
54612,8,86,669,64,4749,22
32634,173,3872,1128,2454,47333,1418
59684,14,194,515,184,24400,10
10983,300,5852,1501,4306,42903,1546
46216,24,573,883,454,12864,119
11785,0,0,1494,0,10813,0
8137,25,1049,1516,718,38016,331
50673,2,47,791,41,2959,6
48826,34,507,794,373,13975,134
55165,3,64,651,51,6725,13
45907,15,165,886,138,5054,27
32008,33,1082,1138,710,6283,372
64866,8,125,351,113,8229,12
59260,871,12359,527,8105,52938,4254
44259,190,3804,904,3358,39573,446
67067,8,150,289,131,5248,19
28230,1,18,1207,12,3073,6
43517,839,11820,731,8848,79005,2972
1478,17,492,1591,328,13825,164
69078,386,8433,222,6667,100484,1766
66949,9,138,292,138,3483,0
37002,16,329,1030,279,13907,50
3296,557,6084,1575,3711,273287,2373
49357,23,234,824,167,7369,67
60245,69,1016,495,775,16981,241
32896,54,1878,1123,1251,40248,627
5125,84,2727,1553,1755,32510,972
67180,1339,33715,283,21449,266209,12266
54017,55,728,690,607,6422,121
28664,123,11345,1199,6072,35840,5273
34393,36,989,1095,662,21439,327
59617,33,454,517,333,8726,121
63133,19,176,402,151,4797,25
19296,65,1795,1379,1167,42066,628
61415,7,134,453,132,4340,2
23968,22,587,1300,476,21716,111
25937,436,10595,1257,7582,50731,3013
19392,6,178,1378,116,8699,62
5833,216,3608,1545,2925,23605,683
35581,5840,87759,1066,61597,338480,26162
7780,29,806,1520,540,7360,266
2236,9,177,1585,123,8208,54
61810,57,647,440,553,29428,94
19199,66,1158,1381,804,8991,354
26275,63,2054,1250,1118,26634,936
40686,86,1485,957,1102,23949,383
1653,1822,59352,1590,37120,207144,22232
9930,12528,440932,1508,261416,1001761,179516
11575,176,7636,1496,2561,43923,5075
63858,20,425,383,230,6559,195
6615,79,2617,1535,1478,25946,1139
58984,40,407,539,329,8729,78
5864,30,1175,1545,786,47913,389
41620,663,10269,940,8472,89190,1797
35067,29,443,1078,356,5304,87
19970,7,173,1368,126,6357,47
15698,890,15788,1442,11325,142243,4463
35648,207,2724,1064,1921,18020,803
34426,12,281,1094,214,8584,67
11540,127,1588,1496,991,11239,597
64857,22,554,352,372,11719,182
32949,2007,37480,1123,24499,123957,12981
49006,14,280,835,237,4273,43
9935,3564,110557,1508,61498,441332,49059
18514,15,478,1393,342,13590,136
38138,220,2770,999,1798,24604,972
5366,133,10919,1550,5483,48620,5436
21961,172,4015,1334,2295,81727,1720
7501,341,18017,1524,5863,68400,12154
27853,879,16654,1215,10298,206484,6356
58615,43,407,550,317,9654,90
53493,6,53,707,46,3251,7
2929,1051,25433,1579,17074,168470,8359
39001,8,118,980,108,4971,10
8443,75,2287,1515,1571,79926,716
36390,104,2591,1044,2022,25187,569
8192,6,228,1516,169,17951,59
21073,3,127,1348,92,4803,35
15570,38,752,1444,506,18975,246
52107,33,407,750,373,5994,34
59186,24,443,532,384,10577,59
57916,14,250,574,198,4384,52
4985,66,1080,1555,731,33870,349
55668,2815,92846,637,27619,219166,65227
10329,258,7887,1505,4421,51889,3466
5032,48,2509,1554,1241,41078,1268
42138,26,544,933,414,10446,130
27756,0,1961,1217,1385,97338,576
41969,8,238,936,186,7005,52
31628,11,273,1144,167,4012,106
21380,176,5613,1343,4366,72591,1247
60664,43,290,480,254,2883,36
47098,4,52,872,36,3768,16
5588,3890,183970,1548,59045,983161,124925
13392,17,868,1474,514,11198,354
21536,154,5573,1340,3807,22264,1766
52648,989,10922,730,8573,54340,2349
34157,227,5011,1098,3735,45049,1276
9127,253,6607,1512,5069,38601,1538
26527,20,532,1245,367,51244,165
14106,19,1352,1463,781,67509,571
63629,6,82,389,65,3534,17
35116,96,2336,1077,2076,16341,260
24364,4973,132741,1291,97020,447253,35721
55363,51,833,645,787,22265,46
66488,111,1767,308,1224,31244,543
32088,87,2094,1137,1350,45181,744
13393,12,710,1474,408,27394,302
32595,210,3172,1129,2485,16294,687
6669,83,2980,1534,1885,29103,1095
29735,1758,44436,1179,27262,98591,17174
1399,3,190,1592,133,13636,57
65107,83,905,344,867,15760,38
23414,58,1164,1311,891,18967,273
41565,9,284,943,215,5704,69
9870,87,2205,1508,1365,29544,840
523,513,13628,1598,9585,102845,4043
31546,42,1968,1146,949,27828,1019
62297,69,873,424,855,6758,18
919,75,2391,1595,1409,41049,982
31578,108,1360,1145,975,16208,385
31346,131,1951,1148,1300,35670,651
29976,18,368,1174,227,8090,141
56708,92,1019,607,912,10678,107
38065,13,430,1001,363,13104,67
57387,8,235,589,186,4233,49
40379,28,583,961,539,23413,44
14066,355,8602,1464,5800,85231,2802
51510,24,347,768,260,3896,87
15647,119,5326,1443,1988,31339,3338
60568,172,2122,483,1743,17472,379
65475,2,69,336,61,2729,8
52272,10,207,745,179,12155,28
56003,21,344,628,225,7769,119
52025,21,199,753,178,3092,21
34187,210,4511,1099,2994,44746,1517
18109,10,316,1400,261,12890,55
41610,3,76,941,68,3155,8
28337,41,2014,1205,961,26318,1053
22879,107,2000,1320,1262,22299,738
6894,26,697,1532,467,28701,230
36279,151,1960,1048,1746,15885,214
13061,1186,22389,1478,13092,182414,9297
8738,5,179,1514,122,7208,57
46624,15,472,877,261,8953,211
4410,7,168,1563,102,22743,66
47845,96,1710,862,1076,14415,634
31017,47,1896,1153,1087,16067,809
52564,54,834,734,621,27708,213
8609,412,12508,1514,6984,44984,5524
55035,332,12242,654,8075,88714,4167
68515,2,54,241,52,3585,2
51623,160,1694,757,1361,18590,333
52535,33,390,735,329,11012,61
13032,18,819,1479,389,10095,430
69363,1,38,212,35,1187,3
31174,70,1680,1151,1121,26772,559
29889,198,3392,1176,2659,32408,733
57073,11,165,597,133,3902,32
53190,6,54,714,43,4344,11
53136,2,30,715,25,4422,5
48944,95,1050,837,825,17839,225
9092,9,193,1512,146,9637,47
11784,3220,172926,1494,65971,839274,106955
9871,729,14888,1508,9173,52265,5715
37219,110,2046,1023,1790,48488,256
12182,118,2512,1490,1414,26489,1098
30232,6,155,1169,71,5547,84
6764,80,1448,1533,969,12053,479
18307,16,765,1397,552,17162,213
48824,39,703,841,531,29954,172
952,1089,19998,1595,12824,84094,7174
16599,119,1719,1428,1121,24647,598
20921,95,2228,1351,1596,18221,632
4689,18,904,1559,668,19011,236
18032,13,441,1401,303,18106,138
8643,4,53,1514,41,14310,12
25601,0,113,1265,79,8897,34
48538,2039,38020,850,14298,134256,23722
9132,5,330,1512,241,39193,89
4963,18,1158,1555,698,20579,460
4328,250,4890,1564,3686,50272,1204
33698,14,282,1108,178,9835,104
64139,21,306,373,151,4792,155
49895,0,2336,810,1445,11336,891
32684,46,1370,1127,492,16861,878
12549,1872,160625,1485,65678,531326,94947
51067,39,471,780,443,13484,28
40969,103,1720,952,1578,31029,142
12503,56,2400,1486,1470,68580,930
15997,91,1260,1437,655,18956,605
58441,36,354,556,309,7761,45
26086,19,295,1254,205,9797,90
35298,80,1189,1072,868,12483,321
12161,541,12696,1490,6824,85375,5872
27320,84,1035,1227,721,10773,314
5491,462,31052,1549,10354,79466,20698
43697,115,1435,910,1093,13714,342
50352,280,3509,798,3070,29720,439
17043,12,403,1420,336,11299,67
51533,85,1000,767,858,15635,142
62614,4,138,415,114,6305,24
4281,2,131,1565,87,9424,44
11248,3,210,1499,131,17478,79
836,28940,1250708,1596,638722,2712834,611986
56922,2648,29715,601,23616,142921,6099
11744,1262,42550,1494,27683,171139,14867
37821,33,917,1007,706,20289,211
29420,127,3119,1185,2011,16562,1108
40387,24,821,961,687,28468,134
17211,16,760,1417,571,18025,189
10619,130,2622,1504,1699,24927,923
29975,330,11830,1174,7641,98858,4189
39656,192,4480,972,3933,55198,547
35776,816,14925,1062,10025,126517,4900
68937,22,559,227,470,14473,89
26175,3,322,1252,198,11526,124
50443,330,3382,796,2883,32285,499
17235,363,8209,1417,6910,85010,1299
52350,695,18500,742,7329,106107,11171
8899,19,1131,1513,688,21679,443
27910,217,5983,1213,4297,34256,1686
62964,17,265,406,237,5928,28
58376,79,1957,559,1934,43918,23
17622,1252,38437,1409,25869,154521,12568
48833,3,94,840,70,15431,24
7665,222,7422,1521,3910,69097,3512
63272,16,165,399,146,3741,19
29746,77,1827,1179,1224,20550,603
56905,127,2399,601,1980,22213,419
34116,107,1703,1100,1177,26971,526
16203,28,686,1433,444,16822,242
5645,63,2615,1547,1621,69528,994
5642,783,39506,1547,21583,206584,17923
68719,88,1242,234,964,19616,278
57382,23,324,589,288,4806,36
35686,97,1419,1064,1156,13780,263
58813,778,14414,544,9223,96965,5191
10062,21,1148,1507,763,33787,385
28941,2115,60233,1194,20009,338206,40224
53854,8,95,694,77,4832,18
12640,42,2343,1484,1140,21216,1203
40439,7,141,961,106,5974,35
61606,5,43,448,39,4428,4
50261,2,47,801,39,2753,8
52675,71,1256,730,1051,31206,205
16134,574,6847,1435,5246,77863,1601
53655,85,686,702,551,8508,135
6101,4,223,1542,161,23356,62
4244,0,101,1565,51,10325,50
298,52,2768,1600,1918,24345,850
8220,4,192,1516,130,7436,62
55571,25,185,640,165,10630,20
19412,55,1466,1377,1018,30286,448
64689,35,478,357,425,23711,53
3268,29,986,1576,695,9480,291
3018,6628,165437,1578,101656,334298,63781
35390,484,8063,1070,5629,39567,2434
12595,1585,68307,1485,40250,408311,28057
18021,1623,23372,1402,15456,117436,7916
66849,22,575,295,507,8394,68
10033,207,4340,1507,2770,31374,1570
5136,26,1352,1553,503,29670,849
39418,404,8109,975,3942,59638,4167
17623,1352,34398,1409,23048,108256,11350
37452,1296,20684,1017,17114,92171,3570
34450,23,658,1093,298,13560,360
26157,32,962,1253,543,14246,419
30784,11,376,1157,242,15810,134
52353,36,725,742,614,20423,111
39290,30,498,977,421,8830,77
18185,6,367,1399,291,19380,76
51120,6,91,778,83,12396,8
48308,2,24,855,17,1701,7
13075,5,405,1478,194,17000,211
21797,32,1566,1336,1049,20086,517
42358,48,974,930,830,8288,144
34919,24,297,1082,211,5314,86
1670,30,950,1590,714,23340,236
3562,1097,29232,1573,16755,165578,12477
26827,35,795,1237,540,17029,255
22816,2293,66623,1321,42143,389730,24480
49185,5,61,829,60,2487,1
49728,5,35,814,29,4396,6
34451,196,3104,1093,2184,17651,920
57340,99,1566,590,1399,18336,167
33459,35,767,1113,515,8107,252
9560,209,6419,1510,4023,35906,2396
27494,51,2515,1223,1627,18985,888
16976,1770,33884,1421,21187,290697,12697
37544,118,2986,1014,2820,53995,166
33067,6,57,1120,48,3980,9
33578,33,637,1111,458,4187,179
14715,1412,46892,1455,31427,473203,15465
15366,393,14550,1447,7619,72672,6931
27093,144,2013,1231,1552,30067,461
5286,13,352,1551,218,9974,134
36750,81,1387,1037,1241,13228,146
30541,24,1046,1162,804,10446,242
14373,44,1181,1460,858,21950,323
53098,21,439,716,374,28117,65
28175,6,545,1209,315,10459,230
37341,131,2712,1020,2498,41633,214
46787,127,708,875,635,9105,73
58135,11,198,567,138,3799,60
45654,78,1172,889,808,18767,364
21888,6,366,1335,281,8901,85
27137,10,252,1231,176,11899,76
58151,2140,34844,566,23202,125933,11642
55798,767,6827,634,4891,49156,1936
50431,153,2221,796,1668,10429,553
19784,3,103,1371,73,3380,30
35340,44,875,1071,710,18203,165
34491,28,944,1093,589,9443,355
60066,1986,27126,502,26467,178244,659
27701,46,1236,1218,796,8472,440
32545,283,7413,1129,4527,32573,2886
50320,823,11115,799,10068,111932,1047
54785,1713,18121,662,15982,147414,2139
57197,25,348,594,224,6828,124
7360,77,6186,1525,1533,36116,4653
40365,80,633,962,550,4118,83
37528,281,2571,1015,2026,33892,545
7564,88,1812,1523,901,24132,911
22533,10,411,1326,279,6826,132
20125,528,19334,1365,10673,150631,8661
16907,2807,66295,1422,43316,195862,22979
205,18,1526,1602,994,32394,532
48901,19,526,838,429,12370,97
29148,3971,166113,1190,84931,379390,81182
38094,753,10271,996,9286,54391,985
4625,15,406,1560,298,15821,108
60007,19,269,504,189,12760,80
64060,4,156,376,70,3595,86
39653,9,385,972,243,9106,142
29169,233,10444,1189,5717,52135,4727
54500,104,1057,673,810,11823,247
35564,2837,50632,1066,39790,355580,10842
36012,439,6670,1056,5720,83883,950
46835,26,552,875,453,10764,99
35566,18,426,1066,293,16432,133
53157,26,204,715,199,6697,5
53165,0,18,714,13,2514,5
30899,190,3777,1156,2477,52511,1300
27642,44,834,1219,570,9928,264
32876,196,3441,1124,2162,29868,1279
58149,15,194,567,166,6937,28
67021,752,10798,290,10362,100696,436
64465,57,1060,363,1046,13043,14
1325,25,755,1592,442,27481,313
28570,26,317,1201,212,6062,105
49637,32,444,817,374,4409,70
11099,451,10574,1500,5985,35920,4589
63307,5,29,398,24,1918,5
3963,343,9546,1568,5187,54750,4359
15917,919,60170,1438,16462,196576,43708
20908,10,331,1351,180,8511,151
27338,23,862,1226,495,11923,367
448,0,69,1599,45,8545,24
18290,123,3133,1397,2181,45921,952
70083,12,396,189,298,4868,98
6491,8473,147425,1537,98946,643269,48479
53926,150,1776,694,1709,19532,67
17792,9,220,1406,142,4799,78
54303,3,55,680,53,4893,2
35437,78,1189,1069,851,45005,338
40179,202,3739,965,3615,68242,124
34962,20,819,1081,570,14611,249
19186,85,1876,1382,1461,57119,415
984,62,4541,1594,2091,76381,2450
7283,39,1387,1526,983,9058,404
68404,6,94,246,86,5811,8
50575,31,301,793,259,5661,42
35355,25,582,1071,500,16514,82
3454,307,11684,1574,7875,68863,3809
36477,25,691,1042,626,21630,65
62639,813,10005,414,9473,79719,532
32685,692,22211,1128,10861,174896,11350
22367,55,2703,1329,2002,23729,701
19161,449,8746,1382,7053,111945,1693
65955,0,12,323,6,1714,6
5755,3349,75136,1546,45364,266843,29772
22627,260,7773,1324,3825,31571,3948
33968,1052,23953,1104,18698,129948,5255
18445,36,1129,1394,714,8508,415
68897,33,422,228,417,15555,5
34724,63,1392,1086,910,14132,482
7904,90,3567,1518,1533,65963,2034
61908,6,78,437,69,2998,9
17606,5,304,1410,246,22334,58
43753,566,9682,910,8856,80103,826
8401,23,556,1515,375,8365,181
23128,37,795,1315,578,11416,217
5232,47,1440,1552,923,12982,517
57812,40,361,577,232,6728,129
10966,15,843,1501,525,11117,318
14329,59,1441,1460,1068,25785,373
27264,15,830,1228,425,23614,405
51528,2,43,763,39,2559,4
25466,46,1843,1268,705,23325,1138
20794,285,8835,1354,6173,66819,2662
30492,15,298,1163,210,13718,88
20286,120,5063,1362,3976,59252,1087
4338,132,2646,1564,1918,83300,728
18606,9,466,1392,279,8069,187
69706,30,301,202,271,4590,30
9260,4,169,1512,108,11220,61
58837,12,171,544,136,3196,35
12670,560,21068,1484,12277,94767,8791
64726,32,439,356,361,6613,78
34559,1,33,1091,32,2935,1
23681,6009,232720,1306,122108,642444,110612
5608,20,539,1548,404,9445,135
36292,0,758,1048,668,26871,90
67110,8,92,287,83,6473,9
27968,9,165,1212,104,13406,61
8600,24,1077,1514,696,16334,381
30442,25,1909,1164,963,16083,946
10131,134,3771,1507,2505,29940,1266
28013,118,2702,1211,1390,26544,1312
59677,7,52,515,44,2548,8
7321,39,1091,1526,787,18877,304
40993,17,525,951,358,12455,167
43569,108,1645,912,1123,22232,522
62563,49,765,417,762,13047,3
36336,2844,35405,1046,28584,248286,6821
61960,76,857,436,773,12353,84
66859,152,2817,295,2661,46515,156
42692,11,319,924,234,8308,85
9457,238,8750,1511,3678,42046,5072
31180,796,17094,1104,13661,95827,3433
12974,3515,146450,1480,79475,424973,66975
22377,2,44,1328,35,5331,9
8264,46,2002,1516,1395,17026,607
34686,37,1123,1087,534,11685,589
29724,67,2284,1179,1576,30988,708
58219,62,575,564,501,12568,74
28475,29,616,1203,451,11493,165
32917,1365,26619,1123,21742,189748,4877
61528,15,186,450,138,8308,48
57939,174,1620,571,1294,23460,326
43103,22,307,918,231,12001,76
28060,5848,198131,1211,86256,316109,111875
19028,23,374,1384,273,14219,101
60314,1110,11917,493,9891,67610,2026
21374,656,8851,1343,5954,35806,2897
4283,1677,42937,1565,25707,201023,17230
2591,421,12187,1582,9276,125687,2911
51648,21,186,764,160,3706,26
9591,89,1995,1510,1141,15633,854
6621,118,2734,1535,1937,37524,797
8808,1499,57528,1513,43986,255474,13542
50596,0,1,792,1,1644,0
32770,14,371,1126,245,12142,126
6379,14,432,1538,319,23749,113
6361,110,3041,1539,2120,44563,921
49104,54,708,832,557,9373,151
6449,119,3370,1537,2582,95893,788
57277,65,689,592,602,11004,87
10137,37,1109,1507,742,22671,367
12904,3,145,1481,63,8017,82
18486,36,830,1394,516,20434,314
8244,112,1393,1516,986,20718,407
20363,22,680,1361,382,13307,298
81,88,3820,1604,2075,88393,1745
17498,17,264,1412,216,11359,48
37422,4679,66733,1018,47815,336006,18918
6072,50,1100,1542,750,46484,350
19829,20,933,1370,539,15875,394
12338,80,2997,1488,2059,37137,938
18566,105,1209,1392,666,15667,543
1681,63,1725,1589,1242,26939,483
12295,1689,46483,1489,28822,224553,17661
61095,1,33,463,32,3304,1
61614,1132,21822,447,16007,132333,5815
48811,30,994,841,717,16309,277
60166,29,298,498,255,8800,43
58955,27,374,539,336,8237,38
22143,0,0,1332,0,5983,0
30662,29,889,1160,481,8613,408
23707,8,198,1305,157,9467,41
21168,1309,38103,1346,24719,294294,13384
40891,9,247,953,181,7513,66
24426,349,8626,1290,5835,70612,2791
52258,607,7410,745,4953,56264,2457
25158,1004,20404,1274,13135,78772,7269
41282,47,835,947,719,15408,116
27789,4427,64664,1216,37857,284254,26807
38441,607,9445,991,8745,95616,700
33205,73,2956,1118,2024,58781,932
31009,133,5152,1154,1758,25225,3394
58770,2,34,545,31,2742,3
8184,13,832,1516,608,27988,224
8095,752,23049,1516,14758,89553,8291
35409,11,304,1070,161,8444,143
31375,509,10707,1148,4406,73662,6301
55757,18,138,635,111,6491,27
14319,419,7904,1460,4944,49396,2960
51206,25,310,776,220,6096,90
15162,26,1603,1450,1061,49816,542
26805,6,315,1238,170,7701,145
11924,554,16792,1492,10854,76927,5938
37029,1,12,1029,6,3966,6
20432,13,386,1360,243,9756,143
12818,49,1350,1482,841,18295,509
65150,31,899,343,127,4772,772
46967,253,4996,873,2657,60092,2339
24864,70,1480,1280,1029,15921,451
22641,29,502,1324,337,11494,165
6069,61,914,1542,605,8295,309
16042,7,334,1436,237,11401,97
21110,22,1016,1347,729,20659,287
37121,7592,142055,1026,101684,639748,40371
18757,62,926,1389,606,17458,320
5990,130,2886,1543,1929,59835,957
57120,2799,43656,596,22052,220664,21604
56034,43,777,627,644,20252,133
14784,0,0,1455,0,13619,0
19016,75,1980,1385,1491,58253,489
12728,72,3299,1483,1328,16595,1971
15113,6,199,1450,121,16476,78
4216,48,1090,1566,808,23842,282
54406,142,1047,677,960,30871,87
41198,8939,308325,949,205390,672824,102935
34508,21009,431892,1092,248967,1366403,182925
42586,164,4572,926,2450,82467,2122
21469,260,5649,1341,4131,118189,1518
19582,1,89,1374,73,7874,16
60663,1640,23724,479,18957,95356,4767
34332,25,549,1096,315,10945,234
36473,24,659,1042,371,25878,288
20899,32,864,1351,572,13568,292
63466,52,600,393,411,5795,189
16811,18,522,1424,198,10306,324
10445,4613,120276,1505,73909,308402,46367
9199,35,1708,1512,834,18362,874
68782,755,18185,232,17710,282579,475
39352,0,25,976,17,2864,8
59462,136,2070,523,1778,65424,292
8104,32,1675,1516,883,15692,792
33907,87,2444,1104,1837,15523,607
49070,45,938,833,629,17288,309
20817,5,122,1353,94,5349,28
20533,56,934,1358,680,21787,254
27376,14,556,1226,357,10206,199
61736,21,261,443,190,9416,71
56122,57,782,624,652,13578,130
14682,34,927,1456,511,8972,416
61368,5,50,454,31,4426,19
63073,16,164,404,123,5539,41
48840,0,45,840,44,6524,1
27065,119,3940,1232,2695,21591,1245
18187,162,3990,1399,2789,23900,1201
1941,2,130,1588,108,16591,22
59947,2,61,506,58,2472,3
38790,92,2720,983,1796,41997,924
49673,601,9137,816,7281,77442,1856
50766,1,58,789,53,2898,5
1493,7,393,1591,289,15280,104
14811,148,5355,1454,2990,49824,2365
11795,320,15291,1494,9608,102269,5683
9053,14,685,1512,472,14093,213
60196,253,3150,497,2740,29753,410
49972,1430,23710,808,18379,170219,5331
28163,8,207,1209,176,4899,31
48802,134,2000,841,830,17689,1170
13272,20217,772371,1476,314661,2198358,457710
386,187,7371,1599,4504,75601,2867
55714,9,88,636,81,4309,7
47221,26,311,721,271,8987,40
44019,82,1099,907,1009,18513,90
1686,45,2511,1589,996,40996,1515
25834,118,3944,1260,2434,15001,1510
3526,34,825,1573,644,21856,181
9508,85,1683,1510,1139,9148,544
18688,140,3466,1390,2601,69036,865
57839,320,4564,576,4301,38816,263
4853,3,104,1557,66,6563,38
23502,3,372,1309,283,11804,89
1015,9,215,1594,149,19568,66
33805,2,124,1107,79,38226,45
3896,1670,49356,1569,25552,296770,23804
61985,94,1099,435,680,25361,419
25708,990,16639,1262,10151,57838,6488
55589,51,929,639,734,12311,195
16797,7,414,1424,291,50787,123
32769,3074,105692,1126,63181,264201,42511
28878,360,10075,1195,7119,80449,2956
12114,4,234,1491,115,6421,119
21146,21,432,1347,271,8819,161
22142,8,487,1332,356,10237,131
22769,69,2047,1322,1554,22140,493
64867,33,974,351,486,15058,488
29503,6,207,1184,112,5613,95
52749,30,526,728,339,10675,187
33175,26,283,1118,203,6795,80
33653,64,1497,1109,1216,17781,281
12290,18,618,1489,370,10775,248
22608,4885,126051,1325,92976,272254,33075
9667,27,1422,1510,699,12983,723
38561,22,430,987,295,14135,135
49437,61,1013,822,649,21639,364
68982,602,13458,225,10748,71835,2710
9659,986,30122,1510,13170,102136,16952
45407,27,237,892,224,7668,13
38875,32,629,982,511,16672,118
43537,22,407,912,315,9176,92
43525,528,7069,912,5911,44374,1158
20069,495,14456,1366,7396,81394,7060
30068,5,52,1172,52,3443,0
8572,23,927,1515,564,15160,363
29196,3528,126824,1189,55888,479443,70936
55299,103,873,646,842,9750,31
822,9339,628526,1596,268492,2671237,360034
32908,40,933,1123,822,20272,111
60136,98,1247,500,903,17586,344
5720,121,5660,1546,2801,60950,2859
38749,20,487,984,406,35310,81
18857,2,109,1387,78,4642,31
52088,19,326,751,213,14493,113
63412,254,6552,395,3973,45605,2579
34820,497,9425,1084,5680,130198,3745
31405,4,114,1148,92,4735,22
19352,10,260,1379,201,23005,59
23471,263,7495,1310,3316,64901,4179
32230,276,4882,1135,3315,45628,1567
42977,326,35054,920,4183,36534,30871
63405,47,624,395,570,10192,54
21631,3603,104572,1338,53949,309000,50623
4208,13,667,1566,499,20513,168
2806,1,195,1580,106,17379,89
28594,10,253,1201,173,9602,80
7327,1464,71572,1526,29314,662169,42258
33637,66,2175,1104,1499,21111,676
21493,17,535,1340,437,12068,98
24748,151,3837,1282,1962,32336,1875
60417,5,50,490,38,3132,12
29244,31,813,1188,394,8323,419
34272,302,4156,1097,3194,44078,962
29144,70,1836,1190,1231,11784,605
30240,37,1194,1168,947,14592,247
36250,53,1606,1049,1433,18857,173
30594,447,15385,1161,9712,94614,5673
11845,248,10317,1493,5793,52982,4524
60616,3,12,482,10,2696,2
25182,93,734,1274,586,13305,148
15040,10,660,1451,365,8266,295
51969,859,9515,755,8957,67171,558
65532,92,845,334,773,13306,72
5447,10,1060,1549,584,16055,476
2589,84,2062,1582,1372,20447,690
267,5,226,1601,149,15095,77
48706,82,1085,844,929,19787,156
16138,614,17582,1435,11866,158968,5716
52323,236,3536,743,3062,35987,474
20031,47,860,1366,539,16212,321
10607,72,2280,1504,1412,25811,868
41587,190,4322,942,2379,29121,1943
17154,27,994,1418,712,45625,282
65216,1226,28354,342,25506,154647,2848
8930,10,602,1513,418,13415,184
15504,26,1017,1445,741,55543,276
34263,13,273,1096,208,3863,65
57165,16,172,595,116,5853,56
41850,6,150,938,129,8301,21
29582,92,1465,1182,975,13975,490
24342,6496,160723,1292,92145,869270,68578
2132,58,928,1586,674,19649,254
21024,52,1262,1349,1002,21008,260
33760,9,389,1107,265,7021,124
48657,117,1087,839,856,15375,231
5683,11,602,1547,287,16251,315
54669,118,2491,666,1528,18062,963
60045,11,147,503,105,8405,42
33570,7,138,1111,103,7879,35
15340,32,743,1447,560,13229,183
1090,46,1987,1594,1215,69650,772
53850,2,41,696,30,2481,11
19258,618,21673,1380,15854,189694,5819
36492,18,335,1041,252,9600,83
14280,39,1301,1461,874,25639,427
2399,16,236,1584,136,29729,100
20741,1046,41321,1355,17646,304709,23675
16371,12,275,1431,193,4935,82
27337,53,1155,1226,865,24045,290
5439,58,2101,1549,1518,61349,583
44966,234,2123,896,1703,18096,420
55455,161,2845,643,2110,28766,735
2910,91,3048,1579,2395,18423,653
57333,23,270,591,216,4539,54
68222,11,242,252,212,7442,30
58179,100,1391,561,1248,16818,143
58989,0,16885,538,13024,117744,3861
4482,936,48702,1562,27824,320450,20878
9304,97,2809,1512,1778,46051,1031
5083,39,841,1554,596,15187,245
32440,9,336,1132,205,4272,131
52391,900,12849,741,9954,72544,2895
28485,91,3229,1203,1623,15721,1606
21911,83,1185,1335,887,13610,298
179,75,3718,1602,2429,21416,1289
57216,15,162,594,131,3206,31
65145,8,120,343,105,8251,15
16771,19,820,1424,597,13616,223
34562,47,2259,1091,1834,20377,425
32459,13,270,1128,205,7984,65
52688,91,819,729,733,11631,86
40430,34,435,961,343,8105,92
30681,117,2278,1160,1635,19445,643
55846,282,4723,632,3911,37322,812
8879,964,26894,1513,16707,152196,10187
68367,305,7379,247,5541,58324,1838
45692,5508,91946,889,66256,314519,25690
56047,137,1579,626,1353,20644,226
38719,133,1328,984,1083,16081,245
47551,84,806,865,508,7364,298
26565,88,1146,1243,746,11401,400
24423,10,380,1290,241,8058,139
10733,126,4100,1503,2232,25697,1868
16546,359,15442,1428,10426,86566,5016
8964,5,140,1513,95,3801,45
18130,239,10997,1400,6389,169109,4608
13021,0,0,1479,0,13131,0
54424,62,541,676,442,5871,99
2284,49,1705,1585,890,11593,815
42568,54,757,927,486,15330,271
8453,37,896,1515,589,37097,307
23243,173,3650,1314,2561,66264,1089
56732,89,2333,606,1190,23700,1143
70033,1,42,190,41,1245,1
31281,77,1125,1149,725,32331,400
56076,14,152,626,142,6397,10
7189,281,5842,1527,3763,76531,2079
43131,26,481,917,400,8164,81
20801,7992,237873,1353,142013,1880698,95860
25409,30,1463,1269,1011,18940,452
64370,7,133,366,120,4239,13
32371,313,7162,1133,4375,81368,2787
18595,32,1140,1392,841,56136,299
32936,28,610,1123,329,6603,281
18906,12,559,1386,370,26671,189
53627,49,581,703,496,13023,85
51149,2214,27744,765,23267,114443,4477
4380,312,15600,1563,6531,47827,9069
19540,2,39,1375,29,37610,10
40050,493,9591,967,7584,105308,2007
31523,44,1468,1146,926,42945,542
50491,4303,58692,795,46508,282506,12184
58275,5336,92212,562,61856,413810,30356
6355,103,1749,1539,1104,26158,645
29677,239,7313,1181,3540,30407,3773
27444,23,1425,1224,914,21434,511
34967,34,613,1081,413,11202,200
3546,65,1811,1573,1200,14143,611
52443,17,384,739,273,20562,111
54788,15,245,662,180,3361,65
25417,32,398,1269,390,27491,8
927,2,161,1595,128,19780,33
21350,532,8831,1343,5514,110002,3317
27964,1349,29271,1212,21158,239325,8113
22746,4,208,1322,161,9834,47
57817,689,7227,577,6743,49117,484
27896,65,1916,1214,1169,20680,747
17424,6949,229803,1414,123523,822413,106280
67217,24,413,283,315,7006,98
5165,21,909,1553,569,14588,340
63885,4,88,381,88,5376,0
56950,234,11463,600,5168,60156,6295
31656,13,368,1144,233,5862,135
51779,35,485,760,356,4742,129
1895,25,604,1588,464,14185,140
20561,697,12759,1358,8917,94409,3842
25858,9,268,1259,162,15076,106
35227,391,6810,1074,5440,93571,1370
26903,666,10406,1236,5965,73198,4441
60641,25,244,480,192,6318,52
9735,28,1354,1509,633,22984,721
66916,29,629,293,519,10096,110
36102,35,825,1053,633,8122,192
23504,9,332,1309,236,8539,96
24845,56,1422,1280,1116,31315,306
29134,151,3565,1190,2356,27346,1209
54663,89,890,666,670,19312,220
29021,3,155,1192,98,5841,57
43609,4296,77605,911,59777,629095,17828
28346,11,684,1205,406,7821,278
64031,55,1071,377,893,34546,178
60330,17,367,492,289,11043,78
45980,16,231,885,164,7397,67
25891,257,4596,1258,3219,38371,1377
26886,4,341,1236,222,9273,119
3213,23,659,1576,378,10230,281
55134,164,3430,652,2609,30765,821
28575,150,3037,1201,1989,13201,1048
35396,7,127,1070,99,6775,28
23888,88,3166,1302,1302,21029,1864
54086,8,104,687,59,4197,45
30410,2,37,1165,33,4321,4
49893,12,105,810,91,7196,14
13612,11,348,1471,196,11127,152
5135,0,112009,1553,65093,557405,46916
21249,17,1360,1345,630,30193,730
23259,61,2058,1313,1739,49151,319
20301,82,1194,1362,894,13220,300
63770,15,270,385,268,4835,2
50268,4,76,800,61,6176,15
61921,41,544,437,486,6874,58
54704,220,3852,665,2435,44991,1417
26150,28,634,1253,368,11365,266
45082,2,33,894,29,2237,4
8831,89,2736,1513,1463,17850,1273
1023,68,2491,1594,1289,12552,1202
56344,8,73,618,57,6791,16
41067,3,63,950,45,4556,18
35203,61,1079,1074,919,16104,160
29725,35,1465,1179,1050,20849,415
34569,98,2237,1091,1080,27794,1157
31516,30,612,1146,283,10683,329
52889,7,132,723,119,20694,13
9179,8,436,1512,277,8359,159
35376,18,334,1062,235,13000,99
66618,48,821,303,726,14208,95
51847,112,2038,758,1815,37708,223
45911,11,383,886,192,9225,191
9157,641,31954,1512,21343,190390,10611
13675,194,10454,1470,5855,61526,4599
14609,1019,22924,1457,14756,95289,8168
39760,22,1225,971,591,13691,634
8460,90,2788,1515,1782,15509,1006
70076,16,323,189,291,9074,32
19280,0,0,1380,0,24660,0
14462,5,143,1458,116,3172,27
60156,20,361,499,351,8230,10
9081,40,713,1512,509,24589,204
12041,37,1203,1491,590,10434,613
19911,63,3617,1369,1938,48929,1679
18872,54,1415,1387,996,13041,419
19457,42,1330,1377,920,23091,410
21981,36,903,1334,596,17674,307
23796,1211,27296,1304,16265,119581,11031
2856,368,10527,1580,5816,83558,4711
4321,47,1427,1564,995,20324,432
29405,2,40,1185,32,3772,8
51473,16488,249437,769,169415,1116453,80022
11367,62,1521,1498,879,30225,642
55877,35,426,632,344,6022,82
54699,7,65,666,52,6974,13
51786,28,389,760,278,12598,111
738,143,6513,1596,4116,32745,2397
28336,13,318,1205,223,7819,95
38501,14,336,989,260,6326,76
11404,173,5299,1497,2612,42864,2687
36280,5,65,1048,65,6793,0
37248,32,732,1022,564,12871,168
3014,30,947,1578,667,9532,280
66534,34,395,306,345,8014,50
52055,9,86,752,75,5092,11
37577,1,12,1013,9,3975,3
30656,13,416,1160,246,10254,170
10937,560,51115,1501,24176,163316,26939
32498,190,2852,1130,2029,37528,823
8986,740,26760,1513,16410,110823,10350
20661,2,107,1356,91,10454,16
35499,4,408,1068,269,19655,139
9580,67,1815,1510,1120,18863,695
24296,1065,23757,1293,17207,214181,6550
23786,89,2733,1304,2061,19786,672
57426,7,275,589,246,5232,29
42824,80,1279,922,1120,27666,159
13009,19,866,1479,521,32420,345
45915,4,111,886,65,6337,46
11515,70,1775,1496,1092,29550,683
58867,1464,24483,543,18288,139661,6195
845,223,6971,1596,4388,46679,2583
8906,945,15775,1513,11200,44106,4575
33886,558,13095,1105,9453,71748,3642
6505,112,3129,1536,2207,19776,922
64960,21,413,348,363,11314,50
45659,17,210,889,187,7460,23
21304,37,1258,1344,434,16042,824
57701,26,336,581,327,7238,9
66292,9,76,313,66,3156,10
4061,376,11686,1567,7095,145267,4591
23782,13,91,1304,82,5359,9
60372,15,168,491,117,5966,51
1909,982,29905,1588,20636,171561,9269
11411,46,1975,1497,705,19191,1270
8819,106,1915,1513,1291,17293,624
6246,42,5074,1540,2699,18693,2375
20169,19,334,1364,296,19195,38
7168,30,642,1528,401,10621,241
13780,6,260,1469,164,12725,96
37254,2,104,1022,85,4182,19
26434,19,772,1246,507,16207,265
9696,4,214,1509,166,8718,48
37360,13,300,1019,229,10668,71
31804,28,896,1141,718,13179,178
6231,7,145,1540,90,20060,55
26988,195,11771,1234,4972,44003,6799
31556,52,910,1145,574,10840,336
62024,29,343,433,289,5526,54
23411,10,240,1311,172,6839,68
16167,380,6622,1434,4329,77561,2293
20792,5962,112247,1354,77853,459602,34394
21999,7,192,1333,157,39337,35
40409,7,157,961,123,7258,34
18175,83,799,1399,656,9349,143
44397,44,679,903,417,27266,262
30250,5089,89256,1168,71077,457735,18179
30392,28,736,1165,636,12672,100
38811,121,5307,982,3588,43218,1719
28022,3205,131012,1211,65389,401447,65623
29461,4,132,1184,91,6622,41
17413,78,2536,1414,1744,32094,792
30511,6,378,1163,241,9023,137
61070,286,4157,464,3767,43050,390
9999,142,7650,1507,4461,60418,3189
51134,41,638,778,506,6050,132
60098,109,875,498,753,11890,122
13429,9396,174329,1473,104318,458628,70011
55116,545,9670,652,5398,76617,4272
55580,54,394,639,311,5800,83
53710,19,211,700,190,6756,21
22918,32,625,1319,529,17279,96
56521,73,867,612,686,13354,181
16627,23,1142,1427,744,17029,398
14056,22,906,1464,589,27157,317
27662,46,1027,1219,770,10508,257
5045,168,8395,1554,5141,56750,3254
38389,1863,29649,992,23872,86582,5777
39995,38,864,968,614,6615,250
20965,29,312,1350,268,19423,44
46813,121,2424,875,1130,19724,1294
15925,16,264,1438,155,8048,109
49566,722,12622,819,9592,97564,3030
9757,18,693,1509,491,15126,202
23027,237,6090,1317,4331,152702,1759
30690,65,2794,1159,1659,16017,1135
2909,641,10451,1579,9278,55323,1173
25867,104,2019,1259,1397,23894,622
4844,6,182,1557,136,10429,46
33322,61,1185,1116,596,14070,589
66720,17,277,300,249,10190,28
6940,232,3718,1531,2564,49922,1154
41958,3,119,936,86,6505,33
43167,62,1198,916,1037,12817,161
39840,7,269,970,158,10985,111
40736,166,3632,956,983,14859,2649
14544,227,11466,1457,6399,66543,5067
17744,9,415,1407,314,13607,101
48666,105,1448,845,1084,56127,364
811,12,473,1596,321,26757,152
52044,483,7253,752,5046,88296,2207
28815,18,577,1197,344,6273,233
6733,16,905,1534,656,15542,249
1843,30,951,1588,654,19997,297
65372,251,2556,335,2249,17800,307
17791,4,105,1406,73,4274,32
35864,22,397,1059,243,13532,154
44252,39,675,904,482,9796,193
41893,40,647,937,528,28216,119
36179,1,20,1051,16,2947,4
24074,137,3889,1298,2941,41268,948
52834,259,2406,725,2269,20226,137
14812,74,1115,1454,915,15852,200
38219,76,1386,996,675,19439,711
16550,18,695,1428,409,10414,286
12374,13,457,1488,221,5495,236
24878,4,156,1280,111,10958,45
58911,22,293,541,228,5658,65
55622,25,380,638,361,8865,19
9654,95,2586,1510,1586,39747,1000
7837,94,1537,1519,1196,37603,341
29704,16,605,1180,355,7044,250
3049,64,1405,1578,884,19032,521
29808,46,1748,1177,1225,25358,523
50739,8,104,789,102,6883,2
27592,181,5100,1220,2212,31257,2888
44623,1831,26012,901,21968,137883,4044
27608,29,847,1220,548,22582,299
61350,72,1828,454,1275,46557,553
29338,3,88,1186,64,7423,24
26167,10,481,1253,205,6491,276
63478,8524,196434,386,196002,720397,432
63755,18,204,386,161,4068,43
13353,166,5605,1474,3231,48825,2374
9725,1,182,1509,59,8269,123
32848,35,1522,1124,949,37265,573
52327,57,618,743,520,7397,98
54319,24,161,678,127,9275,34
32435,5,445,1132,245,9115,200
15395,49,856,1446,616,13785,240
39275,0,49,977,33,9510,16
51133,33,670,778,588,4732,82
5873,319,7548,1545,4503,43503,3045
11306,70,2629,1498,1065,18414,1564
7677,10,663,1521,486,12189,177
48227,2199,47349,857,33164,238854,14185
18262,5,226,1398,188,11409,38
31616,65,2740,1145,1772,14967,968
63910,19,256,381,229,6197,27
54277,162,3352,681,2433,48996,919
52836,31,181,725,157,21083,24
13000,26,3326,1479,1816,38340,1510
4741,183,4523,1558,1833,27668,2690
51600,32,451,765,356,8047,95
51633,8848,207294,764,99445,999929,107849
26638,344,7464,1241,4466,58626,2998
18738,3318,101996,1389,48229,268681,53767
60153,76,1475,499,1076,22239,399
57536,30,312,586,233,10093,79
32977,318,9082,1122,5218,55521,3864
32748,31,882,1126,567,10084,315
18760,42,1210,1389,871,38401,339
21771,61,1745,1337,1143,43755,602
58838,52,539,544,474,9660,65
32286,39,1431,1134,795,6924,636
37019,19,468,1029,414,9624,54
10886,42467,1360559,1501,697289,2560339,663270
14888,32,712,1454,507,16005,205
29151,20,648,1190,399,14555,249
62404,11,106,421,88,3544,18
56340,2,47,618,45,3113,2
66005,10,163,322,121,3642,42
12951,62589,2284568,1480,984140,7209455,1300428
8416,3,145,1515,99,4074,46
18201,0,160,1399,136,8922,24
22643,120,1799,1324,1313,40396,486
52621,38,602,732,367,15006,235
290,882,36343,1600,19407,89572,16936
34206,62,868,1098,637,19089,231
50256,78,1009,801,884,16321,125
50434,52,688,796,546,9366,142
61209,138,1325,459,1034,11437,291
59188,22,383,533,269,4725,114
70228,51,655,184,620,5764,35
54009,409,4490,691,4416,76244,74
19628,88,2199,1374,1331,24363,868
36474,3,94,1042,59,8611,35
31143,193,3433,1152,2145,17716,1288
1823,47,889,1588,623,31848,266
34556,10,313,1091,184,10896,129
12891,147,8238,1481,3947,86686,4291
2086,22,1034,1586,796,54532,238
2642,60,2589,1582,1269,32213,1320
18096,1162,22829,1401,14173,88038,8656
26140,86,2129,1253,1194,13609,935
57643,96,1298,567,1118,20740,180
28206,10,268,1208,157,9823,111
57240,18,275,593,237,7797,38
22418,14,391,1328,332,12572,59
25176,388,7137,1274,6552,77341,585
40218,487,7138,964,6088,46328,1050
13222,7,255,1477,89,7042,166
54038,46,633,690,453,22691,180
9428,23,2509,1511,1164,20340,1345
3067,1212,34058,1578,23754,91014,10304
42754,612,6409,923,4973,85082,1436
24091,24,1088,1297,785,14272,303
24809,0,52,1281,47,3909,5
8794,18,488,1514,344,13068,144
42620,165,2805,925,2078,28334,727
23309,101,1347,1313,890,16458,457
7570,6,85,1523,60,4009,25
27113,8,327,1231,170,8270,157
9544,608,14104,1510,7667,49316,6437
18111,20,749,1400,482,13031,267
69702,54,1117,202,759,11232,358
61907,18,309,437,210,7547,99
22930,1574,52369,1319,33233,248878,19136
36027,2,18,1055,16,1599,2
59451,9477,244573,514,132263,1080371,112310
9122,17,502,1512,364,15455,138
28777,4,213,1197,146,10367,67
27448,45,1972,1224,1101,14026,871
8406,16,723,1515,440,18323,283
30095,149,2025,1171,1363,17200,662
24300,7,318,1293,219,12449,99
26078,15,411,1254,214,9626,197
65501,104,1411,335,1327,21808,84
18341,143,3889,1397,3036,65823,853
36933,139,2606,1032,2153,37420,453
54174,168,2238,685,1720,24524,518
30677,14,293,1160,200,3344,93
48147,8,134,858,110,8049,24
59886,31,442,508,349,13196,93
26126,6201,173827,1253,86842,429534,86985
17437,85,1690,1413,1062,15388,628
20962,85,4282,1350,2143,34672,2139
7603,15,338,1522,253,8078,85
36006,10716,247580,1056,170345,1165791,77235
10075,36,1409,1507,1071,15816,338
51639,61,610,764,501,9456,109
49528,138,2730,820,2125,37366,605
37241,16,386,1023,325,12281,61
16382,71,1770,1431,1202,14320,568
9395,0,166,1511,113,9338,53
2698,364,9224,1581,5785,140138,3439
21116,14,266,1347,216,13840,50
26491,2520,41095,1246,26823,116327,14272
25437,4,323,1268,218,9180,105
69114,19,458,221,385,6018,73
17274,3,152,1416,111,15907,41
27462,226,7818,1224,2920,74392,4898
69322,3,120,214,116,5417,4
64543,3,69,361,63,4870,6
18971,199,8197,1385,3881,132402,4316
51313,48,711,773,561,13984,150
38170,68,2413,998,1925,17346,488
26528,75,1509,1244,590,17091,919
18348,2,205,1396,155,7044,50
36204,4,138,1050,122,5114,16
14957,3,435,1453,322,22226,113
17040,972,22404,1420,15790,212916,6614
54040,29,271,689,240,9912,31
5694,2,323,1547,210,21764,113
2092,607,24299,1586,15828,142140,8471
12970,30,1078,1480,567,15999,511
273,124,3018,1600,1249,12972,1769
57215,9,71,594,68,2040,3
29275,316,7078,1187,4760,67681,2318
52019,25006,312079,737,223403,1116713,88676
14077,63,1953,1464,1419,23719,534
59219,576,11239,531,6893,77969,4346
27449,442,27639,1224,13320,52716,14319
14793,273,14670,1455,8212,55312,6458
11763,12,713,1494,360,5516,353
8295,121,2975,1516,1720,21666,1255
8048,305,6204,1517,3868,31588,2336
9872,69,1840,1508,1239,33567,601
33387,1,79,1114,67,4810,12
53918,329,2788,694,1933,20160,855
8429,62170,2072372,1515,605727,6533918,1466645
56161,552,4528,623,3818,50661,710
435,44,1921,1599,1034,33959,887
20750,35,1049,1354,735,17162,314
31542,23,520,1146,280,13387,240
66244,6,86,314,80,5152,6
12643,354,8033,1484,5266,43755,2767
855,76,3918,1595,2717,36017,1201
18755,50,807,1389,545,15077,262
1594,23,417,1590,307,12329,110
8320,321,10881,1516,6674,42097,4207
15230,144,3916,1449,2503,64503,1413
34149,81,998,1100,799,33778,199
66836,257,3459,296,3318,48067,141
25300,2625,43700,1271,31831,126585,11869
18316,0,0,1397,0,6620,0
60714,5,89,478,73,4594,16
18043,583,13818,1401,7586,131509,6232
54441,95,900,675,710,9136,190
25240,1,151,1272,79,10529,72
15956,303,9365,1438,4193,84416,5172
5981,13,319,1543,217,9915,102
11119,1516,27754,1500,17060,82840,10694
20516,77,3861,1358,2742,48996,1119
49046,157,2038,834,1278,31922,760
54190,10,147,685,106,3588,41
21506,42,1157,1340,843,17108,314
60430,1428,22078,487,18990,187374,3088
4868,211,7963,1557,5311,80206,2652
49455,80,922,822,732,17920,190
17860,24,1081,1405,816,13715,265
13804,450,6258,1468,4456,67433,1802
38465,3200,44408,989,34231,182945,10177
68609,42,442,238,422,11532,20
22249,31,756,1330,500,6840,256
30256,65,1952,1168,1474,19635,478
46916,289,3738,874,2673,33319,1065
60690,7,93,478,87,10850,6
55666,23,557,637,436,12826,121
54614,155,2225,669,1674,28748,551
6240,8,313,1540,210,27353,103
6853,14,685,1532,455,32930,230
3894,340,12921,1569,7160,44575,5761
34811,4,155,1084,99,9468,56
27308,723,24605,1227,11883,171399,12722
9680,42,1644,1510,1019,15577,625
39930,30,608,969,461,8541,147
52767,52,574,727,456,25026,118
1210,20,923,1593,695,29328,228
14695,149,3116,1456,2227,53518,889
14693,992,18284,1456,14124,129316,4160
19618,3769,118133,1374,39385,346314,78748
38407,129,1655,991,1580,28266,75
64332,7,79,367,71,3800,8
3357,14,329,1575,221,13600,108
18449,567,9685,1394,6158,76898,3527
19644,529,11588,1374,8423,119418,3165
134,972,54787,1603,36789,721516,17998
65322,31,364,339,308,11361,56
2769,29,1200,1581,878,39024,322
28122,89,2470,1210,1587,53715,883
6061,40,2443,1542,1433,56552,1010
17773,97,3493,1406,2022,30771,1471
56146,19,236,623,214,8070,22
5265,919,21364,1551,12973,88346,8391
57001,3,59,599,55,2587,4
22809,0,0,1321,0,4994,0
54428,14,172,676,146,3852,26
15394,144,5623,1447,3789,49737,1834
39108,12,451,979,324,5848,127
66463,81,944,308,898,17177,46
12402,272,15610,1487,7990,105162,7620
27450,202,4703,1224,2964,32173,1739
48756,7,52,843,44,4211,8
51764,65,594,761,517,7246,77
4614,6,194,1560,136,18740,58
1426,39,702,1591,499,26130,203
8277,314,5275,1516,3320,21641,1955
27594,4409,140946,1220,72726,713754,68220
45003,6,178,896,123,9553,55
13941,14,969,1466,562,38507,407
54013,38,348,690,264,11366,84
1502,8,361,1591,269,10337,92
35327,14349,397893,1071,256557,958230,141336
21432,2200,77900,1342,38822,419130,39078
63846,3,68,383,54,8401,14
21505,48,1284,1340,880,14884,404
28781,199,3200,1197,1967,23355,1233
56714,8,89,607,71,8619,18
59125,4,50,534,42,3767,8
10689,10,796,1503,514,14652,282
22439,48,1534,1328,703,24638,831
54018,14,91,690,81,6009,10
29595,0,0,1182,0,7767,0
18337,18,464,1397,330,8707,134
33022,60,1703,1121,1070,12060,633
24220,28,1322,1295,936,27721,386
34537,37,475,1092,313,7159,162
7003,16,637,1530,403,27435,234
15735,102,2831,1441,1811,37968,1020
8674,71,3267,1514,2172,24716,1095
6014,75,4296,1543,3365,29930,931
54840,27,437,660,344,3903,93
60885,22,454,471,392,13685,62
62395,10,149,421,142,2988,7
13220,248,2910,1477,2030,47112,880
13863,301,14884,1467,8343,102004,6541
59884,8,77,508,74,4915,3
11943,1,358,1492,122,8937,236
14482,50,963,1458,652,40429,311
58557,62,731,552,645,9194,86
15826,784,42513,1440,23044,198342,19469
48029,50,688,860,508,10578,180
28051,25,1216,1211,474,17219,742
37724,205,5614,1009,3905,87052,1709
13673,20,429,1470,281,6243,148
959,15,806,1595,467,21114,339
59086,34,804,535,597,14294,207
33858,5,283,1106,208,7420,75
3139,10,610,1577,388,18934,222
38230,3,173,997,128,8615,45
33071,416,13476,1120,7686,145996,5790
5965,752,19421,1543,11261,94191,8160
57945,16,213,573,143,5976,70
11108,306,15937,1500,8652,71836,7285
36124,1177,19390,1053,11968,99473,7422
34454,68,2484,1093,980,34514,1504
27766,21,461,1217,322,6185,139
3862,11,655,1569,242,10776,413
29613,6,169,1182,115,4188,54
44185,8,266,905,230,8187,36
5084,2096,64088,1554,42061,182384,22027
25341,229,11610,1270,6662,77137,4948
12004,6,445,1492,222,3997,223
48790,17,203,842,175,3154,28
16014,899,29530,1436,20441,222057,9089
6896,25,1492,1532,619,20927,873
34716,7,440,1086,280,8652,160
27346,79,1873,1226,1027,26786,846
15762,17,758,1441,487,19738,271
22681,34,1009,1323,763,24634,246
42352,28,355,931,194,7401,161
11680,0,0,1495,0,8552,0
62800,2286,26761,410,23791,88280,2970
25207,61,2968,1273,2094,44674,874
902,28,951,1595,688,34985,263
25162,356,8051,1274,6439,143095,1612
47811,53,751,862,582,8107,169
18935,48,1437,1386,975,19403,462
25573,2,71,1266,61,11650,10
366,17,1207,1600,638,31525,569
53083,550,17958,717,11175,81821,6783
54590,10,110,670,88,3199,22
50165,0,378,803,185,4632,193
11593,169,7128,1496,4217,21096,2911
34265,25,704,1097,518,11148,186
4251,27,488,1565,380,10725,108
30335,15,309,1166,286,38475,23
58289,23,268,561,235,14788,33
51233,74,867,775,430,16184,437
33827,5,121,1106,92,14378,29
143,6,297,1603,192,15182,105
60234,41,558,496,527,8951,31
24541,24,805,1287,555,9626,250
9838,92,3976,1509,1787,22360,2189
26210,27,720,1252,421,10959,299
8334,44,999,1516,669,36548,330
17118,3,204,1419,152,15897,52
2250,167,4399,1585,2887,47020,1512
53923,8,66,694,58,2890,8
30325,9,351,1167,226,15683,125
28274,41,674,1207,536,10838,138
3804,172,4145,1570,2928,64657,1217
21269,553,22489,1345,11791,125951,10698
22884,129,7095,1320,4931,71285,2164
67299,20,280,280,280,10362,0
62518,5,218,417,73,5726,145
56690,25,280,608,226,6495,54
25508,421,8198,1267,6304,38160,1894
62949,1,145,407,53,3533,92
35140,32,1067,1076,899,37160,168
42700,140,3019,924,1923,32755,1096
6703,7518,203468,1534,107838,559917,95630
30743,77,2948,1158,1860,36349,1088
31671,44,1367,1144,949,14813,418
17096,212,3659,1419,2762,62667,897
22887,14,534,1319,428,22209,106
43401,139,3004,914,2742,66448,262
67809,6,177,264,129,17725,48
28054,29,840,1211,528,7144,312
12241,59,4189,1489,1833,36885,2356
15024,1963,49564,1452,28424,266332,21140
11374,21,1505,1498,835,9716,670
48454,15,204,853,154,7226,50
65130,31,254,343,245,3873,9
34239,168,3318,1097,2175,28964,1143
32368,13,304,1133,205,5616,99
35939,70,1252,1057,996,10179,256
844,34,1059,1596,749,25533,310
65434,67,1051,336,872,15368,179
5236,25,2403,1552,1319,29034,1084
36723,7,163,1037,160,10097,3
17516,1128,33569,1411,21145,167527,12424
40272,651,8780,963,7368,69304,1412
25024,580,15099,1276,10515,118852,4584
30705,137,4631,1159,3018,29216,1613
31958,130,1998,1139,1293,26162,705
44517,75,1164,901,963,13357,201
41402,39,331,946,301,8880,30
25130,17,554,1274,462,28526,92
62295,2,64,285,57,2709,7
52141,2,112,749,67,2635,45
38140,29,551,999,427,6247,124
50595,2427,57142,792,38770,143310,18372
37786,6,168,1008,90,2413,78
63286,17,225,398,216,9406,9
22813,8,237,1321,201,14186,36
49410,344,6685,823,5386,49561,1299
11781,1400,113488,1494,37969,314460,75519
12305,47,1362,1489,599,13423,763
54592,217,2191,669,1699,24181,492
38279,24,485,995,318,13047,167
38643,19,111,985,101,6479,10
31564,142,3257,1146,2398,12607,859
16974,111,4538,1421,2413,28895,2125
51085,2,34,780,26,4857,8
2104,12,652,1586,498,30583,154
1860,19,923,1588,710,24548,213
60179,342,5355,497,5344,89370,11
9596,96,2644,1510,1579,14017,1065
49870,22,1066,811,644,7313,422
22707,598,20553,1323,8164,47103,12389
25085,17,403,1275,341,13611,62
8958,165,5641,1513,3231,34259,2410
51984,14,211,755,180,12357,31
54425,306,6204,676,4712,55674,1492
26634,247,4976,1241,3621,59131,1355
64905,4463,90027,350,87534,548438,2493
59399,8164,215894,524,116415,791170,99479
19746,1,35,1372,29,2366,6
19253,210,8221,1380,5483,105284,2738
8661,15,558,1514,238,8968,320
10756,137,3583,1502,2200,37953,1383
51495,362,3476,765,2586,40410,890
25309,435,11972,1271,8709,160902,3263
68811,501,11652,230,11008,100328,644
29660,44,655,1181,509,13023,146
27418,8279,169391,1224,106550,530880,62841
52617,38,411,732,289,14056,122
31154,33,1508,1151,830,22795,678
62222,3,115,427,114,2151,1
33128,115,2032,1119,1381,19766,651
28761,1263,31551,1198,18732,291199,12819
3471,900,32646,1574,17737,247634,14909
21407,14,723,1342,501,26946,222
18419,84,2535,1395,1997,46044,538
58627,176,1186,550,1010,9502,176
25600,25,514,1265,307,3982,207
57144,6,93,596,82,5997,11
8963,1,139,1513,93,2911,46
23082,5,235,1316,167,16262,68
17386,6,263,1414,192,8649,71
17114,2,224,1419,184,35695,40
20691,518,18844,1355,12758,79449,6086
60638,15,145,480,145,7381,0
13219,238,5784,1477,4045,35786,1739
8263,84,1093,1516,761,8156,332
45921,47,832,886,593,10532,239
31555,111,4526,1146,2368,40554,2158
19267,123,6307,1380,3863,63725,2444
41479,11,247,944,205,9241,42
42470,1798,34752,928,31636,298440,3116
2003,67,4129,1587,2469,47543,1660
472,697,20732,1599,13541,134896,7191
18890,281,8388,1387,5205,37590,3183
61668,20,125,446,116,7513,9
64341,2,19,367,17,1432,2
16831,364,6711,1424,4089,47829,2622
22475,8,311,1327,272,8682,39
34735,2,182,1086,110,7952,72
13474,9,755,1473,524,12844,231
40796,4,107,955,50,8299,57
25936,3,181,1257,116,10451,65
32880,90,1865,1124,1340,15021,525
45756,91,2469,888,788,11921,1681
47704,249,3289,863,2914,39349,375
34067,159,2713,1101,2099,39491,614
67787,2,11,265,8,2489,3
56496,2,28,613,27,6899,1
51166,953,11759,777,9153,43915,2606
33004,30,667,1121,439,12055,228
36481,254,3577,1042,2407,59444,1170
36520,982,18849,1040,15696,147917,3153
37492,38,916,1016,697,26159,219
41229,29,326,948,282,9592,44
148,1365,75636,1602,45383,357560,30253
24679,64,3493,1284,1574,33559,1919
52366,22,352,742,320,5860,32
5789,35,580,1546,468,12773,112
56156,5,82,623,72,4448,10
27435,24,943,1224,690,11909,253
12981,170,7835,1480,4018,101234,3817
30918,744,15590,1155,9796,146517,5794
32901,87,1754,1124,1360,23361,394
27383,3,218,1225,123,7771,95
45559,197,2744,890,2451,36377,293
39451,125,2571,975,2193,31593,378
5312,16845,348541,1551,160549,747134,187992
4999,8,212,1555,162,9841,50
60791,11,141,475,86,4760,55
41016,32,356,951,258,3576,98
61958,990,20487,434,16724,159827,3763
34291,45,1310,1097,946,10628,364
60331,145,1176,492,1032,34425,144
28433,13,169,1204,128,2914,41
50686,64,1193,790,1049,24222,144
66128,95,1287,318,956,15401,331
582,99,4845,1598,2568,123451,2277
12907,26,1493,1481,661,18834,832
50976,97,1966,783,1709,11921,257
67565,0,30,272,23,3368,7
42390,12,198,930,138,10113,60
17529,34,1360,1411,991,24485,369
26979,51,1059,1234,592,9475,467
57428,65,1529,589,1018,28859,511
9255,19,885,1512,572,14957,313
24435,41,1038,1290,692,24836,346
38089,1,14,1000,13,8692,1
57016,14,167,599,136,6303,31
10702,46,1655,1503,1089,27892,566
18596,264,4821,1392,3573,63048,1248
37665,3493,62019,1011,44256,436662,17763
50661,441,8154,791,6298,78611,1856
27541,24,668,1221,403,9705,265
12972,13,1018,1480,474,31205,544
68862,20,647,229,294,4536,353
15977,27,974,1437,696,6532,278
33371,46,629,1115,381,8568,248
9587,96,4368,1510,2452,36686,1916
13027,28,1247,1479,610,14970,637
9663,3,227,1510,144,8242,83
51396,61,894,771,781,29711,113
25749,269,15529,1261,4559,75917,10970
39196,397,5304,978,3501,42549,1803
47881,5,91,862,80,11377,11
8625,8,258,1514,172,4259,86
50318,10,250,799,206,3427,44
25133,11,198,1274,125,5411,73
52381,12,178,741,130,17141,48
34654,25,1160,1088,717,18426,443
18058,9,789,1401,325,12487,464
49644,61,707,817,646,15978,61
22982,14,813,1318,434,28466,379
41297,444,7342,947,7101,82504,241
55364,2080,51518,645,39682,241726,11836
59037,87,820,537,682,7575,138
667,6042,311887,1597,164826,1471944,147061
9273,11,468,1512,232,6805,236
52493,4,79,737,49,5402,30
15556,8,783,1444,581,67683,202
32966,31,653,1122,442,7323,211
46310,5,70,882,46,4300,24
7844,1,136,1519,109,12364,27
58033,55,713,570,584,12995,129
61993,8,92,434,79,5795,13
20198,16,370,1364,258,15818,112
32223,30,475,1135,319,10590,156
67914,9,157,261,98,5246,59
23444,101,5970,1310,3329,35453,2641
42915,28,738,920,557,20565,181
27390,79,3171,1225,1687,63814,1484
47803,57,1050,862,735,21743,315
56279,3550,54211,619,45412,203939,8799
65398,27,212,337,205,6198,7
46546,40,1072,878,769,23992,303
63417,27,861,395,770,13021,91
40108,623,11378,966,8510,116674,2868
58886,86,1278,542,1030,19667,248
29630,66,1602,1181,968,52500,634
21605,73,1992,1339,1126,34947,866
55590,654,7559,636,6948,57276,611
7600,389,10924,1522,6693,61033,4231
20575,42,1801,1357,1301,34294,500
16977,1763,58224,1421,36279,424818,21945
50308,29,475,800,295,5607,180
57198,2100,30231,594,27003,164102,3228
58869,33,541,542,438,9900,103
4930,14,556,1556,375,16283,181
46088,672,21554,884,8332,115795,13222
67547,93,1327,273,1195,12840,132
44927,12,149,897,129,6702,20
7701,20,667,1521,465,28013,202
32156,3008,48098,1136,38357,145620,9741
58952,13,90,540,86,4552,4
60731,23,263,477,187,4751,76
17583,68,947,1410,777,37659,170
12029,27,915,1491,518,13933,397
29400,13,651,1185,302,14706,349
66221,31,511,315,461,6289,50
56599,529,11949,610,9079,51523,2870
11331,28,1778,1498,668,19446,1110
21954,4,267,1334,156,6124,111
3588,27,1137,1573,470,28845,667
50032,7587,119584,744,93536,578666,26048
5138,473,27724,1553,10333,155867,17391
4498,39,1494,1562,669,19520,825
58373,186,2377,559,1957,25060,420
51472,13920,173886,769,100167,606849,73719
12502,207,5907,1486,3428,43834,2479
36010,5,316,1056,227,15167,89
19053,54,1075,1384,556,25582,519
41052,2715,44923,951,30296,158539,14627
14411,1,126,1459,71,5027,55
23579,66,921,1308,686,30320,235
52529,76,829,735,595,13443,234
29353,193,4980,1186,3005,31051,1975
8745,38,1313,1514,883,17820,430
34733,303,5319,1086,4201,32898,1118
59123,10,128,534,111,3677,17
60469,5,43,487,41,5956,2
38895,2,74,979,71,22665,3
1065,11,460,1594,296,7291,164
64863,20,437,351,262,4940,175
33282,46,680,1116,439,13699,241
15668,33,2024,1442,1172,17122,852
17216,34,2091,1417,1168,31080,923
32130,1,38,1137,19,8637,19
13253,28,790,1476,551,11307,239
39958,9,118,968,114,4306,4
6373,68,912,1539,712,15319,200
39534,6,167,974,124,2614,43
33078,154,5208,1120,2724,53592,2484
36800,39,533,1036,435,7613,98
27958,58,2307,1212,1375,23896,932
56249,161,5505,621,2945,39591,2560
10804,266,5223,1502,3095,19301,2128
5724,354,13081,1546,6627,62684,6454
29018,150,2816,1192,1630,16733,1186
16943,87,2671,1422,1406,21364,1265
3064,51,3052,1578,2175,36049,877
2208,65,2382,1585,1767,36812,615
20554,0,0,1358,0,7242,0
35236,90,1289,1074,899,13687,390
23098,141,3123,1316,2010,63443,1113
34447,18,994,1092,666,9110,328
70575,7,124,172,111,2871,13
58494,29,381,554,332,13923,49
3897,10,622,1569,451,14010,171
8452,245,5618,1515,3212,49804,2406
14177,7,145,1463,108,5117,37
51841,123,1517,759,1356,17630,161
29375,4131,83415,1186,42530,372417,40885
53887,138,1994,694,1679,14865,315
43581,24,440,911,250,6254,190
53407,143,1665,709,1566,22666,99
36396,383,6200,1044,4958,44168,1242
12074,200,3802,1491,2226,22440,1576
35419,44,496,1069,338,5230,158
16737,395,5887,1425,4476,23676,1411
38967,6,108,981,76,4572,32
26738,61,2410,1239,1360,11394,1050
21096,11,604,1348,395,11058,209
52340,709,10079,742,9594,82162,485
32605,22,841,1129,456,19096,385
26546,23,430,1244,229,10351,201
36248,26,267,1049,194,9271,73
40326,8,188,963,138,7894,50
10636,124,5093,1503,3584,37923,1509
28236,726,21096,1207,14992,140039,6104
46081,381,5832,876,5033,54086,799
15317,2411,50594,1448,34852,229373,15742
62099,1869,35479,430,25336,235668,10143
57255,1009,15414,593,14456,97561,958
13276,27,297,1476,155,17875,142
35107,121,2492,1077,2022,21570,470
8176,58,2050,1516,1374,38120,676
39939,155,2096,969,1834,26209,262
49086,11,155,832,115,5573,40
11970,105,2056,1492,1326,17056,730
34584,56,859,1091,641,13714,218
33229,148,2603,1117,2094,20845,509
66490,9,214,308,202,12566,12
22572,347,20194,1325,5627,48319,14567
59937,435,23096,506,7506,72771,15590
31077,5,269,1152,141,6222,128
17887,47,840,1404,700,15881,140
35754,14,576,1062,438,11531,138
41347,30,677,946,571,7265,106
29995,525,13897,1173,10496,175464,3401
56450,4,66,615,57,3543,9
11245,1,166,1499,83,11656,83
55263,173,5881,648,3701,45169,2180
52630,1841,22874,732,18373,190440,4501
54147,34,312,686,252,9145,60
17833,18,646,1405,469,13307,177
65521,35,980,335,612,11555,368
1419,160,5660,1591,3162,170826,2498
9165,46,1202,1512,853,13198,349
49284,2,66,826,58,7578,8
60504,16,276,486,240,8540,36
51539,97,1139,765,986,23545,153
17888,4,109,1404,77,4252,32
17723,18590,481623,1407,274510,1201694,207113
30630,185,3454,1161,2689,34013,765
30862,52,1223,1156,838,27148,385
38343,16,303,993,255,25347,48
47541,12,286,866,219,5926,67
37391,9,217,1018,186,11913,31
31910,160,2906,1140,1899,61289,1007
42372,86,1705,930,1152,25090,553
4466,129,2944,1563,1958,56605,986
29099,20,1135,1191,475,15670,660
60725,23,328,477,298,4080,30
23353,2325,38244,1312,27087,153962,11157
67667,14,170,269,135,5381,35
17087,176,2484,1419,1552,46866,932
10939,65,5530,1501,3360,32064,2170
17496,31,808,1412,431,7238,377
58450,1487,15553,556,14204,70675,1349
65307,33,520,340,487,24672,33
19953,10,554,1368,405,10418,149
27200,10,457,1229,247,14754,210
19943,2780,42965,1368,28293,150539,14672
19710,187,4886,1372,2475,50629,2411
29874,76,1816,1176,1155,70786,661
36819,8,247,1035,164,8522,83
17238,4,87,1417,68,6176,19
20732,27,350,1355,266,13015,84
57492,12,194,587,138,7185,56
62068,125,1099,432,940,18284,159
21072,43,1706,1348,1252,31092,454
632,28,2159,1597,901,15805,1258
23540,23,357,1309,299,31979,58
9589,13,306,1510,210,7571,96
63623,2565,63047,390,42593,296788,20454
18048,4,254,1401,122,7906,132
29040,393,12149,1192,4606,78357,7543
70403,86,1079,178,989,9610,90
16242,13,1462,1433,820,20696,642
33367,485,12464,1115,9003,74643,3461
37335,188,2316,1020,1988,14680,328
11846,38,2880,1493,1324,22196,1556
47469,131,1939,867,1629,20410,310
40627,5,219,958,117,13000,102
70145,1,21,187,21,1688,0
60944,56,672,469,422,9877,250
51755,383,5389,761,5160,77944,229
13820,57,771,1468,471,10891,300
2023,6,282,1587,186,21223,96
49860,504,6101,811,5245,44556,856
50895,11,378,785,176,10221,202
20806,12,790,1353,613,8419,177
54000,41,834,691,706,13926,128
56773,33,377,605,354,9115,23
10003,911,19546,1507,14565,92781,4981
62519,20,293,418,252,5542,41
61803,19,291,441,222,6340,69
3706,109,3255,1571,1799,32734,1456
16712,9469,467187,1426,136660,1466766,330527
8567,5,194,1515,148,8700,46
9743,1,79,1509,31,7011,48
58827,4,65,544,47,3719,18
18684,43,2846,1390,1388,44128,1458
8129,37,1173,1516,483,10356,690
18149,8,236,1400,128,13727,108
10722,16,768,1503,528,11774,240
29720,238,5502,1180,3783,34750,1719
12689,734,16406,1484,9874,118185,6532
41815,61,1420,938,1080,16172,340
39999,111,1578,967,1051,12164,527
34270,25,276,1097,226,3316,50
57334,52,1238,591,975,11465,263
37274,23,447,1022,355,6556,92
16504,10,290,1429,190,10522,100
59659,6,50,516,41,3866,9
4725,39,1189,1559,669,16952,520
45550,3,84,890,73,4071,11
52781,13,350,727,228,26157,122
29825,165,4810,1177,3243,73995,1567
19122,550,25293,1382,15318,238883,9975
55199,14,227,650,132,7379,95
21366,1649,42623,1343,26019,365563,16604
12481,513,20154,1486,8999,88165,11155
7416,13799,581595,1525,283483,1315816,298112
55950,197,2393,630,1900,30055,493
52586,63,941,734,724,14262,217
24587,1067,27311,1286,18467,180410,8844
1244,117,2781,1593,1770,32062,1011
15567,401,5259,1444,3556,55931,1703
66223,21,257,315,195,5538,62
6795,208,7704,1533,3182,69640,4522
12433,571,24531,1487,12861,105181,11670
21005,21,983,1349,581,12596,402
27227,5,268,1229,160,4337,108
23362,401,10244,1312,7451,97170,2793
55963,486,6592,629,4627,41249,1965
50740,2651,62405,789,39560,335090,22845
58416,81,889,557,789,39260,100
42905,127,3017,920,1375,24236,1642
2508,90,2050,1583,1366,23410,684
25418,69,1895,1269,1238,23251,657
52868,15,185,723,152,9942,33
67515,37,546,274,438,9136,108
29202,19,740,1189,450,9339,290
25394,56,3225,1269,1965,39079,1260
47763,0,32,863,27,2858,5
34199,7,202,1098,148,4090,54
36844,15,174,1035,149,5791,25
5310,44,1002,1551,761,14100,241
2185,53,2984,1585,1760,28461,1224
51103,87,922,779,835,19519,87
20545,25,1252,1358,891,19562,361
29318,45,684,1187,547,22200,137
22593,53,775,1325,513,12026,262
34428,49,743,1094,509,12096,234
20060,8,564,1366,454,25190,110
31239,424,11315,1150,6528,97069,4787
17519,1729,78303,1411,54999,396671,23304
48596,14,239,847,196,11802,43
50914,992,15970,784,10616,136876,5354
51562,77,846,766,726,12113,120
7214,74,1703,1527,1010,37505,693
16542,168,3009,1428,2400,33532,609
8113,2,313,1516,197,5633,116
26923,6,209,1235,172,2851,37
8307,18,969,1516,637,21129,332
30346,436,13067,1166,8981,115440,4086
35458,293,4712,1068,3910,76510,802
24792,25,1404,1282,791,16488,613
2403,39,1242,1584,834,14753,408
66960,2,120,292,72,1789,48
36754,70,1102,1037,940,10585,162
39517,51,471,974,417,11499,54
54091,167,1740,687,1616,35682,124
52456,171,3884,738,2869,47217,1015
19159,1079,17587,1382,12692,139669,4895
17631,8,206,1409,150,9455,56
50600,216,1994,792,1731,33527,263
37238,87,2035,1023,1269,22150,766
16092,1,112,1435,67,14458,45
65566,5,366,333,253,11009,113
11972,25,2557,1492,1101,27009,1456
5215,182,13458,1552,8198,78571,5260
12036,34,2912,1491,1303,15867,1609
61973,143,1761,435,1564,16194,197
12386,2,127,1488,84,7608,43
22970,12,604,1318,444,39431,160
56879,16,321,602,264,9265,57
14671,29,1227,1456,917,34336,310
66908,54,663,293,527,10519,136
25620,61,1993,1264,1144,21670,849
31839,763,20531,1141,10655,98132,9876
167,889,39143,1602,23409,90188,15734
34073,3,39,1101,34,2025,5
21450,64,802,1341,598,11577,204
6961,28,802,1531,480,8607,322
3236,37,1968,1576,1268,46971,700
38379,12,291,993,230,12017,61
5507,162,4572,1549,2879,61621,1693
42133,31,708,933,522,12920,186
33008,177,3204,1121,2063,36147,1141
54924,387,4031,657,3591,84674,440
714,27,1633,1597,1087,53439,546
7120,86,2464,1528,1674,47361,790
943,18,521,1595,356,22153,165
3378,166,4388,1575,2689,51413,1699
15177,23,473,1449,342,9525,131
54467,19,236,674,201,9377,35
2507,425,20212,1583,11052,74082,9160
26945,55,1079,1235,849,15319,230
48281,92,1316,856,870,29096,446
27334,94,4937,1226,2356,29765,2581
42612,76,1674,926,1281,16174,393
6836,31,1159,1533,809,30265,350
2948,60,2139,1579,1224,39229,915
63034,26,401,404,210,5327,191
67025,50,1883,290,1650,26593,233
33582,15890,501204,1111,285105,1647666,216099
2383,2,127,1584,92,9823,35
57301,147,2369,591,1600,31441,769
541,31,899,1598,550,23139,349
45155,372,3691,894,2442,48507,1249
10197,127,3958,1506,2737,53271,1221
21085,217,8271,1348,4187,46804,4084
13786,69,847,1468,453,12595,394
57414,73,708,589,667,8847,41
17939,5,243,1403,167,8304,76
65270,1,25,340,24,1989,1
61008,17,165,467,148,4449,17
7369,10,626,1525,442,6902,184
42282,103,1220,932,899,10944,321
38149,43,734,998,570,11115,164
61664,15,227,446,191,8813,36
44000,282,6525,907,6276,50253,249
20614,1142,66629,1357,36667,346288,29962
6287,5,223,1540,171,7518,52
35938,6,115,1058,84,3913,31
23480,16,485,1310,340,7625,145
16378,622,10410,1431,8909,73380,1501
11445,828,81236,1497,37345,288058,43891
30061,47,1469,1172,1021,20655,448
47775,23,297,862,263,12548,34
64313,719,16924,368,8324,128533,8600
3511,186,8104,1573,4129,119785,3975
4315,3,92,1564,68,5952,24
25675,6668,167951,1263,132058,438125,35893
41776,62,490,939,344,6807,146
15083,104,2709,1451,1854,36308,855
55232,115,3925,649,3454,58858,471
29451,13,382,1184,317,11559,65
65649,26,444,331,370,6395,74
42193,26,440,933,374,15135,66
36883,243,2735,1034,2315,33376,420
50624,36,427,792,345,10679,82
36809,101,1826,1036,1599,14778,227
50947,102,1763,783,1323,23589,440
29419,4659,119836,1185,63130,743266,56706
39217,98,1186,978,944,14450,242
2808,1449,53919,1580,22666,131530,31253
12226,55,4118,1490,1824,20298,2294
34349,8,145,1096,128,4972,17
55555,27311,681107,639,342161,2220803,338946
10675,1100,44951,1503,17849,113800,27102
61290,26,393,456,332,8345,61
14406,32,1161,1459,799,18558,362
354,103,2859,1600,1722,54389,1137
24072,149,2715,1298,1939,22545,776
8222,410,11939,1516,8750,98382,3189
15509,7,349,1445,237,13058,112
19511,97,2797,1376,1924,23500,873
20885,20,469,1352,298,5739,171
4948,116,5131,1556,2651,29366,2480
32252,128,2816,1135,2142,31570,674
39377,1133,8601,976,7125,57454,1476
33864,36,1240,1106,808,15088,432
27213,131,2383,1229,1373,13081,1010
13374,78,2239,1474,939,17198,1300
44757,5,122,899,91,4164,31
4517,17,645,1562,480,17341,165
20550,22,530,1358,363,13196,167
18546,65,2085,1393,1486,27706,599
12540,7,464,1486,228,15615,236
30894,200,2498,1156,1894,37118,604
28141,52,691,1209,485,41238,206
7557,0,16490,1523,11417,147145,5073
4690,252,30009,1559,8003,173210,22006
61139,2548,29821,462,28268,113139,1553
6405,491,13023,1538,9486,76582,3537
48732,8,240,844,179,7781,61
16580,157,5310,1428,3384,24727,1926
35988,95,2377,1056,1869,26589,508
38277,270,3999,995,3353,69798,646
42418,18,213,929,173,12209,40
64912,10,220,350,164,5260,56
35883,6,77,1059,54,7768,23
46815,62,976,875,726,8466,250
23593,345,12112,1308,8753,80569,3359
23420,56,1795,1310,1357,41702,438
10627,2599,47570,1503,33488,176711,14082
59793,19,307,511,265,6389,42
32364,104,1970,1133,1397,12093,573
12045,1435,49021,1491,29909,212974,19112
2518,457,13252,1583,9178,76555,4074
58560,477,4733,552,3691,19228,1042
18631,0,70,1391,50,4574,20
10956,108,3258,1501,1514,36961,1744
15261,152,7410,1449,4788,120813,2622
36972,3,64,1031,42,5949,22
13856,1,111,1467,75,8145,36
57381,22,254,589,202,5831,52
29428,5,281,1185,166,7019,115
15540,14,877,1444,626,23832,251
1039,304,16654,1594,7891,101635,8763
11453,60,1680,1497,981,9378,699
10878,116,2877,1501,1612,25612,1265
52345,10,132,742,110,4613,22
64520,263,3438,362,2611,30428,827
25128,4,36,1274,32,5813,4
24279,135,3371,1294,1987,37897,1384
52736,23,211,728,199,8024,12
56185,10,104,622,68,3239,36
48830,32,533,791,436,5775,97
5997,23,455,1543,259,20546,196
5753,17,754,1546,454,29268,300
37287,120,2940,1021,2567,44134,373
365,209,8948,1600,5052,59881,3896
29226,110,2464,1188,1923,15389,541
15345,31,587,1447,377,6278,210
643,50,1909,1597,1342,41847,567
41280,108,1975,947,1562,27980,413
10388,5,158,1505,92,8076,66
1835,28,968,1588,693,16464,275
53958,187,2245,693,2041,14885,204
32470,4,113,1131,73,18412,40
23982,180,5621,1300,3168,27788,2453
59701,336,7054,514,4489,24920,2565
27938,7,193,1213,112,3265,81
18632,108,3955,1391,2057,51477,1898
21369,352,7774,1343,4927,66720,2847
52613,57,740,733,620,12130,120
66899,12,270,294,269,7060,1
37012,1208,23467,1030,17189,247727,6278
34768,6,227,1085,142,9069,85
13450,804,14847,1473,9134,79778,5713
2756,27,1440,1581,966,24800,474
36816,138,1871,1035,1482,28449,389
7864,12,498,1518,243,8099,255
23142,32,1220,1315,942,48328,278
58796,36,398,545,379,6351,19
2592,8,382,1582,228,9828,154
25884,196,4350,1259,2567,31943,1783
58198,49,731,565,418,13399,313
18911,385,4994,1386,3319,111345,1675
16283,96,4291,1432,2700,48101,1591
45013,70,1433,896,1170,9372,263
62749,7,79,412,72,1943,7
39059,27,326,979,258,5899,68
42398,5383,166648,930,67970,889873,98678
59702,653,10597,514,8226,61038,2371
48391,12,66,854,58,3236,8
49641,61,645,817,516,5750,129
60934,4798,80938,469,62579,270921,18359
23428,374,11685,1310,6279,79068,5406
6708,101,3187,1534,1569,33820,1618
2207,944,71278,1585,39308,320999,31970
58948,8,65,540,64,5423,1
2745,30,638,1581,503,20713,135
45954,14,351,885,328,14131,23
4704,44,1687,1559,999,42956,688
11236,45,2223,1499,1284,39718,939
10272,226,4063,1506,2556,56609,1507
41917,113,1288,937,1091,12968,197
19922,5926,149089,1369,102698,380020,46391
12884,83,739,1481,534,14130,205
2565,31,640,1582,420,5929,220
13944,23,1241,1466,535,21346,706
28317,17,531,1206,301,9292,230
16680,28,901,1426,557,5112,344
16516,71,1851,1429,1096,33321,755
39073,826,38602,979,21559,332149,17043
33961,95,2539,1104,863,23850,1676
7255,3673,108733,1526,65725,253012,43008
52607,285,1945,733,1756,115055,189
17528,1267,57672,1411,36691,266958,20981
18075,738,29833,1401,12839,173154,16994
17064,36,1133,1420,880,40683,253
5929,8,184,1544,148,8866,36
62402,12,122,421,96,7862,26
9782,31159,1144859,1509,475051,3179471,669808
32282,3186,125282,1135,58222,633250,67060
57436,48,498,588,311,6722,187
22854,15,338,1320,214,8005,124
62747,55,953,412,833,21448,120
1388,19,734,1592,546,16513,188
19973,53,2109,1368,1472,27095,637
52211,8,78,747,58,2432,20
9416,39,1682,1511,1030,23995,652
50421,28,431,797,245,40577,186
45585,280,3582,890,2119,44587,1463
4932,127,3907,1556,2331,80418,1576
10024,14,1314,1507,649,14978,665
54054,124,1282,689,1109,20481,173
68110,9,193,255,185,4120,8
61011,10,98,467,90,2151,8
28579,104,4941,1201,3169,45911,1772
43821,58,1024,910,791,30507,233
5102,20,807,1554,541,25946,266
55025,17,399,655,305,11040,94
56445,47,707,615,646,17577,61
60303,37,560,493,454,7193,106
412,8,849,1599,445,11048,404
19082,13,544,1383,425,7499,119
23626,3327,79093,1307,46328,452265,32765
66779,9,211,298,145,12080,66
56999,12,200,599,177,7257,23
37427,26,313,1018,283,7071,30
63168,741,8451,401,6611,88350,1840
32631,64,1513,1128,1041,50266,472
31291,28,622,1149,387,13815,235
49490,20,284,821,248,18425,36
52751,10,170,728,134,8069,36
17851,131,2255,1405,1575,18011,680
38126,49,566,999,479,14316,87
847,144,6844,1596,3698,67664,3146
20127,72,1797,1365,1407,13635,390
7145,2,150,1528,108,23663,42
9212,31,1782,1512,1149,65214,633
7056,163,4302,1529,3671,63765,631
35802,12,225,1061,189,7538,36
27472,6,363,1223,231,9176,132
13031,17,817,1479,455,32294,362
14156,559,17227,1463,10667,92604,6560
4991,1196,24946,1555,14552,196558,10394
14946,238,6034,1453,4347,43214,1687
8372,25,1362,1515,677,17675,685
32537,96,3695,1130,2177,28087,1518
41495,507,9688,942,7680,116612,2008
31769,177,2783,1142,1941,10576,842
17877,150,3822,1404,2879,32482,943
64813,25,197,353,134,15026,63
42119,10,334,933,264,22730,70
19405,0,0,1378,0,21326,0
37712,83,1932,1010,1488,25133,444
50881,87,1501,785,1311,46499,190
50978,1214,23434,783,19630,111916,3804
27424,6,232,1224,122,14351,110
7290,24,752,1526,595,8975,157
47579,13,150,865,126,5575,24
53286,35,312,712,284,11322,28
1544,10,687,1590,419,45442,268
61372,16,296,454,266,13126,30
12624,988,31929,1484,20752,206982,11177
16935,161,7911,1422,5383,70468,2528
38337,12,526,994,294,5965,232
3869,21,458,1569,297,21053,161
43545,179,2257,912,2005,20514,252
58991,103,760,538,728,7530,32
35350,0,45,1071,28,7143,17
1073,102,3443,1594,2300,47572,1143
58999,58,598,538,489,9268,109
30562,117,3646,1162,2489,68031,1157
5925,331,29584,1544,13684,185026,15900
38556,5,58,988,55,5417,3
32648,1491,26482,1127,19441,195243,7041
27803,91,2289,1216,1407,22429,882
42376,884,13223,930,10580,117164,2643
29866,135,5340,1176,2750,30690,2590
4877,19,620,1557,453,49922,167
9573,927,30164,1510,20952,95552,9212
32361,46,743,1133,425,10594,318
28193,24,990,1208,595,11010,395
50989,11,225,782,178,8248,47
37154,207,5528,1026,3293,91079,2235
6537,2054,61199,1536,37673,439286,23526
12893,125,4753,1481,2251,39740,2502
5049,104,3786,1554,2468,15643,1318
33675,44,530,1109,376,12457,154
30953,345,13930,1154,6494,62237,7436
6508,805,17907,1536,12688,126178,5219
10860,80,1734,1502,1136,13807,598
1697,7,248,1589,157,14451,91
67678,23,235,269,190,7604,45
22086,11,399,1332,304,21237,95
26149,19,776,1253,487,11530,289
28362,361,8021,1205,4812,60743,3209
13962,134,5868,1466,3422,35861,2446
504,44,3691,1599,1064,29194,2627
27691,33,1172,1218,777,54741,395
48566,874,15811,848,12967,94701,2844
19251,30,916,1380,628,13322,288
36771,3,37,1036,21,5662,16
11273,85,2813,1498,1612,19788,1201
25605,19,1792,1265,924,21090,868
31409,11,266,1148,187,8168,79
46516,7,364,879,243,8906,121
25674,15,534,1263,260,13810,274
48540,48,628,846,478,17389,150
4973,101,4069,1555,2869,40903,1200
15740,192,3632,1441,2298,50120,1334
6770,3644,154038,1533,79354,499604,74684
21483,4,122,1341,76,6021,46
22127,99,2916,1332,1578,20971,1338
44752,270,5188,899,3235,47895,1953
2464,1731,61055,1583,37341,219507,23714
43365,440,8051,914,6458,117091,1593
13191,21,1104,1477,714,16282,390
21471,8,385,1341,264,14275,121
26402,902,20009,1247,12555,94682,7454
61786,33,451,441,438,12088,13
30551,233,9413,1162,4163,22513,5250
3750,91,2252,1571,1650,14012,602
14647,12,579,1456,425,13273,154
46619,6,121,877,81,6115,40
62667,400,8866,414,5739,85807,3127
61088,30,296,464,259,7616,37
20829,36,932,1353,524,7357,408
27276,860,13778,1228,9148,60741,4630
49362,2,27,824,21,3803,6
27133,7,206,1231,155,7686,51
4994,935,67419,1555,31457,250006,35962
50011,78,1117,807,839,15811,278
66848,27,305,295,290,6264,15
65531,257,2912,335,2827,20657,85
45926,63,1503,886,980,14548,523
64976,539,5369,347,4844,44102,525
43433,43,439,913,301,4889,138
58717,269,6168,547,4015,60105,2153
14312,35,905,1461,753,31939,152
5473,620,22104,1549,15644,76345,6460
29135,209,8009,1190,4464,28316,3545
31279,76,1222,1149,935,19659,287
34836,561,17226,1084,13629,111882,3597
10409,216,11337,1505,6132,103625,5205
1711,5,233,1589,140,7324,93
58872,33,740,542,616,22722,124
15839,8,168,1440,115,5776,53
61253,144,2047,457,1517,26484,530
33772,128,3670,1107,2086,70222,1584
52348,445,4150,742,3833,34080,317
20088,6,507,1365,233,11222,274
30585,47,2215,1162,1316,18089,899
33770,76,1740,1096,1186,19077,554
32097,20,517,1137,267,7858,250
61195,9,72,460,61,5530,11
28729,63,2570,1198,1330,20520,1240
49303,84,1395,825,1127,17331,268
16499,2,353,1429,229,11942,124
15403,104,3264,1446,2130,37396,1134
8867,250,11358,1513,8155,78012,3203
1738,13,669,1589,362,14565,307
2164,38,1592,1586,913,12366,679
5541,5,385,1548,241,10332,144
321,4,295,1600,242,22485,53
21395,0,0,1342,0,7478,0
27785,472,15779,1217,8273,129549,7506
33629,108,1915,1110,1385,17855,530
8042,966,40416,1517,18834,275185,21582
46736,184,2687,876,2051,31880,636
9956,196,6474,1508,2551,67793,3923
35333,310,5645,1071,3336,114574,2309
1983,2,171,1587,106,13031,65
52464,39,320,737,251,6751,69
7118,99,4309,1528,2670,32489,1639
18580,6,376,1392,245,21424,131
36548,1,84,1040,67,3375,17
5155,44,1193,1553,640,11885,553
5830,346,17380,1545,10300,84992,7080
6350,31,785,1539,497,19257,288
28909,7,415,1195,229,12090,186
28127,160,7604,1209,3734,46585,3870
5701,1119,71709,1547,39059,192710,32650
60581,24,573,483,522,4478,51
27181,19,412,1230,314,18479,98
64248,3,75,370,65,10465,10
20542,4,250,1358,149,8011,101
9173,21,928,1512,533,8025,395
18981,8220,312793,1385,136421,1070913,176372
37327,61,1234,1020,725,15443,509
699,160,4292,1597,3063,73284,1229
2333,18,762,1584,435,11241,327
9582,57,2157,1510,1366,34342,791
67363,7,106,279,79,4294,27
14743,1,39,1455,26,9316,13
8325,523,12486,1516,7425,51312,5061
36389,245,4044,996,3134,54767,910
20183,117,2060,1364,1546,10594,514
64117,27,430,374,409,6100,21
341,155,13570,1600,6295,132558,7275
34184,147,1619,1099,970,17030,649
51554,7791,152849,767,105547,620598,47302
41746,2,52,939,39,4145,13
50121,4767,64329,804,59812,441425,4517
53942,65,1494,693,766,13137,728
20668,23,578,1356,328,9931,250
11098,72,2110,1500,1480,17763,630
18883,89,2041,1387,1557,19015,484
64138,0,19,373,13,1498,6
7113,41,1294,1529,751,38457,543
44024,5,197,907,154,6466,43
29592,39,1668,1182,894,14021,774
18998,72,2783,1385,2032,56408,751
26308,2127,95511,1249,57700,349103,37811
65607,279,3405,332,3337,37169,68
69418,3,60,211,54,3121,6
18061,4,225,1401,147,8061,78
16774,77,1993,1424,1251,19421,742
5160,8,1230,1553,720,18503,510
10683,70,2208,1503,1435,22968,773
37992,18,290,1002,248,8769,42
39185,18,656,978,451,10750,205
21717,210,8500,1337,3953,93962,4547
51429,5,119,770,89,9551,30
10273,0,47,1506,39,7454,8
1095,277,12959,1594,9772,96827,3187
47660,9,217,864,194,25628,23
6802,807,18484,1533,13158,89749,5326
65116,21,357,344,267,4566,90
6936,523,11192,1531,7762,44455,3430
32832,23,417,1125,315,11853,102
62428,6,100,420,90,4381,10
1604,33,1576,1590,767,30270,809
11272,72,2439,1498,1333,34348,1106
13938,54,2749,1466,1627,12573,1122
26328,22,767,1249,463,8798,304
43769,105,1539,910,1244,14689,295
7769,264,8868,1520,6076,68606,2792
61854,11,222,439,152,6210,70
3082,14,1257,1578,568,21263,689
63343,11,134,397,118,4403,16
13770,628,18464,1469,12575,78610,5889
15557,15,448,1444,333,56437,115
13325,67,4190,1475,2712,51358,1478
6500,20,641,1537,479,8843,162
3243,295,10959,1576,6570,100976,4389
364,25,956,1600,501,6595,455
32110,42,1026,1137,668,15316,358
56439,55,983,615,860,16628,123
6781,20,1304,1533,650,35028,654
29957,5,239,1174,161,12588,78
49101,321,4901,832,3666,51919,1235
33176,169,3310,1118,2500,37628,810
63033,123,1882,405,1794,27235,88
34825,22,360,1084,303,6933,57
66922,41,404,293,396,9904,8
10438,70,2674,1505,1706,20292,968
9221,84,1897,1512,1308,70881,589
29409,25,766,1185,468,20742,298
29027,19,449,1192,274,11119,175
35101,46,1416,1077,694,30252,722
55008,61,1153,655,803,10286,350
50001,34,358,807,290,6008,68
28590,49,1796,1201,1226,25330,570
43020,37,619,919,474,15212,145
57481,131,1432,587,1259,14051,173
56603,8,67,610,58,5973,9
29487,25,1141,1184,819,14888,322
16100,6,302,1435,221,25292,81
8385,220,6092,1515,2864,33437,3228
28705,20,429,1198,270,19438,159
2196,4,406,1585,272,28078,134
27618,77,2077,1219,1197,18555,880
15690,249,3865,1442,3082,88691,783
28598,116,5005,1201,3097,70419,1908
62218,81,1732,427,1505,24719,227
17859,115,3840,1405,2415,49667,1425
9024,5,210,1513,114,9874,96
68178,9,84,253,77,4064,7
52237,21,427,746,303,11656,124
15076,10,605,1451,406,10986,199
2149,23,668,1586,477,18020,191
59623,14,137,517,121,6884,16
15524,59465,1226527,1444,640729,3897846,585798
22093,82,3095,1332,1988,17280,1107
63102,60,561,403,531,9723,30
11448,221,10843,1497,5722,46227,5121
20155,50,1393,1364,927,18674,466
1010,2704,93922,1594,58113,256223,35809
55934,193,2785,630,2312,30948,473
25656,2,83,1263,50,6544,33
3697,11,264,1571,191,11653,73
17295,28,560,1415,381,21562,179
51063,53,767,780,595,13245,172
782,20,568,1596,390,6777,178
8740,222,4591,1514,3104,51907,1487
50257,1410,35140,798,20469,284246,14671
23315,6,192,1313,138,5247,54
5988,5270,127042,1543,84333,252198,42709
34789,226,1621,1085,1321,22136,300
37010,249,4268,1030,3817,49060,451
37686,106,3495,1010,1537,20456,1958
20672,31,1005,1356,742,28005,263
51432,32,836,770,601,13809,235
62507,5,79,418,68,2800,11
56989,3,29,599,24,4064,5
29426,146,2850,1185,2106,46704,744
15659,935,32351,1442,20585,163817,11766
59592,65,1504,518,915,14144,589
56318,61,612,618,603,5527,9
3946,35,1107,1569,802,13729,305
33084,32,1021,1120,515,16192,506
24063,17,358,1298,273,21710,85
49359,169,2958,824,2472,36666,486
6012,18,346,1543,199,10103,147
21446,0,0,1341,0,4918,0
8075,2508,82749,1517,35377,250973,47372
27786,27,1169,1216,658,21611,511
17906,58,2682,1404,2027,42563,655
11279,93,4439,1498,2395,30788,2044
23093,178,3051,1316,2228,44113,823
10238,327,10975,1506,4983,79971,5992
24667,119,4020,1284,2019,44525,2001
18282,105,2284,1397,1796,33920,488
8344,28,1280,1516,734,15272,546
5875,628,20081,1545,11367,169257,8714
66284,172,2120,314,1924,27922,196
43713,23,556,910,491,15060,65
2094,235,8141,1586,4033,104279,4108
32672,2,98,1128,54,3488,44
21261,642,18775,1345,12622,100544,6153
53269,9,161,712,64,7814,97
13722,66988,2780692,1469,991106,5106543,1789586
11450,3461,68663,1497,43237,621947,25426
55234,10,242,649,133,7664,109
2608,38,1502,1582,909,21824,593
23413,774,19466,1311,12792,156927,6674
19869,629,19418,1369,12563,163902,6855
8132,360,5611,1516,3633,25994,1978
57942,39,517,573,431,10192,86
30795,29,1337,1157,846,13843,491
6128,8,139,1541,92,12522,47
37032,82,2543,1029,2092,14509,451
66731,53,687,299,677,10929,10
34180,76,1481,1099,1023,25337,458
60961,48,574,468,532,8771,42
66466,4,124,308,105,4941,19
10483,712,15395,1504,10919,43338,4476
21530,399,21591,1340,6014,91532,15577
67597,28,291,271,271,9747,20
37372,1248,16074,1019,11030,164643,5044
49419,182,3026,821,2606,44439,420
16463,1136,18743,1429,9747,69964,8996
19283,1829,37138,1380,23287,205674,13851
30014,60,1676,1173,1082,13021,594
8580,5,81,1515,47,4660,34
35675,7,103,1064,99,4836,4
1580,431,7528,1590,4354,34478,3174
9566,265,11041,1510,6472,240788,4569
20185,5470,153443,1364,101341,356296,52102
24271,188,1577,1294,1179,20614,398
32073,471,9914,1138,7795,55536,2119
25810,25,399,1260,279,7433,120
55565,230,5602,640,4090,48239,1512
8485,435,5764,1515,4166,35922,1598
65491,237,3873,335,3232,18452,641
1171,28,1075,1593,668,32173,407
37005,7,142,1029,88,7160,54
67441,185,5236,276,4558,80318,678
48728,21,453,844,272,6541,181
68823,9,219,230,218,8039,1
57253,37,599,593,476,12558,123
10253,26,993,1506,690,17008,303
8131,583,9317,1516,6110,47242,3207
39415,24,442,975,353,11926,89
49438,51,1045,822,764,17359,281
16457,21,688,1429,551,25606,137
55971,4,139,629,61,6406,78
64246,38,514,370,497,8382,17
40463,77,1313,960,1080,17327,233
13890,28,1833,1467,1223,43174,610
58403,115,1925,558,1576,24810,349
18485,47,1612,1394,1241,20825,371
6830,762,23070,1533,14278,66799,8792
19898,19,808,1369,623,25951,185
14125,1110,40243,1463,24359,97872,15884
13491,501,21477,1472,15274,120131,6203
26961,62,976,1234,518,8739,458
35455,3,196,1069,112,11662,84
10264,1,93,1506,69,6088,24
49453,69,805,822,595,10527,210
5097,3,97,1554,68,16037,29
60241,14,181,495,160,7160,21
54331,21,228,680,176,6777,52
55513,62,595,641,546,14917,49
52336,25,287,743,248,6638,39
10401,3,225,1505,95,6873,130
50893,158,2034,785,1857,24210,177
4972,10,219,1555,164,10363,55
63996,51,882,378,790,12419,92
64439,170,1910,364,1295,13746,615
9962,2203,42827,1508,24863,101660,17964
1356,354,8129,1592,5808,54157,2321
52943,57,719,721,615,13913,104
53108,493,6956,716,5909,47721,1047
59323,54,719,527,627,22312,92
20055,3,77,1366,69,4901,8
36749,89,1433,1037,1166,19299,267
48696,40,252,845,227,7169,25
23257,3,225,1313,209,15575,16
37013,8,421,1029,260,9138,161
50273,0,15,800,13,3655,2
53078,323,5502,717,4850,71762,652
21719,85,1627,1337,1069,28384,558
30549,16,818,1162,465,23548,353
15426,19,862,1446,541,18295,321
53232,77,797,713,574,12244,223
56970,224,4743,600,3221,76584,1522
31317,89,1376,1149,960,14872,416
55325,9,138,646,94,11672,44
23801,92,2540,1303,1460,36901,1080
15558,26,1200,1444,800,10926,400
36351,1005,20097,1046,15675,171968,4422
19931,71,3066,1368,2003,39885,1063
54782,51,618,662,511,15134,107
12157,410,31294,1490,11728,174932,19566
34222,752,12900,1098,9284,101318,3616
29817,0,157,1177,78,5077,79
4333,3264,120987,1564,65459,468317,55528
58995,4,81,538,61,3698,20
22611,3893,107264,1325,47909,468436,59355
18613,9,977,1392,621,17783,356
35393,33,1060,1070,829,19874,231
28393,3,112,1204,83,14289,29
28250,3,243,1207,154,16953,89
35688,96,2985,1064,1896,29293,1089
5839,15,504,1545,376,11742,128
39093,126,1127,979,881,10197,246
36490,278,5066,1040,2594,25492,2472
19182,7,223,1382,180,7708,43
58829,148,2449,544,1373,28978,1076
1567,94,4652,1590,1828,46182,2824
669,2038,104092,1597,52431,587655,51661
24384,26,610,1291,467,21041,143
49923,71,1199,809,960,12448,239
15883,27,749,1439,495,9970,254
53767,2893,38888,699,24637,202063,14251
36066,19,420,1054,210,9980,210
7099,14,526,1529,321,13042,205
45662,343,4682,889,3160,67569,1522
59784,44,518,511,461,7913,57
2505,76,3003,1583,1877,43453,1126
62939,1,16,407,9,2787,7
58917,66,1012,541,838,20125,174
63128,66,1145,402,792,10785,353
47217,109,1204,870,801,10848,403
6385,42,1147,1538,745,16402,402
10812,42,1109,1502,556,42652,553
31393,36,852,1148,535,10219,317
4202,45,2105,1566,1386,32572,719
19808,269,12860,1370,8756,58390,4104
867,58,1468,1595,995,31536,473
65002,1,22,346,20,3597,2
42658,194,2710,924,1717,44176,993
61311,3,46,456,43,8135,3
15884,1101,20943,1439,15407,81361,5536
61231,1781,31733,458,18368,203726,13365
3590,201,3936,1573,3158,62656,778
35440,22,1060,1069,744,16857,316
63806,28,349,384,270,9640,79
57799,6,89,578,74,1811,15
36941,33,856,1032,645,24398,211
61680,112,1157,445,1133,11541,24
9145,11,903,1512,515,17671,388
38926,1,80,981,54,4740,26
3224,56,1148,1576,849,76975,299
5235,29,877,1552,600,14826,277
41343,112,2228,946,1472,33169,756
9747,117,4941,1509,2205,18604,2736
67432,19,231,277,193,6233,38
39096,21,565,979,463,13105,102
52922,89,950,722,733,11150,217
9181,27,1934,1512,1162,22978,772
204,183,8493,1602,4870,49241,3623
20345,880,18348,1361,14433,59128,3915
67557,159,2879,273,2759,23945,120
9430,39,1163,1511,657,16302,506
62470,386,10797,418,8897,170291,1900
3766,19,556,1571,406,11372,150
60093,9,246,501,211,10033,35
46836,89,1336,875,986,10434,350
16069,2974,293926,1435,66082,652229,227844
58308,28,258,561,243,7458,15
49830,344,5488,812,4186,53544,1302
63710,27,201,387,180,10033,21
22211,177,2397,1331,1461,13515,936
3696,1,131,1571,96,6586,35
49120,1,136,832,128,11097,8
58276,381,10640,562,6338,52153,4302
7119,94,2013,1528,1143,44632,870
9262,751,20464,1512,13559,149403,6905
51580,464,8960,766,6880,48615,2080
25148,5,331,1274,210,9514,121
15048,34,657,1451,520,15263,137
21377,10014,451595,1343,112523,1135124,339072
3776,1226,23422,1570,15628,166843,7794
37746,2152,39342,1009,29426,370012,9916
22501,329,6869,1327,4841,64002,2028
2636,7348,233166,1582,134315,458757,98851
66794,0,273,298,225,8739,48
67694,0,0,268,0,1591,0
41764,53,707,939,686,31751,21
32828,908,18006,1121,12738,196437,5268
13813,11,381,1468,244,18720,137
22185,17,602,1331,270,10057,332
9021,211,6127,1513,3911,92266,2216
13963,3044,121489,1466,66265,828376,55224
27226,6,178,1229,118,4369,60
13128,1011,46843,1477,22495,163663,24348
6084,13,940,1542,632,13980,308
57420,18,183,589,157,4547,26
28419,119,4255,1204,1915,20547,2340
23247,190,9080,1314,4921,59456,4159
9291,5,173,1512,96,4195,77
35008,4632,86185,1080,61920,429618,24265
14838,9,395,1454,257,8578,138
9104,21,579,1512,424,6993,155
21092,711,68402,1348,13647,245675,54755
30933,362,9978,1155,7364,75108,2614
65283,4,50,340,44,3592,6
18901,192,3918,1387,2324,46743,1594
17031,14,373,1420,303,14884,70
36447,43,788,1042,649,21873,139
6486,166,8159,1537,5437,87413,2722
34280,28,573,1096,490,4435,83
41967,43,455,936,285,5018,170
3225,76,1891,1576,1272,14232,619
12669,316,10527,1484,5911,37755,4616
36541,6,184,1040,160,8348,24
2292,38,1295,1585,946,28593,349
51284,523,7887,774,4070,76550,3817
6103,27,469,1542,398,9944,71
50824,46,797,787,636,12330,161
1855,25,2165,1588,1089,17744,1076
23035,276,6548,1317,4584,47036,1964
51610,217,2279,765,2025,42868,254
64923,120,1005,349,908,18733,97
4113,68,2429,1567,1796,54516,633
37277,2072,38122,1022,30533,150363,7589
40825,243,5419,955,4704,38739,715
6759,11,191,1533,154,20022,37
47956,220,1967,861,1534,18656,433
16020,264,7641,1436,5373,82734,2268
56466,127,1113,614,939,11477,174
32376,50,851,1133,552,7884,299
21636,8,228,1338,138,4345,90
30007,69,1897,1173,1205,59157,692
13641,11974,353475,1470,228449,1371441,125026
28780,2842,56882,1197,33392,281022,23490
21121,302,5983,1347,4683,76510,1300
67127,389,10484,286,6595,105134,3889
33828,9,486,1106,324,15779,162
65498,3,239,335,208,5484,31
56981,20,214,599,145,6175,69
55866,16,256,632,213,5154,43
16820,81,3372,1424,2010,47387,1362
21138,605,14870,1347,9822,101867,5048
16165,7,186,1434,110,4862,76
585,225,10497,1598,5890,168321,4607
57513,1000,11535,587,10143,62082,1392
3962,28,852,1568,675,12950,177
61472,3,23,451,22,4226,1
54661,10,195,666,181,5972,14
29450,413,8195,1184,5187,46492,3008
24093,51,1107,1297,726,21037,381
49770,1678,14315,813,11489,81772,2826
52079,13,126,751,78,5974,48
24857,152,2827,1280,1844,25827,983
57437,98,1083,588,793,14590,290
1632,660,16058,1590,12562,97015,3496
46465,36082,720665,880,460530,2192412,260135
61659,10,213,446,151,2966,62
51295,85,853,774,741,9209,112
52791,35,462,726,453,11987,9
47513,334,4890,866,2931,62815,1959
56541,25,204,612,201,7340,3
58777,52,543,545,481,17448,62
4826,6,283,1557,197,17362,86
28668,612,12385,1199,7299,76146,5086
20607,148,10927,1357,6315,70293,4612
37245,87,1143,1022,945,25920,198
7573,18,753,1523,446,15224,307
18554,32,557,1393,437,12616,120
48032,155,1834,860,1649,22239,185
53761,139,1526,699,1315,18014,211
38048,285,8350,1001,4814,61115,3536
21210,8,374,1345,211,11958,163
62450,804,9566,420,7587,79979,1979
31554,102,3259,1146,1959,24090,1300
55995,24,229,628,148,5462,81
57108,3,111,596,58,8283,53
15469,11,171,1445,126,5615,45
7491,9,236,1524,171,6170,65
57335,5035,57561,591,44346,216640,13215
34019,9,446,1102,293,5879,153
27530,107,1605,1222,827,10212,778
21088,23,457,1348,319,22859,138
12370,38,852,1488,502,17600,350
32466,27,288,1131,245,12675,43
18015,120,3432,1402,2644,63855,788
58878,7,133,542,130,4081,3
4401,51,1146,1563,762,30954,384
37917,142,3001,1005,2412,32222,589
21334,39,876,1343,539,15650,337
55070,1070,15035,650,9624,144300,5411
44312,43,2248,904,503,15406,1745
5341,72,1834,1551,1622,21231,212
14809,343,9329,1454,6316,81169,3013
17937,21,440,1403,309,8199,131
54329,24,364,680,289,10883,75
49668,4,89,816,74,5978,15
34472,62,1991,1093,1356,29718,635
52705,446,6297,729,5099,90218,1198
56227,33,479,621,375,14554,104
21679,73,1369,1338,834,43843,535
17301,14,545,1415,381,10175,164
56990,2,44,599,38,3859,6
29552,49,989,1183,621,13856,368
27704,37,707,1218,430,9770,277
19989,174,3762,1367,2280,20078,1482
34141,18,502,1100,320,17975,182
37901,20,353,1006,284,3258,69
21760,28,781,1337,522,14040,259
58226,21,218,563,209,5715,9
17810,315,9486,1406,5521,71789,3965
14350,16,1448,1460,574,26623,874
8726,8,268,1514,195,14510,73
50949,3,98,773,67,4133,31
5622,2071,73514,1547,27554,223336,45960
7005,35,1089,1530,722,17970,367
37020,45,910,1029,752,14840,158
40250,26,454,963,364,8511,90
14331,31,1385,1460,1016,20698,369
11312,205,8441,1498,4657,51818,3784
41470,1757,48963,944,25241,365795,23722
16376,533,16440,1431,11035,142277,5405
30090,146,3763,1171,2268,39410,1495
64493,33,345,363,281,7195,64
27394,15,438,1225,275,10114,163
5975,129,6617,1543,3977,28808,2640
39361,54,459,976,376,6795,83
54918,13,242,658,186,3455,56
70229,8,127,184,67,3650,60
56915,5,72,601,66,7663,6
3541,12,380,1573,257,16681,123
60374,41,1772,491,1140,19376,632
16131,6,138,1435,105,5063,33
20599,303,10670,1357,7664,96459,3006
32062,90,1583,1138,1421,16020,162
48918,935,9323,821,7520,136729,1803
4275,212,8936,1565,5693,165751,3243
30481,108,1076,1163,872,16241,204
11122,11,809,1499,527,32424,282
39825,284,9159,970,5171,55608,3988
54544,822,12305,671,11898,60639,407
62901,10,172,408,160,4590,12
1103,70,2385,1594,1456,27125,929
13277,6,187,1476,123,23395,64
233,107,3550,1601,1934,30292,1616
66971,1581,35103,291,29078,238348,6025
46211,80,1047,883,913,9551,134
30465,7,187,1164,181,8159,6
17181,126,2291,1417,1441,16720,850
23415,135,3209,1310,2321,28417,888
22453,116,4800,1327,2874,39702,1926
8627,399,16585,1514,8385,43952,8200
6510,0,74,1536,46,7745,28
63864,15,344,382,292,9213,52
25610,13,500,1265,332,7765,168
16694,7,199,1426,137,18527,62
1782,1063,32693,1589,22748,138070,9945
34698,491,8430,1087,5866,100312,2564
58591,96,650,551,484,7182,166
55241,5,64,649,38,3311,26
31326,6,517,1149,275,11558,242
6276,4787,243266,1540,108997,828090,134269
26842,2609,86979,1237,47719,637689,39260
21448,38,814,1341,623,4851,191
28184,101,2780,1208,1808,22683,972
26347,84,3928,1248,2163,24860,1765
50695,2,32,790,31,4022,1
2371,30,1522,1584,1147,19491,375
10877,27,714,1501,464,11109,250
20273,19,737,1362,555,18902,182
19080,0,0,1383,0,9181,0
35287,103,1861,1072,1258,13752,603
28798,18,423,1197,266,15448,157
30967,31,973,1154,669,10916,304
19078,14,266,1383,195,9446,71
55969,58,1397,619,1098,38827,299
11369,205,4129,1498,2127,34757,2002
36395,46,711,1044,550,11359,161
17893,1077,26425,1404,16230,161881,10195
7732,24,597,1520,394,16032,203
56881,17,477,602,470,7487,7
26395,67,4660,1247,2948,29552,1712
42728,450,6691,924,4172,35294,2519
4270,38,858,1565,544,19119,314
19281,16460,515845,1380,190335,4090871,325510
55371,57,723,645,586,22779,137
33466,394,8269,1113,5941,60815,2328
60674,49,352,479,292,7161,60
63805,35,910,384,508,9464,402
22484,15,530,1327,299,5642,231
3839,107,4045,1570,2099,121581,1946
9119,7,454,1512,281,11183,173
7267,18,458,1526,304,19995,154
16122,774,17173,1435,11525,86243,5648
50546,1829,21958,793,18342,141723,3616
51959,6,119,755,85,6377,34
43137,509,7041,917,6498,50845,543
21748,16,360,1337,196,16717,164
48986,93,875,836,755,13679,120
34099,288,7538,1100,5135,49427,2403
47672,80,1165,864,842,18157,323
38297,27,463,995,358,12048,105
30891,49,1270,1156,837,16998,433
39262,156,2932,977,2373,85766,559
13130,564,20703,1477,12455,79287,8248
33389,13,113,1114,97,6124,16
48326,7,107,855,86,3180,21
25764,2,120,1261,81,4047,39
50598,2408,37735,792,29136,251883,8599
22016,273,10429,1333,6761,55250,3668
54806,25,207,661,162,8250,45
3099,22,667,1577,444,48117,223
18386,206,11113,1395,4141,73797,6972
57049,29,257,598,250,7391,7
65601,0,15,333,9,1308,6
29055,55,5501,1192,956,37696,4545
24977,748,14636,1277,10531,87694,4105
4296,75,2615,1565,1804,35217,811
63705,8,85,387,52,2670,33
52140,126,2622,749,2380,17547,242
7344,50,1584,1526,757,25610,827
1351,16,839,1592,488,17884,351
28400,22,795,1204,417,6355,378
8399,403,11178,1515,7237,140725,3941
33150,80,2668,1119,1870,55792,798
61354,61,964,455,930,18177,34
32021,1,65,1138,41,8832,24
23381,17,373,1311,242,3489,131
57464,211,3088,588,2724,35240,364
1424,56,1376,1591,1012,16203,364
22045,7,211,1333,182,9034,29
13294,17,308,1476,201,6315,107
65846,6,115,326,102,3356,13
10132,44,1494,1507,991,15923,503
60784,104,1196,475,1108,17460,88
13418,15,396,1474,260,17742,136
65132,10,111,343,90,3602,21
29501,5,474,1184,258,6888,216
16332,272,2940,1432,2599,42852,341
52596,48,754,733,624,8708,130
50772,654,8937,788,8222,76712,715
37096,19,343,1027,292,7952,51
21963,1,223,1334,113,11119,110
7086,45,1772,1529,1206,42706,566
16996,58,2215,1421,1674,18762,541
12289,384,15575,1489,9476,59027,6099
49892,2020,29970,810,18465,196766,11505
30376,9,346,1166,215,11750,131
59030,29,466,537,302,6765,164
22964,65,1185,1318,860,12878,325
61569,411,8962,448,7827,64058,1135
31633,203,5956,1144,4345,44791,1611
61326,54,871,456,819,12155,52
645,25,634,1597,446,13504,188
9516,321,19579,1510,11070,87401,8509
52158,48,573,746,469,11249,104
3582,307,14273,1573,6515,57405,7758
20826,1,46,1353,41,2889,5
28727,73,1468,1198,976,37942,492
60984,39,398,468,322,10593,76
59241,44,466,531,419,5951,47
29576,188,3249,1182,1594,14817,1655
59507,117,1696,521,1201,30722,495
44098,221,4591,906,3859,53713,732
419,809,39538,1599,23797,152391,15741
25005,33,770,1277,428,14587,342
15796,167,4329,1440,2659,31073,1670
6464,10,198,1537,137,36583,61
54279,52,450,681,379,9212,71
28839,452,5834,1196,3752,82940,2082
62732,62,400,412,359,7917,41
27595,119,2097,1220,1491,9600,606
49078,31,482,833,443,19325,39
15463,26,699,1445,404,43429,295
17829,292,4962,1405,3593,38037,1369
47181,101,1609,870,1109,35015,500
40801,67,404,955,305,7034,99
13680,30,449,1470,301,10174,148
44666,1924,42425,900,25020,207911,17405
62284,3,76,425,36,4985,40
21936,1019,21184,1334,15360,270228,5824
53566,84,743,705,627,23058,116
65089,19,172,344,143,6325,29
46201,5,141,883,87,5574,54
49194,449,4455,829,3700,24919,755
13036,1662,43525,1479,22243,139764,21282
21562,293,7793,1339,4633,44609,3160
65514,2,49,335,33,2773,16
20811,3,249,1353,182,19223,67
62423,17,233,421,233,15484,0
6337,41,1222,1539,893,29285,329
57115,7,118,596,84,9651,34
24774,88,918,1282,828,34133,90
583,94,3989,1598,2631,49101,1358
25618,184,6957,1264,3482,76058,3475
9741,17,900,1509,423,12009,477
23224,8,348,1314,256,9711,92
35495,196,3882,1067,3250,55088,632
51001,219,3849,782,3279,29305,570
29078,5,493,1191,228,7988,265
33293,104,2277,1116,1684,18266,593
31138,9,242,1152,120,4164,122
7658,257,5441,1521,3913,38177,1528
26637,93,3039,1241,1339,24249,1700
34778,72,2282,1085,1587,27951,695
60219,3913,106947,496,52159,451022,54788
5954,120,4095,1544,1947,31396,2148
28572,91,1398,1201,946,15689,452
6342,31,679,1539,430,8233,249
62515,9,68,418,61,5612,7
27645,99,2971,1219,1848,18129,1123
50613,52,1034,792,806,10209,228
21103,1026,20758,1347,12709,147367,8049
61875,3632,165737,438,112657,512363,53080
53164,147,1582,714,1474,13969,108
45145,45,809,895,580,10321,229
27153,881,14114,1230,10274,71169,3840
3739,551,31175,1571,14471,152734,16704
6947,226,4542,1531,2901,56663,1641
6271,96,2540,1540,1535,57867,1005
1114,913,44597,1594,25461,201044,19136
12983,0,204,1480,37,6802,167
61552,1434,21874,449,20102,158614,1772
19014,307,11264,1385,5287,101536,5977
19903,136,1290,1369,936,10788,354
9377,5,247,1511,119,9679,128
14196,41,2110,1462,1684,27345,426
29285,7,279,1187,243,12390,36
39748,73,765,971,666,19765,99
45782,1327,19312,888,11914,83579,7398
29818,47,599,1177,380,11754,219
3994,402,11969,1568,7108,133858,4861
84,79,3040,1603,1678,26518,1362
47021,154,1857,873,1234,13833,623
11285,0,0,1498,0,8541,0
24492,305,7353,1289,3895,59207,3458
33982,149,2572,1103,1710,40096,862
35793,1935,38425,1061,29081,335563,9344
14712,2,119,1455,68,15621,51
38688,50,1851,985,982,26565,869
37336,138,3736,1020,2930,65576,806
23275,53,1630,1313,1449,72009,181
3281,35,1386,1575,1003,53793,383
36191,297,3366,1051,2317,36853,1049
15429,50,1421,1446,1106,31733,315
41609,849,11467,942,10358,80272,1109
52640,2,20,731,18,5613,2
16140,412,5078,1434,3526,20673,1552
56016,35,388,627,351,6500,37
30600,178,1350,1161,1097,14694,253
52719,5,82,728,62,4118,20
59233,43,687,531,475,31910,212
34627,59,887,1089,626,16409,261
7826,303,8058,1519,4214,97646,3844
53787,64,647,698,552,10304,95
32950,40,615,1123,416,9309,199
55150,2,78,651,61,5295,17
51401,4685,86021,771,55246,591779,30775
61805,5,158,441,106,3897,52
51324,56,530,773,457,14562,73
68406,3021,101432,245,66891,766734,34541
57039,5,135,598,83,4419,52
58759,1978,44438,545,21410,229756,23028
50358,2,31,798,22,5228,9
16901,157,4092,1422,2101,41765,1991
24844,137,2682,1280,1840,40259,842
36,453,10737,1605,4602,71040,6135
51995,5,75,754,71,3923,4
65918,28,566,324,497,13063,69
10651,115,4152,1503,3036,54088,1116
48469,42,1034,852,707,11460,327
59903,84,2037,507,1686,25908,351
5028,323,15887,1554,9400,78001,6487
12107,1,346,1491,183,16653,163
19668,757,30868,1373,18526,133721,12342
8653,12,529,1514,342,9537,187
14763,88,2919,1455,2440,41321,479
39628,7,85,972,67,2642,18
4936,228,10169,1556,6554,77110,3615
51765,94,996,760,715,20978,281
13911,108,3327,1467,2123,63400,1204
34248,9,208,1098,125,2291,83
2166,9,579,1586,376,37480,203
19966,52,1397,1368,996,13396,401
20113,88,2828,1365,1947,24462,881
39843,164,3089,970,2249,51472,840
36515,19,380,1040,329,15176,51
23190,15,376,1314,323,27642,53
56184,25,328,622,252,7422,76
60269,41,562,495,476,10687,86
2118,16,1144,1586,629,41799,515
19667,10,444,1373,357,16221,87
23058,6,324,1316,259,19182,65
55799,147,1595,634,1072,16501,523
36085,107,2491,1054,1848,12598,643
50918,55,721,784,633,15543,88
26066,120,11116,1254,6592,37093,4524
3142,2250,198030,1577,75878,729859,122152
29474,129,1883,1184,1353,17760,530
48216,26,257,857,218,4022,39
52198,4,47,747,44,5690,3
32962,32,1327,1122,814,22382,513
56893,115,1579,602,1143,15443,436
19968,49,2472,1368,1629,18084,843
7036,16,567,1530,391,19195,176
53965,38,468,692,417,6773,51
31917,17,292,1140,241,9403,51
2376,16,1752,1584,1172,59760,580
29365,142,10460,1186,1800,40928,8660
10228,77,1999,1506,1359,29795,640
61824,97,771,440,507,7874,264
19239,164,3062,1381,2427,31448,635
20208,100,4190,1363,2922,23047,1268
32303,213,3065,1134,2275,22831,790
68207,45,529,252,413,15424,116
39813,235,3489,970,2815,26805,674
26470,491,12331,1246,9482,70827,2849
27904,115,3567,1214,2812,64610,755
3173,17,724,1577,518,22402,206
33261,5926,108720,1116,75133,365004,33587
32698,155,3274,1127,1973,81923,1301
40356,0,0,962,0,9786,0
23569,85,3005,1308,1278,27309,1727
51657,1378,15780,764,13829,121409,1951
40636,5,109,958,85,5014,24
36953,552,14344,1031,11012,121450,3332
33492,39,1006,1112,410,12348,596
7836,15,496,1519,372,31012,124
8278,35,1278,1516,624,10936,654
32456,58,1512,1120,988,17479,524
62307,326,4257,424,3097,40784,1160
21939,139,2077,1334,1452,20590,625
11,12432,492622,1605,195835,4616284,296787
20281,74,1872,1362,1386,22526,486
10098,93,5087,1507,3263,37128,1824
67145,178,4059,285,3321,40465,738
50982,62,1098,782,468,21432,630
51187,24,276,777,265,8007,11
12813,269,6005,1482,3946,38925,2059
28467,20500,546532,1203,231797,1611714,314735
36555,81,1322,1039,1125,15851,197
30056,34,1161,1172,809,12009,352
54102,274,2257,687,1996,14537,261
18838,0,0,1387,0,5415,0
22352,39,971,1329,654,12767,317
64938,62,710,349,512,5586,198
6876,177,8907,1532,5879,66014,3028
35360,30,814,1071,702,36600,112
65533,48,402,334,338,7257,64
41021,36,715,951,591,43096,124
59443,172,2323,524,1864,42475,459
25280,4664,79338,1271,50867,194670,28471
63549,2,79,392,67,7109,12
62004,1,17,434,13,2078,4
23879,87,3483,1302,2321,25299,1162
21268,6,468,1345,323,7925,145
24378,10,269,1291,202,8934,67
58454,21,138,556,105,5195,33
46415,3,35,881,27,4874,8
30617,82,3658,1161,2341,20857,1317
27949,942,19357,1213,13620,181851,5737
35936,43,737,1058,545,12442,192
6548,219,7101,1536,4182,35080,2919
35097,4,110,1078,66,4454,44
23263,255,4579,1313,3758,71973,821
29566,25,583,1182,367,18225,216
732,39,2056,1596,1474,57347,582
35684,326,6791,1064,5666,30096,1125
34243,8,174,1097,121,8847,53
36958,982,17670,1031,15375,120035,2295
61643,274,4254,446,3402,32419,852
23481,36,402,1310,281,6999,121
21644,37,820,1338,737,20321,83
30826,22,274,1157,151,8251,123
53763,50,481,699,381,8132,100
57788,11,153,578,99,7958,54
895,46,1177,1595,745,41006,432
37302,2267,37437,1012,30987,324768,6450
11034,39,1107,1500,885,14471,222
8826,340,9540,1513,4808,56560,4732
883,141,3625,1595,2563,53754,1062
50426,26,457,797,358,22194,99
12441,1042,35805,1487,22064,125440,13741
59788,118,1947,511,1569,15548,378
7485,745,63557,1524,34873,403260,28684
69005,6,98,224,96,5054,2
60991,31,835,467,623,17939,212
10274,71,2453,1506,1829,40791,624
30719,20,693,1159,464,10372,229
16217,17,307,1433,238,11859,69
60699,53,872,478,631,23358,241
24796,2,125,1282,68,5907,57
4814,49,3959,1557,2101,23782,1858
33688,216,4499,1109,3349,39528,1150
56376,233,2408,617,2033,33489,375
15446,48,973,1446,595,12653,378
24630,1025,50682,1285,14371,208412,36311
69843,46,488,197,403,5078,85
22961,52,1133,1318,854,34107,279
22173,121,4919,1331,3303,53925,1616
58743,586,11102,546,9197,123175,1905
23340,88,1340,1312,1085,12601,255
9270,1,172,1512,103,5751,69
30049,10,244,1172,170,15678,74
66208,912,17476,315,13042,127063,4434
51451,6,64,770,59,3980,5
28536,11,261,1202,187,5457,74
17886,88,4865,1404,3312,53790,1553
40604,559,9241,959,7149,103515,2092
70255,4,48,183,46,2807,2
55283,34,333,647,277,8730,56
26663,244,6209,1240,4388,86535,1821
23527,57,2406,1309,1580,21191,826
7151,11,374,1528,273,10975,101
56909,27,439,601,314,9454,125
2976,185,9452,1578,5824,94689,3628
58841,6,47,543,30,6907,17
57159,2688,44674,592,31083,269212,13591
33461,849,26342,1113,17740,112351,8602
51551,78,1739,767,1367,21019,372
12988,0,0,1480,0,70331,0
33882,0,31,1105,20,6482,11
9521,541,17655,1510,11810,77086,5845
28802,68,2033,1197,681,9840,1352
42940,82,1941,920,1257,33104,684
10681,470,7788,1503,5674,37270,2114
32278,139,1837,1135,1278,13717,559
8757,27,781,1514,505,11583,276
29681,119,3464,1180,1759,23992,1705
70337,484,9233,181,9039,60569,194
58563,122,1461,552,817,15986,644
60595,9,96,483,87,2766,9
2868,101,4902,1579,3285,137357,1617
58088,50,1377,568,1039,23821,338
61795,42,468,441,430,4317,38
65376,0,4678,338,4469,63255,209
29465,22,546,1184,283,15619,263
59866,40,419,509,327,7868,92
37385,361,8689,1019,7399,148713,1290
51192,10,149,776,125,5179,24
28930,31,748,1194,583,7653,165
25773,128,2772,1261,1491,14996,1281
23814,220,4266,1303,3287,39976,979
2535,1437,71327,1583,41011,365398,30316
40525,653,12968,959,10912,99392,2056
35824,2,45,1060,41,1499,4
28061,222,5099,1211,3191,35255,1908
42608,17,349,926,213,6041,136
55526,12,125,641,115,7139,10
44921,152,2374,897,2173,32606,201
19104,17,1221,1383,711,41606,510
35219,361,6413,1074,4961,40613,1452
29793,2,107,1178,78,5121,29
27586,14,396,1220,257,17210,139
35544,64,1633,1066,1232,12205,401
18699,10,595,1390,484,19874,111
68849,128,2606,227,2059,51862,547
49073,31,621,833,515,12478,106
39908,25,236,969,182,3555,54
7542,43,1338,1523,912,21383,426
32924,39,486,1123,335,8352,151
59500,12,198,521,178,15398,20
40354,7,83,962,71,2924,12
60645,5,110,480,74,4693,36
57247,61,614,593,584,13062,30
54165,5,107,685,83,4495,24
33086,32,1059,1120,738,9635,321
4405,301,7174,1563,3610,53667,3564
26590,75,3038,1243,1500,26763,1538
47152,220,1600,871,1106,27363,494
62827,10,260,410,212,11854,48
20490,22,919,1359,586,10174,333
48854,22,450,840,380,10195,70
65148,4,14,343,13,2439,1
60562,19,388,484,251,8355,137
65237,37,640,341,435,6837,205
32928,51,1851,1123,1140,37852,711
58073,30,492,568,272,7237,220
6655,11,249,1535,190,5300,59
12079,8,340,1491,189,7382,151
39319,37,682,976,554,10554,128
6138,4,151,1541,98,9407,53
58618,590,7935,550,7546,84946,389
14619,19,907,1456,660,22408,247
52124,25,381,749,287,9405,94
21887,3102,94763,1335,57501,539425,37262
20422,27,1561,1360,696,14135,865
19020,40,1155,1384,911,27181,244
17559,489,13036,1411,8878,72187,4158
50523,19,290,794,240,10921,50
32316,3,91,1134,56,7093,35
61416,1138,56582,453,35345,157580,21237
10177,156,6286,1506,2195,55693,4091
49441,1,58,822,37,2751,21
68429,16,235,245,235,11035,0
55776,99,1809,634,1724,18930,85
19905,703,22971,1369,11430,297849,11541
18502,5359,125651,1393,83549,481710,42102
65912,87,1314,324,1166,12498,148
15996,10,467,1437,271,6944,196
13643,1483,33635,1470,23508,203007,10127
61890,111,778,438,611,6372,167
4604,27,1017,1560,600,15551,417
27755,1484,38275,1217,22100,123689,16175
29509,4,262,1183,182,6067,80
54834,19,128,660,112,7669,16
49568,14,166,819,146,5246,20
1925,72,1634,1588,1201,51234,433
53077,173,1664,717,1502,36524,162
54754,25,168,663,136,4210,32
21518,177,6476,1340,4110,44325,2366
17494,176,5600,1412,4099,47453,1501
33529,7,129,1112,114,11214,15
50195,20,202,803,158,11996,44
4019,256,6117,1568,4586,24795,1531
6143,44,1257,1541,894,31713,363
14414,166,2400,1459,1833,29504,567
20226,149,2484,1363,1813,32770,671
52113,0,0,750,0,3348,0
60429,6,105,489,83,5992,22
30726,936,18634,1159,13574,75787,5060
15207,0,0,1449,0,29445,0
2797,476,8501,1580,6105,60667,2396
30524,50,876,1162,627,9876,249
35184,30,610,1075,456,11476,154
13851,54,1640,1467,1001,31036,639
56368,537,7923,617,7667,100753,256
65375,27,92,338,76,4459,16
54306,6434,104527,680,69714,424418,34813
60240,177,1902,495,1704,38215,198
23424,244,4239,1310,2805,15261,1434
57868,925,15828,575,12688,66688,3140
4683,1520,42405,1559,33003,208978,9402
51908,3,48,757,40,3353,8
38313,13,235,995,180,5910,55
49859,242,4129,811,3620,43812,509
10196,17,649,1506,425,11454,224
67980,11,152,259,123,2950,29
499,271,15175,1599,8102,99542,7073
62101,68,1494,430,1096,20033,398
32120,927,19158,1137,11999,119856,7159
33108,8263,150686,1120,105257,576400,45429
63017,100,1006,405,966,23330,40
46581,20,552,878,275,8739,277
5462,90,2744,1549,2152,82354,592
29378,677,16576,1186,10194,80493,6382
9513,457,15351,1510,6256,52356,9095
22502,31,610,1327,407,17954,203
16763,36,729,1424,501,12065,228
44177,2,75,905,64,6494,11
57932,251,3679,574,2788,49069,891
37966,3,112,1003,96,6388,16
50221,71,1637,802,812,21377,825
12668,3401,96808,1484,54403,358467,42405
66623,15,410,303,312,8230,98
15464,57,2075,1445,1465,22134,610
14592,33,1385,1457,987,37249,398
35113,32,424,1077,301,14853,123
52914,79,889,722,883,19120,6
51666,139,1760,763,1240,27190,520
2921,121,3787,1579,2207,26610,1580
59483,265,2910,522,2693,23800,217
32075,355,6552,1138,5246,34870,1306
10130,33,900,1507,582,12979,318
56984,65,1272,599,934,51258,338
19423,10,476,1377,333,15369,143
61992,106,1980,434,1654,31089,326
2056,175,9599,1587,6616,50151,2983
67106,31,508,287,481,14924,27
2331,83,5870,1584,3569,88934,2301
49953,2481,36879,809,27866,377200,9013
53259,2,76,713,42,3091,34
13449,73,3332,1473,2058,16984,1274
61080,190,2578,464,2510,14306,68
33113,164,5334,1120,3768,45402,1566
53175,16,208,714,187,7646,21
4557,344,16312,1561,5848,42218,10464
32087,19,1166,1137,621,9229,545
52546,51,827,735,781,11563,46
55394,172,3934,644,2945,30823,989
22853,34,1045,1320,713,8893,332
35573,70,1929,1066,1573,15268,356
56656,34,277,609,216,7782,61
60818,0,0,298,0,4389,0
26612,0,0,1242,0,3235,0
4968,21,2447,1555,948,28520,1499
57511,36,296,587,253,13902,43
12827,4,344,1482,118,28986,226
66882,66,1894,294,1565,31856,329
3186,227,7341,1576,4163,127039,3178
26007,263,5052,1256,3708,40129,1344
26044,3153,69804,1255,49999,153760,19805
19945,2,91,1368,73,11710,18
26978,116,3023,1234,1508,28772,1515
54629,264,3131,668,2835,41186,296
53207,4,56,713,44,4183,12
41854,324,3147,938,2469,36404,678
11932,1576,41574,1492,27639,159416,13935
13098,1703,82791,1478,38642,435350,44149
50012,73,1196,807,732,6620,464
50384,322,4371,798,3838,65821,533
32656,583,10317,1128,7480,94341,2837
43389,2,90,914,64,4101,26
53680,2,35,701,32,3309,3
55018,8,171,654,100,5172,71
14089,9,761,1464,542,21464,219
2616,960,35855,1582,24264,125408,11591
9751,72,6163,1509,3458,48774,2705
56473,45,669,614,499,11387,170
18865,187,4220,1387,2990,54131,1230
7108,384,14491,1529,9535,63421,4956
49145,7,85,831,58,2948,27
42406,249,4008,929,2652,73659,1356
22682,76,2317,1323,1651,59255,666
35373,306,6340,1071,4547,39264,1793
30790,575,7852,1156,6147,29197,1705
58690,43,331,548,281,7614,50
19345,35,1373,1379,893,16877,480
50909,38,538,785,390,9493,148
6801,29,601,1533,416,16068,185
35557,130,2936,1066,2460,27920,476
35426,0,1,1069,0,11447,1
38994,45,580,980,483,12449,97
51531,162,2656,768,2321,17708,335
31096,379,10932,1152,6105,55163,4827
15696,69,1487,1442,841,17957,646
45515,16,866,890,681,21149,185
7590,988,27847,1522,14841,146264,13006
51003,149,1779,782,1509,14013,270
31095,39,755,1152,479,11611,276
13321,2480,71687,1475,30264,114996,41423
21147,5,334,1347,230,7211,104
68801,1,42,231,30,2567,12
12,29,1112,1605,683,65504,429
15525,79,1958,1444,1452,18563,506
30901,9,440,1156,223,5508,217
51520,4,84,768,64,5737,20
1583,5,399,1590,236,11683,163
52740,42,785,727,630,23287,155
28948,10,638,1194,157,6494,481
4505,28,1216,1562,692,50444,524
59277,927,16585,529,13239,90728,3346
21815,320,10244,1336,7148,57863,3096
23072,265,4105,1316,2819,39973,1286
63738,111,1304,386,1106,16335,198
49945,116,1599,809,1140,17071,459
40862,25,405,954,181,3712,224
34738,12,236,1086,137,8493,99
43737,46,887,910,664,24669,223
9390,43,1119,1511,679,15579,440
29479,625,10456,1184,7070,114949,3386
29006,1442,35505,1193,20154,203516,15351
15623,13,501,1443,355,13266,146
36849,15361,316719,1032,190147,1372374,126572
1096,771,35855,1594,22700,166923,13155
59621,57,1565,517,977,24932,588
35192,574,13193,1075,9293,192373,3900
622,136,3582,1597,2356,38361,1226
32465,112,3793,1131,2125,31212,1668
25861,37,1158,1259,800,24583,358
63012,4,82,406,61,4216,21
39786,46,910,971,756,8030,154
18302,14,1031,1397,859,67894,172
32863,29,822,1124,554,8181,268
8649,178,8628,1514,5472,67573,3156
43085,192,2513,918,2245,41725,268
14203,7,225,1462,166,6536,59
25454,0,322,1268,216,24487,106
5577,3899,160406,1548,64074,1270026,96332
6592,10,555,1535,395,10511,160
19451,61,1064,1377,756,11689,308
9949,10,620,1508,347,11139,273
66982,42,1005,291,702,10892,303
42158,7,257,933,183,8831,74
11323,5,416,1498,170,7336,246
35612,134,2262,1065,1419,26481,843
64283,2512,62813,368,34255,416562,28558
36286,6895,108436,1048,73921,454985,34515
5131,47,2673,1553,1634,16151,1039
36796,33,944,1036,806,12915,138
35722,16,471,1063,387,7979,84
21205,1119,36955,1346,26806,170240,10149
6441,3,115,1538,83,15635,32
1561,69,1088,1590,767,16377,321
9415,80,1332,1511,974,16214,358
32766,26,575,1126,352,3731,223
59312,63,608,528,558,10049,50
65402,11,167,337,110,4788,57
61559,52,866,449,848,34338,18
47156,5,66,871,59,2533,7
17904,230,8953,1404,6013,62819,2940
28513,72,1189,1202,768,29955,421
32927,21,662,1123,432,10953,230
430,31,1176,1599,762,36121,414
16746,792,14061,1425,8984,80589,5077
50555,2,76,793,57,3305,19
4361,28,509,1564,297,18540,212
15511,5,167,1445,131,12322,36
42492,8632,233728,928,149701,624723,84027
26453,185,4534,1246,2980,23543,1554
48850,90,832,840,759,14230,73
25256,839,37034,1272,26660,93187,10374
19225,23,668,1381,492,26730,176
8967,13,1133,1513,759,13974,374
27473,132,2349,1223,1533,13264,816
35905,44,950,1059,746,5836,204
56741,373,6156,606,4618,50812,1538
479,1761,41846,1599,21491,233308,20355
52931,21,283,722,252,11433,31
11275,8,686,1498,337,26266,349
32464,77,2128,1131,1322,15715,806
61477,75,1197,451,1098,9978,99
62397,35,253,421,238,5797,15
54327,24,290,680,214,8630,76
51911,8,290,757,224,14281,66
13007,14,1117,1479,715,10736,402
33119,273,2758,1120,2225,25499,533
3516,10,573,1573,344,24153,229
10247,8,246,1506,182,8801,64
2022,6,164,1587,108,10426,56
3578,21,578,1573,396,31752,182
64081,1,49,374,35,4272,14
57408,7302,188171,589,111190,796794,76981
51409,67,923,771,750,15569,173
4299,4,279,1565,90,17867,189
11570,0,0,1496,0,10225,0
14104,147,4610,1463,3139,80027,1471
42279,5,97,932,68,4062,29
14159,121,2250,1463,1344,15565,906
8902,24,1222,1513,568,11901,654
9277,283,5739,1512,3713,41464,2026
22189,2,83,1331,54,5248,29
16129,86,1586,1435,1137,25233,449
20143,327,10800,1364,6808,90673,3992
26731,972,19884,1239,10367,152472,9517
33199,863,10296,1118,7278,91991,3018
63966,27,423,379,298,11252,125
62454,21,205,420,197,4148,8
31437,10,228,1147,174,5247,54
49028,8,95,834,83,5114,12
27897,1,90,1214,64,14107,26
54563,65,1684,671,672,11176,1012
633,107,4323,1597,2708,32931,1615
23633,153,3865,1307,2608,76915,1257
1848,10,801,1588,384,10027,417
50861,320,5678,786,4590,33966,1088
36444,123,3990,1043,2894,47629,1096
63681,59,1176,388,1037,13765,139
57729,157,2669,579,1959,36635,710
38869,92,1351,982,1160,8386,191
30531,4,127,1162,70,5858,57
29506,0,0,1183,0,10640,0
3009,14,385,1578,283,7769,102
6497,916,53598,1537,23674,321499,29924
14790,70,1289,1455,912,9927,377
29467,462,7899,1184,5348,51890,2551
18101,5,290,1400,243,11592,47
52451,62,1186,738,773,14593,413
46002,6,210,885,139,7050,71
35947,1,87,1057,63,7647,24
50295,13,157,800,147,7396,10
32004,95,4670,1139,2140,29770,2530
1831,115,3710,1588,2333,60642,1377
56833,49,351,604,265,4921,86
35508,14,157,1067,115,8473,42
56642,11,162,609,122,5618,40
65153,16,208,343,139,3910,69
26436,13,457,1246,294,11643,163
55427,11,140,644,92,6119,48
61300,1863,28776,449,22377,149303,6399
65313,5,105,333,96,3113,9
13720,83,2406,1469,1614,18331,792
7355,32,4411,1525,2214,28200,2197
7292,17,671,1526,418,21101,253
4745,44,833,1558,583,19698,250
28893,87,2168,1195,1274,22150,894
68651,19,269,236,262,5232,7
1433,108,4418,1591,2899,52012,1519
5747,80,2376,1546,1787,20574,589
57600,83,1416,584,1262,14472,154
30734,209,3320,1159,2031,33371,1289
22932,8,710,1319,497,11126,213
19656,135,5128,1373,2300,45915,2828
56757,6,104,606,83,5120,21
32811,61,1122,1125,919,14854,203
3439,93,5624,1574,3511,90246,2113
30018,28,675,1173,384,16208,291
53056,55,921,718,807,14334,114
29739,31,2290,1179,623,14299,1667
48798,42,440,841,389,11373,51
58248,14,180,563,171,7984,9
40009,207,3135,967,2613,33214,522
63390,2,41,396,33,2610,8
55955,179,2482,629,2052,30237,430
8389,223,7305,1515,4376,80847,2929
17128,27,776,1419,658,26307,118
32505,30355,852963,1130,376571,2151022,476392
2818,266,13299,1580,7548,79454,5751
35224,211,3050,1074,2126,38648,924
30201,28,602,1169,469,6024,133
31261,10,387,1150,226,9226,161
22996,1231,21471,1318,15073,79540,6398
35089,2018,28841,1078,25024,160338,3817
55418,13,192,644,149,5164,43
35513,145,4703,1067,3718,65404,985
18162,6,355,1400,179,6917,176
25951,57,444,1257,333,10959,111
64109,31,336,374,284,7759,52
34770,836,19704,1085,11069,101085,8635
8394,5,232,1515,162,6942,70
15258,5,190,1449,146,26177,44
54855,25,220,659,207,7888,13
38950,325,6646,981,4490,27817,2156
32647,210,4508,1128,3059,46907,1449
7631,81,1338,1522,848,25527,490
47249,702,18281,869,9186,112139,9095
19098,79,1223,1383,951,15697,272
35503,215,3428,1067,2674,33006,754
35859,63,1639,1060,1193,7910,446
2015,40,1294,1587,1062,16748,232
10724,5,284,1503,157,7919,127
33530,199,2977,1112,2093,23906,884
13162,71,2187,1477,970,26119,1217
4789,141,6879,1558,3736,35528,3143
66138,50,945,318,787,13488,158
6177,1,68,1541,36,4624,32
53746,260,3748,700,2398,44229,1350
13529,4021,82934,1472,56666,374790,26268
8269,72,875,1516,638,10042,237
41852,1528,22959,937,17145,146930,5814
1750,99,2490,1589,1795,26988,695
23608,450,17484,1308,11647,250127,5837
23625,4222,120176,1307,74048,658177,46128
9553,2157,45131,1510,28071,133025,17060
44201,12699,358605,904,275503,765669,83102
125,4,189,1603,125,5472,64
3317,80,4164,1575,2570,20101,1594
37789,1633,24472,1007,18573,150701,5899
59439,29,368,524,325,23248,43
19655,973,18065,1373,12627,187526,5438
36973,45,667,1031,514,12636,153
38462,37,889,990,724,12630,165
56174,563,8599,623,6825,88620,1774
19181,31,1260,1382,817,21911,443
41977,7,368,936,281,9439,87
31547,54,1152,1146,759,11441,393
25367,104,2140,1269,1019,31439,1121
3677,215,5600,1572,3542,50883,2058
5951,4,93,1544,55,10731,38
27660,225,4136,1219,2579,16834,1557
34574,30,816,1091,578,24563,238
16648,210,3263,1427,2331,48564,932
23606,56,1925,1308,1605,88145,320
44216,372,6160,904,5075,55784,1085
58661,11,111,549,77,3542,34
32265,122,3252,1134,2608,61551,644
60868,2378,49240,470,34467,249635,14773
46399,46,887,881,546,16373,341
20285,32,935,1362,666,11528,269
39346,6,111,976,80,4045,31
29182,105,4115,1189,3088,43769,1027
16106,1360,30096,1435,18829,170719,11267
22847,1763,51821,1320,34845,235631,16976
58718,2,46,547,41,2718,5
48839,25,239,840,215,6317,24
55640,1459,22222,638,21033,130132,1189
5815,7,538,1545,281,20013,257
11894,366,13145,1493,6394,121223,6751
52396,20,454,741,344,14406,110
9690,928,30485,1509,18061,164200,12424
9511,559,9583,1510,6777,35438,2806
56348,58,609,618,493,9754,116
64453,9,227,364,202,7914,25
39006,5,84,980,72,1924,12
22226,104,4238,1330,3539,25700,699
52065,636,10020,751,8035,84198,1985
53002,24,272,720,224,8059,48
45966,21,247,885,199,13399,48
68324,31,326,248,301,11130,25
4805,12421,424132,1558,276980,930389,147152
1152,19,705,1593,567,22410,138
19758,53,1477,1371,1041,19716,436
493,534,20686,1599,11820,173394,8866
6454,4,356,1537,215,35087,141
6613,53,2781,1535,1858,35741,923
64749,2,27,355,21,3165,6
5989,54,1716,1543,1282,76741,434
37388,25,423,1019,336,14919,87
2484,34,1478,1583,826,43962,652
56039,21,325,626,301,4351,24
59196,12,169,532,128,5487,41
6517,55,3538,1536,1413,54482,2125
21577,530,20237,1339,11084,88952,9153
63563,19,316,391,261,8384,55
63469,1,41,393,41,4377,0
13340,15,549,1475,330,15210,219
17944,16,599,1403,496,8953,103
57595,13,280,584,154,3569,126
45764,376,6313,888,5358,57953,955
53015,106,1224,719,1027,22681,197
63183,230,4703,401,3579,23374,1124
20245,6,666,1363,451,23002,215
57352,49,289,590,253,16861,36
41381,7768,237146,946,127065,992136,110081
58806,386,6392,544,6221,49929,171
53576,25,342,705,326,5155,16
56306,13,156,619,118,3573,38
37215,91,3023,1024,1592,32004,1431
52308,63,891,743,696,11395,195
67264,14,126,282,94,2367,32
18428,177,5563,1395,4162,97321,1401
27306,73,2396,1227,1565,23103,831
23628,330,8852,1307,6002,35919,2850
45578,6092,149483,890,114256,748967,35227
4486,678,14610,1562,8397,125525,6213
7561,18,520,1523,361,27644,159
33942,61,2253,1104,1404,15360,849
18649,161,2792,1391,1886,29750,906
59028,415,5652,537,5296,70107,356
13234,1332,27339,1476,15306,190779,12033
28531,431,7472,1202,5799,53327,1673
3168,27,368,1577,274,6103,94
3822,159,3880,1570,2564,21243,1316
15486,385,6719,1445,4133,50228,2586
51597,171,1930,765,1408,25346,522
21700,1160,14288,1337,9783,115792,4505
1058,2,242,1594,179,22510,63
22969,14,530,1318,353,11840,177
47488,1044,14147,866,10717,45649,3430
43093,4260,102195,918,63231,529649,38964
10319,544,14788,1506,9624,105011,5164
63206,5,82,400,66,4518,16
56273,10,322,620,110,13267,212
17720,966,28142,1408,15551,164738,12591
1460,167,5122,1591,3445,86651,1677
28927,19,620,1194,492,13339,128
5941,19268,811560,1544,283630,1563030,527930
57673,312,3018,582,2756,36724,262
39807,447,7506,970,6701,43185,805
23921,13,203,1301,176,12674,27
30100,1502,22519,1171,15560,144577,6959
3958,31,1120,1568,767,31180,353
34310,3,84,1097,53,3428,31
2095,123,5213,1586,2947,93521,2266
26006,33,1914,1256,1099,37369,815
62473,19,197,419,193,5473,4
39018,2177,43753,980,31923,256718,11830
18689,2559,44485,1390,29237,396536,15248
15460,37,548,1445,392,8123,156
34423,67,2773,1092,890,24373,1883
4786,903,29349,1558,14968,63709,14381
28842,28,280,1196,267,4920,13
35979,99,1184,1056,949,30570,235
29133,194,7404,1190,4715,53995,2689
30788,175,3484,1157,2254,28079,1230
29999,195,5627,1173,2838,50351,2789
51988,125,1491,755,1132,15412,359
11884,90,1758,1493,1027,12058,731
33867,746,18797,1106,13123,95378,5674
10976,376,5686,1501,3374,19388,2312
26192,81,1660,1252,1282,24615,378
13600,11,246,1471,173,11473,73
21970,258,10739,1334,6516,51067,4223
17934,102,3793,1403,2753,34891,1040
24862,50,602,1280,505,9095,97
26913,639,11862,1235,7569,47529,4293
54445,226,4255,675,3387,34845,868
37033,54,1101,1029,740,11588,361
54773,43,487,663,339,8384,148
30709,59,1805,1159,1191,21681,614
58622,300,4956,550,3405,13187,1551
57877,33,444,575,319,20143,125
61218,2988,86914,459,50260,545304,36654
63736,0,0,386,0,10627,0
30328,96,2385,1167,1993,50281,392
12997,62,3351,1479,1479,32909,1872
38016,33,768,1002,679,18006,89
3132,231,11590,1577,6206,74850,5384
6662,4,78,1535,56,6375,22
32639,107,2107,1128,1687,23070,420
608,103,3138,1597,2252,48908,886
2637,899,25246,1582,14560,104701,10686
540,6,244,1598,171,53515,73
43949,32,460,908,343,10969,117
10099,34,494,1507,377,6418,117
29834,22,519,1177,337,15621,182
8693,23,1336,1514,791,17440,545
4489,1504,40134,1562,26897,221581,13237
14553,1,119,1457,80,6462,39
48439,94,2681,853,1577,67357,1104
43069,30,561,918,415,29500,146
15442,644,11275,1446,6535,67414,4740
258,6,394,1601,237,13510,157
24164,17,795,1296,597,39389,198
1036,2700,63060,1594,41572,222659,21488
37102,16,414,1027,323,12089,91
55848,261,8171,632,5734,60546,2437
58845,47,637,543,620,24770,17
51896,20,326,757,286,6982,40
51733,2436,33286,762,29442,147285,3844
65319,218,1775,339,1382,13712,393
66851,200,3500,295,2887,45428,613
14883,7,208,1454,151,9552,57
22860,1,45,1320,28,2357,17
13382,302,9136,1474,6612,80765,2524
39208,3215,67524,976,44928,284807,22596
61944,45,546,436,499,18312,47
9243,24,787,1512,521,17137,266
6461,218,9813,1537,6182,185295,3631
43649,2828,56643,911,36260,416094,20383
18707,51,1210,1390,856,18020,354
31321,85,1989,1149,1212,22000,777
14129,85,1811,1463,1265,12113,546
54180,9,119,685,101,4864,18
36235,59,1118,1049,840,19241,278
57512,131,1530,587,1462,22239,68
1987,688,21571,1587,13492,158174,8079
70032,20,483,190,318,11922,165
62544,16,355,417,205,11226,150
1547,70,2269,1590,1618,53687,651
3782,151,7264,1570,4875,53965,2389
32782,135,4450,1126,2673,19975,1777
24785,9,105,1282,90,6733,15
49356,246,3985,824,3649,54667,336
22674,671,15298,1323,8920,126547,6378
32964,84,3792,1122,2375,27287,1417
38236,685,14764,996,7106,38993,7658
55549,118,1049,640,899,19154,150
56631,2,42,610,26,5017,16
4363,109,9064,1564,4439,56770,4625
32212,244,3674,1136,2813,21369,861
38509,29,862,989,765,17001,97
39403,12,127,976,101,6431,26
38751,49,914,984,712,26482,202
54188,5,71,684,39,6517,32
6735,40,1771,1534,1195,34396,576
23277,20,954,1313,695,27538,259
18932,20,463,1386,319,5906,144
49818,0,5607,812,2448,27774,3159
26320,115,4056,1249,2570,22608,1486
64037,11,124,377,103,3970,21
46799,39,410,875,353,6847,57
59533,182,3661,520,3542,31316,119
28363,24657,599769,1205,338455,1486464,261314
662,1,79,1597,55,6613,24
28670,181,5220,1199,2706,47104,2514
1474,25,1031,1591,739,35405,292
55495,17,253,642,199,5076,54
50159,72,616,803,453,8011,163
9607,26,665,1510,411,16768,254
1618,1721,41471,1590,29418,113100,12053
61144,23,584,462,451,13015,133
57122,37,699,596,673,17358,26
4384,66,1802,1563,1202,25275,600
27746,120,2596,1217,1893,26699,703
30200,1334,29997,1169,17954,204647,12043
55994,284,5012,628,4627,27406,385
50231,13,243,802,195,5086,48
4272,421,11696,1565,8151,57184,3545
22606,8,274,1325,216,33136,58
11473,618,14391,1497,8148,89981,6243
68769,3,127,232,74,5532,53
49100,11,219,832,157,5646,62
56974,33,324,599,282,7103,42
773,2,111,1596,72,3995,39
30214,17,540,1169,337,20960,203
30384,5,241,1165,151,7869,90
34843,137,3087,1084,2386,37299,701
1136,59,4740,1593,1747,43612,2993
5942,220,7127,1544,4574,100752,2553
31533,1588,37716,1146,20437,228187,17279
7452,229,17531,1524,8259,137999,9272
1562,50,1567,1590,1211,40096,356
17179,139,3910,1417,2736,57201,1174
25756,11,665,1261,611,16706,54
926,149,5171,1595,3404,24863,1767
31803,280,5938,1141,3689,57770,2249
37418,957,17380,1018,14155,161363,3225
32528,23,600,1130,409,13558,191
16632,36,1041,1427,657,13773,384
67135,8,155,286,139,8673,16
11646,148,3274,1495,2176,51839,1098
14703,64,3717,1456,2646,22178,1071
17801,192,4776,1406,3923,44400,853
58201,134,1893,563,1864,21861,29
5586,145,4187,1548,2550,39056,1637
61400,33,738,454,618,8484,120
25793,617,14182,1260,9838,68104,4344
7374,94,5905,1525,2753,83766,3152
14992,0,0,1452,0,6170,0
24695,15,455,1284,293,8880,162
17574,481,7235,1410,4778,56038,2457
20370,108,5307,1361,2393,46673,2914
49682,133,1409,815,1122,51761,287
23659,23,758,1306,565,29562,193
30745,492,6612,1158,6040,48087,572
56652,191,2398,609,1992,32595,406
10502,95,3755,1504,1895,26341,1860
57904,166,1838,574,1539,29765,299
486,19,736,1599,522,20147,214
11891,183,8204,1493,4182,58117,4022
10947,66,2830,1501,1880,27633,950
60756,425,6376,476,6309,28536,67
66705,3,34,301,26,2694,8
15072,12,617,1451,483,34823,134
20203,124,4057,1364,2562,18917,1495
21759,115,1934,1337,1348,15368,586
20788,28,726,1354,621,22851,105
36112,144,2490,1053,2199,75433,291
22829,116,4431,1320,2960,82939,1471
34612,15379,304555,1088,166480,904309,138075
17913,79,2466,1403,1999,21020,467
31222,2361,46893,1150,28470,251781,18423
60767,366,3879,476,3631,25409,248
34737,103,1290,1086,916,10765,374
26176,17,686,1252,468,15450,218
55488,23,482,642,422,17887,60
50592,0,8,792,7,1425,1
33072,49,1589,1120,904,22984,685
62784,131,4650,411,2438,42540,2212
31134,25,909,1152,388,6928,521
49931,84,1726,809,1111,30516,615
28717,9,391,1198,260,11073,131
29792,4,134,1178,131,17286,3
567,43,1719,1598,1241,18367,478
16473,3,35,1429,23,3931,12
54819,308,12041,661,8005,57809,4036
17872,22,632,1404,428,12386,204
17628,266,5841,1409,3308,51997,2533
21166,271,8692,1346,5479,41351,3213
47888,534,11476,862,9361,127943,2115
24422,266,5401,1290,3163,38452,2238
21177,15,418,1346,334,6735,84
55276,1211,10514,648,8722,98477,1792
21677,1,103,1338,74,4785,29
18268,79,2162,1398,1525,19818,637
5731,15,260,1546,167,5856,93
31739,5,198,1142,170,12814,28
50270,23,320,800,270,5047,50
55957,16,442,629,356,13706,86
13213,0,0,1477,0,6254,0
1988,79,1555,1587,1043,30989,512
54740,398,4607,664,3418,80387,1189
21849,21,457,1336,277,14577,180
22113,6238,226145,1332,109628,609668,116517
67444,9,216,276,94,7831,122
7495,1403,79627,1524,48220,298372,31407
59111,0,604,535,524,9616,80
8978,7997,230138,1513,147778,799899,82360
38167,453,6332,998,4312,29576,2020
28578,33,884,1201,583,12050,301
54935,72,1560,657,656,15039,904
8063,5,820,1517,507,10066,313
4624,613,18777,1560,13140,98262,5637
28476,1233,48820,1203,20814,374939,28006
12027,152,3303,1491,1470,27834,1833
46046,207,3834,884,3479,58198,355
63768,11,86,385,79,1614,7
60184,98,1553,498,1457,18798,96
47857,14,198,862,128,7884,70
65211,42,454,342,326,9411,128
35248,256,2405,1074,2050,19583,355
17320,58,2167,1415,1148,21817,1019
54315,19,340,680,269,7091,71
36148,158,2240,1052,2026,58998,214
1286,40,1733,1592,1316,46251,417
58620,210,3208,549,2333,34285,875
22405,26,828,1328,596,27262,232
38647,116,2136,985,1494,29525,642
30621,9,182,1161,125,5702,57
17459,35,580,1413,447,11581,133
50342,140,2450,798,2239,21620,211
11750,4427,109755,1494,55190,526494,54565
61778,60,884,442,789,17966,95
12452,6134,227601,1487,77606,1421687,149995
29360,37,914,1186,613,23708,301
7641,314,13368,1522,9882,105093,3486
3556,146,4994,1573,2720,96914,2274
36153,23,776,1052,623,14466,153
5401,109,4369,1550,2999,33399,1370
61092,33,575,463,413,15773,162
17764,29,440,1407,296,12748,144
60471,33,315,487,261,6825,54
15176,46,1078,1449,750,17442,328
15153,103,4661,1450,3562,38050,1099
11422,127,5452,1497,3528,44025,1924
18844,4,125,1387,112,9092,13
18199,21,1021,1399,767,15804,254
1186,16,440,1593,355,22114,85
8439,49,1224,1515,619,17422,605
31008,160,3234,1154,2357,31699,877
69842,6,47,197,43,2821,4
58647,5,65,549,43,6878,22
7536,57,2365,1523,1689,61868,676
64416,18,364,365,340,4786,24
46182,22,428,883,349,9308,79
51817,118,1264,759,1017,13574,247
57228,87,955,593,867,11227,88
25474,45,1577,1267,1054,36296,523
48947,171,2244,837,1905,53775,339
69150,5,92,219,77,6434,15
51873,8,108,758,74,7394,34
65291,11,146,340,122,3474,24
10058,0,0,1507,0,9579,0
12803,836,23265,1482,14034,185109,9231
54478,4,50,674,44,3062,6
26822,2083,63054,1237,25742,179923,37312
26043,47,1059,1255,684,10521,375
12207,12,625,1490,309,16866,316
14012,13,776,1465,547,40028,229
10029,15,504,1507,185,13817,319
33235,80,1877,1117,1537,34730,340
25748,94,2483,1261,1504,41776,979
1690,2580,81014,1589,51777,362616,29237
70018,1,23,190,23,3519,0
66497,7,200,307,191,4446,9
16325,1,58,1432,42,9350,16
32557,356,9675,1129,3791,46807,5884
11140,671,13721,1499,9939,67314,3782
38955,57,738,973,637,22445,101
23943,268,16729,1301,8876,72843,7853
50014,68,1181,807,665,32469,516
41824,471,6721,938,4529,50677,2192
38476,26,808,990,592,14529,216
29041,37,899,1192,635,23954,264
14558,27,777,1457,564,9626,213
8463,785,35908,1515,21632,240507,14276
32246,2796,113766,1135,63407,403439,50359
33439,104,1268,1113,880,40469,388
39547,61,1463,974,1224,20471,239
25438,142,5820,1268,3535,94904,2285
41792,13,190,939,147,10717,43
15936,7,159,1438,88,6160,71
11538,32,1055,1496,696,14171,359
14292,267,8259,1461,5344,48537,2915
48373,40,524,854,420,11234,104
14667,4,218,1456,165,10867,53
58834,83,833,544,783,11487,50
26429,499,21130,1246,9284,83465,11846
32737,446,12858,1127,8903,132412,3955
47521,832,11032,864,6872,73881,4160
34785,22,523,1085,366,10451,157
35052,11,178,1079,112,6455,66
69047,370,9652,223,6196,64015,3456
14248,96,3485,1461,1927,39739,1558
60783,160,5113,475,3462,68851,1651
63218,153,2131,400,1825,23303,306
4263,20,494,1565,365,23190,129
23795,204,2881,1304,2116,31471,765
41984,185,3084,936,2568,37856,516
5163,8,165,1553,116,8639,49
28827,7,170,1196,123,14719,47
4996,46,914,1555,440,29470,474
17905,57,1890,1404,1399,24064,491
26905,49,1489,1236,938,15138,551
51509,12,124,768,111,4263,13
21204,48,1709,1346,1259,22994,450
22479,23,1070,1327,529,18805,541
28226,8,392,1208,259,7346,133
58101,249,4707,568,2397,34665,2310
62165,20,214,428,173,5968,41
11655,69,4054,1495,1626,15154,2428
7543,3,114,1523,84,7592,30
5206,15,368,1552,265,12074,103
46027,78,1396,885,911,35627,485
66690,567,14405,301,11282,85585,3123
62301,65,864,424,860,29613,4
3118,20,692,1577,472,22074,220
64681,2,36,357,29,2841,7
20956,3,267,1350,216,9431,51
13604,89,1504,1471,1050,18290,454
32167,177,2180,1136,1289,19038,891
60591,6,76,483,73,2076,3
2893,111,2851,1579,2153,31553,698
3710,6,277,1571,153,22895,124
67384,175,8575,278,4876,34186,3699
55335,0,96,646,74,5849,22
30448,13,254,1164,151,7752,103
31787,39,1061,1142,789,14440,272
18867,94,4833,1387,3594,39379,1239
1482,4,275,1591,213,9278,62
27266,176,5597,1228,3947,56476,1650
15138,21,596,1450,383,13984,213
66606,3,23,304,21,1982,2
5649,77,1814,1547,1178,12964,636
3192,294,16936,1576,10071,140860,6865
64136,54,594,373,582,8263,12
30228,24,741,1169,473,7407,268
56451,2,133,615,105,4679,28
15920,42,801,1438,545,7366,256
2680,29,1041,1581,451,35708,590
28845,39,1384,1196,915,10515,469
57624,62,928,583,865,22648,63
25980,253,9946,1256,6123,128479,3823
53637,9,157,703,133,4478,24
38525,24,692,988,654,17830,38
51990,14,278,754,150,4935,128
3068,1031,44944,1578,29477,171987,15467
26955,795,22884,1234,11309,101115,11575
1112,16,550,1594,416,43189,134
28186,4,59,1208,43,6000,16
40419,7,250,961,202,8787,48
32221,22,902,1135,572,13088,330
12861,53,1335,1481,796,16745,539
25597,15,958,1265,541,9217,417
53346,44,512,710,365,14501,147
21875,82,5041,1335,2543,31838,2498
31046,24,1176,1153,688,14224,488
20184,40,1505,1364,926,22783,579
7399,2,111,1525,63,17354,48
61619,2,18,447,15,2892,3
18700,24,1122,1390,602,7863,520
12108,144,2866,1491,1398,19951,1468
57621,182,2534,583,2159,33668,375
46676,101,1717,876,1535,32432,182
50120,148,1874,804,1697,26874,177
34856,30,976,1083,593,14626,383
69429,11,213,211,201,3870,12
37104,739,9845,1027,8824,39499,1021
40554,415,8617,959,7297,74016,1320
15420,10,394,1446,297,16466,97
39555,340,3283,974,2825,28296,458
38114,29,276,999,215,4809,61
34632,213,2755,1089,2344,68447,411
40287,69,1213,963,958,23029,255
58899,10,143,541,101,10538,42
23506,409,8242,1309,5547,58054,2695
49645,6,161,817,158,9760,3
4721,52,1370,1559,472,24685,898
55712,25,281,636,240,8690,41
15850,32,755,1439,560,18072,195
17093,161,7990,1419,5290,83077,2700
59746,12,71,513,48,4948,23
67692,54,540,268,471,4505,69
516,2,90,1598,55,14627,35
38636,190,2113,986,1614,26286,499
31857,34,603,1141,403,7537,200
8339,361,10735,1516,5800,33583,4935
52883,310,5712,723,5248,115132,464
28577,9,91,1201,88,5274,3
40673,4,164,958,139,14282,25
22315,49,1452,1329,1053,13062,399
54620,29,244,668,232,6413,12
17671,7,164,1408,133,7995,31
21354,616,26887,1343,14498,103241,12389
14895,71,6300,1453,3055,21122,3245
31951,27,636,1140,478,21772,158
27232,8,318,1229,219,7215,99
11434,26,608,1497,414,13316,194
9424,2226,61889,1511,37245,199225,24644
13707,59,2509,1470,853,22746,1656
53279,4,85,712,80,7702,5
3227,1277,32569,1576,21765,221008,10804
66335,2,42,312,36,4915,6
26694,5,112,1240,96,4491,16
30047,33,1230,1172,810,32605,420
49657,101,1635,816,1504,54194,131
3823,258,17798,1570,10207,74749,7591
32179,9,477,1136,287,6610,190
66635,23,218,303,203,6937,15
49176,1557,28761,830,22971,165534,5790
18114,833,19914,1400,12654,204018,7260
32166,10,314,1136,215,5904,99
49220,92,1528,828,1221,21225,307
27672,87,2264,1218,1441,29145,823
47712,2180,29062,863,20434,180132,8628
32389,160,2684,1132,1790,22974,894
17277,14,1215,1416,727,12820,488
52235,1507,21921,746,17889,108103,4032
58185,1,61,565,51,3245,10
64659,30,420,358,420,3989,0
25778,130,4588,1261,2740,26513,1848
66033,554,9299,321,7913,97639,1386
38012,233,6644,1002,4215,56053,2429
33745,36,1324,1108,1040,16688,284
51987,107,2439,755,1863,55641,576
109,9,508,1603,348,6915,160
19453,7,302,1377,216,7789,86
24133,113,5749,1296,3603,39519,2146
25925,13,741,1258,452,18312,289
60419,46,418,490,387,9950,31
49698,268,5772,815,5018,48398,754
49122,2,134,832,82,6088,52
50631,5,109,792,95,2830,14
20770,211,4520,1354,3963,36467,557
27158,5,384,1230,240,11558,144
7755,239,9885,1520,7059,146023,2826
34713,13370,292241,1083,185810,1777051,106431
60325,14,223,492,203,8369,20
60416,50,843,490,748,14675,95
14607,791,8933,1457,6426,53005,2507
34136,56,893,1100,633,24867,260
29266,117,3003,1188,2049,18147,954
34390,68,1128,1095,655,23631,473
24355,212,4374,1292,2890,33220,1484
66225,10,147,315,135,6104,12
54202,21,329,684,289,15399,40
37814,10,246,1007,126,5557,120
31929,10,261,1140,187,9277,74
913,81,2003,1595,1467,40988,536
25448,4643,114623,1268,63050,597974,51573
57440,1579,47981,588,29487,248948,18494
68449,21,166,244,156,3427,10
61828,10,197,440,125,7252,72
6501,7,225,1537,164,6924,61
3604,18,553,1573,369,9903,184
9836,150,5054,1509,2823,21817,2231
6172,4004,114698,1541,64185,435632,50513
182,141,3761,1602,2752,42958,1009
33616,19,229,1110,210,4157,19
60735,23,701,477,406,9311,295
16316,28,507,1432,345,14989,162
9849,12,791,1509,474,18970,317
29674,312,13396,1181,8164,107350,5232
60031,89,1760,504,1261,8045,499
57125,54,1212,596,1189,15590,23
51017,106,2190,782,1163,32061,1027
9238,4,91,1512,55,5223,36
33574,10,217,1110,198,9777,19
14528,38,928,1457,702,11729,226
9336,646,9735,1511,5982,79209,3753
13840,13,785,1468,434,9767,351
10690,510,9085,1503,5532,37528,3553
36035,7,242,1055,194,6438,48
26247,207,4889,1251,2936,72612,1953
44496,2682,32132,902,26802,259660,5330
28870,31,1814,1196,1062,22632,752
63674,99,1145,388,996,20146,149
16161,106,2263,1434,1625,29040,638
28418,4502,105424,1204,58057,591843,47367
24892,2,51,1279,48,7591,3
51363,40,549,772,473,6012,76
47967,31,398,861,315,9371,83
59461,139,2090,523,2061,15148,29
40383,19,226,961,174,5135,52
25646,50,1301,1263,766,18311,535
39872,713,10200,969,8022,139185,2178
4784,5726,115537,1558,77441,400052,38096
11756,3608,187462,1494,67538,798414,119924
28882,12,218,1195,173,8157,45
49014,9,193,832,115,11432,78
22939,11,573,1318,451,15266,122
8143,518,21132,1516,8445,72071,12687
16760,26,687,1425,476,14834,211
26928,20,717,1235,445,37794,272
26357,478,5735,1248,5201,69071,534
36544,28,537,1040,408,14146,129
33845,9,293,1106,259,12854,34
54371,189,1620,678,1546,12816,74
11612,22,1135,1495,689,22687,446
56100,14,146,625,123,5309,23
10366,62,1067,1505,598,7728,469
23555,195,5474,1308,3778,51701,1696
27574,3903,92300,1220,65576,264521,26724
55879,71,980,631,769,15800,211
8675,3,240,1514,171,9068,69
14095,24,1794,1464,1401,23042,393
56982,32,822,599,707,9156,115
3705,58,1577,1571,908,24922,669
15860,164,2092,1439,1253,34758,839
28588,27,586,1201,240,12245,346
2749,29,1265,1581,735,21361,530
45315,108,3108,893,2593,19602,515
50210,36,376,802,323,7812,53
54194,105,1164,684,767,10222,397
35950,217,5096,1057,2895,38745,2201
59388,46,493,525,477,7327,16
37478,389,11205,1016,4608,134470,6597
63675,18,336,388,247,7745,89
40822,83,1243,955,1089,12372,154
43497,68,622,913,436,6051,186
211,53,6359,1602,2795,35925,3564
33517,2,122,1112,75,7486,47
65205,3,119,342,109,14992,10
58186,17,277,565,255,6160,22
4187,9,348,1566,161,12533,187
55842,107,1720,633,1394,16403,326
20278,605,9840,1362,7039,47787,2801
30754,262,4722,1158,3530,51717,1192
50708,328,5889,790,5536,101169,353
14173,530,14283,1463,9373,115950,4910
26890,38,1335,1236,865,14070,470
2379,48,1259,1584,886,17643,373
54739,15,128,664,93,8973,35
57940,0,5,573,4,2335,1
55918,17,521,630,268,14367,253
1668,27,628,1590,438,23175,190
28090,0,0,1210,0,11327,0
22758,154,3931,1322,3005,30094,926
5977,151,5937,1543,3280,80238,2657
63243,1671,27009,399,18444,106093,8565
21508,98,1326,1340,908,7668,418
63488,4,62,393,46,4884,16
50248,28,297,801,256,6186,41
62049,6,60,432,55,2888,5
9810,189,7405,1509,4330,33847,3075
51311,1474,14773,773,12367,67045,2406
56037,4363,86443,627,55812,384629,30631
14301,19,724,1461,371,33176,353
28989,9,523,1193,281,15159,242
33148,508,9991,1119,6899,67430,3092
21383,21,1533,1342,1038,15087,495
21031,16,421,1349,305,11989,116
8086,44,663,1517,409,6717,254
48924,15,220,837,188,5783,32
36192,315,4534,1050,3597,37972,937
35216,188,3544,1074,2949,16263,595
40302,775,13181,963,12217,52459,964
21392,3054,80087,1342,52306,428953,27781
44034,172,4623,907,3327,89453,1296
59822,30,495,510,367,11786,128
28500,24,1135,1202,678,11921,457
51464,39,827,769,696,10175,131
27659,121,3122,1219,2071,54537,1051
8491,52,1983,1515,930,34294,1053
5754,36,3834,1546,2338,35968,1496
32403,73,1472,1133,1103,17787,369
12124,124,2609,1491,1545,9379,1064
58533,84,934,553,783,20332,151
45982,4,45,885,35,9772,10
15027,20,272,1452,198,20897,74
10781,134,4084,1502,2894,61928,1190
15218,112,2579,1449,1888,43802,691
56637,14,217,609,174,12221,43
21375,3,199,1343,110,8674,89
57377,7,73,590,58,15872,15
2362,57,2171,1584,1528,17390,643
67371,463,8396,278,6028,82865,2368
24291,7,136,1293,85,3915,51
63730,20,202,386,188,6224,14
64279,6,107,368,98,5492,9
58090,6,157,568,94,6779,63
34471,13,977,1092,665,12573,312
38883,1,46,982,33,2429,13
59901,261,6017,507,3373,58572,2644
43621,46,502,911,429,8550,73
24521,1815,74811,1288,29227,193223,45584
13660,25,1139,1470,677,12051,462
55319,127,2063,642,1781,31503,282
17695,322,3025,1408,1886,27728,1139
6141,1,91,1541,62,8325,29
27833,395,9990,1215,6801,56786,3189
28273,9,205,1207,145,3910,60
6952,199,11176,1531,5702,92676,5474
29466,15,622,1184,406,22708,216
49647,538,6741,817,5607,112891,1134
19278,56,1225,1380,845,11956,380
15635,0,0,1443,0,8521,0
67207,114,1562,283,1490,20914,72
56132,18,351,624,265,10615,86
34196,12,210,1099,188,5176,22
994,313,19170,1594,9273,61954,9897
30389,52,1462,1165,861,16333,601
10612,2234,75338,1504,46628,291715,28710
33855,21,152,1106,105,2848,47
36069,128,2702,1053,2119,40277,583
6673,28,2205,1534,1302,20323,903
23647,136,2847,1307,1748,15059,1099
53738,1240,23917,700,18574,110771,5343
25079,203,3329,1275,2285,20044,1044
64818,18,245,353,222,6753,23
5217,70,2403,1552,1173,19770,1230
30377,23,454,1166,380,5866,74
41744,29,639,939,549,13571,90
67771,19,186,266,186,3979,0
15187,11,835,1449,332,14464,503
19113,27,610,1383,537,6791,73
2947,20175,712583,1579,336767,1680322,375816
47276,80,2058,869,1708,16964,350
65023,8,91,345,77,3013,14
46888,90,1134,874,809,16709,325
20994,9,227,1350,125,8021,102
20151,16,654,1364,446,5167,208
5012,9,316,1555,192,10007,124
3888,39,1185,1569,833,11352,352
31520,193,2968,1146,2202,34717,766
35363,39,920,1071,692,6858,228
24967,540,9274,1278,5611,81211,3663
50098,105,1045,805,831,39519,214
23102,6,147,1316,135,5063,12
2675,133,5500,1581,3025,46614,2475
9346,35,980,1511,592,12678,388
6148,402,15027,1541,10544,103749,4483
15011,600,34951,1452,16696,226337,18255
13837,979,41491,1468,19199,129445,22292
27504,111,2362,1222,1654,36656,708
48442,330,4363,853,4095,55064,268
8556,296,8124,1515,4828,78321,3296
23548,544,36891,1309,10562,149435,26329
49322,75,884,825,650,15897,234
64704,24,314,357,266,9911,48
54352,12,211,679,148,8026,63
29514,52,1169,1183,838,20327,331
16824,5,141,1424,116,13604,25
64307,6,89,368,78,6987,11
30156,22,694,1170,497,16263,197
135,278,15418,1603,7671,191606,7747
23960,17,793,1301,633,7858,160
26937,35,441,1235,193,11301,248
16930,71,3264,1422,2183,88520,1081
64752,557,7032,355,6580,56130,452
30414,17,974,1165,647,18182,327
12535,255,5296,1486,3835,37513,1461
32078,393,5782,1138,4013,39328,1769
28543,170,4305,1202,2496,38375,1809
29867,6,412,1176,264,6127,148
45342,84,601,892,535,18348,66
37954,31,1134,1004,822,13454,312
6280,77,2102,1540,1504,34581,598
17634,93,1592,1409,1091,38087,501
19709,82,2145,1372,1653,33972,492
56160,88,1391,623,1226,19577,165
24515,4,260,1288,177,4968,83
53554,0,117,705,112,8258,5
50698,6303,133416,769,82519,648785,50897
7180,5,233,1527,157,35754,76
37498,152,4112,1016,3374,45483,738
63402,12,171,395,164,5136,7
33850,147,2323,1106,1733,23235,590
20990,0,0,1350,0,4526,0
13419,69,2000,1474,1324,42197,676
20020,5525,114367,1367,83667,232615,30700
52403,2049,37763,740,35781,148342,1982
34762,8,316,1085,143,6794,173
24750,717,30949,1282,18662,106840,12287
62361,21,223,422,188,4627,35
15053,8,533,1451,381,56958,152
26315,46,2091,1249,995,24482,1096
47996,2,91,860,51,6601,40
830,514,11085,1596,8628,78057,2457
13383,8,244,1474,126,12106,118
56954,490,11670,599,7425,45723,4245
6152,268,3912,1541,2996,30275,916
33442,202,4958,1113,3713,24876,1245
22307,5045,144185,1330,56289,315461,87896
44613,83,686,901,590,9185,96
1650,47,1316,1590,749,17899,567
13725,941,48756,1469,23075,232632,25681
29374,269,3597,1186,2350,35875,1247
6573,54,792,1536,520,7580,272
19301,11,367,1379,281,12763,86
40129,798,21042,965,14102,79408,6940
17111,15,376,1419,247,13421,129
55857,21,315,632,214,6278,101
5005,15,498,1555,317,26936,181
2993,108,2836,1578,2307,33797,529
10680,246,6844,1503,4271,67644,2573
1234,538,47228,1593,15386,193544,31842
62113,120,2547,430,1525,32909,1022
183,753,22326,1602,13155,102401,9171
17321,72,1435,1415,1085,12642,350
32151,433,6709,1136,3429,55960,3280
27429,98,3214,1224,2172,60563,1042
3885,4,133,1569,100,17414,33
10051,895,40385,1507,25623,231361,14762
20468,17,1049,1359,554,22007,495
9865,48,3306,1508,1999,32496,1307
28435,40,2185,1204,613,13760,1572
18454,58,2378,1394,1589,18729,789
25030,31,1696,1276,1172,10585,524
31415,35,939,1148,648,16024,291
16064,26,731,1435,487,17710,244
1177,1088,58156,1593,25304,183505,32852
70052,14,163,190,138,4989,25
1622,3313,94697,1590,55347,324216,39350
33153,14,491,1119,315,15850,176
31570,11,316,1145,222,5926,94
64708,15,130,357,130,7369,0
60831,33,309,473,206,11207,103
11790,225,8308,1494,4644,59484,3664
35767,315,8389,1062,5377,75477,3012
36234,2167,35206,1049,26909,368316,8297
34435,42,1261,1094,925,21899,336
19261,500,11499,1380,7711,43213,3788
16166,57,1391,1434,1141,8929,250
9570,209,5326,1510,3474,29958,1852
24197,42,1468,1295,978,17713,490
806,504,22508,1596,9695,145826,12813
39453,373,3654,879,2759,56595,895
31697,3077,75712,1143,46982,416274,28730
36811,7,212,1036,179,5381,33
58358,84,1400,559,1134,14197,266
11182,542,29910,1499,16490,99212,13420
13087,73,3001,1478,1620,21070,1381
20092,1336,29354,1365,22461,223566,6893
64678,24,440,357,289,8939,151
26090,45,1404,1254,817,17271,587
5134,213,9816,1553,6054,99475,3762
18967,3,299,1385,236,23631,63
28710,25,221,1198,151,3247,70
65908,11,194,325,194,4990,0
40737,138,1567,956,1357,13725,210
24847,16,482,1280,321,6988,161
29693,748,14687,1180,13897,120518,790
10787,45,1566,1502,828,16762,738
60491,25,174,486,163,2970,11
21337,177,5185,1343,4055,35415,1130
21036,67,1488,1349,919,7877,569
36821,255,5521,1035,4210,21584,1311
2861,48,841,1580,522,10620,319
54675,16,143,666,134,6927,9
28851,8,139,1196,136,11696,3
22568,55,2064,1325,1396,63310,668
2994,12,266,1578,204,9318,62
54369,27,374,678,327,17275,47
53535,34,452,706,444,24716,8
7264,25,359,1526,230,6876,129
56595,1016,25260,610,14386,131295,10874
24501,27,577,1288,398,10622,179
11957,1397,68600,1492,31461,452200,37139
49165,236,3824,830,2887,25381,937
35848,36,833,1059,644,13027,189
21046,85,1100,1349,752,8867,348
27866,6585,199673,1214,88623,590574,111050
49699,51,556,815,523,16994,33
4581,1267,43849,1561,31858,138332,11991
59554,6,74,520,51,6730,23
64207,29,361,371,336,8645,25
57823,128,4146,577,2091,37816,2055
59996,387,4915,504,3999,46200,916
52105,24,284,750,212,6742,72
31694,1,147,1143,101,14556,46
24638,25,1461,1285,961,16135,500
55425,34,531,644,493,6095,38
22570,6,189,1325,123,6271,66
18819,129,3410,1388,1940,22332,1470
29622,10919,237525,1182,149062,1224311,88463
62719,19,119,412,108,4165,11
51887,3,50,757,49,4963,1
5385,22,921,1550,672,15344,249
39179,70,1073,978,867,19168,206
22459,23,352,1327,295,6452,57
41942,39,483,936,382,7322,101
27820,93,1574,1216,1473,54103,101
62837,6,73,410,49,4655,24
12695,42,1160,1484,721,6859,439
32322,14,495,1134,338,13198,157
49940,42,566,809,445,11618,121
48844,107,1510,840,1410,20250,100
64539,34,377,362,305,7076,72
33549,73,2542,1111,1364,21807,1178
23568,339,6525,1308,5157,79849,1368
4526,145,3967,1561,2318,33371,1649
28386,205,3312,1204,2318,54942,994
59350,206,2827,527,2439,24988,388
65162,102,1208,343,1125,16511,83
48467,1939,45536,852,28616,353635,16920
28969,118,3358,1193,2577,35360,781
11675,12,858,1495,431,11706,427
24473,53,1046,1289,701,33107,345
7401,9,467,1525,318,25180,149
14128,152,3291,1463,2332,40545,959
14264,2,72,1461,66,4506,6
42744,57,1408,923,891,21328,517
20437,117,6509,1360,4459,55865,2050
35053,167,2606,1079,2194,26821,412
55200,4,65,650,33,3268,32
21048,46,747,1349,418,9377,329
22015,164,3361,1333,1750,32191,1611
8293,0,0,1516,0,6005,0
50707,3,15,790,11,1987,4
51578,7,70,766,62,11119,8
23505,5,354,1309,260,11231,94
23377,23,820,1311,489,12758,331
1702,14765,574004,1589,282050,1220341,291954
7246,9,246,1527,148,10920,98
7319,155,4197,1526,3085,62967,1112
2182,643,36832,1585,22552,151767,14280
53381,71,1235,709,1005,12454,230
277,171,8215,1600,4097,87563,4118
20109,24,1070,1365,581,19245,489
50054,186,3340,805,3232,35329,108
51946,58,873,756,854,14356,19
174,129,8303,1602,4217,48312,4086
4297,43,1711,1565,1146,37227,565
54285,146,1260,680,815,16425,445
11581,35,1126,1496,588,12325,538
3892,8,329,1569,247,31355,82
43934,68,1773,908,1064,36169,709
9381,48,2129,1511,1459,46522,670
52397,8700,167320,740,97010,624340,70310
14380,3705,118112,1459,79920,653156,38192
34086,98,2239,1101,1290,47681,949
59531,14,131,520,97,5723,34
25528,125,2253,1267,1485,24289,768
30834,43,868,1157,380,8189,488
36050,64,1145,1054,998,23114,147
19126,22,1543,1382,1132,40962,411
53033,4,500,719,165,13683,335
61683,91,1630,445,1581,31084,49
35459,91,1574,1068,1185,22394,389
40847,100,1405,954,1289,31786,116
43071,118,1604,918,1326,19812,278
3576,9,448,1573,340,18205,108
49367,39,581,823,312,5128,269
37210,0,25,1021,19,2604,6
36843,3145,53460,1035,39629,279180,13831
53449,10,212,708,164,10380,48
56370,6,92,617,89,6228,3
4871,37,1785,1557,719,37172,1066
18037,314,4945,1401,3433,30156,1512
55182,243,3767,651,3110,54150,657
21270,11,215,1345,150,5830,65
48812,58,1802,841,1348,20995,454
5124,228,4208,1553,2481,42793,1727
65426,248,6350,337,4647,58455,1703
28415,52,1126,1204,738,10386,388
11007,373,12546,1500,6096,88676,6450
10077,8,348,1507,225,9568,123
60891,15,175,471,127,8629,48
8887,13,873,1513,449,31689,424
36940,48,918,1032,716,16732,202
12123,40,1056,1491,714,19548,342
937,3046,117287,1595,62694,255622,54593
35679,12,419,1064,332,6236,87
54350,362,3459,679,3295,75737,164
67037,25,315,289,313,6395,2
62490,74,958,419,870,17586,88
58517,117,1420,553,673,26960,747
48423,7,214,854,138,17030,76
4408,1308,46173,1563,27547,169859,18626
52949,195,3873,721,2834,26393,1039
23876,10189,260273,1302,151773,866909,108500
17153,266,5462,1418,3934,53796,1528
55388,86,1262,644,1002,18535,260
27388,104,3696,1225,1434,41174,2262
37006,803,12408,1029,9725,80879,2683
45153,80,1047,895,912,16984,135
27781,5,361,1217,243,17066,118
628,53,2304,1597,1660,77900,644
51596,4123,51659,765,34460,425477,17199
36130,149,1911,1052,1639,24526,272
14902,28,643,1453,525,11990,118
144,126,8604,1603,2414,33931,6190
56873,89,1356,602,1237,37579,119
56094,116,973,625,695,8236,278
29122,3,301,1190,194,5713,107
1229,173,6915,1593,2857,43611,4058
34528,37,1167,1092,663,16257,504
8610,47,1967,1514,1004,23404,963
26953,301,13012,1234,5553,95269,7459
28024,202,12156,1211,5296,82953,6860
17573,28,733,1410,613,20993,120
13853,140,4382,1467,2648,61738,1734
37249,23,450,1022,280,13694,170
8680,15,582,1514,396,12282,186
55366,29,311,645,238,13561,73
23287,5,216,1313,149,3110,67
22749,66,1561,1322,753,26795,808
37515,180,2980,1015,2266,23345,714
19612,8,145,1374,116,14940,29
28908,149,1791,1195,1223,20691,568
57828,7,170,577,140,5638,30
51208,422,7552,776,6574,107401,978
6650,53,2027,1535,1171,44601,856
2613,17,996,1582,610,37079,386
32443,23,389,1132,286,7351,103
50493,194,3012,795,2637,42175,375
38147,4,148,998,134,37030,14
12320,374,11250,1488,7354,102222,3896
60536,251,3515,485,2755,38790,760
19219,7,245,1381,194,11559,51
61635,32,660,446,479,9693,181
26365,24,627,1248,588,14919,39
38090,177,1667,1000,1388,11766,279
11528,44,1886,1496,1214,53514,672
31942,99,1837,1140,1245,24757,592
18401,3,244,1395,166,8135,78
20937,253,15437,1351,6492,79848,8945
17285,206,2605,1416,1594,20606,1011
52861,44,407,724,383,5614,24
15652,0,0,1442,0,9771,0
14635,74,1495,1456,1017,17787,478
1996,69,2802,1587,1925,34950,877
65504,39,349,335,270,6656,79
23882,636,17176,1302,11780,106734,5396
34296,17,302,1097,174,4382,128
34944,183,2708,1081,2175,46947,533
16579,7,345,1428,282,13796,63
16198,17,1001,1434,762,12989,239
17081,25,516,1419,344,14404,172
14892,29,1156,1453,761,17794,395
38179,55,851,998,501,10830,350
8223,416,8702,1516,5754,34632,2948
15275,72,2580,1448,1897,31157,683
20569,43,1268,1358,753,36818,515
18000,136,4879,1402,3128,38384,1751
60159,6,150,499,124,6345,26
15125,3969,109277,1450,54248,300876,55029
26020,26,839,1255,578,16562,261
22050,709,19991,1333,12423,171196,7568
9547,10,663,1510,217,12730,446
8498,5,363,1515,185,10505,178
56623,1110,30310,610,19713,180985,10597
53788,115,681,698,553,5814,128
20825,60,1485,1353,847,35406,638
65049,2,36,345,30,4503,6
14244,37,1126,1462,723,17615,403
5098,44,1561,1554,868,17359,693
16905,156,3375,1422,2333,51184,1042
15,1897,52006,1605,31011,353058,20995
36833,100,1899,1035,1654,26004,245
66449,30,402,309,379,10775,23
56916,1172,26439,601,20048,305224,6391
10142,339,10711,1507,5061,33214,5650
64986,27,891,347,376,9536,515
7224,100,3075,1527,2049,26442,1026
60992,89,788,467,698,10885,90
12363,47,1310,1488,817,28318,493
61768,117,1746,442,1547,13494,199
51372,22,282,772,252,9492,30
8782,117,3207,1514,1726,28878,1481
15225,940,19488,1449,11261,102858,8227
60083,22,185,502,176,11824,9
57486,45,293,587,258,6698,35
35746,21,577,1063,464,3915,113
17707,1987,58451,1408,20201,234416,38250
55529,19,142,641,136,8911,6
55758,100,1159,635,1096,15623,63
36418,5,132,1044,116,5280,16
19496,15,587,1376,489,15827,98
26495,15,724,1245,368,13036,356
23286,23,695,1313,493,21612,202
49777,501,5774,813,4683,41116,1091
6868,3,96,1532,73,5015,23
55974,286,3938,629,2678,33021,1260
21514,5,136,1340,94,18048,42
13524,81,3938,1472,2405,33509,1533
20375,37,1707,1361,1153,14972,554
20272,2,91,1362,76,4966,15
2032,199,4345,1587,2804,30827,1541
66218,14,224,315,220,9081,4
44207,459,14106,904,7810,99823,6296
28899,16231,362104,1195,215410,1209739,146694
24643,79,1604,1285,859,8458,745
46755,5,164,876,135,10555,29
454,283,25590,1599,7509,174959,18081
21928,69,1872,1334,1324,28203,548
33332,2,189,1115,94,5962,95
48228,10,85,857,81,2867,4
18343,16,731,1397,518,30599,213
30876,18,851,1156,616,7207,235
55068,4,34,653,25,3623,9
27841,22,879,1215,527,21873,352
32551,168,4338,1130,3317,40145,1021
30715,42,1210,1159,414,16015,796
24154,330,26630,1296,11759,115006,14871
15344,46,1306,1447,877,12510,429
25441,166,2614,1268,1972,29531,642
8651,1189,36009,1514,22712,196095,13297
36327,104,1887,1046,1427,24252,460
21840,75,2213,1336,1313,15406,900
40488,8,231,960,128,7016,103
13466,2827,106165,1473,48455,228314,57710
50252,209,2685,801,2433,23356,252
49681,14,180,816,113,7463,67
31210,263,5041,1150,3200,51039,1841
34906,13,392,1082,292,3740,100
63847,153,1913,383,1683,13594,230
58798,11,209,545,168,11885,41
49396,21,812,823,582,24551,230
10617,56,3030,1504,2009,80930,1021
31999,74,1416,1139,916,13426,500
28764,1,76,1198,40,3528,36
25012,200,7778,1276,5015,53395,2763
27046,86,2910,1232,1874,48449,1036
4246,38,1224,1565,823,15271,401
32660,87,2425,1128,1645,18107,780
64431,50,684,364,655,8489,29
18230,134,3716,1398,2513,43745,1203
63949,197,3875,379,2137,22108,1738
66279,23,207,314,169,6599,38
26132,355,4847,1253,2306,52709,2541
34689,31,723,1087,604,12176,119
54291,216,2094,681,1461,18065,633
33784,1292,26819,1107,20137,214474,6682
20566,84,3420,1358,2047,87120,1373
20917,34,1475,1351,840,16981,635
44291,133,1519,903,1292,24596,227
63903,2946,57315,381,51130,297253,6185
68683,2557,51735,235,44923,422724,6812
26732,9,430,1239,251,7735,179
9664,35,1689,1510,994,41793,695
4337,22,1073,1564,684,34450,389
18474,3041,88525,1394,44252,347932,44273
58215,32,478,564,378,11767,100
25407,4,161,1269,98,8827,63
25352,127,2783,1270,1952,37156,831
12660,36,1038,1484,642,21883,396
33765,26,729,1107,427,12117,302
68705,2,57,234,41,4602,16
16240,159,8291,1433,5729,71855,2562
13133,6025,147358,1477,70439,666663,76919
17101,11,787,1419,411,11151,376
64884,15,239,351,101,3518,138
49345,50,755,824,645,25081,110
23189,6,186,1314,167,16498,19
38055,357,5425,1001,3977,35959,1448
63425,54,816,394,486,9670,330
34582,8,224,1091,132,10630,92
34893,16,463,1082,305,6484,158
56959,14,227,600,157,3980,70
41062,108,2838,950,2729,51468,109
20257,316,3496,1363,2805,35833,691
54574,37,413,670,342,17202,71
49484,33,581,821,550,17408,31
9163,43,3475,1512,2218,45076,1257
67727,166,3703,267,3520,33775,183
54807,28,470,661,407,12498,63
33514,3,94,1112,64,5555,30
22824,2,52,1321,44,4371,8
40918,95,2659,953,2233,29346,426
5744,22,821,1546,573,21485,248
30160,63,1367,1170,891,28896,476
51029,338,3559,781,3357,36033,202
12343,28,2706,1488,998,18473,1708
49693,780,8046,815,5899,36465,2147
34563,372,5563,1091,3585,43527,1978
56138,0,20,624,17,3043,3
28327,41,2316,1205,1340,26535,976
26521,59,2028,1245,1200,20172,828
8228,1085,38033,1516,21650,268446,16383
5416,67,4380,1550,2036,39824,2344
10778,443,12429,1502,7728,105418,4701
807,23,613,1596,500,32861,113
28986,87,2123,1193,1219,17172,904
7010,1690,138891,1530,61025,681565,77866
30429,21,935,1165,447,8473,488
25864,52,1227,1259,722,23192,505
61903,36,287,437,249,4931,38
9738,97,6452,1509,4396,47139,2056
37294,17,213,1021,175,5808,38
64943,19,182,348,155,9996,27
56095,118,1900,625,815,13532,1085
56995,24,375,596,248,16498,127
5545,8,248,1548,187,4123,61
4070,95,5393,1567,2678,45686,2715
6749,497,15208,1533,10059,149859,5149
17052,92,2177,1420,1641,30407,536
4364,28,1678,1564,1260,28565,418
20535,16,988,1358,567,16209,421
43369,12,329,914,278,7137,51
22160,36,1309,1331,948,38634,361
63849,27,277,383,198,5822,79
15314,4,260,1448,168,8772,92
20915,7,412,1351,271,12160,141
27906,793,15702,1213,12219,122488,3483
52087,19,429,751,290,16458,139
20006,26,548,1367,312,11479,236
46207,293,4203,882,2484,22871,1719
21384,366,8221,1342,5089,52479,3132
789,89,2466,1596,1109,32291,1357
8603,85,2338,1514,1493,27892,845
62,2052,114380,1604,71714,411256,42666
65952,718,37637,323,16621,98278,21016
24678,112,1299,1284,704,20241,595
49639,180,2117,817,1667,11338,450
62860,18,277,409,234,8442,43
136,899,35786,1603,23667,243650,12119
44179,8541,252584,905,99981,816481,152603
29765,3,261,1178,155,9606,106
22169,34,781,1331,513,22995,268
49734,152,3644,814,2760,22408,884
47227,51,877,869,500,30700,377
10026,3,98,1507,57,3536,41
5688,164,5033,1547,3153,31321,1880
4330,243,6195,1564,4240,52914,1955
24095,13,486,1297,330,21140,156
13299,73,2863,1475,1757,33226,1106
38871,29,576,982,486,4932,90
61222,24,387,459,370,11417,17
28773,14,239,1198,221,7215,18
28304,2,169,1206,101,4388,68
66536,451,6100,306,5956,31454,144
30757,25,654,1158,527,10124,127
23351,358,9166,1312,5933,27656,3233
21580,401,9858,1339,6436,81465,3422
7649,668,21407,1522,12102,191298,9305
12475,299,6492,1486,4178,24470,2314
17567,139,2495,1410,1518,28197,977
49733,91,1174,814,948,32363,226
64805,30,277,354,274,6136,3
42249,14,269,932,197,9172,72
35359,940,16382,1070,12425,139041,3957
35745,6,121,1063,90,3241,31
24758,992,28067,1282,13126,76571,14941
19753,14,849,1371,677,41306,172
34005,707,13601,1103,9441,80067,4160
25846,28143,1241232,1260,404098,4177727,837134
53294,237,5350,712,3624,47642,1726
52276,13,195,745,141,5672,54
26555,16,766,1243,475,23725,291
68666,4,109,236,84,4657,25
36836,52,598,1035,400,11724,198
10122,722,45583,1507,23563,184822,22020
58191,963,15720,565,15436,145419,284
35578,10,241,1066,200,6504,41
17159,26,496,1418,284,9793,212
56614,6481,108080,609,85273,529942,22807
62439,1,8,420,7,1521,1
62205,15,182,427,143,6140,39
37464,189,2518,1016,2156,17532,362
20252,19,441,1363,365,13279,76
10568,12,481,1504,257,12034,224
53786,26,352,698,331,16798,21
23840,46,1060,1303,650,11827,410
22880,8,240,1320,182,10075,58
58980,4246,119329,539,98944,309625,20385
6171,7,221,1541,148,15635,73
10587,31,1194,1504,833,15796,361
29826,81,1817,1177,1122,22965,695
30351,102,1867,1166,1260,40084,607
57017,230,4922,599,4067,40693,855
5277,8,157,1551,115,8504,42
52933,74,1117,722,779,20061,338
10495,52,1385,1504,861,8705,524
57800,52,327,578,310,7224,17
35643,26,469,1065,381,13078,88
31141,64,1515,1152,921,29685,594
39634,0,0,972,0,20154,0
21923,103,1960,1334,1093,17855,867
39598,28,676,953,392,31615,284
25681,31,795,1263,449,17711,346
49523,398,3658,820,3294,39475,364
60837,678,13488,473,10453,65751,3035
57548,29,478,586,305,10688,173
55535,378,8801,641,3758,60792,5043
19310,278,7695,1379,4101,96365,3594
26412,540,31704,1247,15976,148636,15728
17991,47,1726,1402,1013,43945,713
5224,20,1113,1552,675,17037,438
31392,6894,144630,1148,74322,489614,70308
1345,4589,124677,1592,61600,371152,63077
61246,136,2944,458,1670,24021,1274
45891,19,247,886,221,9738,26
38971,75,993,981,858,9151,135
48313,106,1291,856,1014,33070,277
55885,211,1851,631,1521,13961,330
44154,110,2921,905,2681,36935,240
23689,34,900,1306,683,9992,217
5801,37,1158,1545,784,14974,374
13355,745,28044,1474,18066,117050,9978
68591,1,86,238,25,1998,61
4863,767,31973,1557,17460,178658,14513
59994,6,97,504,64,8214,33
25781,18,626,1261,398,11615,228
8955,346,13446,1513,7994,63392,5452
48757,32,811,843,665,13525,146
54261,38,448,682,358,17867,90
14692,11179,442947,1456,163349,839532,279598
61363,87,1011,455,968,9203,43
22311,28,938,1330,787,50552,151
35379,23,494,1070,373,7371,121
23708,5,353,1305,224,13193,129
48560,164,1836,849,1709,18813,127
6341,34,837,1539,596,20756,241
25719,4,83,1262,69,6869,14
31733,1179,27408,1142,11787,100875,15621
8861,24,1993,1513,1294,49230,699
6524,1961,73857,1536,26189,292384,47668
18989,0,123,1385,98,5702,25
23974,1444,29954,1300,22146,169913,7808
53364,4,50,710,41,3178,9
61404,35,493,453,404,14836,89
33266,405,4551,1116,3137,28527,1414
13535,180,2138,1472,1435,11497,703
16000,2007,30773,1437,17653,294050,13120
16775,128,3175,1424,1504,33063,1671
35687,96,1805,1064,1366,14420,439
21277,994,44245,1344,28643,210614,15602
58745,144,2393,546,2070,24392,323
50027,9,125,807,108,4471,17
38165,24,638,998,443,22825,195
16137,271,6391,1435,4150,35970,2241
22119,7213,114720,1332,70940,333138,43780
31891,66,2585,1140,1739,31980,846
66181,1,18,316,14,2121,4
32487,282,4118,1131,3090,50623,1028
33522,69,2061,1112,1294,14651,767
2167,7,321,1586,233,10626,88
41227,224,2544,948,2100,15003,444
12035,315,6860,1491,4551,53742,2309
24846,779,23211,1280,11036,96952,12175
67073,5,56,288,55,3285,1
59957,0,0,506,0,2541,0
65371,324,5062,338,4693,44501,369
35530,57,1141,1067,807,15182,334
16374,11646,416028,1431,229345,1954656,186683
29459,114,8441,1184,4169,27018,4272
48463,67,1275,849,961,38577,314
64070,18,153,375,102,5901,51
17536,1955,75102,1411,45149,324381,29953
48646,17,194,846,148,8033,46
29331,34,872,1186,655,13527,217
32930,1342,25510,1123,16858,170294,8652
34841,12,172,1084,139,8753,33
35299,43,1978,1072,1241,14077,737
22196,215,6629,1331,5077,52122,1552
33124,322,5689,1119,4069,56457,1620
22083,93,2179,1332,1585,34916,594
30428,65,1992,1165,1136,23905,856
34013,19,753,1102,488,11301,265
24440,22,297,1290,225,9244,72
51570,586,12208,766,9433,140867,2775
60864,2,20,472,9,5085,11
37591,471,15387,1009,5548,138226,9839
64710,6,105,357,95,4324,10
729,10,689,1597,491,13879,198
43111,6,95,917,72,4735,23
53522,28,228,707,177,4839,51
15952,34,934,1438,657,10434,277
57589,455,7148,584,6376,59627,772
35845,89,3483,1060,1649,33547,1834
22394,42,871,1328,622,9056,249
4672,43,2568,1559,1741,32320,827
14316,24,344,1461,308,5424,36
63154,5,91,402,70,6102,21
5858,2,211,1545,148,5061,63
15407,68,2158,1446,1512,28672,646
6110,12,472,1542,267,18133,205
31847,109,1870,1141,1525,28132,345
4707,2076,65582,1559,28560,262844,37022
38091,67,1035,1000,960,8903,75
1004,23,1368,1594,962,64272,406
50640,164,3047,791,2866,24395,181
27125,1245,25424,1231,15043,173000,10381
36309,71,1316,1047,1018,24565,298
54133,18,246,686,168,9449,78
1020,9647,364995,1594,192691,1198133,172304
35769,197,3778,1062,3083,30331,695
36914,1268,19865,1033,15721,121067,4144
64217,36,531,371,468,9906,63
11852,33,946,1493,610,10602,336
17204,36,1766,1417,1369,18226,397
15697,12,484,1442,367,16317,117
68027,7,368,255,283,3976,85
52174,24,244,748,220,7072,24
60620,1405,25590,482,19385,90341,6205
6238,108,4326,1540,2670,43777,1656
63042,2,79,405,39,4763,40
1243,126,3994,1593,2398,36468,1596
30516,15,259,1163,173,2471,86
37616,29,494,1012,399,7358,95
713,13,470,1597,334,25613,136
33693,21,898,1109,589,9501,309
30782,0,0,1157,0,11322,0
41482,899,23327,944,15791,235160,7536
37061,122,2377,1028,1898,22993,479
16440,98,3371,1430,2634,23021,737
51901,17,437,757,351,7258,86
12450,2550,85880,1487,59367,440404,26513
23066,3,202,1316,150,13982,52
7084,523,12301,1529,7430,80978,4871
58802,6,97,545,70,3897,27
61625,801,15549,444,8781,132805,6768
28123,20,662,1210,418,10964,244
13930,3328,120678,1466,72987,504667,47691
21003,4,154,1350,126,4691,28
54947,31,386,657,252,10587,134
50554,47,625,793,486,12294,139
59839,13,114,510,66,4870,48
40058,3,164,967,75,6873,89
34047,734,10213,1101,7634,62543,2579
66913,47,671,293,577,14863,94
18516,67,3248,1393,2225,51672,1023
329,1509,119582,1600,57157,420669,62425
4036,23,415,1568,304,16595,111
36359,16,493,1046,374,11977,119
57928,9,211,574,208,4956,3
54453,208,3829,675,3058,43198,771
2904,16,804,1579,546,35077,258
1853,82,4403,1588,3092,72776,1311
32900,259,3311,1124,2517,17753,794
55883,55,964,631,890,21208,74
12655,65,2515,1484,1519,44915,996
22299,188,5405,1330,3823,43881,1582
20388,7,404,1360,315,28487,89
28356,11,506,1205,334,13540,172
35308,61,915,1072,695,12441,220
13831,97,4566,1468,2823,31153,1743
44916,2362,36855,897,34613,132338,2242
6476,1028,45811,1537,24519,287832,21292
18035,13,549,1401,419,11357,130
60180,5,120,490,86,6245,34
65268,16,114,340,112,5282,2
11169,161,2384,1499,1660,62203,724
31766,676,6982,1142,5025,35687,1957
32058,6,169,1138,97,8142,72
58892,15,224,542,189,6501,35
49677,788,14331,816,9429,121609,4902
22654,540,8206,1324,6375,31843,1831
32572,44,496,1129,374,8412,122
14840,2,157,1454,104,6431,53
26223,40,858,1251,501,12706,357
31673,483,15128,1144,7191,120879,7937
47339,14,287,868,218,9098,69
32601,12,723,1129,487,36223,236
17597,57,1025,1410,746,14913,279
15582,89,1279,1443,823,14550,456
52404,51,431,740,327,4385,104
43238,20,439,915,251,16779,188
37390,28,730,1018,635,18364,95
19424,2,92,1377,72,9156,20
54417,7,79,676,50,5874,29
54674,15,189,666,162,11850,27
9525,8,354,1510,213,4344,141
8115,22,782,1516,492,6659,290
25063,35,1376,1275,905,27704,471
36266,63,1390,1048,1304,23022,86
54081,56,600,688,501,13138,99
10373,141,4909,1505,3159,60205,1750
27730,21,267,1218,194,6823,73
41452,134,2985,945,2390,16814,595
21985,124,2937,1334,1791,39776,1146
33878,7,127,1106,103,5946,24
35433,11,87,1069,60,2831,27
62618,34,570,415,495,24434,75
67269,20,610,282,502,11736,108
61950,6,58,436,43,1959,15
19394,82,2912,1378,2209,38481,703
65763,3,49,328,41,3079,8
26222,574,13356,1251,8930,60406,4426
50632,71,1052,791,996,16116,56
19033,810,13009,1384,9429,58718,3580
16576,184,17433,1428,8714,43023,8719
16452,192,3996,1429,2920,23993,1076
51769,2896,48543,760,34314,124249,14229
33142,35,1097,1119,742,28873,355
60583,19,146,483,108,2300,38
63680,446,7295,388,4260,113373,3035
23194,42,921,1314,849,57062,72
57636,26,368,583,276,4991,92
57126,26,463,596,428,8624,35
5867,51,1217,1545,809,24068,408
13268,88508,3702386,1476,1317680,7922875,2384706
65038,37,410,345,358,7380,52
36813,278,4025,1036,3072,23099,953
50837,16,375,787,274,10827,101
76,307,12590,1604,6838,91225,5752
30108,10,153,1171,112,4335,41
27195,15,732,1229,416,11001,316
25512,12,156,1267,115,3291,41
22386,66,1672,1328,1260,53498,412
15280,80,1947,1448,1382,15442,565
56347,118,1141,617,864,14226,277
6165,9,484,1541,288,32240,196
38655,28,786,985,607,26820,179
56869,11,109,602,101,5336,8
23755,7881,250149,1304,119344,1068748,130805
28156,34,634,1209,464,5415,170
19044,13,415,1384,289,9643,126
17817,1341,33627,1406,23716,147460,9911
60237,5,199,496,119,4200,80
52363,15886,234892,742,152972,1000459,81920
15223,1136,39683,1449,19913,196670,19770
2258,125,2810,1585,1945,18948,865
31190,22,403,1151,263,4413,140
33335,3108,75611,1115,45438,169714,30173
14880,184,2800,1454,2129,110973,671
17370,187,8130,1414,5669,104538,2461
17327,23,616,1415,443,12187,173
29139,44,1963,1190,1265,13050,698
24529,20,512,1288,326,7706,186
1246,9,377,1593,283,37787,94
39493,22,507,974,357,5227,150
64837,111,1103,352,1039,17566,64
32573,507,7737,1129,6222,28892,1515
34799,1083,17172,1085,12201,106458,4971
61248,67,849,458,674,11304,175
1716,4,197,1589,139,20825,58
22195,6,335,1331,174,6769,161
32575,11,240,1129,137,4770,103
2837,36,1021,1580,657,20599,364
18405,3,135,1395,94,3341,41
17605,9386,367196,1410,170081,1143411,197115
15746,7,618,1441,486,12024,132
51351,160,2030,769,1494,34168,536
5525,39,1019,1548,696,17026,323
13257,2,623,1476,273,12600,350
8053,120,2823,1517,1863,24685,960
16477,13,276,1429,231,19648,45
26828,101,2306,1237,1490,15138,816
49769,5,131,813,105,3766,26
14493,20,1641,1458,442,8330,1199
9307,351,6215,1511,4197,33498,2018
8207,1735,66652,1516,35209,175420,31443
48893,37,457,839,366,8466,91
44382,10,353,903,315,9126,38
8118,475,16599,1516,10111,64315,6488
27830,11,261,1215,230,24010,31
25882,548,9112,1259,6177,97773,2935
66931,42,441,293,396,9966,45
24143,59,981,1296,725,32287,256
33177,693,10860,1118,7000,97977,3860
53397,26,440,709,325,7255,115
56755,96,1953,606,1351,26428,602
11123,86,2250,1499,1269,20496,981
16110,83,614,1435,417,13222,197
41175,132,2252,949,1884,48925,368
33635,231,7110,1110,5000,74230,2110
14455,153,5402,1458,3972,30928,1430
11162,129,9152,1499,5254,53743,3898
69055,2,67,223,44,4219,23
41518,11,178,944,151,7965,27
24396,43,1135,1291,750,17430,385
34731,226,2994,1086,2311,29490,683
38124,34,282,999,243,8313,39
32191,28,425,1136,230,5038,195
31465,124,1917,1146,1431,25876,486
34881,739,11929,1083,9350,85803,2579
27983,200,14899,1212,3887,44607,11012
15754,15,506,1441,395,14527,111
26843,757,13770,1237,9391,60167,4379
7737,58,1765,1520,1255,71832,510
48549,48,651,849,564,7240,87
67689,17,291,268,232,6169,59
31175,67,1402,1151,913,14396,489
47255,47,515,869,453,10841,62
66100,9,168,319,139,4678,29
2370,225,7524,1584,4710,61211,2814
21695,635,17781,1337,7134,82289,10647
46474,35,492,880,371,7507,121
24720,55,1377,1283,871,24468,506
64055,80,1833,376,1700,26289,133
10609,68,3899,1504,2068,49452,1831
37171,54,1423,1025,1106,39278,317
7541,106,3788,1523,1931,61652,1857
2812,58878,2647433,1580,1009195,7181812,1638238
16478,127,2562,1429,1638,32878,924
8853,94,3922,1513,2065,37768,1857
18565,33,2446,1393,905,25258,1541
19584,18,536,1374,369,18873,167
26398,246,7839,1247,5200,89146,2639
23268,10,322,1313,255,9787,67
64514,55,689,362,374,9218,315
55420,66,895,644,692,16686,203
61114,177,2605,463,2472,38492,133
36845,161,3425,1035,2841,62751,584
6954,22,1476,1531,1085,18181,391
21606,171,3450,1339,2347,23438,1103
33295,73,1553,1116,1233,17749,320
24511,748,14605,1288,6601,115054,8004
31706,26,540,1143,407,10941,133
14547,472,18055,1457,8400,106240,9655
58465,175,2074,555,1643,30500,431
21828,495,11544,1336,7106,57985,4438
33505,27,559,1112,349,7154,210
300,419,17055,1600,8718,102056,8337
227,149,8783,1601,4314,44331,4469
50951,53,460,783,391,5867,69
25648,165,4246,1263,2090,58532,2156
19410,30,1983,1377,1468,20516,515
58870,28,254,542,224,9325,30
26326,1244,30457,1249,15999,189726,14458
25078,77,3025,1275,1557,23833,1468
27316,317,7881,1227,5173,53527,2708
58479,5,82,555,57,7049,25
58552,167,4220,552,2282,33968,1938
54082,96,1569,686,1157,23591,412
41138,25,500,949,406,7556,94
44282,31,683,904,566,14513,117
54640,36,471,667,466,12764,5
32993,67,859,1122,650,6605,209
4224,6,483,1566,302,7115,181
800,100,3903,1596,2223,21292,1680
36253,52,1095,1049,655,13618,440
28688,717,18033,1199,9677,131846,8356
29899,71,1744,1175,1112,17818,632
25613,34,772,1264,527,10522,245
44536,22,702,901,326,11481,376
67138,13,232,286,187,6250,45
58175,7,64,566,62,5430,2
11766,56,2616,1494,1085,25782,1531
6180,13,231,1541,172,13303,59
17699,2387,63762,1408,39692,386605,24070
22734,35,669,1322,555,16557,114
35296,14,756,1071,389,11213,367
68641,6,94,236,83,6115,11
21630,80,2269,1338,1470,39095,799
48529,29,510,850,361,11722,149
32813,2197,44266,1125,35892,213193,8374
3298,46,1592,1575,856,10231,736
33504,1569,39003,1112,27592,242538,11411
18447,7,320,1394,191,12437,129
50156,38,570,803,568,18392,2
26421,31,1908,1247,1066,25502,842
8699,49,2597,1514,1293,18239,1304
65257,51,533,341,494,8635,39
60519,33,371,485,295,4889,76
52992,65,519,720,422,6585,97
39963,4,98,968,90,6229,8
24763,4,156,1282,136,12358,20
36403,53,873,1044,787,26725,86
32831,5,384,1125,167,3995,217
32843,17,383,1125,257,10305,126
37111,137,3027,1026,1997,82223,1030
43837,256,3532,909,2913,16943,619
26982,4,104,1234,79,4313,25
28104,88,3105,1210,1627,18301,1478
17385,83,2378,1414,1708,24646,670
16967,5,247,1421,170,7540,77
56159,4,43,623,34,4532,9
10885,39,899,1501,635,17128,264
51677,8,82,763,61,2770,21
7696,2408,39502,1521,20772,164115,18730
23009,31,1031,1317,565,19488,466
8903,1415,41942,1513,30367,119041,11575
38373,58,963,993,847,10750,116
1339,392,13431,1592,8591,46690,4840
50080,174,3538,805,2770,86230,768
38524,390,9344,988,4132,29144,5212
31486,3,65,1147,45,5925,20
45919,557,6092,886,5641,45015,451
8797,41,1188,1514,683,16933,505
52070,434,5467,750,4795,38200,672
22822,30,905,1321,774,29389,131
54205,1206,12222,684,10492,95090,1730
12213,52,4299,1490,1675,32694,2624
52509,322,4118,736,3611,38616,507
61001,2,52,467,47,3597,5
5727,23788,780138,1546,378186,2322111,401952
29982,6,163,1174,105,3894,58
50540,173,1930,793,1619,22920,311
16635,162,3981,1427,2857,47251,1124
50525,168,2583,794,2188,38506,395
50376,7228,109436,798,91558,389936,17878
29807,43,785,1177,691,9983,94
48733,7,98,844,90,2479,8
61801,376,5039,441,3458,52901,1581
68833,1,14,230,9,690,5
57874,24,244,575,188,10394,56
18379,67,2235,1396,1392,44571,843
36877,22,493,1034,388,9549,105
6751,33,1065,1533,587,19595,478
56770,37,288,605,235,5572,53
35171,52,716,1075,577,17102,139
35605,101,2561,1065,2043,38992,518
30579,13,380,1162,255,13190,125
69653,45,457,203,401,5247,56
57004,9,168,599,134,7817,34
22900,2,205,1319,160,5847,45
13209,134,4757,1477,3232,58213,1525
58394,923,12364,558,11594,130942,770
57321,47,658,591,517,14927,141
64247,6,165,370,147,6926,18
13783,6,377,1468,214,8912,163
55436,76,1024,643,838,21032,186
53706,19,148,700,146,7438,2
35098,15,425,1078,287,13897,138
62282,14,300,425,263,9443,37
5493,480,6574,1549,4819,33435,1755
16507,30,1615,1429,1233,28110,382
45293,151,1637,893,1355,32752,282
48635,162,3174,847,2475,37085,699
11613,245,6980,1495,4195,31732,2785
33704,4262,90841,1108,54171,351248,36670
22725,45,1164,1322,724,15978,440
50020,37,357,807,324,6956,33
15819,40,1282,1440,909,40143,373
51044,53,390,781,349,9658,41
6838,17,339,1533,232,9676,107
50065,5490,164260,801,101290,1166514,62970
57484,21,239,587,168,4218,71
37514,680,14718,1015,12541,36607,2177
4033,288,13404,1568,7257,49804,6147
60881,14,181,472,133,5583,48
34172,17,1070,1099,530,12892,540
10425,44,1830,1505,1052,15176,778
12142,40,1858,1490,821,30497,1037
28597,11,262,1201,184,4019,78
9561,11,1299,1510,870,13604,429
44883,223,4717,897,3765,50515,952
64561,113,2131,360,947,21420,1184
16887,4029,75643,1423,42876,170272,32767
32619,189,6210,1129,3932,30624,2278
18242,18,899,1398,647,19301,252
12278,19,1089,1489,523,9232,566
27816,62,1476,1216,915,22189,561
30806,7,494,1157,318,11646,176
45739,49,759,888,595,7337,164
49093,4,111,817,94,2254,17
64146,2,39,373,32,8979,7
14929,111,5085,1453,3488,80792,1597
18964,104,2406,1385,1674,29147,732
61705,32,519,444,476,8032,43
18746,22,565,1389,491,8353,74
33720,80,1491,1108,894,17439,597
13897,40,1351,1467,818,45195,533
1597,123,6846,1590,3761,81704,3085
19518,59,810,1376,610,12358,200
63654,15,155,388,147,3240,8
33047,29,452,1121,263,5975,189
3351,10,583,1575,298,22639,285
24229,4,247,1295,172,6026,75
52869,13,113,723,82,5624,31
24223,192,3723,1295,3196,63064,527
33983,29,694,1103,414,16464,280
17569,73,2987,1410,1946,28124,1041
23406,60,1453,1311,1144,18963,309
3835,53,3107,1570,2137,21539,970
56226,11,81,621,69,3134,12
30103,11,404,1171,237,8796,167
29257,8,184,1188,121,11043,63
17882,9,339,1404,226,5900,113
14894,109,1134,1453,841,17989,293
56511,9,188,613,143,9183,45
25458,6,190,1268,126,5722,64
23698,6903,127398,1306,95722,332930,31676
11254,76,3598,1499,1533,57002,2065
48576,53,1044,848,1032,13842,12
53358,48,354,710,313,9160,41
38449,151,2537,990,2137,40673,400
34745,58,2496,1086,899,24311,1597
32523,587,15542,1130,10818,45428,4724
27053,2348,47708,1232,28814,166584,18894
22296,319,8989,1330,7019,88856,1970
62632,34,247,414,190,12327,57
8187,72,1613,1516,1059,15898,554
29460,107,1927,1184,1013,20692,914
1309,44,1473,1592,1074,25477,399
37347,11535,196242,1020,132789,724895,63453
57368,7,184,589,146,4298,38
5133,110,4293,1553,2682,41060,1611
36882,27,394,1034,217,5261,177
31446,2,111,1145,75,2602,36
54116,897,12926,687,7951,88365,4975
40308,70,1396,963,1067,23414,329
23191,19,537,1314,470,37842,67
53192,419,3207,714,2392,50361,815
62421,39,428,421,409,9805,19
3985,40,857,1568,511,15792,346
970,5,309,1595,150,12631,159
39025,13,190,980,138,5758,52
2249,61,4081,1585,2337,43303,1744
18218,2,120,1398,100,9511,20
29047,182,5554,1192,3694,71919,1860
9150,54,812,1512,643,8866,169
13584,16,1212,1471,733,50348,479
3257,21,491,1576,285,36155,206
32881,45,1258,1124,898,15877,360
65829,49,475,327,444,11730,31
25113,5457,118634,1275,72998,620146,45636
51773,7,167,760,114,11971,53
5367,9,227,1550,175,6221,52
63833,2,84,384,66,3707,18
33910,3,161,1105,136,12408,25
20847,19,880,1353,551,14134,329
59228,228,1879,531,1508,20721,371
33661,5660,101895,1109,64546,465326,37349
14086,14,508,1464,329,12472,179
20446,10,175,1359,123,7786,52
22553,27,717,1326,532,8908,185
31659,27,410,1144,351,7754,59
54703,2523,34797,665,21569,253799,13228
8770,6,229,1514,137,6619,92
1991,0,2642,1587,1744,40614,898
49480,5,103,821,84,3006,19
33091,185,10994,1120,5701,44505,5293
64033,35,299,377,286,4057,13
37698,45,1007,1010,728,16326,279
51595,32,349,765,258,3963,91
43813,6,58,910,53,6700,5
14945,18,909,1453,662,15232,247
12944,1044,92914,1480,45225,313808,47689
39621,21,380,973,321,7468,59
53862,57,524,695,498,9704,26
57562,100,1919,585,1425,14104,494
11145,45,1464,1499,673,24934,791
51454,113,977,770,845,16512,132
8579,576,12659,1515,8023,135596,4636
16840,8,280,1423,209,16341,71
53219,5,84,713,68,4285,16
44943,101,1380,897,1265,10715,115
41031,20,814,951,722,28725,92
21301,12,369,1344,205,11210,164
27489,3426,96428,1223,55513,354245,40915
7816,1,116,1519,77,25891,39
16609,12,340,1427,223,6085,117
10997,38,2970,1501,1768,29167,1202
7717,13,799,1521,590,40054,209
61335,56,472,455,417,23103,55
56121,69,1078,624,989,13895,89
32663,20,278,1128,151,7525,127
55154,558,5530,651,5071,99411,459
30740,41,696,1159,632,31111,64
15867,3,157,1439,112,4222,45
37832,74,1261,1007,935,12463,326
34062,60,1666,1101,987,13680,679
964,42,2997,1595,1719,66131,1278
52102,571,7188,750,6892,108549,296
14826,45,805,1454,681,18250,124
70567,17,360,172,350,6596,10
27224,13,555,1229,414,7044,141
40372,312,4190,962,3915,46455,275
64481,0,36,363,36,1216,0
26851,4661,53875,1237,37709,213993,16166
14433,304,9527,1458,6871,47410,2656
67324,50,472,280,376,8324,96
23246,1178,33248,1314,21661,246385,11587
25697,8,86,1262,72,8746,14
30154,903,18456,1170,10649,61292,7807
56929,175,2630,601,2495,31063,135
30119,133,3863,1171,2183,18049,1680
37155,39,692,1025,463,10804,229
39754,12,201,971,176,14642,25
53729,226,2198,700,1841,15633,357
35320,61,905,1071,714,106885,191
8321,118,3199,1516,2040,18146,1159
11281,46,2468,1498,1438,37120,1030
59477,1730,41830,522,31918,187316,9912
629,3,206,1597,155,11541,51
27366,12,221,1226,141,6929,80
9334,142,5105,1511,3322,59805,1783
7081,50,1511,1529,936,14386,575
18333,234,6703,1397,4834,36059,1869
56113,132,1325,624,1163,16623,162
13512,259,3294,1472,2253,67228,1041
12555,313,6654,1485,5203,49470,1451
11978,23,1209,1492,611,12117,598
32095,27,396,1137,327,19116,69
24641,673,15822,1285,12023,94789,3799
10685,33,1797,1503,1152,14355,645
58523,342,5337,553,3613,81531,1724
21033,83,2496,1349,1964,45150,532
30189,1321,45910,1169,22450,355345,23460
23116,10,316,1316,243,11579,73
40007,3,48,967,44,2478,4
59271,147,5533,529,3585,67513,1948
31808,4,144,1141,105,7522,39
22934,28,562,1319,387,28025,175
60467,1,25,487,15,3344,10
22084,531,15316,1332,8195,92228,7121
29063,473,13188,1192,6223,88428,6965
2975,388,8772,1578,5960,35687,2812
2597,89,2400,1582,1524,27537,876
4649,7,449,1560,316,9285,133
11055,134,4886,1500,3216,69106,1670
65584,800,15917,333,11835,124111,4082
62905,29,382,408,351,4016,31
49213,12,320,828,200,8575,120
22765,14887,323623,1322,218316,889991,105307
19216,11,332,1381,223,6744,109
44649,32,987,900,556,17022,431
30655,192,3176,1160,1843,26697,1333
36285,49,771,1048,486,10621,285
15347,85,1561,1447,955,30596,606
38481,24,818,989,627,12792,191
30230,16,585,1169,488,11279,97
26059,859,17745,1254,12821,90906,4924
25550,19,323,1266,206,10499,117
29490,274,4246,1184,3284,25332,962
30266,93,1595,1168,1013,20290,582
60423,148,4405,489,3893,43302,512
63941,18,225,380,214,5827,11
62595,90,1265,416,1257,18492,8
47420,12,451,867,332,9761,119
51776,41,370,760,276,6825,94
451,1,285,1599,186,11082,99
12308,10130,250468,1488,144816,749324,105652
37865,10064,237832,1006,138766,795940,99066
49149,7,102,831,66,5285,36
24036,45,1599,1299,1106,32273,493
37541,6,213,1014,176,17448,37
62660,15,158,414,137,12028,21
37212,27,678,1024,549,19063,129
10938,352,17803,1501,8602,96219,9201
26209,5,355,1252,196,6007,159
62030,5,142,433,98,9811,44
10151,53,1940,1507,919,14078,1021
31681,40,1109,1143,862,19236,247
16705,122,3911,1426,2672,30313,1239
8472,95,2977,1515,2045,24172,932
54377,1549,21465,678,15273,120595,6192
55504,33,294,642,216,7345,78
50623,86,1420,792,1326,21714,94
43201,4,97,916,42,2222,55
38198,6,128,997,112,15717,16
20220,13,510,1363,306,8711,204
37181,570,15149,1024,7170,39165,7979
46022,15,457,885,370,10475,87
49150,182,2978,831,2410,31283,568
36556,26,701,1039,548,13982,153
1395,4790,198654,1592,107402,496648,91252
1402,174,7600,1592,6343,65701,1257
34594,3,90,1090,67,2530,23
61581,4,101,448,77,3246,24
8363,10,332,1515,245,11427,87
69,252,13441,1604,6650,151898,6791
65143,41,866,343,640,8884,226
38309,6,273,995,230,7988,43
53827,28,465,697,409,12052,56
55859,223,3030,632,2581,23754,449
301,114,3047,1600,2150,18483,897
43065,14,333,918,271,6935,62
14564,156,5856,1457,3764,31569,2092
53589,540,7134,705,6321,33235,813
37685,5,225,1010,178,4558,47
2664,41,1267,1582,888,30088,379
22971,934,19372,1318,11297,172908,8075
39855,23,764,970,649,18515,115
60936,16,145,469,141,3774,4
20461,92,2947,1359,1973,21976,974
23288,3,51,1313,31,2366,20
31148,156,2502,1151,1857,26016,645
14315,4,51,1461,34,6299,17
33310,127,2767,1116,1743,24506,1024
25609,27,888,1265,503,13383,385
27017,43,2273,1233,1140,23596,1133
38568,42,563,987,402,18983,161
32988,1337,34485,1086,14517,285529,19968
56364,1,56,617,37,4389,19
62432,1,34,420,25,4224,9
36488,70,536,1041,414,8391,122
60900,79,717,471,622,5726,95
318,4432,141158,1600,72439,429220,68719
24703,14,1187,1283,657,34494,530
63001,22,317,406,236,6310,81
13557,58,1996,1471,952,19322,1044
10045,286,5032,1507,3139,36965,1893
19915,4,171,1369,127,11641,44
28515,1222,32072,1202,16022,169684,16050
10229,126,4208,1506,2732,30503,1476
2458,111,2700,1583,1412,23309,1288
64569,34,399,360,372,6899,27
31460,44,837,1119,571,12179,266
53206,271,2623,713,2041,20847,582
27461,7,138,1224,84,5165,54
63104,2,62,403,48,4070,14
32613,172,4315,1129,2381,30075,1934
24702,258,7972,1283,5107,174514,2865
9833,45,2597,1509,802,43594,1795
50374,0,44,798,39,4456,5
22209,38,1522,1331,916,21308,606
23466,16,999,1310,832,24821,167
67868,13,277,262,206,6912,71
28157,2,48,1209,35,4226,13
48946,19,174,837,152,8616,22
48490,70,1753,852,1166,18276,587
36126,31,351,1053,272,8973,79
33938,27,504,1104,359,9376,145
67524,614,13039,273,11058,114329,1981
51193,23,347,776,275,15145,72
6370,19,607,1539,407,30739,200
53575,173,1565,705,1234,10580,331
35981,12,314,1057,273,4142,41
60480,9,114,487,97,2747,17
50149,13,288,804,274,20010,14
42708,101,763,924,674,13494,89
69222,268,4339,217,4290,48998,49
24225,7,252,1295,222,22977,30
44049,202,2609,907,2349,16053,260
445,62,1942,1599,1332,28893,610
55311,19,156,646,126,5640,30
29812,0,0,1177,0,12701,0
41053,210,2406,950,2019,18642,387
60686,22,217,479,143,19806,74
7447,31,675,1524,469,13279,206
41700,16,524,940,386,8523,138
26966,42,1063,1234,625,11184,438
12171,121,3324,1490,1796,23083,1528
61522,36,373,450,294,4820,79
10275,9,701,1506,463,18340,238
53437,19,187,708,152,5018,35
6224,197,7811,1540,4543,18460,3268
11637,52,1189,1495,770,9754,419
13506,440,22296,1472,8444,127792,13852
67426,9,34,277,34,1448,0
62831,27,341,410,334,5591,7
57803,14,124,578,102,3640,22
28921,413,10171,1194,5225,60324,4946
17344,59,1041,1415,757,25654,284
41618,37,592,942,513,15709,79
55332,130,1255,646,942,27260,313
33987,81,1860,1103,1265,28004,595
40721,85,1581,957,1285,19882,296
33647,401,7523,1109,5424,62665,2099
12264,1,518,1489,169,17278,349
49162,334,3501,830,2644,29793,857
53271,18610,264842,700,195877,1278321,68965
11318,4351,580251,1498,183041,1935747,397210
15866,6,487,1439,311,9336,176
48640,58,1335,846,916,35717,419
8551,46,1817,1515,1004,25200,813
45369,59,2023,892,1195,24593,828
23302,117,2358,1313,2043,20159,315
7708,175,3408,1521,2459,23218,949
43457,125,1388,913,931,17419,457
56118,5525,97513,624,83715,429789,13798
35877,78,1942,1059,1342,26196,600
49142,19,336,831,205,7701,131
38010,10,41,1002,41,1812,0
8558,17,642,1515,414,11242,228
34283,14,747,1097,477,19298,270
14748,8,556,1455,370,11647,186
17868,50,1520,1404,1029,27305,491
23733,1029,25312,1305,18336,183403,6976
11021,149,2969,1500,1928,22309,1041
34670,137,2181,1087,1481,35003,700
9498,37,733,1510,500,16038,233
19110,66,3366,1383,2396,35963,970
59565,103,966,517,930,15146,36
47736,55,642,863,523,9220,119
4144,19,772,1567,498,27637,274
44167,463,6564,905,4434,65709,2130
15482,0,0,1445,0,14187,0
17133,339,7848,1418,5197,90156,2651
37100,321,5871,1027,4693,36881,1178
51202,263,3644,776,3552,24647,92
14067,1572,55170,1464,33746,351579,21424
36370,388,4634,1045,4204,57724,430
38025,753,14784,1001,10629,211578,4155
29662,1005,23897,1181,16345,186090,7552
35676,59,699,1064,563,10707,136
22158,52,1377,1331,977,21866,400
33166,21,540,1119,271,5937,269
31241,1,61,1150,47,3131,14
60225,23,462,495,396,16502,66
6692,2359,105969,1534,56067,244171,49902
26399,20,2095,1247,993,25221,1102
13796,77,1354,1468,904,12084,450
42128,8,340,933,209,8263,131
3648,19,1325,1572,785,13629,540
49018,9,340,834,278,12759,62
52531,35,447,735,353,8193,94
72,159,4753,1604,2227,58800,2526
40465,56,761,960,625,13540,136
25061,89,3138,1275,2080,19852,1058
37103,2,71,1027,53,6012,18
35117,9021,241302,1077,118380,855097,122922
12704,13,493,1484,259,13113,234
26286,328,9329,1250,5205,103831,4124
13291,13,604,1476,179,11217,425
24572,98,3737,1287,2374,39430,1363
3512,78,1897,1573,1215,79086,682
62733,174,2061,412,1453,35557,608
28006,2,41,1211,31,7848,10
28328,50,1387,1205,964,9942,423
17262,801,20970,1416,14159,65514,6811
60499,47,454,486,425,6453,29
40445,8,208,960,163,7840,45
60932,15,203,470,171,9264,32
23670,59,945,1306,740,34368,205
67506,0,15,274,13,4275,2
3768,3,61,1571,49,6391,12
51703,2136,36224,762,28368,197276,7856
283,994,29800,1600,19588,311397,10212
24629,0,16,1285,13,5444,3
63633,18,144,389,112,3870,32
58333,1607,39829,560,27548,203747,12281
1199,69,2063,1593,1499,25284,564
52132,4,36,749,32,6767,4
41621,16,444,942,366,7854,78
54957,97,1607,657,1232,18794,375
63051,166,5403,404,3406,42777,1997
59887,38,366,508,331,6679,35
26057,8,167,1254,103,11843,64
52225,21,211,746,189,4045,22
25704,34254,708398,1262,394282,2428183,314116
33521,1131,18907,1112,13104,101073,5803
60243,673,9426,495,7794,83219,1632
22534,101,3147,1326,2038,34051,1109
26667,49,1090,1240,622,11412,468
59633,6,50,517,37,5104,13
58480,5,56,554,48,4995,8
52683,510,6502,729,5366,55605,1136
9916,157,3116,1508,2160,46105,956
59580,110,1586,519,1468,22903,118
35290,71,1054,1073,851,15916,203
30956,17,756,1155,426,6801,330
38058,63,523,1001,462,11865,61
7353,72,1581,1526,1039,29849,542
24565,1344,140497,1287,24499,345040,115998
20630,43,1610,1356,1019,17735,591
61240,37,731,448,650,7198,81
52965,11,321,721,183,8382,138
30255,14,565,1168,359,26539,206
12977,52477,1312796,1480,662916,3457216,649880
28187,174,5964,1208,3437,28554,2527
36865,555,13209,1034,7929,115038,5280
38988,9,184,980,141,4281,43
22147,30,668,1332,451,14412,217
23706,20,973,1305,656,13162,317
13363,743,23091,1474,14383,191391,8708
23479,30,689,1310,513,26167,176
37270,98,1420,1022,1117,18824,303
48779,8,236,842,198,7339,38
18214,158,6763,1399,4829,52529,1934
17461,102,2161,1413,1364,33103,797
49174,3,60,830,52,8200,8
29499,9,182,1184,125,15675,57
57251,39,701,593,562,14569,139
14392,1623,66861,1459,40704,401973,26157
20325,2,72,1361,62,5136,10
1950,2,87,1587,55,18171,32
17564,437,8140,1410,6377,46323,1763
27865,73,702,1214,541,7602,161
16043,233,4294,1436,3216,89922,1078
21459,3624,86743,1341,56708,339752,30035
16753,270,8441,1425,5519,62145,2922
52219,10,221,746,191,6280,30
46930,23,371,874,287,4692,84
68294,4,102,249,83,5452,19
64784,4,92,354,86,2199,6
51883,78,1115,757,828,12852,287
40672,17,563,958,394,11725,169
31452,106,2158,1142,1149,32728,1009
64022,33,554,377,449,10555,105
50425,28,503,797,426,10989,77
25516,2737,54564,1267,38823,186631,15741
68108,157,2450,255,1855,23059,595
30947,19948,464987,1155,240898,983769,224089
61048,210,2047,466,1932,18922,115
24964,15,509,1278,318,6993,191
41846,34,560,938,479,8491,81
55391,52,528,644,336,17228,192
43183,41,513,916,435,6502,78
57826,3,57,577,48,3669,9
53852,2,28,696,23,5080,5
62392,25,242,421,196,7135,46
3410,18,546,1574,329,13524,217
31903,18,509,1140,272,7864,237
58589,20,456,551,305,11987,151
3518,461,9382,1573,6668,66699,2714
36996,25,635,1029,542,16342,93
6527,3,65,1536,56,14069,9
52925,36,524,722,438,16007,86
12924,98,5229,1481,3011,27120,2218
66611,29,431,303,211,4611,220
2813,140,5019,1580,3072,27298,1947
38754,680,7918,984,6363,81038,1555
22906,4,177,1319,132,8764,45
3345,199,9603,1575,6588,111496,3015
58924,27,248,540,220,3485,28
53534,6,66,706,55,3117,11
21391,14,242,1342,196,16257,46
7891,92,5180,1518,3177,44614,2003
743,5760,153616,1596,94394,422649,59222
26277,7,600,1250,280,11488,320
31387,31,1150,1148,727,10563,423
26861,9,411,1236,214,10229,197
25535,108,2563,1266,1481,21073,1082
33042,61,1118,1120,784,7507,334
34115,333,21695,1100,10530,49758,11165
68547,17,307,240,259,5835,48
668,9,380,1597,268,14278,112
58363,2009,38721,556,22074,195068,16647
61576,36,374,448,279,8298,95
19108,76,2182,1383,1314,19235,868
55110,3,140,652,44,5722,96
20308,132,1825,1362,1173,12667,652
48296,84,1167,856,883,11159,284
12350,54,1707,1488,1157,21032,550
57605,11,161,584,147,9486,14
11786,1,239,1494,101,5050,138
21901,97,4519,1335,2685,20552,1834
38272,7,174,995,156,10843,18
10907,3,123,1501,82,5553,41
8736,16,830,1514,490,12717,340
2475,370,9960,1583,6193,103833,3767
50243,458,7223,801,4224,39013,2999
14424,110,3082,1459,2560,31549,522
24543,4060,116456,1287,51450,729021,65006
28967,3,183,1193,117,5685,66
24632,33,1286,1285,861,19322,425
38294,4,479,995,290,8962,189
28106,345,6553,1210,4579,62377,1974
38073,477,13242,1001,10811,149419,2431
49758,19,460,813,378,10503,82
67988,827,18804,259,15569,108692,3235
36976,54,519,1031,404,9875,115
44995,4,83,894,69,7803,14
55454,45,402,643,383,13754,19
47235,45,1051,869,836,18394,215
62548,44,1026,417,947,18700,79
4448,23,2085,1563,1050,41314,1035
42706,52,830,924,737,28733,93
19685,11,257,1373,229,21940,28
59167,12,174,533,151,7923,23
20667,9,277,1356,264,14301,13
19449,11,359,1377,275,8914,84
35642,6,169,1065,138,7702,31
51250,5,60,775,48,3180,12
49617,909,12528,818,12102,70530,426
25873,1613,41454,1259,23484,295559,17970
2723,3700,120143,1581,74113,270453,46030
63052,31,244,404,215,10366,29
27034,460,14507,1232,8469,135469,6038
54473,3250,44352,674,34201,287669,10151
13701,6,112,1470,72,4702,40
15170,16,449,1450,296,19614,153
769,11047,351043,1596,205742,1027293,145301
66261,3,67,314,58,5327,9
2567,6,501,1582,376,27120,125
56802,5,34,604,34,9299,0
41405,309,2547,946,1959,27047,588
59178,9,62,533,51,3969,11
28824,41,1920,1197,1260,17063,660
56452,86,997,615,818,11702,179
48287,9207,140912,856,93709,418181,47203
57278,30,614,592,462,9892,152
56853,3,57,603,44,2735,13
61271,146,2097,457,1536,43709,561
59528,38,363,517,302,8607,61
61871,114,1123,438,1069,14257,54
19101,62,1179,1383,816,19438,363
34391,73,1509,1095,1065,16693,444
54847,25,226,660,167,5000,59
55512,29,424,641,274,9696,150
46585,613,8217,878,6571,104458,1646
66644,4,129,303,129,2941,0
37225,7,97,1023,76,5422,21
701,48,2919,1597,2002,49702,917
1634,31,1344,1590,501,44936,843
8833,25,1024,1513,697,14804,327
32423,28,500,1132,339,25788,161
11765,16,711,1494,331,5472,380
50123,346,6421,804,4967,81308,1454
58671,11,153,548,130,5504,23
2367,14,449,1584,339,9954,110
64088,55,740,374,712,18800,28
27475,7,463,1223,248,8367,215
57944,145,932,573,772,17010,160
37216,22747,464363,1024,288143,2779096,176220
30750,13,806,1158,451,14038,355
42632,28,356,925,280,6145,76
48081,126,2592,859,2258,26715,334
53228,915,8395,713,6059,65386,2336
20809,479,12338,1353,8987,131004,3351
11366,35,1770,1498,957,11706,813
32549,33,1072,1130,739,21313,333
9572,216,4471,1510,3211,34198,1260
56349,155,4220,618,3615,37772,605
64215,560,8701,349,6192,94993,2509
24828,5718,234758,1281,96007,1224603,138751
13697,91,2967,1470,1919,29745,1048
24654,10,428,1285,287,10256,141
56578,47,582,611,510,7534,72
51136,3579,88205,778,41901,1025629,46304
4365,35,1837,1564,388,21481,1449
44704,7,104,900,89,4235,15
38026,41,988,1002,706,28088,282
67794,16,90,265,80,2713,10
13986,303,12393,1465,7269,97188,5124
22124,1227,11577,1332,9782,54754,1795
35319,34,378,1072,265,7179,113
31233,27,711,1150,622,17069,89
31768,17,383,1142,241,5774,142
30352,161,11503,1166,4806,54621,6697
53442,10627,221049,708,120708,1089763,100341
10086,33,1405,1507,862,15411,543
33263,320,16523,1116,4870,73579,11653
9786,49,2878,1509,1738,39035,1140
20405,14,402,1360,238,13810,164
6559,66,1612,1536,1122,13758,490
6956,522,7833,1531,5190,61239,2643
66180,23,182,316,166,3323,16
16780,29,1230,1424,861,25151,369
8536,16,1030,1515,638,14607,392
21132,631,9296,1347,5253,35178,4043
66909,2,55,293,54,4089,1
56719,22,283,607,203,5045,80
41263,18,81,948,62,5916,19
5737,5819,148654,1546,89679,906699,58975
823,1435,78782,1596,46835,316720,31947
55384,11,182,645,150,9112,32
35825,5,127,1060,102,4177,25
1886,13,684,1588,459,16371,225
64682,6,52,357,42,3467,10
46205,596,20227,883,12305,57130,7922
65893,96,1650,325,1643,37447,7
2927,47,1504,1579,967,74632,537
14585,38,1294,1457,995,36992,299
9532,43,1031,1510,680,12163,351
40533,4,157,959,125,8176,32
22103,41,557,1332,420,17168,137
5309,196,5746,1551,3947,99805,1799
22938,74,2068,1318,1426,22011,642
39119,126,1064,979,924,18526,140
11010,532,18900,1500,10681,114048,8219
41752,41,444,939,291,5714,153
38108,53,521,999,483,17818,38
50246,1619,24556,801,20954,68121,3602
28574,32,832,1201,654,8557,178
53246,189,1656,712,753,11417,903
21327,31,594,1344,270,9789,324
12559,587,27336,1485,15138,227832,12198
27013,35,1054,1233,966,38924,88
57724,16,126,580,94,5624,32
54535,976,32091,672,14459,165186,17632
58907,107,1723,541,1261,17053,462
21885,1,112,1335,81,5260,31
36717,15,515,1037,414,15323,101
19826,6872,272619,1370,98534,780025,174085
50649,317,4440,791,3752,73245,688
60625,2542,48733,481,31299,323372,17434
34989,23,634,1080,480,13575,154
756,23,774,1596,525,17070,249
62076,107,1718,431,1348,29726,370
54274,4646,49740,681,33035,203028,16705
1822,181,4381,1588,3220,26471,1161
32360,61,3362,1133,1334,21830,2028
53471,282,4096,708,3835,33837,261
54342,51,489,679,462,12965,27
8574,27,1572,1515,714,14128,858
29857,45,839,1176,488,8367,351
25146,548,14292,1274,8968,67286,5324
3606,538,10334,1573,7397,81495,2937
6593,102,2761,1535,1867,31035,894
20460,1252,33881,1359,19648,249085,14233
6261,192,6828,1540,4100,66425,2728
8054,73,1468,1517,981,14111,487
4561,102,5214,1561,3100,41436,2114
7072,24,345,1529,218,10468,127
20866,142,3125,1352,2280,34496,845
41786,303,4259,939,3174,70076,1085
66113,765,9792,319,8790,63277,1002
14699,24,979,1456,708,12874,271
27124,20,402,1231,261,5893,141
22878,1091,33113,1320,20892,221395,12221
23239,50,1018,1314,768,23860,250
26052,7,359,1255,260,34144,99
55835,7,39,633,25,3432,14
58582,11,155,551,122,10328,33
18008,9120,244414,1402,119490,1442087,124924
39562,21,544,973,418,10737,126
14184,0,0,1463,0,13215,0
16427,7,277,1430,178,11493,99
24112,8,890,1297,535,19862,355
8276,101,6313,1516,2243,59335,4070
9486,609,11324,1511,7578,44126,3746
39274,9,218,976,167,7956,51
51114,8,138,779,129,11730,9
31369,75,1761,1148,1196,57192,565
241,16,1147,1601,837,84030,310
57458,3,58,588,48,4326,10
35611,8031,196850,1065,100030,585217,96820
14401,14,314,1459,214,8581,100
23025,23,835,1317,526,15404,309
42486,41,779,928,526,21116,253
38078,227,3828,1000,3234,29486,594
38237,226,3516,996,2798,22224,718
45946,12,140,886,109,3123,31
3656,54,3476,1572,1629,63102,1847
14055,280,20142,1464,8884,138790,11258
62832,18,227,410,211,3212,16
61280,20,243,457,226,4459,17
18466,4308,74857,1394,52444,310777,22413
38931,212,2283,981,1870,34662,413
26749,35,687,1239,557,31137,130
56935,150,2867,601,2465,17260,402
26954,5,242,1234,224,14641,18
4556,86,9682,1561,2224,35013,7458
18758,18,1714,1389,990,12187,724
17363,25,459,1414,364,17149,95
4835,81,3160,1557,2089,43252,1071
50894,81,1330,785,977,28966,353
34326,436,5548,1096,4825,71047,723
54002,27,307,691,182,8550,125
16803,31,847,1424,635,35012,212
17404,12,395,1414,277,9105,118
57473,6,92,588,81,4928,11
5526,871,38204,1548,23559,200467,14645
63071,14,193,404,192,3518,1
58157,63,1127,566,947,19757,180
68718,5,67,234,54,1693,13
2831,15,640,1580,347,23862,293
66850,2,15,295,15,1410,0
35552,216,3998,1065,3315,28683,683
35032,82,1126,1076,852,38725,274
35891,39,1362,1059,825,10575,537
19731,1,59,1372,44,11434,15
60819,46,1115,420,565,32805,550
25067,7,191,1275,145,8015,46
67043,80,2011,289,841,27625,1170
20287,205,9510,1362,4488,66435,5022
52681,1949,27242,729,19189,184477,8053
3868,197,4989,1569,2446,31540,2543
5468,260,12958,1549,4190,49129,8768
61826,3416,105690,440,65332,639866,40358
27060,8933,233704,1232,127920,1098153,105784
21280,28,603,1344,443,9428,160
21219,52,1337,1345,892,47087,445
28646,8,134,1200,90,6958,44
46067,4233,138014,884,36941,265702,101073
49576,102,1570,819,1456,22583,114
67168,6,252,285,178,16256,74
6193,33,1112,1541,743,12427,369
42034,59,1244,935,980,14971,264
1741,29,1672,1589,1097,22934,575
18425,259,4577,1395,2905,55388,1672
35871,0,41,1059,24,2553,17
7794,56,2726,1520,1939,62675,787
60540,8,156,485,131,8999,25
29708,428,5855,1180,3943,46357,1912
65705,133,2176,329,1995,16407,181
19590,29,547,1374,369,7202,178
28753,2,86,1198,73,6688,13
27223,30,752,1229,465,13445,287
34347,16,461,1096,390,25856,71
56141,13,128,624,103,4221,25
10506,1489,47768,1504,22737,298287,25031
53062,25,259,718,231,3378,28
13432,34,1296,1473,507,42052,789
39445,24,604,975,507,14522,97
9727,15,671,1509,351,9584,320
248,3822,146405,1601,75283,546076,71122
5532,2,52,1548,30,4907,22
11739,120,9181,1494,2318,26486,6863
13042,22,1057,1479,504,47771,553
24006,27,574,1300,416,15826,158
62238,1446,24940,425,22812,123620,2128
33290,47,1481,1116,621,16068,860
29103,66,893,1191,538,8702,355
36120,302,5671,1053,4401,75110,1270
28589,7,313,1201,200,5240,113
34772,109,2991,1085,2212,36494,779
20643,130,3390,1356,1766,38036,1624
25403,62,1261,1269,922,12304,339
30001,5,222,1173,159,29581,63
7125,45,1239,1528,706,15771,533
58074,139,1613,569,1130,24352,483
26604,17,710,1242,454,16457,256
57085,15,418,597,359,8391,59
59089,19,226,536,182,7251,44
23790,5247,144499,1304,82014,826860,62485
28661,20,758,1199,523,17514,235
18766,14,737,1389,570,22460,167
15602,44,2520,1443,1517,27585,1003
58100,1436,45466,568,25168,129240,20298
60418,22,268,490,254,8719,14
60094,6,47,501,35,5805,12
54608,22,658,669,385,25077,273
63830,3,69,384,67,2840,2
58788,1,37,545,34,4006,3
604,85,4335,1597,1698,35081,2637
38014,19,443,1002,304,3290,139
18881,4,137,1387,116,9791,21
29330,42,465,1186,393,10712,72
17332,104,987,1415,720,17714,267
7859,34,755,1519,484,11804,271
29388,71,2524,1185,2083,84403,441
23026,37,821,1317,606,15881,215
813,79,1706,1596,1126,26481,580
17903,3514,102243,1404,61902,224596,40341
24628,9,330,1285,214,4726,116
50142,99,1283,804,1162,16288,121
9998,7,585,1507,272,10466,313
45594,136,1967,889,1354,19747,613
508,33,1427,1598,984,35282,443
4516,3,82,1562,71,3628,11
18821,41,1220,1388,793,10244,427
31030,434,8935,1153,6753,46100,2182
48095,378,4600,859,4083,80996,517
9717,38961,1156063,1509,428661,4127655,727402
45065,49,651,895,463,15977,188
19381,4167,123162,1378,71587,381742,51575
36820,10,333,1035,208,18194,125
8022,38,1662,1517,1271,32202,391
5342,28,1463,1551,827,21194,636
11237,36,2196,1499,1225,51143,971
30914,60,1326,1155,1037,34565,289
50907,110,1153,785,931,8472,222
19026,122,3452,1384,962,26601,2490
25591,23,857,1265,522,6756,335
12319,6,245,1488,121,7086,124
5485,10221,332276,1549,183633,1419714,148643
17164,6,154,1418,115,12843,39
28631,5,119,1200,83,15032,36
12915,0,21,1481,13,3859,8
4792,47,1004,1558,651,9785,353
7065,44,1652,1529,1190,23073,462
14705,227,4866,1456,3403,23358,1463
32625,38,1400,1127,797,10096,603
33592,54,1056,1111,717,7110,339
15688,21,438,1442,366,9820,72
61833,46,658,440,632,13254,26
38743,42,760,984,753,11519,7
24798,171,3640,1281,1739,31066,1901
66671,346,7861,302,7256,118743,605
61538,174,5113,449,3437,67644,1676
50416,4338,87889,797,61156,450022,26733
60933,33,440,469,385,6607,55
37072,2,48,1028,42,3067,6
54468,41,214,674,165,4363,49
11764,7043,262456,1494,146652,1439585,115804
30044,42,750,1172,474,7183,276
61068,1368,24034,464,18570,79453,5464
57266,7,68,592,54,3903,14
38793,132,2726,983,1581,21755,1145
12020,18,897,1492,502,21367,395
10328,69,1666,1505,833,14655,833
58874,27,296,542,248,3476,48
35234,30,494,1074,356,7749,138
15792,15,686,1440,398,16921,288
25494,191,3989,1267,2738,38667,1251
22440,178,5395,1328,4080,33188,1315
28266,24,924,1207,626,15192,298
11566,140,8868,1496,4791,64828,4077
65129,4,27,343,20,5743,7
39284,8,110,977,94,2235,16
55071,273,3607,653,3236,36898,371
30912,0,52,1155,30,4033,22
2061,1033,29316,1586,18183,274227,11133
20255,45,1332,1363,944,9233,388
18345,583,12876,1396,9240,139865,3636
21668,10,349,1338,240,4775,109
607,132671,17112581,1597,2191130,21211530,14921451
25154,731,9074,1274,5927,48487,3147
34176,7,62,1099,61,3706,1
47911,22,300,861,260,19524,40
1269,2892,151381,1592,52964,729976,98417
55844,8,83,633,70,3743,13
42972,14,236,920,174,12868,62
57863,7,119,575,109,6735,10
65131,69,519,343,510,9369,9
6904,109,2053,1532,1573,84723,480
32943,208,3501,1123,1778,29873,1723
17508,9,297,1412,221,8214,76
26138,42,835,1253,547,20153,288
13263,82,1539,1476,1029,36688,510
66060,20,362,320,338,14275,24
37220,21,397,1024,375,17062,22
19739,0,71,1372,50,8537,21
41247,12,86,948,80,9143,6
10494,1597,56458,1504,26428,201179,30030
7795,5,230,1520,121,10396,109
44413,133,1496,902,1291,12563,205
45420,12,208,892,158,5581,50
3545,310,19523,1573,8460,99660,11063
26920,92,2007,1235,946,16021,1061
17777,113,1865,1406,1481,38225,384
35570,15,249,1066,200,5568,49
30576,27,1075,1162,594,24826,481
34105,259,6848,1100,5227,42609,1621
27176,1,88,1230,49,3556,39
67940,56,763,260,651,8623,112
46703,526,8859,876,7410,62439,1449
58338,2385,81185,560,42495,483419,38690
55343,8,85,646,77,8222,8
59662,11,88,516,67,9328,21
44136,213,3451,906,2502,31721,949
38326,15745,412335,994,202115,1906299,210220
36319,8,101,1046,80,6467,21
28984,142,6394,1193,3624,46877,2770
60626,104,1713,481,1169,16397,544
29329,2211,36362,1186,25128,220699,11234
5139,57,1448,1553,1029,34096,419
23819,4,194,1303,146,9048,48
57682,28,289,582,223,3554,66
1048,186,2727,1594,1744,13691,983
64149,48,606,373,496,15529,110
57838,11,118,576,104,4257,14
11307,346,8839,1498,4817,58511,4022
26974,27,681,1234,434,17610,247
32706,757,12326,1127,6513,120598,5813
68438,4,39,244,29,4734,10
17807,10,500,1406,383,18323,117
20747,67,3956,1354,2987,41078,969
55404,6,84,644,58,5558,26
16767,5,43,1424,33,4022,10
8327,49,880,1516,578,12664,302
37527,258,5696,1015,3752,24606,1944
61889,1295,29114,438,20381,148144,8733
14868,1,74,1454,47,7492,27
8279,65,2844,1516,2114,31407,730
58404,8,85,558,64,6410,21
6407,31,743,1538,527,26617,216
5104,14,753,1554,514,16357,239
48585,5,59,848,47,4174,12
22148,54,1397,1332,735,19581,662
19554,69,1485,1375,1014,22775,471
61570,16,184,448,142,6133,42
39549,8990,157353,974,94828,889895,62525
14890,49,1041,1454,573,45189,468
7315,3428,85155,1526,58154,196415,27001
11624,25,2105,1495,896,21552,1209
68256,288,5949,251,2085,49095,3864
55983,94,1839,626,1218,14806,621
29615,21,518,1182,208,6331,310
8233,53,1298,1516,1045,26545,253
38808,26,281,982,216,5482,65
40343,152,2259,962,1808,28792,451
1570,30,503,1590,363,12706,140
68473,5,90,243,90,4751,0
31074,0,0,1152,0,62007,0
55189,171,2080,651,1886,26245,194
12425,575,24994,1487,12585,116042,12409
36986,6,211,1030,184,4399,27
14168,2,128,1463,92,7099,36
41905,20,297,937,191,5152,106
55552,401,6081,640,5367,55566,714
40755,84,2793,956,1675,60964,1118
37660,2642,42368,1011,35039,187189,7329
53051,3,143,718,121,2830,22
17995,12,1018,1402,525,23142,493
5142,244,7023,1553,4801,30109,2222
18920,79,2412,1386,1849,16217,563
23539,27,460,1309,367,19863,93
32241,16,291,1135,185,6844,106
13409,26,456,1474,300,21791,156
57353,7009,415657,590,130431,920800,285226
30187,67,1246,1169,747,26103,499
67487,24,355,275,292,9639,63
64579,14,223,360,217,4242,6
7734,62,2193,1520,1476,28115,717
16016,38,1533,1436,1290,21486,243
43345,411,9161,915,7572,88254,1589
54426,643,7183,676,6736,61285,447
20146,41,1247,1364,744,18967,503
16628,82,2832,1427,1587,49928,1245
17065,67,1346,1420,1083,33667,263
15057,18,789,1451,590,54482,199
24974,308,8279,1277,5173,72112,3106
5011,3,154,1555,105,9535,49
65044,2256,33720,345,32025,241086,1695
4396,2,133,1563,103,10785,30
67328,8,299,280,254,6684,45
18200,18,400,1399,313,6935,87
717,6,512,1597,345,6020,167
61567,10,66,448,61,1883,5
54772,31,231,663,176,6991,55
32430,12,700,1132,421,17277,279
34693,231,3227,1087,2624,18500,603
54237,112,1645,683,1465,41409,180
50724,25,249,790,207,3527,42
16500,46,942,1429,755,25044,187
35725,33,313,1063,245,10904,68
7274,485,8643,1526,5789,40732,2854
43157,102,1171,917,968,18186,203
8072,89,4045,1517,2652,22723,1393
56622,157,1096,610,931,16385,165
5186,3021,93220,1552,50689,327911,42531
5560,66,1424,1548,994,27827,430
27800,13,367,1216,220,10051,147
17679,4,199,1408,141,11732,58
38818,8,151,982,124,5241,27
51119,41,593,778,500,8641,93
66994,18,247,290,182,5217,65
2986,117,3596,1578,2376,39812,1220
57665,403,4051,582,3456,29203,595
5766,16,478,1546,340,23438,138
10300,120,7204,1506,3524,44734,3680
61640,12,106,446,98,5835,8
8737,8,378,1514,259,59153,119
54269,10,201,682,140,7609,61
6581,6,262,1536,126,19751,136
36857,11,336,1035,266,8305,70
34878,142,1542,1083,999,19779,543
36701,1935,24845,1038,21860,75681,2985
36244,15,154,1049,146,8957,8
12451,3226,114332,1487,66008,225053,48324
62252,1312,27977,425,21348,167043,6629
59253,263,3131,530,2405,32376,726
17281,10,377,1416,290,6854,87
52378,81,723,741,668,16225,55
1373,32,948,1592,667,13272,281
29920,10,228,1175,156,11612,72
8395,2079,91708,1515,47982,231611,43726
28345,26,931,1205,643,15747,288
29569,37,1177,1182,578,10650,599
33431,9,320,1114,176,4948,144
20543,170,5804,1358,4215,39697,1589
40075,14,149,966,124,5082,25
25451,2004,86809,1268,43882,492204,42927
56931,552,9260,601,8372,69833,888
17483,385,6312,1412,4714,45155,1598
37352,15,500,1019,366,12667,134
14819,16,642,1454,491,23869,151
49557,187,1924,819,1752,9109,172
58004,348,5959,571,3950,40282,2009
44928,71,1264,897,950,13644,314
50744,76,1022,789,853,13754,169
68995,17,447,224,399,22999,48
29604,16,858,1182,551,19125,307
7316,79,12440,1526,2431,50742,10009
41580,872,11490,943,8838,62969,2652
9638,92,1938,1510,1277,26844,661
65278,252,847,340,587,29441,260
63151,28,281,401,258,5795,23
39996,2,132,967,106,9319,26
4708,17610,638698,1559,280959,2746521,357739
48530,7,90,850,62,10185,28
16085,210,5674,1435,3521,62305,2153
59842,136,1973,510,1568,26247,405
64861,1,23,352,19,2400,4
35574,20,495,1066,391,10987,104
60799,186,4812,475,3933,39028,879
24538,44,1635,1287,1099,44363,536
21217,8,399,1345,267,4861,132
43181,77,983,916,803,14289,180
54537,31,607,672,347,20848,260
55278,106,1225,647,1074,13111,151
17735,31,963,1407,661,13277,302
4573,28,1741,1561,981,23120,760
11525,645,26288,1496,16313,197614,9975
10323,64,1734,1505,1018,17970,716
48350,58,741,855,596,10168,145
23826,3347,37039,1303,29886,455198,7153
42522,1,35,928,22,1652,13
12404,40,1424,1487,969,13913,455
42900,22,447,921,354,15521,93
17514,40,756,1411,353,6809,403
31549,524,9097,1146,4981,48934,4116
5788,101,2509,1546,1769,27627,740
60190,62,744,498,618,13042,126
26466,3,200,1246,126,8204,74
49282,16,246,826,201,8818,45
63643,4,39,389,30,3561,9
26767,63,2527,1239,1517,47533,1010
63560,56,550,392,503,11535,47
54583,27,454,670,327,11669,127
53897,6,75,694,68,6536,7
14550,93,2310,1457,1654,37370,656
46364,128,1408,881,1220,19848,188
29779,119,2752,1178,1688,37992,1064
27225,11,260,1229,111,3893,149
6837,195,5348,1533,3957,36286,1391
37440,6268,229999,1014,97862,962222,132137
17077,3676,151722,1419,42243,793683,109479
28408,75,1096,1204,706,13612,390
25432,22,704,1268,474,13872,230
31817,165,2552,1140,1768,49631,784
17049,0,146,1420,117,6405,29
21130,31,1053,1347,744,31679,309
51693,58,1517,763,1051,12835,466
22291,97,1943,1330,1689,37679,254
54443,264,4577,675,3247,43393,1330
24537,340,18357,1287,8982,164505,9375
15776,2630,102452,1441,55951,495529,46501
29126,1,197,1190,121,7077,76
6136,232,5599,1541,3325,70617,2274
17329,1127,16461,1415,9934,68598,6527
56961,2521,41526,600,30865,183325,10661
34674,57,1443,1088,1079,19539,364
50944,15,161,784,144,3291,17
21663,124,4935,1338,2744,19608,2191
39821,2467,96500,970,43072,490896,53428
24374,29,956,1291,663,16525,293
37342,0,0,1003,0,5665,0
28086,14,184,1210,116,7023,68
20823,11,196,1353,157,10196,39
56731,1080,19300,606,14129,110221,5171
45869,229,2664,887,2348,20537,316
45545,292,5313,890,4614,37924,699
22406,70,3989,1328,2371,15075,1618
16169,21,281,1434,241,15514,40
25562,395,6569,1266,4391,50975,2178
983,57,1496,1594,1078,42765,418
9042,11,613,1513,342,33109,271
53406,4,46,709,32,1328,14
19069,1920,68376,1384,44270,305705,24106
29645,20,593,1181,348,10201,245
25612,203,5874,1264,3202,33635,2672
57192,56,626,594,513,20454,113
34677,42,675,1088,476,9712,199
10832,487,14267,1502,8874,49881,5393
60363,25,463,491,386,6956,77
57721,203,4265,580,2414,49776,1851
30507,3,166,1163,110,15417,56
8791,366,17003,1514,6587,278356,10416
12297,58,3190,1489,1963,43496,1227
63232,54,1103,400,1033,15997,70
58876,317,3884,542,3313,38782,571
58218,212,3048,564,1937,20027,1111
199,27,847,1602,666,25036,181
4582,250,15358,1561,4773,61006,10585
39027,38,781,980,481,10550,300
48623,53,562,847,493,9306,69
41866,62,1378,937,728,24159,650
5245,146,3488,1552,1945,31790,1543
2103,159,6268,1586,2385,66217,3883
25272,0,81,1271,53,6748,28
25607,10984,213979,1265,150976,573729,63003
51359,4,153,772,123,4478,30
29205,20,617,1189,357,9855,260
25845,22,1323,1260,815,13642,508
60129,29,715,500,497,17479,218
16318,5,203,1432,140,9738,63
64888,4,88,351,84,6832,4
35432,93,1842,1069,1462,21625,380
62093,115,1631,431,1252,20330,379
56008,15,170,626,142,6079,28
60351,28,431,492,426,5629,5
45150,33,329,895,274,11494,55
18204,1157,25215,1399,12013,185075,13202
64518,154,2971,362,2167,35522,804
20081,98,2220,1365,1640,36404,580
39643,46,624,972,463,14357,161
55032,999,12329,654,8885,60070,3444
57815,47,464,577,376,8634,88
59524,66,891,521,748,12202,143
25982,235,4693,1256,3383,51246,1310
59116,147,1697,535,1383,9611,314
9128,58,1963,1512,851,25845,1112
34816,45,441,1084,315,5148,126
34452,267,6918,1093,5362,67650,1556
79,160,7361,1604,4415,76889,2946
9153,657,25440,1512,14558,158560,10882
57010,77,1001,599,1000,18774,1
438,189,7228,1599,5305,48285,1923
1680,6,330,1589,245,29674,85
36832,306,6762,1035,3728,34226,3034
36387,32,1061,1043,771,14519,290
34927,85,1994,1082,1425,27198,569
57162,854,59589,594,19845,200200,39744
24729,16,534,1283,466,18300,68
22516,8,144,1326,100,5431,44
9530,14,645,1510,389,8655,256
21816,19,774,1336,434,15926,340
19040,12,332,1384,229,14173,103
23638,73,2041,1307,1435,52753,606
48886,10,190,839,154,8660,36
33329,60,1085,1115,718,25960,367
18768,7,454,1389,272,32265,182
3778,60,1405,1570,941,17458,464
51810,45,492,759,478,18406,14
69825,30,246,197,206,3441,40
9843,1087,30733,1509,22297,129488,8436
64868,9,294,351,98,5544,196
17395,10,540,1414,384,17339,156
29085,3747,76111,1191,46589,563552,29522
37625,36,819,1012,690,11524,129
39871,20,416,970,357,13127,59
69043,237,4296,223,2871,44590,1425
59071,66,482,536,437,8225,45
50932,9,242,783,159,8494,83
65022,473,1414,346,1181,70780,233
56111,581,4548,625,3535,42061,1013
65875,8,148,325,118,5004,30
27298,43,1536,1227,927,31997,609
58299,41,412,561,325,7357,87
63843,11,110,383,107,3228,3
32658,46,1969,1128,1185,24817,784
4957,33,1729,1555,822,29163,907
61707,17,188,444,162,4772,26
15786,2695,57621,1441,40375,184008,17246
18305,4,47,1397,40,2793,7
8971,231,11294,1513,3164,68299,8130
33249,808,13858,1117,10605,67034,3253
67359,672,11656,278,10507,98257,1149
38432,58,1099,991,766,19035,333
36036,2747,46128,1055,32500,319608,13628
29216,39,972,1189,692,47164,280
13925,40,1743,1466,1080,22669,663
11945,510,10440,1492,6478,94567,3962
584,109,2801,1598,2141,33220,660
40630,22,317,958,249,17766,68
4648,12,758,1560,423,13916,335
66609,219,3708,303,3408,37211,300
40729,122,1501,534,876,20665,625
42484,25,412,928,339,8874,73
60588,19,172,483,128,2915,44
54777,27,441,663,372,11830,69
21225,713,5329,1345,4208,37530,1121
1863,71,3010,1588,1930,111652,1080
21359,22,1074,1343,649,8559,425
18395,6268,143611,1395,95326,386384,48285
57890,1,46,575,37,1873,9
766,48,1695,1596,992,41099,703
32428,6,123,1132,76,7777,47
1666,13,408,1590,247,8995,161
5943,126,10633,1544,1719,49229,8914
36715,71,776,1037,694,8827,82
1108,345,14629,1594,9220,59072,5409
31297,322,5945,1149,4425,111926,1520
22427,40,761,1328,377,16086,384
28788,2339,70941,1197,45546,460691,25395
52920,11,184,722,157,8278,27
28158,31,1407,1209,871,22093,536
61414,5,42,453,42,2903,0
12608,3574,88373,1485,53289,162253,35084
46631,2,85,877,67,4030,18
35446,22,505,1069,377,11734,128
6312,76,2820,1540,1847,24649,973
36406,1376,19214,1044,16698,155236,2516
30635,21,704,1161,411,7149,293
21786,23,666,1336,445,17588,221
57965,166,2475,572,2280,36742,195
381,16,743,1599,434,32950,309
56550,63,593,611,495,6730,98
66093,12,96,319,91,4563,5
55639,0,65,638,40,3041,25
29586,128,1949,1182,1216,22716,733
59361,293,4832,526,3351,34103,1481
49873,17,357,811,314,5580,43
29118,165,4365,1190,3024,56279,1341
24357,21,507,1292,407,35657,100
27935,33,1062,1213,695,14281,367
28331,32,1299,1205,588,18233,711
27988,28,855,1212,529,11763,326
40369,123,2060,962,1045,43494,1015
61332,686,8606,455,7827,59522,779
5046,33,1927,1554,1101,58379,826
19955,40,1417,1368,1113,28020,304
14475,778,17787,1458,14078,161779,3709
51239,29,644,775,478,16269,166
32490,45,1911,1130,1296,29146,615
9305,11,368,1512,252,11010,116
25028,126,2309,1276,1967,51702,342
8046,42,415,1517,261,4541,154
13517,8,284,1472,207,5875,77
58568,231,2050,552,1818,22592,232
54705,147,1765,665,1364,20748,401
22150,57,2311,1332,1620,16580,691
4444,17,714,1563,328,10331,386
62211,30,401,427,387,12155,14
8087,114,1519,1517,1226,37728,293
21522,88,1978,1340,1360,24765,618
5859,167,3551,1545,2018,28265,1533
30221,270,2529,1169,1662,20724,867
50898,207,3858,785,2543,53529,1315
54389,13,175,677,168,11448,7
559,42,2301,1598,1440,34386,861
66014,7,141,322,76,1597,65
59053,737,18455,536,13136,123076,5319
14702,9,280,1456,201,14549,79
17485,4,147,1412,108,6735,39
27680,2247,99583,1218,46925,453440,52658
21344,792,15866,1343,11408,79797,4458
168,371,9721,1602,6920,97430,2801
63902,2245,29687,381,28196,159962,1491
11643,555,16054,1495,8880,113273,7174
58417,348,4012,557,3378,36581,634
8045,578,7706,1517,4812,73482,2894
31738,52,1749,1142,1141,31891,608
25491,27,295,1267,226,8691,69
8179,276,10201,1516,5466,35417,4735
48492,54,894,851,814,21947,80
3979,1987,64315,1568,35660,283594,28655
50055,10,149,806,119,11273,30
40735,39,694,956,492,22016,202
9732,29,882,1509,593,7183,289
10252,6,445,1506,237,7188,208
13,116,4262,1605,2196,54002,2066
9054,31,1170,1512,764,13377,406
2985,94,2421,1578,1310,23419,1111
34405,30,824,1094,639,9386,185
53336,26,163,711,149,25535,14
26392,62,2608,1247,1540,14996,1068
10755,255,7288,1502,3873,56873,3415
8119,16,356,1516,254,4014,102
27317,89,2104,1227,1668,17938,436
36417,281,4656,1043,3070,43172,1586
40841,106,2255,954,1920,26717,335
51780,406,3996,760,3231,21442,765
22457,14,502,1327,372,12469,130
54361,154,1507,679,1245,27295,262
49824,53,1006,812,880,20366,126
10226,61,1520,1506,1002,10947,518
33202,126,3824,1118,2758,53700,1066
19173,675,18889,1382,14088,222539,4801
17604,67,1545,1410,1300,22282,245
9681,119,5447,1510,3174,44884,2273
20265,227,4948,1362,3201,43681,1747
25095,1766,59316,1275,32932,383400,26384
6051,119,1798,1542,1359,41661,439
26877,3,68,1236,66,7187,2
56417,146,1498,616,1241,39259,257
21874,35,1324,1335,920,34818,404
14767,1755,63202,1455,31928,309412,31274
37354,82,2891,1019,2298,43698,593
23174,7,321,1315,238,7081,83
26808,16,374,1238,186,5303,188
50590,26,286,792,220,10242,66
47795,2429,38286,840,30426,273003,7860
64348,430,6643,367,5701,93023,942
16394,1910,58744,1430,36237,384300,22507
31573,22,322,1145,273,9354,49
39343,6,123,976,93,17837,30
10988,66,2272,1501,1425,66767,847
50871,4,68,786,63,2724,5
67038,2742,170026,283,75454,2345081,94572
13887,52,1737,1467,951,42428,786
21835,0,0,1336,0,7707,0
57033,5,141,598,130,12552,11
22954,2,96,1318,77,11507,19
41812,11,222,938,204,8551,18
23618,4,110,1307,92,4205,18
22726,149,2289,1322,1761,37033,528
16982,6,227,1421,154,8907,73
55084,30,359,653,354,11060,5
16335,38,1663,1432,1134,29120,529
26021,4,195,1255,169,5989,26
40001,34,501,967,372,8478,129
14434,2,190,1458,96,7541,94
26477,67,1097,1246,722,6302,375
28593,138,2504,1201,1748,28360,756
14756,4,234,1455,182,7379,52
11895,41,1656,1493,821,25786,835
46356,220,3274,881,2357,18688,917
15174,6,469,1449,313,11034,156
24458,83,1723,1289,1118,17377,605
26497,495,8051,1245,6906,63855,1145
16039,158,3982,1436,2953,59637,1029
20030,3,217,1366,148,11965,69
17571,147,5808,1410,3537,35765,2271
12523,97,3340,1486,1728,29485,1612
61575,36,425,448,383,9145,42
61841,19,277,440,233,5016,44
14404,38,1108,1459,835,16264,273
372,8,480,1600,355,9828,125
32048,23,1155,1138,613,15420,542
56589,52,597,610,495,6715,102
47708,69,755,863,626,9386,129
24146,381,12311,1296,9108,76714,3203
54113,44,493,687,416,10190,77
24103,8,138,1297,84,11653,54
16267,20,919,1433,630,15840,289
58177,66,1032,565,894,16484,138
38450,11,168,990,141,6584,27
23284,41,1312,1313,1067,30839,245
33218,186,2478,1116,1575,29932,903
12673,851,43457,1484,21613,259717,21844
1434,1,187,1591,121,28319,66
32550,2038,31952,1130,20443,133511,11509
58856,22,246,543,215,8350,31
58117,71,457,567,381,10121,76
28803,50,2855,1197,1308,15547,1547
38469,24,633,990,507,26684,126
62914,3,49,408,43,2183,6
45626,11,151,889,105,11461,46
23399,6,189,1311,147,9799,42
43321,8,294,915,235,6652,59
14919,14,350,1453,224,9973,126
23056,0,0,1316,0,4839,0
61418,33,645,453,388,13798,257
35985,31,641,1056,536,12852,105
36393,926,12950,1044,10970,149296,1980
22458,24,459,1327,318,24178,141
27946,23,595,1213,372,9504,223
39365,22,437,976,271,12307,166
13982,5,319,1465,184,8596,135
6431,355,6504,1538,4540,59394,1964
33483,116,4205,1113,1913,36774,2292
8546,36,956,1515,642,20271,314
48583,61,1995,848,1268,10063,727
6962,115,1889,1531,1244,33052,645
54121,152,1475,687,1279,26201,196
4242,3,318,1565,239,28137,79
11611,5,500,1495,271,21536,229
23015,16,799,1317,574,25373,225
2063,2645,136045,1586,69763,550684,66282
25219,5,92,1273,78,19499,14
61122,10,259,462,217,8318,42
4951,16,475,1556,310,9550,165
49082,40,352,832,321,5898,31
4179,62,2313,1566,1488,29028,825
28677,42,1095,1199,778,24881,317
50818,50,569,787,462,7979,107
58068,8,61,569,56,5011,5
9565,10,243,1510,154,5554,89
23841,183,4441,1303,3671,61898,770
10000,53,1185,1507,558,20410,627
32229,4643,85899,1135,57248,262390,28651
1390,26,847,1592,627,24701,220
11322,244,3607,1498,2312,32574,1295
21314,216,7411,1344,5185,80445,2226
66149,22,580,317,577,7123,3
24024,366,10547,1299,7512,85986,3035
29796,13,245,1178,152,6843,93
14439,231,8069,1458,4117,74221,3952
16072,3801,212843,1435,55849,348687,156994
54221,64,1214,683,813,13868,401
709,32,1855,1597,1288,53967,567
42174,3,168,933,147,6408,21
34931,84,1615,1082,1149,19513,466
34554,1,47,1091,30,3399,17
50154,19,168,803,140,3346,28
31338,331,7185,1148,5121,39007,2064
29706,92,3254,1180,2223,44605,1031
41817,136,1579,938,1243,25650,336
11768,153,5209,1494,2676,98538,2533
50046,57,794,806,674,11497,120
57919,28,393,574,364,12623,29
60893,229,4171,471,2854,65749,1317
16430,117,1410,1430,796,21450,614
11180,56,1482,1499,713,19405,769
50365,496,6364,796,5254,73076,1110
27265,82,1763,1228,1356,40115,407
62605,19,279,415,261,8081,18
62118,135,1411,429,1216,16641,195
9876,523,12107,1508,6953,88207,5154
51957,542,7667,756,7154,57233,513
4830,41,1038,1557,744,22536,294
64212,6,54,369,50,3991,4
13471,0,0,1473,0,7307,0
55726,27,375,636,352,6887,23
32194,127,2838,1136,1353,34476,1485
63956,1,79,379,62,4416,17
16411,2717,106126,1430,50148,698082,55978
13338,13,483,1475,258,11231,225
61497,7,111,451,76,2970,35
20975,26,1068,1350,718,24658,350
48379,168,2293,854,1882,31054,411
64254,12,85,369,72,6086,13
57218,10,65,594,57,3010,8
5872,6,551,1545,252,16180,299
6672,4,344,1534,267,16507,77
58786,43,470,545,342,7597,128
5854,5,268,1545,194,23051,74
29625,18,849,1181,340,7046,509
22073,164,6398,1333,4054,54386,2344
47137,5,83,871,65,3518,18
49464,21,234,822,195,5803,39
52733,1672,21175,728,13226,90969,7949
26185,10,540,1252,285,8234,255
36274,40,1007,1048,748,25204,259
42036,12,394,935,310,10456,84
37593,83,2020,1013,1966,18255,54
46048,48,860,884,633,11119,227
29774,37,2272,1178,911,11290,1361
53278,125,3757,712,2686,37060,1071
7090,2,207,1529,163,10152,44
55484,27,300,642,290,7688,10
63396,9,115,395,89,7497,26
47063,2103,35643,871,19220,280948,16423
51698,40,329,763,284,3486,45
44774,91,1229,899,988,18037,241
55973,155,2651,629,1656,29998,995
28819,282,13002,1197,4442,46062,8560
39738,221,3945,971,2809,37831,1136
54114,64,709,687,708,6922,1
29443,1263,31237,1184,21932,178704,9305
11947,19,1736,1492,678,28285,1058
21708,85,3243,1337,1585,26489,1658
60624,14,167,481,138,10673,29
12040,431,12811,1491,8354,66388,4457
15801,622,19212,1440,9731,91087,9481
61346,44,1057,455,662,17112,395
16300,3,326,1432,195,8431,131
11992,221,2186,1492,1316,15655,870
61556,10,184,449,121,4061,63
810,2753,89200,1596,52265,234054,36935
5317,1,97,1551,61,5669,36
6093,903,25040,1542,18019,94105,7021
54630,39,192,668,150,6832,42
12720,1722,69365,1483,41042,305604,28323
4352,38,1742,1564,959,26710,783
13756,0,0,1469,0,8009,0
4389,26,574,1563,455,63988,119
16916,520,15530,1422,10199,70620,5331
12008,2,221,1492,164,11493,57
28464,48,2087,1203,1178,30080,909
27742,9,356,1217,288,18306,68
4989,302,6644,1555,4274,66316,2370
44592,1725,23528,888,16807,208915,6721
32442,25,345,1131,249,9570,96
36383,264,5665,1045,4427,30149,1238
63186,10,82,401,64,12564,18
4307,10747,393675,1565,200562,1455482,193113
67436,57,2709,277,2172,56300,537
59192,4551,84601,532,73967,322145,10634
50269,234,2993,800,2553,49950,440
53514,48,626,707,500,14919,126
58987,18,255,539,212,8170,43
10727,5,411,1503,256,6202,155
28448,716,32122,1204,10057,184045,22065
14746,6,95,1455,59,5032,36
31647,69,1694,1144,937,25034,757
35201,98,919,1075,796,8486,123
17105,174,5940,1419,3378,20864,2562
29310,1,113,1187,62,7016,51
61428,52,944,453,830,12782,114
23254,126,1658,1313,1129,24189,529
38378,310,3660,993,2321,38577,1339
13318,11,316,1475,155,10262,161
44896,350,4851,897,4168,88277,683
18617,0,0,1392,0,11442,0
8374,106,4868,1515,2501,54809,2367
6842,145,5171,1532,3254,35260,1917
5266,206,4289,1551,3037,36206,1252
11410,121,6591,1497,4313,41191,2278
1044,20,443,1594,318,18121,125
37810,73,2895,1007,1668,21308,1227
40914,3966,63481,952,48740,481755,14741
22706,1155,43223,1323,25698,214084,17525
37709,5,122,1010,112,3067,10
4560,227,7766,1561,4273,137900,3493
52525,65,1000,735,678,12968,322
26736,1612,33163,1239,22337,126729,10826
37597,344,5163,1012,3800,30681,1363
18233,88,5763,1398,2573,65851,3190
3586,13,462,1573,301,19612,161
11529,2,352,1496,173,4681,179
7860,9,299,1518,178,3706,121
14802,17,559,1454,374,29026,185
37594,30,858,1013,700,15287,158
16876,22,562,1423,386,12517,176
52120,7,85,749,61,4918,24
65177,27,393,342,343,8169,50
30999,22,430,1154,301,12297,129
14265,326,7077,1461,5040,48608,2037
32001,26,593,1138,427,3319,166
15844,12,469,1440,294,7286,175
26783,130,2997,1238,2005,48929,992
25390,115,5804,1269,2868,30025,2936
49679,17,358,816,286,15707,72
64983,125,3510,347,3358,26213,152
12612,32,1036,1485,585,19453,451
58976,36,490,539,391,11399,99
54995,26,509,656,273,7736,236
14834,12,1080,1454,705,15964,375
26283,3,97,1250,79,6713,18
59418,45,500,524,454,5948,46
53438,39,553,708,494,10112,59
55322,217,4414,646,3516,45019,898
2099,6,377,1586,262,19103,115
30772,7,244,1158,146,3715,98
52576,803,8504,734,7279,55088,1225
51096,51,419,779,349,9995,70
56303,21,376,619,372,11333,4
49661,1939,761137,816,36790,526400,724347
14652,49,1312,1456,932,17512,380
48446,5085,103834,853,61811,717901,42023
63295,20,394,398,318,8453,76
35047,9,193,1079,129,7454,64
14420,27,877,1459,619,28810,258
48939,285,7473,837,4979,49457,2494
66077,18,60,320,58,4922,2
49151,75,1243,831,1034,27301,209
31745,85,1530,1129,1010,27693,520
13060,319,12133,1478,7394,86049,4739
14445,14,1703,1458,1105,15731,598
34159,629,61283,1099,22020,100375,39263
67606,8,563,271,333,6846,230
24131,28,781,1297,541,11100,240
65206,119,1588,342,1527,35608,61
33619,7,117,1110,81,2930,36
27186,90,3302,1230,1780,23512,1522
30197,0,36,1169,33,5420,3
31376,100,2054,1148,1565,23732,489
15447,8,220,1446,148,16204,72
35068,900,19950,1078,12776,111252,7174
51,768,32909,1604,16169,188694,16740
31214,23,770,1150,402,7037,368
33727,42,954,1108,728,24849,226
28997,70,1166,1193,795,23842,371
60515,24,295,485,228,7940,67
4192,867,29404,1566,15783,231078,13621
50997,18,297,782,203,8157,94
62543,2,58,417,36,8002,22
9552,33,1141,1510,824,40644,317
59366,105,1703,526,1378,14102,325
57907,11,737,574,152,5766,585
56985,47,519,599,411,9312,108
2875,2849,81194,1579,45812,150649,35382
13993,534,21422,1465,12759,199507,8663
19339,0,66,1379,36,4668,30
31793,405,7656,1142,3831,56836,3825
57745,169,2900,580,1791,26679,1109
32732,20,491,1127,429,5402,62
41585,170,1502,942,1286,25244,216
9767,56,1244,1509,681,22499,563
43905,33,943,909,668,57678,275
13917,303,9868,1467,7423,78747,2445
24869,10,465,1280,229,5739,236
13279,338,8018,1476,5482,55555,2536
11361,39,962,1498,555,8258,407
19892,670,47336,1369,18444,163019,28892
5506,4,248,1549,181,23957,67
38526,7,230,988,183,6367,47
4628,54,702,1560,490,13585,212
26975,51,986,1234,618,23141,368
60772,573,10815,475,6777,66178,4038
12382,7,519,1488,258,7167,261
31957,76,2038,1139,1477,14991,561
42394,1323,24301,930,17998,95174,6303
12236,90,3175,1489,1470,34303,1705
57003,5,91,599,75,3750,16
38330,132,2944,992,2245,17782,699
10386,2356,100723,1505,57291,590732,43432
9555,696,12421,1510,8526,85546,3895
30823,3715,84051,1157,44485,268198,39566
17188,80,2234,1417,1742,45092,492
57640,336,4994,583,4732,86651,262
45168,2,38,894,30,4101,8
26462,2,234,1246,162,5910,72
30366,33,474,1166,422,8528,52
23656,84,2706,1306,1677,50266,1029
14001,46,1335,1465,894,46298,441
40259,123,1459,959,1240,16226,219
2229,161,6442,1585,4258,35153,2184
48567,3,41,848,34,4309,7
27384,113,3325,1225,2015,25697,1310
60905,18,222,470,203,7082,19
26460,60,1252,1246,710,32183,542
781,92,6098,1596,4364,118558,1734
43107,1870,40215,917,22970,160846,17245
60020,4,50,504,41,2801,9
26529,3,206,1244,133,6268,73
16415,52,906,1430,659,13162,247
1042,1942,48629,1594,23847,308966,24782
22512,19,1050,1326,413,20463,637
18203,32,1095,1399,823,16061,272
28091,96,884,1210,699,14938,185
27975,85,1865,1212,1241,20281,624
32911,122,2825,1123,1501,20395,1324
13827,2,127,1468,101,5768,26
58651,165,1349,549,1016,13587,333
63439,537,9540,394,7511,70885,2029
34711,203,4255,1086,3011,41007,1244
36139,106,1351,1052,1174,20473,177
58630,284,3709,550,3544,34622,165
60121,6,194,500,135,6094,59
31419,70,2097,1148,1427,18246,670
2241,144,8736,1585,5488,51838,3248
384,33,1914,1599,1057,20512,857
50505,147,2168,794,1692,37955,476
38061,14,368,1001,275,6425,93
38536,3,77,988,60,5944,17
34158,3,138,1099,99,7032,39
37105,9,243,1027,239,14355,4
21290,1,91,1344,71,3114,20
21426,3,271,1342,209,7622,62
12403,56,2091,1487,1252,13083,839
55538,108,1071,641,1003,18034,68
8023,2142,31215,1517,21330,97977,9885
23270,5,327,1313,229,11754,98
16791,1586,25711,1424,17954,111221,7757
54928,106,1279,657,1267,9144,12
8817,40,1326,1513,858,14854,468
25478,224,3597,1267,2538,30756,1059
27119,1224,32732,1231,16597,152997,16135
36183,44,1071,1051,830,14737,241
2665,95,2327,1582,1771,49802,556
63666,6,80,388,80,3623,0
5527,183,6543,1548,4635,52326,1908
57866,10,120,575,105,3793,15
20955,11,251,1350,190,11151,61
64073,16,183,375,145,4275,38
30437,273,6625,1164,5167,86361,1458
9670,87,1666,1510,858,11212,808
31898,25,545,1140,323,4814,222
26169,3,120,1253,81,5855,39
245,129,6486,1601,3950,41213,2536
29664,19,331,1181,274,19469,57
33445,38,887,1113,622,14962,265
16450,19,257,1429,215,14133,42
55021,2,30,655,28,1807,2
55892,19,216,631,191,6229,25
44317,65,1112,903,738,15343,374
9932,35,1251,1508,786,17527,465
27792,228,3517,1216,2525,32579,992
1970,9,413,1587,257,15836,156
31527,172,2506,1146,1621,14933,885
28018,18,178,1211,146,8127,32
51808,436,7777,759,5254,65683,2523
25351,28,1621,1270,1067,14123,554
9198,3150,116278,1512,45872,806175,70406
28016,430,8855,1211,6693,53059,2162
56649,66,948,609,671,10209,277
24415,161,4450,1290,3179,27896,1271
53428,86,506,708,434,7407,72
22421,289,6728,1328,5064,67916,1664
34286,12,434,1097,248,11247,186
8121,289,4620,1516,3170,55268,1450
48869,3088,59210,839,43353,251278,15857
22693,6,381,1323,261,16853,120
46769,168,2212,875,1957,45389,255
10596,43,877,1504,554,12460,323
14124,12,335,1463,267,8752,68
22633,33,686,1324,598,11997,88
31687,109,1497,1143,1287,9103,210
18370,5,121,1396,91,10534,30
46511,10,153,879,117,10920,36
20781,23596,990438,1354,414509,3543335,575929
15242,137,3054,1449,2095,75185,959
14237,52,2401,1462,1423,18576,978
2268,214,5281,1585,3212,42876,2069
14940,35,948,1453,589,16310,359
30971,13682,414064,1154,279097,845135,134967
28340,5,351,1205,220,6232,131
48465,149,2145,853,1203,16467,942
25948,7,98,1257,85,9219,13
21179,2,220,1346,156,7163,64
30285,103,6813,1168,3802,32179,3011
31191,5233,110757,1151,74474,455449,36283
65630,7,66,332,51,3789,15
27493,13,533,1223,332,19572,201
573,489,15225,1598,10092,102050,5133
64369,38,623,366,607,13718,16
56447,25,366,615,352,10852,14
61760,134,3565,443,1546,28507,2019
15452,29,1434,1446,593,19248,841
55499,98,1158,642,963,12110,195
59021,7,75,538,61,4828,14
52730,10,138,728,110,4273,28
23469,52,1303,1310,787,27102,516
61441,651,8194,452,8160,96816,34
47292,54,937,869,728,29289,209
36193,0,93,1051,55,7670,38
10847,115,4245,1502,2485,20491,1760
37971,105,1671,1003,999,18961,672
35724,7,185,1063,130,14442,55
52524,10,131,735,103,8616,28
27456,20,585,1224,411,12893,174
28053,96,3531,1211,1826,21800,1705
32709,22,431,1127,342,10585,89
57613,1303,15850,584,12386,173019,3464
21720,21102,359728,1337,244856,913354,114872
41471,2,69,944,54,8980,15
8570,20,962,1515,605,20697,357
13459,33,1517,1473,981,13982,536
36132,1383,22981,1052,20556,115665,2425
7079,186,7320,1529,4456,38851,2864
10625,1444,41198,1504,24425,105254,16773
50380,28,438,795,396,7495,42
59370,65,1390,526,849,17835,541
777,5,362,1596,240,23736,122
50834,233,4123,787,3538,74493,585
2076,45,2363,1586,1852,63125,511
25452,84,3318,1268,2006,14566,1312
5725,136,7148,1546,3350,27127,3798
49424,19,434,822,370,11449,64
20498,7,598,1359,244,34415,354
66204,9,176,315,159,3679,17
45254,128,1419,893,969,13100,450
17131,0,0,1419,0,7050,0
48107,616,10830,858,8183,107076,2647
33768,1020,20071,1107,11976,119130,8095
27942,10,536,1213,307,22370,229
171,387,9126,1602,5694,276398,3432
48514,5,173,851,132,3757,41
36875,6693,148140,1034,89492,774107,58648
60521,35,394,485,324,9075,70
24462,581,12192,1289,7105,84588,5087
11712,131,2790,1495,1707,43058,1083
26716,447,13855,1240,9187,133319,4668
36068,311,4097,1054,3635,28321,462
2595,13,809,1582,541,25726,268
35910,16,232,1032,165,8117,67
15864,74,2482,1439,1201,38178,1281
57175,7,110,595,88,5929,22
246,1223,23900,1601,13719,174934,10181
46373,167,1673,881,1488,9828,185
12208,16,2522,1490,430,19947,2092
565,195,7851,1598,4864,54343,2987
11820,0,0,1494,0,13262,0
67130,0,7,287,6,2534,1
2537,26,734,1583,567,27026,167
40909,52,922,953,734,13731,188
14842,9,446,1454,304,42908,142
59051,20,192,537,147,4385,45
52813,67,888,725,759,8714,129
42436,64,969,929,712,17580,257
52046,5,160,752,119,6874,41
57291,2507,27847,592,23365,135512,4482
8377,20,969,1515,505,11731,464
38483,15,269,990,231,6792,38
8342,224,3484,1516,3328,32164,156
50447,773,7979,796,6177,27820,1802
9882,10,153,1508,72,7837,81
37299,81,1832,1021,1254,29461,578
49216,16,368,828,227,9285,141
53847,172,1296,696,1092,12476,204
18480,24264,795152,1394,405061,3113671,390091
57376,7148,89994,590,73773,324285,16221
34662,229,4634,1088,3133,26282,1501
55984,103,1033,628,844,20125,189
49208,37,336,828,318,8482,18
355,82,2508,1600,1904,24887,604
35874,28,392,1059,287,6615,105
54749,84,791,663,551,19082,240
15580,0,0,1443,0,5754,0
20249,114,1508,1363,956,21776,552
59240,28,429,531,328,13658,101
49164,124,2245,830,1698,30212,547
53815,18,321,697,220,8919,101
6181,2,105,1541,66,6661,39
34786,148,2566,1085,1897,40955,669
66398,56,688,310,669,6536,19
4694,36,993,1559,684,22945,309
50435,457,5359,796,3372,50978,1987
32200,37,384,1136,292,8995,92
7884,46,977,1518,583,23797,394
5732,22,1155,1546,680,30421,475
24180,115,2712,1296,1641,13634,1071
730,96,3691,1596,2428,23665,1263
55947,14,143,630,88,5197,55
13333,3,192,1475,133,11395,59
66447,19,341,309,320,7760,21
18533,115,2303,1393,1452,26726,851
25066,386,7765,1275,5501,51155,2264
61244,85,1062,458,1000,12343,62
27600,64,1659,1220,1207,25593,452
42762,47,549,923,407,8762,142
49890,2310,79529,810,28834,472065,50695
30,44227,1763685,1605,848246,4557055,915439
53126,618,6098,715,5650,49383,448
37496,5676,115973,1016,80218,335363,35755
21571,19,668,1339,341,21070,327
37231,37,605,1023,475,13799,130
58617,154,2717,548,1567,24337,1150
15693,146,3231,1442,2365,28984,866
14586,72,2995,1457,2217,22407,778
27396,40,1453,1225,1009,27262,444
12487,77,2325,1486,1315,34534,1010
17812,12,508,1406,418,11746,90
60062,324,7653,502,4394,40167,3259
9240,84,1987,1512,1274,22743,713
35668,48,703,1064,524,12843,179
35125,2153,40168,1077,28199,350424,11969
50755,46,1168,789,730,22133,438
21400,45,1140,1342,851,42075,289
57275,3,88,592,83,3228,5
21821,86,4407,1336,2586,34030,1821
2554,328,24314,1582,11828,163437,12486
24666,13584,283062,1284,177851,1391281,105211
48740,56,765,843,673,10457,92
42930,27,481,920,394,9359,87
6475,426,17948,1537,9680,126640,8268
23930,7,166,1301,129,4532,37
57879,5722,83753,574,65906,345350,17847
2134,7,329,1586,252,19884,77
19431,13,403,1377,262,18780,141
31140,236,8467,1152,3703,100986,4764
49999,11,170,807,126,10499,44
49458,8,181,822,121,6162,60
22852,31,713,1320,493,8383,220
66621,15,443,303,311,11732,132
14093,22,811,1464,599,16981,212
62220,34,302,427,258,5426,44
12276,1716,61977,1489,37115,322800,24862
24886,62,1050,1279,778,13276,272
69088,2,55,222,47,1883,8
26306,41,1034,1249,603,10152,431
37856,132,3434,1006,2596,39590,838
24608,11,538,1286,336,13043,202
4802,6,455,1558,313,12812,142
19052,67,2403,1384,2024,37199,379
67785,26,213,265,198,4665,15
20133,237,5927,1365,3009,49228,2918
54212,668,13774,683,8889,78321,4885
64268,82,565,369,491,6335,74
37586,174,2799,1013,1903,23595,896
26381,34,844,1247,467,9628,377
15824,311,6048,1440,3503,60396,2545
19440,18,190,1377,147,7433,43
27918,27,899,1213,659,15699,240
11543,3454,140963,1496,84160,531873,56803
60646,17,306,480,210,4793,96
53625,28,651,703,268,9452,383
6352,20,788,1539,540,26834,248
20889,7852,189201,1352,112136,662088,77065
49514,20,287,820,240,5383,47
56282,450,6986,619,6765,48908,221
3024,23,723,1578,578,12820,145
31535,19,153,1146,97,5416,56
47691,192,2273,863,1872,25420,401
2751,582,39706,1581,14006,274770,25700
9700,949,83652,1509,34036,307303,49616
15294,762,19056,1448,14372,198807,4684
31703,116,2084,1143,1309,22070,775
25970,257,10927,1256,7515,65224,3412
52269,583,24954,744,10715,137422,14239
44522,94,3661,901,1516,29449,2145
25481,33,655,1267,438,8883,217
56965,139,2422,600,2227,14454,195
26196,86,2464,1252,1741,32124,723
6788,6,141,1533,121,8754,20
32184,40,1023,1136,578,9211,445
51924,305,3462,756,2501,21849,961
35009,53,1609,1080,1344,14275,265
1377,799,79753,1592,25819,234994,53934
8896,145,3410,1513,2169,20103,1241
57672,36,394,582,300,9369,94
57337,80,1367,591,1127,20854,240
5471,68,1879,1549,1233,16628,646
5260,42,670,1551,447,10216,223
55201,22,255,650,192,7529,63
58942,25,202,540,163,8986,39
16611,832,12047,1427,9549,50648,2498
41245,4,201,948,120,3719,81
53541,4001,50552,706,38870,321636,11682
28359,200,5416,1205,4376,90219,1040
191,452,24059,1602,14110,189000,9949
60798,129,2165,475,1378,35156,787
37906,111,2054,1005,1602,21490,452
35252,1295,30026,1074,14873,198701,15153
24014,21,562,1299,414,11110,148
66472,567,8534,308,7890,82250,644
49877,622,7177,810,6635,75719,542
4347,8,418,1564,301,30227,117
17447,22,308,1413,211,18499,97
64090,0,19,375,15,1461,4
59148,38,808,534,489,7057,319
29718,203,5644,1180,4489,46148,1155
49969,310,4943,808,4675,30628,268
28793,1225,31563,1197,21654,227448,9909
62928,2686,54489,407,45580,268604,8909
3405,39,2633,1574,987,47543,1646
60652,454,5001,480,4341,41484,660
21047,38,1377,1349,1100,25606,277
53619,6,55,703,46,2448,9
61965,38,894,435,642,25621,252
28326,106,2368,1205,1502,32218,866
28947,1,51,1194,39,3359,12
21552,2655,51984,1340,32028,239410,19956
54896,33,194,658,191,6325,3
56478,12,248,614,202,9681,46
27599,19,589,1220,350,6851,239
54296,140,2020,681,1911,59857,109
27382,64,1682,1225,1032,22089,650
4257,80,2969,1565,1898,46732,1071
60813,47,735,474,700,10015,35
11822,5,279,1494,153,7244,126
57201,67,878,594,687,9467,191
68084,20,317,256,230,4376,87
35865,10,156,1059,124,5221,32
536,17,684,1598,451,19943,233
26852,118,1760,1237,1120,35456,640
18327,7,307,1397,210,10672,97
14087,1707,45395,1464,21130,160570,24265
19204,22,709,1381,514,8234,195
2453,74,2043,1583,1451,24265,592
52622,14,269,732,224,29238,45
13916,15,319,1467,204,13930,115
35691,183,4672,1064,3444,65603,1228
45443,46,583,891,449,8577,134
35091,41,847,1078,644,18635,203
6420,20,795,1538,507,25514,288
8340,165,13471,1516,2965,38975,10506
3713,1,143,1571,101,21226,42
37026,1375,23486,1029,18885,226503,4601
43261,133,1892,915,1456,32270,436
2785,179,5099,1581,3150,34844,1949
6259,19,656,1540,487,33139,169
48370,12,613,855,386,9905,227
61956,80,565,436,519,15386,46
2269,21,531,1585,347,26689,184
67007,720,11469,290,9501,116595,1968
3607,59,1763,1573,1202,7490,561
56224,30,371,614,336,8492,35
28831,20,520,1196,310,7794,210
22770,189,4302,1322,2863,17005,1439
42832,51,893,922,713,15238,180
30445,18,207,1164,174,7467,33
53851,44,545,696,531,8822,14
32576,129,2978,1129,1995,22940,983
64206,20,367,371,296,27640,71
40872,163,2170,954,1862,16015,308
588,17,1123,1598,380,38826,743
59331,2166,31475,527,30791,205609,684
18176,62,1979,1399,1309,16362,670
62737,15,190,412,129,6574,61
43377,491,7043,914,5943,90810,1100
55939,17,360,630,247,6294,113
67817,1,120,264,93,2689,27
14009,381,15467,1465,9613,97268,5854
35665,3021,77825,1063,38918,415159,38907
9889,168,3582,1508,2392,24085,1190
23154,327,10086,1315,4306,35103,5780
26108,273,6045,1253,4312,32348,1733
66765,58,560,298,504,6884,56
50449,6,50,796,43,4230,7
28021,6,150,1211,125,24809,25
61503,5,102,450,87,3979,15
28547,170,3145,1202,2436,23124,709
35545,16,707,1066,548,13181,159
3088,79,2608,1577,1581,14370,1027
51936,398,5705,756,4271,33979,1434
49314,2,27,825,25,2856,2
5063,210,5935,1554,2815,60857,3120
51072,36,549,780,492,11224,57
5504,2749,109884,1549,58148,274942,51736
49140,224,2922,831,2458,34226,464
52427,85,1331,739,1174,64360,157
29002,7,228,1193,193,15572,35
5114,23,377,1553,262,16471,115
48694,6,126,845,88,3273,38
20585,0,105,1357,58,10064,47
36306,582,15606,1047,10399,62073,5207
3031,82,5022,1578,3204,35559,1818
15300,545,8921,1448,5548,78951,3373
13446,2688,92968,1473,57769,296454,35199
46648,108,983,877,740,7900,243
12684,675,17120,1484,10299,113408,6821
52007,70,849,754,676,10756,173
32258,263,8619,1133,5959,76695,2660
66471,33,509,308,372,15958,137
41816,90,1667,938,1494,22215,173
65305,20,249,340,201,6892,48
10653,22,1137,1503,754,16250,383
42204,142,3221,933,2863,58471,358
14024,35,662,1465,404,10645,258
16049,164,3716,1436,2531,65899,1185
30341,81,1980,1166,1403,48009,577
37990,4576,83637,1002,57759,259816,25878
55270,18,342,648,299,12971,43
34625,2,131,1089,101,9837,30
22384,112,2488,1328,1810,43559,678
9857,919,38970,1508,13048,270835,25922
15831,40,1241,1440,804,26412,437
15880,235,9273,1439,6595,138039,2678
9413,201,10967,1511,5946,79275,5021
12196,3,236,1490,133,5965,103
45940,17,301,886,233,6496,68
58051,520,8285,570,7798,149282,487
29611,438,18207,1182,12964,55785,5243
7339,26,527,1526,399,22982,128
30163,88,1168,1170,940,33743,228
9310,439,13739,1511,7900,41131,5839
16431,953,19238,1430,12710,97342,6528
6327,8,669,1539,247,10830,422
3951,445,24235,1569,7694,137520,16541
14638,42,969,1456,680,53583,289
25676,2298,69229,1263,30190,269286,39039
36147,3121,86217,1052,47924,318309,38293
61331,50,685,455,525,10811,160
27497,354,5894,1223,4680,42879,1214
60580,60,893,483,564,12490,329
26228,47848,1234288,1251,501435,3665010,732853
66205,50,810,315,793,15924,17
58902,6,56,541,42,7895,14
55997,613,8027,628,7808,63600,219
13736,540,14733,1469,9310,74771,5423
31260,545,6762,1150,5349,48807,1413
26271,2786,67960,1250,43964,301287,23996
30786,104,2005,1157,1383,22557,622
34359,656,17210,1095,13996,133132,3214
30673,463,17413,1136,6711,119641,10702
59929,47,569,507,520,12921,49
57018,511,10386,599,7103,39715,3283
1381,109,2491,1592,1690,28156,801
37059,41,789,1028,576,8660,213
389,2177,81962,1599,43416,368885,38546
53045,3767,47172,718,33987,272134,13185
36988,83,3192,1030,1559,39790,1633
17751,339,10757,1407,7334,32593,3423
54415,521,4859,676,4144,38837,715
18161,81,2767,1400,1998,71785,769
19567,22,598,1375,440,20383,158
20729,673,11681,1355,6141,110132,5540
34522,115,3952,1092,2753,40409,1199
62199,13,235,427,187,9532,48
23556,11,491,1308,271,5014,220
30793,139,3409,1157,2524,38063,885
58619,103,2170,550,1329,9837,841
34823,157,1996,1084,1587,34440,409
35600,9,229,1065,127,15961,102
5143,72,4512,1553,2015,71322,2497
56533,1672,24737,612,16363,167689,8374
24509,380,10320,1288,6894,53928,3426
29213,16,459,1189,134,3123,325
64838,49,754,352,667,13673,87
21944,4,225,1334,164,5575,61
8424,51,652,1515,412,10582,240
58844,22,230,543,206,4880,24
66789,1,18,298,14,1281,4
12990,295,11539,1480,6639,169190,4900
36394,17,356,1031,246,6507,110
24256,51,1577,1294,1028,28126,549
33797,22,419,1107,396,5217,23
8492,78,1158,1515,776,8142,382
38412,77,1241,991,779,16794,462
35231,39,1482,1074,1036,20156,446
38006,309,7083,1002,5574,78279,1509
31065,39,1743,1152,1104,13714,639
13530,1070,33217,1472,21819,155328,11398
36320,198,4200,1046,3711,28397,489
55401,97,2260,644,1788,19746,472
23183,22,1225,1314,771,18252,454
58875,17,218,542,172,5384,46
39015,8,234,980,164,7084,70
33577,292,9977,1111,5686,63546,4291
35250,42,534,1074,425,18914,109
61196,13,133,460,101,8621,32
14198,4630,156430,1462,76477,782998,79953
59491,272,3262,522,2519,37931,743
61463,42,409,452,320,8402,89
25134,41,1934,1274,988,25329,946
28741,4156,92676,1198,52861,207853,39815
60569,2916,38042,483,32664,134156,5378
34479,22,573,1093,365,16351,208
28580,2216,49959,1201,34243,340669,15716
61693,223,2594,445,2535,33054,59
26701,43,1574,1240,999,16322,575
684,34,2789,1597,1617,24776,1172
25585,133,5499,1265,3383,40445,2116
26642,907,33993,1241,13948,250239,20045
24686,5,254,1284,185,19070,69
20489,24,658,1359,481,10318,177
2368,397,12565,1584,10408,90706,2157
36363,417,9258,1045,6884,76918,2374
9726,386,6852,1509,4462,57684,2390
63273,103,1482,399,1279,19685,203
49167,582,11300,830,7577,82701,3723
21773,36,1648,1336,991,15458,657
28864,13,365,1196,241,4315,124
9000,404,6912,1513,4713,50934,2199
4592,4,156,1560,106,7183,50
1507,8,934,1591,547,23613,387
41235,30,541,948,501,26067,40
4780,170,8079,1558,3752,150866,4327
9797,300,4154,1509,2988,30110,1166
44988,87,1253,896,1162,18333,91
33183,49,2105,1118,1013,68910,1092
51812,112,1526,759,1230,18699,296
38477,10,210,990,136,4959,74
17256,323,8974,1416,5489,64716,3485
28390,1145,37333,1204,23481,171768,13852
59430,1,59,524,43,2202,16
20590,227,2860,1357,2379,39974,481
32793,48,1449,1126,904,9615,545
31229,12291,344811,1150,178812,1572951,165999
25824,106,1789,1260,1023,20658,766
66429,51,1406,309,1341,21857,65
29754,1276,37152,1179,27382,271964,9770
64920,3,33,350,32,1205,1
36476,20,347,1042,317,9918,30
23317,157,4766,1313,2528,31671,2238
33391,6477,178969,1114,92306,676407,86663
5878,71,2276,1545,1367,42937,909
28766,40,595,1198,408,11309,187
11508,56,915,1497,622,9364,293
62028,65,589,433,563,4278,26
29125,21,342,1190,204,4225,138
20641,297,5962,1356,3803,56914,2159
11481,639,17228,1497,9509,118771,7719
22407,2693,69389,1328,49457,379634,19932
710,93,3445,1597,2474,29957,971
32473,40,1497,1131,853,26059,644
15014,191,5690,1452,3552,50035,2138
49124,95,784,831,666,10646,118
17565,7,432,1410,293,11066,139
9131,4385,162805,1512,59720,416554,103085
58687,231,5048,548,3766,33994,1282
3074,10,554,1578,322,35909,232
63394,535,5463,395,4622,51289,841
19594,121,1935,1374,1173,23929,762
22329,436,9922,1329,7287,93799,2635
66275,5,78,314,55,5310,23
48943,291,4937,837,3839,27392,1098
10785,16,433,1502,287,6339,146
12804,2405,49032,1482,26566,149731,22466
56261,38,519,620,465,19293,54
39552,13,194,974,174,7307,20
16423,23,889,1430,630,9408,259
57794,108,2013,578,1213,17707,800
40960,25493,345264,952,205550,2078205,139714
61561,26,609,449,475,10896,134
23396,175,4368,1311,3154,56029,1214
62336,0,5,423,3,1872,2
9602,25,1032,1510,632,13712,400
3676,4,133,1572,96,15253,37
56902,343,6795,602,4474,62112,2321
18570,14,245,1392,208,24808,37
2778,5,247,1581,119,19082,128
10104,5,453,1507,166,20881,287
11928,360,10867,1492,6206,101773,4661
68181,1,56,253,13,1874,43
57391,304,3036,589,2519,20396,517
62938,115,2204,407,2199,24923,5
8231,49,1803,1516,951,17402,852
12900,66,1968,1481,763,27516,1205
22040,23,682,1333,411,14008,271
149,57,3180,1602,1212,26140,1968
18083,141,3337,1401,1961,43422,1376
28659,61,1889,1199,1167,28636,722
32963,55,1213,1122,626,20738,587
30767,16,534,1158,366,5063,168
8450,40,794,1515,505,7717,289
15628,137,5774,1443,3616,117284,2158
9805,289,12639,1509,8356,48803,4283
54892,130,1405,658,1118,15607,287
4913,19,491,1556,394,21797,97
49806,64,716,812,570,14533,146
29922,602,6242,1175,3737,45938,2505
52242,28,551,746,452,10699,99
65295,8,60,340,58,3257,2
50636,3,169,791,129,5597,40
36550,2,122,1039,95,7639,27
29000,67,2717,1193,1703,16777,1014
57634,24,256,583,195,3744,61
62472,2426,45338,419,40528,324266,4810
29119,27,282,1190,281,12555,1
22522,7339,160517,1326,94546,532579,65971
38467,535,14407,990,9450,103524,4957
10119,23,796,1507,529,12854,267
19754,15,389,1371,226,11571,163
50074,63,549,805,422,16971,127
49901,21,305,810,252,6931,53
3735,3,220,1571,165,13981,55
7647,508,7809,1522,5672,38261,2137
55598,874,8104,639,5867,57993,2237
40858,23,571,954,445,19349,126
56519,29,405,612,336,12861,69
12258,1368,51701,1489,24965,328152,26736
18754,198,10707,1389,7100,42103,3607
10389,4,154,1505,87,4169,67
61073,9,90,464,84,10116,6
56913,58,1012,601,774,24884,238
4822,487,20434,1557,12520,219563,7914
2604,483,14234,1582,9007,50466,5227
8710,367,10834,1514,6421,61686,4413
28521,75,2064,1202,1700,15968,364
41158,37,472,949,384,11530,88
38322,6,160,994,137,5373,23
19377,3617,111444,1378,58143,757066,53301
4249,58,1199,1565,826,31203,373
63569,6,117,391,100,3465,17
49630,9,126,817,105,4134,21
23124,7,350,1316,253,8203,97
35669,84,2230,1064,1978,30600,252
57948,20,228,573,183,5558,45
14759,9,372,1455,237,8057,135
51680,19,381,763,233,10946,148
17430,55,937,1413,788,17916,149
50282,147,1667,800,1574,29007,93
23870,1845,47481,1302,26153,146351,21328
19849,56,1925,1370,1430,26109,495
55688,9,128,637,105,9398,23
38898,17,327,981,180,5974,147
47495,52,435,866,328,12727,107
21282,63,1002,1344,782,15391,220
17598,79,2213,1410,1597,29890,616
52620,5,96,732,55,7494,41
58801,8,46,545,41,3054,5
42386,15,405,930,247,7559,158
58588,25,434,551,396,12226,38
31492,31,501,1147,407,13090,94
19704,59,1228,1372,933,22237,295
54318,5,83,680,73,3693,10
25534,19,1076,1266,690,22295,386
33003,17,373,1121,284,13131,89
3037,3,382,1578,290,28389,92
30479,32,993,1163,648,16996,345
61733,204,1983,443,1781,20952,202
29863,4,159,1176,95,4922,64
34252,111,1593,1098,1314,32981,279
49089,33,482,832,274,17321,208
6704,43,977,1534,605,10159,372
26558,1413,26928,1243,12092,105200,14836
18952,4936,128020,1386,94014,321357,34006
15703,20232,982923,1442,324553,2735438,658370
58490,66,1044,554,922,32851,122
34316,119,2555,1096,1577,19041,978
11206,3274,105793,1499,52138,472282,53655
10018,37,2366,1507,1606,32452,760
44562,292,4976,901,3429,40415,1547
17219,14,545,1417,278,10688,267
23896,24,1372,1302,701,14489,671
398,434,14324,1599,8356,53668,5968
29212,78,2015,1189,1300,15715,715
39054,60,973,979,706,19795,267
37619,12,609,1012,475,13798,134
39922,4060,77088,966,47955,520172,29133
24240,561,20579,1294,13816,193832,6763
39152,147,2161,978,1670,18470,491
15428,2330,28532,1446,22427,223816,6105
30794,74,920,1157,636,12093,284
36525,129,1987,1040,1299,28572,688
35392,14,235,1070,221,10237,14
37661,56,671,1011,572,7905,99
37236,89,1121,1023,978,11506,143
30687,50,898,1160,800,16732,98
55383,46,532,645,436,9258,96
23282,17,641,1313,482,25939,159
5699,42,1081,1547,773,27457,308
19593,11,528,1374,280,13997,248
1455,59,2144,1591,1577,20678,567
33738,216,2241,1108,1764,20397,477
48176,35,207,858,205,9281,2
15472,105,2744,1445,1798,31531,946
58316,18,307,561,238,17380,69
12132,40,1369,1491,593,15775,776
14927,0,0,1453,0,8196,0
36512,174,1817,1040,1221,16540,596
36321,272,3476,1046,3013,39285,463
35615,20,461,1065,312,10235,149
24182,52,1468,1296,979,40748,489
4381,3,94,1563,75,11126,19
30737,3136,57798,1159,45939,209220,11859
25305,38,812,1271,415,17091,397
26238,90,1683,1251,1049,18429,634
52413,20,256,740,198,4557,58
63298,165,2150,398,1655,21836,495
33617,68,1275,1110,1025,30435,250
38886,84,1948,982,1343,27335,605
38335,28,895,994,577,12292,318
37459,54,857,1017,724,13999,133
5203,279,5398,1552,4086,31547,1312
35694,23,681,1064,412,8082,269
64164,33,828,372,682,9565,146
64251,1357,29554,370,29354,228715,200
35565,14,344,1066,231,10255,113
11956,85,5306,1492,3271,44103,2035
56086,539,14722,625,12920,127925,1802
17890,15,465,1404,346,14044,119
21502,24,1006,1340,652,16926,354
38722,229,3591,984,2974,24802,617
12769,57,1222,1483,721,11383,501
26141,8,137,1253,127,5802,10
54164,11,163,686,136,8225,27
21867,694,30641,1335,17862,266494,12779
34971,7,240,1081,148,4821,92
40912,346,4192,953,3132,28405,1060
55610,56,382,638,312,6626,70
51609,346,5404,765,4432,57136,972
24207,73,3903,1295,2689,41870,1214
6590,33,781,1535,468,17514,313
13078,136,6601,1478,3815,52681,2786
11142,50,2692,1499,1645,24864,1047
44654,218,2913,900,2271,24591,642
13236,1467,60843,1476,41163,359207,19680
24096,32,1324,1297,823,19191,501
10499,133,2494,1504,1870,42769,624
24298,104,2472,1293,1573,28600,899
36910,8,253,1033,174,4965,79
1920,151,6556,1588,2946,147254,3610
41272,12,195,947,79,4398,116
59064,24,240,535,211,4545,29
16445,33,837,1430,569,11664,268
50332,6,177,799,162,3207,15
26706,3566,89608,1240,58234,342254,31374
37428,19,270,1018,196,7989,74
20752,26,622,1354,473,6291,149
13278,316,15816,1476,9223,88318,6593
57150,13,205,595,123,7300,82
13086,394,20858,1478,9610,113034,11248
13337,2,95,1475,69,7054,26
34217,15,493,1098,229,10654,264
28379,19,523,1205,321,17553,202
20701,221,7363,1355,4951,124492,2412
28648,15,503,1199,367,10824,136
6387,16047,1438693,1538,282854,1797401,1155839
26998,686,15503,1233,7454,80209,8049
1759,24,1267,1589,495,12906,772
37507,18,366,1015,286,22007,80
8690,1,261,1514,153,11660,108
29489,28,374,1184,333,8521,41
65050,6,197,345,157,9312,40
53035,228,4525,719,3504,52699,1021
59385,33,486,525,400,17076,86
40851,35,518,954,479,9963,39
36188,1215,23242,1051,18067,218656,5175
18534,6,543,1393,390,10314,153
9337,76,1453,1511,765,19330,688
40452,114,1434,960,1154,18388,280
22888,6,144,1319,101,15004,43
60002,189,6688,504,3544,62359,3144
37735,10,125,1009,115,5111,10
52177,9,110,748,89,5198,21
49618,176,2882,807,1307,38413,1575
51292,5,130,774,88,7932,42
52103,45,543,750,334,7986,209
23344,3,54,1312,39,8665,15
49075,121,1417,833,1358,23588,59
46580,6269,127945,878,86193,865089,41752
64163,12,92,372,78,10770,14
31232,44,2282,1150,1461,34561,821
32558,699,11505,1129,8461,72137,3044
38510,564,16522,989,8029,90794,8493
57727,614,10177,580,8246,55526,1931
55051,82,1052,654,716,10724,336
7637,94,3514,1522,2098,51526,1416
55285,149,2226,647,2006,17728,220
27142,128,1908,1230,1022,14940,886
21543,87,2443,1340,2026,32756,417
14155,6,512,1463,319,9928,193
28312,478,10261,1206,7459,66606,2802
27220,233,3004,1229,1895,18545,1109
2798,22,1179,1580,778,30531,401
27797,51,1067,1216,719,17890,348
30171,240,7728,1170,5015,114896,2713
52544,32,277,735,226,5034,51
64066,24,194,375,178,3423,16
15367,110,3596,1447,2670,48513,926
14286,48,1320,1461,1000,30647,320
63330,294,4291,397,4213,24891,78
27476,89,3055,1223,2205,30131,850
53102,66,579,716,482,10009,97
50773,94,2742,788,1771,28651,971
38648,32,867,985,659,18828,208
52712,305,2748,729,2340,22596,408
39582,13,349,973,210,9688,139
238,3675,223188,1601,112597,517138,110591
43895,202,6315,909,4247,68478,2068
38303,6,66,995,47,6468,19
26289,277,6177,1250,3818,47308,2359
33264,17,463,1116,318,13051,145
38423,8,176,991,154,8301,22
17002,189,4207,1421,2632,33306,1575
34229,275,3540,1098,2834,27867,706
62653,21,271,414,231,6788,40
6598,18,807,1535,518,24243,289
7765,19,966,1520,613,19655,353
15739,9,267,1441,197,9613,70
53943,9,102,693,76,6814,26
20970,20,322,1350,213,7510,109
42308,5,229,931,148,13753,81
4442,41,1104,1563,780,27817,324
18677,15,401,1391,256,11155,145
1358,61,1709,1592,1270,50314,439
22607,2155,49863,1325,31953,327331,17910
26061,30,1770,1254,1314,6512,456
1041,1837,47993,1594,28091,231232,19902
30670,49,1342,1160,626,13070,716
20462,3,69,1359,58,7448,11
31621,94,3210,1144,1778,42467,1432
30993,12,213,1154,148,2881,65
21682,45,983,1338,755,44074,228
17177,410,10485,1418,6383,91269,4102
6472,19,2016,1537,230,20909,1786
49315,5,84,825,63,3208,21
33822,437,7727,1106,4207,79909,3520
5335,220,4628,1551,2858,47221,1770
30192,198,4372,1169,3637,54282,735
31882,861,22891,1140,14936,116485,7955
16108,108,1938,1435,1306,14281,632
41335,2166,46992,945,19643,127287,27349
51963,8,145,755,126,6554,19
37000,1444,29337,1030,24604,270252,4733
10608,100,2770,1504,1415,28913,1355
12663,29,1210,1484,714,39172,496
27850,2,101,1215,69,4422,32
64874,304,8770,351,3617,73995,5153
23806,2,201,1303,156,17251,45
26504,22,571,1245,424,23347,147
63501,183,5398,391,5032,53101,366
17530,1145,35401,1411,17853,183954,17548
21397,21,781,1342,620,11526,161
57590,12,109,584,90,6035,19
5847,23,680,1545,511,23048,169
1642,1,167,1590,142,15016,25
16136,68,2423,1435,1874,33592,549
27663,65,1758,1219,1441,44146,317
7684,7,351,1521,231,31483,120
60149,21,328,499,285,16883,43
25077,441,8248,1275,5855,32045,2393
36772,9,309,1025,226,15105,83
2555,5,226,1582,133,8062,93
41877,86,1907,937,1259,22066,648
41387,20,445,946,436,9450,9
2764,567,10632,1581,7572,59581,3060
45232,7,216,894,200,3267,16
21549,7,303,1340,204,5924,99
1206,22,456,1593,304,30192,152
11278,2089,61452,1498,30941,145559,30511
17775,52,1429,1406,1059,16053,370
35335,23,610,1071,444,20916,166
68739,63,1078,233,1004,19076,74
22246,333,9402,1330,5795,113449,3607
6168,386,6997,1541,4097,33449,2900
25293,23,703,1271,548,25710,155
28653,27,835,1199,341,14217,494
23520,3,193,1309,118,23318,75
68321,32,666,248,550,12371,116
66441,319,4940,309,3358,71775,1582
52735,63,1059,728,716,19556,343
64836,58,939,352,895,13427,44
36265,141,3319,1048,2449,37572,870
26307,56,1551,1249,945,17034,606
56513,10,144,613,79,3853,65
55126,51,487,652,436,11363,51
32239,0,88,1135,64,5018,24
58343,16,415,560,333,9193,82
54160,63,669,686,342,9283,327
56456,475,3946,615,3272,40390,674
12409,24,725,1487,335,14802,390
11967,57,1266,1492,557,16850,709
22020,289,12889,1333,4671,120215,8218
67431,11,104,277,90,4237,14
24142,120,1579,1296,828,11972,751
4812,63,2085,1557,1372,16944,713
51022,62,1232,781,931,19819,301
59529,11,284,521,206,8618,78
34060,1276,34722,1101,17084,159048,17638
8776,9,476,1514,306,7038,170
23321,93,1149,1313,814,11738,335
52940,38,404,721,252,17204,152
17334,51,1223,1415,764,19615,459
34501,6,56,1092,38,2175,18
17948,16,296,1403,162,5349,134
27628,83,2947,1219,1716,22830,1231
58165,1456,35995,566,29389,227749,6606
19974,397,8029,1368,4277,68077,3752
54831,28,279,660,245,7020,34
11500,114,11058,1497,6682,68648,4376
8696,72,1238,1514,833,12515,405
13311,67,2066,1475,1020,17824,1046
35024,27,725,1079,450,12981,275
8502,3405,125172,1515,76087,319267,49085
50706,30,250,790,178,3522,72
66578,225,2395,304,2336,27285,59
21326,51,2525,1344,1472,19341,1053
33608,30,774,1110,525,8595,249
6848,57,1923,1532,1391,18377,532
7673,18,448,1521,292,14106,156
57456,1766,26311,588,17384,142281,8927
54169,187,3294,685,2798,34444,496
8665,38,615,1514,351,10307,264
65412,84,967,336,877,14483,90
49560,42,370,819,294,8370,76
68317,5,33,248,27,4157,6
54755,209,1734,661,1466,18083,268
4637,8,165,1560,125,13906,40
3334,21,577,1575,428,46365,149
34380,36,782,1095,528,8976,254
21438,76,3053,1341,2329,69335,724
62697,11,94,413,71,3230,23
35304,41,1211,1072,920,15027,291
38534,1094,16041,987,12087,206777,3954
15916,17,662,1438,390,16032,272
57723,24,196,580,172,9380,24
51262,57,331,775,243,4581,88
3627,129,6145,1572,4323,47989,1822
48766,11,154,842,129,8018,25
59777,8,113,512,93,11606,20
52655,12,91,731,77,4463,14
21402,321,9202,1342,6210,48901,2992
24472,149,3588,1289,2627,38369,961
46323,5,73,882,49,4943,24
60283,4,43,494,37,4124,6
67163,1,27,285,24,2658,3
53441,209,2738,708,2432,75467,306
20779,267,4219,1354,3006,26597,1213
41437,5,59,945,47,7032,12
51544,1304,14361,767,11630,106146,2731
50033,20,618,807,419,12678,199
17491,10854,198778,1412,127629,496806,71149
45621,12,190,890,167,5722,23
20932,89,2118,1351,1443,26927,675
49485,40,619,821,609,14832,10
67034,356,6251,289,5521,68954,730
15603,72,793,1443,546,9429,247
20409,29,1120,1360,711,13436,409
18833,26,1001,1388,694,15150,307
30672,10,411,1160,250,9277,161
41780,246,5636,939,4346,49764,1290
29263,25,726,1188,373,9841,353
21796,21,644,1336,457,12312,187
63525,14,101,392,72,7080,29
63792,9,214,385,184,6229,30
21813,39,1079,1336,701,25178,378
13857,9,264,1467,158,8865,106
35480,77,2038,1068,1270,20226,768
6943,133,3053,1531,1713,45613,1340
1255,81,3189,1593,1657,32050,1532
5784,10,306,1546,191,6238,115
6761,70,4227,1533,2446,28288,1781
38157,18,381,998,273,10308,108
29986,18,564,1174,371,8188,193
67563,93,1553,272,1541,29755,12
26464,25,2075,1246,1079,7651,996
21581,1,95,1339,63,3847,32
36044,81,1278,1054,1041,11962,237
36744,23,704,1037,513,13658,191
14409,0,0,1459,0,8783,0
56822,21,235,604,198,5950,37
14356,21,872,1460,607,15369,265
18225,204,11416,1398,7268,42052,4148
16572,385,7870,1428,5068,53363,2802
22605,1651,47625,1325,30992,224987,16633
28322,2,54,1205,37,3273,17
21201,89,2022,1346,1449,41480,573
15933,38,558,1438,439,25566,119
22689,291,4875,1323,3465,32778,1410
30065,31,487,1172,362,15963,125
56153,53,677,623,438,17968,239
3170,12,345,1577,210,11871,135
1844,180,6010,1588,4255,77335,1755
34678,37,400,1088,343,13609,57
15728,6,601,1441,400,16707,201
22520,23,882,1326,634,10374,248
56101,72,872,625,780,32545,92
67567,248,4254,272,3732,65523,522
54577,70,683,670,555,20668,128
19856,68,2071,1370,1396,21424,675
40305,985,14811,963,12145,99524,2666
5038,6,409,1554,289,18375,120
34908,4,154,1082,126,20697,28
36021,532,7432,1055,4557,56812,2875
59213,17,300,532,209,5108,91
12351,14,681,1488,358,14798,323
4935,307,12680,1556,4813,41065,7867
35683,231,3406,1064,2826,51369,580
34010,1348,17233,1103,12091,65437,5142
35538,3,133,1067,69,4832,64
32783,49,1493,1126,902,24486,591
63279,1235,17641,399,15986,104593,1655
8697,54,1312,1514,790,18228,522
28020,11,651,1211,421,10229,230
32659,47,624,1128,441,10069,183
34146,22,657,1100,349,6687,308
58050,1078,19322,570,17203,83258,2119
14613,18,491,1457,353,19140,138
23925,11,456,1301,334,16206,122
20505,29,774,1359,471,22770,303
22850,3,343,1320,250,10653,93
36917,590,8911,1029,7103,49046,1808
5488,12,796,1549,431,12841,365
16505,2,255,1429,191,11575,64
31854,165,2765,1141,2024,32334,741
15498,6,154,1445,113,6045,41
772,251,8796,1596,6221,38886,2575
29038,4,35,1192,35,6031,0
19588,37,1281,1374,939,12714,342
13192,115,1752,1477,1033,11690,719
36337,168,1924,1046,1452,12383,472
17753,129,7814,1407,3908,34010,3906
60390,7,168,491,136,7316,32
60478,4,33,487,31,1647,2
16896,4,180,1422,139,10959,41
23983,369,9298,1300,5545,137524,3753
9474,36,1213,1511,570,10522,643
19233,1443,37522,1381,25373,139437,12149
3724,35,808,1571,609,42572,199
37036,143,2620,1023,2184,38275,436
15333,76,2663,1447,1463,36439,1200
1465,16,890,1591,528,22084,362
40802,8,269,955,197,8489,72
25076,8,289,1275,196,11710,93
19608,226,8756,1374,2687,110092,6069
61686,11,165,445,108,5355,57
47091,31,423,872,376,16077,47
67808,99,1302,264,946,17439,356
11749,35,958,1494,436,13734,522
19397,31,660,1378,496,6456,164
51519,127,1124,768,1008,42529,116
145,2207,164660,1603,92206,967530,72454
14543,17,577,1457,432,13182,145
46460,1696,25660,880,18090,202158,7570
43265,121,3159,915,1295,18220,1864
15399,91,1854,1446,1445,24414,409
9137,22,1095,1512,670,13957,425
468,840,21002,1599,11659,88764,9343
18172,1774,40826,1400,24359,143176,16467
20951,14,199,1350,125,5374,74
37584,556,14206,1013,8847,67966,5359
9191,72,2434,1512,1498,14421,936
14441,206,4076,1458,2906,38366,1170
53070,16,223,717,212,12037,11
55001,14,124,655,120,9669,4
34567,17,367,1091,278,15182,89
8,89,5043,1606,2470,90645,2573
6946,43,610,1531,471,10816,139
6333,1550,42613,1539,25004,103143,17609
5721,19,726,1546,416,11060,310
41204,79,1178,949,885,10511,293
30504,13,620,1163,375,13049,245
28880,2338,49145,1195,20153,323423,28992
57263,43,904,592,567,10665,337
56050,57,570,626,398,12599,172
29828,6,139,1177,92,6165,47
12867,7,255,1481,151,4293,104
15656,242,6239,1442,3869,69946,2370
5653,33,1894,1547,1078,10935,816
35651,22,530,1062,389,10413,141
55906,3,46,631,37,3006,9
31029,164,4174,1153,2245,22770,1929
18053,15,740,1401,540,8441,200
23892,38,1196,1302,811,18217,385
11100,396,7520,1500,4707,46253,2813
19570,3,111,1375,59,5782,52
20560,12,608,1358,490,8728,118
8267,2,193,1516,139,3929,54
61807,1018,16366,440,14705,106480,1661
34800,133,1846,1084,1324,23271,522
25851,49,586,1259,347,10521,239
2531,1423,60913,1583,38083,344592,22830
22981,10,539,1318,358,10502,181
51747,39,621,761,522,11337,99
15715,27,1046,1442,815,33911,231
35963,12,390,1057,297,11403,93
7655,428,10288,1521,6316,35972,3972
49421,1298,25086,693,12974,106230,12112
23617,19,509,1307,380,16565,129
34705,48,1469,1087,688,11466,781
33155,54,1134,1119,777,16048,357
54125,109,1320,686,1191,21673,129
63807,10,214,384,173,10453,41
9790,53,1414,1509,613,11031,801
58781,67,954,545,732,12597,222
377,15,679,1600,317,20970,362
13728,21,1157,1469,710,44034,447
29478,103,4092,1184,2527,40004,1565
31258,209,7715,1150,3618,42209,4097
34708,505,7412,1085,5005,62469,2407
6442,227,10367,1538,5557,101305,4810
49498,200,3210,821,2497,35360,713
56730,66,668,606,521,19185,147
60154,32,463,499,403,8947,60
35992,240,5328,1056,3041,27625,2287
56692,37,401,608,382,10417,19
31672,66,2305,1144,1438,30611,867
41463,13,222,945,176,8649,46
37001,21,318,1030,280,8943,38
5159,24,1535,1553,494,26000,1041
40775,259,3695,955,3278,44080,417
48792,37,1219,842,932,20889,287
45115,38,485,895,308,3989,177
27037,4,307,1232,181,14002,126
60788,797,8605,475,8004,62893,601
19530,36,1643,1375,1228,69417,415
19087,1672,44987,1383,28891,232642,16096
7650,57,1829,1522,1190,17321,639
52687,27,334,729,255,15283,79
46030,31,527,885,440,19433,87
65087,17,278,344,248,7261,30
7144,5,209,1528,134,13876,75
48518,167,1816,851,1582,18042,234
54031,12,520,690,178,5813,342
1961,156,5939,1587,3503,61270,2436
15286,3,161,1448,119,5682,42
20387,7,246,1361,140,6943,106
12869,24,1663,1481,647,12008,1016
34464,11,507,1093,286,15316,221
45533,1123,25534,890,16582,175701,8952
8950,42,1663,1513,1043,15680,620
61394,21,117,454,105,5247,12
58936,24,486,540,363,11470,123
7045,2574,68106,1530,33942,255479,34164
24753,40,1699,1282,1083,15422,616
18473,32,825,1394,525,21919,300
26375,55,1962,1248,1338,21582,624
31824,51,922,1141,623,5182,299
62046,591,13930,433,9706,72509,4224
53084,154,1282,717,1280,25503,2
60759,22,392,476,337,11116,55
63700,6,60,387,56,4611,4
5871,7,174,1545,123,22673,51
3352,835,25887,1575,16060,107075,9827
54032,37,707,690,411,10362,296
18115,24,304,1400,231,9760,73
35205,13,326,1074,274,8237,52
61292,10,143,456,132,6204,11
38919,235,2510,981,2101,20801,409
66569,7,257,304,208,3406,49
16735,17,582,1425,411,11964,171
10428,314,5894,1505,4415,38079,1479
23785,361,7684,1304,5370,49326,2314
45303,2,31,893,20,6356,11
933,208,8897,1595,5869,31754,3028
34642,238,4419,1089,2441,49670,1978
37944,3,70,1004,44,6111,26
43877,32,775,909,549,11412,226
2601,47,2397,1582,1458,57266,939
63561,46,426,392,344,6924,82
5842,315,13441,1545,7528,209629,5913
32134,100,2302,1137,1191,15696,1111
65882,166,2682,325,2200,23435,482
31329,128,2224,1149,1649,26126,575
24187,274,3771,1295,2579,26044,1192
27751,41,851,1217,588,17040,263
12011,237,5220,1492,3403,32624,1817
52541,872,30818,735,12864,212468,17954
35961,5,63,1057,62,4186,1
66189,44,580,316,459,8905,121
44843,47,769,898,665,10646,104
8318,94,3433,1516,2354,26171,1079
28462,190,1606,1203,1413,17297,193
6504,21,675,1537,416,26880,259
401,32,858,1599,589,21880,269
24329,36,1100,1292,608,13954,492
9897,909,71666,1508,40388,204026,31278
4197,104,5900,1566,2430,37360,3470
59435,7,86,524,73,6040,13
19936,1924,50192,1368,25250,203545,24942
69792,37,1243,198,1206,17604,37
51726,111,1532,762,1199,25716,333
43977,13,231,907,212,13376,19
22942,11,352,1318,237,5725,115
60201,9,78,497,61,7921,17
27288,579,11685,1227,6691,91518,4994
62332,13,300,423,287,7461,13
8835,854,31081,1513,19039,124321,12042
26316,244,11252,1249,4463,65697,6789
56492,629,7621,613,6757,68313,864
52952,18,232,721,187,6160,45
11657,27,1632,1495,863,14317,769
5386,9,708,1550,386,8497,322
18644,7,198,1391,170,8652,28
56071,32,375,626,236,11504,139
56807,105,2145,604,1417,30138,728
8961,46,1591,1513,1081,41485,510
29221,10,234,1188,163,8293,71
44949,45,1517,896,637,20554,880
746,12790,287583,1596,143069,569590,144514
11193,4758,170992,1499,89026,483618,81966
9029,17,878,1513,581,11772,297
13620,4,451,1471,219,5631,232
36172,34,711,1051,696,34103,15
17968,163,2081,1403,1450,20319,631
21601,3,99,1339,59,8532,40
24046,6,151,1299,141,4417,10
24877,34,1880,1280,1111,27715,769
20812,1516,73537,1353,26892,256590,46645
56242,11,143,621,84,4358,59
33787,607,12520,1107,9706,75910,2814
26564,14,508,1243,279,20797,229
63834,234,3740,384,3151,30980,589
57205,120,1077,594,1036,16243,41
67925,48,498,260,391,5559,107
9417,99,3308,1511,2177,21339,1131
10880,115,4771,1501,3205,33811,1566
12345,33,2291,1488,1450,20539,841
41322,97,1401,935,1072,21497,329
30760,446,13430,1158,8298,208308,5132
22538,2425,62143,1326,42284,165166,19859
65503,4,22,335,20,2223,2
15991,121,1559,1437,1150,34192,409
17788,3,177,1406,116,8512,61
48876,19,306,839,253,9425,53
51699,542,9761,762,7978,67537,1783
16989,132,5742,1421,3708,29747,2034
55261,55,1040,648,929,15117,111
19022,390,13569,1384,9358,125276,4211
24939,22,473,1278,298,6425,175
62957,3,48,407,46,3151,2
16603,407,10446,1428,7503,37456,2943
27331,158,9092,1226,4976,52941,4116
22310,7,384,1330,278,19040,106
9959,1401,55794,1508,28524,291182,27270
6948,11,646,1531,379,32775,267
50100,393,5810,805,4482,68582,1328
25165,69,757,1274,528,6991,229
18091,820,21659,1401,17163,97718,4496
29362,24,633,1186,472,21172,161
57413,4209,115817,589,61832,453747,53985
36200,15,412,1051,279,11518,133
22080,15,432,1332,322,5291,110
66467,7,83,308,72,4490,11
58684,12,102,548,71,3257,31
56429,4,120,615,115,10654,5
58677,89,1222,548,973,13022,249
14627,18,1090,1456,826,27484,264
24341,314,7395,1292,5587,43022,1808
30494,99,919,1163,801,28216,118
36468,2,58,1037,50,7127,8
17982,22,598,1402,471,15744,127
33240,34,653,1117,455,17387,198
31303,55,1540,1149,954,22918,586
68848,8,103,228,86,2351,17
63551,891,12165,392,9050,42511,3115
6075,1115,42932,1542,19914,269977,23018
36426,15,352,1043,291,7190,61
5646,63,2297,1547,1398,14017,899
28487,15,405,1203,229,7517,176
13264,47,1987,1476,1268,55675,719
68292,15,173,249,159,3954,14
33259,170,3706,1117,2322,21093,1384
34113,267,6233,1100,4214,74889,2019
29080,8,600,1191,408,46531,192
27707,435,19364,1218,10187,122641,9177
58099,185,3255,568,2499,35177,756
5441,167,20698,1549,5500,72512,15198
8655,111574,4723747,1514,1476687,10136768,3247060
35713,2768,76769,1063,55731,405813,21038
9864,95,1832,1508,1298,25563,534
40937,583,7562,953,5541,30196,2021
50516,12,191,794,139,6362,52
37951,424,8765,1004,6808,51429,1957
2919,14,848,1579,617,47967,231
50992,6696,107392,782,76138,484570,31254
19354,118,2003,1378,1620,79238,383
59316,26,431,528,369,8913,62
9233,14,444,1512,231,11501,213
11681,35,787,1495,513,22770,274
4184,16,1149,1566,637,11100,512
34160,11513,362361,1099,153861,2069501,208500
49897,11,135,810,116,5880,19
8482,69,1687,1515,1079,28228,608
41612,9013,130776,942,97863,754729,32913
29527,116,4521,1183,3388,28597,1133
31467,20,394,1147,261,6825,133
27440,22,565,1224,386,5040,179
35322,150,2488,1072,1753,39569,735
27818,5,184,1216,99,12970,85
62499,13,120,419,96,3819,24
27445,132,5864,1224,4254,70445,1610
56291,38,676,619,591,16109,85
13762,297,6542,1469,3864,79351,2678
17513,3,141,1411,118,4979,23
16393,6,88,1430,66,19411,22
42013,4,166,935,91,4596,75
22442,40,1648,1327,1239,25430,409
14990,11,319,1452,225,15977,94
12823,50,1891,1482,740,17951,1151
1933,3,169,1588,116,21073,53
15517,202,9742,1444,6374,68533,3368
48573,354,4978,848,3373,70090,1605
30747,547,9569,1158,6455,51135,3114
56924,6,100,601,76,7657,24
36876,149,1777,1034,1545,19689,232
50798,493,9989,788,6635,86699,3354
55702,64,896,636,843,14412,53
1994,3030,68938,1587,38810,343203,30128
39934,3,105,969,89,5361,16
65429,0,14,337,12,1707,2
13639,137,6923,1470,4002,88895,2921
42558,5,209,927,139,18227,70
12061,5,272,1491,122,5621,150
43,422,17903,1604,10955,161105,6948
23029,1239,46859,1317,23433,340318,23426
62011,5,108,434,59,3689,49
15122,3827,149110,1450,74580,543345,74530
57237,194,1763,593,1585,16860,178
34516,29,613,1092,427,14337,186
11311,32,1255,1498,472,11183,783
61423,1,27,453,27,4708,0
65431,119,3077,336,2615,21405,462
25930,27,592,1258,415,21003,177
47296,41,1109,869,819,32631,290
13571,908,22817,1471,14548,90440,8269
5065,37,958,1554,676,32692,282
30774,18,487,1158,285,8017,202
14873,30,1530,1454,643,12664,887
50942,33,411,783,288,10638,123
10901,6521,208740,1501,123156,878089,85584
24166,3,96,1296,74,5924,22
34661,82,908,1088,687,21215,221
61059,23,373,465,233,8964,140
32774,0,69,1126,46,3831,23
34084,16,446,1101,214,8280,232
9175,93,2513,1512,1593,44066,920
11981,1081,45831,1492,26385,209212,19446
2900,282,10570,1579,3099,59273,7471
4613,371,9161,1560,5978,67506,3183
13028,37,721,1479,571,19040,150
21254,341,6964,1345,4431,50516,2533
30321,4,250,1167,220,9671,30
7359,20,665,1525,485,13922,180
63210,10,125,400,107,4442,18
2692,17206,582408,1581,368323,1464056,214085
26572,120,4641,1243,3082,23813,1559
41257,48,1200,948,994,17858,206
18257,189,15309,1398,8095,80384,7214
27161,57,1064,1230,586,13642,478
56035,44,687,627,663,20981,24
4523,31,1591,1562,987,25636,604
43004,34,510,920,344,11868,166
66670,15,60,302,55,4023,5
52204,28,295,747,292,24829,3
55422,8,138,644,83,8987,55
60600,10,97,482,85,6423,12
18938,420,5205,1386,3325,24819,1880
28047,41,1039,1211,686,18085,353
54283,18,302,681,227,7801,75
10477,46,946,1504,620,13793,326
33793,185,2527,1107,1716,19785,811
50296,9,103,800,95,15658,8
60861,41,448,457,349,9525,99
23808,78,2930,1303,1718,23541,1212
40852,38,765,954,597,22701,168
17667,4,161,1408,112,7385,49
2398,8,250,1584,176,7697,74
14745,46,962,1455,792,25742,170
13097,25,847,1478,477,68475,370
14617,83,3392,1457,1632,45718,1760
59599,46,778,518,679,21038,99
10067,542,14610,1507,8679,83274,5931
14610,8,301,1457,242,8130,59
65226,28,344,341,327,8647,17
32654,44,2053,1128,866,18724,1187
50571,48,953,793,833,5158,120
48395,81,1988,854,1314,40605,674
61072,34,388,464,347,10657,41
46092,132,2031,884,1687,49258,344
41027,201,4004,951,3092,42428,912
19109,0,0,1383,0,17898,0
49199,95,934,829,821,19296,113
9072,103,1642,1512,1136,13883,506
64549,47,332,361,309,8829,23
56537,97,1377,612,1232,34739,145
50234,16,260,801,205,9371,55
38019,11,541,1002,373,12874,168
28720,5,211,1198,137,10131,74
62564,83,847,417,695,15107,152
20354,64,1607,1361,1147,39104,460
56040,596,4817,627,3676,34109,1141
54005,2,16,691,16,3284,0
68092,0,33,256,26,3854,7
24624,38,1782,1285,957,13088,825
26676,8,360,1240,200,10475,160
4901,10,305,1556,208,26560,97
14235,9,328,1462,229,21584,99
5626,2574,101110,1547,47325,657721,53785
51481,22,279,769,238,8236,41
3368,33,1229,1575,871,32775,358
11168,70,802,1499,503,15034,299
44288,6,78,904,67,3956,11
13881,26,1060,1467,822,38663,238
47176,1083,16082,870,11814,78118,4268
58518,14,263,553,167,3429,96
35343,60,1522,1071,1209,20837,313
19125,285,4521,1382,2649,47205,1872
25112,82,3666,1275,2699,31231,967
54107,45,431,687,267,9338,164
14183,17,710,1463,491,13902,219
43553,18,764,912,583,17716,181
48992,148,2057,835,1508,14166,549
42063,1,16,934,12,12278,4
49609,34,469,818,388,21919,81
24007,48,1604,1300,1092,62861,512
58070,40,335,569,267,6347,68
26142,86,1367,1253,953,18290,414
68346,1,112,248,51,3239,61
64916,31,510,350,291,11250,219
47885,467,7908,862,6882,92180,1026
60564,9,99,484,87,3856,12
14578,0,76,1457,46,13433,30
17677,24,550,1408,352,9566,198
67533,96,1530,273,1440,10190,90
68496,873,17570,242,13944,122946,3626
44389,43,833,903,664,9760,169
18918,0,267,1386,194,7663,73
35509,4,139,1067,88,6295,51
33518,94,1916,1112,1260,19243,656
6005,14,1205,1543,737,12470,468
9907,5,255,1508,179,14228,76
57607,163,3558,584,2479,36469,1079
28859,2,211,1196,139,13202,72
60341,1,8,492,7,1319,1
12281,1580,44100,1489,28255,217904,15845
24420,29,355,1290,280,27283,75
2966,155,6069,1578,4174,32596,1895
2548,112,4698,1582,3028,51183,1670
5280,79,2449,1551,1316,54894,1133
7615,193,16596,1522,8569,98623,8027
50510,15,290,794,241,8730,49
15678,271,7972,1442,5375,101514,2597
64289,34,380,368,375,8904,5
15249,180,4744,1449,3014,51187,1730
63426,44,811,395,758,15754,53
17524,298,13388,1411,8365,86586,5023
52311,69,1395,743,1170,14878,225
30317,4,204,1167,139,5492,65
63204,18,330,400,321,10531,9
21714,242,8617,1337,5169,79832,3448
1201,56,1708,1593,1294,35908,414
24410,114,5946,1290,2997,35163,2949
28970,74,2265,1193,1540,55361,725
51649,453,6290,763,4388,37461,1902
33444,237,4118,1113,3025,56344,1093
63764,153,1906,386,1541,14025,365
50034,19,165,806,136,19225,29
49853,1018,12837,811,11426,109277,1411
67039,33,475,289,420,11160,55
51315,337,4998,773,4039,30262,959
5474,12,636,1549,463,25785,173
33683,25,374,1109,291,6911,83
50515,22,406,794,293,4308,113
10615,46,1340,1504,836,15671,504
49354,24,445,824,347,8924,98
16258,61,1511,1433,999,24593,512
47863,23,353,862,323,10741,30
2729,100,4876,1581,2562,67691,2314
52748,181,3538,728,2277,32709,1261
22462,50,952,1327,707,9855,245
25933,488,15298,1257,8536,50907,6762
337,663,29191,1600,16060,165330,13131
49683,34,548,800,523,9186,25
30178,46,2149,1169,1263,35336,886
30787,140,2440,1157,1554,29481,886
7032,51,1179,1530,770,38897,409
32469,45,1011,1124,713,15353,298
4571,1670,36518,1561,27586,130915,8932
62878,49,400,409,326,3728,74
50488,66,991,795,819,17717,172
34879,18,539,1083,364,9264,175
18807,16,228,1388,185,22018,43
1338,180,4231,1592,2752,20234,1479
65186,21,213,342,208,5398,5
1329,5135,207093,1592,120902,1051101,86191
30927,102,3895,1155,1717,50095,2178
49581,90,1009,819,981,11494,28
38384,1879,29085,992,23259,324434,5826
32507,20,439,1130,300,7927,139
63820,72,861,384,696,10588,165
13211,32,1102,1477,540,12058,562
57142,107,1967,596,1037,13450,930
70538,2,40,174,37,4127,3
10358,107,2933,1505,1448,27128,1485
10905,574,8007,1501,4948,29246,3059
52111,22,205,750,187,4980,18
61641,9,241,446,163,20138,78
27735,2,56,1218,45,13548,11
9894,2019,64540,1508,28538,195576,36002
1267,66,3093,1592,1797,81903,1296
9435,37,1438,1511,1030,23717,408
20703,375,14942,1355,8398,132450,6544
32581,17,270,1129,228,10533,42
36916,248,3868,1033,2946,33237,922
4022,108,3824,1568,1928,55115,1896
49554,41,708,819,607,9286,101
39087,38,751,979,573,11157,178
29624,127312,3735954,1181,1365057,10148797,2370897
21357,22,525,1343,341,13697,184
17279,46,1521,1416,983,30121,538
16895,40,1820,1422,1125,36325,695
34683,13,393,1087,248,14303,145
26971,9,263,1234,156,8682,107
12307,412,12301,1489,7537,64660,4764
9282,532,9166,1512,5732,61913,3434
352,7,180,1600,129,12019,51
8029,259,7817,1517,5072,131253,2745
38748,217,3904,984,3295,61048,609
25548,17,384,1266,319,12223,65
19131,51,1523,1382,1002,22858,521
34620,671,11519,1088,8653,75709,2866
16615,1781,27786,1427,19203,119931,8583
66134,48,1636,318,1250,19938,386
69124,5,48,220,45,1444,3
61038,6,78,466,65,2442,13
55672,172,2137,637,1733,27193,404
65695,3,110,330,91,6689,19
11468,29,928,1497,328,7919,600
6960,107,4207,1531,2378,41461,1829
23378,16,341,1311,242,7498,99
29371,72,1050,1186,1009,51283,41
6828,118,5547,1533,3082,34318,2465
29342,21,245,1186,149,2874,96
4761,30,1678,1558,641,43434,1037
62541,4,27,417,23,1866,4
24485,232,6839,1289,4987,58046,1852
35114,102,1526,1077,1116,18929,410
60142,315,4881,499,2495,34616,2386
1498,34,671,1591,551,44705,120
59874,41,494,509,415,8617,79
20497,435,12125,1359,8769,159626,3356
55092,913,12986,653,11323,88511,1663
48915,494,10887,838,9462,119446,1425
21809,4235,69942,1336,48454,165911,21488
64438,9,209,364,178,8257,31
15699,8842,299281,1442,119995,1339591,179286
19538,2127,46162,1375,27172,151040,18990
59713,14,125,514,97,4633,28
61749,4,63,443,44,3232,19
36402,3,82,1043,63,8054,19
5967,27,966,1543,605,12628,361
36367,63,488,1045,389,6195,99
38075,96,3558,1000,2221,59881,1337
50941,1424,22887,784,18908,123107,3979
35590,171,2797,1065,1935,21794,862
23903,733,41120,1302,19664,310532,21456
7835,18,926,1519,492,12366,434
23269,94,2267,1313,1585,23734,682
12513,242,6331,1486,3757,35354,2574
56385,37,425,617,348,10257,77
16319,11,775,1432,531,9565,244
21515,14,1447,1340,782,17800,665
2901,49,1543,1579,966,34518,577
169,22,775,1602,407,6926,368
22081,5,236,1332,147,8759,89
30155,17,313,1170,210,6464,103
39928,2994,39047,686,32200,251465,6847
31587,449,8649,1145,5836,55551,2813
3036,2,268,1578,212,26055,56
22099,41,1884,1332,1144,31528,740
29294,14,231,1187,182,9986,49
19623,6001,300477,1374,114036,960353,186441
18310,694,20684,1397,15367,195075,5317
19002,127,6668,1385,3036,27944,3632
70187,2,77,185,53,3193,24
50038,22,249,806,204,13670,45
61946,52,415,436,409,5862,6
24924,512,17974,1279,11733,104061,6241
25389,16748,457766,1269,261439,2283666,196327
15592,168,5198,1443,3883,71938,1315
53182,115,1288,714,1051,20721,237
21893,69,3066,1335,2303,47199,763
29966,16,515,1174,380,12049,135
47260,32,659,868,601,19444,58
23166,239,4843,1315,3899,76920,944
25678,565,8493,1263,5590,87910,2903
33,579,12106,1605,7118,105856,4988
12736,54,1452,1483,752,16412,700
38436,17,536,991,400,11183,136
7115,32,1229,1529,634,35083,595
38080,1,142,1000,71,4727,71
43981,20,199,908,169,9637,30
12325,349,11874,1488,5876,67312,5998
17703,500,14156,1408,9897,104062,4259
46486,35,733,879,548,12677,185
50814,16898,363583,787,212030,1572996,151553
4377,46,1781,1563,1345,49379,436
22952,938,22814,1318,13117,62222,9697
7574,14,916,1523,698,20048,218
67028,3,83,290,71,3425,12
35582,275,8841,1066,7277,80422,1564
36967,50,1057,1031,822,16278,235
32810,81,1935,1125,1055,10690,880
49267,29,380,827,290,4645,90
11482,28,1370,1497,867,49477,503
66981,233,5033,291,3728,43699,1305
29114,446,11871,1191,7615,98759,4256
14636,27,403,1456,315,14033,88
25199,170,8318,1273,5037,45562,3281
37526,168,2427,1015,2033,43320,394
5582,4,152,1548,111,7323,41
59244,135,2605,530,1311,16103,1294
26296,30,840,1250,584,17360,256
317,102,4549,1600,3220,32876,1329
2933,2504,152531,1579,46615,657967,105916
24793,4,198,1282,127,11924,71
1259,73,3493,1592,1829,40324,1664
68047,15,167,257,122,4771,45
27325,2,174,1227,119,4850,55
49054,47,576,833,449,6686,127
51005,22,208,782,204,13333,4
12667,4,328,1484,194,30210,134
16422,23,455,1430,290,9661,165
58682,10,72,548,49,19430,23
6438,4,166,1538,104,17478,62
7069,203,2746,1529,1809,19585,937
46871,222,4832,874,2200,48857,2632
33984,13,95,1103,72,13150,23
49746,491,6235,814,5344,94628,891
23905,8,221,1302,177,8394,44
11035,14,357,1500,210,5605,147
64454,15,227,364,227,3921,0
19481,138,5169,1376,2771,59726,2398
57506,204,3243,587,2381,26299,862
50535,48,585,793,446,11552,139
41875,6452,133779,937,106849,648569,26930
57294,14,195,592,177,4042,18
32871,77,1567,1124,1019,18039,548
672,52,2147,1597,1168,33733,979
1720,474,16336,1589,10557,65079,5779
7645,16,227,1522,198,5609,29
29884,80,1292,1176,927,12620,365
3829,50474,2396202,1570,646439,5531856,1749763
50323,16,190,799,161,5105,29
34692,29,562,1087,359,10157,203
16181,295,6282,1434,4203,54766,2079
38776,145,2523,983,1988,66934,535
29536,13,310,1183,249,16271,61
51157,30,588,777,433,16129,155
62343,9,179,423,106,3975,73
42865,173,2022,921,1575,19479,447
49131,178,3624,831,2168,34754,1456
55112,5,46,652,35,3107,11
47853,16,364,862,291,5525,73
2025,205,6624,1587,4044,41552,2580
17646,60,2820,1409,1532,16454,1288
32102,10,246,1137,164,14579,82
46934,366,7348,873,6291,124671,1057
6235,176,6316,1540,4013,51418,2303
43761,63,764,910,563,8130,201
53819,6,141,697,94,4826,47
2889,5460,355807,1579,143564,620565,212243
23305,12,344,1313,245,19588,99
67260,7,126,282,104,7754,22
59754,29,409,513,291,7222,118
4645,39,777,1560,574,26457,203
53152,6305,103582,715,68797,686894,34785
41848,163,3438,938,2778,64828,660
2541,46,2917,1582,1617,50399,1300
5903,50,2129,1544,1201,21759,928
38296,50,529,995,432,4756,97
36462,28,760,1042,543,9317,217
55943,121,2570,629,1978,19629,592
6587,37,769,1535,580,10069,189
32715,45,877,1126,532,27546,345
30259,14,483,1168,330,18849,153
1919,127,4669,1588,3197,41170,1472
53389,4,59,709,53,2661,6
14969,53,813,1452,513,13037,300
31632,195,4008,1144,2272,37283,1736
54004,35,543,691,283,9024,260
50846,86,1354,786,1025,16557,329
14437,14,778,1458,565,22772,213
13469,1136,26601,1473,16386,200006,10215
7413,6,515,1525,255,8416,260
10890,206,4942,1501,2729,57414,2213
8658,127,3522,1514,2520,20268,1002
17149,54,1439,1418,801,8582,638
59598,10,106,518,72,5330,34
54311,113,1222,680,885,18631,337
25330,229,3531,1270,2294,38505,1237
60114,68,1205,500,880,33526,325
12926,5,602,1481,244,25350,358
59764,127,1372,512,1275,10084,97
3910,183,3815,1569,2528,110428,1287
27378,613,12057,1226,8298,103799,3759
20757,24,760,1354,551,20031,209
60097,218,3231,501,2382,19562,849
11695,11,478,1495,178,10713,300
47773,142,1502,862,1217,35540,285
6411,2262,41055,1538,30164,203255,10891
18692,2,109,1390,79,5018,30
62937,14,206,407,153,4367,53
41760,126,1321,939,1007,20677,314
22224,52,2416,1330,1794,15282,622
47957,172,3403,861,2628,53947,775
31153,66,1722,1151,978,40468,744
15932,3,116,1438,40,5814,76
12862,1568,46572,1481,28493,284694,18079
1203,24,972,1593,715,28244,257
22844,483,14428,1320,7998,65450,6430
30758,75,2726,1158,1245,32731,1481
55336,8,35,646,33,4909,2
49115,18,217,832,164,6074,53
63446,164,1159,394,1128,12010,31
52584,7,103,734,94,15989,9
38086,369,5824,1000,4389,45981,1435
65128,20,245,343,205,4671,40
21906,5,276,1335,159,8850,117
62796,66,663,411,619,7339,44
26683,24,378,1240,225,9029,153
65103,2,12,344,11,2288,1
69180,0,0,218,0,802,0
22508,9,372,1327,239,11957,133
28776,84,2546,1197,1768,53693,778
40678,431,7078,958,5428,45477,1650
28377,2208,37287,1205,24971,141032,12316
34900,25,587,1082,307,17859,280
60212,338,5116,497,4464,66053,652
6738,237,13594,1534,6992,116372,6602
15608,2,210,1443,132,5136,78
32959,65,3208,1122,2359,24524,849
31765,33,1605,1142,902,18199,703
19200,2,102,1381,72,5215,30
15562,7,503,1444,369,37896,134
35051,1106,24053,1079,19925,127341,4128
17693,19,680,1408,465,8044,215
61164,10,142,461,111,5551,31
21513,6,118,1340,77,9411,41
18356,7,144,1396,127,14664,17
64716,142,3626,356,2966,32081,660
18772,2146,40132,1389,28247,180046,11885
45601,7,173,890,102,4529,71
49766,981,15381,813,13599,120386,1782
14172,66,3134,1463,2180,41870,954
53976,8,106,692,77,3561,29
6911,102,2685,1532,1467,13921,1218
15637,51,1689,1443,1088,22580,601
16037,55,1355,1436,1062,21199,293
68394,69,701,246,492,9350,209
10920,0,17,1501,13,7525,4
34783,51,1847,1085,1366,90087,481
4945,28,1077,1556,777,20323,300
624,159,2343,1597,1314,11087,1029
24801,139,4827,1281,2473,62431,2354
22106,105,4614,1332,2448,28580,2166
40140,2,57,965,24,4819,33
58433,32,439,557,397,10151,42
5393,33,1913,1550,1136,25303,777
20773,358,5882,1354,3217,42965,2665
27623,55,1041,1219,547,6737,494
51547,22,123,767,109,7012,14
36546,58,929,1039,760,12481,169
64998,17,244,346,188,8170,56
58096,14,105,568,82,5617,23
12967,2,112,1480,69,9251,43
56244,4,67,621,46,6696,21
32803,38,694,1125,497,14945,197
31418,19,607,1148,429,17042,178
21203,14,880,1346,575,12943,305
26641,111,2225,1241,1659,27427,566
38187,25,326,997,308,9534,18
59520,5,37,521,33,2549,4
65407,126,1859,337,1834,23802,25
1874,1063,34442,1588,21889,163243,12553
64291,47,571,368,532,18221,39
9893,115,2622,1508,1656,15665,966
8786,6,508,1514,307,16654,201
38355,2,101,994,83,3590,18
11816,12,849,1494,285,11941,564
37522,30,897,1015,716,27064,181
47533,71,1061,866,814,13773,247
9195,48,1427,1512,897,23921,530
21774,134,2962,1336,2064,23639,898
25759,35,1076,1261,620,11462,456
14983,0,48,1452,35,4540,13
8521,459,8859,1515,6140,36759,2719
58192,61,1438,565,930,14947,508
7577,137,4152,1523,2627,123475,1525
25117,13,638,1275,426,27158,212
10632,91,2021,1503,1359,14235,662
56336,2,41,618,31,2807,10
56025,5,60,627,57,5124,3
56021,96,1391,627,1245,35523,146
65917,11,123,324,105,4432,18
38301,3549,74687,995,52436,338685,22251
57873,9650,146663,575,105279,500987,41384
33591,112,3758,1111,2393,24459,1365
59133,164,2477,534,1590,29609,887
35849,16,325,1060,227,5746,98
31491,1004,12379,1147,9586,65797,2793
768,56,2132,1596,1117,31375,1015
52890,12,101,723,83,4466,18
47358,35,240,868,189,7318,51
59558,2525,50684,520,29093,372324,21591
59128,241,2735,534,2237,17200,498
57297,5,75,591,55,4097,20
62420,20,306,421,244,5089,62
3767,5,355,1571,262,25494,93
10899,40,1390,1501,545,22550,845
33192,137,2973,1118,2078,30361,895
30364,32,689,1166,427,4584,262
29923,335,6439,1175,5159,47114,1280
55511,32,288,641,239,10739,49
67293,12,150,271,140,4826,10
59364,60,646,526,538,17586,108
28238,36,1496,1207,929,22450,567
24583,28,933,1286,608,13064,325
29488,14,985,1184,595,9889,390
4869,15073,619734,1557,252787,1325126,366947
7598,15,775,1522,543,32507,232
10115,5409,189629,1507,109663,588653,79966
56022,570,10023,627,7449,43814,2574
35857,505,5194,1059,3794,30802,1400
12037,31,1128,1491,641,19501,487
35933,20,328,1058,240,7469,88
52609,18,207,733,161,7933,46
55280,263,3172,647,2418,46603,754
28031,53,1145,1211,573,17867,572
18245,27,499,1398,386,12878,113
46156,2719,68334,883,23858,209057,44476
16703,579,17359,1426,9226,115932,8133
35429,97,1022,1069,527,13950,495
19341,83,2113,1379,1324,33376,789
13588,51,749,1471,407,17328,342
2021,9,641,1587,434,21862,207
8522,58,2248,1515,1559,34049,689
28267,71,5466,1207,2385,70586,3081
16097,486,13553,1435,7657,113148,5896
56147,5053,132208,623,77672,638881,54536
31909,1551,24309,1140,18237,83301,6072
64316,24,107,368,102,24433,5
30298,36,1286,1167,745,32522,541
8287,23,568,1516,370,23465,198
62512,20,531,418,479,7676,52
24786,66,1570,1282,858,32365,712
22664,23,562,1323,437,12032,125
13490,413,13920,1472,8414,85565,5506
49537,26,444,820,406,17687,38
7265,14,544,1526,401,18929,143
40860,76,1052,954,627,16285,425
49591,58,1039,818,775,13145,264
45624,3,68,889,58,11484,10
57161,56,631,595,571,13141,60
9488,133,3288,1511,2114,34277,1174
37677,938,17733,1011,11578,157116,6155
33933,31,364,1104,270,17803,94
27400,11,215,1225,148,10151,67
31000,226,5451,1154,3691,23137,1760
21135,42,1052,1347,679,11879,373
38507,1725,32931,973,18745,92861,14186
15704,147,2996,1442,1824,32289,1172
20510,6,200,1358,154,10702,46
69437,23,219,210,201,6955,18
56640,296,5457,609,5108,48977,349
30628,7,115,1161,110,3831,5
20978,50,2407,1350,1354,13780,1053
23661,22,699,1306,565,28847,134
40020,45,1106,967,796,18827,310
5095,1,202,1554,181,15161,21
34282,8,448,1097,282,9034,166
25469,882,12537,1268,9645,107884,2892
19924,988,22577,1368,13459,105323,9118
55545,10,157,640,153,9179,4
10339,149,4495,1505,1980,33840,2515
57121,52,747,596,613,23434,134
54862,118,891,659,820,13086,71
11565,52,1992,1496,1296,19014,696
7519,130,3140,1523,2333,35653,807
40393,20,734,961,545,16015,189
420,34,1647,1599,964,41281,683
54827,50,443,661,289,10402,154
24302,63,2654,1293,1715,50785,939
26662,2677,39543,1240,24940,111788,14603
23279,69,3011,1313,2282,125731,729
61403,16,745,454,247,8533,498
57287,35,561,592,350,13653,211
48836,669,7079,840,6711,112023,368
24550,17,358,1287,286,5014,72
50671,471,8564,791,5243,33786,3321
53652,10,124,702,97,10287,27
7186,91,4548,1527,3151,67819,1397
50356,131,2107,798,1790,21070,317
39622,68,1595,972,562,24975,1033
10295,5,234,1506,163,22908,71
20491,509,7709,1359,4997,66675,2712
97,22,522,1603,392,13235,130
64720,33,1114,356,897,39246,217
42456,98,1681,928,1253,6359,428
25787,14,363,1261,223,14293,140
28401,35,830,1204,535,11205,295
27829,855,10062,1215,8436,75389,1626
19127,3,422,1382,297,19040,125
28443,104,3047,1204,2069,14296,978
64570,8,166,360,152,9153,14
19472,6,154,1376,100,22697,54
54914,254,5005,658,3876,42103,1129
2612,98,1668,1582,1242,19521,426
16544,62,2031,1428,1229,29030,802
42626,135,1325,925,1045,19340,280
49192,78,1207,829,1009,12352,198
54894,12,36,658,29,4315,7
38306,76,1252,995,990,18758,262
10763,18,662,1502,445,11772,217
23624,6,154,1307,112,9061,42
15787,10,407,1441,296,13605,111
23360,36,2043,1312,1029,20017,1014
60481,72,1162,487,779,19694,383
19475,75,1688,1376,1192,33867,496
58264,14,177,562,150,10727,27
29435,19,739,1185,441,8153,298
58828,134,3196,543,1982,35347,1214
16757,784,28402,1425,13736,264316,14666
69621,24,418,204,190,6879,228
67938,106,1376,260,1239,18361,137
5602,17,874,1548,445,21965,429
67898,20,185,262,164,9680,21
19716,131,2622,1372,2236,21809,386
906,4,230,1595,170,12071,60
29236,27,930,1188,642,9099,288
2551,154,8115,1582,4484,63204,3631
41665,38,642,941,475,3564,167
56383,69,1184,617,776,7794,408
6052,21,537,1542,357,19735,180
66693,26,230,301,195,7371,35
28212,61,1656,1208,969,13841,687
16027,28,372,1436,281,23775,91
60691,18,230,478,193,6187,37
45042,1173,24841,895,14455,165315,10386
55760,84,836,635,727,9706,109
38979,33,494,981,395,4946,99
21082,1689,36680,1348,23655,127095,13025
32640,11,609,1128,187,14147,422
14376,13,377,1459,314,20053,63
60681,29,447,479,381,24978,66
59463,4621,82667,519,60524,576676,22143
11660,53,3061,1495,1524,27124,1537
5652,42,1148,1547,836,20586,312
32029,114,3555,1138,1344,30748,2211
53990,67,673,691,561,11339,112
12400,97,6817,1487,3075,43673,3742
57330,381,5101,580,3788,28968,1313
11011,352,8865,1500,4385,53867,4480
16286,23,651,1432,429,15106,222
38881,2,79,982,43,4504,36
38088,31,241,1000,186,5481,55
22773,17,546,1321,321,8104,225
755,46,2421,1596,984,30704,1437
5090,29,680,1554,306,35403,374
50877,180,2232,785,2143,27032,89
35597,36,554,1065,436,10014,118
12851,683,24318,1482,14711,109574,9607
21176,3,116,1346,77,6429,39
63802,102,1973,384,1597,25584,376
61459,84,1360,452,1175,27556,185
17765,58,2139,1407,985,28454,1154
51065,134,1750,780,1483,54296,267
7503,102,3063,1524,978,13762,2085
25603,1277,22633,1265,14024,95690,8609
5068,4,225,1554,162,17822,63
58315,11,90,561,59,3839,31
51161,92,1651,777,1390,34047,261
21325,57,667,1344,497,18280,170
26161,10,159,1253,111,5905,48
49981,327,5506,808,3283,69230,2223
50785,57,774,788,644,12613,130
21447,7,390,1341,253,13129,137
51002,372,4488,782,3372,53034,1116
55871,22,312,632,260,12910,52
15931,27,1227,1438,957,57024,270
55618,148,2800,638,2197,57233,603
40703,48,1305,957,1091,18900,214
35728,87,1993,1063,1685,17219,308
29440,5494,111512,1184,72361,532134,39151
37551,136,2126,1014,1777,25800,349
11815,18,580,1494,345,20762,235
31497,7,336,1146,212,8144,124
60701,11,134,478,133,9382,1
2169,12,411,1586,289,16002,122
55899,209,3372,631,2929,29420,443
32786,20,467,1121,224,7226,243
65308,120,4103,340,2670,31599,1433
28339,43,1164,1205,722,19035,442
33217,165,3426,1118,1863,13452,1563
22258,79,2488,1330,1570,33108,918
40696,235,2117,957,1674,36617,443
55638,125,3274,637,2228,19038,1046
7565,8,597,1523,131,15224,466
57856,299,3564,575,3316,48061,248
9819,91,3561,1509,1583,34702,1978
49797,58,566,812,515,10762,51
27564,41,1324,1221,582,10906,742
50448,116,3086,795,2584,37976,502
67638,82,882,270,862,17460,20
20213,168,3860,1363,2879,29396,981
10663,313,10650,1503,6831,106221,3819
36722,907,20711,1037,13090,202450,7621
55493,491,7389,642,5907,107557,1482
25106,23,705,1275,456,16492,249
30450,63034,1989997,1164,916292,5081732,1073705
56275,799,20742,620,12684,205746,8058
23356,9,364,1312,299,13588,65
53517,20,419,707,265,21065,154
14963,18,694,1452,468,8873,226
55625,55,465,638,390,12036,75
15682,1,66,1442,41,7454,25
34256,91,2012,1098,1331,10049,681
11606,66,3279,1496,2171,36979,1108
3249,118,5445,1576,3126,80476,2319
37208,26,391,1024,283,10705,108
26290,359,11828,1250,5413,101773,6415
9709,106,2456,1509,1853,65521,603
16838,202,10659,1423,6097,65292,4562
50228,15,180,802,146,7330,34
1435,24,640,1591,427,27284,213
24081,28,819,1298,517,10463,302
20373,14,753,1361,596,35792,157
35496,1116,24109,1068,21223,175128,2886
3808,9,142,1570,113,21700,29
28014,2992,82943,1211,33644,345058,49299
33860,460,5980,1101,3742,80801,2238
15058,2,540,1451,402,19665,138
9141,102,1505,1512,1207,19366,298
29364,14,282,1186,189,9964,93
68676,7,115,234,93,4164,22
7707,547,24129,1521,17370,93121,6759
64738,22,417,356,338,7845,79
36909,64,1797,1033,1637,34493,160
52441,3,72,739,53,6075,19
55557,2,62,640,62,3942,0
68236,19,671,251,474,18537,197
20128,2,270,1365,213,10067,57
35351,39,404,1071,382,11204,22
20998,12,567,1350,414,13363,153
18731,173,4066,1390,2643,69410,1423
36298,51,1469,1048,920,21511,549
47415,11,336,867,199,6562,137
54493,1381,20179,625,12515,168277,7664
31669,4082,58616,981,48871,258487,9745
63905,95,1083,381,971,14303,112
53042,116,1035,718,976,15586,59
52412,55,657,740,593,33712,64
16157,161,5618,1434,3409,103999,2209
16556,5,234,1428,176,13345,58
6450,419,20372,1537,11251,89093,9121
32674,8,229,1128,192,8551,37
21633,562,11960,1338,8490,79917,3470
32686,16,513,1128,319,20358,194
3466,112,3838,1574,2791,55789,1047
59693,6,86,515,71,2522,15
30077,9,193,1172,117,20050,76
30224,267,4703,1169,3596,70264,1107
43899,1753,27968,909,19918,143069,8050
18470,166,4381,1394,2951,49635,1430
3362,25,452,1575,334,15434,118
31094,57,1055,1152,672,16659,383
57898,82,810,573,551,10878,259
17757,69,2741,1407,2013,52875,728
67702,83,805,268,754,8455,51
56530,381,8984,612,7414,85369,1570
37764,2139,26969,1008,18708,127031,8261
10800,4,200,1502,115,12075,85
54250,65,611,682,560,32371,51
2580,193,5155,1582,3858,27301,1297
15919,380,15937,1438,11178,51954,4759
17014,41,936,1420,625,11521,311
44962,10,133,896,83,7080,50
28641,10,734,1200,449,10224,285
35473,12,469,1068,300,9023,169
17268,38,2020,1416,1360,32570,660
31296,52,1059,1149,737,15036,322
43493,8608,102385,913,80519,266374,21866
6941,30,1185,1531,790,21505,395
58003,39,321,571,247,6432,74
7284,5,257,1526,165,32831,92
40353,10,152,962,146,7460,6
25373,1795,47697,1269,35571,305069,12126
33789,3,66,1107,42,8525,24
22989,115,3733,1318,2766,71322,967
55352,345,12640,645,6201,427781,6439
9729,22,339,1509,233,7529,106
15495,70,881,1445,502,7134,379
14980,24,816,1452,581,18249,235
639,88,3153,1597,2119,38088,1034
27008,157,4680,1233,3399,31653,1281
5448,29,993,1549,748,32117,245
1717,15,788,1589,445,12611,343
48736,5,110,844,107,5385,3
48777,1221,16075,842,12236,106479,3839
11587,161,7601,1496,4727,166701,2874
3011,306,7176,1578,4693,67743,2483
1137,59,1546,1593,1092,23806,454
6125,7,459,1541,303,22872,156
37023,5,38,1029,37,3468,1
12690,665,22342,1484,11660,90573,10682
11282,769,23793,1498,16095,147609,7698
12847,15,907,1482,547,23861,360
26825,44,1808,1237,789,33680,1019
63195,7,136,400,94,5766,42
62058,9,186,431,167,8539,19
57684,22,248,582,177,7813,71
834,823,22568,1596,15300,143270,7268
11078,9,291,1500,190,14710,101
21957,34,785,1334,547,11298,238
980,17,1363,1595,738,16834,625
61988,21,239,434,223,8626,16
21429,67,1665,1342,932,27827,733
14555,36,1053,1457,697,11995,356
17094,64,2340,1419,1523,37683,817
18211,250,4920,1399,2674,48449,2246
35879,29,1084,1059,726,16078,358
22030,268,3431,1333,2520,24565,911
621,50,1611,1597,1183,19884,428
17158,392,20949,1418,6426,101845,14523
60442,27,175,488,158,5976,17
24920,164,3075,1279,1989,27529,1086
54137,24,357,686,223,56363,134
21057,29,833,1348,629,18104,204
39770,269,6417,971,5213,44858,1204
51415,3,60,771,36,3148,24
18164,18,391,1400,312,8273,79
62109,70,662,430,601,7351,61
10140,192,5447,1507,3347,35921,2100
58438,72,901,556,682,12133,219
62257,8,244,426,170,1926,74
22595,21,633,1325,449,31672,184
50219,489,9114,802,8214,51527,900
57452,20,264,588,175,6319,89
9160,64,1671,1512,1008,13612,663
9812,2,67,1509,53,5334,14
18795,468,17268,1388,11638,278892,5630
68331,19,271,248,246,6653,25
48559,17,202,849,136,5879,66
55599,16,150,639,131,4567,19
22055,391,5620,1333,4064,45181,1556
6458,70,2625,1537,1442,31038,1183
30484,31,1463,1163,989,22448,474
11139,3402,106447,1499,56597,544723,49850
32496,34,1097,1131,548,22142,549
38974,52,1004,981,806,30455,198
30004,43,1351,1173,812,33788,539
63865,4,41,382,39,2269,2
3232,35,670,1576,375,15268,295
26949,167,3067,1234,1771,33010,1296
7420,6,256,1525,178,13945,78
17324,58,1294,1415,892,15992,402
32691,442,11995,1128,9379,147820,2616
32091,246,4282,1137,3045,20895,1237
41802,33,648,939,502,8185,146
55532,179,1983,641,1773,31489,210
27149,10,219,1230,132,5556,87
48099,53,1661,859,1119,19910,542
24808,41,810,1281,688,26778,122
33484,169,4204,1113,2743,21725,1461
32127,5,77,1137,61,5671,16
61431,481,4375,453,4239,32140,136
48643,951,13338,835,10419,69357,2919
10557,159,4841,1504,3063,86922,1778
10906,83501,2871679,1501,1099635,6681175,1772044
511,30,1398,1598,995,55664,403
16626,125,12334,1427,7413,51677,4921
18727,39,991,1390,722,55534,269
20581,474,12754,1357,8537,119096,4217
12202,268,8853,1490,5017,58757,3836
43039,12,116,919,104,5178,12
30663,554,10291,1160,7752,69304,2539
51573,65,1083,766,842,15534,241
12672,81,1901,1484,1018,34862,883
67790,484,11398,265,10729,126622,669
15470,14,505,1445,368,11616,137
23018,144,3421,1317,2736,28885,685
13186,246,3487,1477,2559,26876,928
26482,1,66,1246,41,5104,25
17555,22,621,1411,498,13132,123
44693,5,124,900,97,6053,27
30968,1860,33284,1154,21655,146005,11629
23979,115,1702,1300,1393,24669,309
18806,12,354,1388,201,14093,153
37741,16,303,1009,299,7037,4
6998,110,2221,1530,1701,26830,520
63303,112,3563,398,3303,30884,260
3045,38,531,1578,369,4416,162
60439,4109,55601,488,48090,216494,7511
25169,17,267,1274,231,5878,36
61016,531,7559,467,6704,68631,855
40670,177,3294,958,2398,20578,896
63831,29,290,384,254,7396,36
36840,30,588,1035,410,8626,178
4400,1001,70032,1563,32839,361722,37193
14058,101,2778,1464,1663,24501,1115
29306,18,604,1187,352,8311,252
4419,3404,117514,1563,58159,280545,59355
27010,97,4435,1233,2941,39484,1494
37071,7,120,1028,86,5238,34
2668,33,1176,1582,715,33968,461
13285,2,161,1476,114,6289,47
15374,106,1647,1447,1295,61733,352
50262,5,106,799,70,5242,36
34016,57,1085,1102,607,27988,478
37738,709,9542,1009,7765,39977,1777
18740,220,8403,1389,5075,31990,3328
23457,58,1463,1310,1226,48936,237
33482,1624,26657,1113,16465,144227,10192
18640,21,1027,1391,583,14071,444
48362,29,527,855,374,19869,153
33810,396,13809,1107,9778,63451,4031
59077,42,420,536,378,12577,42
48220,33,562,857,409,16082,153
22008,13,825,1333,624,27678,201
33024,32,888,1121,627,24319,261
33434,31,1039,1114,870,16041,169
43677,554,11015,911,8526,72912,2489
64997,23,345,347,277,4632,68
6922,33,1011,1531,689,16551,322
20642,29,652,1356,490,10001,162
14170,179,6068,1463,3960,38963,2108
2965,185,5972,1578,4045,54663,1927
5783,948,40414,1546,19773,136102,20641
52297,124,1369,743,1153,29566,216
19524,31,1134,1375,556,46165,578
52200,103,1065,746,845,18805,220
53076,41,521,717,456,11018,65
2593,102,4222,1582,2666,69820,1556
7712,1510,33625,1521,20887,203397,12738
49474,1,24,821,20,3771,4
50750,14,345,789,248,9975,97
28351,168,2918,1205,1838,27776,1080
44056,20,182,907,131,3849,51
21754,84,1834,1337,1218,20933,616
29905,408,8887,1175,6279,102188,2608
26900,225,7092,1236,4693,33870,2399
13076,3346,165139,1478,97239,415390,67900
15758,253,8211,1441,5869,89610,2342
7494,69,2276,1524,1496,33898,780
19827,84,4294,1370,2445,55529,1849
12490,0,0,1486,0,7259,0
36142,5,165,687,143,4295,22
9965,55,845,1508,619,14175,226
26829,19,544,1237,337,14229,207
64734,7,63,356,51,6532,12
19694,89,2727,1372,1563,23853,1164
13581,865,41315,1471,17141,250700,24174
46941,108,1536,873,1406,30757,130
27433,21,625,1224,394,20964,231
34137,147,3230,1100,2149,163564,1081
23522,33,1567,1309,1015,9096,552
3016,23,710,1578,516,32878,194
10441,47,1111,1505,705,10152,406
49153,0,206,831,169,9048,37
25668,154,3675,1263,2015,34749,1660
64441,7,124,364,97,6288,27
5562,65,1964,1548,1143,13826,821
54654,14,113,667,71,6933,42
51992,227,3276,754,3034,27703,242
15848,3,181,1440,118,6232,63
52888,357,4840,723,4482,39960,358
25270,118,2273,1272,1595,39079,678
54507,35,418,673,374,7862,44
52442,21,381,739,350,6127,31
51316,69,789,773,694,18957,95
49612,663,8893,818,7118,44433,1775
53340,100,855,710,590,11341,265
3193,201,7227,1576,4591,47317,2636
10060,171,4817,1507,3188,28524,1629
4978,470,26237,1555,15567,186896,10670
24337,21,649,1292,435,10300,214
31335,14,389,1148,238,21640,151
12422,141,2929,1487,1778,35554,1151
36009,1,30,572,22,2663,8
3941,30,1400,1569,981,13125,419
1805,30,1123,1589,705,15319,418
17288,11,381,1415,307,20800,74
31100,120,3574,1152,2567,72026,1007
40747,15,232,956,176,8874,56
11571,0,0,1496,0,9173,0
57687,10,119,581,95,4865,24
29272,15,518,1187,277,7420,241
36154,179,4976,1052,3873,43471,1103
21423,27,826,1342,467,10563,359
36229,1,38,1050,26,4157,12
53314,891,11536,711,10781,72205,755
5500,29,685,1549,446,20256,239
9140,47,675,1512,489,26312,186
6040,233,7733,1542,6160,91318,1573
17637,8,270,1409,211,8436,59
3424,1117,77932,1574,38675,207659,39257
10520,44,2122,1504,1094,22582,1028
43147,45,1138,917,904,17964,234
67856,4,104,263,80,3271,24
53455,642,10135,708,8986,125751,1149
45018,64,769,896,627,20526,142
55830,25,482,633,357,5409,125
58506,112,1629,554,1452,24045,177
53344,36,506,710,448,15902,58
18222,2,79,1398,66,20632,13
11280,41,1761,1498,1005,56532,756
16569,915,29873,1428,12429,123938,17444
54016,8,110,690,82,5929,28
31135,39,2175,1152,1546,32884,629
23655,0,0,1306,0,8894,0
21011,20,358,1349,243,4028,115
19138,3,99,1382,86,8855,13
26265,88,2784,1250,1156,19424,1628
25522,0,0,1267,0,15370,0
35281,264,4412,1070,3971,44165,441
27653,62,1322,1219,872,14692,450
64133,16,134,373,122,4295,12
32070,167,3443,1137,2498,42575,945
20434,779,19535,1360,13408,156605,6127
1120,168,5581,1593,3467,32905,2114
23838,16,302,1303,195,9896,107
50276,18,233,798,187,12604,46
37455,14,351,1017,291,10235,60
11134,116,4915,1499,2844,36607,2071
17470,4,135,1413,119,11775,16
32931,20,499,1123,259,8796,240
6560,17,446,1536,361,38537,85
27038,7893,144204,1232,85842,394212,58362
25799,798,12400,1260,11065,257598,1335
51357,48,761,772,570,13165,191
1839,98,3633,1588,2307,25242,1326
65346,801,16343,338,16141,130264,202
3851,65,2337,1570,1062,34000,1275
51448,34,631,770,486,7675,145
66937,48,728,292,665,14550,63
61914,1515,29119,437,18707,163629,10412
68792,27,435,231,362,9332,73
59919,13,149,507,138,9952,11
58650,5,103,549,57,4729,46
66538,10,68,306,65,4845,3
9619,24,1209,1510,781,14218,428
37392,53,825,1018,643,16321,182
49507,18,417,820,348,11868,69
19527,8,268,1375,145,5525,123
22754,618,14430,1322,10271,70602,4159
5542,30,1894,1548,1099,19509,795
58470,259,4222,555,3748,34122,474
60135,188,12874,499,9155,34896,3719
40092,2,61,966,50,4297,11
33077,26,525,1120,336,7751,189
8503,68,3631,1515,2186,29883,1445
65981,142,3040,323,1340,11155,1700
28944,1928,75896,1194,36660,387804,39236
32260,2,218,1135,132,6528,86
29531,28,2006,1183,1235,17150,771
38394,9,125,992,107,8860,18
18779,109,3012,1389,1996,26371,1016
33330,2065,33866,1115,26468,88534,7398
38634,672,7926,985,5589,48553,2337
64143,8,120,373,97,2697,23
22614,434,5338,1324,3378,24895,1960
10093,1685,40381,1507,21175,195762,19206
31902,74,1746,1140,1354,41981,392
5657,67,2190,1547,1160,36337,1030
21683,62,749,1338,463,13503,286
12522,87,1971,1486,1067,26673,904
33115,31,771,1120,524,15827,247
25823,521,10345,1260,6215,102299,4130
18773,17,543,1389,419,11906,124
37773,95,1707,1008,1044,22544,663
31066,60,1480,1152,1006,21637,474
526,965,77768,1598,22788,256491,54980
28017,21,303,1211,249,8158,54
45804,14,116,887,106,6577,10
41303,34,430,947,362,11661,68
20715,1,66,1355,52,5117,14
28324,177,6062,1205,3902,46957,2160
11619,5,424,1495,158,7083,266
31880,89,1662,1140,1181,10216,481
17115,14,937,1419,656,20668,281
28075,19,471,1211,298,7043,173
14520,20,1422,1458,897,15400,525
67420,250,4952,277,4807,55011,145
5519,455,15167,1548,9151,48061,6016
42648,150,2952,925,1923,34998,1029
1033,4,579,1594,386,11962,193
1899,145,6824,1588,4398,44936,2426
9222,1438,45923,1512,26143,284489,19780
64174,4,72,372,68,3018,4
64353,11,150,367,130,5303,20
36517,657,26872,1040,13822,152950,13050
22320,57,1662,1329,1109,16075,553
11727,411,24927,1495,13481,123073,11446
27790,354,9554,1216,7042,79126,2512
18145,81,4175,1400,2824,35974,1351
3034,195,4425,1578,3288,31674,1137
6929,66,1228,1531,694,8792,534
34455,199,4576,1093,3496,24795,1080
63107,84,2029,403,1718,24646,311
10402,56,784,1505,552,16599,232
2150,23,2451,1586,1379,103525,1072
15906,3047,155247,1438,73943,415059,81304
49042,879,9633,834,7938,90576,1695
2115,34,2947,1586,1800,27922,1147
28635,22,321,1200,191,8814,130
63732,7,191,386,138,6866,53
35980,143,4585,1057,3086,60076,1499
61274,8,76,457,72,2213,4
58947,167,4534,539,3315,21072,1219
46962,22,614,873,519,8463,95
39511,307,5863,974,4779,99396,1084
19168,7,434,1382,144,13384,290
9958,241,7489,1508,3968,83582,3521
11490,64,5322,1497,2794,21348,2528
29485,68,1280,1184,1056,15486,224
62576,40,459,416,346,8202,113
51301,514,8470,774,7498,45942,972
40726,46,1165,956,1016,26219,149
22791,1856,62586,1321,26084,306754,36502
61289,1070,15354,456,12862,61162,2492
20787,15413,446788,1354,179531,1784355,267257
2724,77,3679,1581,2506,85439,1173
62715,69,1242,412,770,18367,472
5866,870,33112,1545,14912,189312,18200
56610,60,541,610,431,7738,110
61278,144,2070,457,1846,9213,224
32145,1094,28828,1137,12037,91819,16791
8413,15,794,1515,541,19609,253
8612,12,569,1514,355,8568,214
41372,19,448,946,364,21035,84
36100,243,5124,1053,4197,54043,927
53115,41,703,716,517,13010,186
52295,275,2304,744,1952,58509,352
18231,144,3455,1398,2867,40483,588
5718,25,413,1546,242,10055,171
35059,17,374,1079,285,11038,89
32093,25,557,1137,240,26970,317
53715,189,1890,700,1748,15251,142
18118,1,55,1400,44,3008,11
68362,645,11726,247,11720,135163,6
64807,151,4619,353,3232,45766,1387
3749,163,5327,1571,3772,26170,1555
34281,53,1561,1097,948,11572,613
26214,384,11530,1252,6938,81988,4592
50346,621,9383,799,7367,44646,2016
5851,43,978,1545,643,10688,335
41344,43,781,946,707,9038,74
6022,41,1333,1543,838,13094,495
22120,35,687,1332,508,15990,179
21998,130,8415,1333,5335,60979,3080
8404,49,2202,1515,1486,73231,716
9584,86,2740,1510,1849,44512,891
31366,59,966,1148,802,6942,164
30532,22,625,1162,392,16588,233
9090,1440,42207,1512,26796,238177,15411
46295,8,153,882,121,7179,32
12371,55,3144,1488,1495,26245,1649
9860,3,203,1508,112,4255,91
30347,227,3903,1166,2281,23510,1622
18990,37,1583,1385,1008,16219,575
28926,4353,152664,1194,71228,772584,81436
23946,17,347,1301,221,13763,126
67178,31,560,284,502,5413,58
20772,182,5449,1354,3444,39553,2005
50381,43,714,798,590,20075,124
56083,1386,16173,625,15727,80225,446
29549,158,4557,1183,2253,71525,2304
62656,132,1357,414,1309,12248,48
24755,6,181,1282,107,5463,74
5088,34,1446,1554,891,28915,555
56041,74,953,627,815,24730,138
55152,95,692,651,563,7133,129
16742,10,136,1425,113,7977,23
9144,30,909,1512,507,21028,402
21775,6,302,1336,171,10077,131
11558,31,1006,1496,545,14660,461
33970,29,1027,1104,482,10894,545
24451,117,2743,1289,1825,33306,918
41910,13,307,937,236,8581,71
28213,15,532,1208,408,14136,124
54522,43,434,672,331,5606,103
37880,34,595,1006,547,12822,48
54099,56,246,687,223,6427,23
47961,53,841,861,632,6476,209
32819,54,1282,1125,810,13579,472
64766,23,491,355,398,9671,93
34151,165,4742,1099,3806,82911,936
51104,101,2395,779,1878,38423,517
48823,41,446,841,379,8867,67
22126,276,9225,1332,4359,59944,4866
7897,9202,913300,1518,278193,2074173,635107
41597,41,610,939,500,18865,110
13170,1068,36345,1477,19563,200449,16782
13744,493,10993,1469,6571,76823,4422
57455,12,355,588,332,4986,23
8918,232,8177,1513,5237,42353,2940
14821,86,2251,1454,1401,55260,850
32055,81,1590,1137,1338,16188,252
33913,28,428,1105,315,8780,113
34525,18,417,1092,286,11962,131
30502,3,149,1163,115,2673,34
28406,300,5097,1204,3373,36904,1724
46339,48,762,882,688,19809,74
61546,609,19030,449,10694,154269,8336
19586,64,1604,1374,1136,21259,468
25195,132,4291,1273,2764,28520,1527
40022,12,388,967,357,9379,31
49494,67,565,820,446,12934,119
27555,77,2494,1221,1687,25537,807
37978,2919,112133,993,62103,573526,50030
36277,3416,96171,1047,36698,474841,59473
27571,661,19586,1220,12135,123352,7451
56018,5,125,627,71,7627,54
58388,48,576,558,403,7368,173
54358,63,597,679,507,20836,90
3544,141,6497,1573,3035,36044,3462
34810,16,262,1084,190,10850,72
41147,37,440,949,368,11506,72
15332,126,3862,1447,2722,44220,1140
2263,5,168,1585,119,19808,49
60750,165,3573,476,2700,20983,873
10578,1098,24612,1504,13705,171718,10907
1636,145,5001,1590,3240,45433,1761
53295,42,731,712,577,9047,154
9085,786,13339,1512,7318,78973,6021
48590,12,169,847,138,6492,31
12807,47,2868,1482,1559,33029,1309
24214,519,17895,1295,9453,135964,8442
17486,117,6218,1412,2942,57365,3276
10157,22,1003,1507,663,14963,340
11313,11,590,1498,320,8990,270
36527,225,3635,1040,2995,17570,640
22699,75,2720,1323,1863,56574,857
35082,11,254,1078,179,15189,75
49553,23,398,819,344,10507,54
46481,61,696,880,445,13364,251
23916,4305,78837,1302,60320,242714,18517
36767,3,69,1029,57,4989,12
59020,10,113,538,90,6469,23
54638,28,317,667,255,5252,62
69633,4,72,204,58,1172,14
3085,6,284,1578,203,12594,81
43577,48,499,911,334,6319,165
29997,10,454,1173,266,9514,188
32313,27,809,1133,515,6632,294
30385,399,6429,1165,4732,65804,1697
60513,32,366,485,302,12615,64
64091,0,19,375,18,1905,1
24627,2211,55043,1285,37990,245383,17053
31075,222,9506,1152,6106,100882,3400
9762,699,20979,1509,14150,88197,6829
42784,10,134,923,110,5784,24
37308,6,111,1021,79,4773,32
27542,513,9476,1221,7021,81824,2455
26345,729,14194,1248,8933,64671,5261
59245,18,198,530,193,7721,5
64011,103,1247,377,1226,12611,21
36419,20,530,1044,432,18606,98
56305,92,2106,619,1676,16253,430
14841,8,319,1454,236,14673,83
32172,314,4704,1136,3311,31720,1393
19787,3,110,1371,84,10681,26
62503,17,155,418,121,7122,34
18561,21,336,1393,258,5160,78
19929,115,5097,1368,4042,71486,1055
31615,26,681,1144,409,5920,272
67475,0,0,275,0,1786,0
62054,8,174,432,163,9511,11
21866,863,17240,1335,10600,91213,6640
17858,110,2169,1405,1588,72010,581
52756,53,557,727,526,19826,31
57272,89,898,592,774,11144,124
13344,27,667,1475,395,8567,272
46171,132,1581,883,1350,12210,231
16489,24,1064,1429,704,9368,360
27575,201,3694,1220,2270,47303,1424
39425,31,610,975,503,13518,107
16912,47,2551,1422,1324,29176,1227
62401,4,23,421,18,5126,5
25876,23,762,1259,559,15544,203
31056,64,1843,1153,1311,28110,532
15913,8,349,1438,136,9139,213
4596,3,561,1560,245,13106,316
16675,7,178,1426,136,8457,42
51007,192,2829,782,2416,64074,413
18902,313,7799,1386,4384,59532,3415
13448,841,16682,1473,10882,57942,5800
56663,34,598,609,474,14613,124
61716,179,2521,444,1941,24721,580
68098,6,57,255,52,2970,5
30671,16,477,1160,313,6225,164
56380,103,1297,617,1093,11098,204
61968,1032,26117,435,17391,218229,8726
67903,2,43,262,39,2484,4
62717,5,109,412,70,3613,39
45540,164,973,890,829,11729,144
8305,8,310,1516,179,13425,131
51289,530,6869,774,5066,58805,1803
4777,28,1094,1558,810,14220,284
66487,6,90,308,65,2027,25
16874,2,114,1423,81,14219,33
58057,3142,41319,569,35770,146522,5549
29035,68,2229,1192,1321,15071,908
51108,25,459,779,363,11360,96
34672,270,6105,1086,4890,129074,1215
33657,21,310,1109,269,7000,41
13665,1334,45791,1470,28226,232232,17565
15265,303,7416,1448,4637,63557,2779
10852,135,3019,1502,2228,17000,791
4870,53,2114,1557,1384,19210,730
13399,1331,69121,1474,36441,228510,32680
21074,32,1045,1348,705,10487,340
57013,7,199,599,185,4562,14
33026,84,2226,1121,1312,27924,914
52790,444,5470,726,4373,43022,1097
49793,6,42,813,33,3935,9
48008,40,809,860,423,30352,386
29583,108,2259,1182,1340,20180,919
5323,20,497,1551,311,22139,186
27572,163,3052,1220,1480,34997,1572
10462,827,14254,1505,9208,75681,5046
36534,6143,88356,1040,60034,279971,28322
35616,21,391,1065,301,5805,90
31620,107,5288,1144,1448,20804,3840
4102,389,12805,1567,8582,101929,4223
27562,2038,38375,1221,26089,203467,12286
29806,454,9333,1177,6859,85278,2474
58635,8451,195372,550,129747,776438,65625
64115,6,49,374,37,4555,12
35056,2631,76940,1079,30062,235339,46878
38997,21,528,980,452,31428,76
51690,233,2962,763,2173,32480,789
43997,4,176,907,144,25490,32
28453,44,1307,1203,839,28878,468
19247,182,2837,1380,1975,23665,862
54217,153,2806,683,1889,43319,917
14587,12,455,1457,322,18915,133
57814,126,1427,576,1038,24201,389
53648,8,90,702,89,6213,1
4232,627,21194,1566,14009,145042,7185
9776,367,13912,1509,8612,65938,5300
35486,466,5973,1068,5052,115636,921
42500,575,15920,928,7553,99155,8367
50899,6,62,785,46,3505,16
48725,635,12174,844,8714,105521,3460
35387,62,757,1070,601,11755,156
26904,1521,41080,1236,23898,336717,17182
19621,0,109,1374,76,6790,33
16488,22,508,1429,339,14119,169
20948,183,3120,1350,2209,40083,911
340,95,5750,1600,3460,36581,2290
30922,36,615,1155,508,12015,107
10014,715,39710,1507,21243,180718,18467
7697,3,200,1521,131,17283,69
58141,648,41988,567,10651,142791,31337
2517,169,4571,1583,2941,58154,1630
54120,6,29,687,22,6063,7
6805,18,983,1533,633,15109,350
35791,35,1835,1061,1145,11995,690
37485,29,508,1016,382,11218,126
21385,8,306,1342,226,9532,80
8246,228,4736,1516,2774,33239,1962
27105,37,2296,1231,1089,19695,1207
36999,114,1886,1030,1308,20568,578
28342,14,510,1205,337,25881,173
57407,99,1238,589,722,11655,516
21365,312,12944,1343,5100,29372,7844
51701,145,1388,762,1108,19343,280
40274,672,10746,963,9562,119135,1184
4873,744,14903,1557,8449,86785,6454
26363,16,488,1248,318,5536,170
59503,53,684,521,599,11728,85
39146,29,736,978,575,13493,161
61406,99,3577,453,1834,32229,1743
18605,11,645,1392,513,7717,132
60125,97,661,500,581,10535,80
60967,31,226,468,197,6730,29
37965,0,0,1003,0,3475,0
56246,168,2888,621,2490,30579,398
21333,137,2270,1344,1624,27834,646
52789,11,189,726,149,7417,40
57716,12,270,581,215,7500,55
26983,2671,90808,1234,41776,442518,49032
63766,2365,30272,385,23470,105793,6802
63244,11,104,399,89,3735,15
59797,38,1036,511,664,6712,372
24173,10,309,1296,241,10748,68
37259,99,1993,1022,1322,26385,671
10594,2147,32079,1504,19104,151672,12975
2701,209,5180,1581,3444,48274,1736
40028,15,320,967,233,8358,87
27375,221,2977,1226,2134,22144,843
21802,2,158,1336,122,10612,36
18520,7,413,1393,323,11722,90
36379,6,209,1045,153,5756,56
9472,483,17715,1511,11544,127263,6171
9441,13,746,1511,508,26661,238
53757,10,50,699,45,7495,5
36867,0,38,1034,32,3920,6
24414,29,579,1290,451,14171,128
23139,22,612,1315,419,13993,193
15184,4,1050,1449,214,11812,836
37986,0,29,1003,22,2519,7
5374,62,2850,1550,2156,27622,694
38549,1012,19400,987,11836,169362,7564
29314,0,0,1187,0,3392,0
55933,61,953,630,738,14365,215
12260,36,1707,1489,889,25178,818
59942,42,353,506,310,6236,43
56709,33,293,607,248,4205,45
44708,28,493,900,406,32599,87
61720,17,191,444,182,5737,9
15315,0,0,1448,0,20346,0
55470,74,1204,642,889,15608,315
14538,5,66,1457,49,4994,17
28423,6,453,1204,260,14516,193
35457,30,723,1068,566,23935,157
10845,28,1380,1502,835,23564,545
64457,2,31,363,29,5039,2
23913,2505,53606,1302,34612,282962,18994
30216,40,1839,1169,1203,15670,636
30092,154,2414,1171,1858,21910,556
28888,207,3791,1195,2024,16241,1767
61002,150,1917,467,1650,15900,267
27685,96,2449,1218,1702,23383,747
57388,5,132,589,89,7428,43
15339,3285,87199,1447,59133,446988,28066
60389,1743,25284,490,21401,213409,3883
31752,53,711,1142,483,10475,228
67857,19,230,263,192,12202,38
62727,32,358,412,325,6881,33
14850,10,441,1454,316,10020,125
1313,11,692,1592,407,13220,285
17809,124,2298,1406,1848,24040,450
30866,437,9239,1156,6986,55110,2253
18301,15,629,1397,397,15582,232
49090,8,81,832,69,5734,12
22343,215,5383,1329,3819,28160,1564
37404,1286,41323,1018,18480,206505,22843
22293,40,862,1330,608,52632,254
26309,16,671,1249,361,6412,310
60805,41,780,474,613,28641,167
36753,5,82,1037,60,2324,22
57320,26,429,591,341,8600,88
82,279,17938,1604,10143,157351,7795
53354,47,406,710,346,17703,60
55897,823,10601,631,9564,65267,1037
31429,80,1641,1147,1114,31987,527
58113,8,218,568,184,9332,34
18263,2747,62754,1398,48001,188623,14753
35168,86,1563,1076,1015,18756,548
66316,4,63,313,53,2605,10
13789,73,2396,1468,1430,24934,966
16919,2004,71877,1422,46766,628586,25111
31380,8388,184915,1148,92853,875759,92062
52866,46,399,723,324,5787,75
18643,38,985,1391,744,24530,241
21131,42,1693,1347,1054,24797,639
11497,127,3111,1497,1565,20224,1546
14898,192,4466,1453,3150,24559,1316
48813,12,233,841,180,10397,53
28209,23,941,1208,513,10282,428
29200,9,467,1189,313,7995,154
28534,11,236,1202,179,7129,57
1080,3,126,1594,78,9431,48
7678,52,1444,1521,978,29478,466
40117,154,2287,965,1704,23349,583
8358,1228,34009,1516,22240,237342,11769
14079,76,4078,1464,2567,29975,1511
598,37,2167,1598,1469,23311,698
49600,386,5124,818,3806,30139,1318
30640,29,460,1161,324,23029,136
30937,103,2064,1155,1361,24089,703
6134,23,885,1541,606,29345,279
23645,111,1807,1307,1258,41910,549
48547,21,526,849,420,9436,106
19269,1583,31129,1380,20421,108001,10708
36333,221,6702,1046,4095,24926,2607
15244,17,665,1449,475,14711,190
50716,11,238,790,175,7143,63
6495,8615,199308,1537,109543,491233,89765
4149,416,10276,1567,6622,53080,3654
17866,10,262,1404,183,5648,79
38336,145,2666,994,2106,19872,560
23296,24,1013,1313,676,10951,337
21962,426,5217,1334,3185,26213,2032
57489,420,10778,538,5705,98094,5073
9784,19,638,1509,266,6098,372
2932,131,6085,1579,2439,50586,3646
30763,29,988,1158,578,11307,410
47831,157,3929,862,2078,39580,1851
33640,4,328,1110,155,7517,173
29574,17,773,1182,532,15288,241
17706,66,3432,1408,1454,43730,1978
9718,259,13689,1509,5309,132622,8380
1476,32,706,1591,545,29996,161
45862,8451,243495,887,127772,1089179,115723
59202,8473,226225,528,114667,963517,111558
56498,37,645,613,552,14199,93
28784,29,914,1197,556,18128,358
60252,44,699,495,441,13595,258
31501,19,474,1146,377,12090,97
31257,105,2540,1150,1114,12731,1426
35674,22,355,1064,268,8827,87
4509,9,214,1562,172,10852,42
52137,126,1853,749,1380,20690,473
56142,10,181,624,152,5926,29
29016,11,351,1192,298,11229,53
51052,256,2122,780,1470,38028,652
36413,633,13342,1044,8913,85969,4429
53836,59,581,697,547,10621,34
31411,4,105,1146,62,2852,43
55016,43,496,655,391,13425,105
10090,15,392,1507,296,14204,96
28792,268,11608,1197,7927,81376,3681
61219,64,1519,459,1147,12040,372
34396,141,2060,1094,1522,27582,538
34331,797,11686,1096,8256,60532,3430
59928,43,679,507,591,10215,88
27328,9,472,1226,317,26168,155
3396,19,499,1575,376,15055,123
4862,37630,1634481,1557,538913,3458780,1095568
37211,107,1690,1024,1502,23212,188
13738,7,757,1469,420,20163,337
2226,258,13010,1585,7580,67573,5430
43749,473,7556,910,6091,51579,1465
15178,47,1095,1449,447,7219,648
28044,2723,68581,1211,42067,388316,26514
13608,23626,832473,1471,307703,3006304,524770
34950,37454,1420308,1081,531664,4112498,888644
689,7287,285847,1597,170671,827187,115176
417,45,2031,1599,1191,72934,840
36542,718,14069,1040,10201,118418,3868
13239,552,14628,1476,5388,71301,9240
7438,33,1788,1525,1196,34726,592
21457,833,34870,1341,18463,255468,16407
31394,40,459,1148,386,7810,73
10164,35,1256,1507,749,15900,507
66995,43,580,290,552,13182,28
15832,9,270,1440,173,11384,97
12635,140,14365,1484,7928,97336,6437
28503,245,3762,1202,1992,31270,1770
16816,158,3662,1424,2718,31355,944
15922,12,148,1438,99,8354,49
44822,17,407,898,326,9231,81
28961,32,1708,1193,833,27880,875
18966,13,355,1385,257,10040,98
21497,1,33,1340,27,3731,6
47979,48,774,859,531,11692,243
40655,268,5336,958,4431,90130,905
56826,410,3958,604,2868,48808,1090
39229,121,1628,978,1425,51419,203
20769,104,3555,1354,2379,45119,1176
59183,450,6999,533,5527,76161,1472
35878,113,2014,1059,1248,28504,766
55213,76,1336,649,896,24295,440
66371,14,293,311,281,10185,12
47051,14,377,872,246,8357,131
31756,26,778,1142,487,19145,291
27100,18,857,1231,445,17478,412
7753,6,355,1520,208,35509,147
18489,888,14433,1394,11755,101237,2678
55373,224,1781,645,1645,21196,136
22727,1632,25553,1322,14023,112902,11530
46847,28,608,875,466,35695,142
30128,368,11775,1170,8506,115613,3269
54904,23,306,658,230,7078,76
11793,95,2327,1494,1161,11659,1166
57392,5,118,589,90,6979,28
53380,36,308,709,250,12886,58
8834,24,1675,1513,813,20810,862
8417,0,54,1515,41,4567,13
54484,100,1123,674,984,11099,139
4640,684,10518,1560,6844,58852,3674
29068,18,476,1191,296,11191,180
31790,1,151,1142,111,6607,40
19088,7,230,1383,202,9729,28
974,93,2830,1595,1983,54147,847
6220,188,5813,1540,3320,50753,2493
63873,11,129,382,109,2600,20
34660,10,248,1088,180,12014,68
46389,58,819,881,687,10324,132
17556,26,1098,1411,680,11206,418
66506,23,333,307,288,6419,45
15732,24,1004,1441,561,20406,443
49965,19,410,808,351,27819,59
256,5841,286501,1601,167781,1381739,118720
30622,55,1632,1161,884,14992,748
23024,101,2248,1317,1592,20727,656
12554,10,780,1485,442,9407,338
67041,21,840,289,769,13116,71
35502,34,588,1068,474,10901,114
1009,6141,210637,1594,129342,594863,81295
4325,4,731,1564,329,29841,402
48339,329,4836,855,4512,72233,324
54229,496,5475,683,4206,49804,1269
41120,14,215,950,163,5161,52
62534,147,2208,417,2126,35623,82
43233,41,525,915,462,18564,63
18315,125,4129,1397,3157,84069,972
18192,19,934,1399,650,40711,284
38220,10,300,997,218,6774,82
62293,43,1033,424,949,22426,84
10199,6,164,1506,105,7210,59
56369,118,1567,617,1408,19621,159
16367,5,517,1431,309,15202,208
53405,2,36,709,16,2399,20
13501,62,2641,1472,1045,21296,1596
6003,25,422,1543,309,12634,113
35782,139,1507,1062,1236,8872,271
23848,537,17725,1303,11210,134745,6515
24008,71,3236,1300,1733,42730,1503
13427,184,5159,1473,3059,59545,2100
64585,30,434,360,399,7100,35
50987,11,118,782,101,5582,17
16985,413,5688,1421,4730,38039,958
2452,21,571,1583,376,13785,195
52741,36,624,728,514,11596,110
47065,50,931,872,721,12624,210
23649,181,6265,1307,4743,113985,1522
21659,1863,40208,1338,29120,141851,11088
9459,22,532,1511,369,12910,163
41391,4414,70744,946,54786,325957,15958
59398,11,196,525,138,8657,58
25757,54,2036,1261,1386,12436,650
26628,200,3872,1241,2056,20055,1816
5282,125,6260,1551,4869,43099,1391
28885,35,2636,1195,1541,46247,1095
24019,7312,169544,1299,94774,664530,74770
9276,48,1405,1512,914,18369,491
36956,196,4321,1031,2029,24158,2292
28229,3,62,1207,44,4143,18
18396,5,102,1395,80,8099,22
28025,339,10342,1211,5382,59745,4960
12237,46,850,1489,522,9968,328
33254,24,595,1117,401,14643,194
23081,114,1996,1316,1366,49642,630
8030,12,631,1517,273,7637,358
59845,1,42,510,26,5949,16
49272,51,510,827,438,22722,72
2905,964,30243,1579,18579,127224,11664
49772,5,149,813,105,9732,44
4639,19,972,1560,584,11255,388
39541,610,8272,974,6242,61737,2030
37098,26,584,1027,492,11909,92
11859,29,1939,1493,865,23520,1074
67376,29,184,278,169,3357,15
51019,245,3290,781,2600,33896,690
38231,40,697,996,611,16576,86
56973,19,345,600,304,14322,41
47212,114,2810,870,1375,25018,1435
14355,116,2993,1460,2216,69522,777
48290,1097,17884,843,13361,80488,4523
22301,7,103,1330,63,34868,40
33919,2049,59453,1105,28131,220916,31322
34756,1215,18160,1086,12555,95826,5605
44441,87,1077,902,972,18105,105
20879,26,1213,1352,774,16372,439
47605,27,435,865,418,6353,17
18762,125,6546,1389,3459,47798,3087
58656,3283,78438,549,40192,468412,38246
17798,372,11534,1406,7502,89347,4032
54156,105,963,686,777,11182,186
52800,1529,37071,726,30729,335279,6342
1647,3548,98483,1590,55254,198196,43229
31425,36,803,1147,588,14139,215
32858,10,201,1124,145,10307,56
62272,44,560,425,512,8953,48
10516,6,177,1504,125,8099,52
17633,21,962,1409,712,21358,250
18725,1,271,1390,200,8481,71
68492,8,46,242,45,2656,1
62580,850,9899,416,7459,96094,2440
851,61,2125,1596,1459,34925,666
14399,1709,56513,1459,37555,604006,18958
37162,44,823,1025,614,15399,209
51138,4,49,778,43,2460,6
32956,2,117,1122,72,2496,45
28105,7,186,1210,157,4602,29
8362,41,1129,1515,759,24222,370
17225,14,394,1417,310,16908,84
6683,125,2184,1534,1413,18299,771
42069,6,171,934,156,3705,15
14886,248,6138,1454,4770,55018,1368
59473,83,743,522,625,7096,118
23366,75,4772,1312,2482,36397,2290
25296,15,277,1271,209,6429,68
53060,632,9074,718,7922,85949,1152
40574,188,2254,959,1878,32955,376
30735,66,1148,1159,692,7236,456
56740,15,270,606,215,8765,55
33927,141,2210,1105,1426,44684,784
4510,227,10668,1562,6941,61515,3727
46104,35,329,884,249,4856,80
5722,40,990,1546,647,42632,343
10751,370,13410,1502,6698,104828,6712
67681,12,167,269,151,5773,16
65119,97,1597,343,1498,31719,99
10537,347,9764,1504,7437,66252,2327
53481,7,184,707,76,13102,108
54144,160,2136,686,1598,21339,538
28045,12,409,1211,326,6982,83
38132,128,2830,999,2217,29084,613
3966,26,474,1568,379,9417,95
22504,25,435,1327,312,9049,123
2544,1289,45183,1582,25815,289338,19368
4008,489,12391,1568,4647,73255,7744
53859,7,74,696,71,4861,3
49833,38,663,812,591,14625,72
50325,432,5679,799,4766,57824,913
26211,35,330,1252,210,5012,120
32841,158,9531,1124,3672,57320,5859
9562,199,6833,1510,2930,30241,3903
58884,33,408,542,284,9548,124
12506,2737,76133,1486,44736,498453,31397
14660,149,2918,1456,1736,36481,1182
20064,15,1006,1366,582,21074,424
19120,45,2426,1382,1608,18695,818
10844,15,685,1502,430,35556,255
57061,13,153,597,96,11538,57
23240,59,1984,1314,1434,37340,550
29956,150,6339,1174,4053,48491,2286
66421,1,36,310,35,4988,1
21399,25,522,1342,381,11782,141
45001,49,592,895,521,20246,71
33296,1985,34558,1116,25797,131459,8761
43218,1,55,916,40,1884,15
58015,188,1746,571,1639,20356,107
1245,254,9360,1593,5548,94441,3812
22914,40,911,1319,552,18840,359
9815,81,2415,1509,1495,24968,920
10473,94,2287,1505,1664,34825,623
15196,12,1017,1449,665,12227,352
37502,1,172,1016,104,6360,68
59676,13,124,515,81,5107,43
13041,0,0,1479,0,8663,0
5630,157,4573,1547,3118,34082,1455
20349,15,642,1361,431,7377,211
5418,251,7880,1550,5419,35428,2461
1930,73,2312,1588,1590,57745,722
38214,2,36,997,34,3578,2
11927,9,704,1492,350,14167,354
50870,158,1249,786,1050,15874,199
12996,24,1489,1479,933,36959,556
16407,28,1453,1430,1009,53161,444
16754,364,10088,1425,5464,47151,4624
46035,49,796,884,642,16223,154
13152,8,368,1477,200,12631,168
62615,5,85,415,82,3772,3
13522,187,5403,1472,2960,44486,2443
34064,204,4287,1101,2751,31203,1536
37853,58,1103,1006,800,10364,303
26105,9,444,1253,278,8561,166
62034,51,462,389,408,9919,54
31883,43,1877,1140,1224,14084,653
30233,17,938,1169,740,37104,198
34822,59,886,1084,683,19289,203
35211,0,32,1074,27,2691,5
173,715,30667,1602,16470,129087,14197
8451,501,17541,1515,9825,111537,7716
9820,34,1928,1509,1331,22247,597
63207,67,802,400,603,12390,199
3058,5,413,1578,217,19358,196
1508,289,9513,1591,5889,65202,3624
63614,2,150,390,54,3766,96
63901,73,1243,381,1231,15600,12
23794,15,614,1304,429,14119,185
21212,83,1978,1345,1138,10357,840
2667,0,77,1582,66,18718,11
31092,46,1243,1152,740,20447,503
46406,935,17522,881,14174,195158,3348
56505,1,30,613,29,6772,1
34647,34,795,1089,548,11008,247
20378,15,710,1361,491,25662,219
69580,85,487,204,436,15729,51
56123,31,356,624,282,5946,74
30177,18,427,1169,277,6187,150
16194,32,1488,1434,959,40744,529
30570,59,874,1162,545,8710,329
29387,72,1984,1185,1700,74591,284
3146,27,676,1577,468,62170,208
60394,55,858,490,744,8760,114
29394,67,3253,1185,1565,18428,1688
7523,635,22951,1523,11775,156795,11176
28785,475,14564,1197,10740,115975,3824
22735,127,2431,1322,1722,22658,709
17745,180,9275,1407,5340,78578,3935
12439,78,1401,1487,787,16848,614
60365,21,256,491,167,5696,89
42664,88,1282,925,1001,32999,281
26991,159,6809,1234,3991,56124,2818
68955,52,457,226,393,6980,64
7726,7,689,1520,266,27859,423
13241,1223,36075,1476,18120,219876,17955
59158,44,2186,533,728,16207,1458
42123,24,564,933,416,14987,148
2545,26,568,1582,368,28004,200
23621,16,580,1307,445,40877,135
20553,142,4165,1358,2890,88135,1275
10721,36,929,1503,595,9228,334
884,7,302,1595,206,23162,96
32878,698,12819,1120,9667,103075,3152
25501,11366,432113,1267,131777,1049381,300336
49592,45,524,818,426,12648,98
19390,103,2614,1378,1781,28749,833
22428,24,694,1328,595,7157,99
63743,158,2260,386,1039,18574,1221
10405,11,308,1505,200,10656,108
13922,1593,56784,1466,41509,132714,15275
21858,2,62,1335,53,4168,9
31734,5,112,1142,89,2321,23
59526,5,67,521,49,3424,18
24876,8,386,1280,235,6858,151
36533,4,231,1040,173,6950,58
13983,1264,37349,1465,23917,255188,13432
38344,2373,33597,988,29137,240043,4460
40194,134,3273,964,2501,76268,772
4872,5,144,1557,95,4516,49
4214,240,4406,1566,3258,35398,1148
49593,626,7583,818,6518,69142,1065
19471,118,2782,1376,2280,63855,502
13940,186,5956,1466,3185,58214,2771
23780,1500,36066,1304,28048,286004,8018
28204,33,598,1208,397,20651,201
20808,10,190,1353,92,7144,98
15292,7,536,1448,433,21450,103
26563,5,422,1243,262,9248,160
22668,7,312,1323,222,14106,90
26652,24,1863,1241,1225,17811,638
36005,29,469,1056,403,18809,66
8388,42,754,1515,502,11419,252
5816,3131,86003,1545,41468,298745,44535
25283,189,2205,1271,1377,15175,828
2062,122,8714,1586,5961,98629,2753
11046,193,13695,1500,5046,90540,8649
50645,69,776,791,723,8252,53
34032,874,21096,1102,8717,130126,12379
17957,26,839,1403,632,22260,207
3483,967,31535,1574,19991,74868,11544
57667,29,381,582,337,7424,44
10078,123,5435,1507,2432,46542,3003
64624,64,839,359,772,7163,67
14206,3,396,1462,305,16939,91
68028,1239,29118,258,22005,305198,7113
3468,40,1307,1574,913,15192,394
24352,5257,153462,1292,98009,354652,55453
67773,48,522,266,481,10158,41
23663,311,23543,1306,12197,64163,11346
28713,15,549,1198,315,5321,234
66430,0,12,309,8,1631,4
65835,50,1104,326,1093,25475,11
36554,68,1875,1039,1064,50734,811
16333,3,229,1432,152,15949,77
20456,95,1680,1359,1279,19048,401
16359,126,1361,1431,902,23854,459
1957,502,9451,1587,6541,41869,2910
63302,13,116,398,116,2153,0
51461,0,0,770,0,5487,0
63857,38,416,383,322,8071,94
40815,55,761,955,667,18880,94
17214,24900,621668,1417,324214,1226872,297454
56556,17,218,611,161,8096,57
19616,404,8473,1374,4959,68486,3514
61590,334,5755,448,5249,34786,506
64671,18,172,357,128,4522,44
15736,25,765,1441,586,11868,179
49487,73,734,821,560,25583,174
53101,51,396,716,348,10075,48
6543,45,2365,1536,1084,16840,1281
23653,357,8500,1307,5920,37082,2580
416,16,467,1599,333,40757,134
19992,28,1747,1367,1060,19079,687
19418,96,2728,1377,2254,20130,474
54423,3595,50028,674,38210,416059,11818
34123,7,194,1100,116,2653,78
12261,158,10769,1489,6430,34180,4339
11659,55,3472,1495,1696,65968,1776
6711,9,569,1534,436,8344,133
25152,8,369,1274,236,9888,133
33974,201,3180,1104,2353,28443,827
27278,46,799,1228,558,9880,241
35539,12,188,1067,150,4262,38
56682,77,1018,608,875,10252,143
18622,3,225,1392,175,4377,50
11738,11,425,1494,164,10650,261
34787,7,101,1085,80,3827,21
59568,168,4447,519,3455,57462,992
10435,0,0,1505,0,14132,0
17970,145,4124,1403,3041,66653,1083
42788,363,6427,922,5419,54994,1008
18238,45,1729,1398,1329,34099,400
42576,9,303,927,229,11432,74
24332,14,226,1292,160,4856,66
23891,154,2983,1302,2200,30369,783
65925,21,141,324,127,5500,14
58124,2,13,567,10,5160,3
13223,317,20102,1477,10038,93941,10064
54511,3,30,673,25,4374,5
56065,87,1238,626,1208,25872,30
67306,53,752,280,737,12201,15
47936,87,1016,860,926,8116,90
20858,11,426,1352,267,13679,159
67772,11,327,266,313,8557,14
31420,0,47,1148,38,3754,9
1444,21,545,1591,375,24652,170
24963,17,160,1278,119,2895,41
16690,35,823,1426,639,43155,184
6905,17,427,1532,298,17438,129
21308,399,8323,1344,6014,43006,2309
22358,19,927,1329,605,24152,322
1408,212,4479,1591,2996,46433,1483
9095,34,1086,1512,767,15149,319
19775,13,376,1371,274,30171,102
32280,63,2341,1135,1754,23244,587
57876,110,1959,575,1281,31364,678
49113,235,4603,832,2448,113346,2155
38239,21,241,996,224,11164,17
52005,21,209,754,181,5277,28
25996,0,58,1256,42,3457,16
3119,28,955,1577,678,39521,277
41788,5,126,939,100,2991,26
56219,465,10350,622,7306,176161,3044
11776,9,210,1494,115,15541,95
60308,27,340,493,221,5350,119
52185,23,285,747,178,14477,107
12031,44,1092,1491,641,11301,451
17545,1113,39918,1411,20852,267475,19066
56092,10,124,625,121,8877,3
57778,47,937,578,735,26528,202
11446,535,23473,1497,9577,258518,13896
5972,30,688,1543,494,7252,194
4778,700,16365,1558,10944,51831,5421
17611,4,160,1410,141,19433,19
43253,34,909,915,796,22889,113
706,21,673,1597,418,27510,255
6357,3,52,1539,31,5738,21
5940,950,33835,1544,21974,331233,11861
3219,58,1290,1576,880,12091,410
838,255,8337,1596,5645,42279,2692
19536,748,20518,1375,15000,273635,5518
38851,48,1454,982,1257,26496,197
17635,26,1627,1409,1164,45350,463
63212,41,530,400,508,9881,22
29629,27,830,1181,605,13273,225
6496,3026,78533,1537,48300,237234,30233
12476,465,28801,1486,11312,119266,17489
59880,13,159,508,150,4325,9
32887,12,428,1124,318,23876,110
29521,477,19831,1183,12868,204619,6963
49920,3,121,809,67,13837,54
3872,4,254,1569,178,10437,76
34297,29,904,1096,547,14559,357
48753,5,89,843,81,4184,8
35663,134,3737,1064,2055,25252,1682
7589,18,1031,1522,677,30759,354
61605,1044,21666,448,15520,78352,6146
5708,9,237,1547,160,8747,77
28079,122,4977,1210,2889,52607,2088
42306,124,1220,931,999,19205,221
34419,2,125,1094,62,7058,63
20686,0,0,1356,0,13552,0
34224,2568,36526,1098,27964,94712,8562
61825,13,129,440,125,2343,4
29059,762,15273,1192,9502,89597,5771
13443,137,5278,1473,2928,36148,2350
53754,19142,260732,699,163595,1568900,97137
16282,2501,69097,1433,51471,452259,17626
34461,12,209,1093,141,8904,68
55431,199,2915,643,2601,48142,314
60615,34,824,482,458,9849,366
31431,430,9220,1147,4819,80608,4401
42894,346,8761,921,7893,57079,868
34818,6,176,1084,130,4966,46
3866,85,2080,1569,1392,69824,688
55417,27,217,644,162,4049,55
11548,1889,73383,1496,42968,607741,30415
9248,10,401,1512,196,7213,205
51660,436,4022,764,3216,31251,806
21178,4,260,1346,220,22514,40
25084,1377,26461,1275,21243,103903,5218
32034,20,385,1138,242,8303,143
23934,113,6295,1301,1237,46070,5058
20023,86,2275,1367,1218,25401,1057
50292,317,3901,800,3798,33057,103
249,6,273,1601,205,23149,68
8888,730,22459,1513,14196,110247,8263
63121,17,249,403,222,3654,27
58621,63,772,550,531,24668,241
32148,258,4925,1137,3002,54823,1923
66347,29,375,312,291,7647,84
63297,20,566,398,536,11155,30
29538,27,1035,1183,673,12993,362
38769,50,886,983,713,7974,173
48477,27,312,852,167,11947,145
67320,0,14,280,12,3283,2
8356,1383,47372,1516,32869,206228,14503
57026,129,1545,598,1241,20752,304
34253,7,116,1098,92,13273,24
8027,4251,111702,1517,68603,233038,43099
59402,25,327,525,283,11440,44
54655,36,594,667,349,6363,245
52194,663,17723,747,12246,82462,5477
40,2,293,1604,159,16343,134
4490,31,3169,1562,2099,25027,1070
48089,53,1622,859,1376,7042,246
24918,11,636,1279,404,9827,232
17808,232,3777,1406,2739,28412,1038
21851,3,147,1336,102,4903,45
11385,535,21191,1498,14903,166274,6288
31301,38,556,1149,355,15369,201
61776,965,19068,427,16903,132535,2165
7793,118,4532,1520,1806,20815,2726
11235,1159,22971,1499,14736,80164,8235
11399,57,5694,1497,1032,18572,4662
10465,114,5464,1505,1753,52017,3711
31406,8,405,1148,268,7751,137
14451,23,505,1458,350,16112,155
45514,18,225,890,190,16280,35
39681,8,145,972,120,5485,25
49891,27,315,810,252,4115,63
55409,12,166,644,134,11232,32
37921,37,868,1005,663,12398,205
24733,46,563,1283,409,8867,154
2944,102,2510,1579,1905,21599,605
27322,6,131,1227,91,3571,40
42680,82,1709,924,1492,15712,217
17802,129804,6567355,1406,1691805,11700055,4875550
1312,34,1189,1592,893,53658,296
600,17,609,1598,446,50107,163
48618,1401,17869,847,13969,144563,3900
7142,54,1523,1528,848,19547,675
58018,216,2519,571,2018,37868,501
35261,2,103,1073,79,8908,24
24507,9,172,1288,126,14235,46
16414,339,13969,1430,9408,189828,4561
25246,16,1119,1272,457,20751,662
25557,120,5537,1266,3479,47856,2058
9220,109,3940,1512,2329,60823,1611
49642,35,522,817,454,17772,68
19930,754,36536,1368,19868,224266,16668
17455,75,3141,1413,2257,38224,884
25733,10,215,1262,171,13241,44
52086,41,588,751,402,21556,186
4290,62,1302,1565,820,16571,482
2036,429,12107,1587,7282,56098,4825
27160,21,608,1230,405,9776,203
29602,39,1111,1182,717,24094,394
51470,8,146,769,109,10825,37
14176,4237,168279,1463,77712,521849,90567
7767,29,1981,1520,1331,21435,650
8852,59,1669,1513,1020,25420,649
10998,54,3133,1501,1302,32439,1831
12713,32,1316,1484,703,14179,613
67823,262,4400,264,3156,44169,1244
50112,96,933,804,846,11564,87
34517,58,981,1092,677,17691,304
10241,151,5770,1506,3405,82112,2365
1404,2,258,1591,170,12409,88
38452,74,1057,990,891,10234,166
6569,78,2821,1536,1743,51994,1078
63256,1,34,399,32,4296,2
53082,2,54,717,50,4858,4
60863,11,90,472,53,5676,37
33088,242,3098,1120,2161,19619,937
2780,17,599,1581,431,22946,168
7412,4,176,1525,111,8283,65
34721,76,1385,1086,988,15298,397
7730,116,2032,1520,1371,38876,661
8571,13,908,1515,566,20512,342
43030,35,340,919,283,12951,57
49035,9,127,834,91,5667,36
33965,1,13,1104,9,4483,4
64516,15,207,362,205,5224,2
15213,538,20031,1449,9709,100877,10322
67501,8,113,273,100,3914,13
19031,55,1950,1384,1253,39424,697
31596,10,592,1145,347,10786,245
10839,10,545,1502,302,14549,243
25446,34,797,1268,553,5314,244
25627,3,69,1264,51,5167,18
35577,1784,49534,1066,34255,311890,15279
703,515,11773,1597,7143,82944,4630
45877,133,1786,887,1579,22462,207
29682,11,568,1180,352,12252,216
43917,5,49,909,44,1570,5
50781,124,2984,788,1181,15550,1803
64903,7,68,350,47,5644,21
8703,17,307,1514,190,5963,117
60980,2,52,468,25,4465,27
30303,73,2482,1167,1674,22105,808
37943,5,130,1004,111,4468,19
21841,18,735,1336,501,31719,234
32188,18,504,1135,324,5018,180
20726,40,1019,1355,664,13335,355
39591,271,7257,973,4559,60479,2698
65090,42,1190,344,1188,32370,2
7863,216,8378,1518,5674,111448,2704
33017,12547,585475,1119,178641,1877331,406834
26647,10,290,1241,126,5782,164
42332,1776,42758,931,25064,247428,17694
46420,9,66,880,61,4950,5
10259,20,675,1506,416,9742,259
62977,14,336,406,271,8534,65
61781,47,1055,441,918,12953,137
22543,41,1908,1326,1382,31677,526
5689,4,309,1547,214,26044,95
1049,43,1755,1594,1201,24813,554
13753,76,3024,1469,1400,23074,1624
19859,63,1006,1369,592,17401,414
2262,59,2697,1585,1627,27934,1070
22110,338,5667,1332,3874,48795,1793
8090,320,4689,1517,3345,24226,1344
43101,117,2573,918,2171,39741,402
50287,37,486,800,440,19452,46
9536,116,2184,1510,1408,20094,776
67542,4,55,273,30,2697,25
36113,45,720,1053,612,16342,108
5072,1281,84603,1554,28453,208963,56150
27432,1472,46439,1224,29463,286972,16976
68920,383,5723,227,4760,55527,963
43329,426,7380,915,6148,91820,1232
38119,157,3197,999,1901,54340,1296
53731,107,1833,700,1490,34936,343
22194,63,1601,1331,986,13062,615
64026,79,3660,377,1376,30440,2284
11253,66,2811,1499,1669,28433,1142
687,616,11734,1597,8026,76128,3708
17954,4,215,1403,181,4978,34
14490,63,1822,1458,1467,56243,355
20418,606,14470,1360,8288,152082,6182
51110,39,379,779,330,7281,49
22464,17,429,1327,269,8414,160
5193,117,2974,1552,1712,54555,1262
57578,4223,80266,579,42685,184655,37581
14656,163,5786,1456,3650,26903,2136
2512,32,1007,1583,676,24833,331
61067,19,282,464,239,6994,43
69268,13,112,215,105,5049,7
39082,3,263,979,196,8056,67
29311,1574,22358,1187,15131,178676,7227
64896,43,588,350,475,12887,113
1092,29,1435,1594,733,32821,702
53026,4,127,719,52,3847,75
10655,69,2624,1503,1749,33150,875
53573,60,1111,705,891,17071,220
23740,52,1581,1305,1032,12678,549
50492,6,128,795,107,12665,21
11452,196,8294,1497,3841,33162,4453
40449,18,659,960,369,13710,290
5660,18,1108,1547,702,17220,406
55694,15,224,636,216,7922,8
19266,98,1662,1380,908,14274,754
1000,23,986,1594,662,25456,324
49785,80,811,813,751,8671,60
24067,93,2450,1298,1784,20596,666
50031,72,561,807,467,8474,94
33932,18,1075,1104,523,10036,552
41754,1274,19269,939,15458,138021,3811
3381,80,1925,1575,1261,18291,664
36232,47,587,1049,440,7386,147
18800,29,1202,1388,733,16571,469
20624,258,6146,1357,3793,28134,2353
32386,794,14438,1133,10908,72711,3530
39819,8,153,970,117,5912,36
33031,22,376,1121,279,3879,97
31968,27817,486469,1136,230142,1085955,256327
26068,89,1875,1254,1254,22986,621
19917,70,2029,1369,1154,33001,875
21673,63,2116,1338,1151,19021,965
11621,942,24220,1495,14916,165362,9304
17632,161,4621,1409,2714,34454,1907
22551,12,323,1326,196,8235,127
62364,71,1171,422,819,10858,352
21507,31,517,1340,414,12492,103
14846,94,1663,1454,1067,8800,596
55645,60,749,637,669,23606,80
56616,48,810,610,643,21394,167
32158,20,429,1136,399,8220,30
10466,149,4053,1505,3056,48811,997
31897,133,3867,1140,2399,40691,1468
15808,1818,48208,1440,26002,292519,22206
62903,2776,48151,407,30905,350788,17246
45288,37,659,893,543,13050,116
17543,46,3299,1411,2062,30903,1237
70177,2,28,186,24,1541,4
33960,5,64,1104,43,4593,21
65034,1716,5748,345,5018,381103,730
56980,18909,314271,599,239301,1287187,74970
66252,5,62,314,42,4112,20
24442,28,614,1290,429,9337,185
11814,62,1517,1494,801,15721,716
56777,5,74,605,71,51916,3
56464,24,341,614,260,8509,81
16860,53,1949,1423,1411,53732,538
35490,197,5156,1068,3845,96921,1311
52349,133,2495,735,1239,24746,1256
40648,159,2425,958,1673,29903,752
28685,12895,281419,1199,165648,1217966,115771
9106,4,146,1512,92,7272,54
12387,98,4542,1488,1959,35531,2583
20479,198,3922,1359,3115,25887,807
60654,52,764,480,723,10279,41
69339,4,64,213,55,1504,9
33573,6,397,1111,260,9721,137
1517,3,235,1591,129,18485,106
58894,2255,27539,542,23328,195079,4211
12232,323,6173,1489,3940,45024,2233
30668,70,2754,1160,1478,13079,1276
58127,78,1533,567,1287,26211,246
32561,666,14935,1130,8033,51926,6902
5587,870,42769,1548,22194,249029,20575
635,199,6829,1597,4962,76340,1867
3490,165,2628,1574,1616,20257,1012
31852,23,445,1141,306,14680,139
32638,13,318,1128,217,5089,101
35852,74,1151,1060,1015,35085,136
9033,65,1311,1513,932,15073,379
32682,37,984,1128,576,9675,408
62709,4,30,413,28,4952,2
12801,13431,379081,1482,198234,1471965,180847
37816,152,1680,1007,1481,13087,199
14136,331,2910,1463,2168,29987,742
38300,4,146,995,102,5645,44
16429,26,1650,1430,987,48384,663
61991,75,723,434,499,9109,224
1410,22,778,1591,527,22385,251
24049,0,46,1298,33,7742,13
1754,12221,576437,1589,303390,1885398,273047
30205,67,1904,1169,1362,65300,542
35727,67,1023,1063,701,20719,322
56551,300,3950,611,3378,35939,572
13424,90,4079,1474,2497,90981,1582
22893,53,2228,1319,1252,28367,976
33602,3610,102495,1110,43762,443251,58733
59661,1664,37815,512,28314,219545,9501
62627,41,371,414,345,5609,26
34458,15,504,1093,418,12104,86
66417,645,7951,310,6427,67376,1524
25236,189,2119,1272,1386,13265,733
57793,123,1476,578,1352,21416,124
12249,32,1127,1489,562,29191,565
56891,13,259,602,205,5519,54
35572,240,3311,1065,2550,27527,761
2068,1910,46583,1586,31738,120775,14845
18267,1,71,1398,43,3133,28
31984,208,5584,1139,3552,33859,2032
21460,96,3590,1341,1810,15812,1780
10406,17,505,1505,313,6932,192
65879,0,16,325,15,1877,1
57208,35,461,594,365,11461,96
63634,696,10282,389,7891,96108,2391
18573,48,1326,1392,1164,70935,162
12122,21,606,1491,309,10520,297
12945,36,1547,1480,958,86972,589
63281,15,184,399,179,9880,5
21283,53,447,1344,414,15165,33
60437,15,161,489,130,5605,31
45811,180,2912,885,2115,60090,797
53547,10,147,706,114,6982,33
5358,47,2877,1550,1326,32948,1551
22125,178,5276,1332,3755,37805,1521
57279,84,2736,592,2262,23975,474
5251,4,292,1552,170,5379,122
34089,25,400,1101,281,10673,119
1722,379,14743,1589,8897,217933,5846
22574,23,810,1325,552,12126,258
5402,30,1174,1550,797,21476,377
474,36,2564,1599,1575,50687,989
59824,31,292,510,226,4114,66
59681,2,49,515,40,5626,9
55462,887,7296,643,5633,49438,1663
13723,117,5817,1469,3469,62618,2348
57219,31,278,594,253,14817,25
19478,46,1446,1376,926,15777,520
28884,131,1936,1195,1000,13167,936
22416,17,772,1328,575,13850,197
14591,73,1663,1457,999,16932,664
61408,90,1607,453,1535,16000,72
31723,44,936,1143,697,11460,239
54462,61,819,674,477,10807,342
63698,91,1328,387,1240,41283,88
63226,53,674,400,569,17855,105
65901,3,62,325,56,1809,6
24020,30603,626753,1299,357016,1533991,269737
66363,40,684,312,549,4818,135
53057,6,68,718,56,3547,12
13071,116,6172,1478,3064,62819,3108
2835,135,4543,1580,3269,40100,1274
2750,7,268,1581,174,5936,94
45936,4,49,886,39,1787,10
30419,33,954,1165,566,10989,388
57273,30,549,592,207,9762,342
54869,22,242,659,179,7603,63
37769,66,629,1008,541,12895,88
28489,362,18355,1203,10817,94000,7538
49883,23,490,810,364,9378,126
15751,311,8727,1441,6423,138817,2304
30739,21,448,1159,264,3430,184
27876,2,124,1214,90,7754,34
48785,4110,59073,842,45305,240641,13768
53641,749,7123,702,6377,49568,746
4548,458,7003,1561,4240,32188,2763
25420,34,595,1268,414,11605,181
14959,30,1934,1453,1212,11309,722
20953,75,1227,1350,699,13419,528
9569,122,3471,1510,2453,24090,1018
61049,27,234,466,204,4984,30
17366,20,2055,1414,1276,25801,779
21534,7,502,1340,328,9449,174
26626,2,61,1241,52,9471,9
10282,7,345,1506,218,10509,127
12051,10,352,1491,209,8074,143
11413,211,8133,1497,3910,72745,4223
26194,286,5030,1252,3017,27992,2013
32299,27,925,1134,638,6586,287
59694,6,52,515,45,4241,7
12566,51,5678,1485,1491,36782,4187
13416,224,12033,1474,5350,134207,6683
1836,152,5801,1588,3802,25017,1999
26770,5030,85371,1239,51334,304009,34037
21692,2,202,1337,139,11309,63
60274,18,615,494,282,13937,333
12702,226,11094,1484,6702,163835,4392
36079,857,13819,1054,11570,208783,2249
62845,18,522,409,374,19775,148
33397,67,749,1114,476,19500,273
5278,246,7523,1551,5354,137277,2169
54736,19,849,664,562,4623,287
18453,32,506,1394,368,10900,138
63420,4,52,395,48,4686,4
51589,51,598,765,539,11399,59
66201,330,4241,315,3293,40507,948
27501,221,4312,1222,2692,35871,1620
62848,198,2306,409,1542,16316,764
34509,121,2864,1092,1925,31178,939
58311,673,14034,537,7958,83525,6076
63066,54,472,404,432,5896,40
25669,90,1688,1263,982,9255,706
28557,91,2708,1201,1454,28084,1254
65480,102,1485,335,1298,9332,187
27798,11,484,1216,301,15005,183
50153,16,309,804,247,9445,62
9701,407,7064,1509,5427,39269,1637
25091,311,14080,1275,7939,157554,6141
37351,261,3837,1019,2755,31503,1082
62320,8,148,424,99,4093,49
34863,68,856,1083,528,7868,328
66305,9,163,313,163,4498,0
2485,20,694,1583,536,18389,158
23008,10,233,1317,184,7444,49
4674,238,4951,1559,3046,28703,1905
10705,77,6541,1503,4076,79727,2465
12611,183,3818,1485,2388,54119,1430
11157,403,14222,1499,7589,54577,6633
23300,43,960,1313,547,15463,413
7175,5,429,1527,269,10361,160
37361,20,537,1019,506,15979,31
51604,11,89,765,66,4073,23
52670,2,41,730,31,3024,10
10112,20,637,1507,483,12648,154
31353,129,1230,1148,672,11695,558
58558,30,312,552,299,7119,13
56778,26,186,605,183,6125,3
10598,162,2791,1504,1793,27297,998
1712,55,1989,1589,1388,41845,601
17762,38,879,1407,515,14198,364
18518,19,580,1393,447,15918,133
66116,12,193,319,152,5452,41
38130,6,149,999,111,8341,38
18439,1852,65540,1395,40414,350726,25126
36019,117,3151,1056,2427,24429,724
19442,14,678,1377,477,20936,201
47701,52,850,863,687,17770,163
58547,71,801,553,570,10858,231
13913,259,7698,1467,5652,47845,2046
55930,34,593,630,494,12358,99
35846,48,1101,1060,874,19638,227
40870,10,146,954,119,3744,27
1689,180,7748,1589,4378,144461,3370
18983,61,1182,1385,715,10837,467
30482,22,299,1163,205,9948,94
16656,0,0,1427,0,7512,0
52084,362,4515,751,3654,48500,861
65984,173,2503,323,1736,27214,767
56885,25,385,602,301,10449,84
27028,5595,119307,1233,76065,734949,43242
54226,73,434,683,432,4681,2
58293,6,49,561,39,4199,10
25193,101,2422,1273,1537,42839,885
51375,56,581,771,408,9906,173
16413,56,2437,1430,1358,36279,1079
660,617,16154,1597,11066,67045,5088
36461,31,345,1042,270,4784,75
43361,1,43,914,32,3779,11
38977,51,627,981,566,12603,61
6149,303,16146,1541,8510,319432,7636
43885,150,2481,909,1050,21183,1431
5910,1597,31422,1544,20046,194961,11376
45717,3,86,888,63,4949,23
22539,12,329,1326,246,30987,83
62135,24,591,429,390,9296,201
28806,82,1497,1197,1251,33267,246
8175,101,1297,1516,811,7010,486
67115,7,126,287,98,6085,28
5111,94,3573,1553,2493,116026,1080
61206,482,9643,459,8251,135061,1392
18169,10,411,1400,320,24643,91
30557,240,4279,1162,2815,22302,1464
31921,10,461,1140,262,11483,199
31480,107,3702,1147,2532,94320,1170
35637,11,252,1065,182,3743,70
46720,399,5316,876,3649,32440,1667
4502,3442,90337,1562,51551,223637,38786
19228,129,1846,1381,1367,29841,479
52718,2597,33753,728,22874,227140,10879
25924,481,17730,1258,9689,88000,8041
31718,44,1315,1143,613,13969,702
25287,22,439,1271,286,11819,153
22921,500,9098,1319,5640,34004,3458
53697,8159,122986,694,86241,700694,36745
24893,44,730,1279,527,15265,203
58126,179,2753,567,1970,30247,783
37696,3652,175900,1010,56865,278508,119035
20216,81,1427,1363,871,26255,556
60687,35,593,479,583,20556,10
2869,61,2214,1579,1530,43194,684
65600,98,1870,333,1765,41962,105
29424,567,9715,1185,7368,94537,2347
57176,21,256,595,216,15596,40
54864,22,416,659,290,9167,126
57756,657,6654,579,6378,52021,276
59890,44,855,508,581,33604,274
9809,134,2528,1509,1609,24847,919
21660,767,24704,1338,11413,133552,13291
53469,172,1752,708,1589,19995,163
51853,243,2612,758,2442,54853,170
43991,4,70,908,58,4848,12
5372,33,568,1550,393,17793,175
32336,95,3640,1134,1412,12159,2228
33895,22,388,1105,184,7352,204
32883,27,267,1123,205,6068,62
27690,6,491,1218,306,16834,185
3080,7,240,1578,152,10750,88
8742,245,10559,1514,7143,140396,3416
67447,744,9953,276,8064,52742,1889
2572,56,1821,1582,1052,14263,769
1409,3629,126976,1591,48706,287426,78270
68296,2,33,249,29,2261,4
11330,252,10824,1498,6631,72276,4193
22354,54,1114,1329,725,16768,389
34278,15,476,1096,347,5420,129
57517,1,25,587,19,2976,6
62995,3,69,406,54,3384,15
40433,30,355,961,318,7789,37
27072,9,329,1232,203,10431,126
29771,2,39,1178,30,3059,9
14190,69,1307,1462,868,19119,439
14130,342,10703,1463,6424,62589,4279
49457,288,2533,822,2366,27999,167
14099,7,475,1464,314,8139,161
1453,210,9073,1591,5856,156464,3217
38188,10,190,997,138,5225,52
26364,9,242,1248,157,9945,85
40083,68,1320,966,1075,67415,245
19320,47,1810,1379,1012,35136,798
11415,14,511,1497,302,4970,209
55091,21,294,653,256,7263,38
13436,63,2793,1473,1576,16128,1217
18077,691,27412,1401,11866,149919,15546
27152,51,1043,1230,632,23311,411
28239,40,1530,1207,988,30033,542
32016,302,6546,1138,4184,92930,2362
18273,2785,64924,1398,36191,266480,28733
27368,115,1737,1226,1144,20299,593
21982,70,2431,1334,1534,15071,897
8116,3,173,1516,107,10829,66
16923,4,96,1422,71,4223,25
54611,33,320,669,289,19005,31
52292,11,216,744,156,18348,60
37549,9,201,1014,190,2590,11
735,41,3581,1596,1957,78123,1624
61852,1,10,439,8,1910,2
26857,8,238,1237,152,6587,86
53988,131,773,691,688,15797,85
36053,222,2949,1054,2381,27354,568
3595,6448,200413,1573,121804,453031,78609
59182,1,25,533,18,1923,7
62052,23,279,432,204,8118,75
54711,31,246,665,192,11727,54
15871,31,736,1439,498,17589,238
48843,36,563,840,450,13606,113
33696,39,797,1108,563,9150,234
33476,12,246,1113,163,22462,83
36282,67,1131,1048,888,20250,243
3244,9,349,1576,227,16786,122
61844,27,336,440,307,13632,29
32562,161,1989,1121,1111,51334,878
26023,52,1100,1255,692,17392,408
47383,79,2836,867,1897,38436,939
19991,40,1337,1367,1025,19716,312
18673,29,610,1391,423,8740,187
63289,17,363,398,315,8720,48
9080,11200,346655,1512,140675,1150189,205980
34555,968,17213,1091,14376,120322,2837
15348,136,3840,1447,2647,19314,1193
1767,328,19586,1589,12493,143463,7093
65366,23,514,338,498,16345,16
34638,324,5408,1089,3167,96865,2241
23218,12,540,1314,383,6228,157
19964,125,4663,1368,3157,38251,1506
28817,74,3035,1197,1602,20162,1433
6024,847,27187,1543,17874,176181,9313
42273,657,16293,932,10381,118072,5912
30860,64,892,1156,729,19103,163
32678,129,4375,1128,2870,25754,1505
58121,206,3131,567,2576,19806,555
18365,30,1015,1396,755,13099,260
8080,2549,162852,1517,54503,358314,108349
58725,31,443,547,352,12788,91
51122,44,572,778,430,17121,142
61190,39,1347,451,444,25074,903
53723,5,109,700,77,4391,32
12958,25,1645,1480,965,33428,680
67050,58,951,289,713,10560,238
20988,14,279,1350,194,5261,85
54683,4,72,666,54,3310,18
12104,103,1811,1491,966,19731,845
15293,3,68,1448,44,2939,24
62092,128,1570,431,1140,26500,430
15869,5,164,1439,79,3354,85
23086,172,3941,1316,3135,32759,806
20087,12,363,1365,270,24842,93
61953,28,203,436,189,4336,14
12872,419,10972,1481,5490,65806,5482
54593,1645,24412,669,13553,187769,10859
59134,40,514,534,466,7338,48
50957,54,338,783,272,7329,66
5546,52,2977,1548,1362,29794,1615
7105,8,238,1529,168,9509,70
14694,23,670,1456,343,6216,327
53413,11,142,708,129,4924,13
58542,8,104,553,52,3507,52
68945,2,28,226,26,2482,2
56838,43,608,603,473,12627,135
24113,1,111,1297,94,5100,17
6927,19,1006,1531,538,17354,468
15503,16,763,1445,539,28947,224
5904,141,5563,1544,3745,111984,1818
59634,12,96,517,87,4908,9
24749,126,3792,1282,2766,36503,1026
12000,27,678,1492,383,8460,295
66862,8,144,295,104,4649,40
32641,311,11953,1128,6510,82241,5443
60563,50,1176,484,716,21202,460
54771,57,591,663,518,12930,73
27483,11,402,1223,241,4676,161
34899,13,310,1082,244,10625,66
32723,1976,58918,1127,38635,202506,20283
41288,3,100,947,60,7188,40
60636,944,15534,480,11162,163497,4372
4412,283,9647,1563,6238,48549,3409
49041,169,3218,834,2677,19213,541
6949,65,2414,1531,1310,48842,1104
14219,828,28652,1462,14058,170624,14594
39847,79,2659,968,1947,21277,712
48318,105,2882,855,2103,41085,779
61658,399,8439,446,6824,111876,1615
18691,128,2346,1390,1656,20907,690
16612,81,1524,1427,816,32698,708
63955,17,370,379,369,6705,1
4710,222,6862,1559,3830,34960,3032
48569,11,176,848,90,4259,86
21988,569,15520,1334,10641,126746,4879
23532,204,5190,1309,3936,73818,1254
8626,45,1358,1514,794,16744,564
42194,10,202,933,173,12234,29
34445,3,98,1093,70,7980,28
13995,800,18838,1465,12443,161273,6395
55102,61,671,652,568,11476,103
29955,72,1152,1174,762,31796,390
33934,18,350,1102,259,5741,91
6082,28,909,1542,625,43615,284
67271,6,107,281,80,6417,27
63062,18,281,404,278,6927,3
7528,21,1196,1523,815,60397,381
35142,191,3321,1076,1890,26959,1431
29593,131,2307,1182,1412,9872,895
37840,2,24,1007,23,9710,1
23200,455,14610,1314,11127,92699,3483
35626,9,160,1065,133,7828,27
7207,69,2622,1527,1707,19914,915
27644,136332,3485710,1219,1655045,8959397,1830665
31674,134,1893,1144,1199,7932,694
33856,49,602,1106,381,6638,221
19735,10,614,1372,476,22439,138
19807,10,558,1370,404,22824,154
30624,64,1700,1161,1239,9635,461
61022,934,19677,467,15000,95362,4677
8996,11,365,1513,257,22749,108
37997,642,11304,1002,8512,116281,2792
48520,9,138,851,81,4195,57
33273,111,1634,1116,1436,22972,198
11329,206,4728,1498,1728,34268,3000
25502,57,3632,1267,2023,28593,1609
30598,52,1741,1161,1244,22828,497
41436,46,810,945,703,13763,107
59114,1678,42593,535,29295,185134,13298
11113,24,825,1500,459,15439,366
25137,346,14474,1274,5595,67831,8879
21642,365,9366,1338,6240,47565,3126
52495,98,1086,737,950,24571,136
14139,153,4083,1463,2949,24059,1134
16222,53,1077,1433,760,18963,317
1327,2142,101522,1592,53234,384717,48288
14823,238,7691,1454,5778,62716,1913
49442,65,1315,822,1117,11906,198
28349,4,189,1205,122,6018,67
30545,1798,40606,1162,26511,176342,14095
27568,59,778,1221,474,7501,304
61752,1368,29147,443,23860,172182,5287
28920,106,2548,1194,1402,23108,1146
58712,13,132,547,132,10095,0
9595,111,2201,1510,1471,21059,730
22037,526,16465,1333,11958,179185,4507
16553,16793,347997,1428,159272,846679,188725
39101,6,139,979,125,8087,14
30360,24,851,1166,493,10972,358
35300,8,182,1072,156,5424,26
61595,36,359,448,316,6876,43
44286,92,1667,904,1158,26832,509
58252,4,75,563,54,4166,21
36514,57,604,1040,507,10478,97
31371,782,11685,1148,7271,39675,4414
38368,1051,19755,992,11754,154588,8001
56442,31,553,615,457,12539,96
22796,29,568,1321,328,13046,240
1027,83,3752,1594,2022,44023,1730
34913,748,18139,1082,12257,176258,5882
30503,44,685,1163,496,18635,189
62920,24,362,407,250,6158,112
26281,984,27689,1250,21202,192260,6487
48817,22,352,841,189,5256,163
50842,0,202,786,163,13515,39
10285,129,5702,1506,3654,36298,2048
56737,165,2343,606,2222,30925,121
7205,703,28453,1527,18441,161421,10012
27413,1568,30421,1225,21926,159726,8495
16432,35,1097,1430,953,25416,144
62583,115,1613,416,997,30844,616
17036,866,53841,1420,26194,368563,27647
30383,74,1614,1165,1178,16528,436
22060,20,1010,1333,750,21036,260
61043,7,66,466,52,4031,14
14751,296,10060,1455,6251,101241,3809
1521,49,840,1591,624,15350,216
700,0,67,1597,51,5547,16
15889,9,431,1439,340,6057,91
26314,2,100,1249,62,7878,38
60972,56,494,468,394,11993,100
45079,124,1386,895,926,19704,460
9778,5097,187944,1509,95853,734297,92091
58766,9,121,546,113,5326,8
53191,1,81,714,67,5330,14
15768,216,4642,1441,3093,38876,1549
10538,2,89,1504,57,10011,32
10761,62,1021,1502,575,15847,446
10940,3714,100338,1501,57167,201712,43171
25184,74,3097,1273,1933,24559,1164
2473,37,1624,1583,1037,34592,587
30817,20,364,1157,274,26511,90
56488,40,746,613,655,8807,91
57417,283,3202,589,2883,36522,319
32870,67,2050,1124,1364,30769,686
21716,6,251,1337,155,13925,96
28797,67,967,1197,621,15231,346
1649,175,7578,1590,5213,74313,2365
4528,7013,210418,1561,118922,666090,91496
62675,24,345,413,229,6737,116
27668,823,13543,1218,9640,113053,3903
12240,15,477,1489,237,8021,240
53495,108,1164,707,1040,13917,124
20215,64,1611,1363,1096,42917,515
41758,13,294,939,269,10834,25
36138,22,506,1052,403,5520,103
15942,222,4945,1438,2543,29070,2402
49620,676,16390,815,7265,86480,9125
11982,26,900,1492,456,8993,444
60040,34,250,503,220,7644,30
68804,4,61,231,53,4014,8
33321,89,1678,1116,1265,38673,413
29670,29,927,1181,477,21146,450
35111,19,419,1077,322,5920,97
5912,18,451,1544,326,25375,125
6253,287,14946,1540,7301,121471,7645
28333,370,7311,1205,4922,67322,2389
51335,172,2537,773,1810,21277,727
66235,7,218,315,165,11258,53
37466,9,78,1016,65,13004,13
51162,143,1240,777,1032,30540,208
49783,16,237,813,186,6391,51
38500,110,1253,989,1143,25929,110
20091,18,616,1365,433,15009,183
26299,34,1233,1249,774,24844,459
42362,258,1757,898,1485,22335,272
27397,17,922,1225,533,11354,389
1551,34,1687,1590,1044,11433,643
50133,419,7941,804,5532,132524,2409
32553,152,4068,1130,2484,22539,1584
22834,2,96,1320,76,35784,20
15692,1966,67694,1442,46052,360957,21642
30661,33,438,1160,281,5501,157
6710,2,68,1534,47,8386,21
61667,16,203,446,115,3658,88
60541,43,341,484,338,3444,3
22584,2,122,1325,82,15070,40
62304,50,796,424,616,9434,180
59851,158,2374,510,1691,35948,683
50905,0,18,778,14,1469,4
39866,13,341,970,310,10643,31
57809,5,22,577,22,3999,0
4041,320,9570,1568,5142,133236,4428
41631,21,236,941,197,12035,39
11433,92,3251,1497,1756,24237,1495
34361,44,644,1095,446,6484,198
7421,98,1950,1525,1229,11235,721
50021,11,192,807,162,9303,30
63174,47,792,401,785,9847,7
21184,1503,64294,1346,18832,348599,45462
13928,10,482,1466,275,29008,207
61857,92,901,439,725,17433,176
4157,104,2730,1566,2053,59897,677
47939,22,658,861,447,25918,211
49044,47,586,834,558,9862,28
17062,0,111,1420,75,6565,36
30483,289,9384,1163,5232,39074,4152
30736,11,218,1159,174,10804,44
56446,37,366,615,325,10118,41
716,4,181,1597,133,15274,48
58592,104,827,551,825,12310,2
61322,3,106,456,67,3754,39
30257,13,311,1168,218,16652,93
14330,216,6262,1460,3668,31896,2594
5748,72,1736,1546,1206,20665,530
4131,788,15718,1567,10031,138745,5687
37583,9,129,1013,56,4255,73
22517,2349,34580,1326,23913,94170,10667
45672,130,2202,889,1838,20646,364
6971,14975,576486,1531,285903,1399472,290583
53849,11,106,696,74,7352,32
36835,319,9349,1035,3648,58965,5701
30175,7360,186014,1169,127979,786754,58035
65062,85,544,344,524,11533,20
16867,13,581,1423,320,18771,261
10193,22,682,1506,434,9461,248
17576,4,274,1410,213,6569,61
55144,683,12151,651,11127,82278,1024
13326,25,736,1475,492,13332,244
41809,326,3027,939,2453,23063,574
1575,339,8161,1590,5217,26520,2944
43976,15,371,908,311,7646,60
217,97,7817,1601,3683,53670,4134
3216,1133,53654,1576,26681,322893,26973
653,3,153,1597,113,16181,40
12073,35,2231,1491,751,24859,1480
7023,65,2391,1530,1480,49076,911
57457,57,901,588,661,11894,240
17607,170,2555,1410,1735,46026,820
17460,11,208,1413,162,5960,46
63467,22,383,393,319,6935,64
26669,59,1753,1240,1138,26305,615
6200,40,1347,1541,1094,22731,253
3974,4,159,1568,115,14186,44
55503,62,1033,642,940,13219,93
58534,1453,40766,553,22186,293128,18580
68180,27,328,253,221,4706,107
15949,23,1234,1438,686,25709,548
21565,11,381,1339,200,12989,181
14499,55,2196,1458,1395,25352,801
42786,26,384,923,305,17342,79
14140,21,274,1463,224,14362,50
27082,11,612,1232,404,12047,208
48961,74,578,836,498,8376,80
32972,184,4325,1122,2421,54375,1904
42935,6,96,920,73,4184,23
21363,4,266,1343,196,11890,70
53774,492,4728,699,4566,42006,162
64427,42,665,364,632,7849,33
306,220,9683,1600,6982,92403,2701
31365,411,10806,1148,6730,50821,4076
36323,40,735,1046,698,11181,37
37400,366,17317,1018,6343,84492,10974
60165,76,427,498,402,7833,25
57805,363,7701,578,7601,37960,100
58587,221,4039,551,3636,33322,403
5659,39,1083,1547,765,27569,318
30505,1315,29788,1163,15154,135912,14634
53633,29,360,703,322,5486,38
54382,517,7996,678,7573,39885,423
59978,16,268,505,248,10012,20
38193,151,2091,997,1678,15866,413
34840,7,124,1084,93,5853,31
1625,84,5702,1590,2583,45285,3119
41419,161,2537,946,2060,18974,477
19099,664,12723,1383,8070,144048,4653
37765,51,1374,1005,1076,23472,298
5557,154,2476,1548,1454,35883,1022
3252,499,9462,1576,7075,105181,2387
14035,292,9082,1465,5797,95673,3285
23648,31,759,1307,553,16275,206
50407,561,8972,797,6620,77576,2352
14674,142,3654,1456,2744,31478,910
30368,1887,33157,1166,26564,209886,6593
11160,4,158,1499,86,6307,72
35362,1036,13800,1071,11208,63900,2592
30946,119,3747,1155,2047,32828,1700
14981,799,42115,1452,13492,238624,28623
53932,275,2970,694,2089,30496,881
38650,20,315,985,266,3667,49
2290,41,2110,1585,1430,50166,680
61533,20,328,450,264,8404,64
43829,26,602,909,533,18534,69
27689,9,321,1218,172,10559,149
39788,63,826,971,711,7615,115
65951,10,91,324,87,7877,4
50136,33,360,804,308,4372,52
59543,793,18526,519,11594,95451,6932
58701,52,404,547,374,9737,30
16135,33,551,1435,391,7088,160
37932,1,13,1005,13,6340,0
28048,6,299,1211,171,14074,128
54731,29,213,664,197,7884,16
59166,11,113,533,102,4824,11
45996,15,164,885,143,6197,21
15852,30,1205,1439,866,19512,339
57818,16,280,577,260,12156,20
21167,24,599,1346,403,23561,196
18070,7,322,1401,213,15258,109
2136,99,3139,1586,2224,58337,915
35799,0,53,1061,32,4201,21
56561,53,912,611,721,21975,191
35147,44,1339,1076,852,28662,487
17793,6,345,1406,232,26573,113
19741,286,8156,1372,6119,90045,2037
58383,41,486,559,461,9587,25
41474,57,934,944,852,26372,82
53545,256,3533,706,3368,33512,165
52980,1115,10744,720,8611,111718,2133
53238,59,845,713,470,7713,375
55786,295,5297,634,4840,52837,457
33172,471,12904,1118,11890,66219,1014
40024,47,933,967,718,14974,215
3102,595,16838,1577,12216,53100,4622
11983,661,14723,1492,10882,118974,3841
15390,318,7998,1447,5863,115927,2135
29079,112,3259,1191,2008,16725,1251
15714,43,1742,1442,1184,28262,558
66984,85,1404,291,1261,36938,143
39197,21,580,978,522,17057,58
34688,4,136,1087,91,4881,45
2560,90,4479,1582,2075,45506,2404
2899,74,1522,1579,1180,49456,342
22936,18,1092,1319,730,12807,362
62850,19,178,409,152,6291,26
16279,4,84,1433,38,6225,46
57732,219,2760,580,2232,15866,528
31919,4,99,1140,71,4583,28
44531,22,270,901,210,5955,60
68513,10,260,242,242,7235,18
49656,20,296,816,259,13520,37
15052,6255,137713,1451,69445,546382,68268
42258,181,2297,931,1569,29231,728
67877,6,109,262,82,2796,27
49080,12,115,833,114,11696,1
32056,1612,34624,1138,23866,165607,10758
12887,67,1528,1481,997,87217,531
23963,176,5199,1301,3878,45192,1321
51491,30,233,769,187,9787,46
33888,1939,23220,1105,16336,126451,6884
69163,45,551,218,206,6833,345
64627,14,268,359,216,7325,52
47751,45,361,863,324,7173,37
4461,62,2218,1563,1624,14996,594
3147,5219,211643,1577,93465,485867,118178
13534,302,10258,1472,3875,47457,6383
48737,11,538,844,356,11464,182
31116,596,9424,1152,5791,69889,3633
59339,5,59,527,53,4742,6
52401,23,443,740,319,9564,124
8167,11,403,1516,271,27622,132
40766,3,84,956,71,4627,13
49732,215,4484,813,3207,36312,1277
38142,14,179,998,149,5759,30
7681,1697,92047,1521,51809,397406,40238
14991,37,701,1452,526,7846,175
54387,14009,200108,668,138704,654386,61404
41561,2101,23033,943,18390,161310,4643
46636,1,25,877,20,2178,5
61150,3,63,461,59,7544,4
23385,81,1232,1311,931,12272,301
25711,5,238,1262,134,14930,104
17292,21,852,1415,540,15258,312
15769,36,1167,1441,861,43894,306
18163,4,173,1400,149,7308,24
38287,19,271,995,216,7887,55
6546,1848,49111,1536,27870,206110,21241
36429,195,3401,1043,1310,27982,2091
56625,96,1131,610,1048,21982,83
1181,63,1066,1593,703,18825,363
23386,309,6953,1311,4183,38222,2770
7545,2,164,1523,116,8752,48
29142,74,2485,1190,1200,12346,1285
37652,74,1571,1011,879,32145,692
6305,5,115,1540,77,5299,38
11615,126,2687,1495,1726,34837,961
6192,1210,25720,1541,15166,160223,10554
15894,13,2648,1439,878,56085,1770
58060,6,142,569,84,4358,58
16525,1198,20473,1429,7217,158602,13256
22821,3604,104647,1321,46234,305154,58413
51836,29,297,759,284,11177,13
69559,5,103,207,92,3170,11
1098,263,10446,1594,5308,75919,5138
32719,16,598,1127,366,10937,232
50646,406,5436,791,4949,76886,487
7354,829,32936,1525,13289,249485,19647
18173,62,2104,1400,1542,39171,562
2189,85,3907,1585,2511,28890,1396
59891,94,1503,508,1382,22457,121
13077,3,242,1478,100,12137,142
33775,1118,25244,1107,12100,167094,13144
20816,3,163,1353,126,10109,37
5023,5,198,1555,154,13773,44
57872,1155,30299,575,13544,158240,16755
2315,98,4015,1584,2427,70462,1588
69188,33,212,218,195,5882,17
51899,35,425,757,338,5657,87
2246,35,1327,1585,974,22645,353
5021,25,1052,1555,711,23174,341
15319,23,530,1448,342,13422,188
32296,5,319,1129,160,8567,159
37855,1137,21991,1006,16344,149222,5647
15198,94,2605,1449,1472,29176,1133
55775,17,200,634,162,4446,38
61258,3,62,457,49,3410,13
21654,338,5402,1338,3537,51926,1865
5451,243,23571,1549,11137,76976,12434
5511,110,4907,1549,2623,34697,2284
51761,6,42,761,41,4418,1
36854,60,829,1035,648,12728,181
36247,42,516,1049,423,13458,93
41510,10,213,944,173,18133,40
21997,189,3736,1333,2174,28872,1562
49702,1397,22150,815,18081,158616,4069
57681,47,382,582,324,10035,58
35243,56,854,1074,685,15969,169
36057,272,8609,1054,1788,68665,6821
12472,0,0,1486,0,6883,0
48125,82,1146,859,1116,12281,30
57588,23,229,584,201,6488,28
36386,286,2257,1045,1821,30300,436
49328,24,319,825,232,4378,87
51667,0,471,763,462,11213,9
35506,4736,104815,1067,84308,495010,20507
32460,32,773,1131,509,14985,264
51165,9,140,777,118,6288,22
19396,51,2280,1378,1464,34648,816
19399,89,2590,1378,1726,76240,864
10564,3,141,1504,79,4897,62
9519,12,750,1510,484,7478,266
23820,155,4495,1303,3290,65349,1205
19347,236,5217,1379,2492,37181,2725
30152,51,1025,1170,637,14044,388
56771,14,172,605,137,6525,35
54097,137,1529,685,1425,25540,104
21846,59,1096,1336,706,13648,390
34279,19,433,1096,346,3452,87
27247,343,5707,1229,3042,66221,2665
53204,21,508,713,394,24621,114
5938,4,184,1544,137,4466,47
33306,29,515,1116,351,6197,164
57140,96,1075,596,1007,17113,68
49001,11,130,835,90,4968,40
1462,29,1400,1591,905,24375,495
56644,120,1445,609,1256,24403,189
57954,31,441,566,309,4200,132
57386,5,33,589,24,5161,9
53092,16,112,716,87,3318,25
50559,11,311,791,235,3486,76
17190,262,8896,1417,5993,54165,2903
65992,9,69,322,68,3714,1
60409,7,351,489,113,4882,238
55578,15,89,639,75,8112,14
3622,82,2539,1572,1535,64670,1004
68568,7,47,239,43,2535,4
55551,440,7335,640,6580,79783,755
24040,15,654,1299,421,13724,233
50069,159,2511,805,2036,51528,475
23589,20,549,1308,425,49244,124
57538,2254,51542,586,34548,268062,16994
27814,18,445,1216,292,15874,153
23915,46,853,1302,602,17844,251
42774,8,200,923,156,13300,44
14443,4334,443458,1458,101220,922988,342238
49094,49,451,832,372,4700,79
8088,441,13804,1517,7664,74230,6140
38959,64,2401,981,2117,28910,284
1190,12,674,1593,481,17533,193
28934,43,1465,1194,968,24814,497
20221,30,630,1363,369,18060,261
11555,8770,327511,1496,166657,641249,160854
13308,10,462,1475,287,11334,175
27401,512,13295,1225,11801,103309,1494
54023,8,147,690,146,6848,1
51189,9697,197395,772,113802,958704,83593
51502,25,349,768,293,10556,56
63720,8,159,387,143,2999,16
12293,303,14680,1489,8218,62390,6462
20709,184,3021,1355,2030,28990,991
53362,64,806,710,728,22759,78
29197,12,670,1189,382,22853,288
10489,13,289,1504,179,6710,110
51506,38,463,768,366,16038,97
10317,20,388,1506,246,8694,142
4601,20,1137,1560,543,21846,594
49943,101,1689,809,1652,56100,37
65678,119,1808,330,1453,32229,355
21084,284,6672,1348,4647,43570,2025
36718,47,496,1037,429,9875,67
15064,6,419,1451,308,24935,111
55803,254,2819,634,2540,21743,279
67926,0,20,261,16,1255,4
50107,104,1179,804,901,25458,278
19684,130,3824,1373,2152,49198,1672
8093,329,15069,1516,9246,73614,5823
53638,2442,44084,703,33547,105327,10537
11598,7,864,1496,463,17847,401
67859,38,433,262,366,13763,67
49473,7,297,821,188,17491,109
34994,50,1260,1080,877,15102,383
35708,2405,53922,1063,42881,180852,11041
31377,1140,22267,1148,17690,114746,4577
50111,81,1061,804,992,15891,69
49608,344,5395,818,4902,68959,493
65018,44,295,346,276,4576,19
54899,618,8678,645,8309,82888,369
31887,26,1740,1140,728,8458,1012
45509,1786,24777,890,21678,235610,3099
32273,41,1248,1135,648,10496,600
16030,16,531,1436,371,9349,160
63498,6,70,393,63,3760,7
30291,1088,19351,1167,12277,245581,7074
56416,46,644,616,388,9285,256
28338,224,6290,1205,3970,52556,2320
30620,4197,91129,1161,57161,246676,33968
13668,28,548,1470,345,11603,203
29188,187,3565,1189,2599,28422,966
26957,165,8076,1234,3983,69045,4093
32281,27,1157,1135,722,12990,435
64790,245,4297,354,4129,26061,168
33796,181,5178,1107,3932,46690,1246
34193,280,8088,1098,5304,63168,2784
27374,108,2372,1226,1748,29154,624
49839,84,960,812,891,51774,69
69467,386,9902,210,9038,77582,864
59198,1,23,532,19,1944,4
7071,155,10497,1529,3871,57501,6626
58681,320,5059,548,4081,22980,978
61173,14,137,461,135,8058,2
23152,2,132,1315,89,4362,43
6366,174,4185,1539,3099,125700,1086
30808,211,4310,1157,2306,28049,2004
63391,36,578,396,526,8223,52
22368,5245,144040,1329,98529,620588,45511
50419,59,594,797,519,5591,75
31306,18,817,1149,426,11098,391
33879,474,9499,1105,5690,83289,3809
53480,24,492,708,410,6916,82
27459,48,1506,1224,576,14862,930
7388,42,2324,1525,1691,18201,633
51637,5,83,764,72,7705,11
30645,24,854,1161,514,28642,340
37065,20,374,1028,301,7965,73
19717,440,10949,1372,8134,140867,2815
41914,6,125,937,87,3463,38
48652,5903,98867,846,68659,746085,30208
1133,17,436,1593,313,5077,123
27005,158,4636,1233,2024,34267,2612
35516,1503,24380,1065,19741,172137,4639
15681,9,302,1442,216,9278,86
19847,9,746,1370,467,16157,279
3813,162,2204,1570,1613,17344,591
20241,462,9473,1363,6498,78287,2975
9008,627,18559,1513,11187,60835,7372
28765,14,403,1198,248,16775,155
41491,14,149,944,107,4531,42
30910,20,614,1155,358,19500,256
951,631,19100,1595,10642,85456,8458
21904,12,368,1335,191,19441,177
31097,101,3056,1152,2183,27465,873
11804,189,3770,1494,1999,24261,1771
34368,877,9229,1095,7853,147325,1376
65637,14,200,332,162,3478,38
30168,13,677,1170,419,10155,258
32244,70,1009,1135,717,14044,292
28982,59,1286,1193,835,17505,451
35016,13,528,1079,314,9247,214
27998,6,90,1212,71,4872,19
66382,133,1227,311,999,20678,228
22260,334,7290,1330,4323,79618,2967
33804,88,2544,1107,1899,43979,645
21342,9,410,1343,322,12839,88
25673,1742,28895,1263,16089,158870,12806
42610,5,153,926,126,18401,27
59837,13,167,510,118,8097,49
4570,3,158,1561,113,9116,45
3154,38,944,1577,716,20791,228
21539,0,903,1340,610,13133,293
43179,136,2154,916,1574,34587,580
3704,29,938,1571,680,14866,258
11672,5,559,1495,249,14340,310
68810,3,125,231,64,4993,61
14454,3,151,1458,97,8863,54
25900,536,8234,1258,5657,60683,2577
4056,425,14919,1568,10043,49594,4876
58564,29,368,552,340,7862,28
20733,4,300,1355,199,14593,101
9200,66,2450,1512,1659,16793,791
58492,25,726,554,389,22881,337
33585,42,1713,1111,956,8697,757
33607,137,2371,1110,1655,22169,716
58669,1144,18798,548,13585,109846,5213
7051,10,246,1530,177,6979,69
20657,73,3122,1356,2450,58439,672
35909,7,303,1058,185,39332,118
4137,10,122,1567,85,6195,37
20559,30,1204,1358,693,31398,511
23601,10,175,1308,141,6795,34
47899,26,564,862,474,12442,90
15673,2,96,1442,67,7849,29
60061,138,1672,502,1336,20385,336
4359,141,4387,1564,2204,26976,2183
57412,65,382,589,309,4331,73
16496,76,2188,1429,1527,81641,661
23070,11,483,1316,307,11072,176
36748,5,113,1037,92,1843,21
3593,54,1359,1573,958,27403,401
14775,17,242,1455,150,11045,92
59501,173,2328,519,1784,22109,544
154,495,17607,1602,10543,76354,7064
28109,405,14076,1210,7968,134266,6108
58272,217,4777,562,2797,32835,1980
40460,38,936,960,751,10980,185
70186,12,220,186,184,2588,36
22420,1625,26167,1328,14886,128238,11281
10025,15,272,1507,188,5708,84
66554,23,308,305,248,9791,60
48670,53,995,845,728,18891,267
33053,20,524,1121,347,5617,177
22941,39,1983,1318,1296,23739,687
48482,15,225,852,187,6301,38
16056,21,337,1436,239,7766,98
26816,99,2898,1237,1993,20641,905
35260,17,248,1073,154,7256,94
40371,12,289,962,245,6843,44
66426,10,130,309,123,3282,7
26229,78,2190,1251,1849,60128,341
8965,31,1427,1513,910,31482,517
56762,11,179,606,164,4879,15
15488,30,1432,1445,942,15863,490
18027,455,8638,1402,4832,46842,3806
22747,62,1068,1322,750,13323,318
25789,11,578,1261,398,23662,180
36300,91,947,1047,752,24538,195
36410,293,5397,1044,4408,45050,989
18940,9334,257046,1386,169435,1377868,87611
45058,27,335,895,281,13745,54
47723,58,666,863,601,12608,65
9250,55,1359,1512,768,25851,591
18107,80,3504,1400,2529,54555,975
7054,379,6967,1530,4926,51354,2041
10279,9,451,1506,258,6934,193
56686,4,84,608,66,4903,18
57792,128,1925,578,1787,15026,138
40467,13,365,960,312,7520,53
1849,11,437,1588,351,12350,86
17120,305,8405,1419,4644,61289,3761
27084,114,1830,1232,1082,8201,748
56469,21,327,614,263,14563,64
41095,219,3476,950,2578,20370,898
66617,11,60,303,53,3852,7
4620,61,1167,1560,934,16566,233
9227,514,21271,1512,12168,115276,9103
55348,235,2566,646,2101,27447,465
27500,23,830,1222,466,31610,364
49465,564,7866,822,4888,81011,2978
31816,93,3177,1141,1675,23026,1502
8375,35,2475,1515,1546,52519,929
53124,2041,21318,715,18125,186144,3193
36352,11,168,1046,148,15400,20
11060,262,18558,1500,8542,142003,10016
57602,4,40,584,40,2892,0
57825,177,2481,577,2028,39779,453
22157,7,668,1331,461,8824,207
6255,205,5167,1540,3857,33687,1310
37232,14,143,1023,104,4155,39
25524,52,788,1267,554,8496,234
50737,1125,20306,789,9606,125320,10700
43413,549,8483,914,7547,70220,936
42316,131,2916,931,2290,41422,626
60030,6,107,504,69,2922,38
29184,33,757,1189,484,18660,273
30577,6,78,1162,56,5061,22
52006,332,4623,754,3851,29446,772
61849,17,389,440,386,4726,3
23476,568,10650,1310,7779,113340,2871
28821,99,2222,1197,1456,11914,766
8701,1,33,1514,25,4230,8
4236,248,4832,1566,3087,48831,1745
15671,45,1035,1442,953,19629,82
7405,5273,161861,1525,100770,365223,61091
27233,8,177,1229,129,12730,48
17282,279,4269,1416,3125,25324,1144
21753,119,3545,1337,2085,42720,1460
25796,880,15008,1260,10802,98059,4206
24696,12,422,1284,292,15259,130
7273,27,1854,1526,1162,23872,692
6417,28,1499,1538,1134,22498,365
52270,10,219,745,177,10882,42
28629,114,3531,1200,1982,17670,1549
41226,13,573,948,401,14097,172
34666,2,183,1088,46,7679,137
54692,242,3075,666,2347,83738,728
59875,1679,30826,509,21979,133424,8847
44273,30,328,904,205,7952,123
370,146,3080,1600,2054,28090,1026
11045,290,25077,1500,13511,81853,11566
3730,126,6313,1571,2822,68740,3491
46881,169,2287,874,1927,26888,360
16766,374,5266,1424,3396,72226,1870
51564,33,637,766,409,17351,228
46972,136,4156,869,1695,56157,2461
23078,209,10061,1316,6848,47941,3213
20835,26,276,1353,214,10603,62
14498,3,167,1458,124,8116,43
12928,5036,116313,1481,69856,330190,46457
49175,167,1818,830,1551,18892,267
11850,33,1513,1493,695,25294,818
26095,395,4585,1253,4146,61089,439
11377,59,2189,1498,1163,49102,1026
14221,1932,83651,1462,39236,511058,44415
57545,53,551,586,479,10222,72
61066,18,281,465,272,16361,9
58075,6,67,569,61,6914,6
25623,10,305,1264,195,15942,110
5306,63,2881,1551,1021,12889,1860
62365,132,1889,422,1851,19868,38
8750,78,3174,1514,1699,22670,1475
5627,13,589,1547,404,38374,185
23212,7,198,1314,147,7899,51
4174,543,10864,1566,5114,64319,5750
12159,7,303,1490,155,6853,148
32471,74,890,1131,504,15540,386
67710,49,615,268,561,7558,54
37554,64,1075,1012,698,15826,377
63839,1753,34555,383,32595,306127,1960
34371,157,5304,1095,3377,27184,1927
34122,165,3301,1100,2400,32215,901
29648,128,2655,1181,1559,19719,1096
31798,75,1978,1141,1258,33596,720
17734,44,1490,1407,963,30036,527
22582,157,7817,1325,4247,55631,3570
69258,576,13051,216,10171,92833,2880
30188,3,224,1169,138,5323,86
38333,1,50,994,39,3459,11
35702,136,1967,1064,1691,40168,276
45791,10,194,888,170,5168,24
58967,20,195,539,195,11614,0
35413,84,1641,1070,799,12839,842
19559,48,1823,1375,1101,15788,722
64788,39,593,354,576,11251,17
54162,55,400,685,348,12634,52
19874,14,538,1369,365,13637,173
60375,15,128,491,120,2151,8
14158,176,5546,1463,2605,23625,2941
42630,32,888,925,626,11794,262
62455,12,196,420,175,5245,21
4234,9,170,1566,134,18420,36
36158,2318,40140,1051,27076,218733,13064
8752,70,2963,1514,1599,39980,1364
19426,42,1248,1377,912,9753,336
64467,17,295,363,264,6361,31
34439,65,867,1094,690,19184,177
10168,172561,8244160,1506,2125834,16326181,6118326
19220,126,7152,1381,4230,56334,2922
31364,8,293,1148,174,19496,119
62008,62,942,434,752,16543,190
37196,146,4231,1024,3334,44140,897
51708,23,250,762,229,3062,21
28154,256,4212,1209,3180,40987,1032
51931,42,2426,756,606,28055,1820
30587,216,3752,1162,2546,26254,1206
63463,70,617,393,440,4041,177
25870,37,1187,1259,971,46359,216
29393,8,310,1185,184,20396,126
22495,336,9249,1327,5914,126727,3335
8929,13,448,1513,318,6435,130
654,164,8318,1597,4426,72588,3892
66838,64,1007,296,812,19133,195
30411,24329,670765,1165,345456,1448481,325309
65403,24,309,337,150,4380,159
33220,33,675,1118,432,23213,243
11383,10,473,1498,320,16237,153
1396,16,526,1592,346,13132,180
56036,20,533,627,368,21353,165
20001,308,13921,1367,9639,138276,4282
60709,8,154,478,45,16559,109
67987,978,19814,259,19693,143888,121
19568,1242,27242,1375,18836,208435,8406
15070,7,269,1451,203,34160,66
3425,132,10712,1574,4178,72068,6534
5863,831,33490,1545,14679,183134,18811
21559,78,1978,1339,1458,34529,520
46740,39,611,876,453,12111,158
45841,39,1327,887,1027,18690,300
75,13,626,1604,387,25886,239
27518,32,701,1222,581,25226,120
19770,82,1503,1371,1005,10513,498
18510,6,156,1393,112,3639,44
27230,0,0,1229,0,3102,0
50474,823,32074,795,16252,123427,15822
61427,26,284,453,244,6719,40
574,12,533,1598,386,23998,147
40196,13,559,964,365,9082,194
37844,47,511,1007,369,7214,142
11208,74,3110,1499,2014,24320,1096
18094,27,633,1401,370,9463,263
62891,26,508,408,283,11550,225
52845,168,1860,724,940,19116,920
1147,19,657,1593,459,28409,198
55717,25,301,636,233,11271,68
60566,1356,24662,484,18315,95186,6347
10704,0,299,1503,111,13983,188
17083,4,105,1419,74,4387,31
3077,42,1866,1578,1293,18648,573
27212,2060,58989,1229,42250,276637,16739
59970,736,12789,505,8629,94736,4160
21787,643,13714,1336,11324,38231,2390
19008,487,15596,1385,8750,43673,6846
32493,88,1898,1129,1534,22325,364
12398,14,343,1487,234,10952,109
11068,1453,65053,1500,32452,345880,32601
10097,113,4088,1507,2383,37290,1705
63590,70,514,391,496,13588,18
11532,0,121,1496,64,6153,57
30875,13,498,1156,351,7071,147
13996,6,174,1465,126,11033,48
65809,14,127,327,125,5135,2
59669,6,124,516,99,8417,25
18676,1,95,1391,54,8130,41
14452,52,1437,1458,1123,24265,314
13807,12,325,1468,168,14075,157
50659,11,159,791,117,6351,42
57434,26,899,588,313,9629,586
32178,129,4547,1136,2484,32813,2063
29810,845,16735,1177,12143,125489,4592
20401,32,599,1360,441,12641,158
53670,138,1704,702,1174,24181,530
63547,10,118,392,100,5269,18
56490,79,632,613,522,6637,110
10859,21,848,1502,423,7495,425
24575,23,615,1287,434,9495,181
40727,5,97,956,83,6107,14
29709,1,100,1180,69,4905,31
31312,303,5358,1149,4322,29905,1036
41144,3,64,949,58,15589,6
15841,0,0,1440,0,6971,0
57479,13,331,587,219,9264,112
32411,1785,43735,1059,37642,300235,6093
57111,33,418,596,329,4352,89
4028,151,5160,1568,3491,67985,1669
34586,18,286,1091,222,6148,64
10841,48,1101,1502,770,34902,331
52089,15,244,751,175,13837,69
38404,68,1067,992,949,37877,118
57014,127,1231,599,1130,17336,101
3971,67,1647,1568,1221,24256,426
24506,249,5264,1288,3377,24956,1887
34888,2,499,1082,266,17562,233
28160,43,590,1209,441,8164,149
20880,197,3881,1352,2743,34700,1138
59165,22,207,533,180,9226,27
12039,36,1004,1491,614,18584,390
22466,102,1839,1327,1344,17893,495
21732,155,6342,1337,2676,37022,3666
10478,14,531,1504,367,12711,164
55887,30,302,631,266,5251,36
16940,39,1953,1422,1222,17928,731
6038,18,1107,1542,808,36326,299
3708,8564,270316,1571,139271,784089,131045
57927,9,177,574,155,8638,22
5715,5,143,1546,101,16855,42
52818,56,861,725,484,13130,377
7852,45,2474,1519,672,66753,1802
34033,61,781,1102,499,5914,282
49320,18,487,825,157,3465,330
28353,47,942,1205,462,13322,480
5710,26,606,1547,376,17265,230
18781,81,2154,1389,1536,23449,618
6310,7,342,1540,244,8875,98
26784,237,4313,1238,2782,48948,1531
11622,38,3188,1495,1127,31978,2061
51713,171,1412,762,1222,21602,190
2702,5,219,1581,149,12195,70
58643,55,1959,549,946,13145,1013
43585,1,22,911,21,3215,1
16344,6,139,1431,101,12046,38
27607,32,376,1220,273,5650,103
35598,810,12914,1065,9933,88712,2981
21115,81,1922,1347,1394,22962,528
1559,23,858,1590,657,11847,201
52938,8,79,721,60,5519,19
40181,57,939,965,727,6958,212
58170,114,2625,565,1756,20117,869
52515,52,603,736,581,12616,22
47871,6,113,862,95,3939,18
17396,89,5343,1414,3568,35237,1775
37042,279,4908,1029,4611,82565,297
15068,25,981,1451,737,41829,244
55547,30,355,640,345,9035,10
65534,48,765,334,396,10618,369
24938,251,4388,1278,2105,30908,2283
30980,636,17825,1154,10781,159452,7044
60814,2436,40527,474,36425,325263,4102
35412,0,0,645,0,8137,0
10850,20,1330,1502,521,17596,809
16673,3,183,1426,133,10674,50
19129,23,739,1382,547,13914,192
54729,92,1077,664,892,19647,185
20076,18,1060,1366,715,10554,345
67315,19,315,280,308,14353,7
31285,37,837,1149,609,8864,228
48718,78,1535,844,1197,12935,338
15449,242,7261,1446,4847,57901,2414
26620,221,5340,1242,3716,86521,1624
49091,302,3321,832,2755,26585,566
7514,27,631,1523,429,8815,202
26484,14,630,1246,378,5773,252
55069,484,7213,653,4770,39012,2443
9649,229,10409,1510,6807,49364,3602
49388,49,469,823,383,5889,86
50777,13,299,788,225,6004,74
32325,1,98,1134,81,4828,17
50670,25,450,791,379,11144,71
61649,32,924,446,798,18996,126
65772,5,108,328,99,2967,9
59508,4,61,521,41,4512,20
25545,49,1112,1266,640,6798,472
39437,30,576,975,435,8825,141
30582,20,383,1162,267,3359,116
32119,90,2947,1137,2191,38878,756
4217,1425,65213,1566,24005,243728,41208
2800,20,777,1580,389,17615,388
67780,10,171,265,167,6602,4
8687,2,97,1514,67,6517,30
5359,14,903,1550,517,11595,386
32899,65,2878,1124,1997,37925,881
9613,5,217,1510,153,5617,64
6467,48,1673,1537,931,55782,742
32500,18,561,1131,325,16078,236
25712,57,798,1262,543,14094,255
26282,360,12581,1250,7978,172606,4603
61412,2,47,453,33,5464,14
53282,58,842,712,756,19271,86
62863,2031,37695,409,36631,239388,1064
62790,9,126,411,117,2455,9
34618,17,327,1089,201,8938,126
37823,22,912,1007,787,19435,125
30026,5831,110840,1173,67707,256667,43133
43789,14,394,910,235,8348,159
10079,132,5787,1507,3400,58926,2387
29434,31,454,1185,344,14151,110
15983,8899,319199,1437,160053,1425426,159146
36221,1232,23876,1050,19151,143834,4725
3494,5,138,1574,90,14838,48
31340,10,315,1148,207,27066,108
23779,257,6870,1304,3167,78632,3703
66183,13,150,316,128,4090,22
7526,0,79,1523,61,16926,18
32760,24,322,1126,249,6749,73
64116,52,341,374,305,5471,36
23886,948,24319,1302,15417,109778,8902
8650,38,1144,1514,734,11007,410
14335,123,2290,1460,1766,28738,524
1621,17,921,1590,461,42510,460
26959,341,4136,1234,3697,24347,439
48907,693,10010,838,7769,53727,2241
28981,346,11024,1193,6536,62050,4488
10603,14,551,1504,382,27159,169
38321,9,186,994,147,6958,39
57755,62,957,579,493,33224,464
38731,502,6403,984,5491,49301,912
9650,283,7038,1510,4823,42251,2215
26774,35,2218,1239,1073,24948,1145
49604,181,2142,818,1572,21458,570
61892,10,133,438,105,4763,28
49694,96,1301,815,1088,12094,213
56538,608,7535,612,6794,29867,741
49084,3862,56323,825,42298,235762,14025
42590,203,1865,926,1462,20757,403
52264,27,455,745,412,15275,43
27261,13,273,1228,183,3997,90
13714,51,660,1469,420,6784,240
66367,4,33,311,28,3670,5
16570,11,140,1428,105,9871,35
5019,13,669,1555,425,17723,244
58758,0,143,546,67,2956,76
30054,106,3829,1172,1752,22635,2077
52693,25,359,729,286,12919,73
21142,252,5465,1347,4170,57609,1295
53593,20,286,705,228,11619,58
23769,68,2423,1304,1680,39709,743
55386,119,1450,644,1183,16855,267
22913,14,431,1319,293,4946,138
11283,453,10095,1498,5591,105165,4504
19873,33,935,1369,510,10591,425
49983,8298,140023,808,118614,508363,21409
23178,18,642,1315,450,14695,192
12448,48,1265,1487,757,37487,508
33092,3,76,1120,61,6697,15
26791,5,62,1238,50,15906,12
49217,9,225,828,116,7201,109
394,22,761,1599,571,45635,190
66026,1337,18225,321,15646,97598,2579
8695,34,816,1514,444,19220,372
50873,201,2053,786,1667,17091,386
8541,13,789,1515,511,13185,278
49738,22,312,813,225,9683,87
51686,5,120,763,88,7780,32
18323,69,1489,1397,1070,72737,419
46187,1,312,883,219,9825,93
33618,272,4786,1110,2738,47486,2048
32124,85,1876,1137,1262,26641,614
27862,13,804,1215,495,13311,309
3548,189,21592,1573,7479,92556,14113
23418,2020,32754,1310,23167,137847,9587
22818,1772,21405,1321,14417,113975,6988
57354,290,3552,590,2998,28182,554
34848,14,264,1084,194,9063,70
51008,39,708,782,447,6421,261
32690,136,2525,1128,1982,24501,543
14687,282,9619,1456,5705,67286,3914
47043,18,147,872,115,5650,32
60141,12,129,499,107,8987,22
15510,47,1651,1445,985,10345,666
432,3,229,1599,137,14339,92
42616,1964,31955,925,24846,242138,7109
5818,13,167,1545,117,4721,50
59296,40,310,528,272,7310,38
52941,85,1163,722,1058,15556,105
53506,268,3347,707,3099,16397,248
36714,1131,37932,1037,21491,198583,16441
56078,52,769,626,652,15151,117
22493,38,790,1327,590,16189,200
63239,1,18,399,13,3727,5
30094,193,6116,1171,4242,58817,1874
30457,77,1918,1164,1137,17195,781
60866,233,3787,472,3738,43055,49
10422,20,1017,1505,472,25445,545
59805,39,349,511,325,6794,24
7160,41,1622,1528,1060,41919,562
53376,180,3103,709,1554,16299,1549
26372,19,673,1248,337,26863,336
3138,6,204,1577,148,23198,56
21770,577,12079,1337,6633,71207,5446
51705,131,3718,762,3481,30603,237
4054,14,356,1568,254,23712,102
65357,46,856,338,707,8111,149
40994,35,798,951,694,11324,104
12693,3230,126397,1484,60468,769602,65929
17406,4901,142515,1414,92835,421862,49680
54859,28,284,659,232,4991,52
5074,264,10104,1554,6943,61397,3161
54585,15,227,670,200,12398,27
58779,35,349,545,314,10494,35
58727,338,4732,547,4636,32174,96
34764,866,36987,1085,19897,201845,17090
45741,20,276,888,261,9589,15
56890,21,421,602,393,10472,28
21557,8,340,1339,267,6792,73
1217,668,23613,1593,13562,114021,10051
30287,54,4044,1168,2230,51941,1814
19214,63,3195,1381,2344,40909,851
380,32,1332,1599,879,36526,453
3079,146,3332,1578,2248,25380,1084
57614,10,277,584,254,9544,23
60918,56,1195,470,1167,23161,28
22983,214,2772,1318,1800,27079,972
24439,1300,25690,1290,17344,120249,8346
44547,901,24898,901,19483,121438,5415
66808,3,40,297,36,3174,4
24791,33,906,1282,644,22112,262
1915,10,366,1588,260,17559,106
15963,2605,65718,1437,40301,392233,25417
40607,15779,290218,958,203450,1614972,86768
40758,311,4932,956,4449,74920,483
11288,116,3235,1498,1455,17709,1780
34285,15,435,1096,330,10984,105
9467,6,104,1511,76,8002,28
50348,3,67,799,62,5272,5
67732,62,707,267,613,11103,94
6043,122,5228,1542,2721,53462,2507
30142,67,2857,1170,2128,21407,729
15560,10,483,1444,359,13530,124
30454,7,218,1164,109,4881,109
29580,10,399,1182,280,15618,119
58891,12,299,542,261,5473,38
57132,16,370,596,320,5263,50
12634,9,704,1484,315,11821,389
11472,14,713,1497,437,11399,276
23909,74,1746,1302,1275,37721,471
27421,95,1871,1224,1258,19212,613
2940,32,910,1579,768,31722,142
34788,18,330,1085,252,30243,78
55849,116,1142,632,985,26744,157
58017,2,30,571,30,4284,0
33994,791,13579,1103,10784,58559,2795
51656,380,5258,763,5033,78283,225
31867,7,247,1141,166,13720,81
31300,145,3187,1149,2113,29246,1074
51234,968,21857,775,10245,147552,11612
22713,106,2615,1323,1957,24148,658
50207,188,3114,802,2862,50778,252
55800,347,5602,634,4634,24018,968
25992,79,1844,1256,1135,12134,709
761,103,4677,1596,3296,37168,1381
53902,634,6607,694,5926,44475,681
20751,1054,28218,1354,13248,170178,14970
52907,5430,109463,722,61967,590255,47496
29949,36,671,1174,599,13000,72
28922,249,8047,1194,2198,70947,5849
42794,187,3528,922,2380,46408,1148
7169,2026,45779,1528,20637,325166,25142
9301,121,2596,1512,1746,15942,850
37429,566,18272,1017,8160,218703,10112
11936,47,1242,1492,784,21851,458
37301,12,149,1020,129,5679,20
39200,0,169,978,145,7790,24
8602,5,349,1514,238,13140,111
26401,186,2864,1247,1845,20257,1019
25057,38,871,1276,581,23184,290
15675,433,10259,1442,6391,89891,3868
17300,9,115,1415,91,7578,24
65555,30,478,334,466,9566,12
67853,22,804,263,526,19615,278
16741,4163,140661,1425,70780,681027,69881
25563,129,4307,1266,2707,23914,1600
26609,28,335,1242,325,6623,10
20648,96,3305,1356,1786,40712,1519
2873,615,18792,1579,12329,76289,6463
41132,192,3049,949,2168,66712,881
24391,173,5106,1291,4073,83653,1033
16558,15,586,1428,421,8579,165
30082,25,966,1171,699,18996,267
48615,18,355,847,293,20345,62
64286,181,2069,364,1923,21543,146
6139,214,8441,1541,5556,105216,2885
59008,18,115,538,88,3941,27
51965,40,411,755,282,7854,129
57183,550,7079,594,5818,45352,1261
25639,9,237,1264,165,6301,72
34999,45,1012,1080,809,25072,203
37151,293,4734,1026,3928,44265,806
8800,5,198,1513,132,5571,66
70201,5,98,185,75,11693,23
58258,29,570,562,487,11341,83
6481,111,2411,1537,1569,10651,842
51552,4,148,767,59,6359,89
8557,27,534,1515,343,8886,191
36364,1,56,1045,52,4828,4
44267,58,461,904,413,11507,48
13259,27,981,1476,435,14019,546
20494,84,2713,1359,1544,20835,1169
51646,62,1133,764,1060,24404,73
23020,33,1985,1317,1029,16744,956
1774,6,331,1589,216,19793,115
6228,105,4233,1540,2736,74769,1497
2672,9,362,1582,215,18235,147
8353,76,3614,1516,1214,60659,2400
8254,92,2586,1516,1333,19490,1253
18525,75,2868,1393,2023,27683,845
29456,27,534,1184,333,8838,201
24248,194,3336,1294,2504,31771,832
61047,7,73,466,63,4571,10
6628,801,20793,1535,12763,120583,8030
48471,40,300,853,280,8445,20
67242,10,138,282,119,3947,19
55875,55,760,632,669,11617,91
31039,5525,113747,1153,75266,244583,38481
20872,48,1024,1352,829,21853,195
22447,35,715,1327,535,16020,180
33060,19,552,1120,402,33181,150
35215,22,402,1074,308,9966,94
33136,40,1299,1119,860,17301,439
26335,1278,34566,1249,21222,212376,13344
39837,13,302,970,208,10112,94
31208,954,17842,1150,14621,61772,3221
38814,99,3498,982,2174,30729,1324
6969,29,712,1531,509,32295,203
41717,19,640,940,519,12924,121
53878,151,5443,691,2474,36633,2969
35149,18,537,1076,271,5025,266
63981,144,1428,378,1377,16027,51
42410,8,70,929,58,8837,12
26294,17,786,1250,495,14061,291
34144,16,383,1100,197,9371,186
14606,2,138,1457,76,2903,62
30939,157,10069,1155,4430,49043,5639
20095,44,1130,1365,810,20630,320
21220,42,721,1345,482,14287,239
34956,102,2309,1081,1664,22413,645
30104,3,193,1171,111,7002,82
8540,389,11930,1515,7307,96241,4623
33624,1,77,1110,60,3973,17
38324,15,386,994,344,27683,42
15066,16,1049,1451,739,49282,310
50397,5,43,797,30,5147,13
57504,6,129,587,101,5794,28
17542,2298,52536,1411,37425,277298,15111
23627,57,964,1307,699,12127,265
34723,647,7161,1086,5624,57217,1537
31187,95,2305,1151,1436,19077,869
10630,107,4180,1503,2721,44589,1459
50521,340,6664,794,4635,74613,2029
23804,38,517,1303,371,16505,146
32655,1189,34069,1128,24689,263621,9380
6972,22,681,1531,424,19721,257
32867,30,1225,1124,780,11652,445
22473,151,4543,1327,2629,77250,1914
28228,34,845,1208,587,17864,258
17742,217,5807,1407,4292,35123,1515
30915,170,2439,1155,1791,33953,648
11589,45,1650,1496,997,11221,653
40840,140,2080,954,1883,16618,197
60800,111,1536,475,1318,16172,218
15627,146,3996,1443,2696,38387,1300
13400,25,917,1474,469,7901,448
18476,14,386,1394,255,12484,131
54745,171,1992,664,1243,22762,749
43285,11,455,915,382,13339,73
8657,46,1101,1514,772,12251,329
21250,34,2006,1345,1367,10452,639
35560,186,4238,1064,2703,22588,1535
57385,39,678,589,566,26258,112
66387,18,202,297,158,6791,44
8251,5,493,1516,204,4759,289
67133,2,19,286,17,3028,2
67118,7,47,287,46,1853,1
58890,11,140,542,135,3845,5
49057,45,761,833,641,13336,120
8513,642,11630,1515,8584,51347,3046
67123,72,799,287,753,12436,46
30170,58,732,1170,640,19688,92
22729,16,383,1322,257,11135,126
10992,13,510,1501,257,11784,253
24387,57,1273,1291,804,10603,469
18536,8,400,1393,251,7098,149
56436,62,817,615,542,8844,275
61471,1725,27964,444,23599,184861,4365
3228,20,1235,1576,574,13073,661
15553,6,412,1444,321,26322,91
49346,17,201,824,198,5271,3
28679,8,288,1199,193,12919,95
39156,101,1032,978,831,21634,201
10811,603,21177,1502,11287,133341,9890
21884,661,18853,1335,8687,91435,10166
5827,1429,36715,1545,21919,109915,14796
61562,2,64,449,55,2843,9
22481,89,2864,1327,1967,28342,897
27237,5,443,1229,256,10628,187
64567,3,39,361,27,2565,12
55012,9,61,655,43,5830,18
57325,14,214,591,182,5875,32
30272,915,13156,1168,8798,69036,4358
8026,1004,105026,1517,47224,390751,57802
545,742,38238,1598,13131,100803,25107
47160,51,698,870,565,13136,133
48574,57,871,848,751,16619,120
10432,0,0,1505,0,10401,0
29014,36,1198,1193,787,8900,411
56704,15,319,607,216,14308,103
31648,20,737,1144,545,41958,192
24830,80,2101,1281,1784,19397,317
39595,111,1767,973,1411,27842,356
23728,28,467,1305,310,5681,157
6353,18,441,1539,338,5970,103
13062,135,4217,1478,3135,61419,1082
60310,6,103,493,89,2395,14
15664,2244,99145,1442,42412,242323,56733
53483,2,63,707,51,4650,12
8073,117,4179,1517,2380,43641,1799
24856,7,236,1280,207,6997,29
14897,312,8213,1453,6000,65221,2213
15669,38,1353,1442,885,8028,468
50440,9,116,796,108,5600,8
43245,8,100,915,78,3105,22
12761,190,9155,1483,5043,70677,4112
43281,1518,62229,915,25909,237900,36320
10442,1904,56587,1505,29953,306620,26634
40121,36,380,965,311,6298,69
69366,3,96,212,91,4882,5
30031,282,6291,1173,3804,60080,2487
23440,61,700,1310,433,7868,267
2427,14,669,1583,346,21340,323
11900,37,2648,1493,1057,64838,1591
53781,846,12073,699,8813,74824,3260
30262,22,527,1168,347,6440,180
15506,13754,363804,1445,226438,888533,137366
44846,27,731,898,404,14015,327
4035,5,259,1568,139,14435,120
7445,161,10886,1524,4547,97547,6339
62477,8,87,419,82,7643,5
16961,41,1411,1421,903,52741,508
24373,0,0,1291,0,10514,0
47517,251,2669,866,2152,38824,517
22256,63,3121,1330,2342,48505,779
51835,84,1512,759,1355,23352,157
17075,4,50,1419,46,8459,4
13126,5,611,1477,273,16795,338
25921,87,2317,1258,1253,27546,1064
5914,8,253,1544,182,19001,71
36339,1405,28870,1046,19557,165136,9313
38411,37,578,992,451,7759,127
51098,14,150,779,141,6572,9
37585,52,739,1013,369,10367,370
24965,53,1589,1278,874,8332,715
3250,53,1731,1576,1259,32988,472
44223,115,1858,904,1601,24222,257
16253,245,11515,1433,5630,96763,5885
18626,146,5757,1391,3856,107426,1901
35571,10,227,1066,146,3251,81
3905,19,659,1569,373,38364,286
66760,19,173,299,173,9978,0
9512,41,2202,1510,900,25469,1302
45910,35,344,886,326,13561,18
24768,25,550,1282,373,9490,177
50196,86,1596,802,1376,28409,220
51888,30,380,757,299,4495,81
16154,11,423,1434,299,7403,124
61143,3,72,462,47,2754,25
29644,43,1871,1181,1092,16563,779
67001,11,127,290,100,4976,27
9356,637,21053,1511,13123,79125,7930
4316,73,1642,1564,1291,16299,351
49461,79,1460,822,1286,25955,174
25008,1383,38298,1277,20794,249824,17504
1050,702,17389,1594,11480,76457,5909
58496,164,1283,554,1035,16210,248
3470,9,299,1574,205,12476,94
13100,8,671,1478,332,5997,339
35289,123,2584,1073,1630,28705,954
38351,22,334,994,272,6233,62
41672,31,777,941,596,11220,181
47104,73,666,871,595,9062,71
3025,52,3161,1578,2185,55531,976
50522,20,189,794,108,4806,81
34773,24,539,1085,344,3908,195
43191,15,431,916,353,11627,78
41592,16910,348311,942,222420,1049414,125891
24945,7,294,1278,208,7428,86
35875,27,567,1059,426,9452,141
28357,21,642,1205,369,12422,273
18023,150,6755,1402,4008,36251,2747
21781,6,174,1336,114,6525,60
14505,227,6408,1458,4268,37871,2140
24328,195,4928,1292,2866,21373,2062
12023,4,248,1492,128,8854,120
60063,179,3181,501,2624,66629,557
22599,72,1917,1325,1396,31858,521
6806,490,12628,1533,8743,44911,3885
8255,17,687,1516,450,29150,237
59012,197,3440,538,3044,16723,396
59535,37,585,520,548,7591,37
18011,238,6666,1402,4855,55340,1811
19506,141,2128,1376,1410,15325,718
41784,2011,37161,939,24802,218581,12359
60073,631,10771,502,6079,49646,4692
26423,142,4840,1247,1778,41619,3062
11714,139,2427,1495,1636,19011,791
16844,183,4656,1423,3030,70154,1626
10814,34,2370,1502,1565,57537,805
59748,25,321,513,225,7854,96
38572,703,10661,987,7238,79138,3423
19635,87,3931,1374,2385,30539,1546
31641,59,1152,1144,653,14497,499
10312,70,1316,1506,996,24244,320
39865,102,1103,970,888,7742,215
36970,556,15710,1031,10981,94433,4729
61922,68,1034,437,848,13050,186
27757,7,258,1217,157,9549,101
7790,14,289,1520,170,10875,119
30923,54,1333,1146,921,13254,412
2318,286,9646,1584,6395,84806,3251
32785,390,14577,1126,9069,53339,5508
51456,658,6604,770,5705,50672,899
6214,23,636,1540,421,9027,215
66553,0,87,305,86,4911,1
50728,7,177,789,143,9447,34
8169,375,17100,1516,11005,71492,6095
24311,141,3485,1293,1992,22019,1493
34402,415,6906,1094,3483,52409,3423
62829,74,1023,410,949,18429,74
29150,2,76,1190,37,1680,39
35481,0,49,1068,27,3112,22
69103,630,14462,220,12363,129800,2099
32589,58,1348,1129,922,21626,426
65587,29,217,333,191,2885,26
69391,5,82,212,53,5129,29
58444,97,1495,556,884,17479,611
62504,16,239,418,213,5754,26
23643,204,5422,1307,3441,39167,1981
32099,57,1559,1137,873,9501,686
58341,645,10377,560,8215,91125,2162
49687,395,7255,815,4837,92021,2418
19325,7,292,1379,226,12392,66
55621,11,168,638,134,6379,34
55727,11,244,636,175,12766,69
30052,199,4802,1172,3329,110028,1473
58509,102,1767,554,1452,19372,315
52139,27,251,749,212,6211,39
31825,15,440,1141,357,6050,83
15957,55,2254,1438,1422,26656,832
53841,17,146,696,128,4604,18
58900,78,514,541,487,8257,27
7313,12,388,1526,240,12826,148
28389,0,0,1204,0,11693,0
2342,35,1386,1584,978,27156,408
7080,940,64486,1529,31109,352467,33377
23143,5,109,1315,107,7553,2
10022,35,1565,1507,1100,62017,465
38242,18,363,996,298,11669,65
3480,949,12657,1574,7828,59338,4829
6131,216,6553,1541,4273,88765,2280
8761,3,238,1514,161,3510,77
10889,49,750,1501,547,11176,203
62385,32,314,422,305,5714,9
52210,85,1055,747,734,17341,321
3859,9,291,1570,197,12245,94
11909,14,589,1493,308,7771,281
10806,466,37159,1502,23543,84999,13616
51479,17,212,769,163,7058,49
67052,6,131,289,129,3827,2
28484,93,2435,1203,1488,29299,947
15222,24,767,1449,490,18711,277
9100,2,212,1512,160,21020,52
32290,53,1122,1134,890,14685,232
55873,5,40,632,34,3345,6
29171,372,10873,1189,6633,104440,4240
12925,523,14794,1481,8970,48247,5824
15654,20,459,1442,294,9543,165
51632,860,64224,764,14412,147644,49812
2075,307,12724,1586,8301,95547,4423
30685,90,1058,1160,811,18554,247
12570,84,2057,1485,1056,27004,1001
5530,21,463,1548,360,7427,103
21555,19,563,1340,367,9027,196
1189,307,12696,1593,8746,49813,3950
16981,609,14927,1421,10037,138593,4890
34061,565,18645,1101,10149,150065,8496
22618,428,11297,1324,7477,62152,3820
12788,145,6386,1482,3727,89162,2659
29876,5,161,1176,100,7214,61
21265,15277,280389,1345,170695,654972,109694
40466,215,2821,960,2213,31683,608
58654,40,499,549,494,15526,5
2190,14,620,1585,323,12072,297
11942,648,19530,1492,13296,201777,6234
21095,32,773,1348,496,12781,277
30759,4828,150941,1158,72790,629056,78151
15727,14,779,1441,472,38026,307
58699,6,59,547,51,7368,8
16897,642,13023,1422,10200,60576,2823
14626,1583,93219,1456,32377,451889,60842
49038,1836,27385,834,20191,143751,7194
26488,179,4705,1246,3067,45355,1638
25505,152,3133,1267,2396,39425,737
13794,8,375,1468,155,9998,220
61025,10,103,466,75,5940,28
25969,385,7856,1256,5246,47973,2610
40474,62,1323,960,795,59791,528
64550,29,449,361,386,10175,63
47548,20,325,865,219,5478,106
33372,193,7366,1115,3853,52650,3513
62958,28,474,407,420,21984,54
59695,9,117,515,91,4108,26
36218,27,380,1050,264,7884,116
8092,177,4298,1517,2741,34519,1557
20555,488,18213,1358,10540,69887,7673
3260,13,842,1576,584,19814,258
37503,46,792,1016,584,10564,208
29432,1160,21786,1185,14410,126140,7376
19868,40,939,1369,740,12560,199
2859,519,10373,1580,5657,111377,4716
64560,47,671,361,617,11640,54
57574,28,360,585,319,7677,41
42007,24,217,935,177,4630,40
17974,89,4033,1402,2844,36085,1189
61312,6,78,456,70,5434,8
518,23,1072,1598,783,20315,289
59419,1266,22460,524,17753,152613,4707
1936,885,25360,1588,17578,125899,7782
6804,68,3020,1533,1820,34240,1200
27206,58,1456,1229,958,19340,498
22710,658,11324,1323,7214,73871,4110
53714,54,501,700,362,6443,139
1429,120,4276,1591,2653,97593,1623
32399,562,10881,1133,6120,94531,4761
23383,78,1364,1311,897,17500,467
2154,28,641,1586,438,20757,203
57380,4,42,590,32,1715,10
56726,71,569,607,519,6802,50
21615,1226,24291,1339,14151,151155,10140
57645,101,1368,583,1022,11354,346
57490,36,488,582,403,6879,85
18393,245,10534,1395,5743,104289,4791
34726,49,949,1086,758,13281,191
33643,18,260,1110,193,8932,67
31167,1162,14746,1151,8184,77467,6562
28449,65,1784,1204,1271,36151,513
27057,135,4834,1232,1487,53404,3347
54565,18,223,670,171,6510,52
30552,19,618,1162,391,10058,227
32328,4,82,1134,47,4768,35
18367,34,849,1396,548,11139,301
33418,2,83,1114,52,7499,31
10864,2136,79756,1502,46313,500219,33443
34714,7,133,1086,119,5987,14
31293,262,2685,1149,1811,21854,874
65106,4,37,344,23,2715,14
3318,76,6339,1575,3934,77250,2405
16338,3,205,1432,137,7429,68
25899,171,4314,1258,2224,39782,2090
35965,1335,16222,1057,14240,183455,1982
17453,75,1127,1413,980,27813,147
8880,22,1013,1513,676,35602,337
20323,50,1044,1362,704,46176,340
64956,10,265,348,242,9926,23
17600,5,200,1410,136,6320,64
11022,100,2008,1500,1263,31427,745
7530,20,664,1523,414,13019,250
28522,1496,103628,1202,33622,367129,70006
55043,9,161,654,154,6272,7
13656,188,3418,1470,2623,28407,795
62223,208,3860,427,1934,18346,1926
28059,15,518,1211,359,13818,159
63246,154,2426,399,2056,36613,370
303,21,1678,1600,1116,42171,562
33626,21,334,1110,214,7142,120
23421,336,4466,1310,2687,23179,1779
29587,191,4448,1182,2658,23216,1790
21310,14,299,1344,200,14665,99
63502,16,135,392,94,3811,41
47473,0,65,867,46,2285,19
8068,44,983,1517,632,13892,351
65710,13,144,329,118,3683,26
14988,18,804,1452,561,28994,243
44352,27,592,903,511,15291,81
14806,37,932,1454,535,19323,397
8213,529,6796,1516,4843,27275,1953
24850,8,181,1280,133,5382,48
54111,64,859,687,743,11502,116
17582,5118,178654,1410,100797,706325,77857
49350,2162,56198,824,26703,415690,29495
20025,4,166,1367,117,4880,49
2598,8,190,1582,141,12180,49
22598,4172,139470,1325,66750,481072,72720
62319,39,360,424,359,8416,1
38463,13,294,990,280,12718,14
54761,69,1086,663,920,11509,166
57957,17,201,573,188,19722,13
14568,476,14467,1457,10066,106154,4401
20708,165,2559,1355,1783,26223,776
56327,24,404,618,283,8724,121
20186,21,589,1364,419,7756,170
5027,818,17149,1554,9009,145833,8140
36186,19,230,1051,211,5886,19
22111,84,3595,1332,2115,58369,1480
14535,4,50,1457,46,7075,4
64045,59,623,376,614,21080,9
49968,9,131,808,129,4836,2
54412,1272,13579,676,11183,142287,2396
14915,7555,174313,1453,110404,561514,63909
15629,143,3952,1443,2465,40981,1487
54207,28,488,684,317,16725,171
62630,15,349,414,295,7018,54
40310,119,1845,963,1550,32612,295
9862,172,7585,1508,4657,57182,2928
46523,105,2286,879,1268,29200,1018
47953,486,9165,861,6074,108549,3091
66099,13,198,319,155,3687,43
23361,10,319,1312,228,7864,91
29056,24,1102,1192,692,14520,410
1725,25,943,1589,655,22319,288
3996,410,7651,1568,5363,60757,2288
6132,50,1759,1541,1153,49903,606
33665,27,713,1109,475,11365,238
5247,537,15107,1552,8382,58013,6725
58279,6,122,562,111,4210,11
30062,2797,51225,1172,40144,247035,11081
39884,94,1915,969,1516,16060,399
314,8,221,1600,175,14633,46
38515,51,919,988,531,10128,388
58209,84,1593,564,913,31337,680
32035,44,624,1138,413,16104,211
45098,16,442,895,378,3793,64
28546,25,523,1202,334,9290,189
21723,596,14519,1337,9470,97868,5049
33385,714,13328,1106,9468,117150,3860
52844,11,131,724,96,5412,35
33477,167,5379,1113,3187,22518,2192
16933,49,1412,1422,931,12983,481
35031,91,1947,1079,1635,24558,312
33186,19,696,1118,356,9948,340
51378,5,38,771,33,4262,5
8065,9792,242028,1517,135397,608281,106631
66058,8,139,320,139,12577,0
9742,61,2440,1509,1398,22669,1042
9018,17,771,1513,538,14880,233
34987,132,2432,1080,1773,33079,659
64773,10,169,355,165,3588,4
27627,97,2890,1219,1858,37994,1032
50725,4,137,790,108,10154,29
27563,81807,2007981,1221,888516,5259763,1119465
17331,4,342,1415,235,21037,107
58938,333,9373,540,5380,33649,3993
376,37,1465,1600,972,56317,493
52099,29,374,750,329,11816,45
28235,40837,735473,1207,384704,1468707,350769
40980,57,821,952,819,17363,2
2982,46,1634,1578,1066,26584,568
62130,46,1751,429,995,16764,756
64702,22,696,357,447,10090,249
37014,13,312,1029,267,7143,45
15750,20,774,1441,600,16637,174
34096,406,8204,1098,4580,67602,3624
5969,16,582,1543,344,14788,238
51417,1600,18263,771,15268,134350,2995
19334,53,927,1379,604,9868,323
22200,12,585,1331,388,11027,197
13819,0,29,1468,25,3436,4
20727,67,1390,1355,760,22893,630
12220,16,435,1490,248,7768,187
33404,19,272,1114,226,7024,46
27425,2150,41866,1224,28593,153372,13273
20012,24,1087,1367,732,10837,355
10169,45,1491,1506,836,10173,655
10957,8,357,1501,215,11174,142
19701,175,6298,1372,4669,32213,1629
1610,80,3906,1590,2087,29527,1819
12110,10757,260889,1491,168363,804672,92526
7035,13,481,1530,385,30478,96
17943,2,148,1403,120,8968,28
51954,113,1108,756,1013,18757,95
64559,1577,19813,361,18436,127429,1377
30536,255,5104,1162,3600,66180,1504
41333,77,1440,946,1282,19460,158
23609,105,3981,1308,2552,71183,1429
20212,102,1996,1363,1327,21841,669
25904,17,477,1258,315,12596,162
22268,47,884,1330,691,23865,193
27943,70,2794,1213,1560,23177,1234
11071,154,4379,1500,2647,29071,1732
57372,173,2891,590,2610,50687,281
28052,6,242,1211,178,11296,64
63356,13,257,396,203,5480,54
34912,27,1086,1082,512,37585,574
31702,26,916,1143,339,7895,577
58940,6,68,540,48,4117,20
53461,186,1933,708,1214,23880,719
16494,118,2548,1429,2046,44940,502
13161,5,198,1477,110,7237,88
1168,30,1392,1593,1038,33309,354
39870,26116,501257,969,262118,1767667,239139
18002,8,218,1402,146,5448,72
29023,47,1407,1192,973,44446,434
29072,3,174,1191,106,5363,68
731,4,251,1596,177,20604,74
40380,33,300,741,227,4673,73
68560,227,3123,239,2883,36898,240
29705,109,2120,1180,1635,24998,485
16662,16,577,1427,406,11723,171
53866,7,158,695,137,18030,21
53826,110,2683,690,1122,13622,1561
18703,20,505,1390,419,15451,86
27633,57,1573,1219,1019,18860,554
22987,665,49284,1318,17445,174787,31839
26435,10,383,1246,238,7614,145
39918,408,9597,969,5908,62856,3689
70047,29,332,190,317,5095,15
34246,17,1698,1098,754,22607,944
9296,31,1454,1512,942,16055,512
24276,90,3627,1294,2430,43287,1197
20187,61,2085,1364,1489,31245,596
28848,28,1211,1196,817,29100,394
52979,471,6798,720,5983,59104,815
54439,18,134,675,111,6951,23
57239,1209,14819,593,11575,96805,3244
12344,24,2350,1488,1180,24676,1170
31085,49,1048,1152,734,37921,314
24616,106,2395,1286,1713,18712,682
22901,148,3706,1319,2327,27076,1379
11159,1815,60938,1499,37285,176293,23653
55620,7,297,638,223,7464,74
46825,2,75,875,40,3116,35
18847,7,311,1387,212,17560,99
66942,20,274,292,175,10595,99
15291,3,70,1448,43,3143,27
23001,74,1289,1318,760,16030,529
40295,36,471,963,277,8417,194
1809,483,15751,1588,8991,39711,6760
60013,38,569,504,496,7478,73
38982,484,9890,981,6311,99949,3579
2387,13,914,1584,787,8327,127
29918,7,245,1175,181,10653,64
43472,55,770,913,700,13241,70
34040,112,2199,1102,1720,56994,479
58166,2727,39871,566,36462,278385,3409
46795,47,705,875,597,12737,108
31832,48,753,1141,581,17066,172
6602,109,2441,1535,2116,27584,325
29947,16,741,1174,385,12686,356
32598,5929,129562,1129,77875,579389,51687
9538,161,4243,1510,2948,25327,1295
19733,181400,5921429,1372,2013154,16727356,3908275
11224,3,168,1499,109,8495,59
17490,26,604,1412,449,23072,155
32257,33,1010,1135,619,8840,391
11574,31,855,1496,532,34869,323
43833,1650,26263,909,19878,162636,6385
7843,10,341,1519,285,10249,56
31106,10,353,1152,172,12460,181
31837,63,1839,1141,1053,10031,786
8232,459,49756,1516,16396,273058,33360
40551,337,2935,959,2318,20468,617
38158,1839,30363,998,19677,129688,10686
1518,12,499,1591,306,37643,193
8085,7,183,1517,129,6575,54
11905,53,2076,1493,773,15890,1303
42740,1,102,923,84,6851,18
56917,12,108,601,82,8184,26
52548,376,4895,735,4315,33754,580
28691,129,2827,1199,2013,21176,814
22546,21,518,1326,350,9907,168
3134,23,657,1577,384,8695,273
17255,449,16426,1416,10472,132366,5954
68463,17,324,243,320,8590,4
7667,11,600,1521,445,42199,155
51164,66,646,777,452,10566,194
9887,1017,31944,1508,18939,169481,13005
25941,9450,258001,1257,154118,975061,103883
51231,97,1596,776,1252,16608,344
4806,1278,26054,1557,14268,125860,11786
65043,10,54,345,47,4613,7
34616,45,1203,1089,703,19076,500
64147,101,1569,373,1222,37748,347
51976,290,3470,755,2806,35123,664
53955,25,242,693,195,7926,47
22997,33,1152,1318,833,13501,319
49660,95,1181,816,1046,20180,135
51055,64,481,780,413,16250,68
7106,5,225,1529,163,10713,62
50868,289,5277,786,3946,32666,1331
25788,13,294,1261,211,6255,83
61691,401,6562,445,4319,50666,2243
21060,6,328,1348,213,24039,115
7768,26,627,1520,387,7816,240
30461,327,9431,1164,5643,70517,3788
28752,6,148,1198,91,2790,57
36804,338,5849,1036,4909,76911,940
53400,61,735,709,608,9047,127
57137,7,87,596,62,2805,25
9388,4,265,1511,201,19975,64
33780,125,2080,1107,1537,27200,543
15188,57,2755,1449,1874,62922,881
10740,2322,75637,1503,31329,572969,44308
56812,352,10132,599,7554,70600,2578
14650,4,247,1456,189,4572,58
13150,141,5872,1477,2696,90815,3176
4928,201,4718,1556,3614,48565,1104
49616,339,4737,814,3707,56309,1030
30493,679,13021,1163,8229,100386,4792
14307,282,8765,1461,5323,106895,3442
31344,6,375,1148,250,11891,125
59894,12,99,508,93,4027,6
56619,265,2836,610,2259,27285,577
48707,2730,48024,844,34069,265829,13955
64397,15,296,365,233,5603,63
16541,4899,147036,1428,69782,485271,77254
34615,2928,54187,1089,35579,341059,18608
32675,25,620,1128,330,6507,290
9821,170,11047,1509,7067,43355,3980
65761,729,10684,328,8730,114767,1954
20833,19,350,1353,265,13862,85
52286,300,3549,744,3119,52284,430
5728,9,287,1546,198,14150,89
23823,30,822,1303,625,21175,197
13011,7,345,1479,199,21851,146
25546,65,1247,1266,976,24315,271
54527,40159,572338,672,342254,2880877,230084
37617,7,455,1012,279,13260,176
3702,2,121,1571,87,18247,34
5066,110,2707,1554,1930,22617,777
57886,30,198,575,150,11443,48
55113,45,840,651,599,25179,241
54684,801,13644,666,8876,122498,4768
24031,87,3442,1299,2411,32948,1031
17722,19,741,1407,448,44123,293
16587,51,3004,1428,1795,32150,1209
11347,31,1051,1498,546,14581,505
53447,6,75,708,43,3675,32
15741,9,168,1441,115,9409,53
67467,90,1348,275,831,16157,517
39556,46,1370,974,1092,27341,278
6544,1205,25060,1536,17415,272910,7645
14637,69,1777,1456,1240,35816,537
13509,34,1113,1472,652,12901,461
53947,49,1024,693,829,7908,195
40556,2,166,959,128,5968,38
19105,21,1086,1383,716,27041,370
51226,245,2480,768,2154,23130,326
9542,20,408,1510,264,10236,144
17250,1318,33608,1416,18009,222968,15599
22395,30,1520,1328,878,18435,642
36105,54,942,1053,861,18747,81
53559,48,549,705,442,8209,107
3325,4759,155277,1575,104931,456353,50346
5822,55,1172,1545,681,19650,491
14028,67,1699,1465,1007,15372,692
52474,2675,35375,737,30142,268557,5233
24639,30,544,1285,374,5334,170
35650,50,1810,1065,1196,23111,614
20863,76,1248,1352,772,14282,476
67699,92,1251,268,990,15248,261
12903,5,105,1481,63,3223,42
33692,261,4726,1109,3034,24901,1692
2195,10,385,1585,283,17968,102
35246,2,24,1074,18,6279,6
38341,136,1946,994,1588,19076,358
18177,16,499,1399,369,12683,130
33695,11,263,1108,211,10005,52
278,14,488,1600,287,31700,201
36907,13,689,1033,547,26667,142
58241,2,30,563,23,4944,7
40915,2304,89568,953,29033,416996,60535
34808,45,998,1084,662,13673,336
18137,14,800,1400,591,13404,209
19290,237,8182,1380,5219,73568,2963
10535,42,2290,1504,1497,40217,793
32646,26,789,1128,539,11888,250
21619,11,539,1339,403,6574,136
4589,11,498,1560,302,24242,196
60943,17,324,469,307,7217,17
12501,705,22410,1486,14546,171836,7864
65185,124,1703,342,1661,17584,42
50966,234,2629,783,2238,28125,391
59164,112,1418,533,1171,12984,247
7015,2773,93859,1530,42091,359560,51768
24029,45,1267,1299,871,32347,396
53960,0,14,693,12,2577,2
10848,52,922,1502,574,6340,348
59616,27,227,517,216,4476,11
50560,96,1269,793,909,28190,360
32227,340,8120,1135,6113,63928,2007
23809,8,185,1303,137,10376,48
15143,4653,240244,1450,89959,873642,150285
52487,5100,84663,737,52441,928624,32222
26446,2964,100191,1246,48429,417397,51762
2926,76,4495,1579,2549,34657,1946
23839,17,338,1303,232,11002,106
65614,1,11,332,6,1384,5
13947,25,1243,1466,648,19516,595
18426,39,1308,1395,666,21797,642
28733,7,269,1198,174,11917,95
8507,651,10664,1515,7755,47491,2909
52549,20,245,735,218,9931,27
6964,0,102,1531,67,14453,35
36058,2217,72482,1054,36752,342128,35730
38342,206,3436,994,3148,49238,288
22303,2446,62111,1330,40469,268677,21642
37753,41,595,1009,386,9147,209
9425,1631,42471,1511,23113,216990,19358
41838,335,5016,938,3957,104702,1059
44398,3,42,903,31,3256,11
32932,29,1087,1123,474,12197,613
31509,56,1652,1146,1031,29957,621
11777,150,5400,1494,3067,69102,2333
57141,5756,146155,527,68648,682149,77507
68350,202,2506,248,2169,24277,337
61454,9,66,452,61,7358,5
38318,20,225,994,176,5717,49
30245,25,503,1168,281,6796,222
21194,285,4495,1346,3043,18771,1452
26997,190,2847,1233,1997,20295,850
9880,7,239,1508,168,24341,71
32777,294,3302,1126,2147,37193,1155
1470,25,1076,1591,805,32033,271
12198,0,0,1490,0,7426,0
20876,55,641,1352,462,11691,179
54967,1673,26762,654,17887,238286,8875
4861,70,1003,1557,580,25846,423
19160,3,185,1382,119,9452,66
27043,81249,3705799,1232,1151525,6483217,2554274
26704,4108,64167,1240,41406,295829,22761
64310,4,189,368,165,4428,24
58711,61,476,547,459,10559,17
55007,2,21,655,18,3094,3
2712,78,1827,1581,1258,22447,569
48580,26,351,848,312,12080,39
9419,98,3064,1511,1631,25113,1433
10480,199,5162,1504,2867,55849,2295
53398,135,1644,709,1461,19724,183
38554,18,304,988,239,9269,65
44425,0,25,902,16,7480,9
9086,83,2805,1512,1797,31551,1008
23271,11,290,1313,204,6303,86
7743,151,5303,1520,3617,46664,1686
4568,3,115,1561,90,15442,25
7801,6905,125028,1519,72550,314196,52478
64257,14,342,369,263,8115,79
42070,35,399,934,330,3853,69
59231,1395,29004,531,22945,201718,6059
1074,178,12517,1594,5232,121611,7285
31758,516,9680,1056,5292,31556,4388
34842,5408,79695,1084,50380,239521,29315
57193,66,1425,594,1110,9999,315
31356,26,447,1148,289,13564,158
22721,13,740,1322,462,10735,278
17914,906,18210,1403,13978,206371,4232
6841,6,243,1532,124,5463,119
18378,576,16541,1396,8319,164315,8222
12270,94,1058,1489,637,25289,421
38381,631,9409,993,8299,114823,1110
19119,27,767,1382,592,29943,175
19273,8,385,1380,285,20807,100
14507,145,4597,1458,2264,25779,2333
62330,3,37,423,29,6927,8
22716,796,15297,1323,10785,88129,4512
48077,5232,123578,859,65262,627001,58316
66535,1,8,306,7,1403,1
37425,81,2198,1018,1377,58012,821
13388,4,301,1474,143,12706,158
16425,2,137,1430,106,5945,31
52506,3854,80220,736,45451,357287,34769
66095,507,6950,319,6390,80463,560
3643,14,413,1572,312,17678,101
49266,338,4519,827,4082,67639,437
12766,3924,119519,1483,64994,481217,54525
28912,12,197,1194,139,8649,58
38328,905,14107,994,10305,43328,3802
18801,17,420,1388,269,10543,151
43125,35,599,917,478,13804,121
15284,15,1210,1448,602,13495,608
27321,749,18933,1227,13366,76210,5567
27292,126,3112,1227,2343,28731,769
33134,195,9461,1119,5919,74576,3542
19356,71,1563,1378,1099,24122,464
57174,11,232,595,176,2720,56
9497,22,791,1510,496,15920,295
16113,29,440,1435,345,7070,95
2005,25,1583,1587,962,60963,621
18148,185,3264,1400,2258,23648,1006
13823,1,58,1468,32,3537,26
31800,133,2107,1141,1589,19980,518
5944,73,1075,1544,705,14163,370
9257,38,1103,1512,670,14131,433
14390,24,644,1459,489,10751,155
50501,3389,141096,788,111613,637746,29483
49674,40,590,816,528,20026,62
11998,1,103,1492,50,5138,53
49274,19,291,822,259,13649,32
40093,14,257,966,203,7097,54
19745,50,2412,1372,1415,10923,997
27403,15,411,1225,387,23710,24
35653,1,30,1065,25,3204,5
43633,13,537,911,430,17992,107
62786,382,7313,410,5175,61884,2138
51767,12,145,761,126,9256,19
63557,8,146,392,124,5739,22
66460,10,140,309,99,11071,41
14195,155,3346,1462,1758,27713,1588
38935,57,847,981,707,9428,140
1197,1392,72937,1593,36217,203863,36720
26674,25,597,1240,431,12661,166
4308,457,10026,1564,8699,122618,1327
51956,16751,240342,755,191211,787501,49131
27104,13,996,1231,488,15758,508
24899,5,279,1279,208,7599,71
10293,80,1707,1506,1092,17083,615
52406,665,8365,740,8239,45776,126
19433,16,1107,1377,939,28679,168
4026,23,1283,1568,904,17929,379
31147,153,3722,1151,2069,15862,1653
19218,41,1631,1381,1079,26354,552
49227,17,409,828,221,10417,188
49269,596,11675,827,9825,64006,1850
5284,1084,42668,1551,24481,212778,18187
50124,65,1130,804,972,13309,158
31747,34,805,1142,569,18689,236
4966,52,3141,1555,1856,31635,1285
48578,683,7724,848,6348,33970,1376
25848,43,1889,1260,1106,17880,783
18122,34,586,1400,378,15941,208
66989,32,362,290,323,19088,39
32245,225,3294,1135,2648,33518,646
65404,6,66,337,36,2600,30
3636,12,956,1572,659,22828,297
2858,602,23542,1580,15404,158671,8138
41556,33,846,943,660,20456,186
59082,51,661,536,539,17087,122
68453,337,6417,244,4450,70026,1967
35286,3114,100477,1073,47168,187835,53309
70292,4,77,182,66,2821,11
49517,114,877,820,672,11879,205
1916,980,24046,1588,14466,101274,9580
31053,52,1429,1153,1056,10383,373
17362,62,2371,1414,1459,32630,912
21995,71,2413,1334,1482,25948,931
38638,550,28527,986,15581,71265,12946
19810,14,215,1370,164,18960,51
60737,14,451,477,263,4465,188
20644,6,244,1356,154,8570,90
20529,5,204,1358,107,4300,97
56864,4,101,603,75,6257,26
4050,539,16482,1568,9456,139253,7026
61249,2618,44434,454,35270,294667,9164
37820,8,272,1007,209,8995,63
56994,32,418,599,370,10278,48
12824,55,1034,1482,599,17047,435
23811,88,1249,1303,987,12235,262
53526,6,57,706,52,5573,5
17045,613,17708,1420,12588,200416,5120
20744,47,1702,1355,1010,29404,692
32720,7,176,1127,121,5852,55
23937,65,1268,1301,742,27451,526
38176,27,681,998,598,6386,83
59349,31,348,527,305,8132,43
25637,14,300,1264,242,11098,58
16722,140,3019,1425,2227,66984,792
53969,74,1449,692,1237,19228,212
55305,1,22,647,21,3029,1
4701,72,1632,1559,1158,28153,474
12155,9,548,1490,325,45714,223
66362,125,1263,312,1059,16860,204
3473,499,11940,1574,7692,45308,4248
58613,1010,23629,550,19026,80524,4603
26258,246,4964,1251,3619,80807,1345
31264,21776,664432,1149,271078,1818160,393354
15811,109,3007,1440,2081,42544,926
3890,123,4781,1569,2749,141391,2032
35388,7,115,1070,91,6825,24
24280,37,1346,1294,959,40565,387
62215,8,137,427,93,2121,44
13304,37,2426,1475,1279,39644,1147
57163,657,15313,595,14640,78179,673
14740,7,237,1455,174,14499,63
20466,3,139,1359,113,11964,26
15468,5,374,1445,282,7955,92
26233,66,1290,1251,845,18435,445
8807,137,3038,1513,1927,20684,1111
9600,27,1010,1510,425,11541,585
12316,111,1876,1488,1188,13580,688
16256,1183,22347,1433,14372,113768,7975
54961,228,2442,656,1839,28395,603
38486,33,537,989,426,10634,111
49226,12,237,828,172,5119,65
3995,1,108,1568,68,6597,40
60236,43,677,496,560,12956,117
6637,834,28293,1535,19579,78479,8714
10010,55,1674,1507,1093,28016,581
34593,2330,62572,1090,34341,239102,28231
27740,4,153,1217,83,4789,70
66140,35,345,317,295,8069,50
27274,7,331,1228,211,8498,120
1824,46,1306,1588,969,40001,337
60570,290,5382,483,4395,34576,987
12420,64,2211,1487,737,17215,1474
49047,29,453,834,385,3998,68
20976,13,168,1350,118,5687,50
37655,192,3538,1011,2950,19926,588
66920,8,137,293,108,4347,29
18633,22,650,1391,444,10053,206
13314,107,1301,1475,870,17093,431
22691,3506,99254,1323,50387,446141,48867
26619,877,19035,1242,11451,130482,7584
32584,22,484,1129,326,14035,158
55570,32,275,640,265,9138,10
48552,0,30,849,27,2473,3
69140,30,486,219,425,5764,61
22184,1175,17479,1331,10624,80400,6855
34321,2532,50150,1096,26598,293230,23552
52775,8,80,727,63,6716,17
50428,8,123,797,113,17540,10
51439,3,87,770,64,5239,23
25963,721,12754,1257,10920,137455,1834
22444,29,383,1327,323,6731,60
33615,0,0,1110,0,14213,0
14260,13,322,1461,218,25922,104
35917,2068,58185,1058,39712,286605,18473
50787,383,7560,788,6120,78741,1440
60745,16,149,477,141,6820,8
20365,21,442,1361,297,20238,145
32429,144,1619,1132,1120,13198,499
30537,43,1836,1162,967,17732,869
21243,43,1115,1345,742,13169,373
38308,8,254,995,198,18291,56
37981,6385,89099,1003,47145,502126,41954
5405,231,5427,1550,3647,30113,1780
16232,7,325,1433,214,5013,111
56991,5,64,598,52,3912,12
16479,161,2989,1429,1788,83455,1201
47949,40,685,861,509,12021,176
38427,276,3323,991,2221,28061,1102
45338,209,2380,892,2145,54499,235
25990,11,351,1256,270,11173,81
3292,41,609,1575,480,10653,129
52694,5675,87737,714,58640,293483,29097
19901,6,215,1369,169,12136,46
35541,21,434,1067,336,4355,98
68712,414,9033,234,6584,64154,2449
48791,256,4126,842,3579,58458,547
36699,35,619,1038,385,10363,234
39659,13,154,972,134,4941,20
5348,66,1343,1551,912,24500,431
46973,10,432,873,278,18847,154
14343,330,7851,1460,4241,139253,3610
38484,277,3639,989,3270,36559,369
54605,26,462,669,201,12508,261
28256,8,121,1207,89,7087,32
10109,70,6740,1507,3537,44743,3203
25616,165,6629,1264,3181,59890,3448
51809,831,39822,759,16758,187483,23064
32568,55,631,1129,458,7690,173
29609,8,240,1182,153,18732,87
43436,34,783,913,442,12821,341
49791,20236,686306,810,237910,1886213,448396
27997,790,22160,1212,15535,173744,6625
62522,42,638,418,457,12111,181
47200,184,3262,870,2709,73178,553
16607,11,176,1427,120,6588,56
32044,8,403,1138,225,4741,178
64552,167,4215,361,1935,22952,2280
28542,55,759,1202,512,14881,247
67511,7,70,274,50,3556,20
5962,78,3641,1544,2417,40944,1224
25755,13,322,1261,194,13071,128
15019,84,1790,1452,1332,30043,458
23933,4,191,1301,92,5623,99
54335,19,192,679,145,27291,47
50148,140,1371,804,1197,11084,174
36551,17,517,1039,416,8464,101
66576,2,29,304,21,2173,8
21777,25,886,1336,541,6192,345
21579,62,2748,1339,1495,35837,1253
57594,48,868,584,670,19910,198
14996,17,617,1452,407,9246,210
9614,4950,345581,1510,116698,1066952,228883
35784,38,504,1062,368,6068,136
19012,2,362,1385,251,14214,111
8917,94,2999,1513,2187,36698,812
740,239,5401,1596,3530,43892,1871
37021,273,3788,1029,3265,20897,523
59817,33,378,511,281,13565,97
3001,88,5786,1578,1963,50263,3823
54089,53,749,688,653,39241,96
11389,20,882,1498,519,11031,363
16492,3,157,1429,99,6237,58
247,6710,157378,1601,91016,471839,66362
21614,9,482,1339,323,5107,159
60769,471,9581,476,8969,67933,612
18415,40,816,1395,587,7824,229
42020,871,16884,934,10436,175450,6448
12227,0,0,1490,0,9319,0
27807,180,5054,1216,2249,48513,2805
18537,16,837,1393,603,10947,234
30816,2672,63233,1157,32748,238000,30485
61912,1474,23929,437,18082,128755,5847
59736,18,650,513,260,7729,390
19887,164,4217,1369,3427,257920,790
16577,0,182,1428,135,8053,47
15708,467,16901,1442,10523,111695,6378
32759,105,2277,1126,1335,13688,942
48298,8,143,856,82,18189,61
12984,14,596,1480,280,11494,316
50795,261,4247,788,2791,33686,1456
45642,4174,96138,888,44849,372213,51289
5398,1725,23990,1550,15022,122390,8968
3256,68,1201,1576,789,22212,412
45707,76,1144,889,880,13486,264
29655,68,1302,1181,910,16361,392
4661,65,2870,1559,1882,45015,988
62346,1839,17968,423,15058,105465,2910
37015,90,2278,1029,1679,52567,599
17407,34,1736,1414,1240,30753,496
22104,108,3493,1332,2143,34741,1350
67419,15,123,277,100,3155,23
68147,6,37,254,31,4455,6
28003,4,305,1211,182,10153,123
26331,2,267,1249,184,8918,83
26250,21,1068,1251,663,14186,405
34533,10,190,1092,119,7966,71
64126,726,27263,373,13104,113062,14159
16971,97,2846,1421,1939,51082,907
37426,1,56,1018,45,2903,11
18121,90,3308,1400,1587,17989,1721
43151,9,255,917,215,5086,40
9679,1,8,1510,6,5754,2
23725,21,708,1305,500,6554,208
53343,53,1007,710,865,39136,142
11990,46,2418,1492,920,34709,1498
10559,351,17529,1504,7703,58369,9826
57843,90,1548,576,1169,42887,379
392,57,1257,1599,964,14632,293
68185,213,4454,252,4379,50018,75
7800,126,4053,1519,2575,30110,1478
65768,0,0,328,0,5072,0
68546,23,526,240,311,12579,215
17950,59,3261,1403,1982,41946,1279
22279,32,773,1330,526,15753,247
57134,62,563,596,387,7044,176
45641,2020,58778,889,27888,204914,30890
28466,50,812,1203,428,9492,384
25822,97,3862,1260,2685,39387,1177
22868,70,1052,1320,631,12402,421
66157,1,23,317,20,1878,3
6597,42,1913,1535,1376,34286,537
12526,67,3843,1486,1758,54928,2085
41702,257,3285,940,2706,22316,579
1382,3791,205254,1592,72775,377801,132479
7623,30,1390,1522,942,30798,448
12747,67,3373,1483,2155,71401,1218
29245,20,506,1188,293,8133,213
64027,11,149,377,123,4797,26
27357,3190,90842,1226,51679,369175,39163
54242,1,18,630,13,2344,5
59369,97,1456,526,989,15270,467
2843,26,1012,1580,534,14457,478
61544,38,349,449,206,9008,143
2760,20,935,1581,626,21387,309
63255,145,1781,399,1157,16490,624
6026,40,1631,1543,894,44489,737
25090,217,3729,1275,2265,21790,1464
16559,4,325,1428,212,12798,113
30243,74,1262,1168,808,36698,454
19658,19,363,1373,292,10504,71
20214,68,1719,1363,1091,20059,628
54994,0,37,656,37,3165,0
56688,58,1741,608,971,11450,770
61116,11,234,463,107,4057,127
22586,124,3561,1325,2189,53158,1372
2018,147,3776,1587,2575,27357,1201
17379,5,152,1414,100,3555,52
47875,22,567,862,489,9297,78
3347,245,5104,1575,3321,58904,1783
51624,317,9175,764,4480,71951,4695
19051,63,1884,1384,1013,30256,871
29831,4077,71276,1177,47579,367868,23697
29835,10,436,1177,215,4342,221
18465,31118,521133,1394,288614,1394279,232519
8700,84,3869,1514,2248,35989,1621
21126,15,581,1347,400,17562,181
31289,98,2552,1149,1919,19991,633
21880,187,2741,1335,2165,15953,576
18251,1,100,1398,81,7474,19
26300,113,1880,1249,1182,30830,698
22793,1322,37721,1321,18408,347772,19313
22202,0,490,1331,314,12093,176
26713,1240,24061,1240,14872,302793,9189
2924,38,1209,1579,817,25914,392
13618,23,1176,1471,809,32077,367
14431,1417,40201,1459,27468,333057,12733
35323,20,1037,1072,743,12406,294
18119,6,419,1400,305,18602,114
1624,94,972,1590,606,9172,366
60273,2,49,495,47,5333,2
27477,11,415,1223,249,24409,166
49838,0,8,812,5,1796,3
4565,16,444,1561,313,15024,131
19671,86,2829,1373,1941,45259,888
1304,58,1630,1592,1138,27110,492
55612,77,630,638,568,14705,62
20334,35,642,1361,431,9791,211
552,61,2466,1598,1818,85071,648
57765,1215,20453,579,15705,110072,4748
29839,107,2974,1177,1791,19364,1183
66841,4,47,296,33,2211,14
32014,17,556,1138,328,10921,228
16861,8,230,1423,162,22656,68
27914,131,2687,1213,1914,21916,773
61,43,1466,1604,964,27515,502
9835,244,4391,1509,2428,19946,1963
66925,13,210,293,165,4589,45
37221,6,199,1023,124,5239,75
505,10,253,1599,189,24613,64
60753,36,564,476,521,7232,43
37115,10,177,1027,155,3660,22
34585,40,2484,1090,1494,25961,990
1495,295,17352,1591,10753,92172,6599
31477,876,12799,1147,8699,88767,4100
51831,84,2679,759,1177,22466,1502
17337,10,125,1415,103,5544,22
18483,1,81,1394,58,4668,23
50604,36,643,792,516,17154,127
42980,35,741,920,502,19466,239
62592,92,2066,416,1925,25555,141
8851,30,1072,1513,618,34876,454
10125,4468,104163,1507,55585,248435,48578
16435,59,1310,1430,782,13755,528
60584,2549,34358,482,27284,195961,7074
51504,32,177,768,163,5522,14
46717,14,220,876,192,28780,28
63060,65,565,404,486,8744,79
29482,10,437,1184,338,11155,99
27714,98,2258,1218,1372,47487,886
38399,54,813,992,650,16172,163
61333,52,548,455,502,7427,46
25422,1477,18617,1268,10932,123988,7685
4622,24,1431,1560,1063,21391,368
38252,83,763,996,538,7623,225
27350,29,651,1226,456,15174,195
63111,1024,12491,403,11155,112278,1336
9407,25,835,1511,607,14528,228
64755,2,69,355,54,3377,15
38180,82,957,998,697,8044,260
43733,6,141,910,96,4045,45
17110,7,180,1419,113,5778,67
3148,67,1710,1577,1288,39832,422
11014,12,1034,1500,571,27659,463
18843,83,2580,1387,1892,29340,688
32359,244,4970,1133,2605,31835,2365
18660,28,646,1391,487,12113,159
62443,9,103,420,97,5808,6
58747,18,128,546,126,3709,2
1840,35342,1019231,1588,499973,2892590,519258
752,4,286,1596,182,12052,104
32521,380,6596,1108,3018,108012,3578
30252,253,10655,1168,5894,67298,4761
11929,132,7401,1492,4666,88781,2735
33382,51,776,1115,625,18112,151
28623,67,2990,1200,1968,34884,1022
11344,599,15970,1498,10140,64085,5830
30183,38,1984,1169,1289,36047,695
33538,2,114,1112,75,5655,39
51418,34,340,765,321,12192,19
26329,3374,79699,1249,57238,362725,22461
8059,31,601,1517,389,13605,212
11141,72,1806,1499,1207,20412,599
34357,15,265,1095,198,7917,67
64190,25,361,372,313,14672,48
46872,16,290,874,217,11628,73
53735,85,2872,700,1414,24925,1458
57269,26,323,592,309,8844,14
24228,93,2268,1295,1637,48189,631
33342,15,932,1115,597,25609,335
3522,64,1606,1573,1291,24590,315
68420,20,419,245,415,10123,4
17847,133,2267,1405,1474,24175,793
64958,41,278,348,239,5161,39
43625,76,1433,911,1038,17364,395
17150,38,845,1418,561,7923,284
2438,18,908,1583,489,16743,419
12797,71,2070,1482,1249,46965,821
34414,4,99,1094,80,5769,19
51813,3093,54018,759,33676,420692,20342
39462,24,393,975,353,28587,40
53790,258,7263,698,3245,98795,4018
28074,16,648,1211,366,14800,282
56362,105,1293,617,1200,20603,93
65179,16,478,342,203,11884,275
31717,948,17793,1143,13350,82630,4443
56229,11,356,621,284,9539,72
20033,79,5346,1366,2133,60120,3213
58908,17,173,541,148,5310,25
53382,497,8440,709,6444,95380,1996
62116,15,123,430,107,12624,16
25953,22,708,1257,516,33010,192
54063,35,344,689,334,10084,10
35278,1414,15519,1073,11620,91597,3899
5821,95,1734,1545,1231,26779,503
31619,7,236,1144,175,13074,61
14506,71,2171,1458,1591,31467,580
58066,44,524,567,485,17964,39
34747,144,4449,1085,3053,27987,1396
18582,13,324,1392,254,12789,70
63995,10,263,378,262,8735,1
17017,22,1155,1420,405,20589,750
51148,842,12240,777,9245,196221,2995
56694,31,247,608,216,5706,31
43817,8,154,910,130,3119,24
52801,59,777,722,620,8194,157
36713,57,1789,1037,978,41492,811
50212,49,597,802,554,10395,43
48473,2179,29749,853,27508,182897,2241
14737,90,1919,1455,1273,23291,646
42796,2193,58929,913,23081,428348,35848
64377,269,3464,366,3016,55187,448
57627,103,1818,583,1742,23326,76
22657,0,0,1324,0,6964,0
13395,7,488,1474,259,22032,229
31319,67,1160,1137,725,9287,435
24161,138,2088,1296,1432,27682,656
27928,16,184,1213,106,5806,78
22604,2607,80035,1325,46490,512372,33545
28883,5,131,1195,61,16062,70
54222,146,1054,683,871,26203,183
20617,133,2534,1357,1677,36022,857
25445,30,424,1268,309,5206,115
54368,412,10835,677,5636,50789,5199
35087,21,346,1078,213,7870,133
65528,833,12274,334,12127,121299,147
57796,37,675,578,557,14133,118
6574,142,6285,1536,3821,27895,2464
31855,9,375,1141,237,10477,138
38152,33,703,998,623,17847,80
2486,2,185,1583,116,14142,69
11751,4,467,1494,249,15231,218
63601,9,165,390,123,6455,42
24502,10,420,1288,323,15881,97
13519,15,1277,1472,784,33554,493
30850,84,1987,1156,1342,17324,645
57528,116,1568,586,1319,23684,249
14625,0,50,1456,33,4300,17
30544,274,9300,1162,5685,57910,3615
37237,33,737,1023,510,15863,227
56390,244,4426,613,3735,41467,691
15597,19,589,1443,379,19673,210
7114,23,2533,1529,1448,81795,1085
26231,229,6507,1251,4393,39972,2114
7306,151,4241,1526,2995,57877,1246
10165,3741,189980,1507,76116,615498,113864
24790,37,885,1282,589,13931,296
35153,556,11105,1076,8551,102287,2554
58391,1254,32250,558,14809,157421,17441
10769,58,2988,1502,1879,25235,1109
49869,129,2136,811,1848,27043,288
1928,391,7237,1588,4479,39152,2758
66941,82,861,292,780,17988,81
57776,6,40,578,38,4981,2
45248,9,118,893,104,12949,14
32431,276,5632,1132,3736,28227,1896
38320,26,389,994,291,8116,98
64582,29,443,360,345,5707,98
56465,198,3461,614,2824,52454,637
57390,12,177,589,145,4643,32
22265,3,195,1330,120,7544,75
54717,62,1121,665,789,37178,332
22316,533,10580,1329,6590,89149,3990
18977,183,4398,1385,3390,44295,1008
9170,12,423,1512,231,8603,192
69768,0,82,199,82,3869,0
45073,13,274,895,239,10465,35
35775,64,1592,1062,1282,26946,310
42622,81,925,925,825,20670,100
32115,42,617,1137,363,13735,254
38779,98,2755,982,1477,22093,1278
30623,76,2567,1161,1378,20210,1189
29256,17,759,1188,394,22205,365
4190,124,2881,1566,2086,24542,795
25361,348,6283,1269,4164,54819,2119
59700,2676,50618,514,40860,334093,9758
25447,45,2122,1268,934,16566,1188
17013,196,14237,1420,6710,74297,7527
21278,1,58,1344,41,2232,17
52010,22,565,754,539,14161,26
64739,28,482,356,458,21627,24
9541,1411,31012,1510,16424,216589,14588
57356,34,823,590,566,22708,257
29621,28,1378,1182,869,19176,509
61656,114,950,446,704,13588,246
23717,296,7569,1305,5262,35862,2307
3621,18951,689950,1572,306280,1808655,383670
11115,21,590,1500,371,15766,219
53793,10,177,698,124,13674,53
10091,22,755,1507,451,5954,304
35386,57,1520,1070,1097,11467,423
20240,0,0,1363,0,7765,0
48940,85,1141,837,908,14240,233
29010,29,877,1193,586,33473,291
23342,39,965,1312,803,40243,162
16736,1176,22750,1425,13910,151639,8840
7521,0,0,1523,0,38605,0
49938,6,111,809,69,3789,42
14308,12325,262158,1461,152801,1085049,109357
66184,3,35,316,29,1944,6
15364,0,0,1447,0,5527,0
531,25,871,1598,559,22222,312
43357,7,252,914,197,11864,55
4971,11,465,1555,345,8593,120
37197,18,302,1024,275,12637,27
50459,7749,214742,796,107275,976910,107467
60832,29,301,473,239,3318,62
6485,659,13755,1537,7980,79499,5775
15457,35,1773,1445,1156,17560,617
25973,4,273,1256,180,16010,93
13197,2376,106125,1477,52063,633151,54062
14614,291,8392,1457,5766,120786,2626
28829,332,7221,1196,4316,64590,2905
20207,59,2186,1363,1400,27187,786
38195,80,937,997,687,12868,250
61192,23,287,460,202,5282,85
34853,0,98,1083,62,3931,36
47487,70,1145,866,941,30765,204
51020,10,109,781,86,5529,23
34974,8,405,1080,247,11349,158
53019,29,264,719,208,7396,56
50897,13,148,785,114,3034,34
2384,901,43749,1584,22309,379567,21440
33663,73,1068,1109,735,10706,333
50983,3,62,783,47,3080,15
33425,74,2440,1114,1662,47561,778
22229,19,790,1330,470,13730,320
14560,10,402,1457,287,6980,115
54998,39,321,653,233,11458,88
21943,1,126,1334,104,5347,22
14632,68,1650,1456,1135,25485,515
24649,72,1052,1285,766,10723,286
30882,61,2353,1156,1760,19147,593
37363,3,108,1019,83,4865,25
2339,20,768,1584,586,31622,182
21145,327,3903,1347,2311,19442,1592
25377,132,4250,1269,2719,64627,1531
25856,32,636,1259,299,4686,337
64935,154,2160,349,1900,48647,260
61484,65,604,451,592,8817,12
21967,251,8864,1334,4163,55613,4701
20242,324,7099,1363,3899,33852,3200
63224,1,23,400,18,2471,5
35303,32024,759352,1072,449299,2330517,310053
833,29,764,1596,578,30746,186
63947,1127,17767,379,17036,141316,731
11831,0,0,1494,0,10010,0
19447,21744,561609,1377,334835,1825378,226774
9065,78,2611,1512,1790,44350,821
27554,1757,31668,1221,25622,117334,6046
50669,59,695,791,633,6256,62
65964,7,103,323,86,3947,17
34155,42653,2061335,1099,575842,5412245,1485493
3597,29,898,1573,669,14296,229
49297,57,1741,826,1516,8024,225
10796,8,637,1502,429,14021,208
63920,1202,23189,380,16376,132376,6813
59415,206,6312,524,3488,57488,2824
17458,88,5278,1413,2958,76429,2320
37771,1798,34621,1008,26186,192032,8435
20580,8,547,1357,366,37737,181
63486,23,186,393,118,2895,68
3406,120,5870,1574,4130,128839,1740
19923,134,4180,1369,2862,55772,1318
37251,25,710,1022,646,11293,64
51679,384,5252,763,4269,40957,983
33857,0,100,1106,88,8616,12
25503,620,16818,1267,8459,59082,8359
36790,3,61,1036,58,6520,3
12544,27,2048,1485,1052,11535,996
56409,4,53,616,48,3738,5
36377,30,482,1045,380,24499,102
27855,303,2153,1215,1495,23711,658
57293,8,78,592,54,4460,24
11628,291,6848,1495,4994,48225,1854
19606,130,2639,1374,1506,14197,1133
31545,220,3141,1146,2119,27399,1022
49636,67,997,817,849,8963,148
14500,2,95,1458,61,10784,34
52608,2,65,728,50,6865,15
67183,166,2667,284,2176,46224,491
36080,2,53,1054,47,4730,6
58775,26,369,545,345,10860,24
8458,114,4699,1515,3101,18922,1598
61523,151,3128,450,1769,30396,1359
3078,138,3828,1578,2547,18011,1281
24533,30,2308,1288,1413,40264,895
56304,62,1056,619,858,14364,198
29646,232,7719,1181,5445,99903,2274
18589,2,76,1392,62,24850,14
63603,7,140,390,90,7908,50
6120,22,693,1541,492,17450,201
67074,13,417,288,295,9777,122
23272,0,0,1313,0,12551,0
19932,3,107,1368,95,6948,12
7788,5,206,1520,151,13104,55
13516,138,2977,1472,1993,42264,984
55450,52,625,643,500,9666,125
8615,52,1603,1514,650,12810,953
51782,23,479,760,291,30106,188
55170,14,160,651,125,3355,35
24123,9,359,1297,259,13579,100
9636,18,1523,1510,644,13437,879
33826,181,6903,1106,3280,58523,3623
31823,22,682,1141,482,15593,200
16032,7,457,1436,352,10794,105
68510,8,291,242,73,3534,218
12828,184,3245,1482,2097,30803,1148
56449,5,77,615,54,5638,23
14774,6,246,1455,192,31014,54
36706,0,40,1038,34,6142,6
1328,202,3029,1592,1976,31102,1053
9590,143,3892,1510,2629,48128,1263
24456,596,18649,1289,13453,90964,5196
8678,47,1396,1514,926,19771,470
31363,0,34,1148,22,2366,12
7008,3,662,1530,516,39632,146
25974,25,621,1256,482,18808,139
32998,279,10318,1121,6954,41919,3364
61227,1370,26532,458,19971,165573,6561
29775,678,27383,1178,17779,146386,9604
62219,4,110,427,85,5101,25
22221,32,659,1331,458,7887,201
58979,27,300,539,209,9429,91
60278,0,81,494,71,3362,10
1852,250,4108,1588,2594,31009,1514
46230,39,353,882,324,17433,29
37825,41,1914,1007,850,23321,1064
15301,50,1770,1448,1232,20120,538
60317,404,5776,493,5577,24262,199
1252,504,25015,1593,8364,103706,16651
24766,2362,68520,1282,39796,240105,28724
3555,18,556,1573,369,8555,187
52547,19,178,735,160,3056,18
25640,26,442,1264,295,7274,147
55302,46,1011,646,674,15033,337
33320,153,2214,1116,1674,17282,540
31873,3,50,1140,42,6133,8
31571,23,374,1145,248,9005,126
19698,7,331,1372,263,9750,68
24552,28,674,1287,570,28917,104
29511,19,733,1183,465,14768,268
8097,48,1123,1516,727,14491,396
63617,116,2117,390,2090,27727,27
21664,95,1524,1338,958,24494,566
49520,34,384,820,329,5537,55
22206,12,369,1331,240,7635,129
13153,23,1061,1477,600,14951,461
27484,27,1001,1223,695,24796,306
59056,2783,53735,536,34562,275488,19173
16159,415,3198,1434,2819,79396,379
2872,19,389,1579,301,27876,88
13414,82,3524,1474,2182,46219,1342
61542,380,5635,439,4126,35081,1509
343,17,376,1600,253,14230,123
53224,216,2785,713,2097,17910,688
45355,116,1318,892,1093,13815,225
37675,136,2099,1011,1903,35447,196
11352,174,5453,1498,3589,41495,1864
61616,272,5792,447,3763,77527,2029
11183,151,3950,1499,2451,22344,1499
20891,17,207,1352,165,9270,42
33991,33,1101,1103,793,14445,308
11395,26,935,1497,690,17327,245
15797,720,25553,1440,16498,117133,9055
38310,277,3547,995,2978,18202,569
51240,238,3860,775,3675,19798,185
5470,7,104,1549,79,25848,25
13034,49,1831,1479,992,23639,839
12407,2,308,1487,152,6627,156
27895,17,434,1214,279,6198,155
52856,244,2296,724,2005,20206,291
25634,117,4523,1264,2280,63270,2243
29689,7,435,1180,234,4412,201
64608,23,187,359,123,9419,64
30991,5,210,1154,169,9501,41
69613,1,102,205,73,2295,29
253,248,5443,1601,4072,68564,1371
69390,19,221,212,206,5762,15
7410,33,1036,1525,759,22690,277
37486,1539,34441,1016,25873,147786,8568
36028,26,418,1055,347,14686,71
50227,71,942,802,695,18198,247
27139,97,3537,1231,1696,78049,1841
20649,43,1640,1356,1171,41833,469
60434,24,396,488,338,5875,58
59757,166,8756,513,6177,70603,2579
19752,122,4723,1371,2116,41873,2607
44797,18,305,892,209,7960,96
65126,10,54,343,45,3779,9
46341,172,1917,881,1662,43875,255
5524,75,1597,1548,1048,11597,549
10185,1131,34294,1506,22263,213919,12031
31200,8,171,1150,105,5317,66
3340,96,4321,1575,2572,31779,1749
48035,134,1913,860,1734,16129,179
29777,17,704,1178,479,16490,225
62683,131,1912,413,1787,17491,125
33791,1189,30470,1107,22089,159659,8381
12392,59,2332,1487,1365,28988,967
59179,23,249,533,185,5864,64
11454,205,7304,1497,4119,57169,3185
59498,15,99,521,76,9015,23
17254,105,3566,1416,1717,33227,1849
31562,5,628,1145,435,21342,193
8221,1215,55374,1516,35952,299653,19422
6250,179,7290,1540,4581,53335,2709
32109,12,226,1137,192,5900,34
17805,3414,74428,1406,39532,259846,34896
24219,7,236,1295,189,15333,47
21292,14,478,1344,334,19034,144
4037,1,55,1568,41,13764,14
8803,7,259,1513,165,7999,94
19287,16,357,1380,294,12679,63
4681,98,5333,1559,2687,61490,2646
68701,15,218,235,141,5536,77
24349,0,0,1292,0,19697,0
11912,54,4550,1493,2336,26152,2214
49749,69,699,814,667,15773,32
14891,0,0,1454,0,38417,0
56546,18,180,612,147,5068,33
785,165,4333,1596,2916,45384,1417
31345,131,4049,1148,1569,36981,2480
7487,13,209,1524,146,7597,63
19212,5954,176582,1381,88651,958188,87931
8407,153,1909,1515,1264,35847,645
60285,19,125,494,106,4672,19
19715,58,904,1372,695,18765,209
2822,1359,81972,1580,36115,379469,45857
23193,27,580,1314,513,42653,67
24043,144,3539,1299,2458,30996,1081
39805,131,3452,970,1676,20066,1776
35819,5883,168369,1061,100303,377751,68066
634,179,6065,1597,2605,53162,3460
6031,939,49395,1542,27076,198220,22319
19950,3,121,1368,99,12504,22
4836,33,730,1557,445,30804,285
66440,98,1536,299,1337,23453,199
58807,9,114,544,110,5129,4
65465,7,144,336,116,3415,28
30067,4,112,1172,96,4414,16
57188,11,123,594,91,6102,32
18346,122,4305,1396,2294,41584,2011
1854,487,18361,1588,7339,133095,11022
34311,49,770,1096,620,7027,150
8230,216,8863,1516,4443,73098,4420
61848,7,110,440,94,1787,16
6401,19,523,1538,384,11376,139
5820,13,747,1545,431,10676,316
9939,8,396,1508,251,12907,145
8100,25,505,1516,344,10798,161
49583,21,288,818,253,13112,35
12453,85,3779,1487,1474,17342,2305
7152,50,1464,1528,1016,31658,448
37267,30,1088,1022,566,12946,522
16619,2193,65892,1427,32831,232872,33061
67030,59,489,290,389,6247,100
29844,62,3062,1177,1978,39783,1084
18260,141,2265,1398,1405,27797,860
1125,9,228,1593,175,16553,53
1691,1,116,1589,69,15220,47
59813,19,492,511,239,6788,253
32635,1664,30960,1128,18299,90844,12661
60173,16,318,498,224,5371,94
1320,225,16901,1592,8010,58196,8891
51529,0,0,646,0,8624,0
16173,72,1929,1434,1185,14195,744
29525,36,1034,1183,803,13289,231
51467,1933,60393,769,20379,388236,40014
453,24,2388,1599,1043,19365,1345
11665,111,3508,1495,2033,28785,1475
6756,43,2090,1533,1174,22174,916
48141,7,172,858,146,7552,26
9867,6,151,1508,98,5414,53
23989,38,1946,1300,1157,15367,789
20793,2,531,1354,380,19341,151
5085,84,1189,1554,776,12313,413
52942,33,380,721,320,7822,60
49868,46,626,811,561,6839,65
37186,292,7559,1024,6786,68917,773
7797,38,1636,1519,926,36405,710
38072,97,2653,1001,1831,44077,822
2420,260,10284,1583,5847,103374,4437
8208,11,548,1516,360,15412,188
28264,264,5145,1207,3271,29281,1874
42444,46,1857,929,1420,38825,437
22477,1352,53613,1327,27253,232133,26360
46359,15,245,881,131,8603,114
5796,50,1073,1545,758,32029,315
6113,49,2377,1542,1495,19549,882
8621,6,281,1514,161,8049,120
61604,32,387,448,226,6530,161
20098,179,7354,1365,4847,70522,2507
29030,4,120,1192,108,5757,12
48433,34,479,854,430,11229,49
57300,14,162,591,126,7803,36
34813,68,1943,1084,1429,26716,514
61101,325,7453,463,7196,87267,257
2761,359,7657,1581,5203,60759,2454
55851,10,202,632,126,10112,76
2397,309,17733,1584,11426,77726,6307
63429,20,178,394,164,3514,14
29862,2,80,1176,54,5152,26
4952,116,7636,1555,3452,54085,4184
19371,47,599,1378,355,8437,244
5250,462,13081,1552,7466,170463,5615
62290,4,110,424,90,2343,20
21845,36,1866,1336,716,32914,1150
15004,29,1234,1452,633,13151,601
20120,248,7503,1365,5354,57999,2149
49850,36,591,811,423,10536,168
50102,25,354,805,288,13613,66
26622,5,205,1242,172,9535,33
18713,2,210,1390,139,19215,71
35253,1101,19915,1074,17352,167871,2563
17803,15,275,1406,201,11424,74
13287,148,6751,1476,2792,61923,3959
10974,58,2602,1501,1821,56093,781
44143,7,198,906,159,5349,39
7633,21,510,1522,358,12518,152
11811,127186,8445609,1494,1649549,18204603,6796060
6530,9,398,1536,311,22137,87
10001,158,8214,1507,3416,25561,4798
61327,19,241,455,145,5904,96
39799,32639,888120,971,518222,2619166,369898
53410,47,588,709,414,10209,174
17789,11,529,1406,414,14606,115
30821,128,3722,1157,2163,27399,1559
32522,5,541,1130,354,19798,187
57689,46,959,581,748,15926,211
53759,28,378,602,357,17621,21
54532,226,2540,672,2054,31936,486
5730,983,35969,1546,17845,120152,18124
18929,401,8840,1386,4148,46235,4692
22118,41,1899,1332,1360,63293,539
53275,41,288,712,267,4421,21
14944,55,1485,1453,998,12919,487
16241,4,186,1433,131,5076,55
12313,158,2284,1488,1526,15480,758
19605,13,237,1374,172,4879,65
2239,0,91,1585,70,11850,21
727,735,31015,1597,17461,131565,13554
7616,51,1272,1522,880,25556,392
50991,20,200,782,180,9148,20
21245,47,2763,1345,877,19737,1886
5130,538,13057,1553,8230,106735,4827
13909,18,830,1467,515,28503,315
33792,64,1883,1107,1107,31044,776
2490,174,6129,1583,3792,25958,2337
12395,229,9482,1487,4183,33446,5299
59301,26,279,528,196,6647,83
62151,306,4408,428,4383,66829,25
34633,13,452,1089,271,10296,181
60090,141,1767,501,1262,46604,505
57984,27,467,572,415,28623,52
55262,1,20,648,19,3680,1
23665,50,832,1306,597,21710,235
16914,26,505,1422,406,13687,99
14968,65,1298,1452,1043,46048,255
11585,10,541,1496,307,8159,234
31872,6,222,1140,156,5320,66
18324,196,3282,1397,2465,24299,817
55281,6,105,647,88,6827,17
18709,7,331,1390,224,11326,107
62079,461,6634,431,6286,74693,348
64191,53,839,372,818,15616,21
56149,12,212,623,164,8467,48
32310,89,3044,1134,1726,23373,1318
28954,111,1485,1194,1200,24384,285
60227,20,178,496,140,9375,38
29803,361,10518,1177,5560,59244,4958
17736,4724,189776,1407,95874,504763,93902
27863,9,588,1215,358,10954,230
60075,177,2769,502,1770,22661,999
48829,11,633,840,384,13891,249
15134,12,232,1450,172,18059,60
18237,146,6630,1398,5352,47219,1278
10340,139,7558,1505,3692,81582,3866
12902,699,12196,1481,8325,49076,3871
68695,1,33,235,29,2542,4
55896,38,363,631,274,10875,89
31432,485,5742,1147,5099,67052,643
16848,56,1135,1423,818,28857,317
47635,1268,14488,865,11981,74456,2507
68080,37,473,256,340,12631,133
64691,126,1773,357,1345,16140,428
10975,5,259,1501,115,6235,144
21881,16,519,1335,393,12245,126
35967,41,1304,1057,831,13409,473
874,6984,300806,1595,147144,952144,153662
65548,87,1128,334,962,16857,166
17436,16,240,1413,214,17496,26
8039,302,4892,1517,3560,46736,1332
3430,13,506,1574,289,13239,217
11016,81,2609,1500,1751,34751,858
66692,1,21,301,20,2750,1
55047,72,1028,654,672,25786,356
70665,0,0,169,0,2024,0
10782,22,1018,1502,626,34690,392
12109,97,2947,1491,1951,66611,996
26824,1,62,1237,48,2635,14
68887,10,123,228,115,3811,8
36945,42,1336,1032,856,26755,480
11536,234,16678,1496,8809,79155,7869
55004,14,338,655,257,7662,81
67430,236,10083,277,4376,58638,5707
60163,3,64,499,46,3886,18
21868,3,74,1335,62,9875,12
20483,7072,219712,1359,112304,851604,107408
19068,1909,63246,1384,29642,219687,33604
34754,69,1198,1086,967,10044,231
25327,786,21197,1270,10101,99271,11096
36924,30,381,1032,315,8826,66
27222,111,2680,1229,1712,26266,968
66156,51,1620,317,1336,13884,284
56587,29,458,611,399,8030,59
23744,27,495,1305,369,12863,126
13329,67,1539,1475,948,28078,591
27147,46,1954,1230,1145,33681,809
2521,19,712,1583,525,44825,187
24491,67,1322,1289,817,14322,505
51603,571,15715,765,10911,76596,4804
48157,23,506,858,387,16836,119
1713,85,4255,1589,2262,58730,1993
34493,693,12780,1093,11308,164654,1472
60001,1958,34997,499,23982,203784,11015
38034,230,3189,1001,2468,46806,721
54421,52,559,676,430,14363,129
25837,105,1968,1260,1326,17482,642
29978,6,231,1174,147,6215,84
26927,445,9729,1235,6615,42874,3114
49663,18,98,816,82,6454,16
3878,109,3086,1569,1444,23434,1642
52579,63,701,734,574,14142,127
16948,19,1120,1421,746,16552,374
26969,24,401,1234,267,11438,134
48619,43,499,847,393,13756,106
378,506,20077,1599,12232,98926,7845
20892,31,817,1352,595,30507,222
55534,10,147,641,137,8203,10
58449,34,490,556,364,5275,126
16031,10,327,1436,260,19655,67
19034,254,4836,1384,2687,39892,2149
24252,10,389,1294,280,18523,109
68824,95,1611,230,1194,18960,417
39391,63,1449,976,1361,26310,88
10231,30,661,1506,403,28411,258
3323,26,608,1575,436,20232,172
7147,63,1098,1528,790,16062,308
31408,80,1723,1148,1110,26910,613
36301,354,3710,1047,3059,35025,651
53925,50,1309,693,725,56456,584
54693,13,162,666,129,20954,33
44121,1,36,906,21,2805,15
54447,0,1275,675,1071,13223,204
542,212,8175,1598,5240,51924,2935
30857,115,1889,1156,1361,23990,528
4503,455,10661,1562,7471,43810,3190
18328,6,351,1397,256,10193,95
5388,15707,588495,1550,316009,1299273,272486
17207,67,1652,1417,1370,17573,282
12310,11,789,1488,438,12634,351
17495,7,443,1412,375,18160,68
4918,622,25417,1556,14132,117228,11285
7715,675,16214,1521,9044,115019,7170
1151,74,5493,1593,3622,51018,1871
4859,273,5009,1557,3430,77919,1579
4851,15,986,1557,515,28700,471
34707,15,550,1087,398,15032,152
12547,19,583,1485,371,5023,212
38435,106,2279,991,1388,15404,891
13771,4,132,1469,87,14506,45
10235,1952,67489,1506,37900,385144,29589
9981,6,369,1508,249,9245,120
63082,57,891,403,676,14126,215
494,99,2411,1599,1045,33454,1366
37650,13,156,1012,133,2190,23
19697,21,397,1372,293,14427,104
40223,127,2923,964,2337,39528,586
22977,103,3592,1318,1669,29019,1923
16713,137,1811,1425,1387,25784,424
11941,15717,428450,1492,209467,1495539,218983
35744,3,129,1061,100,4587,29
1258,18,812,1592,563,22127,249
14042,618,8131,1464,6014,42425,2117
10370,1596,63547,1505,30478,246780,33069
62782,58,509,411,476,12561,33
35989,132,2106,1056,1843,25087,263
11771,39,1704,1494,706,16806,998
32805,247,6176,1125,4067,49278,2109
17293,16,835,1415,602,17857,233
24926,66,3443,1279,1826,32709,1617
31719,20,678,1143,367,9350,311
6124,15,589,1541,415,18028,174
37684,163,2152,1010,1904,20972,248
16215,21,851,1433,704,23587,147
26550,45,1358,1244,587,13523,771
45449,0,144,891,105,4396,39
53971,2037,22101,692,15936,92842,6165
67546,2,64,273,54,2290,10
38134,102,1759,999,1370,17992,389
64706,35,184,357,182,4336,2
4632,731,29940,1560,17355,354356,12585
9881,149,6243,1508,3788,28694,2455
15812,353,9122,1440,4903,100052,4219
20521,706,30678,1358,14387,171267,16291
41177,27,383,949,276,7158,107
4427,1601,37320,1563,25503,242727,11817
62163,4,46,428,40,2793,6
32515,18,421,1130,358,19682,63
44324,519,11105,903,9398,51451,1707
54808,1136,12787,661,9346,115566,3441
9349,623,26678,1511,15922,107729,10756
58045,238,2214,569,1916,28605,298
22348,14,559,1329,402,16043,157
29571,187,4270,1182,3049,21819,1221
54029,119,1392,688,1310,19488,82
21143,293,6508,1347,4448,28845,2060
55359,39,513,645,476,5544,37
49129,112,1389,831,1186,60724,203
18828,34,619,1388,448,12733,171
23267,41,2791,1313,1995,49686,796
67,12,942,1604,718,51872,224
20903,1413,36978,1351,25072,169402,11906
13817,4,169,1468,114,8319,55
15594,784,24189,1443,16286,114126,7903
62351,1,28,423,16,5472,12
8793,1251,48723,1514,29015,163781,19708
29183,57,1425,1189,843,17401,582
28399,18,367,1204,231,8670,136
56434,20,388,615,276,6870,112
59878,340,5538,508,3273,56990,2265
17171,46,873,1418,678,12793,195
48528,15,168,850,143,4362,25
17965,282,7019,1403,4946,52588,2073
59410,42,681,524,576,9170,105
37729,155,2195,1009,1863,21173,332
5357,27,716,1550,432,11539,284
11684,57,2691,1495,806,10406,1885
44129,68,1301,906,868,26807,433
30495,43,862,1163,597,19833,265
37190,10,260,1024,211,8111,49
13051,6,324,1478,175,10411,149
23810,6,211,1303,141,10223,70
31614,123,3670,1145,1610,20575,2060
7370,46,1697,1525,1175,33585,522
51581,0,51,766,24,6415,27
12119,11,433,1491,260,8314,173
33018,3194,54636,1121,34540,295466,20096
12480,208,4678,1486,2109,47713,2569
66664,3,27,302,25,1226,2
19046,0,0,1384,0,8875,0
4738,57,2656,1558,1576,29778,1080
11418,43,1212,1497,701,16720,511
60206,431,13944,497,8458,53821,5486
67070,50,702,289,611,16663,91
23515,189,6551,1309,3096,56285,3455
3886,7,445,1569,296,19343,149
41239,9,184,948,150,2502,34
48868,202,2810,839,2512,28290,298
54826,195,1374,661,1190,14737,184
31445,16,215,1147,150,10786,65
25706,294,10131,1262,3666,59894,6465
38956,8,66,981,57,2717,9
52223,7,83,746,69,6336,14
5535,7,217,1548,167,6180,50
17923,140,3550,1403,2564,21748,986
1838,3089,92451,1588,48874,197436,43577
98,17086,469241,1603,248303,1140329,220938
18922,0,0,1386,0,17970,0
7770,63,1507,1520,1008,9897,499
44903,23,459,897,337,5638,122
15994,196,8461,1437,5849,85201,2612
1569,13,423,1590,240,31840,183
25279,170,1603,1271,1290,29816,313
10048,8,263,1507,188,20603,75
27343,8,712,1226,496,22954,216
63249,11,242,399,212,6203,30
15612,55,757,1443,457,12248,300
37223,284,4430,1023,3308,88755,1122
13345,20,491,1475,276,9666,215
55783,669,6264,634,5116,31345,1148
61682,192,3389,426,2818,54595,571
13177,13,755,1477,430,17886,325
4459,48,1684,1563,1263,20972,421
16681,844,25383,1426,16479,299765,8904
44302,65,930,904,740,18836,190
28446,19,966,1204,579,12939,387
46225,2,30,882,23,5550,7
4664,64,1771,1559,1245,38832,526
5267,75,3837,1551,2710,54174,1127
26727,620,7012,1239,5280,56383,1732
53429,18,207,708,146,6531,61
68896,671,9967,228,9359,44888,608
28988,160,3183,1193,2275,51396,908
40741,81,2001,956,1641,21085,360
26269,2793,226035,1250,39237,278688,186798
56811,26,241,604,226,6138,15
8135,60,1718,1516,1206,22063,512
57798,5,77,578,68,1825,9
55206,5942,97924,650,75777,427316,22147
48279,155,2805,856,1788,33906,1017
29279,38,789,1187,412,15603,377
30169,256,7912,1170,2977,26425,4935
57853,10,188,575,142,5957,46
11052,1025,29099,1500,20052,124730,9047
5394,19,593,1550,419,11312,174
15448,49,1163,1446,849,20019,314
6326,82,2934,1539,1411,15801,1523
460,36,1747,1599,1037,19035,710
24266,261,4704,1294,2609,28043,2095
22318,587,11646,1329,7799,59935,3847
4760,11,278,1558,170,16399,108
16357,1,101,1431,63,9296,38
68914,8,106,227,89,3289,17
27713,28,846,1218,667,13236,179
62111,100,1922,430,1801,11956,121
68306,21,221,249,203,5906,18
49985,42,604,808,489,14417,115
19254,27,359,1380,260,10832,99
66729,171,3508,300,3267,39055,241
24058,32,685,1298,513,12872,172
53582,8,100,705,82,4907,18
548,215,7399,1598,5812,51691,1587
26387,3280,65486,1247,39729,222055,25757
15102,28,1451,1451,813,13782,638
35792,554,8086,1061,6691,68780,1395
36460,22,619,1042,405,12593,214
55222,33,515,649,449,4402,66
28837,15,490,1196,338,10467,152
27545,106,3983,1221,2687,36573,1296
64442,1189,18912,364,16895,127530,2017
24650,38,2252,1285,1306,35452,946
68239,48,1075,251,689,21955,386
33208,10,358,1118,198,9089,160
4276,30,841,1565,519,58381,322
59717,148,1628,510,1218,24027,410
15373,1719,129904,1447,48831,494198,81073
30488,623,14240,1163,8643,116106,5597
58235,53,619,563,614,19407,5
661,373,17870,1597,7831,207618,10039
24110,22,816,1297,533,14861,283
21372,72,1441,1343,1225,20222,216
25251,1934,50639,1272,24399,151463,26240
15566,7,324,1444,201,8759,123
34087,111,2158,1101,1476,18381,682
70117,0,0,188,0,1199,0
307,11,452,1600,297,15667,155
31709,5,115,1143,79,6939,36
33906,2,127,1105,98,3101,29
50689,3,122,790,85,13308,37
25294,118,1871,1271,1340,14399,531
32657,1667,25958,1128,13620,129354,12338
51512,110,2180,768,1345,15865,835
15601,113,2533,1443,1484,37975,1049
29731,279,6009,1179,4309,68863,1700
60658,35,515,480,434,9890,81
49562,643,8336,819,7354,64677,982
14491,7,241,1458,142,16148,99
16720,68,2320,1425,1601,27505,719
30109,438,14928,1171,10106,92269,4822
53472,61,587,708,529,17911,58
24079,852,28676,1298,18676,177333,10000
8486,329,19305,1515,12250,125187,7055
31071,8,148,1152,90,5061,58
22833,26,1157,1320,889,20622,268
23292,16,407,1313,282,6720,125
65602,1669,17552,333,16518,85499,1034
25932,10,755,1257,444,31646,311
11507,81,2131,1497,1367,19184,764
31192,86,1284,1151,995,25716,289
54909,27,596,658,430,18842,166
30773,16,588,1158,376,11140,212
40817,538,5070,955,3822,43321,1248
5763,147,2200,1546,1181,38580,1019
18996,283,15163,1385,7548,70973,7615
30984,127,3389,1154,2016,20340,1373
13433,83,1940,1473,930,14107,1010
33715,16,548,1108,370,17809,178
52581,55,726,734,611,14641,115
177,13,349,1602,269,16335,80
23291,79,4578,1313,2878,36467,1700
39594,263,4614,973,3435,35733,1179
32417,16,636,1132,398,5011,238
43153,238,2185,917,1844,16666,341
3482,47,1246,1574,749,9192,497
58885,40,553,542,440,11867,113
25029,10233,252091,1276,120786,826074,131305
50117,10,211,790,168,6777,43
68677,1,56,235,41,4431,15
46513,7,109,879,89,6700,20
39341,398,4027,976,3014,40022,1013
53169,372,3921,714,3633,36996,288
533,125,3766,1598,2739,50039,1027
44298,33,569,904,428,11089,141
4024,248,9038,1568,5384,59106,3654
52652,72,755,731,614,26411,141
21276,37,1424,1344,1051,10799,373
36123,41,480,1053,388,20351,92
66818,71,1986,291,1175,36159,811
50068,14,226,805,221,8441,5
23477,329,4981,1310,3814,24760,1167
37806,1942,69642,1007,24947,464559,44695
16828,121,2858,1424,1355,34848,1503
4188,142,7412,1566,4539,38172,2873
59910,3,295,507,92,9984,203
2381,9,251,1584,178,29652,73
15466,5,128,1445,72,9903,56
5239,25,1443,1552,976,12408,467
3638,5,155,1572,114,41145,41
52545,24,455,735,313,12051,142
58741,2,41,546,34,6995,7
29312,742,15768,1187,11144,119780,4624
6829,159,6243,1533,4140,27096,2103
11038,9,362,1500,231,8189,131
37752,28,563,1009,513,15112,50
59603,261,4946,518,4523,23792,423
29809,752,15810,1177,14030,150750,1780
23787,78,1831,1304,1273,31931,558
16145,0,67,1434,40,7770,27
12322,1177,48679,1488,26313,233951,22366
39975,461,8185,968,7537,75525,648
70412,112,1707,177,1438,9427,269
18782,9,843,1389,535,14722,308
36289,95,2468,1047,1969,28013,499
33325,40,492,1115,340,6631,152
29652,15,569,1181,314,6351,255
1659,86,4437,1590,2507,66376,1930
8099,208,4460,1516,3396,28326,1064
10260,3,321,1506,183,15954,138
39221,46,1411,978,1064,18009,347
34377,2,169,1095,116,8986,53
66081,38,1181,320,1142,13972,39
22784,60,3051,1321,1829,25510,1222
63978,23,209,378,141,10697,68
50964,247,2300,783,2075,36292,225
5151,159,4629,1553,3030,40739,1599
5238,5,341,1552,241,8988,100
68615,1,53,237,39,3350,14
37256,7738,200796,1022,126983,573835,73813
14648,11,564,1456,285,12229,279
46025,64,788,885,635,10028,153
1287,10,777,1592,328,24322,449
8698,304,12675,1514,5510,125144,7165
34170,777,23780,1099,10222,155484,13558
6580,107,3129,1536,2173,22345,956
62959,0,41,407,9,1981,32
28181,40,632,1209,509,13895,123
67367,172,2704,278,2511,23787,193
12454,5333,239309,1487,105883,542467,133426
58047,281,3939,570,3838,31837,101
63468,50,696,393,615,10389,81
52565,29,658,734,519,17981,139
32999,168,3654,1121,1598,25578,2056
38845,16,273,982,245,10210,28
48634,553,10267,846,8369,73060,1898
41962,45,451,936,428,8926,23
53628,126,1861,703,983,31577,878
65098,376,6096,344,5486,46087,610
32352,16,667,1134,413,7714,254
60639,11,151,480,120,9520,31
52981,386,5121,720,4609,63087,512
18933,20,645,1386,450,9184,195
8583,9188,658233,1515,192993,2017218,465240
48041,15,404,860,322,19917,82
6966,5,251,1531,169,13522,82
53727,41,408,700,311,24906,97
28078,573,8428,1210,5081,55741,3347
25589,25,641,1265,443,12719,198
64544,28,341,361,281,5772,60
15755,28,1316,1441,917,45127,399
20800,15,670,1353,481,9479,189
37605,3391,47936,1013,28936,267810,19000
15649,22,688,1443,512,6869,176
12015,1628,60905,1492,36124,339768,24781
12288,6,217,1489,120,7939,97
35156,17,214,1076,157,3623,57
20838,17,377,1353,287,14924,90
56946,92,883,600,742,10665,141
64635,63,1064,359,906,16455,158
36974,36,901,1031,718,21673,183
32024,58,974,1137,655,34587,319
50885,84,1752,785,1499,22548,253
28742,16,239,1198,110,3101,129
12172,37,867,1490,507,5387,360
20582,3,190,1357,136,10295,54
59864,80,450,509,424,7212,26
19055,184,3016,1384,2293,19765,723
49139,48,911,831,772,16061,139
64270,16,268,369,262,9198,6
10657,92,3220,1503,1731,27440,1489
2850,71,4522,1580,2952,27045,1570
51781,3,103,760,95,6002,8
8050,27,726,1517,491,9795,235
28234,2,95,1207,67,7477,28
53921,34,312,694,278,17724,34
58556,36,595,552,547,17083,48
58688,43,487,548,462,9837,25
23872,22,1207,1302,824,40025,383
1294,486,18117,1592,10519,92705,7598
1001,14,926,1594,651,43268,275
32066,14,288,1138,253,7806,35
17341,24,672,1415,490,13063,182
66427,36,472,309,364,15962,108
32019,272,5436,1137,3580,25251,1856
1427,17,1206,1591,736,7137,470
52437,405,4425,739,3698,35699,727
69573,46,945,206,913,15946,32
36242,81,1811,1048,1646,55363,165
25644,112,4293,1263,2827,72927,1466
33274,32,666,1116,457,11190,209
50146,178,2990,801,2544,43754,446
32529,39,626,1130,443,9427,183
24522,2877,52156,1288,36210,299382,15946
8249,22,1288,1516,669,22612,619
4116,23,771,1567,531,26297,240
64604,49,1529,359,1057,19389,472
63124,19,493,402,209,11452,284
9534,2165,74201,1510,39959,222051,34242
6989,32,2522,1530,1348,23783,1174
31474,55,900,1147,477,26770,423
16399,3121,147473,1430,54893,746858,92580
22306,22,1363,1330,947,33398,416
30508,16,583,1163,349,8144,234
14910,4,419,1453,295,10154,124
15521,98,1922,1444,1268,38248,654
67401,28,654,277,423,20145,231
35817,1194,19368,1061,17034,165766,2334
61813,77,1044,440,935,14885,109
9386,21,585,1511,438,13482,147
4388,783,24121,1563,17352,142730,6769
10393,6,250,1505,187,7623,63
55048,107,925,654,826,4851,99
7215,28,1050,1527,667,26424,383
25173,23,533,1274,294,5407,239
63685,504,15491,387,5231,77952,10260
58028,233,1922,569,1808,18641,114
29096,6,601,1191,334,7389,267
745,860,80696,1596,41241,325495,39455
34459,28,830,1093,644,6343,186
65904,25,387,325,334,16077,53
12355,9,337,1488,225,17787,112
56333,58,897,618,719,12963,178
14965,51,753,1452,516,12305,237
53086,286,4062,717,2808,27468,1254
20197,92,2592,1364,1600,37295,992
16724,568,16954,1425,6255,76607,10699
58184,33,343,565,253,6325,90
35258,4,49,1073,45,5046,4
19118,78,3625,1383,2035,41598,1590
62186,143,3071,362,1344,21034,1727
28388,126,4170,1204,2889,24268,1281
32827,23,523,1125,354,8274,169
17480,59,3228,1412,2143,33167,1085
12233,166,3687,1489,2346,29125,1341
27769,139,4647,1217,3327,43985,1320
49919,10,262,809,176,11364,86
55124,95,1839,637,1330,26265,509
36375,6,343,1045,262,7333,81
4641,0,116,1560,77,9123,39
15898,22,889,1438,604,14364,285
5911,33,769,1544,321,19015,448
65833,0,25,327,24,1981,1
58840,131,2058,543,1866,17842,192
23939,47,1695,1301,1152,11039,543
25740,414,9381,1261,5897,36690,3484
65753,2,38,329,25,3676,13
17360,14,228,1414,157,6804,71
18191,11,326,1399,222,10209,104
24449,81,2410,1290,1536,33557,874
67172,9,196,284,193,5679,3
2972,28,1768,1578,756,11461,1012
24933,1673,39589,1278,22172,186686,17417
66648,8,122,302,106,5772,16
17033,16,346,1420,268,11341,78
65225,7,97,341,72,5066,25
24694,17,278,1284,194,14039,84
52906,1261,12628,722,10152,159269,2476
1128,69,1143,1593,719,21164,424
8124,474,23958,1516,15652,75270,8306
37637,266,3634,1012,2891,46346,743
1394,7,334,1592,250,20910,84
65435,7,91,336,87,3526,4
33383,4,54,1115,30,4978,24
18098,7,428,1401,301,5359,127
43903,18,380,909,311,13679,69
33783,7,165,1107,111,5127,54
51546,69,335,767,322,15371,13
9169,551,16286,1512,9045,64397,7241
99,249,15731,1603,8669,100624,7062
20534,154,21399,1358,2857,75878,18542
16999,19,1353,1421,931,43817,422
20398,6,213,1360,145,11482,68
52386,6,98,741,88,7868,10
54374,14,206,678,131,4606,75
51079,0,153,780,108,7154,45
63727,62,738,386,571,10232,167
58270,585,10151,562,9752,61047,399
42356,2491,52653,930,36170,179108,16483
61782,14,164,441,157,10193,7
60835,524,7749,473,6794,52223,955
492,225,7935,1599,5366,86825,2569
50115,1065,16730,804,11870,145830,4860
50950,729,13446,783,9760,93900,3686
37126,390,11921,1026,8506,124159,3415
69285,1,27,215,19,4759,8
37701,27,464,1010,343,5572,121
23201,857,29802,1314,17883,158957,11919
2534,93,1883,1583,1161,10610,722
5916,1217,37012,1544,22017,148721,14995
12282,29,1606,1489,648,32004,958
24707,112,4916,1283,1373,24928,3543
11309,5,111,1498,84,10894,27
58148,38,1385,567,751,18301,634
67389,5,21,278,16,17083,5
62419,26,388,421,352,7573,36
36962,15,259,1031,216,14464,43
31125,5,42,1152,28,1341,14
49240,225,3482,827,3073,38478,409
54506,221,3444,673,3148,47633,296
38292,11,213,995,195,10860,18
4306,434,15799,1565,12416,72991,3383
62547,3,123,417,104,6404,19
14741,42,1315,1455,882,22847,433
10126,336,10957,1507,7296,58471,3661
5123,1933,76654,1553,36710,348510,39944
33393,12314,235338,1114,136090,527079,99248
4699,41,1622,1559,1120,12908,502
44462,16,257,902,142,10331,115
12253,1242,35718,1489,24453,173653,11265
10343,556,18745,1505,11771,183676,6974
40478,2062,22659,960,18345,154240,4314
64556,6,140,361,112,2859,28
56438,427,6590,615,5256,50823,1334
46009,219,7974,885,4219,27986,3755
6375,48,1410,1539,902,24593,508
41864,91,1350,937,1095,13702,255
17861,168,3150,1405,2061,51063,1089
53439,5,74,708,55,5943,19
56673,124,2798,608,1918,35351,880
11088,7,211,1500,131,18062,80
31677,41,602,1144,444,13290,158
12471,23,1400,1486,771,14518,629
67231,25,275,283,268,3954,7
12368,20,880,1488,523,19035,357
64740,0,2,356,2,2664,0
61917,9,123,437,121,2789,2
37862,777,13437,993,10873,123822,2564
5018,3,113,1555,78,4450,35
54466,678,13950,674,7027,61548,6923
49074,971,15366,833,11412,116045,3954
20153,11,604,1364,413,8131,191
58102,38,433,568,394,15696,39
10500,50,1320,1504,926,15963,394
8682,29,1131,1514,704,11703,427
62308,5,137,424,132,5315,5
1504,41,967,1591,704,31550,263
30331,339,6720,1167,4147,41339,2573
17655,45,928,1409,620,6863,308
30329,43,909,1167,667,12126,242
2157,253,9278,1586,5646,78647,3632
1110,511,10891,1594,7263,92993,3628
14519,419,6120,1458,4100,43045,2020
32437,28,397,1132,287,6763,110
10463,52,1969,1505,1229,21187,740
324,27,1200,1600,748,24542,452
49033,141,3860,834,1235,19649,2625
68634,382,6595,236,5792,73868,803
38092,19,516,1000,322,14139,194
49407,108,1034,823,945,30721,89
27283,87,2295,1228,1690,27906,605
11741,12,253,1494,141,12360,112
36947,37,505,1032,413,5113,92
32751,77,1018,1123,744,27877,274
67020,7,181,290,154,5184,27
33594,9,172,1111,144,8431,28
46831,259,3879,856,2960,37253,919
21104,25,1287,1347,995,18802,292
8423,144,3268,1515,2313,23198,955
59013,6,78,538,56,2772,22
54301,12,126,680,113,4622,13
52891,37,426,723,385,7076,41
23526,23,258,1309,221,18980,37
30660,106,1911,1160,1366,23364,545
37395,8,215,1018,190,7906,25
2532,5886,179049,1583,92894,420377,86155
9487,31,797,1511,477,17985,320
35752,1,22,1062,12,2355,10
16970,157,6268,1421,2756,38935,3512
36136,33,775,1051,692,10972,83
35105,145,4221,1077,2590,57605,1631
61913,15,511,436,381,14500,130
58683,120,2465,548,1512,27596,953
11335,19,446,1498,300,13516,146
58152,31,404,566,308,6834,96
40588,411,21475,953,9337,118065,12138
21408,3,61,1342,52,16121,9
14721,65,1063,1455,770,13717,293
59595,59,724,518,568,16698,156
17547,179,4006,1411,3192,67412,814
9093,126,4388,1512,1997,23019,2391
35045,210,3333,1079,2199,20706,1134
52677,2475,48715,730,24534,153511,24181
57394,186,1126,589,1020,17638,106
53944,109,1472,693,1149,17874,323
25879,144,3692,1259,2562,18984,1130
14653,7,231,1456,138,6946,93
48697,42,1333,844,856,19554,477
52417,14,242,740,193,7293,49
62445,5,98,420,50,3450,48
22779,22,1113,1321,739,16295,374
27402,41,1181,1225,709,18781,472
51457,16,254,770,200,7105,54
30519,22,744,1163,466,16747,278
33401,17,309,1114,228,10832,81
60118,1060,27720,500,18113,188796,9607
51159,55,470,777,398,4925,72
29154,18,852,1189,499,15488,353
33443,24,1236,1113,553,21504,683
13645,8,682,1470,454,21870,228
66629,118,1836,303,1680,18188,156
29012,70,1027,1193,684,8854,343
35739,9,614,1062,397,10910,217
18057,3,70,1401,56,3665,14
64364,35,385,366,373,9032,12
20625,15,1019,1356,744,26425,275
30032,94,1726,1173,1374,25748,352
30831,5,256,1157,161,9891,95
19252,354,5274,1380,3389,41067,1885
3557,639,15597,1573,8463,116112,7134
9183,55,2287,1512,1378,23047,909
43293,1492,25017,915,18691,202736,6326
38400,924,16216,992,13301,50303,2915
31994,36,345,1139,256,10268,89
16751,3241,66361,1425,46549,397169,19812
22072,11,293,1333,202,14799,91
4684,60,1799,1559,1069,24874,730
21661,634,14187,1338,9404,44349,4783
26981,92,1197,1234,712,10609,485
45897,22,315,886,292,22547,23
40644,2,155,958,76,5549,79
10201,184,5712,1506,2936,64056,2776
42532,64,657,927,530,16802,127
23600,26749,673828,1308,306120,1933876,367708
408,171,5878,1599,3982,33687,1896
50960,134,2522,783,2045,31453,477
69190,4,27,218,22,7697,5
47963,0,0,861,0,2484,0
34409,19,644,1094,456,10803,188
55709,19,140,636,140,4467,0
25297,12,518,1271,339,12820,179
16313,0,57,1432,26,5855,31
2285,354,12497,1585,7665,107016,4832
32692,3,240,1128,103,5957,137
44871,3,46,898,36,2273,10
17532,47,1660,1411,1303,34579,357
11263,165,3128,1499,1755,31738,1373
53177,30,661,714,483,10980,178
28620,21,842,1200,568,17337,274
49025,53,555,834,489,12537,66
20266,24,1292,1362,895,18220,397
24314,49,965,1293,571,15835,394
40235,77,798,964,641,7778,157
42414,23,386,929,331,22010,55
37447,12,285,1017,189,13516,96
59406,684,8007,525,6322,57803,1685
32165,306,11570,1136,7068,51919,4502
53626,71,987,703,834,34623,153
15927,9308,377065,1438,120856,770724,256209
22896,4,299,1319,166,7848,133
39307,1,124,977,109,4157,15
43897,12,421,909,312,13775,109
39134,56,1711,978,1179,29227,532
24121,115,3616,1297,2469,102254,1147
5183,30,1458,1552,808,13911,650
35202,19,321,1075,254,4367,67
61236,96,2412,458,1657,28759,755
25163,895,15194,1274,10751,74509,4443
54652,178,4006,667,3952,58239,54
23297,15,358,1313,233,3763,125
34444,299,4531,1093,3350,32200,1181
14407,0,0,1459,0,12107,0
13371,139,3434,1474,2258,21957,1176
51272,995,8766,774,8698,42292,68
39203,43,482,978,307,12917,175
38439,34,1059,991,837,23559,222
1989,118,3289,1587,2393,47005,896
31109,16,414,1152,391,26747,23
19017,23,460,1384,323,11633,137
3374,1550,33398,1575,22768,186686,10630
3721,948,26933,1571,18401,105311,8532
30415,20,544,1165,370,5670,174
19714,0,0,1372,0,19422,0
23736,7,274,1305,221,15069,53
19858,151,2813,1369,1790,19084,1023
50316,3256,58649,799,33807,197118,24842
55469,23,288,643,209,6144,79
32084,96,784,1137,621,9707,163
55845,18,352,633,280,7774,72
61160,71,1471,461,1420,14481,51
57918,10,267,574,184,9125,83
58104,16,145,568,125,6148,20
68780,137,1943,232,1384,19676,559
48786,8,408,842,273,10122,135
13632,2347,33913,1470,23175,208150,10738
25217,197,3638,1273,2302,20072,1336
42300,125,6137,931,4031,38739,2106
6706,239,9004,1534,4496,49063,4508
61314,55,764,456,678,23058,86
39881,28,935,969,700,11470,235
64245,14,232,370,207,5926,25
19505,115,3402,1376,2336,32727,1066
16565,452,8573,1428,5641,38449,2932
3757,8,114,1571,89,10476,25
9138,42,2089,1512,834,13745,1255
56171,32,367,623,218,6538,149
48483,16,369,852,284,14966,85
49184,7,90,829,61,3948,29
25556,168,5272,1266,2538,32727,2734
43163,157,3086,916,2652,29197,434
32941,0,39,1123,31,3804,8
65369,11,226,338,126,5216,100
40753,215,3552,956,3320,50648,232
22222,118,2772,1331,1921,18192,851
50291,4,64,800,56,3300,8
52460,1791,18431,738,14761,165679,3670
55264,838,14036,648,12290,78308,1746
7812,60,2128,1519,1479,32121,649
16170,78,2819,1434,1503,45251,1316
13876,151,4413,1467,3023,45764,1390
31407,34,949,1148,648,25547,301
21950,25,437,1334,211,5034,226
54854,3,34,660,22,3237,12
21128,51,1388,1347,954,19948,434
53649,137,1918,702,804,25456,1114
52159,20,331,748,269,11609,62
32742,30,714,1127,484,15450,230
55375,162,2232,645,1942,36244,290
31083,130757,2790503,1152,1197626,4903441,1592877
48639,9,210,846,179,10197,31
47891,10,161,862,111,5398,50
12858,21,678,1482,393,15816,285
22876,1050,28180,1320,18044,143515,10136
40403,15,203,961,173,6574,30
24288,747,46041,1293,6972,85895,39069
37358,5221,121383,1019,75559,319253,45824
55505,3443,55138,642,42124,415375,13014
42223,193,3889,932,2699,72993,1190
23674,478,21214,1306,4597,100278,16617
130,149,5451,1603,3271,46037,2180
4692,231,10770,1559,7230,62941,3540
42510,94,1018,928,927,49273,91
52045,2,47,752,34,2991,13
14378,49,2674,1459,1551,42030,1123
30728,163,5173,1159,3764,39136,1409
45508,6,61,891,49,3688,12
22460,4,345,1327,262,14610,83
23743,14,372,1305,269,14859,103
23079,47,1207,1316,915,18700,292
15318,116,2748,1448,1941,25796,807
33253,1008,14827,1117,8603,59489,6224
63055,1,20,404,9,5653,11
21117,1156,26789,1347,18965,212509,7824
59747,9,156,513,144,10834,12
49773,66,1189,813,1151,36247,38
14912,106,3604,1453,2352,55347,1252
63669,62,1693,388,1144,23112,549
8108,63,3837,1516,2185,18685,1652
56091,43,614,625,467,7854,147
29526,535,13829,1183,10667,79235,3162
2480,460,15351,1583,9934,115961,5417
19299,13,224,1379,147,6789,77
14034,491,19387,1465,10947,154512,8440
14646,832,51145,1456,37242,294078,13903
66032,11,84,321,73,3932,11
14090,37,1846,1464,1150,16534,696
5675,94,2984,1547,1701,44530,1283
56379,1033,22131,617,14395,169350,7736
35831,12,291,1060,211,3914,80
60602,177,3098,479,2273,24568,825
15111,7,255,1450,166,16728,89
54243,61,534,683,430,8648,104
65053,281,3145,344,2965,25020,180
3407,51,1261,1574,767,18086,494
31126,51,1283,1152,877,15750,406
14691,167,10035,1456,3100,35616,6935
15282,38,1059,1448,817,11443,242
60675,5,62,479,55,3296,7
2515,221,8307,1583,5094,42242,3213
1464,22,934,1591,669,18729,265
7029,231,22713,1530,5747,109020,16966
29416,74,1793,1185,1200,36246,593
56520,17,161,612,149,4679,12
24925,190,2070,1279,1605,24974,465
3445,30,969,1574,673,12971,296
5152,1115,79437,1553,36449,412249,42988
19961,1548,57094,1368,33819,333723,23275
61563,6,126,449,125,3383,1
44608,18,849,901,389,9722,460
60841,170,7054,473,1842,52927,5212
60220,7607,280185,496,188446,1016849,91739
1771,93,6478,1589,3804,25553,2674
33929,266,6126,1104,5184,70106,942
56136,44,944,624,309,9671,635
22076,3,111,1332,80,5210,31
10638,138,3334,1503,2473,70086,861
18733,46,2247,1390,1312,53939,935
67882,2,29,262,29,1695,0
61388,6,127,344,115,4885,12
16377,25,1712,1431,1030,16210,682
70295,4,38,182,35,1774,3
67083,27,600,288,598,11175,2
34395,748,14549,1094,8321,93970,6228
13199,70,1642,1477,1123,25987,519
8769,88,3202,1514,2300,57231,902
3022,50,3697,1578,2095,19615,1602
36856,27,607,1035,284,8221,323
17403,8,296,1414,221,19028,75
1172,20,982,1593,545,27733,437
35562,28,1002,1066,595,10220,407
40660,1,110,958,91,4390,19
11029,86,3621,1500,2049,17729,1572
27920,26,1479,1213,874,30442,605
2743,42,1139,1581,797,42086,342
45671,43,643,889,486,10964,157
69817,39,226,197,220,5899,6
48721,21,257,844,216,6975,41
3967,97,3813,1568,2709,27200,1104
35472,135,3033,1068,2310,41756,723
63418,5,37,395,34,3470,3
57,38,1116,1604,829,46697,287
66,0,1,1604,0,56413,1
10900,48,1663,1501,1066,11450,597
21983,170,2815,1334,1857,30512,958
32407,100,1424,1132,1046,16477,378
18849,15,375,1387,320,15310,55
19210,0,152,1381,104,5182,48
16616,44,1072,1427,900,20339,172
19669,48,1044,1373,724,29457,320
10156,25,972,1507,605,5680,367
9167,189,5398,1512,3671,37815,1727
35711,40,1022,1063,716,15550,306
24034,198,4443,1299,3358,60612,1085
31022,4,65,1153,51,8340,14
31814,38,346,1141,290,5989,56
16472,151,5932,1429,3936,75277,1996
510,31,892,1598,650,22413,242
57996,2,29,571,23,4062,6
5600,4776,239526,1548,80801,1364221,158725
12630,72,1272,1484,753,13713,519
16879,16,689,1423,468,36568,221
28231,14,646,1207,378,8313,268
51710,31,291,762,271,12685,20
57552,23,421,586,288,13669,133
16324,1,130,1432,79,6714,51
32190,71,1462,1136,908,19466,554
32269,124,2550,1135,1530,22673,1020
34056,68,1976,1101,1032,17449,944
18373,73,2774,1396,1569,74814,1205
37836,0,23,1007,18,7630,5
19535,38,1064,1375,802,27110,262
18618,6,444,1392,366,16620,78
40415,3,48,961,23,1829,25
24404,30,1396,1290,911,52790,485
28825,75,1292,1196,899,16280,393
13135,77,4384,1477,2971,65741,1413
14497,157,2457,1458,1917,44304,540
1439,536,23824,1591,16418,73318,7406
14444,68,1097,1458,862,18225,235
36163,105,2792,1051,2176,80836,616
54131,12,96,686,84,2569,12
38665,156,7552,985,3870,66457,3682
53840,17,112,696,81,3735,31
67499,12,203,274,186,4047,17
27783,6632,215399,1217,114522,531355,100877
57523,139,1412,586,1004,33110,408
21360,21,977,1343,600,7522,377
33609,249,4843,1110,3425,61172,1418
11219,912,25952,1499,15106,89049,10846
29759,40,495,1179,420,12589,75
29977,6030,121562,1174,72095,456460,49467
2611,6,220,1582,154,19039,66
32989,34,371,1122,274,3513,97
29129,17,488,1190,422,9520,66
39523,28,478,974,367,11276,111
19812,2,99,1370,81,4308,18
63921,6,148,380,102,7528,46
35259,10,260,1073,172,7089,88
57558,33,633,585,563,19278,70
31181,971,27771,1151,12440,132440,15331
25814,66,1385,1260,897,15763,488
24765,83,2507,1282,1647,21503,860
12197,182,8284,1490,4681,45198,3603
34634,20,640,1089,455,14154,185
53884,94,836,695,702,10548,134
30241,491,7141,1168,4229,73051,2912
25368,90,1379,1269,893,23430,486
25288,19,539,1271,368,15853,171
39914,48,1313,969,1097,23334,216
55834,84,727,633,673,18638,54
64690,128,1556,357,1026,24060,530
30995,4,61,1154,39,2332,22
50166,13,98,803,86,4776,12
16799,105,2054,1424,1441,26692,613
20277,86,3725,1362,2564,27428,1161
8995,165,7723,1513,3635,28248,4088
26787,40,644,1238,482,9929,162
26656,14,528,1241,215,22213,313
9216,11,340,1512,223,7311,117
67079,28,670,288,661,15401,9
22295,12,184,1330,120,12281,64
66021,528,10799,322,10048,102830,751
13871,45,2648,1467,1686,37048,962
19732,30,642,1372,448,10592,194
34828,20,297,1084,260,13048,37
61884,728,8412,438,7925,45284,487
13759,283,8521,1469,5577,86833,2944
21790,965,22574,1336,12062,102239,10512
17152,5,202,1418,149,6246,53
4193,17,320,1566,230,19493,90
50524,51,628,794,483,9736,145
31598,188,2547,1145,1764,11671,783
39033,90,3125,980,1863,31129,1262
843,76,1901,1596,1344,35936,557
14611,30,1370,1457,914,30072,456
17997,40,610,1402,467,7467,143
52361,109,2565,742,1565,21027,1000
26930,18,423,1235,310,23625,113
34916,51,782,1082,490,11522,292
32202,13,374,1136,262,25214,112
21240,135,1821,1345,1414,45474,407
1820,21,359,1588,277,35014,82
14453,109,3293,1458,2053,22418,1240
41761,27,533,939,394,14660,139
7021,47,1865,1530,1174,33942,691
66950,11,114,292,96,4031,18
1176,8,394,1593,204,11001,190
24633,7,199,1285,143,7768,56
22555,105,1785,1326,1024,15844,761
20356,37,622,1361,358,11971,264
53692,1911,54622,701,18218,134704,36404
60836,758,12837,473,11360,73255,1477
29028,32,487,1192,438,23942,49
55744,12,138,635,93,3947,45
5050,312,7477,1554,5072,80162,2405
2663,49,2747,1582,1744,27918,1003
26698,98,1675,1240,1003,8298,672
33571,337,7433,1111,5026,67144,2407
50304,123,2181,800,1686,13306,495
6291,81,1617,1540,1141,12182,476
20394,13080,304902,1360,191952,899558,112950
29007,9,722,1193,344,17238,378
4680,182,9248,1559,4186,73531,5062
36496,12,259,1041,214,7254,45
28034,44,833,1211,605,10613,228
62362,43,508,422,374,15830,134
58069,317,4378,569,3189,33947,1189
60685,161,3846,479,1909,28964,1937
24704,4152,101985,1283,59215,566222,42770
23965,2019,87265,1300,42336,292966,44929
22496,3355,77753,1327,55617,462892,22136
53816,109,1231,697,1138,20322,93
9097,11,1108,1512,590,11334,518
55661,419,8527,637,7855,51658,672
1528,6,224,1591,165,23787,59
150,64,2746,1602,1622,73366,1124
3457,236,7670,1574,4735,56077,2935
50430,136,1553,796,1198,18809,355
1183,91,1858,1593,1299,22191,559
2210,51,4169,1585,3089,36874,1080
31943,45,1682,1140,886,21591,796
2762,610,13993,1581,7794,71680,6199
31840,70,1598,1141,1140,26995,458
59447,18,199,523,181,7447,18
18022,324,12064,1402,7741,93098,4323
22019,581,11042,1333,8237,69498,2805
37266,382,8523,945,7969,68903,554
38457,2,132,990,104,12344,28
51013,3,99,782,79,3392,20
57625,84,1125,583,1054,36190,71
32649,13,364,1113,286,12671,78
62624,13,112,415,101,4818,11
40491,13020,248797,953,175648,1064836,73149
47609,31,247,865,176,8546,71
40864,45,731,954,694,19314,37
13525,26,719,1472,335,15703,384
52309,108,1380,743,1231,13814,149
4271,8,419,1565,251,17775,168
17429,310,18955,1413,9459,120764,9496
15090,577,25793,1451,15381,117191,10412
20229,132,4436,1363,1757,25460,2679
51349,291,3826,766,3449,42741,377
11293,131,3375,1498,2305,25307,1070
14926,31,818,1453,544,36757,274
57308,348,4664,591,4609,43130,55
18894,68,2262,1387,1110,24482,1152
6747,226,11002,1533,6593,340995,4409
21525,1070,33764,1340,24181,153239,9583
25149,22,750,1274,635,17198,115
9185,2868,96336,1512,58549,292421,37787
27080,15,119,1232,93,17387,26
28805,39,969,1197,661,33048,308
15571,24,1643,1444,1215,24735,428
55296,10,130,647,115,10940,15
59027,11,182,537,144,6098,38
60922,36,255,470,248,4990,7
39774,14,223,971,198,5870,25
15199,70,894,1449,673,15498,221
33327,57,1117,1115,829,26020,288
10700,24,288,1503,235,8637,53
18194,13,215,1399,161,12207,54
4714,119,2796,1559,2064,20164,732
51838,60,650,759,500,21535,150
56796,55,592,604,554,18341,38
52558,84,999,735,839,17513,160
54573,105,1553,670,1201,10119,352
66504,11,157,307,130,4875,27
23953,138,4063,1301,1853,96004,2210
35662,180,2883,1064,2029,42303,854
50104,1,46,805,34,3170,12
27492,916,13264,1223,9928,114678,3336
5775,22,617,1546,325,15901,292
17405,96,4334,1414,2530,31010,1804
25228,130,2998,1273,1957,61148,1041
46939,2,111,873,88,5545,23
33098,43,722,1120,533,9387,189
18567,133,3408,1392,2657,35041,751
60956,42,393,469,307,7197,86
31127,23,234,1152,173,2852,61
18552,52,1277,1393,823,15761,454
55145,15,164,651,106,4525,58
23408,48,1192,1311,766,20045,426
13769,39,1542,1469,773,14138,769
12504,31,1445,1486,688,19445,757
13112,26,735,1478,390,54444,345
55932,7,85,630,83,5988,2
16591,47,560,1428,414,34457,146
32039,26,745,1138,477,5907,268
52543,51,962,735,843,13973,119
25022,13601,312743,1276,179267,745471,133476
21221,67,1991,1345,1267,57328,724
3993,10,350,1568,198,7456,152
27333,29,1058,1226,551,7803,507
37265,341,12513,1022,10556,32903,1957
52911,437,4891,722,3889,30429,1002
15806,139,5156,1440,2348,37431,2808
62976,73,1811,406,1736,24179,75
36522,6,220,1040,165,10041,55
68876,341,7317,228,6294,68379,1023
36310,273,4225,1047,3772,58862,453
22705,52,1574,1323,1171,35249,403
49050,248,5136,833,3134,52791,2002
57845,164,2210,576,1979,20000,231
26915,148,4037,1235,2977,44151,1060
1406,27,1165,1591,748,35230,417
24399,436,19371,1291,5633,86443,13738
59424,11,163,524,145,12120,18
26465,139,2958,1246,2306,51337,652
9027,12,417,1513,286,7498,131
20586,1915,32145,1357,24828,192016,7317
34245,92,1223,1098,885,9602,338
61527,34,301,450,275,4716,26
6376,22,693,1538,484,47493,209
13081,21,803,1478,413,22984,390
37813,35,974,1007,841,8972,133
45684,2,102,889,80,7016,22
10276,13,994,1506,578,15936,416
52421,5,102,740,74,11151,28
27767,6,127,1217,80,2486,47
7763,2,66,1520,40,3395,26
59612,301,5776,518,2747,40289,3029
14379,146,2800,1459,2151,49296,649
55970,13,172,629,133,6843,39
58746,44,670,546,476,11237,194
24756,7,272,1282,140,7418,132
8672,24,855,1514,533,19108,322
36759,249,2138,1037,1692,11128,446
25179,543,10956,1274,7219,40129,3737
18095,31,2491,1401,1666,19320,825
20942,229,7641,1351,6184,67124,1457
64899,11,69,350,64,12189,5
19834,290,4668,1370,2687,62549,1981
7204,141,3198,1527,2173,45990,1025
7856,9,505,1519,376,30159,129
56840,85,1102,602,799,22672,303
58672,5373,108025,548,68639,663330,39386
56666,0,133,609,105,6666,28
50177,354,4942,803,4461,56711,481
23519,5,199,1309,144,10023,55
23631,6,520,1307,362,10085,158
23105,4,142,1316,56,6114,86
55064,23,159,653,122,8648,37
29284,13,275,1187,203,5609,72
49420,17,239,822,167,9620,72
23136,37,1281,1315,819,12019,462
30599,420,3091,1161,2354,30439,737
60867,27,287,472,204,7645,83
13737,205,3300,1469,2331,14375,969
53329,1086,11183,711,9450,72414,1733
60948,179,3373,469,2455,15282,918
18139,118,6803,1400,5068,95180,1735
35787,2,83,1061,74,7227,9
56800,275,6655,604,5838,79513,817
52792,13,180,726,178,17816,2
1047,520,17711,1594,11855,122804,5856
22733,658,22898,1322,11093,106030,11805
64410,2,152,365,139,6836,13
1256,28,1067,1592,662,18370,405
62403,4,53,421,38,5185,15
34595,17,441,1090,357,8973,84
55936,66,536,630,448,10037,88
27269,5,69,1228,60,6296,9
58084,1748,28047,569,19621,148776,8426
52121,68,1218,749,969,22772,249
841,49,1772,1596,1234,21339,538
39374,75,1421,976,996,13305,425
1280,4,157,1592,101,26841,56
28469,52,1411,1203,805,16610,606
1405,4,228,1591,184,5003,44
10180,429,23523,1506,16766,142143,6757
29036,2103,74060,1192,40731,230085,33329
8932,12,630,1513,427,18598,203
21657,79,2313,1338,1540,27006,773
106,1151,132178,1603,57483,590428,74695
11419,24,534,1497,342,13324,192
21707,14,385,1337,250,7128,135
11860,27,1060,1493,471,18995,589
18055,1065,26166,1401,18874,74201,7292
3419,165,5628,1574,4188,27539,1440
33173,191,2980,1118,1909,32248,1071
51437,373,6290,770,5900,57418,390
8076,6,325,1517,170,20043,155
45505,15,256,889,198,13455,58
66485,13,225,308,156,4935,69
12225,0,0,1490,0,19983,0
8654,348,20822,1514,12648,85139,8174
44596,9360,151157,901,109079,612193,42078
6888,32,765,1532,596,17511,169
15970,18,314,1437,203,8992,111
61525,13,98,450,73,4340,25
2366,38,915,1584,714,10604,201
13347,45,753,1475,471,8171,282
30271,8,219,1168,147,9868,72
9083,740,13088,1512,8736,45202,4352
48772,8,394,842,346,3558,48
9669,197,11368,1510,7061,212213,4307
53930,28,277,694,223,5747,54
3977,16,962,1568,520,39988,442
3184,26,550,1576,425,10086,125
26844,121,4316,1237,3294,86221,1022
23508,33,671,1309,521,19084,150
58229,86,1736,563,1284,17550,452
20834,508,6668,1353,3599,25353,3069
64612,758,8701,359,6667,61650,2034
36801,10,91,1036,75,11429,16
17297,5,102,1415,82,6352,20
53306,36,534,711,417,5382,117
56461,7,129,614,94,4779,35
23071,5,194,1316,137,8852,57
34624,130,3397,1089,2686,33402,711
49495,67,829,821,660,22385,169
22167,23,372,1331,290,5567,82
18611,31,1882,1392,1571,22220,311
52314,11,116,743,107,3590,9
29898,35,1240,1175,774,16710,466
41727,2,56,940,36,8542,20
8153,81,2787,1516,1786,23668,1001
12274,175,7985,1489,4588,62101,3397
56342,59,745,618,586,13273,159
64971,4,56,347,40,7141,16
66122,10,97,318,93,2096,4
59204,13,114,532,95,3230,19
63080,2,45,403,32,3056,13
12560,36,1697,1485,783,18502,914
13350,69,2808,1474,1959,40533,849
42259,18,315,932,252,11341,63
55996,19,151,628,112,4712,39
53888,1030,16390,694,14334,199941,2056
33795,168,2940,1107,1742,49326,1198
2748,6,206,1581,142,15223,64
13441,167,5024,1473,3293,84226,1731
8250,5,307,1516,188,16390,119
23119,646,12698,1316,8690,172604,4008
63006,18,271,406,197,15151,74
52112,17,227,750,186,16274,41
65824,22,204,327,200,3738,4
10150,1,137,1507,92,4623,45
32602,315,7244,1129,5414,36212,1830
29215,49,1436,1189,1230,11735,206
30543,51,3844,1162,1439,38485,2405
63497,10,194,393,153,6964,41
57006,33,661,599,545,13593,116
32816,23,583,1125,252,17599,331
32749,18,671,1126,490,8233,181
19987,16,567,1367,402,51755,165
40922,2114,49179,953,36220,115472,12959
27202,56,2097,1229,1273,21568,824
34373,45,502,1094,392,8800,110
15049,10,379,1451,204,17526,175
32547,85,1601,1130,1183,29612,418
66724,8,116,300,114,6141,2
10556,223,6154,1504,4029,52956,2125
58521,325,2776,553,2353,24086,423
10198,754,28362,1506,19254,159870,9108
9763,866,36437,1509,22905,134364,13532
36156,65,978,1051,800,19612,178
54346,2358,49443,674,41067,350149,8376
36271,208,2174,1048,1684,47451,490
655,323,15404,1597,9331,57011,6073
30173,337,5471,1170,2326,30942,3145
64809,17,159,353,108,16953,51
49293,21,343,826,298,9638,45
2881,117,8561,1579,5750,107736,2811
29017,826,12064,1192,9270,66900,2794
5603,2739,81037,1548,37627,282008,43410
13302,114,5476,1475,2473,106985,3003
53503,32,315,707,256,7693,59
1076,96,5914,1594,3132,33870,2782
19189,12,621,1381,439,15862,182
23980,21,354,1300,304,32102,50
23999,146,3929,1300,2204,26728,1725
28392,272,4709,1204,2716,25448,1993
601,88149,2346191,1598,1184908,5625103,1161283
55476,13,144,642,101,13479,43
12910,0,0,1481,0,8061,0
35121,58,1099,1077,944,34703,155
16188,520,14198,1434,8699,76920,5499
15182,278,9422,1449,6108,52655,3314
24075,17,433,1298,300,10649,133
8859,1359,57001,1513,33430,327960,23571
8691,23,1132,1514,731,14018,401
18896,114,2647,1387,1593,23887,1054
63583,2230,13266,391,11053,285775,2213
64532,2649,45086,362,35142,309833,9944
58577,106,2108,551,1672,10824,436
17215,34,629,1417,538,25867,91
1626,5,75,1590,54,5643,21
57889,178,2840,575,2705,29204,135
30680,1,177,1160,105,5580,72
6147,73,2352,1541,1672,32091,680
31119,28,547,1152,355,9682,192
11620,24,591,1495,342,6183,249
16817,8,442,1424,303,13892,139
57231,82,1088,593,1069,13503,19
33508,308,5869,1112,4185,31082,1684
29399,181,3593,1185,2677,56692,916
52467,25,225,737,210,6155,15
28841,49,602,1196,376,8911,226
58207,28,192,565,175,7661,17
37479,77,1760,1016,1125,26324,635
39912,256,4302,969,3368,33018,934
36990,50,1146,1030,934,20420,212
27919,52,1741,1213,1188,31400,553
29019,105,1904,1192,1339,23151,565
32226,63,1280,1135,489,31127,791
18144,8,352,1400,230,14621,122
37437,29,633,1017,541,15776,92
52819,125,1173,725,906,22572,267
36504,4,127,1041,100,15553,27
31715,19,429,1143,287,4304,142
12890,176,4044,1481,2578,50601,1466
64748,5,47,355,40,3128,7
25131,1038,28411,1274,12654,92749,15757
3277,103,6962,1576,4321,40580,2641
39690,12,362,972,286,22235,76
9461,15,418,1511,287,15468,131
38177,148,3339,998,2166,28380,1173
40087,431,10708,966,8264,32176,2444
59273,1511,33450,529,24915,176540,8535
52537,188,3182,735,2135,62811,1047
19135,92,3170,1382,1738,30410,1432
554,12,379,1598,297,36796,82
28064,14,534,1211,191,7472,343
17481,11,122,1412,69,6876,53
242,1449,43967,1601,23535,155917,20432
12723,112,1578,1483,933,13387,645
22755,73,1052,1322,688,31096,364
63067,56,978,404,582,12096,396
55287,61,745,647,720,42325,25
4606,38,1416,1560,849,23983,567
11944,259,6511,1492,3189,54993,3322
2898,1,81,1579,52,6652,29
1766,5,181,1589,141,7599,40
15905,133,3459,1438,2078,53526,1381
26393,32660,1346710,1247,313613,4120094,1033097
14449,1872,53673,1458,35331,181365,18342
39830,27,400,970,388,12397,12
5770,470,16982,1546,8203,68971,8779
50283,41,672,800,558,10054,114
17209,83,2291,1417,1229,17934,1062
17836,1284,17955,1405,10783,108539,7172
22208,4,169,1331,90,4840,79
27955,4286,114255,1212,59646,729464,54609
23107,275,11689,1316,6206,69522,5483
50056,17,167,806,155,2840,12
31720,92,2141,1143,1317,25859,824
37195,91,2281,1024,1524,56760,757
27135,36,870,1231,743,19665,127
51243,6,50,775,41,3320,9
24137,373,17858,1296,6250,132761,11608
35338,29,545,1071,411,7940,134
13868,69,1218,1467,606,19625,612
5497,15,397,1549,253,16674,144
38240,2,16,996,12,1608,4
63985,10,229,378,171,5814,58
7352,4,110,1526,90,12008,20
16226,3,619,1433,425,14929,194
13646,4788,130143,1470,70572,694491,59571
13142,623,28203,1477,15613,175294,12590
62598,79,729,416,670,16630,59
17544,2,68,1411,46,3574,22
38265,6,129,996,113,4926,16
13558,246,8716,1471,4796,65288,3920
1892,222,9986,1588,5999,52229,3987
23374,35,1134,1311,861,25271,273
31625,8,187,1144,125,10238,62
6321,226,7636,1539,4975,45615,2661
34743,287,5044,1085,4243,37625,801
49279,3885,55578,826,40987,242076,14591
6004,51,994,1543,694,12846,300
63324,55,467,397,409,8336,58
61115,9,219,463,201,5102,18
50844,659,10561,786,7804,44794,2757
37790,299,5431,1007,5221,50150,210
66759,11,170,299,139,2885,31
15391,132,3256,1447,2204,42168,1052
66562,18,256,305,199,4589,57
33093,129,2184,1120,1721,24934,463
53401,127,1911,709,1784,36077,127
34022,148,2026,1102,1687,22906,339
25453,37,1089,1268,760,11735,329
58094,39,811,568,570,16412,241
11711,123,4822,1495,3285,41396,1537
22917,20,890,1319,636,19815,254
55090,16,290,653,164,3015,126
11051,26,1078,1500,526,9019,552
69371,71,1900,212,1523,23569,377
3790,1054,34411,1570,14986,187797,19425
65646,47,414,331,380,11001,34
51263,1506,26299,775,23758,138760,2541
11602,8,450,1496,229,11299,221
27009,16,688,1233,439,16274,249
56877,5970,183554,602,126901,499640,56653
8520,1462,26773,1515,15983,69160,10790
52255,10,97,745,59,3920,38
29054,43,564,1192,417,6890,147
27191,29,739,1230,470,13615,269
33368,1001,17547,1115,13907,161130,3640
50507,61,1337,794,860,12783,477
64089,5,49,375,41,1484,8
611,1060,46447,1597,29322,260170,17125
3461,2,55,1574,44,6582,11
8496,30,1037,1515,646,38346,391
18690,4,152,1390,61,8188,91
62991,114,1122,406,1119,7172,3
63679,3,65,388,40,4744,25
12740,194,3331,1483,2061,38900,1270
12007,28,1466,1492,794,27297,672
36808,46,1280,1036,750,22010,530
3487,75,4718,1574,3383,53115,1335
5829,0,73,1545,68,7327,5
62350,191,1818,423,1549,24692,269
60411,142,2038,487,1526,25724,512
26012,5,642,1255,381,13948,261
21933,1788,27796,1334,18844,140617,8952
28112,15,372,1210,231,14934,141
26273,26,1123,1250,748,16991,375
12671,0,0,1484,0,9690,0
24127,0,20,1297,11,2569,9
9938,8,546,1508,290,14844,256
27470,137,2629,1223,1730,15483,899
18809,20,865,1388,646,9768,219
58325,52,311,560,267,6025,44
21309,17,841,1344,539,14259,302
20050,140,5957,1366,2916,35467,3041
17539,1188,46190,1411,26038,241025,20152
54545,207,2263,671,1295,33527,968
58626,567,8588,550,7731,112879,857
908,150,5084,1595,2415,63048,2669
28145,10,255,1209,159,7888,96
31901,7,193,1140,141,10199,52
3679,57,1067,1572,673,21113,394
10921,40,1329,1501,749,18336,580
58689,681,8179,548,5741,72476,2438
36764,345,3499,1037,3132,34706,367
1416,253,7785,1591,5643,75941,2142
3356,7,148,1575,114,7204,34
40095,612,7853,966,6518,54059,1335
59933,49,934,506,723,8733,211
10601,25,865,1504,475,9238,390
54721,130,2453,665,1708,26216,745
18825,12,152,1388,118,4640,34
57037,14,362,598,315,5288,47
19501,621,19794,1376,7372,217919,12422
57286,101,2109,592,1418,27558,691
68038,68,1169,257,1053,13184,116
24344,9,424,1292,299,9510,125
53739,59,784,700,654,14492,130
24936,367,6388,1278,4487,167951,1901
37337,12,420,1020,283,13471,137
59488,28,184,522,138,5262,46
3214,349,28968,1576,9002,94859,19966
60497,325,6164,486,3239,33645,2925
17079,183,3864,1419,2617,35833,1247
30896,1,47,1156,31,3469,16
5666,871,11624,1547,8158,47363,3466
22830,36,1703,1320,1127,31215,576
39919,26,344,969,303,11238,41
30839,11,219,1156,167,4826,52
14408,86,2080,1459,1612,25126,468
39677,9,198,972,170,7463,28
4083,33,1162,1567,720,14325,442
16234,7,226,1433,191,15275,35
27190,197,3863,1230,2606,48648,1257
37908,7,90,1005,77,7900,13
6191,14,365,1541,239,9731,126
45474,30,348,891,316,6888,32
33044,10,746,1121,489,13623,257
58603,177,1788,551,1638,12240,150
1121,85,3850,1593,2199,39672,1651
22133,82,1505,1332,965,17911,540
62441,23,658,420,455,17324,203
59637,41,501,517,398,15316,103
20785,49,1132,1354,739,24520,393
46899,18,290,874,159,4204,131
3603,5,262,1573,184,23034,78
66337,20,221,312,160,2390,61
10913,0,15,1501,10,8354,5
57024,5,49,599,40,3347,9
3021,106,16690,1578,8768,82568,7922
58326,10,180,560,170,5795,10
8562,3589,101604,1515,58792,255686,42812
55216,3,99,650,94,2801,5
48955,51,1054,836,510,17401,544
27027,4,72,1233,48,4825,24
50211,340,3616,802,2811,36866,805
34623,834,13381,1089,7155,58764,6226
64297,31,405,368,394,7805,11
34457,57,1394,1093,926,26194,468
15278,10,303,1448,245,18668,58
14934,400,29759,1453,9941,131153,19818
2487,12,552,1583,381,14660,171
54297,36,195,681,164,4875,31
60700,5,177,478,78,10758,99
62918,191,1632,407,1473,16656,159
58877,11,114,542,102,6263,12
27858,48,1063,1215,625,6561,438
7400,528,41274,1525,23917,193995,17357
15126,15,763,1450,419,18075,344
8779,312,16166,1514,8301,82576,7865
62843,82,760,409,612,8036,148
17451,8,208,1413,174,9989,34
50929,42,503,784,378,12105,125
23709,17,511,1305,308,7364,203
67255,10,276,282,231,2910,45
27738,37,531,1217,364,13963,167
6188,41,939,1541,639,14011,300
17355,91,2247,1414,1795,64526,452
58367,115,769,559,663,11897,106
10454,48,2814,1505,1550,20490,1264
50305,24989,501387,800,313313,1999734,188074
3655,88,3982,1572,2233,55252,1749
55921,596,6262,630,3256,161462,3006
10043,6,268,1507,122,17669,146
13869,0,0,1467,0,11345,0
27669,277,4094,1218,2413,21950,1681
61162,15,115,461,98,5259,17
29921,12,375,1175,251,10326,124
8237,5,413,1516,284,21421,129
45721,139,1451,888,1284,19405,167
30897,15,550,1156,394,10279,156
35890,137,3025,1059,2325,76165,700
650,393,6752,1597,5020,46051,1732
11041,10,359,1500,235,7713,124
36932,13,290,1032,248,4506,42
33307,372,6141,1116,4776,19474,1365
8638,87,3026,1514,1814,21099,1212
65091,47,734,344,629,6758,105
51199,1096,17395,776,15807,72048,1588
36456,19,324,1043,265,10076,59
68114,36,652,255,619,21862,33
24149,318,5990,1296,4075,55388,1915
33032,2,61,1121,47,7331,14
62475,33,469,419,326,6950,143
45687,52,826,889,689,15120,137
4210,595,21569,1566,12082,162550,9487
19079,45,1663,1383,1048,17104,615
765,92,6554,1596,4174,91602,2380
310,204,5180,1600,3013,43667,2167
65180,39,275,342,222,8249,53
52880,14,299,723,218,9710,81
23199,77,1224,1314,995,25634,229
16902,39,504,1422,411,23743,93
12800,193,5253,1482,3143,33707,2110
58543,240,3296,553,3187,24839,109
21009,260,8986,1349,4437,103315,4549
49944,34,569,809,340,10131,229
12018,3,237,1492,69,15061,168
54302,5618,69282,680,44541,225760,24741
35850,16,280,1059,220,7074,60
44118,6,105,906,98,5206,7
6729,804,29552,1534,19457,183761,10095
1596,61,2094,1590,944,50084,1150
48971,66,576,836,462,21796,114
19343,4,83,1379,69,4314,14
20756,773,29245,1354,22122,162810,7123
50904,27,200,785,169,7039,31
7423,3,132,1525,89,32910,43
37622,644,11771,1012,10445,83502,1326
65451,4,42,336,30,2739,12
8778,12,445,1514,272,5200,173
63485,79,902,393,884,10721,18
36378,13,343,1045,292,7400,51
53151,20,356,715,301,8323,55
59023,25,199,538,183,5356,16
13527,0,0,1472,0,6473,0
37063,397,4320,1028,3710,46763,610
9548,1995,58717,1510,43855,274526,14862
25547,14,133,1266,118,17649,15
64592,20,249,360,213,5669,36
16637,553,7286,1427,5225,76026,2061
17185,116,3407,1417,2527,18020,880
28706,26,794,1198,405,7718,389
37240,45,1250,984,990,25102,260
4475,26,653,1562,526,11116,127
9914,18,562,1508,301,8842,261
29001,92,2586,1193,1849,20931,737
33138,12,370,1119,263,7589,107
55732,68,812,635,782,40619,30
51216,5,47,776,36,4996,11
10716,4,165,1503,101,22524,64
65907,102,1171,324,829,7762,342
228,210,6707,1601,4637,79357,2070
1094,459,20784,1594,11495,123028,9289
53623,0,0,703,0,7360,0
33227,1384,40497,1117,24994,178948,15503
51670,4,80,763,62,5627,18
5460,111,7080,1549,3655,67633,3425
38003,25,811,1002,515,14767,296
38805,297,7368,982,4380,87153,2988
43725,201,4233,910,3068,54353,1165
7644,18,859,1522,476,28036,383
45100,2,107,895,51,2759,56
62471,26,396,419,293,13575,103
69249,17,223,216,200,6033,23
41710,21,471,940,384,18002,87
13583,31,1215,1471,685,16731,530
36211,2,130,1050,104,4505,26
18543,189,11022,1393,6715,50830,4307
22541,21,627,1326,450,7763,177
66041,57,916,321,780,22021,136
23754,51,854,1304,623,30803,231
16257,45,423,1433,318,15491,105
49989,158,3647,808,2091,38632,1556
6568,119,3083,1536,1776,53408,1307
24289,42,1204,1293,743,6622,461
36209,19,391,1050,259,17229,132
32555,25,1065,1129,331,8644,734
20987,2,125,1350,94,11210,31
46823,340,4438,875,3261,72014,1177
50735,113,1467,789,1197,11970,270
25001,628,24546,1277,15436,198229,9110
52343,13,314,742,282,11719,32
54345,9,87,679,72,6592,15
728,5,433,1597,243,25201,190
19830,49,773,1370,513,10404,260
18462,4369,150130,1394,75878,531881,74252
63090,464,9558,403,7049,64558,2509
63559,1178,17119,392,15586,147047,1533
27144,177,4893,1230,2016,68384,2877
54778,147,880,663,681,7612,199
36038,15,315,1055,266,6164,49
61140,6753,117949,462,86630,688504,31319
40906,32,522,953,377,13059,145
15104,26,411,1451,286,6482,125
62184,55,899,427,828,16849,71
60958,18,394,468,371,10364,23
60152,7,69,499,61,4918,8
26526,555,14723,1245,10399,114562,4324
27944,35,1280,1213,770,14472,510
34852,12,224,1083,151,8091,73
69442,5,47,210,40,3618,7
52710,47,533,729,460,26256,73
55876,54,750,632,623,5954,127
20636,118,2260,1356,1698,21630,562
19192,68,2509,1381,1842,116240,667
13824,40,1317,1468,744,32307,573
62955,319,3211,407,2688,30661,523
26092,77,2044,1254,1282,10735,762
30036,18,353,1172,285,12993,68
19372,1411,30125,1378,20846,331582,9279
24244,110,1686,1294,1196,30795,490
68890,6,79,228,72,6491,7
25985,9,451,1256,285,11788,166
60384,124,1552,491,1112,23426,440
19317,33,1080,1379,751,12596,329
55516,2,17,641,16,6096,1
8402,19,1097,1515,687,9466,410
9035,291,6444,1513,4352,34604,2092
41550,357,9270,943,7664,95038,1606
28046,53,1236,1211,719,6534,517
16410,438,11632,1430,8019,132327,3613
40065,77,1204,966,842,16741,362
41748,9,184,939,130,7138,54
21545,31,554,1340,448,6074,106
31078,34,925,1152,570,18359,355
7699,25,1829,1521,952,19316,877
68361,12,110,247,92,4159,18
24804,108,1552,1281,1014,15208,538
40138,5,70,965,57,9340,13
15351,17,541,1447,441,26438,100
22286,427,11962,1330,6924,99623,5038
8446,11,977,1515,447,21022,530
22864,42,1145,1320,901,20123,244
37895,112,2006,1006,1121,17810,885
34053,4,263,1101,163,5928,100
58389,722,18931,558,13181,125856,5750
1735,10,374,1589,309,18402,65
55903,10,289,631,213,5513,76
64094,454,4766,374,4245,54315,521
24469,431,11715,1289,8317,102406,3398
63010,30,205,406,193,8544,12
8265,18,481,1516,326,9119,155
63392,126,1201,396,1014,16068,187
28605,9,184,1201,117,4603,67
42496,36,525,928,381,11013,144
6457,18,1414,1537,876,14144,538
56515,446,4520,613,3645,46088,875
29074,3,125,1191,84,6788,41
9339,32,1531,1511,1086,39567,445
50782,170,1824,788,1603,14822,221
2621,83,2511,1582,1562,58109,949
41255,207,3177,948,2714,35816,463
42528,1,33,928,26,2571,7
29585,6,288,1182,171,9939,117
24375,19,587,1291,432,12426,155
35023,52,1112,1079,665,12515,447
51271,8,204,775,185,7029,19
15285,5,290,1448,213,12378,77
28775,3,121,1197,110,5611,11
53629,76,1058,703,889,16025,169
12028,112,10349,1491,4954,25916,5395
762,399,27844,1596,16239,243744,11605
53257,0,4,713,3,1711,1
34640,35,510,1089,373,6198,137
9992,38,1126,1507,680,20237,446
66830,6,68,296,59,3846,9
67726,8,172,267,128,9007,44
48557,1206,17416,849,13675,153914,3741
8659,8,363,1514,231,8363,132
13690,94,3276,1470,1655,61030,1621
2395,141,3428,1584,2504,22282,924
22649,14,489,1324,282,7227,207
12933,20048,689172,1480,284738,2399855,404434
35123,413,8375,1077,6531,51343,1844
29614,27,837,1182,584,13830,253
54359,5,60,679,44,2008,16
21742,39,1471,1337,845,14180,626
20500,12,256,1359,137,10832,119
31830,398,12457,1141,7966,112781,4491
51305,4,128,774,126,7991,2
49479,34,562,821,481,20646,81
22283,265,6450,1330,4282,42122,2168
1806,71,3253,1588,1812,22679,1441
65988,10,178,323,104,4961,74
17510,31,1561,1412,1116,22997,445
25902,92,2873,1258,1666,22650,1207
57336,40,473,591,395,5518,78
13390,42,2187,1474,1065,24304,1122
22634,8,394,1324,286,19000,108
36249,1940,44975,1049,24680,198003,20295
66511,74,984,307,617,9561,367
53954,24,196,693,182,4400,14
12955,298,12947,1480,7766,91458,5181
60940,20,258,469,221,5539,37
60155,712,17799,499,8961,98576,8838
67314,12,136,280,117,3030,19
49234,30,419,828,209,8915,210
21251,14,628,1345,457,4952,171
22688,132,1687,1323,1071,17726,616
51341,38,486,772,338,11633,148
20713,11,416,1355,292,7496,124
11006,25,1489,1500,711,16495,778
34622,19,448,1089,338,10133,110
4854,85,3340,1557,1970,64292,1370
61452,312,12285,452,7801,64254,4484
846,86,2718,1596,2045,51208,673
7540,140,4153,1523,2211,29319,1942
53917,972,9397,694,6179,50453,3218
4017,21,278,1568,206,9503,72
34946,16,420,1081,263,8451,157
19649,0,43,1373,35,6195,8
57143,493,6818,596,6646,51459,172
54139,34,306,686,214,7800,92
7260,63,2180,1526,1551,18254,629
11823,20,668,1494,379,9669,289
12830,8,507,1482,257,34914,250
31744,82,2270,1142,1275,31697,995
63783,27,207,385,192,5254,15
14162,690,36916,1463,20469,150439,16447
4647,43,1312,1560,869,32995,443
8519,3,148,1515,90,13239,58
51184,279,2916,777,2427,29644,489
11596,4,416,1496,211,6458,205
15239,0,0,1449,0,21116,0
17702,150,6451,1408,4440,60889,2011
17377,3,102,1414,67,2163,35
10644,7,269,1503,192,9320,77
60172,34,444,498,440,13172,4
19430,10,731,1377,483,17275,248
57466,85,1359,588,1254,11925,105
42628,38,1108,925,685,14607,423
62191,34,407,427,321,9766,86
64243,45,566,370,536,6158,30
20139,281,6944,1364,5345,69617,1599
48993,79,1695,835,1233,17665,462
4638,25,810,1560,612,15178,198
24028,18,438,1299,306,8639,132
3821,107,5108,1570,3103,42705,2005
56557,503,10493,611,9571,164157,922
24055,72,3211,1298,1799,22222,1412
2256,30,1173,1585,843,19639,330
36111,503,9800,1053,8827,130583,973
7444,8,905,1524,312,48676,593
23045,40,643,1317,512,22970,131
32438,29,869,1132,566,32274,303
35837,1776,30611,1059,25751,176386,4860
38243,91,1457,996,1314,30927,143
33535,6,178,1112,128,4193,50
9316,176,4043,1511,2922,21080,1121
19047,9,199,1384,157,9039,42
25160,19,532,1274,293,12215,239
8677,103,3474,1514,1045,22816,2429
51237,8,164,775,157,10744,7
8418,20,258,1515,174,7095,84
28413,72,2163,1204,1498,33240,665
25821,2,63,1260,56,12559,7
6164,218,11381,1541,5551,71270,5830
13839,41,1294,1468,659,11662,635
5099,45,1377,1554,977,94330,400
31069,13,564,1152,437,15004,127
31724,8752,180983,1143,104970,731073,76013
53263,83,1092,712,966,24408,126
2401,74,3833,1584,2547,55921,1286
12383,780,22826,1488,12337,129099,10489
29938,14,509,1175,293,11732,216
9643,17,691,1510,487,25558,204
15617,55,1384,1443,994,13424,390
24092,214,5358,1297,4181,44772,1177
12656,246,8257,1484,4799,37964,3458
23258,7,179,1313,145,16410,34
65141,518,6718,342,5256,53849,1462
1369,31,1402,1592,812,13112,590
28444,52,1598,1204,963,9349,635
54267,29,427,682,407,6099,20
11650,581,52552,1495,19026,204143,33526
34362,25,916,1095,587,17854,329
42004,21,313,935,274,10403,39
55568,2755,38413,640,28814,223688,9599
48353,203,3108,855,2469,49580,639
31025,0,48,1153,36,3896,12
18082,40,1051,1401,740,33104,311
51844,269,3003,758,2509,22073,494
54070,6050,64752,688,51281,261745,13471
60603,1674,26137,482,20092,149709,6045
22023,3725,155975,1333,75700,969917,80275
8667,16,717,1514,375,13701,342
60383,0,53,491,43,6426,10
15747,1,74,1441,45,6204,29
40834,37,543,955,494,14644,49
10306,2,109,1506,76,13707,33
6700,34,1541,1534,1001,27374,540
23103,8,290,1316,206,8247,84
38698,38,584,984,491,15225,93
37831,618,14401,1007,11564,51608,2837
13063,29,622,1478,394,15897,228
30394,95,2110,1165,1298,39028,812
12410,186,3659,1487,2120,27544,1539
614,4,430,1597,324,44442,106
69414,8,163,211,108,5848,55
32826,12,684,1125,401,9014,283
48553,10,124,848,105,3511,19
41791,42,1243,939,946,11486,297
8314,39,1763,1516,1196,30044,567
53744,9,174,700,136,6280,38
30223,9,496,1169,308,5568,188
57196,68,1089,594,707,16875,382
34081,1235,25005,1101,18336,110165,6669
63403,870,11466,395,11119,91519,347
26087,637,12200,1254,8114,36303,4086
56799,39,488,605,478,7655,10
16369,2,40,1431,26,3277,14
5605,27,932,1548,794,20944,138
19455,9,235,1377,142,8276,93
27626,39,1217,1219,706,7856,511
11163,78615,1811662,1499,742219,7143689,1069443
4248,7,339,1565,257,20997,82
561,40,1236,1598,900,17914,336
19811,105,2879,1370,2025,41991,854
3035,8,109,1578,86,6271,23
63268,227,2850,399,2687,36068,163
60464,14,125,488,111,4272,14
4492,339,6262,1562,3706,62071,2556
48561,54,470,849,388,6863,82
5889,5,242,1545,182,19248,60
53055,24,199,718,170,3538,29
7822,58,1545,1519,1013,37396,532
17267,11,380,1416,177,6156,203
32398,30,269,1133,222,5544,47
66507,13,201,307,166,5191,35
26603,12,262,1242,186,13237,76
59549,31,459,520,371,8485,88
10818,9,542,1502,367,27896,175
18668,21,524,1391,398,19993,126
5758,367,21451,1546,14276,98408,7175
6882,309,5430,1532,3715,31184,1715
52684,15,131,729,110,9303,21
46273,57,699,882,688,11573,11
27517,2,118,1222,67,3473,51
4539,281,7962,1561,6338,156705,1624
49326,23,279,789,190,19881,89
20700,4365,78419,1355,63467,407770,14952
26610,25,683,1242,423,17921,260
42770,1,33,923,24,4928,9
36870,58,1768,1034,1129,53097,639
8554,16,992,1515,643,18622,349
57314,14,298,591,231,8409,67
30605,106,1038,1161,785,13693,253
2369,22,856,1584,515,24011,341
57638,42,434,583,353,17894,81
54326,586,19788,570,9427,147349,10361
53109,85,905,716,793,11276,112
30776,8,365,1158,204,8833,161
29158,45,1974,1189,1135,11562,839
49169,142,1834,830,1484,24786,350
5039,10,208,1554,138,10548,70
53188,20,214,714,179,10508,35
27649,12,988,1219,504,30942,484
30529,15,427,1162,293,11578,134
33773,19,1292,1107,831,23456,461
32695,18228,530006,1128,220346,1093175,309660
49958,83,1211,808,876,25445,335
22885,1092,29119,1320,21318,185970,7801
27066,117,3389,1232,1931,18532,1458
12935,178,6861,1480,3502,30932,3359
18941,3783,141932,1386,80381,941596,61551
4558,45,1119,1561,709,15343,410
36439,190,3181,1043,2628,35503,553
63976,9,104,378,83,3338,21
20083,4,164,1365,113,6759,51
28107,21,210,1210,137,5323,73
21231,49,1659,1345,1238,29895,421
47149,53,875,871,735,18932,140
21831,126,3187,1336,1929,55918,1258
61381,78,843,454,593,7095,250
20166,0,0,1364,0,8675,0
67300,3,138,280,68,4856,70
60945,8,92,469,92,6062,0
691,94,1338,1597,920,10711,418
9412,9,348,1511,203,8032,145
16420,7,223,1430,155,9023,68
48935,10,284,837,229,5161,55
6281,21,716,1540,417,16801,299
61178,4185,113495,460,80102,518483,33393
37839,47,631,1007,445,13958,186
349,14,578,1600,353,16163,225
40745,502,8280,956,6780,43934,1500
23281,14,600,1313,448,19220,152
8723,1362,58807,1514,36637,315659,22170
30828,7,304,1157,184,4080,120
16018,370,8072,1436,5039,27162,3033
27907,9,411,1213,348,23288,63
56048,84,899,626,672,14396,227
3319,34,1826,1575,1265,16186,561
9931,466,16818,1508,10704,146496,6114
50577,9,386,792,208,4192,178
50135,35,381,804,294,8181,87
12473,107,3310,1486,1867,37231,1443
16909,82,1342,1422,978,18299,364
51410,69,1113,771,734,19509,379
61255,6967,158238,457,106357,520104,51881
6239,2192,68232,1540,36874,395230,31358
48584,18,255,848,143,10747,112
23123,4,179,1316,140,5775,39
12960,0,0,1480,0,13362,0
17271,9,275,1416,181,5494,94
26548,41,1122,1244,785,25234,337
4334,121,4139,1564,2259,23302,1880
41513,2,56,944,41,5733,15
62389,7,163,422,108,5934,55
52685,25,311,729,237,3570,74
50993,243,2797,782,2553,15676,244
24278,7,280,1294,247,14305,33
7796,309,19138,1519,7311,160617,11827
50530,216,2176,794,1837,31947,339
56887,1,7,602,7,1583,0
48911,59,646,838,570,21773,76
22718,25,2177,1322,1374,26564,803
40941,27,403,952,244,26463,159
13590,49,1712,1471,1027,15181,685
59727,5,28,514,28,3001,0
6790,23,774,1533,600,40273,174
18834,4,135,1388,99,8883,36
17718,4,625,1408,288,10602,337
36757,20,332,1037,306,11684,26
1307,77,3194,1592,2047,113747,1147
9761,15,476,1509,302,7025,174
5450,53,1912,1549,1328,20176,584
19100,54,2530,1383,1598,16659,932
19158,153,2618,1382,1908,40902,710
26831,31,1484,1237,858,12872,626
60133,34,262,500,240,7102,22
62617,36,382,415,327,6172,55
6821,6,222,1533,136,16814,86
831,4,152,1596,112,9811,40
61203,16,206,460,189,5698,17
51427,16,434,770,326,10586,108
18478,28,419,1394,295,8504,124
2801,1512,29568,1580,21771,148337,7797
23031,40,857,1317,568,8175,289
53940,79,1342,693,863,11141,479
14298,0,0,1461,0,23379,0
67526,17,71,274,65,1803,6
34441,10,211,1093,139,4882,72
9844,197,6344,1509,3129,39422,3215
14076,140,3532,1464,2428,58372,1104
26724,55,2546,1239,1398,90625,1148
18229,6,315,1398,223,9828,92
37017,263,6984,1029,4970,63746,2014
9984,150,5010,1508,3469,47102,1541
27875,75,1203,1214,864,15035,339
21228,4190,111180,1345,71637,746462,39543
12001,13,489,1492,241,6445,248
64422,4,48,365,38,3018,10
47272,69,660,869,477,10872,183
16202,23,435,1433,304,8724,131
60704,21,175,478,150,10858,25
56350,12,243,618,185,8366,58
49128,335,3264,831,2327,25977,937
65184,1,62,342,52,4510,10
9937,253,5041,1508,2518,28630,2523
18269,35,2043,1398,1016,12284,1027
26202,20,447,1252,284,9666,163
6380,64,6946,1538,2169,25305,4777
15748,7,525,1441,380,33718,145
18155,640,17532,1400,10486,121171,7046
15385,6,186,1447,122,3100,64
25229,34,606,1273,343,6663,263
4663,166,3732,1559,2506,32273,1226
22052,7,135,1333,98,4470,37
34891,24,537,1082,406,5860,131
28544,129,3397,1202,2957,41996,440
29073,3,104,1191,61,4223,43
16078,99,2702,1435,1617,18953,1085
37763,5,162,1008,131,8595,31
12641,204,6518,1484,3716,49915,2802
23735,156,3136,1305,2427,35856,709
43061,156,2297,918,1301,30282,996
41634,7690,132191,939,87253,739715,44938
35483,10,193,1068,141,4070,52
23198,13,288,1314,170,4920,118
58231,19,200,563,182,8659,18
28830,28,713,1196,451,13553,262
3630,13,436,1572,318,20091,118
34847,39,342,1084,283,10324,59
32740,17,564,1127,334,8513,230
34961,249,4352,1081,3327,24151,1025
7271,800,16626,1526,10826,77468,5800
49747,475,5328,814,3868,54766,1460
36786,131,1569,1036,1284,33990,285
56958,10,150,600,110,4118,40
28744,12,163,1198,111,3223,52
527,5,171,1598,127,9587,44
15964,60,1347,1437,855,22249,492
52634,125,1787,731,1770,22943,17
52953,0,0,721,0,2772,0
48504,66,775,850,587,6947,188
3810,31,1147,1570,857,15435,290
31512,158,3167,1146,2013,45938,1154
28914,25,540,1194,318,5059,222
7700,517,10367,1521,7182,90947,3185
43305,32,517,915,411,7915,106
14194,1039,44106,1462,17864,170413,26242
28915,45,1110,1194,672,10789,438
166,303,12308,1602,6841,137982,5467
48457,99,1060,853,868,13562,192
31807,726,10149,1141,4812,44592,5337
11225,1,115,1499,68,5112,47
69106,39,534,221,432,10039,102
24689,115,2047,1284,1424,30867,623
57546,66,792,586,510,10115,282
55806,98,2121,633,1708,30778,413
8504,49,1720,1515,1054,27578,666
24831,44,902,1281,645,12039,257
35154,6475,144065,1076,80980,536615,63085
22452,82,3856,1327,2071,50641,1785
15910,1508,62554,1438,31029,361400,31525
19441,38,1388,1377,957,9739,431
65816,1085,28775,327,24221,187450,4554
61811,79,2493,433,734,28857,1759
28329,165,2958,1205,2396,28314,562
18275,34,1128,1398,716,10580,412
64631,10,103,359,96,8397,7
57964,26,287,572,238,9114,49
59180,1,57,533,43,3706,14
31472,188,2429,1147,1767,16172,662
13745,341,11441,1469,6128,28161,5313
38319,1224,14763,994,9532,129634,5231
60812,5,103,474,98,4736,5
31302,5,33,1149,25,8462,8
18399,14,198,1395,132,2870,66
20026,13,432,1367,306,6370,126
56749,38,428,606,324,7153,104
61997,93,748,434,624,7150,124
22164,21,1729,1331,1306,21839,423
43529,1769,29207,912,23519,244639,5688
2960,94,1988,1579,1481,17364,507
49141,4,126,831,95,4641,31
32758,21,436,1126,285,9120,151
58137,2449,68235,567,51117,379880,17118
26967,13,239,1234,185,14887,54
17423,592,5065,1414,4148,64765,917
46226,58,986,882,899,21315,87
17657,16,942,1409,602,9493,340
46052,11,176,884,157,7367,19
8952,0,0,1513,0,9563,0
53867,10001,156098,694,101569,1139287,54529
10579,4000,183468,1504,88617,608046,94851
24824,143,4059,1281,2291,26337,1768
55705,480,7167,636,3806,125453,3361
17272,633,17147,1416,12361,164813,4786
57242,162,3048,593,2347,34007,701
52097,102,2024,750,802,10511,1222
24719,19,605,1283,354,6991,251
19024,48,728,1384,526,17568,202
52486,24,393,737,274,14252,119
28791,14,281,1197,175,8116,106
5004,12,816,1555,435,38363,381
3600,88,2640,1573,1309,16154,1331
1016,76,2251,1594,1455,44204,796
13012,25,1125,1479,518,7892,607
31821,212,5555,1141,4334,33326,1221
3972,34,1299,1568,938,34362,361
31129,23,278,1152,171,6678,107
19276,43,1384,1380,921,8649,463
9096,26,960,1512,585,11989,375
9551,99,1887,1510,991,17115,896
20279,53,2087,1362,1146,16588,941
16010,76,2935,1436,2163,50991,772
55689,57,519,636,480,20202,39
30079,42,737,1172,499,11777,238
5705,1533,35674,1547,21104,107504,14570
61445,5,48,452,33,2835,15
33948,269,2734,1104,1759,38902,975
1299,635,9878,1592,7290,53727,2588
50805,135,1530,787,1348,28042,182
68019,26,264,258,240,6381,24
62691,122,1782,413,1681,20465,101
27832,92,1621,1215,1182,29628,439
52197,171,1462,747,1121,23879,341
35094,10283,216258,1078,126948,1436583,89310
30293,23,787,1167,392,13600,395
32868,42,1071,1124,590,18428,481
38274,13,204,995,166,3448,38
15175,92,3025,1449,1873,40869,1152
61186,19,276,460,141,12544,135
19383,103,4857,1378,2920,49841,1937
64001,218,4324,378,3925,26703,399
20243,19,654,1363,380,17278,274
67153,137,2116,285,1867,37734,249
6334,7,384,1539,253,15137,131
57827,8,81,577,80,2404,1
25691,439,8151,1262,4399,86864,3752
50349,1368,23772,799,14939,102950,8833
53717,127,1302,700,1024,18585,278
55453,2,31,643,29,2545,2
9633,22,1271,1510,897,20973,374
18001,7,620,1402,522,42031,98
58139,238,3848,567,3361,30626,487
31206,282,6828,1150,5043,81301,1785
21428,37,1556,1342,921,17858,635
51018,98,855,782,783,9831,72
8866,740,15466,1513,9252,49084,6214
14829,271,10229,1454,5973,131165,4256
33271,21,128,1116,94,2916,34
66322,15,179,313,147,11255,32
36305,360,8638,1047,7611,46669,1027
28504,162,4397,1202,3275,53603,1122
11799,196,12393,1494,5485,68186,6908
63722,5,306,387,173,4211,133
17885,7,111,1404,76,12694,35
30805,31,809,1157,398,9034,411
51097,669,7681,779,6496,69120,1185
30642,4993,141380,1161,82973,930003,58407
322,153,11749,1600,6961,94668,4788
34579,0,52,1091,31,2006,21
21211,721,19310,1345,10557,112747,8753
38129,984,15041,998,8071,56065,6970
37003,185,2916,1030,2329,58520,587
27884,17,874,1214,499,29885,375
11961,0,0,1492,0,4419,0
17643,8,482,1409,372,16411,110
4153,75,2566,1566,1764,14407,802
11658,38,886,1495,453,6053,433
33908,529,8296,1105,6491,65337,1805
29981,21,698,1174,367,4589,331
64806,3,19,353,16,2878,3
43485,28,310,913,276,7838,34
14182,38,747,1463,509,24172,238
33829,126,3276,1106,1811,20885,1465
21792,247,5047,1336,3608,34828,1439
65396,8,133,337,88,5580,45
62966,13,72,406,61,9103,11
27369,1048,30534,1226,20849,204594,9685
31609,18,565,1145,360,11053,205
4250,218,5259,1565,3828,58277,1431
2803,1350,47814,1580,24239,119195,23575
15453,13,216,1446,164,5427,52
27547,53,1071,1221,847,32199,224
17795,3,185,1406,136,9248,49
11184,69,3028,1499,1594,26780,1434
58783,9,131,545,106,9099,25
26456,154,2578,1246,1834,37175,744
53555,4,38,706,26,2583,12
34795,2309,28728,1084,23145,113302,5583
36787,41,907,1036,733,16293,174
23793,5103,113389,1304,61451,300279,51938
16830,3,173,1424,124,11082,49
42580,306,7067,927,4795,67758,2272
63374,22,213,396,203,11345,10
8606,16,938,1514,475,14932,463
56027,250,6604,627,4193,42086,2411
52425,139,1431,740,1169,18326,262
68926,19,297,227,286,8052,11
2874,76,3071,1579,2114,56613,957
56345,9,224,618,161,7574,63
54858,91,1007,659,832,16681,175
339,206,8396,1600,4832,66193,3564
21531,92,5443,1340,3215,53283,2228
60299,32,772,493,455,13900,317
22300,2935,113340,1330,49280,418777,64060
34626,45,508,1087,375,7276,133
10903,341,9759,1501,7682,81176,2077
48164,21,226,858,169,11421,57
20180,32,608,1364,383,6858,225
23948,343,4691,1301,3847,18463,844
15161,32,1187,1450,826,24343,361
1641,2,123,1590,83,6900,40
30499,163,5531,1163,3974,85813,1557
23956,244,5663,1301,3685,30979,1978
33316,66,1420,1116,1072,31699,348
7775,5,163,1520,81,20924,82
65563,2,38,334,33,2544,5
4793,1311,45337,1558,14501,272892,30836
30244,95,2898,1168,1606,26781,1292
66791,8,152,298,144,5275,8
53118,175,3566,716,1601,27463,1965
23367,23,989,1312,607,10699,382
38413,139,2565,992,2244,25057,321
30814,112,2018,1157,1298,15679,720
3794,6406,181151,1570,109913,424944,71238
35895,358,7672,1058,3962,42916,3710
53798,4134,65793,698,55094,284215,10699
9787,66,3282,1509,1863,22039,1419
23341,1,158,1312,132,9085,26
38042,199,5985,999,2182,55933,3803
60824,2,99,474,85,6616,14
39211,220,4167,978,2543,59798,1624
17095,106,4075,1419,1700,50803,2375
43597,270,7508,911,4819,49492,2689
9479,25,769,1511,542,14915,227
14628,82,3608,1456,2631,56002,977
21319,13,5252,1344,773,32795,4479
57680,37,362,582,307,6817,55
54730,1420,9080,664,6839,45001,2241
26799,23,259,1238,214,11196,45
50994,1452,29278,782,17177,87387,12101
3240,24,537,1576,391,41371,146
49716,1311,26103,815,19020,126481,7083
50477,1064,8035,663,6008,109618,2027
62407,10,133,421,108,4105,25
30568,435,9419,1162,7297,84601,2122
34921,8,180,1082,100,2487,80
58963,182,1991,539,1958,17950,33
69210,42,142,217,135,7090,7
30766,8,214,1158,170,11798,44
46851,525,11246,874,6008,78087,5238
59373,149,4071,526,3800,18622,271
820,1273,50250,1596,29161,279850,21089
57419,52,1024,589,645,17282,379
9048,663,13318,1512,8616,153444,4702
37509,10,344,1015,274,4590,70
56941,30,505,600,435,10493,70
60507,13,189,486,148,2714,41
41528,20,298,944,226,14239,72
58637,246,2885,550,2765,28269,120
18814,1680,63851,1388,36378,189712,27473
19861,142,1964,1369,1601,21351,363
3167,500,14764,1577,8668,54094,6096
22566,36,1582,1325,1077,15692,505
7482,8,531,1524,207,16124,324
31040,40,546,1153,348,9337,198
44199,113,1809,904,1455,20538,354
64949,15,168,348,120,14306,48
9692,22,697,1509,515,25573,182
67258,842,15882,282,12787,125016,3095
26834,1222,30929,1237,18862,112000,12067
30396,260,5505,1165,4365,70208,1140
22043,859,17487,1333,10594,97664,6893
4665,33,719,1559,531,26776,188
11213,59,1092,1499,706,13150,386
7740,112,2596,1520,1585,22043,1011
19414,4,136,1377,91,4622,45
43946,22,347,908,309,12217,38
67247,736,9953,281,9018,64450,935
5415,19,514,1550,398,13349,116
426,91,2251,1599,1564,22644,687
9852,1172,15791,1509,12269,128287,3522
22805,37,2297,1321,1378,50137,919
1403,4,457,1592,338,10910,119
62889,33,405,408,376,10775,29
46499,11,419,879,348,19424,71
36122,86,1153,1053,1041,21878,112
55665,20,418,637,387,7416,31
31541,68,1714,1146,1199,20192,515
57177,12,107,595,97,4163,10
2953,200,6965,1579,5055,30721,1910
49445,27,414,822,341,10820,73
10826,132,2667,1502,1529,24931,1138
54079,9,80,688,79,3736,1
52213,2495,37620,747,34863,133961,2757
29783,26,396,1178,279,8922,117
13119,1,83,1478,55,7976,28
55251,28,252,649,212,4334,40
34406,62,941,1094,650,8018,291
17981,811,10918,1402,8439,95897,2479
19315,2598,45259,1379,29729,222765,15530
45724,1107,21509,888,16041,96955,5468
64472,14,243,363,219,11296,24
57083,1374,26411,597,17554,148664,8857
52167,928,13899,748,13178,62346,721
10313,222,3284,1506,2350,34668,934
10590,60,2309,1504,1347,21825,962
59303,82,947,528,907,24722,40
62452,2,21,420,20,3937,1
55592,71,1320,637,1159,35162,161
10175,29321,960653,1506,360316,2510365,600337
18793,8,109,1388,93,8883,16
66000,2,90,322,48,7823,42
47195,174,1822,870,1378,12835,444
3909,80,3183,1569,2296,22199,887
34121,192,3961,1100,3164,49351,797
55347,447,5266,646,4418,50848,848
52665,78,747,728,552,11656,195
65639,2,50,332,42,5608,8
21241,1,111,1345,97,6639,14
27488,43,1823,1223,1111,23774,712
51304,19,385,773,280,14006,105
15610,122,3771,1443,2749,34156,1022
21224,872,26467,1345,13098,151014,13369
29651,14,533,1181,395,14137,138
3947,227,4508,1569,2828,46910,1680
15631,87,1990,1443,1076,22556,914
23912,56,1305,1302,1094,70495,211
57374,41,553,590,521,18698,32
65740,172,3110,329,2928,33810,182
24431,189,1846,1290,1437,15769,409
1958,111,4647,1587,2800,21445,1847
22165,604,12243,1331,7174,76405,5069
8020,43,1472,1517,990,34475,482
40651,328,5455,953,4883,82415,572
48065,26,239,859,233,9085,6
67695,1,79,268,63,4340,16
34850,58,1067,1084,774,23183,293
13498,72,4281,1472,1994,27461,2287
39769,113,2191,971,1166,20653,1025
48827,262,3755,840,3318,45137,437
4288,79,2170,1565,1371,41480,799
22069,105,1814,1333,1099,12200,715
4460,14,1538,1563,618,36358,920
47196,82,1090,870,823,10039,267
11609,14790,292583,1496,153553,546309,139030
29316,971,21422,1187,12430,96449,8992
45252,138,3041,893,1937,25014,1104
52352,3230,45294,742,33280,244037,12014
60962,21,301,468,244,7071,57
2715,476,17924,1581,11299,170860,6625
68332,33,602,248,466,10995,136
32844,62,1428,1123,1004,10934,424
57784,59,1744,578,703,17715,1041
19305,411,8916,1379,6056,104715,2860
66082,2,49,320,41,2935,8
30408,2777,58840,1165,30024,192750,28816
10550,26,1193,1504,739,25511,454
10583,14,857,1504,573,10023,284
22053,30,808,1333,516,8525,292
56060,2,93,626,80,4571,13
63543,116,1155,392,879,8343,276
56835,201,1872,600,1740,20180,132
33278,123,3391,1114,1807,29371,1584
69990,2,19,193,19,883,0
62674,6,62,413,54,3121,8
50628,116,2506,792,2166,21857,340
38008,25,506,1002,397,3145,109
13908,13,679,1467,294,15436,385
70321,43,1171,181,874,20133,297
34348,51,962,1096,845,19898,117
55274,13,202,648,195,8195,7
44481,34,610,902,545,20566,65
21023,32,1676,1349,1144,25527,532
57899,33,516,574,386,19004,130
9047,78,3100,1512,1948,33801,1152
15989,10,467,1437,320,10454,147
27670,36,474,1218,354,14624,120
65748,21,277,329,271,8143,6
26661,188,3951,1240,2549,15295,1402
51996,11,218,754,190,7525,28
428,39,3363,1599,1643,23480,1720
50534,97,1261,793,1018,22865,243
25910,59,1858,1258,973,15034,885
12212,104,5691,1490,2399,30988,3292
60978,364,4517,468,3568,91090,949
28441,9,978,1204,495,6117,483
23472,6,92,1310,61,4017,31
8107,8,658,1516,285,13362,373
23976,51,919,1300,649,20249,270
59539,548,6135,520,5221,38001,914
57349,11,206,590,166,5209,40
63237,3,62,400,23,3012,39
48582,191,1364,847,1103,23265,261
8660,25,1230,1514,854,20644,376
60035,27,413,503,362,10642,51
4177,19,517,1566,392,12312,125
14753,51,2147,1455,1653,41313,494
58795,35,381,545,317,4440,64
35740,5,239,1063,70,3644,169
15838,4,211,1440,143,9642,68
53237,1694,18997,713,16745,116963,2252
7301,17,566,1526,320,16540,246
63136,370,4165,402,3293,54691,872
20444,23,1703,1359,1079,28377,624
95,11368,360573,1603,147096,983726,213477
16247,1,226,1433,128,7687,98
49845,7,119,812,101,5353,18
20380,17,813,1361,659,19752,154
68034,3,83,257,56,3066,27
49994,965,14044,808,13562,99375,482
6207,140,6470,1540,3485,83352,2985
54948,7,158,657,73,6348,85
12406,0,0,1487,0,27794,0
37497,34,875,1016,688,42774,187
31468,174,2691,1147,1805,23843,886
24972,80,4242,1277,1914,20770,2328
3599,3,123,1573,97,8564,26
26711,10,218,1240,146,5381,72
48526,1149,163616,849,16603,248279,147013
24699,202,5380,1283,4028,122572,1352
37918,36,411,1005,325,5606,86
14359,9,267,1460,208,10255,59
54836,95,706,660,553,12238,153
34651,24,288,1088,186,6468,102
34833,101,3167,1084,2217,95703,950
5738,21,504,1546,360,24198,144
9608,9,414,1510,175,8996,239
11086,34,580,1500,377,14230,203
36465,9,161,1042,125,8842,36
36897,140,1466,1033,1180,13904,286
24737,1396,30490,1283,21535,122635,8955
28721,11,654,1198,393,7863,261
10032,39,2216,1507,1293,21607,923
40017,29,871,967,720,11870,151
9985,72,2118,1508,1498,24977,620
14403,76,1326,1459,708,13723,618
7471,24,634,1524,483,23961,151
34952,12,397,1081,230,9979,167
40742,83,1450,956,1178,10177,272
48695,61,643,844,543,8413,100
22630,14,663,1324,413,12972,250
30904,311,5268,1155,4011,63631,1257
9410,23,1161,1511,670,15093,491
15483,20,624,1445,356,39495,268
29790,89,3087,1178,2014,40045,1073
36878,38,729,1034,605,11756,124
14800,403,11972,1454,8038,48801,3934
8178,116,3034,1516,2122,31253,912
63965,23,415,379,281,10493,134
29680,1,61,1181,46,12001,15
15574,1961,85128,1444,48581,177802,36547
8328,2556,69662,1516,42809,206204,26853
16275,10,520,1433,434,19745,86
61395,993,12774,454,12055,107589,719
2069,228,13781,1586,9503,105136,4278
33089,28,1217,1120,744,13902,473
22815,0,19,1321,19,3372,0
20350,40,1941,1361,1229,17583,712
19300,38,257,1379,184,15997,73
31682,34,870,1143,714,12177,156
4413,65,2727,1563,1838,57839,889
22499,53,1292,1327,1027,19253,265
11495,176,11311,1497,4787,74279,6524
11700,0,0,1495,0,17195,0
65837,4,43,326,25,5607,18
1380,66,1657,1592,1190,21957,467
5690,32,675,1547,405,12426,270
57773,47,675,578,552,13584,123
23298,16,534,1313,419,6181,115
12905,0,0,1481,0,24120,0
53217,33,360,713,243,12589,117
38216,137,1610,997,1202,22342,408
1683,7,112,1589,67,12960,45
21504,40,504,1340,355,10947,149
25439,1329,24266,1268,15316,168327,8950
3680,18,794,1572,559,23717,235
56096,45,575,625,476,6668,99
16502,1,97,1429,62,24988,35
40790,200,3438,947,2687,65755,751
8459,2,192,1515,92,8790,100
54490,27,425,673,296,7087,129
61718,23,319,444,255,8031,64
23285,57,3260,1313,1212,26906,2048
27913,40,1116,1213,647,9987,469
50041,99,2032,806,1404,52608,628
55169,54,919,651,617,15956,302
33328,57,2085,1115,1545,34754,540
57977,12,118,572,98,20446,20
44762,15,426,899,236,7520,190
11074,1262,61214,1500,32042,260531,29172
55444,49,468,643,384,11279,84
39067,9,237,979,207,5915,30
475,301,14697,1599,10115,132953,4582
10188,4,91,1506,62,8301,29
23216,1125,19109,1314,14568,94214,4541
30358,36,713,1166,471,4892,242
62753,67,932,410,775,12283,157
1422,23,982,1591,695,16478,287
64032,43,1562,377,875,18848,687
21953,8,152,1334,80,8375,72
62536,24,698,418,633,14725,65
22423,286,4165,1328,3203,19425,962
5187,12,403,1552,298,8398,105
23283,4,305,1313,250,11867,55
28030,424,6473,1211,4023,25645,2450
31230,215,3420,1150,2458,36237,962
61442,50,478,452,427,7071,51
62785,9,132,411,119,6392,13
17358,49,1493,1414,983,43141,510
18243,702,15733,1398,13026,58059,2707
60926,51,468,470,399,9215,69
30274,9,377,1168,251,11788,126
53581,2708,29518,705,23080,275479,6438
20179,10,430,1364,248,6883,182
52351,67,710,742,582,11204,128
37052,156,2046,1028,1334,30990,712
41030,8,184,951,119,21682,65
12152,6,255,1490,111,10751,144
22620,675,19035,1324,12073,116077,6962
29964,105,2402,1174,1637,17300,765
34796,47,762,1085,498,18024,264
22285,8,232,1330,158,8087,74
13297,66,2853,1475,1277,37776,1576
29628,14,499,1181,314,11090,185
13201,6,307,1477,150,9018,157
28001,1257,11998,1211,9711,92296,2287
12337,338,6840,1488,4374,42742,2466
53620,974,18451,703,9823,138166,8628
50580,25,320,792,259,9573,61
35329,747,13281,1071,8084,86105,5197
26639,21,442,1241,297,12917,145
32054,27,920,1138,540,7002,380
35807,32,631,1061,580,22496,51
11833,20,605,1493,335,27737,270
54124,244,3403,686,2179,35951,1224
11842,7,510,1493,279,14978,231
29932,16,365,1175,267,10532,98
56093,199,3421,625,2548,57023,873
60085,690,9670,502,6146,37704,3524
54516,118,1197,672,1064,25255,133
9228,844,45600,1512,21070,118000,24530
791,45,1940,1596,1061,31938,879
59635,15,119,517,108,4602,11
10350,17,444,1505,227,8403,217
9312,94,2901,1511,2017,28841,884
28708,16,1283,1198,707,11599,576
52156,3275,55206,749,42138,217569,13068
25404,10273,241241,1269,144900,746700,96341
8225,320,9296,1516,6078,73132,3218
22777,149,7368,1321,2530,74832,4838
45679,144,2568,889,1829,53207,739
5945,69,4191,1544,1794,70013,2397
56415,4,107,616,67,11569,40
3307,7,233,1575,180,15617,53
10347,48,1436,1505,954,14449,482
59977,80,548,505,519,9235,29
64338,7,115,367,88,6715,27
28861,12,298,1196,191,8211,107
11849,146,7738,1493,3026,24768,4712
9375,2315,64136,1511,37933,261659,26203
29092,114,3425,1191,1877,28808,1548
5381,38,1639,1550,1149,30795,490
13793,18,962,1468,616,49776,346
60381,284,2238,491,1941,14210,297
17411,213,5670,1414,3697,39295,1973
11462,162,8632,1497,3508,54117,5124
62082,100,1097,431,1092,8550,5
28287,7955,195448,1206,116569,1093266,78879
5628,337,12662,1547,7680,45791,4982
52946,23,588,721,363,19283,225
18830,217,6177,1388,4463,40647,1714
39182,5,103,978,80,4082,23
51505,231,3553,768,2183,87254,1370
17434,2,320,1413,230,33481,90
32308,305,5320,1133,3761,50247,1559
3802,41,520,1570,343,12161,177
15928,19,453,1438,359,22528,94
32219,73,2340,1135,1111,18511,1229
7093,6124,204000,1529,107035,761824,96965
17005,47,735,1421,519,12439,216
58821,19,289,544,240,9153,49
63733,19,356,386,348,15038,8
32414,118,5534,1132,2403,32914,3131
69313,95,1526,214,1448,11856,78
49622,11,533,817,262,11400,271
34323,190,5078,1096,2413,82732,2665
54962,578,6928,656,6426,87363,502
34650,688,20818,1088,8170,118970,12648
315,133,4390,1600,2368,43863,2022
62479,3,45,419,29,4729,16
11144,7,427,1499,232,6370,195
6204,29,929,1541,655,14942,274
15274,2,132,1448,68,7966,64
64486,48,724,363,692,19701,32
19061,10,275,1384,211,15318,64
7847,1355,100733,1519,33149,379040,67584
6099,465,18437,1542,9216,176848,9221
59779,37,495,512,492,20098,3
25319,113,3675,1270,2211,79614,1464
19403,940,22476,1378,9132,77647,13344
36017,952,11764,1056,10271,83146,1493
25511,190,6401,1267,4789,85910,1612
43025,80,995,919,860,17478,135
46348,59,1390,881,1272,34297,118
41615,60,918,942,778,21347,140
19102,27,1055,1383,596,12639,459
16968,13,202,1421,162,11463,40
54218,308,2505,680,2170,40725,335
60217,14,245,496,217,7795,28
23352,4059,73804,1312,60732,219094,13072
59958,10,134,506,98,3999,36
11047,0,7025,1500,5161,35734,1864
14211,26,885,1462,718,76496,167
39603,12,405,973,269,6681,136
8297,33,946,1516,633,10262,313
63450,23,198,394,152,5149,46
51950,528,6152,753,4736,88085,1416
48860,30,719,840,577,16172,142
17376,6,76,1414,69,6757,7
64500,15,129,362,104,5020,25
22848,43,1118,1320,849,8439,269
10891,14618,262454,1501,145437,647726,117017
16339,105,2252,1432,1674,26951,578
63166,80,1549,401,1158,28552,391
49658,5,193,816,93,3635,100
62202,43,335,427,282,10162,53
3891,54,1932,1569,1025,36295,907
28964,228,4309,1193,3084,46133,1225
52039,52,690,753,532,15957,158
13606,4159,112204,1471,67190,431508,45014
5865,656,15735,1545,7026,184338,8709
23737,223,2693,1305,1930,17437,763
40668,2,33,958,17,1618,16
32012,34,1600,1138,1071,33220,529
12054,22,1260,1491,558,30776,702
21941,198,4076,1334,2827,48315,1249
53891,135,1028,694,894,18209,134
26340,7,182,1248,174,9899,8
859,1112,45222,1595,27142,340721,18080
56793,417,4393,605,3671,34525,722
67566,46,1042,272,753,12867,289
40537,149,1648,959,1449,17426,199
50692,364,4135,790,2840,38231,1295
53235,16,450,713,371,23002,79
63185,1,36,401,35,4343,1
2335,212,4481,1584,3404,60423,1077
35370,19,573,1071,473,7023,100
51678,232,3300,763,2584,36948,716
944,9999,328322,1595,190592,1257441,137730
4252,530,17574,1565,11855,60757,5719
47397,45,566,867,505,11601,61
59809,2245,45782,511,43181,215810,2601
6095,7,393,1542,229,19079,164
34643,46,791,1089,643,13235,148
58571,10,221,552,83,5379,138
60527,7,109,485,64,2983,45
60049,12,102,503,90,5362,12
51980,3347,38968,755,32445,310001,6523
50487,62,822,795,628,37879,194
3409,40,2598,1574,1763,23785,835
51647,102,1573,764,1166,20675,407
6705,4,164,1534,113,18824,51
36890,328,6968,1034,4273,95137,2695
54475,388,5262,674,4731,56712,531
34991,21,347,1080,231,9429,116
5570,95,2311,1548,1404,18554,907
16301,4,147,1432,91,4788,56
54474,225,4489,674,1728,24151,2761
22927,634,18731,1319,14810,184570,3921
32467,15,527,1131,262,11167,265
33411,35,746,1114,553,19975,193
32300,3,189,1134,126,4453,63
67461,156,3306,276,1684,39325,1622
6557,339,17574,1536,11209,254820,6365
18457,16,970,1394,517,13848,453
25699,51,721,1262,506,10037,215
8196,844,16085,1516,11376,65725,4709
57887,145,2074,575,1782,43402,292
8361,8373,158305,1515,96674,572013,61631
5654,66,2579,1547,1538,40829,1041
48741,2,49,843,36,5475,13
33082,311,6910,1119,4128,74540,2782
64590,105,761,360,700,8793,61
24800,60,1746,1281,1228,20310,518
29359,45,905,1186,565,11974,340
20738,53,2804,1355,1689,24858,1115
14839,9,406,1454,299,13497,107
27187,3,93,1230,58,3765,35
3743,181,4816,1571,2803,39469,2013
64643,24,363,358,262,10320,101
61439,41,491,452,445,17464,46
49748,37,883,814,778,25371,105
7166,18,1189,1528,906,26332,283
68907,5,100,228,97,3192,3
4093,197,4628,1567,2793,43070,1835
19048,29,1571,1384,1098,33636,473
30703,131,2414,1159,1631,15035,783
14848,7,1021,1454,337,15196,684
17796,4,93,1406,65,2698,28
10446,3,90,1505,65,7111,25
31927,863,14174,1140,8286,78216,5888
9661,5,161,1510,103,8100,58
19736,190,5465,1372,3851,90969,1614
28665,108,1766,1199,1429,17430,337
56162,22,606,623,322,17940,284
64444,65,1864,364,1630,30634,234
44787,113,1735,898,1588,27042,147
56382,108,1061,617,964,16626,97
54648,20,311,667,270,4672,41
2144,606,25016,1586,12101,65585,12915
58237,85,1364,563,1348,32733,16
60079,3,82,502,65,4813,17
16364,114,2192,1431,1073,25994,1119
67204,81,1348,284,1344,18903,4
5197,53,2657,1552,1649,29494,1008
56112,263,4597,625,4390,27686,207
18937,17,1331,1386,920,31755,411
52161,14,142,748,116,10629,26
56824,98,1843,604,1159,10437,684
37113,91,676,1026,546,15466,130
51879,44,455,755,372,13705,83
44688,35,752,900,578,22084,174
54201,16,173,684,171,5716,2
67332,10,79,280,67,5904,12
33531,53,1561,1002,1368,27637,193
60777,52,665,475,517,10315,148
62442,25,459,420,444,5406,15
21364,135,3162,1343,1853,25959,1309
31282,145,3526,1149,2179,32621,1347
65662,15,294,331,233,10962,61
38656,16,322,985,270,10518,52
11588,75,3235,1496,2010,25188,1225
13992,532,20296,1465,9433,124517,10863
17375,1,19,1414,17,4423,2
67945,18,195,260,134,6339,61
13580,5,517,1471,297,15185,220
30952,179,4045,1155,3287,72774,758
14523,197,6734,1457,2689,40012,4045
8490,9,327,1515,191,6303,136
37333,45,1579,1020,1084,18718,495
34004,80,1469,1096,1025,17046,444
36428,87,1655,1043,1077,30270,578
11577,8,488,1496,258,16083,230
22926,292,6818,1319,5084,57708,1734
28725,1173,26274,1198,18620,87406,7654
19933,434,11227,1368,7013,53317,4214
21617,215,4394,1339,2492,40019,1902
7094,918,20142,1529,13157,81654,6985
6970,9,343,1531,250,8546,93
56272,1,45,620,21,2799,24
54733,81,1065,664,679,23100,386
22323,141,1637,1329,1009,10944,628
24368,15,427,1291,322,10793,105
896,171,2966,1595,2048,24214,918
14679,15,736,1456,565,15589,171
30607,11,517,1161,300,11438,217
20329,23,967,1361,562,25487,405
14516,73,2069,1458,1426,11370,643
49811,21,402,812,202,8416,200
27372,497,9707,1226,6631,63253,3076
36777,437,9123,1035,5505,110849,3618
65068,3,33,344,27,3575,6
16484,86,590,1429,391,46200,199
46944,174,2571,873,2171,28721,400
20662,0,0,1356,0,9032,0
62906,355,3870,407,3242,41841,628
64473,207,3534,363,2861,35691,673
45674,12,585,889,279,12536,306
4138,58,3257,1567,2321,69809,936
18827,134,5549,1388,3283,119134,2266
34052,33,518,1101,302,4783,216
54476,4,56,674,44,3956,12
21980,68,1440,1334,921,17721,519
49373,925,7995,810,6348,74347,1647
17816,45,1231,1406,747,16253,484
63037,1,29,405,29,3495,0
13576,158,7673,1471,4167,24004,3506
30631,4355,86950,1161,59456,261794,27494
24073,143,1553,1298,1223,106593,330
63780,16,218,385,215,5236,3
27336,248,4567,1226,3554,72309,1013
49764,12,280,813,230,9735,50
21419,319,6675,1342,4144,92349,2531
33641,124,1663,1110,1178,35317,485
55141,2,52,651,51,8325,1
18900,59,3171,1387,1794,22898,1377
21964,49,1779,1334,879,60285,900
24865,204,3026,1280,2032,29625,994
2106,3,198,1586,147,15766,51
19525,189,2558,1375,1477,14407,1081
28681,73,1489,1199,971,12479,518
8354,46,875,1516,472,8538,403
38000,261,3785,1002,2731,36441,1054
49854,246,2874,811,2567,28270,307
2093,52,2070,1586,1392,32331,678
12060,2456,96226,1491,41828,514514,54398
2313,220,7552,1584,4317,32685,3235
49309,71,907,825,847,12145,60
15158,10,449,1450,330,12543,119
33662,21,320,1109,288,12549,32
27395,1351,45525,1225,20227,132833,25298
4447,29,694,1563,546,17882,148
2324,141,5255,1584,919,25396,4336
36360,71,703,1046,632,17358,71
60089,5,37,501,30,2635,7
12734,25,1369,1483,655,12608,714
23219,106,2724,1314,1899,44245,825
20311,38,1895,1362,677,11395,1218
50919,22,220,784,193,8239,27
3431,55,1447,1574,1001,18305,446
34576,171,5085,1091,2901,25121,2184
58611,150,2217,547,1766,53730,451
35633,461,23327,1065,5876,103446,17451
18845,148,2407,1387,1810,37679,597
43505,84,1275,912,1071,18199,204
28965,1,103,1193,63,10345,40
50928,17,162,784,139,3322,23
60194,22,220,498,198,5143,22
31695,55,1002,1143,666,17428,336
57804,10,92,576,75,3374,17
49271,173,2923,826,2466,41113,457
27170,3,82,1230,66,3665,16
6392,31,1205,1538,855,18247,350
66996,0,28,290,24,3067,4
18548,29,735,1393,584,17837,151
20263,0,14,1363,14,2711,0
22683,189,3751,1323,2692,129243,1059
58306,0,0,561,0,5441,0
3876,25,984,1569,578,27106,406
51940,13,173,756,140,9985,33
50049,2,41,806,39,2777,2
51038,6840,117877,781,98968,532993,18909
2334,6,399,1584,270,30741,129
17097,42,1567,1419,1109,45739,458
60627,72,1360,481,1135,37186,225
20458,5,168,1359,138,5153,30
18961,82,4316,1386,2591,66048,1725
10027,11,606,1507,400,26995,206
60468,21,287,485,225,14943,62
14267,1081,26241,1461,13717,91408,12524
56230,322,8313,621,3033,58819,5280
39765,474,9099,971,6333,49230,2766
48862,53,558,839,509,13296,49
34304,138,3801,1096,3614,70886,187
24128,35,1256,1297,862,30182,394
4818,1434,62706,1557,29706,405428,33000
45159,28,329,894,266,8048,63
17721,13,620,1408,432,21449,188
62887,18,218,408,171,8940,47
39434,526,8279,975,7631,97214,648
10546,161,6975,1504,4647,51668,2328
34699,3,101,1087,56,3850,45
41431,22,349,945,282,13062,67
46699,514,10445,875,6998,137192,3447
56654,76,1122,609,756,12987,366
66475,2,71,308,63,3156,8
19023,2805,56707,1384,36836,178896,19871
37905,316,6079,1005,6039,27328,40
45460,49,940,891,503,22254,437
1290,8,378,1592,280,17867,98
53386,183,1732,709,1433,11845,299
19737,1,68,1372,50,4397,18
826,5,136,1596,88,15630,48
17212,171,4235,1417,2670,73681,1565
31332,984,24153,1146,11777,126789,12376
18197,21,676,1399,402,20930,274
69389,13,146,212,108,6417,38
29231,100,4081,1188,2425,30789,1656
5223,312,7919,1552,5301,41700,2618
57465,56,426,588,385,11618,41
55026,64,1207,655,757,16323,450
24727,142,8485,1283,4425,45779,4060
13184,385,28133,1477,10614,92644,17519
12881,21,746,1481,278,7730,468
49195,169,1945,829,1688,15863,257
21123,3533,147385,1347,73327,869456,74058
29102,22,397,1191,273,12851,124
36441,8,462,1043,335,13058,127
33038,271,4214,1121,3072,30187,1142
50722,66,868,790,818,23952,50
12792,479,26660,1482,13407,210616,13253
54677,89,542,666,494,7123,48
8928,3,196,1513,59,4961,137
63923,62,1072,380,884,13143,188
33809,34,868,1107,669,17405,199
17001,4,155,1421,119,9799,36
17057,303,5312,1420,3816,21375,1496
45962,131,1984,885,1679,28342,305
38377,7,194,993,174,3972,20
34984,22,631,1080,429,7607,202
38522,2110,29250,988,21673,95267,7577
15465,12,567,1445,294,10636,273
23703,50,986,1305,796,36671,190
32143,8,247,1137,114,5349,133
52054,0,22,752,21,2296,1
7140,1,80,1528,54,17565,26
8591,45,2108,1515,1136,18027,972
37558,8,221,1014,172,8235,49
7686,54,2101,1521,1445,32097,656
26437,2294,69030,1246,26434,348799,42596
3761,0,813,1571,506,12365,307
10766,64,536,1502,390,10433,146
15098,5,76,1451,51,9895,25
30353,658,15957,1166,11132,131214,4825
25506,97,2240,1267,1658,39215,582
33649,34,496,1109,434,6590,62
9040,12,2451,1513,486,15965,1965
14085,758,15838,1464,10156,126878,5682
57123,6,33,596,31,2327,2
10459,57,1666,1505,1104,26303,562
29293,3,230,1187,124,3793,106
14724,7,174,1455,126,13209,48
40492,142,1438,960,1075,10688,363
23089,316,7113,1316,5052,53514,2061
31463,506,7591,1147,4411,35926,3180
18991,0,34,1385,30,20606,4
38185,804,13211,997,9780,82316,3431
24050,96,2926,1298,1730,14429,1196
39874,10682,635442,969,242122,1125313,393320
66551,4,88,305,66,4988,22
34168,9,169,1099,117,17025,52
8590,6,333,1515,209,13833,124
50300,18,157,799,137,7354,20
17895,42,1655,1404,1295,17581,360
16784,35,2349,1424,1318,20988,1031
4980,15,391,1555,225,19597,166
46489,76,1023,879,786,33872,237
26337,36,1165,1249,844,29916,321
35064,1,23,1077,18,2689,5
20894,22,421,1352,294,19418,127
17688,26,355,1408,277,9022,78
14210,776,12411,1462,8665,66449,3746
19824,0,60,1370,50,12205,10
34701,92,1064,1087,750,14871,314
17627,91,1678,1409,1231,16562,447
53053,288,3035,718,2720,63730,315
11268,0,0,1499,0,12855,0
21293,14,366,1344,314,19010,52
948,2,104,1595,68,11904,36
9347,4,194,1511,97,7973,97
61879,112,3186,438,2544,15581,642
18550,24,860,1393,511,22507,349
9772,9,781,1509,229,14844,552
54062,309,3338,689,2719,19602,619
16854,100,1911,1423,1201,17414,710
22890,9,200,1319,149,10250,51
64871,25,495,351,404,10105,91
53889,89,1942,694,1041,12680,901
44183,24,393,905,265,11195,128
53230,10,175,713,136,6956,39
53818,11,131,697,105,5268,26
7716,3677,147999,1521,65019,481057,82980
30906,156,3425,1155,2026,28735,1399
32457,38,857,1131,536,18904,321
11723,0,0,1495,0,8537,0
66332,8,223,312,196,5770,27
34085,17,432,1101,264,7919,168
48682,11,292,845,222,6824,70
57515,40,446,587,363,9031,83
11451,29,1305,1497,845,14288,460
51412,26,522,771,340,11901,182
23576,20,733,1308,478,12004,255
62263,4,69,425,62,7013,7
29386,49,1453,1185,1211,65011,242
13616,35,1637,1471,910,25102,727
32857,72,1114,1124,812,19718,302
25554,1118,25365,1266,14596,87219,10769
46485,5,98,879,86,6580,12
23365,16,210,1312,152,5122,58
52654,1,33,731,18,4246,15
2744,247,11428,1581,7081,36444,4347
5469,61,1699,1549,1151,20004,548
34317,70,1264,1097,1153,11311,111
31548,149,4664,1146,2545,51760,2119
40626,2453,46479,958,32414,338007,14065
10491,12,596,1504,381,8206,215
40886,418,8534,954,5991,79408,2543
18744,57,981,1389,565,13953,416
61792,53,607,441,564,11913,43
555,67,2904,1598,2084,23522,820
32835,134,2981,1125,1802,24760,1179
14393,136,4305,1459,2876,25178,1429
31663,24,403,1144,283,4954,120
65481,12,332,336,295,8827,37
4031,166,3431,1568,2166,43360,1265
36095,35,672,1053,582,14848,90
29882,18,624,1176,440,7421,184
50162,17,183,803,143,7321,40
22911,95,1932,1319,1411,20445,521
28269,69,1164,1207,815,23973,349
652,56,7690,1597,3457,52890,4233
63456,476,6685,394,5604,39291,1081
24316,9,183,1293,149,6228,34
24359,1534,14785,1291,10346,104465,4439
24479,88,2238,1289,1526,16044,712
55572,12,210,640,162,18712,48
61409,25,316,434,192,8553,124
63482,1,29,393,24,4548,5
37263,15,299,1022,243,5525,56
64642,13,246,358,199,12495,47
14772,5,185,1455,131,5891,54
12937,660,17507,1480,8989,48214,8518
56114,8,193,624,147,16942,46
15444,270,32187,1446,5060,118750,27127
35937,88,1374,1058,905,16410,469
14598,255,4044,1457,3207,31663,837
51904,216,2762,757,2295,25744,467
19665,7054,260041,1373,147576,1036589,112465
69945,0,24,193,16,2335,8
6282,5,315,1540,172,22847,143
65109,152,1547,344,1260,7761,287
44526,22,328,901,245,7461,83
50653,10,53,791,52,2382,1
38074,13,359,999,250,14822,109
19695,48,793,1372,468,15836,325
2257,16,435,1585,264,12103,171
48973,1,48,836,37,7404,11
15197,281,7254,1449,5344,68517,1910
9258,11,811,1512,456,11031,355
9675,59,1760,1510,1309,23752,451
58,682,27716,1604,19450,267998,8266
30840,7,224,1156,134,3828,90
8057,21,244,1517,179,9870,65
48742,15,253,843,222,4996,31
58154,184,2614,566,1955,16964,659
9382,41,1201,1511,643,8100,558
32358,4,159,1133,107,15677,52
18651,654,24931,1391,14161,151481,10770
45790,100,1695,888,1386,14930,309
64815,21,255,353,240,8499,15
29140,275,8956,1190,6020,34160,2936
62038,53,678,433,504,11284,174
23853,50,2190,1303,1443,18065,747
32089,180,2698,1137,1956,15838,742
7208,33,1041,1527,809,56165,232
11316,307,7501,1498,3995,63158,3506
13782,54,1307,1468,579,17970,728
37984,11,490,1003,406,7738,84
7092,45,1273,1529,910,17738,363
62255,9,96,426,87,5057,9
51783,596,10113,760,6488,87417,3625
5828,962,57336,1545,36430,326761,20906
50790,274,6943,788,3929,37862,3014
54143,260,1981,686,1693,18335,288
22603,164,7058,1325,5034,59942,2024
52878,111,1508,723,1220,49367,288
24165,46,1845,1296,1215,20280,630
47688,127,1968,863,1531,14353,437
55924,5847,103087,628,69310,673563,33777
27409,248,3505,1225,2878,23570,627
46509,79,942,879,745,10785,197
13586,1025,20446,1471,14241,181053,6205
21662,1033,29702,1338,19770,256543,9932
17945,8,888,1403,291,16899,597
21037,917,37461,1349,12664,188599,24797
38057,513,7755,1000,6740,75175,1015
62787,112,1128,411,849,10868,279
22058,20,513,1333,303,9000,210
14593,34,454,1457,376,16947,78
60176,76,1068,498,747,10039,321
50030,13,162,807,131,9753,31
60550,18,237,484,227,8303,10
55508,12,261,641,189,6505,72
38247,29,789,996,611,31851,178
7172,6,431,1527,292,11581,139
12174,117,3596,1490,2040,12374,1556
7506,84,3572,1524,2478,16884,1094
53975,2048,34044,692,21038,190952,13006
1893,10,314,1588,225,16579,89
10694,606,16480,1503,11129,111870,5351
37177,843,15891,1025,10919,100877,4972
5200,16,839,1552,605,23719,234
15781,118,3918,1441,2447,56558,1471
27347,14,508,1226,254,25258,254
25658,470,5492,1263,3595,30384,1897
53323,19,147,711,127,5710,20
33225,4,121,1117,78,4078,43
363,180,9736,1600,6212,56648,3524
48656,12,298,846,250,7635,48
35214,2,44,1074,31,5813,13
23096,1,117,1316,76,7267,41
2790,41,3456,1580,2300,23612,1156
14063,3,166,1464,122,9272,44
21674,14,634,1338,298,6281,336
14921,29,1363,1453,858,27409,505
28647,28,567,1200,320,11718,247
25579,104,3281,1265,2248,21889,1033
27584,0,0,1220,0,33917,0
12199,12,358,1490,210,10912,148
47320,59,765,868,625,10959,140
35400,172,4102,1069,2933,28300,1169
60939,7,181,469,47,3003,134
30619,609,12691,1161,8822,111779,3869
8449,13,912,1515,600,9605,312
3837,25,2120,1570,808,34287,1312
13488,7,236,1472,163,17092,73
49095,97,1595,832,1307,12922,288
560,62,1924,1598,1388,20531,536
42917,88,1549,920,1077,38827,472
50383,20,215,798,192,5892,23
40167,88,1565,965,1064,31005,501
34104,33,1473,1100,806,11794,667
56221,103,1603,622,1585,23288,18
40199,38,1053,964,899,11328,154
19765,9,491,1371,263,10656,228
2654,30,1837,1582,742,29081,1095
27870,79,1704,1214,977,35798,727
35239,22,312,1074,234,9547,78
37645,4912,78637,1012,52044,411406,26593
15273,18,593,1448,443,20547,150
373,339,26497,1600,8132,146860,18365
59795,26,307,511,284,6736,23
26303,2,189,1249,124,6869,65
26356,20,572,1248,385,10919,187
15888,12,512,1439,370,17869,142
9745,186,4040,1509,2640,25905,1400
50004,38,429,807,381,14176,48
42646,56,758,925,678,24494,80
43449,9,194,913,142,17482,52
25690,33,906,1262,605,24859,301
15386,1032,32037,1447,15205,214821,16832
14807,2,236,1454,120,4387,116
53154,54,769,714,610,14045,159
68918,654,13281,227,11777,103282,1504
6119,190,9509,1541,4945,87443,4564
32799,56,1718,952,1027,38151,691
37049,35,921,1029,712,39536,209
60582,76,1370,483,939,11952,431
34254,15,576,1096,437,5108,139
41667,36,622,941,459,3242,163
60599,160,2492,483,2155,37091,337
13415,9,886,1474,219,12969,667
38063,0,11,1001,9,5193,2
30884,42,763,1156,497,6608,266
18064,0,157,1401,131,17431,26
62000,35,509,434,319,5224,190
35161,666,11688,1076,8632,71337,3056
17843,51,1374,1405,942,40268,432
20651,62,969,1356,712,18101,257
24619,1384,44227,1285,20567,294657,23660
15537,16,1529,1444,828,20979,701
59721,1795,45473,514,29907,439904,15566
66012,30,201,322,174,5464,27
37788,15,327,1008,238,13430,89
11250,6,634,1499,310,11001,324
20848,36,541,1353,419,9915,122
22042,7,274,1333,171,9039,103
68595,31,429,238,296,7860,133
43461,49,1305,913,1014,17594,291
27070,1254,108144,1232,31755,317456,76389
13797,239,9342,1468,5181,117462,4161
67917,36,268,261,247,5740,21
27844,63,1884,1215,1129,16618,755
14641,65,2016,1456,1344,21830,672
41714,63,1514,940,1248,25413,266
36805,18,437,1036,351,6734,86
36063,4,131,1051,94,9586,37
11968,23,1032,1492,487,12482,545
37733,2,92,1009,72,4800,20
62612,1200,16486,371,16442,138007,44
14616,344,10347,1457,7464,98320,2883
3359,127,5256,1575,1569,78019,3687
51090,98,1384,779,1111,15638,273
50271,73,879,800,591,12097,288
56957,189,2002,600,1860,16770,142
60846,1094,23822,457,16934,205476,6888
28120,10,700,1210,430,10011,270
13044,225,7573,1479,4249,65010,3324
33012,25,483,1121,280,19110,203
50457,158,2632,796,2156,68425,476
46852,6,127,874,109,12390,18
62679,113,1472,413,1344,19185,128
1751,68,1033,1589,719,8853,314
20052,381,11298,1366,6536,37619,4762
28208,9,200,1208,165,11047,35
32064,7056,156924,1138,106589,492720,50335
20537,176,7352,1358,5374,49226,1978
15816,45,1081,1440,820,33798,261
1463,8,334,1591,235,19589,99
48533,76,1786,850,1643,17095,143
27857,1171,19847,1215,15168,77761,4679
21688,87,1954,1338,1141,26850,813
63179,13,282,401,168,7095,114
8804,36,2405,1513,1173,54199,1232
4719,13406,546468,1559,226710,1497286,319758
12647,1860,58082,1484,36411,240855,21671
1800,195,4116,1589,3140,26685,976
26318,229,7061,1249,4156,36759,2905
32846,2167,56682,1125,35301,464252,21381
10524,36,1282,1504,882,28028,400
58421,37,491,557,452,20855,39
35079,1697,27194,1078,19050,212580,8144
27311,153,3962,1227,2230,22561,1732
7512,64,2024,1523,786,30566,1238
28743,333,6689,1198,4719,69031,1970
30099,147,2452,1171,1811,31401,641
14299,36,667,1461,473,12442,194
24586,2,174,1286,151,7191,23
37415,238,6648,1018,5008,130766,1640
6589,47,974,1535,579,11375,395
20791,117,1908,1354,1315,21493,593
14984,308,8009,1452,5499,71454,2510
63896,5,53,381,42,3007,11
53946,30,400,693,318,11899,82
29606,402,9805,1182,6521,73593,3284
6318,68,2365,1539,1640,19623,725
46958,864,19961,855,12226,111300,7735
7034,1441,47541,1530,22935,133702,24606
47284,31,829,869,732,22566,97
4414,9,392,1563,300,12297,92
5432,453,15014,1550,10341,172714,4673
55194,4,64,650,43,6964,21
51612,1961,30807,758,22339,289578,8468
31462,58,1097,1143,662,29997,435
30998,272,3782,1154,3076,29352,706
61241,1,15,458,13,1962,2
38033,58,1678,1001,1359,48692,319
51860,1198,14023,758,10902,82035,3121
62912,3,93,408,64,4537,29
39613,35,398,973,379,11370,19
30818,85,1928,1157,1447,17090,481
54208,373,4218,684,3829,62465,389
66222,110,1645,315,1519,26832,126
4540,21,977,1561,698,56874,279
50327,5592,71517,799,51082,244154,20435
18491,72,2098,1394,1461,24759,637
26995,80,2628,1233,1919,28240,709
20376,13,900,1361,660,16373,240
17506,33,699,1412,588,24778,111
50807,33,545,787,408,7721,137
65353,6,138,338,123,4495,15
17780,147,4654,1406,3487,168186,1167
57686,200,2944,582,2883,15006,61
57598,69,621,584,538,11586,83
24833,22,542,1281,383,14759,159
34182,18,1086,1099,697,22852,389
57393,35,585,589,530,17521,55
37662,59,666,1011,563,19580,103
37745,124,2257,1009,1830,15277,427
22239,4413,95130,1330,57901,557880,37229
63630,19,313,389,221,5574,92
15253,387,8338,1449,6048,98253,2290
67434,13,151,277,146,6198,5
4615,2,156,1560,114,10321,42
30575,118,2750,1162,1651,20149,1099
11986,232,8730,1492,5728,77671,3002
25666,10471,233838,1263,134710,548700,99128
51332,1162,18416,773,14393,96591,4023
16952,107,2890,1421,2437,30286,453
6903,40,990,1532,570,33197,420
29337,5,131,1186,92,8830,39
8296,2,132,1516,86,9421,46
17686,6,225,1408,174,14131,51
6643,25,968,1535,589,21559,379
53726,337,4334,700,4173,35211,161
13101,385,28730,1478,12037,159306,16693
3169,1,132,1577,90,11109,42
57777,34,409,578,297,8776,112
32481,433,14225,1131,8490,58474,5735
35920,1596,38658,1058,24918,200801,13740
13122,105,3566,1478,2219,59432,1347
64336,3,60,367,47,4948,13
46968,19,301,873,207,8450,94
29145,5099,145410,1190,87464,344547,57946
53585,38,496,705,427,9559,69
5092,8,495,1554,280,10133,215
12277,34,6308,1489,2464,16243,3844
17402,31,1092,1414,924,18830,168
4819,465,12451,1557,8537,215950,3914
14387,1289,29621,1459,22166,246309,7455
8434,791,19030,1515,10854,71009,8176
28891,229,4613,1195,1806,40297,2807
51811,62,735,759,526,12622,209
30123,141,4434,1171,2514,35717,1920
64156,25,398,373,391,12109,7
29161,4,94,1189,67,7062,27
29101,6,181,1191,73,7022,108
56540,77,1466,612,987,25878,479
31400,1,66,1148,38,3627,28
17656,1,66,1409,36,4030,30
68888,18,167,228,153,3632,14
8226,39,1026,1516,699,15800,327
6443,25,943,1538,541,21085,402
58246,161,1848,562,1644,12110,204
32295,21,253,1123,183,9035,70
12932,90,1818,1480,659,19455,1159
26336,447,15637,1249,10376,71389,5261
27764,151,3800,1217,2280,21937,1520
18241,12,862,1398,613,38064,249
60264,1490,31694,495,23197,218519,8497
8775,60,1731,1514,1159,14510,572
12087,102,5647,1491,1093,40621,4554
35127,330,6255,1077,5228,41245,1027
56257,22,379,620,335,18895,44
328,93,3044,1600,1573,38158,1471
22556,11,317,1326,251,13217,66
52636,152,2251,731,1965,36823,286
26803,84,1927,1238,1218,25604,709
54562,2110,308012,671,29471,424394,278541
50691,13,84,790,62,3063,22
58668,53,668,549,501,10940,167
13566,2,259,1471,135,22003,124
2686,405,10593,1581,6107,70678,4486
35099,51,706,1078,513,7008,193
1265,6,273,1592,124,28843,149
24779,239,5350,1282,3208,54021,2142
67745,22,518,267,317,16361,201
41019,24,364,951,285,7654,79
23393,99,3773,1311,2336,53526,1437
7524,188,6497,1523,2755,83118,3742
51232,456,5529,776,3424,94246,2105
4039,13,195,1568,145,10750,50
60307,59,520,493,487,6546,33
15079,26,834,1451,637,14305,197
6264,11,736,1540,276,22411,460
29675,44,1056,1181,741,5382,315
25871,137,2949,1259,2026,50373,923
59426,142,1240,524,1111,27696,129
18084,4,237,1401,142,3487,95
52676,24,464,730,308,19535,156
48691,178,1781,845,1456,21250,325
6677,200,3158,1534,2082,46371,1076
38410,38,840,992,600,17913,240
30535,48,852,1162,619,13218,233
32491,106,3086,1131,1714,19465,1372
69334,3,41,213,26,2412,15
69029,36,578,223,508,7413,70
50458,39,554,796,469,4817,85
14831,0,31,1454,14,2740,17
51288,57,735,774,569,20780,166
48759,145,1851,843,1652,35236,199
32627,43,1007,1129,710,10709,297
18962,93,1294,1386,931,10471,363
58140,19,394,567,339,6144,55
49026,20,456,834,418,7735,38
48485,20,304,852,229,8498,75
977,794,42485,1595,26155,148311,16330
24179,23,244,1296,195,8238,49
51642,8,227,764,194,8603,33
35354,61,1850,1071,1413,13847,437
60786,2350,39488,475,31429,281399,8059
12533,47,1346,1486,699,35565,647
50975,23,281,783,205,5492,76
39326,81,754,976,600,9223,154
15295,27,955,1448,707,30809,248
38713,44,573,984,414,19539,159
14306,25,766,1461,463,10713,303
34449,27,845,1093,555,24892,290
61939,77,1036,436,823,17800,213
20107,184,3566,1365,2088,61205,1478
11994,2,274,1492,143,5189,131
3987,94,1293,1568,911,19238,382
21153,123,2955,1346,1798,30052,1157
1227,1274,69241,1593,33844,321400,35397
13764,573,11777,1469,7845,106548,3932
26665,221,8925,1240,5248,50238,3677
32836,50,1136,1125,839,39496,297
50379,374,6090,797,4866,62071,1224
26483,89,2551,1246,1634,15487,917
962,66,1463,1595,1137,50031,326
59432,687,11061,524,10336,73667,725
15902,6,270,1438,118,24201,152
14629,426,13281,1456,9250,67882,4031
64048,89,896,367,613,19556,283
49670,49,1214,816,828,22209,386
3422,4,111,1574,68,8191,43
16266,454,7189,1433,5523,67592,1666
20130,337,7022,1365,4826,105063,2196
53368,1,66,710,44,7768,22
7191,23,2004,1527,1254,29218,750
60041,25,256,503,221,11775,35
35930,40,579,1058,409,18749,170
45947,54,1073,886,924,21412,149
23265,16,794,1313,587,35465,207
54971,362,7188,656,3003,56780,4185
26312,2043,56889,1249,33923,441490,22966
85,39556,2317546,1603,859589,5175360,1457957
4843,8,301,1557,209,9033,92
6526,50,2316,1536,1570,38803,746
31860,96,3892,1141,2520,41134,1372
58484,27,192,554,169,5372,23
63376,39,741,396,591,18585,150
21728,10,205,1337,145,17640,60
1111,54501,1988550,1594,871851,3688503,1116699
66795,64,838,298,685,7636,153
55060,92,675,653,611,12709,64
35152,13,378,1076,217,20630,161
5410,21,1118,1550,779,14640,339
22027,15,490,1333,400,10198,90
20371,232,5667,1361,4308,74951,1359
21207,22,401,1346,308,7000,93
33972,32,362,1104,279,14805,83
51488,5,77,769,61,6304,16
5427,5,366,1550,242,8400,124
20403,2,190,1360,140,6407,50
38289,5,164,995,101,9813,63
30538,23,530,1162,470,37544,60
56830,234,3493,604,2989,30601,504
15091,243,4301,1451,3178,48979,1123
41314,6,193,947,155,22280,38
58580,20,568,551,446,11768,122
19982,7,303,1367,206,16290,97
38066,1085,19618,1001,15292,113768,4326
24424,18,834,1290,574,9691,260
12814,169,5838,1482,3714,54851,2124
30318,56,1750,1167,1144,28418,606
37706,18,728,1010,451,13042,277
15422,1243,24260,1446,16136,204213,8124
6272,232,24108,1540,3954,84906,20154
5931,9,268,1544,195,22046,73
51424,5,83,770,50,4138,33
52184,27,304,748,266,5825,38
19070,55,1742,1384,1383,46914,359
49731,23,412,814,361,8265,51
33318,67,2203,1116,768,7982,1435
20767,17,431,1354,319,37212,112
27289,2,133,1227,71,5840,62
41603,3477,51633,942,34080,242089,17553
59239,38,637,531,528,10566,109
11775,57,1796,1494,739,8755,1057
16772,336,8284,1424,5268,75787,3016
24960,191,3603,1278,2297,55822,1306
25480,170,2265,1267,1680,26750,585
63943,7,119,380,98,2169,21
12434,13,1122,1487,433,10929,689
13622,6,311,1471,175,11404,136
3375,2130,69660,1575,38842,150195,30818
8051,7,275,1517,197,12076,78
50409,14,271,797,116,2536,155
22840,48,970,1320,684,22666,286
18363,3,204,1396,153,11155,51
9117,864,41302,1512,24105,157944,17197
30476,5,235,1164,150,12208,85
49344,11769,420735,824,155634,1140478,265101
33037,18,656,1121,269,8523,387
2878,160,4091,1579,2818,26364,1273
34442,57,1654,1093,1090,23327,564
56424,6,52,616,50,3748,2
6866,37,786,1532,488,31680,298
18871,16,504,1387,402,15078,102
31455,58,1060,1147,705,12406,355
57833,487,9543,577,5944,71515,3599
10980,124,1615,1501,1115,28956,500
40634,621,11002,957,8624,98878,2378
27234,2,120,1229,82,144682,38
63826,26,353,384,353,6315,0
62602,69,605,416,604,8208,1
3989,58,1842,1568,1331,25362,511
8315,48,1263,1516,942,9619,321
57505,215,2491,587,2099,16257,392
29642,0,0,1181,0,5207,0
60781,47,565,475,481,17518,84
20393,29,725,1360,559,11127,166
17145,118,2379,1418,1653,28792,726
49988,42,1067,808,596,9661,471
26887,20,235,1236,161,7153,74
61524,253,4541,450,2659,38385,1882
61126,47,429,462,364,6578,65
8405,44,1588,1515,1031,23794,557
30870,7,274,1156,200,6262,74
8475,24,1139,1515,698,14930,441
12366,82,2459,1488,1370,36016,1089
10354,91,2262,1505,1377,26296,885
21799,34,1387,1336,941,11892,446
7787,37,1526,1520,1052,22897,474
8425,73,2265,1515,1427,18581,838
54211,14,128,684,118,4659,10
38251,16,494,996,454,13400,40
37623,303,5645,1012,5179,56026,466
20898,71,1572,1351,1253,18698,319
62396,119,638,421,633,11688,5
21872,11,655,1335,394,19633,261
2011,8,226,1587,155,12687,71
55149,39,1453,651,588,23438,865
4553,8,226,1561,168,10328,58
52471,1961,21975,737,18109,203055,3866
33436,11,196,1113,119,4848,77
30977,913,34024,1154,16213,269193,17811
36260,69,2178,1049,1461,40763,717
20089,8,334,1365,270,23701,64
24681,156,3089,1284,1880,12022,1209
53682,5,66,701,45,3930,21
11440,15,263,1497,161,6413,102
59189,34,555,532,534,17819,21
6684,6034,282159,1534,136191,1754257,145968
60802,9,52,474,46,4653,6
55704,12,301,636,229,19383,72
1558,1487,53638,1590,23705,115501,29933
19841,5483,147661,1370,96306,485830,51355
54403,84,1437,677,907,19419,530
28026,391,11261,1211,5971,114252,5290
29379,11,214,1186,129,7471,85
35785,128,1921,1061,1511,35950,410
7711,4,213,1521,107,6338,106
750,60,2665,1596,1752,31441,913
47499,514,6691,866,4938,59684,1753
55485,311,5620,642,5397,66800,223
27922,40,1469,1213,805,22922,664
58055,5591,79171,569,60459,249491,18712
7434,41,1369,1525,909,27150,460
34287,5,210,1096,157,8575,53
61099,117,2338,463,1746,33059,592
50770,23,365,788,307,9208,58
31373,146,3203,1148,2865,42041,338
5913,9,140,1544,112,4245,28
68291,0,0,249,0,1687,0
29229,0,0,1188,0,7984,0
37067,11,190,1028,142,4396,48
58118,262,5120,567,2469,17872,2651
29553,8,292,1183,208,6447,84
51205,49,1038,776,692,11054,346
50998,669,11208,782,8727,142794,2481
29224,84,2553,1188,1573,15134,980
56782,14,247,605,221,5753,26
70096,20,360,187,260,6214,100
59559,686,12615,520,9463,66463,3152
61096,42,1131,463,1046,8419,85
34232,63,1220,1098,953,27057,267
23677,113,2783,1306,1994,23667,789
20890,11,280,1352,216,7426,64
34801,16,275,1085,215,7088,60
4766,182,2990,1558,1928,43590,1062
22565,8279,354291,1325,126090,961887,228201
13597,33,1591,1471,701,14838,890
18778,7,466,1389,361,36127,105
22976,88,2228,1318,1040,22198,1188
22685,14,575,1323,411,24236,164
29077,45,1272,1191,748,15261,524
30254,1518,24474,1168,17280,190284,7194
58895,96,831,542,768,8853,63
19246,62,1391,1380,1059,17785,332
12209,19,1413,1490,691,24596,722
3552,97,3397,1573,2506,45412,891
58187,445,5943,565,5275,23770,668
19519,29,1466,1376,892,17446,574
33285,56,1398,1116,748,8106,650
48630,28,299,847,241,7268,58
31786,27,779,1142,528,12484,251
22827,26,929,1320,651,13168,278
15908,446,14919,1438,10288,130794,4631
27679,1819,45476,1218,30709,244199,14767
9014,5,275,1513,192,12439,83
3850,0,55,1570,41,7992,14
61424,17,225,453,212,5014,13
32738,3,80,1127,55,3047,25
56309,21,289,618,263,12489,26
58263,32,277,562,235,3015,42
68625,11,147,237,101,4071,46
15054,684,11552,1451,9331,68343,2221
52737,62,1117,728,757,15287,360
2815,29,834,1580,654,16928,180
23904,850,21065,1302,12230,126335,8835
62718,0,26,412,22,3816,4
15269,51,1552,1448,982,27690,570
10867,63,2855,1502,753,20854,2102
12431,56,2168,1487,1070,25341,1098
34307,6298,133133,1097,93905,385184,39228
32432,12,276,1132,164,10552,112
4293,480,23407,1565,13757,104852,9650
17668,261,9230,1408,6588,57007,2642
31118,564,14869,1152,9725,77566,5144
41590,25,707,942,603,16995,104
22100,139,5523,1332,3691,58368,1832
1170,16,796,1593,559,11329,237
10297,294,7406,1506,5137,62628,2269
36724,4,88,1037,71,16409,17
14744,11,219,1455,181,9853,38
24500,31,611,1288,355,15725,256
11835,7,641,1493,239,15269,402
40246,27,444,964,257,35217,187
41504,146,2602,944,1759,46417,843
42366,2959,59259,892,40489,348663,18770
54670,161,2832,666,1740,22437,1092
35014,20,591,1079,424,10772,167
33433,27,364,1114,252,6132,112
40547,664,12647,959,10738,42077,1909
15298,555,15676,1448,10838,105607,4838
29173,5,372,1189,185,9499,187
49114,32,331,832,228,9782,103
58608,23,240,551,212,5597,28
39792,6,246,971,155,11453,91
66865,41,433,295,409,8064,24
5304,20,874,1551,584,33297,290
60095,1547,20251,501,14815,179701,5436
31796,26,674,1141,391,22099,283
4155,20,454,1566,328,8415,126
25212,3,172,1273,118,7212,54
28319,21,407,1206,242,9720,165
38582,14,177,986,124,13831,53
10368,0,10,1505,3,13177,7
16815,708,36173,1424,10428,254345,25745
19188,52,1330,1381,924,28733,406
26458,79,2509,1246,1838,34966,671
61609,221,2854,447,1862,27237,992
995,72,4661,1594,3171,30744,1490
40440,761,8465,961,7116,63073,1349
10540,520,10397,1504,7094,72907,3303
30337,471,10823,1166,7533,117023,3290
24178,6,290,1296,189,4565,101
20396,23,847,1360,596,28754,251
21665,19,424,1338,275,12115,149
6244,4,264,1540,210,4819,54
37922,22,213,1005,156,69920,57
1184,29,1396,1593,933,15745,463
8827,10,489,1513,328,13480,161
13847,181,2343,1467,1394,26128,949
16470,0,41,1429,28,5585,13
31165,20,358,1151,248,8151,110
63893,10,141,381,130,4640,11
60447,44,504,488,318,8670,186
39427,58,883,975,748,10228,135
69221,22,326,217,315,9187,11
24004,11,329,1300,200,7248,129
1522,1091,48658,1591,26372,136505,22286
12244,68,2214,1489,1157,64662,1057
18515,3,164,1393,118,6186,46
48554,4936,88609,848,64209,798372,24400
17400,2920,79257,1414,55287,381719,23970
13065,14,496,1478,308,26107,188
55679,15,171,636,119,8391,52
42714,577,9399,924,7665,72337,1734
4929,190157,5818378,1556,2333852,11974401,3484526
67974,12,207,259,193,5424,14
22745,43735,1448361,1322,614179,2461001,834182
40894,32,495,953,397,8212,98
30269,60,1749,1168,785,19833,964
49260,31,1098,827,698,23846,400
12821,37,1068,1482,674,15837,394
5571,31,1417,1548,1008,68802,409
3525,65,1534,1573,1104,23830,430
32107,12,286,1136,256,8142,30
40943,9,297,952,228,8681,69
52433,2,68,739,53,16564,15
58546,0,14,553,12,1881,2
3747,14,451,1571,314,8914,137
59870,32,771,509,733,27547,38
31827,3,82,1141,58,4425,24
37463,13,317,1016,225,9430,92
38113,731,21839,999,17554,130537,4285
51041,66,1477,781,1020,11837,457
26184,86,1922,1252,1270,17402,652
14474,699,20258,1458,11521,77544,8737
51751,69,862,761,824,14784,38
8335,86,2345,1516,1577,29499,768
31809,83,1493,1141,989,28379,504
23085,2124,48312,1316,35715,246853,12597
21916,53,1750,1334,1093,37440,657
21435,1499,28677,1342,22084,100903,6593
1582,17,486,1590,291,35098,195
9689,97,2896,1509,1483,30665,1413
27430,622,26218,1224,9813,125370,16405
10407,38,1241,1505,639,9387,602
34492,951,16789,1093,10841,103410,5948
23306,10,343,1313,232,30477,111
28774,13,425,1197,323,9218,102
62177,38,384,427,313,7993,71
466,125,3934,1599,2575,34865,1359
20472,24,1271,1359,837,16914,434
50206,68,3373,795,888,29443,2485
41087,13498,274816,950,171639,1746976,103177
35150,698,19816,1075,9815,132872,10001
38541,373,4712,988,3307,18975,1405
3632,282,10609,1572,6909,110323,3700
7330,137,3672,1526,2016,23352,1656
15406,39,1725,1446,1086,10930,639
55911,247,2555,631,2416,26662,139
24812,50,1051,1281,683,14551,368
48853,6,155,840,105,2992,50
31034,823,22383,1153,15483,56328,6900
21895,55,1242,1335,791,34044,451
5070,108,2373,1554,1727,17644,646
33902,564,10140,1105,8540,82582,1600
7845,122,3205,1519,2160,42604,1045
31416,65,872,1148,561,15832,311
16707,41,581,1426,443,5737,138
9215,493,9986,1512,6712,40495,3274
52611,116,998,733,907,8792,91
24183,53,646,1295,550,56607,96
26671,1768,27194,1240,19360,159318,7834
53595,28,292,705,260,6066,32
52966,60,1031,721,948,10056,83
53155,43,588,715,476,5845,112
8622,550,32093,1514,14306,254417,17787
20034,12,326,1366,242,20312,84
61032,340,2587,466,2082,14594,505
21214,1,56,1345,35,12020,21
31218,18,607,1150,305,22293,302
59441,1,100,524,55,5869,45
36707,121,2357,1037,1935,23504,422
26241,256,4603,1251,3040,16412,1563
29685,44,805,1180,480,6257,325
33122,178,5721,1120,4356,102373,1365
16508,17,532,1429,368,9863,164
56532,221,1721,612,1300,31059,421
37321,0,0,1021,0,8379,0
2180,14,282,1585,202,10986,80
7414,16,647,1525,458,17105,189
65692,12,116,330,100,4645,16
18288,221,7657,1397,6107,64062,1550
57207,55,897,594,736,9556,161
63723,10,269,386,196,9270,73
17210,10,593,1417,313,6726,280
30825,5,255,1157,140,4738,115
42328,19,261,931,217,7659,44
4420,479,19245,1563,9310,89924,9935
9129,60,2221,1512,1336,12316,885
40331,305,4407,962,3680,51526,727
10868,174,4454,1501,2164,31146,2290
51230,733,9300,776,8150,76664,1150
28613,96,5033,1200,2877,36323,2156
21814,1,99,1336,70,10154,29
51748,52,989,761,874,17434,115
50797,7,70,788,63,12224,7
40905,113,2435,953,2050,27602,385
16853,9,370,1423,258,10873,112
8066,1224,30606,1517,11256,186997,19350
22474,7,381,1327,285,21209,96
11883,362,13252,1493,7500,66663,5752
32847,1278,30519,1124,16482,149255,14037
61788,1710,33545,434,33066,263997,479
32897,34,1114,1124,713,14333,401
31076,96,3342,1152,1770,41871,1572
25552,423,14090,1266,10133,150060,3957
36056,529,10520,1054,8452,39165,2068
21899,107,2841,1335,1661,19133,1180
24807,191,4016,1281,2498,26700,1518
68303,3,62,249,47,9221,15
46132,15,162,884,120,6444,42
35894,7,409,1059,265,9578,144
8370,15,592,1515,397,19028,195
623,54,1605,1597,1176,21311,429
29193,19,1393,1189,788,19638,605
32018,20,531,1138,303,7170,228
40689,21,916,957,565,37125,351
48587,288,3514,848,2911,40842,603
30753,137,3678,1158,2474,42273,1204
27743,63,1386,1217,775,17486,611
63785,26,177,385,169,7769,8
51559,409,4985,767,4261,56756,724
25686,674,17805,1263,9617,122917,8188
50453,9,83,796,66,4149,17
8170,587,17735,1516,12689,78897,5046
19896,164,3886,1369,2906,36835,980
29700,63,1391,1180,809,13014,582
18029,35,1346,1402,791,9761,555
24365,176,3376,1291,2652,31900,724
69408,186,3422,211,2955,41115,467
2113,57,2342,1586,1529,28064,813
12173,27,1127,1490,555,14522,572
16264,73,2610,1433,1901,78879,709
49559,3,110,819,82,7234,28
42890,235,3863,921,3520,33586,343
22947,25,891,1318,702,16352,189
4947,3091,81573,1556,49104,222958,32469
54278,70,382,681,322,4187,60
51370,108,1837,772,1308,31891,529
34290,239,7097,1096,4203,64376,2894
28431,102,3006,1204,1706,52849,1300
28508,71,1059,1202,692,13264,367
5846,18,596,1545,483,21375,113
21367,661,13982,1343,9528,68471,4454
6967,23,921,1531,610,26769,311
53018,53,1117,719,986,16970,131
48825,9,199,841,178,6184,21
29859,30,1218,1176,706,33862,512
48510,103,1136,850,1089,14570,47
69468,15,237,210,220,6370,17
59092,49,1695,535,1054,44795,641
11276,22,1175,1498,560,18838,615
52716,66,718,729,580,12976,138
5173,36,1410,1553,535,15606,875
24723,15639,342901,1283,211465,1666420,131436
33065,22,825,1120,450,18247,375
49239,39,659,825,483,8496,176
45652,58,790,889,630,14645,160
17732,41,1557,1407,1056,17863,501
62865,1245,23113,409,16604,152496,6509
11669,1076,44391,1495,17192,208837,27199
1154,385,17324,1593,11550,83986,5774
9448,26,1041,1511,780,13251,261
29422,50,718,1185,554,11653,164
28726,29,469,1198,270,6658,199
44657,11,234,900,142,5549,92
30149,63,1966,1170,1525,27962,441
64051,6,139,376,128,3365,11
19235,2,164,1381,122,24029,42
60894,9,92,471,42,4329,50
57990,12,170,572,141,5843,29
117,0,0,1603,0,12732,0
35383,172,2288,1070,1752,16205,536
36213,37780,847227,1050,525861,2838297,321366
51042,24,606,781,378,7733,228
18400,3,198,1395,109,3774,89
21382,68,2616,1343,1103,42377,1513
19918,417,15397,1369,10708,50271,4689
61571,3,75,448,51,6694,24
3440,8,270,1574,180,14844,90
67422,23,372,277,366,6285,6
193,45224,1481098,1602,683322,2828724,797776
58322,295,2438,560,2266,22294,172
32323,24,841,1134,574,20686,267
61856,49,493,439,429,6870,64
8993,1,172,1513,103,3404,69
10950,43,1641,1501,1083,24457,558
17091,21,337,1419,267,9264,70
4828,86,3962,1557,2961,46554,1001
34776,376,5970,1085,4474,51646,1496
8271,42,1229,1516,897,17234,332
70659,0,26,169,21,1006,5
10854,0,1828,1502,1107,49594,721
5264,91,2844,1551,2136,26846,708
61287,841,9362,456,8048,88209,1314
4099,308,13293,1567,5383,134369,7910
45113,81,749,895,579,21495,170
20077,15873,728321,1366,241922,1916761,486399
22837,1,61,1320,47,5492,14
56808,33,433,604,420,11522,13
30612,3417,67493,1161,41314,351293,26179
35843,1502,41168,1060,26358,207607,14810
11355,140,2526,1498,1649,42160,877
37445,58,775,1017,577,10346,198
47332,441,4867,868,3564,29561,1303
43207,138,1958,916,1606,19591,352
7158,3,161,1528,101,8686,60
24381,58,1566,1291,1047,46946,519
34273,162,2527,1097,1906,46573,621
29830,70,2712,1177,1857,21309,855
54799,12,116,662,101,5731,15
26042,78,1458,1255,997,13136,461
26485,36,706,1246,439,20353,267
13748,389,12710,1469,8112,143289,4598
15208,315,11341,1449,8330,48766,3011
66131,6,86,318,70,3949,16
14212,12,529,1462,281,27797,248
9458,1149,27872,1511,17785,134147,10087
23525,109,2624,1309,1908,29694,716
35049,250,5937,1079,5419,70266,518
14620,3,232,1456,130,4289,102
48047,0,41,860,26,8384,15
11789,792,21546,1494,10914,97164,10632
38028,7,91,1001,68,7074,23
24836,36,1014,1281,660,9480,354
51943,43,488,756,418,10216,70
26046,37,1388,1255,651,14573,737
4983,5,383,1555,282,6589,101
34422,193,7444,1094,4103,39160,3341
24767,163,3005,1282,1868,17181,1137
29945,14,441,1174,261,7555,180
61627,1,23,447,20,3190,3
12085,2271,64685,1491,37775,146040,26910
3201,5061,152480,1576,81102,545900,71378
62147,110,1445,428,1220,16263,225
30683,10,564,1160,177,3996,387
30190,168,4077,1169,2491,29811,1586
51141,11,315,778,261,10653,54
19927,34,1693,1368,876,22876,817
61982,35,638,435,588,17236,50
589,67,3209,1598,1919,57863,1290
35747,56,1677,1062,1263,9827,414
3220,17,889,1576,662,17380,227
29729,326,5135,1179,2750,55076,2385
68005,584,8027,258,8002,58213,25
61845,101,1037,440,963,15119,74
4014,442,8863,1568,4867,72360,3996
30229,5,156,1169,131,4080,25
22245,12,551,1330,351,7439,200
4463,798,53207,1563,23181,305045,30026
35126,424,12529,1077,6440,76013,6089
33110,1,93,1120,70,5395,23
22748,5,147,1322,97,6363,50
9739,1,232,1509,170,10829,62
2795,107,3864,1580,2776,26439,1088
21583,126,4166,1339,2858,54748,1308
59109,9,65,535,49,3561,16
10862,140,3852,1502,2527,25360,1325
25157,0,0,1274,0,9886,0
24299,5,358,1293,176,11145,182
49068,240,6380,833,1804,48360,4576
41810,105,995,938,856,12167,139
49510,9,156,820,141,7934,15
54272,196,2641,681,2153,23841,488
59105,40,305,535,197,11538,108
36499,244,1482,1041,1158,21207,324
8544,532,11336,1515,7602,64912,3734
15096,339,6996,1451,5122,63709,1874
28517,80,2100,1202,1762,14216,338
6011,44,1791,1543,1253,58548,538
49960,4,43,809,28,4970,15
14634,15,402,1456,329,18438,73
27744,42,804,1217,541,7717,263
34074,3739,98985,1101,50966,486144,48019
27823,57,1339,1215,1070,14238,269
64911,45,388,350,343,12298,45
21473,57,1778,1341,1252,11606,526
19139,8,608,1382,365,15291,243
53530,273,4142,706,3671,36109,471
34251,554,9232,1098,7286,66846,1946
29813,121,4661,1177,2315,60121,2346
25800,36,963,1260,587,32637,376
32160,6,346,1136,201,4788,145
11825,55,1832,1494,705,13859,1127
26373,1,193,1248,137,7785,56
52209,55,484,747,398,5503,86
35204,23,687,1074,544,21597,143
51591,19,232,765,215,3943,17
28551,562,14427,1202,9372,79009,5055
7714,21,609,1521,453,25153,156
24222,3183,69384,1295,35292,560200,34092
16434,84,1572,1430,1119,26987,453
33465,70,1283,1113,991,36225,292
29192,0,4,1189,3,12015,1
40767,5,86,956,55,6244,31
49771,459,6805,813,4525,86762,2280
28162,1,35,1209,32,1812,3
66476,2,130,308,129,6352,1
41531,44,934,944,643,13172,291
11964,35,943,1492,493,7268,450
18266,157,3394,1398,2346,20517,1048
64262,1346,19058,369,18137,152583,921
15761,44,889,1441,573,29441,316
16483,47,1421,1429,913,16511,508
59799,130,1307,511,1036,12510,271
56334,5,60,618,45,2765,15
23766,10,195,1304,117,10698,78
18157,20,398,1400,323,8302,75
30565,43,2702,1162,1324,22997,1378
3239,73,1549,1576,900,27813,649
18624,112,2736,1391,1933,46661,803
16575,1114,37707,1428,19117,158529,18590
34792,82,1071,1085,710,14413,361
61650,33,603,446,520,8259,83
1922,14,877,1588,664,14783,213
15620,12,347,1443,257,8154,90
33114,23,307,1120,216,5462,91
40990,411,5390,951,4145,55844,1245
25782,40,1301,1261,760,12688,541
29532,0,0,1183,0,41153,0
20177,1,133,1364,92,2809,41
58679,21,218,548,186,4633,32
20282,5,197,1362,140,6346,57
10790,5779,226928,1502,89503,934090,137425
39993,1193,19372,968,16136,119648,3236
18464,736,49151,1394,22873,95627,26278
10212,151,5001,1506,3337,69044,1664
36313,23,716,1047,637,13077,79
42416,4,128,929,83,3687,45
41141,83,2282,949,1889,53401,393
12628,57,2750,1484,1690,28601,1060
32372,714,26956,1133,12683,174599,14273
1870,64,2602,1588,1397,31970,1205
27029,185,4660,1233,2766,45081,1894
13537,23,815,1472,524,10093,291
22449,20,1055,1327,750,34311,305
54115,27,179,687,160,3435,19
15833,322,5699,1440,3161,54348,2538
52896,193,5277,722,2551,43511,2726
2609,27,556,1582,351,25928,205
14275,119,2667,1461,2212,34678,455
60215,166,2986,496,2014,21544,972
63604,43,478,390,381,7781,97
53569,56,1051,705,781,15454,270
35378,926,13944,1070,9733,175389,4211
66444,3,26,309,18,1251,8
65154,8,49,343,35,4569,14
28426,201,3667,1204,2084,19729,1583
36302,183,2184,1047,1790,24889,394
11458,68,2024,1497,1401,19370,623
34510,110,2915,1092,2213,24739,702
41135,83,1544,949,1327,32510,217
58686,21,327,548,270,4823,57
32762,4,283,1126,211,10537,72
50939,150,1970,784,1532,22387,438
67798,36,388,265,355,5013,33
41218,677,10536,947,8333,118679,2203
55326,32,412,646,378,6650,34
31108,6,58,1152,50,2719,8
43473,0,40,913,36,2637,4
28545,7631,192471,1202,109791,760636,82680
52588,0,289,734,242,5382,47
51915,212,1683,757,1425,23799,258
49664,8,148,816,118,8373,30
38715,60,1060,984,916,15787,144
30872,23,713,1156,531,4583,182
41638,239,3033,941,2418,41972,615
48877,38,411,839,328,19848,83
30749,6,175,1158,100,5672,75
59873,177,1525,508,1169,14895,356
29841,21,701,1177,415,10487,286
58168,157,2186,566,2025,30116,161
61131,2,63,462,59,3070,4
16235,268,5672,1433,4214,71686,1458
43127,696,14499,917,8288,187205,6211
10497,96,3797,1504,2411,20715,1386
29198,9,305,1189,170,7023,135
48687,170,4837,845,2636,39681,2201
56518,8,142,612,118,5564,24
25642,3866,128893,1264,71841,616254,57052
19550,3,196,1375,136,5972,60
13430,154,2005,1473,1357,17367,648
16105,1,47,1435,35,5456,12
48283,3680,74548,841,45523,507161,29025
52093,646,9868,750,8398,99805,1470
382,192,9962,1599,4613,73342,5349
31122,18,522,1152,422,11907,100
30858,12,229,1156,150,24265,79
58352,23,374,560,293,7164,81
6977,13,1262,1531,891,13438,371
39612,8,374,973,285,11705,89
7544,48,801,1523,548,11061,253
15233,3,198,1449,140,15619,58
31778,52,902,1142,677,13044,225
26164,6,129,1253,95,16836,34
53689,3611,69333,701,38026,197622,31307
51851,9,159,758,127,5118,32
34922,17,512,1082,349,11515,163
29800,282,6860,1177,2704,72028,4156
10825,157,6214,1502,3545,45559,2669
1793,22,1248,1589,942,25968,306
14047,28,1360,1464,861,10436,499
67538,8,64,273,46,2636,18
19794,10,505,1371,184,14427,321
59433,88,1565,524,1379,25579,186
9840,1472,35323,1509,23886,230145,11437
63924,37,611,380,378,11971,233
28202,1755,33225,1208,20619,98539,12606
22068,0,0,1333,0,5611,0
58153,45,573,566,495,26006,78
11697,7,289,1495,152,9944,137
26201,248,5871,1252,4009,38658,1862
29156,88,2579,1189,1705,17801,874
65670,97,1583,330,1399,9971,184
2218,63,1269,1585,827,9449,442
65155,1836,57853,343,34783,313971,23070
1655,43,2211,1590,1352,43720,859
53338,26,306,711,255,4467,51
29423,0,0,1185,0,11737,0
15005,71,967,1452,602,10874,365
25729,2,99,1262,67,8196,32
15151,27,1848,1450,1200,25251,648
38009,1118,16912,1002,15189,120237,1723
4205,21,395,1566,291,17290,104
8082,28,2225,1517,1388,24416,837
28602,57,1403,1201,923,25955,480
54512,27,314,673,258,5540,56
1131,104,3850,1593,2549,78504,1301
12468,813,17910,1486,10854,116787,7056
59421,13,147,524,115,8509,32
68596,38,689,235,382,11067,307
56,91,4212,1604,2549,24606,1663
10073,1079,21109,1507,13953,106924,7156
60726,24,256,474,215,5215,41
1934,101,2263,1588,1591,35015,672
24489,83,3021,1289,1947,20851,1074
1025,61,3100,1594,1590,46479,1510
14065,533,14490,1464,10992,133110,3498
55632,487,8533,638,7152,59879,1381
24691,0,0,1284,0,2426,0
1022,480,26934,1594,16501,96195,10433
27991,60,980,1212,810,41671,170
35929,1317,24723,1058,19181,162531,5542
51928,7,91,756,78,3076,13
8735,24,1226,1514,765,13752,461
12816,6,596,1482,240,5814,356
1483,68,2852,1591,1997,51122,855
27118,41,583,1231,541,22682,42
4225,4,111,1566,73,13047,38
56260,28,337,620,314,10695,23
53812,85,706,698,524,9522,182
10254,814,24073,1506,12891,80115,11182
63836,21,416,383,328,14066,88
59987,24,461,505,420,10380,41
55374,23,317,645,260,14484,57
26556,3437,91259,1243,39490,264379,51769
51061,29,219,780,197,8908,22
39320,115,1538,976,1234,11999,304
36746,399,5138,1037,3882,25391,1256
18219,87,3003,1398,2224,89965,779
24203,3,336,1295,100,19195,236
61505,5,79,450,71,3793,8
34646,11,490,1089,316,5501,174
34238,12,548,1098,325,11880,223
7153,60,1855,1528,1149,39068,706
434,11,246,1599,165,30125,81
62342,5,18,423,18,3357,0
24335,489,9948,1292,5670,100222,4278
52958,33,416,721,330,5366,86
22490,3,78,1327,62,5953,16
64589,129,2526,360,736,14855,1790
23987,1355,35004,1300,17512,182942,17492
39021,169,2882,980,2169,23139,713
40882,19,447,954,342,8666,105
18336,469,9594,1397,6174,43935,3420
49459,217,2988,822,2621,33372,367
53977,83,3649,692,2248,43411,1401
48845,7,106,840,88,19678,18
62115,2,39,430,38,3414,1
65957,28,364,323,294,12928,70
304,15,621,1600,455,17531,166
21059,1492,32272,1348,26365,265575,5907
3564,59,4342,1573,2458,54361,1884
29033,0,0,1192,0,3781,0
9994,306,9000,1507,4808,74295,4192
19894,343,17682,1369,8935,55773,8747
25594,127,2868,1265,2012,52133,856
33233,259,5733,1117,4547,60278,1186
53821,7,112,697,66,4153,46
3386,82,4523,1575,3223,100603,1300
24505,79,3691,1288,1847,23313,1844
49584,19,320,818,248,8901,72
27952,23,825,1212,621,16945,204
50614,199,2320,792,2212,56028,108
53476,100,1170,708,983,21821,187
50921,166,2430,784,1776,26962,654
805,11,345,1596,216,10028,129
60476,10,120,487,103,6586,17
26081,54,5510,1254,1418,19580,4092
26586,7,446,1243,274,8202,172
53021,304,4519,719,2989,55210,1530
57469,93,1787,588,1202,16816,585
64984,21,156,347,145,3947,11
26338,90,7612,1249,4413,29582,3199
8216,591,16067,1516,7799,78281,8268
23842,60,2786,1303,1640,28383,1146
16081,948,18835,1435,15125,174871,3710
5324,169,3676,1551,2538,40416,1138
35873,21,559,1059,446,14118,113
2072,82,3405,1586,2119,30712,1286
40999,45,932,951,826,13912,106
60610,24,448,482,389,8277,59
60438,923,12755,489,10503,59896,2252
8303,2608,56623,1516,38991,163772,17632
24264,801,17988,1294,11658,93934,6330
23788,74,3095,1304,1730,59227,1365
60078,12,138,502,136,8964,2
59514,19,327,521,191,7947,136
18939,6,274,1386,184,9592,90
3640,4,364,1572,223,17143,141
7049,13,396,1530,240,16974,156
48908,2,36,838,33,1849,3
48579,61,602,848,499,9885,103
19454,141,6292,1377,2785,35974,3507
68727,18,201,234,166,6220,35
38191,234,6159,997,4812,38290,1347
50339,1030,11381,797,8291,131932,3090
35315,12,632,1072,449,8255,183
24822,16,393,1281,277,10748,116
28004,21,1105,1211,461,6125,644
24817,18,793,1281,634,23055,159
36742,367,8495,1037,5220,52756,3275
42772,39,891,923,716,18447,175
34174,8,101,1099,88,9516,13
10926,1,28,1501,23,12511,5
22431,85,2981,1328,2061,34089,920
10667,117,4512,1503,2658,23005,1854
64530,20,287,362,248,6134,39
8206,112,3956,1516,2561,13793,1395
32370,94,2187,1133,1451,16935,736
9618,151,5751,1510,3545,55363,2206
50180,36,394,803,340,9073,54
33130,576,12951,1119,9145,73886,3806
40638,36,347,957,268,4992,79
57683,62,727,582,687,9819,40
34880,13,388,1083,278,18126,110
60941,157,2528,469,2357,46758,171
66713,2,57,300,45,4280,12
31506,189,2673,1146,1573,14050,1100
62984,2,30,406,24,3972,6
33824,53,1143,1106,776,10332,367
4919,5,224,1556,149,9836,75
40448,7,228,960,192,7784,36
34385,107,1982,1095,1080,21325,902
18136,8,513,1400,395,34857,118
20659,10,347,1356,264,11653,83
3965,35,1513,1568,1037,32012,476
26688,108,2924,1240,1961,18534,963
43967,197,2741,908,1739,31487,1002
6319,205,5729,1539,3428,35999,2301
13891,80,2738,1467,1418,45468,1320
8348,1651,58818,1516,27809,125594,31009
10205,58,2342,1506,1137,22413,1205
29673,466,6924,1181,5152,43409,1772
61622,99,1715,447,1621,24831,94
35855,23,519,1060,403,15256,116
33469,119,2670,1113,1757,29294,913
14154,15,543,1463,400,9241,143
26264,49,1280,1250,653,10146,627
59171,664,11638,533,9266,91758,2372
40036,78,886,967,827,13370,59
14303,43,2613,1461,1343,26216,1270
44557,1873,26991,901,21036,245416,5955
69739,16,214,201,157,4498,57
501,22,935,1599,707,27409,228
444,69,2201,1599,1570,50330,631
46681,34,797,876,672,19719,125
64621,7,318,359,106,7937,212
6957,30,1070,1531,788,30625,282
491,5,398,1599,236,27944,162
55500,125,2044,642,1261,20058,783
32343,6,186,1134,123,2740,63
33244,61,1790,1117,1284,23222,506
52346,93,1472,742,984,20720,488
64848,4,63,352,57,2748,6
31091,139,2756,1152,1795,20401,961
20159,330,10664,1364,6042,95973,4622
55259,33,536,648,506,37195,30
3332,19,885,1575,387,18789,498
26187,145,3917,1252,2774,23623,1143
49786,20,363,813,306,8790,57
3060,101,2046,1578,1424,23776,622
66299,837,10124,313,9760,92737,364
54865,5,15,659,10,2286,5
41253,288,3605,948,2527,23283,1078
18220,166,6917,1398,4813,110364,2104
16613,14,795,1427,171,13248,624
21307,355,9961,1344,6680,70026,3281
19744,8,545,1372,446,25144,99
62492,9,139,419,103,3901,36
25908,129,1856,1258,1123,14439,733
46914,0,0,874,0,4301,0
30386,169,2678,1165,1883,37300,795
35230,13,127,1074,82,3159,45
56962,860,12865,600,11733,163470,1132
56758,2577,63106,606,38721,373684,24385
62508,129,1649,418,960,16089,689
40953,1403,24404,952,20849,218215,3555
69095,26,209,221,176,3845,33
55606,4,45,639,41,2093,4
10136,49,1325,1507,838,7971,487
49963,6723,117191,809,89241,420968,27950
35352,113,3978,1071,2711,46103,1267
5289,18084,725884,1551,337288,1187395,388596
2877,222,5694,1579,4151,25094,1543
61689,72,1046,445,931,9890,115
12759,21,581,1483,345,20155,236
8191,23,713,1516,493,7821,220
56296,24,386,619,278,7054,108
25955,26,825,1257,545,14217,280
13001,0,0,1479,0,11213,0
33545,120,2320,1111,1783,49103,537
13058,372,25015,1478,12527,60226,12488
4653,13,396,1560,268,17145,128
57151,95,2224,595,1874,32047,350
43133,0,0,917,0,14656,0
1167,6271,171727,1593,120152,609137,51575
26679,1787,55051,1240,33864,340478,21187
31348,29,1161,1148,639,7124,522
54185,615,6006,685,4909,51945,1097
14442,4,160,1458,94,15154,66
16388,14,692,1430,360,10662,332
13875,332,11085,1467,7205,95648,3880
48899,7,79,832,70,5783,9
13228,71,2699,1476,1410,31717,1289
12864,1271,68995,1481,32277,262371,36718
4914,37,1885,1556,1217,10001,668
1903,17,428,1588,311,10122,117
26931,174,6941,1235,3886,40053,3055
57107,22,236,596,152,5320,84
40923,24,694,953,537,6998,157
24027,1,117,1299,75,5647,42
50665,2,92,791,78,3436,14
33116,58,565,533,480,8368,85
61671,2,25,445,21,3287,4
13072,61,2541,1478,1491,11249,1050
56889,8,98,602,87,4371,11
53644,54,640,702,451,13364,189
26195,25,615,1252,437,17652,178
54871,44,648,659,461,11339,187
34292,32,884,1097,607,6300,277
58658,25,392,549,321,6935,71
58282,8,119,562,94,5645,25
5409,130,4982,1550,3327,32573,1655
31015,1,47,1153,39,5888,8
1056,18,1398,1594,969,14191,429
23748,413,6440,1305,4554,67852,1886
15121,72,3632,1450,2203,37571,1429
49203,49,950,829,702,32477,248
34398,18,384,1094,214,8752,170
16197,2005,40776,1434,27754,191087,13022
53599,8,75,704,60,4850,15
58983,420,8443,529,5680,86614,2763
23453,30,1807,1310,820,15171,987
35561,218,4084,1066,3576,16461,508
23379,6,344,1311,233,20903,111
7228,117,3618,1527,2271,34251,1347
7346,17,564,1526,312,16333,252
65956,8,179,323,177,12639,2
59921,24,447,507,386,14104,61
5091,51,2203,1554,1328,33213,875
1088,199,7418,1594,4277,48638,3141
17701,55,2084,1408,1466,25097,618
26292,1,36,1250,33,6201,3
14013,344,7488,1465,4652,64500,2836
31969,23,462,1139,383,11177,79
20754,19,776,1354,614,17682,162
3574,1608,33585,1573,21201,186273,12384
9143,21,610,1512,356,11942,254
36117,895,11187,1052,8166,87905,3021
4086,1438,20087,1567,15771,159433,4316
2772,176,6439,1581,3322,102953,3117
64458,35,534,363,466,9368,68
58378,587,15059,558,9986,80624,5073
56880,190,2887,602,2808,48021,79
61905,12,189,437,160,6247,29
6384,143,3318,1538,2217,69697,1101
59711,16,125,514,95,4656,30
59768,7,180,512,153,5698,27
3592,3349,282312,1573,114523,2651968,167789
22857,37,616,1320,385,5140,231
46552,31,490,878,422,13153,68
36535,1192,18097,1040,13218,118890,4879
63404,160,2315,395,2116,29081,199
45807,2198,98508,886,41700,549478,56808
55988,1487,19937,603,16281,147641,3656
51932,76,925,756,695,10655,230
8533,2525,157379,1515,61943,512534,95436
13698,75,3078,1470,1369,25798,1709
50705,18,190,790,163,7340,27
41947,339,9667,936,7335,81969,2332
26119,11,448,1253,303,25036,145
14369,14,503,1460,400,18697,103
39962,234,3154,968,2821,36879,333
10669,0,410,1503,235,8964,175
59556,667,16045,519,13749,112801,2296
8810,158,7763,1513,3672,44440,4091
17927,20,675,1403,514,8261,161
19587,442,6124,1374,4069,52557,2055
67894,0,10,262,8,1557,2
53546,369,3405,706,3100,20270,305
39863,174,2109,970,1875,17361,234
59786,43,333,511,319,7099,14
43204,107,1859,916,1330,32692,529
1150,25,413,1593,337,16912,76
55992,137,2270,628,1870,22204,400
13667,3721,125007,1470,76404,737441,48603
25956,596,15690,1257,7128,61977,8562
31231,134,4675,1150,3858,33438,817
1144,110,2836,1593,2327,21264,509
25332,0,0,1270,0,5933,0
11416,187,6124,1497,3911,47436,2213
10240,352,5464,1506,3662,65276,1802
26812,31,1085,1237,781,13947,304
692,435,11804,1597,7748,46627,4056
31949,86,2813,1140,1766,26535,1047
31061,891,22261,1152,12239,118931,10022
29973,146,3103,1174,1317,23530,1786
34194,36,877,1099,560,18306,317
63099,24,425,403,415,6270,10
34521,15,298,1092,267,4144,31
5375,34,679,1550,451,18513,228
10456,3528,114875,1505,67231,663050,47644
23935,109,1899,1301,1255,36810,644
66124,583,10328,318,9395,76016,933
57881,23,420,575,337,9667,83
1718,190,10447,1589,5706,75264,4741
58359,1237,13981,559,12145,71023,1836
16653,21,293,1427,245,14715,48
29385,116,3265,1185,1875,27273,1390
66145,2,32,317,25,2226,7
26874,1064,38823,1236,21739,307597,17084
15323,5,143,1448,102,12095,41
58771,51,1599,545,983,33650,616
60380,12,272,491,210,10754,62
13577,4,207,1471,94,7661,113
11706,36,1612,1495,683,14478,929
8197,589,36828,1516,12588,149825,24240
37222,87,2305,1023,972,18393,1333
46453,40,655,880,499,23366,156
21595,176,5069,1339,3328,31576,1741
35466,27,504,1068,322,12868,182
1731,1999,47189,1589,31759,124866,15430
9564,7,242,1510,151,8493,91
67535,6,103,273,95,4883,8
20478,20,765,1359,516,13473,249
14353,10073,184738,1460,116308,578205,68430
37343,271,6156,1020,5336,40856,820
30490,25,799,1163,554,17050,245
53290,71,1041,712,872,10145,169
47747,28,292,863,270,11808,22
38991,4,41,980,36,11874,5
19600,16,684,1374,399,14386,285
52556,664,13139,734,6676,90737,6463
13386,2417,97465,1474,58778,439092,38687
39731,12,114,971,110,4764,4
37172,17,249,1025,185,9083,64
12601,122,6408,1485,4471,55499,1937
32543,108,2222,1115,1090,30995,1132
39190,17818,473089,978,298793,1103042,174296
4698,70,1969,1559,1483,34662,486
58030,21,401,570,353,13341,48
35305,4002,82436,1072,56693,362533,25743
9678,6,233,1510,156,14636,77
69240,540,8570,216,8546,104373,24
70232,29,439,184,398,6076,41
23832,641,38996,1303,6590,102348,32406
16224,155,3086,1433,1770,14444,1316
12826,12,890,1482,508,24677,382
13551,3045,78456,1471,49607,324118,28849
50105,95,1346,804,1162,11131,184
59877,33,419,508,384,11991,35
61530,342,4166,450,4021,49611,145
47819,51,858,862,665,9315,193
35083,10,271,1078,152,4790,119
20522,7,713,1358,564,10738,149
28702,6,132,1198,83,11077,49
57962,197,2509,573,2312,29887,197
3109,3,93,1577,78,9615,15
37025,10,399,1029,314,6643,85
60500,20,134,486,130,4506,4
51938,183,1897,754,1581,25880,316
51886,1295,15237,757,11122,74834,4115
45500,1287,70504,891,17671,278026,52833
56144,14,178,623,156,7687,22
32292,51,1217,1134,746,8462,471
63125,12,359,402,282,8361,77
29328,227,7838,1186,3810,31804,4028
47,1799,126302,1604,50694,497263,75608
26814,182,2590,1237,1593,20366,997
33471,57,1330,1112,861,13554,469
64898,16,261,350,173,4334,88
11520,1007,25092,1496,14322,120488,10770
29691,9,211,1180,121,6759,90
21294,161,9615,1344,3588,116392,6027
37571,11,231,1013,179,11434,52
15513,1021,15468,1445,10188,77680,5280
11885,19,592,1493,286,15117,306
5762,71,1396,1546,873,15921,523
20824,5,159,1353,126,5776,33
34502,118,3796,1092,2914,44439,882
50286,5,48,800,48,4338,0
55767,672,8929,634,6487,61717,2442
68036,22,547,257,479,7665,68
12629,2975,104652,1484,54675,492789,49977
34821,77,2423,1084,1479,25834,944
25089,5,429,1275,281,18270,148
67282,4,36,281,32,4726,4
1529,19,541,1591,394,17525,147
4139,1503,51552,1567,29537,224993,22015
636,9,477,1597,361,13429,116
37849,70,634,1006,552,7504,82
7680,14,562,1521,431,33038,131
68479,26,374,242,303,5610,71
65125,68,1140,343,1034,17774,106
1639,100,2931,1590,1501,63581,1430
13638,3795,181916,1470,82852,695795,99064
48289,840,18144,856,15219,99275,2925
20280,136,2964,1362,1792,32978,1172
52293,1,39,744,29,5410,10
35821,70,2360,1061,1767,35882,593
29178,71,2375,1189,1725,58182,650
58300,75,651,561,619,14371,32
32332,142,2285,1134,1739,26119,546
2418,221,7728,1583,5687,36009,2041
13531,9242,347603,1472,153229,1209450,194374
61090,3,65,464,62,3466,3
19462,9,158,1377,91,7835,67
31006,33,1586,1153,1211,21871,375
20524,69,1169,1358,817,22990,352
60611,7,92,482,61,4790,31
14600,33,742,1457,528,22472,214
15501,3555,133807,1445,59973,348857,73834
14514,133,2144,1458,1442,23129,702
52860,40,418,724,309,8155,109
1316,14,232,1592,169,13795,63
63077,24,809,401,263,8719,546
21569,176,2934,1339,2595,43483,339
45219,19,263,894,211,4641,52
39898,12,365,969,255,6865,110
19467,71,3540,1377,2572,31788,968
25520,30,748,1267,329,12867,419
42552,349,6825,927,5873,58310,952
4393,14,168,1563,98,5394,70
32784,0,35,1126,27,3351,8
16179,376,10645,1434,5706,75063,4939
62010,99,2112,434,1828,22597,284
17122,68,1982,1419,1488,19129,494
17586,34,1157,1410,689,10578,468
16096,11312,352516,1435,137680,1825291,214836
40425,2673,28920,961,27645,129619,1275
19058,46,822,1384,607,6760,215
8765,36,1179,1514,732,14897,447
4279,4,92,1565,64,17732,28
60361,29,395,491,366,9079,29
53179,219,3499,714,3188,26054,311
37045,46,723,1029,615,10067,108
38388,37,657,992,582,11232,75
49163,7,109,830,81,3979,28
21582,41,1166,1339,747,16366,419
14827,130,2170,1454,1557,68364,613
16098,119,1727,1435,1047,30134,680
53160,132,1382,715,953,15292,429
13384,13,549,1474,241,10298,308
243,187,7487,1601,5240,56379,2247
53497,5,90,707,81,4887,9
26330,35,815,1249,661,9846,154
52811,130,2151,726,1585,21153,566
64969,4,47,348,37,7854,10
8310,7,158,1516,99,5531,59
59338,15,449,527,294,15914,155
9811,165,4250,1509,3353,31349,897
28271,105,3158,1207,2181,20612,977
30820,102,2474,1157,1245,22764,1229
40328,25,456,963,286,10026,170
11378,95,3061,1498,2010,35735,1051
61621,925,25645,447,19165,254669,6480
9540,533,8568,1510,5333,43916,3235
20896,6,105,1351,83,5714,22
36738,3333,90528,1037,40697,474090,49831
32090,411,8694,1137,5225,33067,3469
67660,58,962,269,891,19837,71
25946,827,17725,1257,10414,143764,7311
66410,9,205,310,144,5305,61
45751,177,2137,888,1622,17179,515
29025,1635,50485,1192,19457,218654,31028
15307,1179,28312,1448,17726,168111,10586
40216,5400,81355,964,63326,484335,18029
8630,8,775,1514,509,17215,266
33558,42,926,1111,763,29509,163
9888,137,2562,1508,1483,35363,1079
19980,2,83,1367,66,4951,17
23514,6,271,1309,197,10062,74
56735,103,1001,606,769,10807,232
61074,16,266,464,215,4225,51
9699,11,301,1509,193,4521,108
25143,172,2392,1274,1554,15512,838
7873,37,1588,1518,1114,21340,474
13975,17,755,1466,411,8130,344
66706,874,28709,300,12005,120250,16704
25801,21,404,1260,267,14218,137
20583,162,3956,1357,2873,33814,1083
473,25,1324,1599,931,33622,393
24116,1555,25666,1297,19126,68826,6540
54028,144,2137,690,1862,49664,275
12294,0,0,1489,0,7980,0
36328,1364,26823,1045,24095,184627,2728
33650,428,15634,1109,11136,109244,4498
5344,9,345,1551,266,13634,79
8922,2263,84162,1513,31706,317677,52456
19000,0,0,1385,0,6365,0
35960,101,1615,1057,1338,8345,277
12899,6,205,1481,105,5474,100
22145,19,772,1332,553,15589,219
55785,100,851,634,747,12789,104
17369,7,536,1414,386,15214,150
64107,1,17,374,16,1678,1
41579,486,4460,943,3676,23554,784
38430,34,344,991,298,5868,46
58318,13,93,560,79,5021,14
12973,15,1149,1480,557,17479,592
17138,61,3852,1418,2175,17249,1677
15227,48,2303,1449,1310,63411,993
5228,20,432,1552,340,15561,92
20571,167,8413,1358,5168,79907,3245
15810,629,22409,1440,15974,377774,6435
8809,22,763,1513,518,13558,245
15147,425,6509,1450,4729,48242,1780
31908,86,3478,1140,2260,52663,1218
22585,11,392,1325,271,6339,121
17269,12,304,1416,250,25070,54
16852,170,6003,1423,3759,30856,2244
42950,7,172,920,136,4930,36
50375,99,2088,798,1659,32760,429
9688,310,8433,1509,5146,32308,3287
66245,1014,12369,314,11504,90072,865
64224,10,90,371,76,4276,14
40776,8,237,955,203,3317,34
17246,75,1911,1416,1322,20958,589
39858,51,1098,970,969,13694,129
34990,28,392,1080,341,16130,51
35948,94,1409,1057,1074,20237,335
21701,2230,54105,1337,25743,371749,28362
21193,169,5372,1346,4497,51122,875
37924,0,34,1005,27,18340,7
30480,46,1177,1163,658,7194,519
59631,43,474,517,403,10518,71
9324,71,1409,1511,895,32687,514
29933,85,932,1175,512,12286,420
19297,380,6904,1379,3831,68197,3073
12838,36,2517,1482,1208,26928,1309
21296,5,147,1344,108,5787,39
28983,28,923,1193,608,16291,315
9261,36,1189,1512,749,22717,440
50699,8,57,790,45,3868,12
50,42,1378,1604,992,46703,386
17966,102,2994,1403,1466,20665,1528
24400,10,179,1291,125,9266,54
32474,14,411,1131,293,11827,118
58865,219,5175,543,3538,32259,1637
23938,0,0,1301,0,13359,0
25200,188,3081,1273,2302,22097,779
10865,7,402,1502,240,7993,162
9420,221,6107,1511,3538,37015,2569
55917,95,1128,630,940,12701,188
11595,48,2114,1496,1350,20000,764
62678,47,508,413,424,7871,84
62600,1,53,416,35,2724,18
66612,3811,77234,303,74675,374991,2559
23511,50,2077,1309,1566,42373,511
50161,49,731,803,595,22758,136
30413,22,471,1165,307,4426,164
49565,67,1575,819,1413,62544,162
24993,31,1157,1277,741,16403,416
17367,10,265,1414,200,5926,65
59660,116,1451,516,1339,18116,112
1586,26,1458,1590,824,21527,634
29887,220,6247,1176,4687,58483,1560
40811,9,110,955,89,4412,21
27198,435,17695,1229,9992,111465,7703
52508,4,79,736,56,5488,23
1671,44,1150,1590,795,36969,355
51753,81,889,761,739,16783,150
6393,183,6066,1538,4239,37169,1827
27582,14,460,1220,323,10425,137
30101,39,822,1171,551,21208,271
34807,8,164,1085,115,3336,49
16906,152,4356,1422,2908,59796,1448
59935,619,16280,506,13698,87975,2582
49469,28,299,821,181,10472,118
14832,4,236,1454,154,5053,82
20099,12,480,1365,378,19102,102
2328,7,186,1584,145,19696,41
35510,148,2152,1067,1253,16483,899
55888,75,1366,631,1020,15091,346
5213,13,355,1552,305,19161,50
45874,5,132,887,100,4838,32
31781,11,264,1142,185,3015,79
37964,12,241,1003,215,8481,26
51878,13,231,757,206,5648,25
27932,59,1383,1213,669,20166,714
15139,111,2031,1450,1384,16778,647
38031,18,315,1001,183,15413,132
37809,14,287,1007,244,9909,43
14783,31,929,1455,537,19702,392
49246,947,39903,827,14268,255500,25635
29029,42,784,1192,544,8690,240
15241,9,450,1449,302,25589,148
58443,5250,159081,556,93932,626662,65149
17976,130,3335,1402,2159,22866,1176
62954,43,259,407,252,4817,7
34008,6,317,1103,193,19921,124
63977,6,108,378,83,5726,25
66408,1155,31838,310,21405,200427,10433
28089,18,322,1210,247,8806,75
8686,56,1842,1514,1055,13455,787
16396,2,43,1430,26,5012,17
55646,13,102,637,102,13121,0
57649,74,1168,583,1131,26957,37
7722,180,4682,1521,4022,35079,660
1635,18,444,1590,320,20664,124
6360,5,134,1539,100,6094,34
7320,20,461,1526,340,21128,121
20314,23,451,1362,307,10858,144
49621,2,59,817,50,5482,9
18669,7,147,1391,101,18438,46
38362,1368,33359,993,12571,249463,20788
65425,12,143,337,124,7610,19
56126,1911,20640,624,17584,103932,3056
21541,96,5839,1340,2418,101641,3421
11696,52,3862,1495,1277,13468,2585
28225,175,5001,1208,3285,37310,1716
33178,15,414,1118,292,7272,122
68127,108,2807,255,1870,28615,937
38517,11,147,989,119,2249,28
3469,34,764,1574,612,18882,152
8017,1,160,1517,93,12081,67
67966,344,2999,259,2639,17866,360
24151,111,1631,1296,1041,14446,590
65045,282,3674,344,2792,66760,882
8576,41,2245,1515,1368,46415,877
9077,28,900,1512,647,16370,253
21978,12,310,1334,156,4299,154
54293,85,2198,681,893,16670,1305
5490,237,6663,1549,4379,69107,2284
24949,7,223,1278,146,12927,77
54136,7,34,686,32,4400,2
58262,196,1314,562,1215,29238,99
32833,185,2811,1125,1927,25395,884
30124,132,2268,1170,2081,17486,187
36711,41,823,1037,640,8736,183
53608,394,4977,704,3835,105669,1142
17032,10,182,1420,152,11999,30
13185,339,11141,1477,6810,63365,4331
33051,102,2562,1121,1804,25717,758
8741,3417,137878,1514,62977,345201,74901
63491,31,315,393,272,9737,43
41629,473,5958,941,5286,62218,672
10958,1302,38614,1501,24066,182158,14548
35841,44918,738439,1057,462201,2986518,276238
31213,31,610,1150,414,14114,196
17382,24,1235,1414,867,13386,368
15123,17644,578678,1450,302198,2282750,276480
54872,214,3753,659,1975,39171,1778
37750,2,41,1009,33,4575,8
37283,33,1019,1021,806,29456,213
30118,7,444,1171,275,15805,169
29382,3,204,1186,138,3868,66
14731,7,112,1455,84,7470,28
25009,28,1448,1277,977,25633,471
7176,4,107,1527,83,8305,24
14869,154,6895,1454,4442,70314,2453
10332,218,7367,1505,4428,34064,2939
62018,7,75,433,64,3474,11
62400,4,91,421,59,3453,32
223,303,12690,1601,7152,56927,5538
12662,3,336,1484,167,12134,169
25333,0,0,1270,0,9642,0
10799,42,1327,1502,854,42573,473
58584,32,502,551,338,9721,164
32747,270,6873,1127,4095,46291,2778
27279,30,640,1228,411,12035,229
36733,32,492,1037,426,7097,66
28094,6,388,1210,250,6953,138
31748,51,988,1142,794,20620,194
54072,4,25,688,23,3253,2
22330,6946,201814,1329,107830,944950,93984
29764,2,48,1178,40,7225,8
49834,1808,56354,756,28755,260687,27599
11277,267,15688,1498,8434,163145,7254
29174,8,255,1189,181,11306,74
18193,12,573,1399,416,17562,157
5353,11,881,1550,588,23562,293
35808,23,468,1060,390,22939,78
64828,23,259,353,242,3533,17
40720,35,542,957,468,6762,74
24340,2124,53395,1292,29182,279402,24213
4432,238,3883,1563,2329,43748,1554
9806,24,422,1509,186,8764,236
29163,39,1774,1189,913,18112,861
36593,167,3016,1037,2416,18325,600
13292,290,14827,1476,7980,73822,6847
50361,48,557,798,412,7774,145
12744,272,8363,1483,5330,57161,3033
55253,23,237,648,214,9828,23
35115,227,3613,1077,3083,65934,530
35714,329,7747,1063,6423,49713,1324
8256,352,7672,1516,4761,32736,2911
14157,9727,173987,1463,93232,499924,80755
66532,2,42,306,35,3579,7
23900,169,3720,1302,2283,46591,1437
30606,31,736,1161,394,12099,342
44712,25,218,899,150,7165,68
27509,143,4227,1222,2677,91337,1550
56597,69,1387,610,1155,13195,232
21248,31,485,1345,329,6561,156
2231,337,7856,1585,5708,84698,2148
15575,44,1425,1444,797,20425,628
25,174,12600,1605,7136,84922,5464
37176,178,1157,1025,980,15817,177
7547,6,276,1523,175,13657,101
29996,110,5040,1173,1823,41087,3217
9929,412,11953,1508,6726,72236,5227
29153,15,1168,1189,684,17498,484
49052,20,569,833,440,26442,129
25455,35,815,1268,533,10122,282
27018,127,3631,1233,2772,132887,859
7799,5,122,1519,79,6016,43
41599,499,7922,942,5853,44250,2069
17286,38,1356,1416,945,24991,411
51682,2719,52600,763,28983,401316,23617
37728,47,650,1009,541,16154,109
7901,7804,186796,1518,110063,411941,76733
67355,5,92,279,82,2605,10
58238,85,1259,563,1231,35877,28
26261,8596,260661,1250,134909,876998,125752
61492,5,34,451,30,3035,4
25971,691,18038,1256,9974,134828,8064
49,104,3417,1604,2022,51570,1395
19660,12188,428786,1373,205517,1062261,223269
57395,137,2111,589,1964,41189,147
22720,3,214,1322,161,6084,53
50498,17,245,795,199,8075,46
48271,486,7289,856,6110,50945,1179
36001,3,99,1056,78,8304,21
947,164,4837,1595,2963,31376,1874
56203,34,323,622,296,4378,27
15077,4,715,1451,506,30244,209
36998,5,91,1030,83,5781,8
34475,2372,33412,1093,27864,172971,5548
65654,1,29,331,23,3115,6
33139,3,31,1119,29,1993,2
38338,4,183,994,134,8553,49
22324,231,3991,1329,2847,28038,1144
52810,159,1848,725,1538,17615,310
4034,905,37953,1568,22931,197870,15022
61929,926,174688,432,36128,208051,138560
31605,21,794,1145,521,12437,273
26538,66,1021,1244,690,14043,331
42666,22,615,925,563,30604,52
28062,173,2015,1211,1318,20839,697
62907,1,30,408,26,5069,4
59642,15,457,517,314,9013,143
66160,880,13809,286,8956,179252,4853
31794,18,324,1141,228,8341,96
27312,0,100,1227,70,5365,30
66069,6,71,320,69,2334,2
63665,8,95,388,79,2762,16
63423,375,17828,395,9261,79148,8567
45470,20,868,889,649,10324,219
6571,35,1106,1536,863,42825,243
17871,29,789,1404,544,12412,245
13495,11,440,1472,263,6126,177
9331,931,29404,1511,19959,159010,9445
33230,14,245,1117,173,16599,72
30778,44,1055,1158,791,29076,264
26213,3,88,1252,59,2950,29
21976,117,2373,1334,1713,21281,660
8109,27,433,1516,315,7128,118
66566,15,227,304,198,10603,29
43055,1265,23474,918,20457,80427,3017
60803,63,995,474,743,18178,252
59205,7,148,532,129,24576,19
60214,16,174,496,162,4630,12
33336,26,705,1115,394,19029,311
48205,6,83,857,78,6216,5
18747,30,635,1389,456,7738,179
55344,61,876,646,763,9528,113
28801,9,577,1197,349,13537,228
18277,288,12264,1398,8558,79679,3706
14529,21,720,1457,551,10912,169
15202,51,1186,1449,695,13544,491
44141,6,202,906,155,11848,47
24754,4,192,1282,127,6662,65
65804,86,736,327,635,10221,101
22365,121,1161,1329,777,9863,384
4303,11,496,1565,383,14257,113
17202,4254,84013,1417,50245,254256,33768
32162,6,410,1136,216,7396,194
1623,29,965,1590,601,13710,364
12145,86,2782,1490,1779,53850,1003
46518,9547,265859,879,129580,653700,136279
30644,5,183,1161,154,7137,29
40006,18,331,967,251,6925,80
50274,244,4070,800,3734,24273,336
861,38,2518,1595,1090,37332,1428
38856,69,1229,982,850,20838,379
66401,0,39,310,33,2199,6
55211,69,679,650,598,13938,81
923,30,1090,1595,841,37909,249
9318,556,35033,1511,17511,208711,17522
44308,123,1489,904,1343,13214,146
17942,11,408,1403,301,15279,107
8898,149,9731,1513,4670,115410,5061
12783,4,364,1482,176,6945,188
6586,7,274,1535,141,3900,133
23164,2790,84575,1315,57132,415650,27443
29483,27,669,1184,488,13646,181
55550,6,64,640,53,7375,11
34242,3,30,1098,24,2319,6
13227,52,1722,1476,1146,22691,576
51874,110,915,758,826,14294,89
11015,21,616,1500,353,45763,263
51722,84,1907,762,1265,22180,642
43881,6,168,909,110,3454,58
38953,4,61,981,54,14025,7
57128,12,117,596,115,5488,2
27927,112,2442,1213,1550,8568,892
15529,4021,117172,1444,70624,785454,46548
27385,51,911,1225,585,22734,326
24771,13,867,1282,503,8609,364
4599,7,255,1560,196,8383,59
31665,6488,273343,1144,107266,827793,166077
29168,241,3571,1189,2480,39813,1091
49411,30,311,823,237,6072,74
58466,233,2881,555,2578,29645,303
55591,13,237,639,156,14793,81
22650,6669,124132,1324,70988,743347,53144
51117,31,145,779,130,8004,15
13867,74,1342,1467,777,10117,565
7900,11,714,1518,579,19642,135
38528,22,432,988,261,6126,171
29791,12789,361362,1178,185629,1118303,175733
35194,23,419,1075,304,9939,115
28081,219,4027,1210,2040,210900,1987
27205,64,2156,1229,1383,21795,773
40631,38,951,958,674,21072,277
38357,5,144,993,101,5683,43
46147,4,66,884,54,4206,12
18786,34,760,1389,438,8766,322
11853,7,582,1493,237,8407,345
15148,74,1825,1450,1399,20658,426
48700,26,325,844,262,13370,63
31696,89,1350,1143,796,23561,554
4425,27,608,1563,505,25023,103
26950,63,1780,1234,1403,71494,377
19788,379,9952,1371,6313,118671,3639
24576,55,644,1287,596,42972,48
7012,95,2752,1530,1777,89055,975
25470,0,0,1268,0,24858,0
55174,25,212,651,186,3540,26
43673,1367,24706,911,14771,171198,9935
19366,46,1112,1378,918,39120,194
3416,63,1226,1574,852,15399,374
35155,1330,49903,1076,16645,163658,33258
20471,11,271,1359,214,12514,57
30867,45,833,1156,526,8071,307
14551,38,974,1457,711,42844,263
12059,14,760,1491,378,20781,382
64423,20,183,364,145,5863,38
10094,33,836,1507,575,15307,261
14426,87,1480,1459,1027,13863,453
34400,261,6180,1094,4102,99251,2078
44039,24,344,907,240,4749,104
57736,3,39,580,34,1708,5
62775,145,2510,411,1264,37473,1246
32349,38,901,1133,504,18770,397
67661,26,432,267,283,13483,149
34769,23,975,1085,540,24714,435
42566,47,989,927,748,25666,241
21576,837,18979,1339,7060,183788,11919
66873,0,18,295,17,2062,1
52220,0,20,746,17,3557,3
5994,21,866,1543,621,15847,245
18874,5,526,1387,394,22482,132
18671,33,714,1391,464,12464,250
21764,48,1788,1337,1107,31742,681
24757,43,860,1282,527,9686,333
17969,2946,80056,1403,50887,239159,29169
4797,149,5520,1558,3519,68009,2001
3805,11,199,1570,135,18537,64
37532,25,516,1014,487,15489,29
34009,11,410,1102,244,12685,166
37421,2,107,1018,92,4190,15
25464,50,899,1268,855,13021,44
16346,22,705,1431,475,31384,230
3248,5,131,1576,100,27250,31
57973,36,418,572,360,16190,58
49196,26,562,829,495,22042,67
950,450,15199,1595,8350,61401,6849
16330,7,174,1432,127,12169,47
2217,13,665,1585,356,23396,309
60053,7,191,503,171,5052,20
31521,389,8305,1146,6075,133851,2230
27824,13,201,1215,181,16166,20
30125,54,2933,1170,1059,20634,1874
54196,1785,25909,684,24368,130555,1541
37458,52,914,1017,744,9476,170
21234,121,2308,1345,1807,35381,501
69132,0,15,220,15,2510,0
2429,481,30917,1583,12553,149670,18364
23295,10,227,1313,147,4243,80
30724,54,1406,1159,1154,28992,252
36281,29,283,1048,232,5936,51
6702,27,977,1534,747,33452,230
46907,605,7983,874,7210,38350,773
39640,175,3407,972,3239,23544,168
14923,143,1900,1453,1396,41432,504
57914,11,183,574,138,8673,45
34110,246,5058,1100,3538,54613,1520
27821,6,108,1216,65,4574,43
32047,63,1553,1138,1002,22661,551
61734,11,59,443,55,3874,4
59193,27,276,532,240,4327,36
26010,35,1951,1255,913,18302,1038
50155,17,243,803,207,9046,36
18959,67,1169,1386,744,27791,425
67820,4,70,264,49,4673,21
3883,26,2260,1569,1253,24152,1007
55321,10,97,646,59,8848,38
62997,2,55,406,26,3638,29
54498,1352,29402,673,17806,146567,11596
39392,634,12856,976,12273,80708,583
9793,110,5744,1509,3078,76920,2666
41086,41,511,950,406,11897,105
3048,134,5828,1578,4116,49899,1712
12730,145,3912,1483,2334,47689,1578
20251,192,4979,1363,3155,44164,1824
33612,29,1284,1110,784,24428,500
33679,92,1402,1109,844,21779,558
54723,62,922,665,850,17012,72
56594,49,515,610,451,4151,64
20372,618,17628,1361,13262,106872,4366
39955,298,3901,968,3511,40245,390
38844,5,164,982,126,7315,38
21328,80,1112,1344,811,6348,301
6588,175,5316,1535,3382,42128,1934
53068,3310,37325,717,27115,446376,10210
27305,31,1311,1227,717,11925,594
22531,3,202,1326,151,8000,51
36453,346,5310,1043,4693,43666,617
940,255,13529,1595,8066,74215,5463
13470,16,587,1473,336,17748,251
54547,43,789,671,761,7022,28
30892,138,3813,1156,2724,44020,1089
28643,71,1300,1200,872,20857,428
27399,429,6862,1225,5177,37761,1685
60306,42,797,493,634,8395,163
67995,3,24,259,19,2103,5
21769,15,251,1337,158,6671,93
61334,29,525,455,505,7154,20
43043,60,880,919,783,17426,97
10426,126,4955,1505,3216,27766,1739
30581,72,2646,1162,1465,9743,1181
63687,50,774,387,659,11122,115
59504,220,2758,521,2563,20741,195
30055,93,1485,1172,946,24860,539
23890,930,22920,1302,12503,151356,10417
20730,7,285,1355,216,8703,69
21824,130,4538,1336,2902,32175,1636
9719,1148,66616,1509,29344,282759,37272
8563,533,13663,1515,8492,77726,5171
54057,20,266,689,224,7363,42
41005,30,570,951,485,8923,85
7522,233,5345,1523,3084,37076,2261
31458,125,1456,1143,1135,28434,321
27122,239,5266,1231,3543,59295,1723
8597,65,1940,1514,1260,22085,680
40206,106,1674,964,1489,30236,185
20911,1942,53014,1351,35546,420781,17468
22350,192,7052,1329,3969,56117,3083
27490,56,1020,1223,680,14270,340
35789,3040,77188,1061,40498,819396,36690
19532,31,631,1375,437,13418,194
11130,3734,61727,1499,33478,283364,28249
63473,9592,172704,393,164363,991616,8341
27002,31,852,1233,434,12874,418
54332,145,1869,680,1262,20109,607
48848,38,547,840,434,8232,113
9099,471,19717,1512,10329,137182,9388
12324,36,3684,1488,1103,27953,2581
59395,41,641,525,431,8081,210
3563,26602,1580250,1573,457492,3700302,1122758
64162,4,58,372,27,5103,31
57662,24,259,582,152,5139,107
9489,22,244,1510,173,7819,71
50132,1973,28942,804,25952,143067,2990
18944,8,408,1386,322,13178,86
37958,452,5652,1003,5113,55682,539
36424,317,3981,1044,3407,39756,574
24035,11,532,1299,400,9776,132
9037,3031,71847,1513,44195,131273,27652
24821,34,894,1281,614,24023,280
31878,4,257,1140,175,7117,82
58482,240,2790,554,2563,50327,227
23585,248,4216,1308,3265,37916,951
57229,33,509,593,367,22724,142
53404,38,478,709,422,10657,56
26613,24,113,1242,86,101745,27
35358,371,6723,1071,5089,48384,1634
61266,1,45,457,27,8323,18
1032,31,1170,1594,892,49760,278
19132,11,560,1382,390,22225,170
3258,120,5986,1576,3198,53372,2788
50544,109,1147,793,998,30675,149
36861,4,121,1034,108,9189,13
36091,4,87,1053,79,10962,8
14040,19,967,1464,346,21769,621
56858,31,417,603,351,6516,66
57130,201,2867,596,2339,26012,528
24157,2115,49712,1296,31129,234925,18583
30574,96,2045,1162,1380,14488,665
47637,41,465,864,327,15056,138
40898,38,846,953,700,9847,146
43693,49,571,910,425,15082,146
50564,117,1800,793,1710,19287,90
19795,15,941,1371,656,20738,285
32615,326,8243,1129,4718,78754,3525
20485,15,386,1359,232,11475,154
53390,50,1895,709,1236,14777,659
24622,14,415,1285,269,8924,146
24775,11,433,1282,293,7449,140
3046,19,916,1578,649,34066,267
5665,513,10404,1547,6358,49595,4046
58424,140,2355,557,1910,14350,445
23339,10,371,1312,283,13159,88
22422,117,3019,1328,1860,14375,1159
28962,48,1011,1193,587,37039,424
10296,6,386,1506,275,11321,111
21281,40,1642,1344,1032,19894,610
20416,38,1573,1360,956,36726,617
20190,65,5131,1364,2752,66704,2379
15336,31,872,1447,608,25275,264
571,20,1790,1598,911,20749,879
67636,24,183,270,173,3134,10
26313,1499,38214,1249,22399,338051,15815
640,69,3798,1597,2332,70008,1466
59006,94,2275,537,2237,27752,38
56971,12,152,600,137,4282,15
53527,67,570,706,543,10852,27
12050,244,8021,1491,4322,144932,3699
32531,388,7371,1130,4326,38224,3045
50036,1,90,806,38,2883,52
20638,121,5264,1356,3624,28807,1640
15165,4,234,1450,183,11433,51
11533,166,3171,1496,1696,30018,1475
53941,6,50,693,39,4131,11
15354,153,10138,1447,5825,53424,4313
39777,50,664,971,531,18256,133
39719,181,4320,972,3741,55824,579
56566,170,1588,611,1355,15835,233
13552,259,8429,1471,5146,82063,3283
9078,265,6089,1512,3848,40588,2241
528,385,15277,1598,9608,123401,5669
27864,22,1047,1215,711,7177,336
33644,104,1931,1108,1106,59704,825
33231,34,2248,1117,958,51602,1290
27427,1575,40107,1224,20531,268935,19576
6931,75,8517,1531,1547,50857,6970
18014,1282,66803,1402,22443,472537,44360
40962,58,922,951,820,24407,102
33109,7,194,1120,132,16565,62
51729,30,237,762,149,5145,88
28736,1813,37930,1198,25649,333630,12281
19659,5,285,1373,166,20087,119
47833,13,224,862,176,3064,48
11013,29,1121,1500,692,15773,429
27956,24,810,1212,485,11673,325
28436,58,1534,1204,978,24483,556
1085,36,1623,1594,1064,39696,559
22951,125,3893,1318,2278,19830,1615
25392,9842,262933,1269,104046,873088,158887
32944,171,3934,1123,3059,47349,875
14903,32,831,1453,655,17752,176
61411,105,2264,453,1009,20496,1255
22759,22,455,1322,345,12107,110
15544,2,92,1444,67,6284,25
5472,62,1609,1549,679,28333,930
37508,12,255,1015,228,7119,27
40013,92,1216,967,1034,21053,182
48796,284,3118,841,2832,18925,286
34871,6,343,1083,219,8370,124
67582,9,168,272,142,4120,26
30649,587,10478,1158,7031,130751,3447
28007,8,442,1211,274,10475,168
38283,174,2474,995,1882,26176,592
59453,14,104,523,88,3825,16
37285,43,723,1021,602,18963,121
39024,88,1161,980,937,10219,224
18105,1051,28862,1400,15752,207764,13110
14590,859,25845,1457,16855,136625,8990
66296,69,486,313,368,4872,118
33956,42,955,1104,741,19348,214
18490,56,1798,1394,1264,13916,534
59854,2890,66614,509,37409,217782,29205
42564,1043,12963,927,10280,108425,2683
61392,28,632,454,379,6368,253
20874,514,6287,1352,3443,35507,2844
66465,86,1476,307,1438,28720,38
22333,1,44,1329,35,5296,9
28731,181,3991,1198,2703,12586,1288
1566,36,1249,1590,952,49823,297
23797,11,351,1304,239,10579,112
36899,47,579,1033,443,13983,136
11718,59,2230,1495,765,11378,1465
34565,52,990,1091,573,13122,417
1153,10,239,1593,201,14961,38
34306,773,35848,1097,12785,137711,23063
5509,75,1513,1549,975,10445,538
52691,111,1402,729,1278,44631,124
65855,146,3625,326,2496,31879,1129
10415,6,364,1505,175,7788,189
58750,12,235,546,202,11692,33
3580,24,1863,1573,899,28033,964
52020,4,93,753,88,7798,5
3171,57,1057,1577,737,9972,320
42642,238,3351,925,2988,60564,363
59227,1940,32512,531,19620,197748,12892
23531,26,1273,1309,764,17152,509
64179,3,96,372,91,3499,5
5634,39,1017,1547,705,25322,312
13494,24,1600,1472,876,12632,724
14639,0,131,1456,59,7355,72
26168,41,1393,1253,1173,11243,220
8943,3194,63801,1513,36616,252543,27185
37656,50,729,1011,600,14841,129
24858,129,2891,1280,1917,30413,974
31051,33,480,1153,317,6067,163
12396,705,34934,1487,14885,115354,20049
20572,71,2480,1358,1690,14916,790
20565,19,878,1358,618,11456,260
61872,19,161,439,158,2260,3
47101,98,1260,871,981,13374,279
13342,442,22931,1475,11622,159687,11309
49049,59,707,834,483,7369,224
15130,0,0,1450,0,46892,0
34093,23926,543884,1100,268896,1573168,274988
23203,5,134,1314,100,5264,34
65086,19,431,344,421,13463,10
14884,27335,620522,1454,361321,1879274,259201
50625,229,5197,792,4036,64294,1161
42662,5479,107991,924,76487,386110,31504
28929,12,308,1194,189,12556,119
56290,20,427,619,298,10575,129
59403,71,1004,525,874,29965,130
32489,85,2352,1131,1436,28904,916
56133,30,272,624,196,9922,76
15356,58,1258,1447,914,27311,344
9056,54,1277,1512,821,14619,456
856,8,683,1595,299,17911,384
49382,5,59,823,50,5410,9
53632,2128,25258,703,18975,187786,6283
34706,4,84,1086,55,5152,29
40332,8,143,962,122,9696,21
16685,41,817,1426,450,14626,367
38376,410,10524,993,6620,106917,3904
37091,282,6401,1027,6188,45250,213
31170,1807,36605,1151,25818,524140,10787
4474,88,2023,1562,1346,29279,677
19689,66,1178,1373,720,12715,458
22540,66,1097,1326,850,12965,247
9789,20,1055,1509,521,13011,534
7595,198,6246,1522,3413,20811,2833
799,6097,299107,1596,125420,925507,173687
26576,374,6090,1243,4349,49809,1741
2338,109,3460,1584,2301,51403,1159
25253,53,1654,1272,1062,56239,592
68961,6,72,226,70,2927,2
33564,74,1063,1111,587,16078,476
14281,168,9354,1461,4029,103607,5325
14051,6,691,1464,299,36091,392
48642,6,90,846,73,3252,17
56265,29,294,620,235,7969,59
6345,150,3368,1539,2314,106754,1054
19130,22,413,1382,348,24455,65
23003,33,559,1318,434,20935,125
15967,5,241,1437,158,6010,83
38471,56,937,990,783,13996,154
23230,209,2574,1314,1325,75027,1249
67616,10,192,271,130,7462,62
18841,9,184,1387,140,15547,44
60347,89,1189,492,689,15609,500
64123,18,160,373,107,4757,53
26691,160,4670,1240,3524,36069,1146
11691,858,20762,1495,14932,130205,5830
52865,8,115,723,110,7792,5
41567,22,369,943,264,6242,105
17155,71,2060,1418,1532,32643,528
54149,1,23,686,21,2395,2
21948,4,59,1334,43,9471,16
18463,356,25064,1394,7772,128979,17292
2596,395,5308,1582,3707,46007,1601
17746,11494,758884,1407,253380,1988494,505504
60160,294,3975,499,2441,32870,1534
32893,507,18585,1124,8882,130643,9703
4749,312,17254,1558,11229,117630,6025
59936,420,8659,506,5678,88038,2981
16446,40,385,1430,316,20526,69
66987,2,73,291,55,4845,18
2259,5,268,1585,205,13364,63
18350,141,3946,1396,3009,44969,937
32670,105,2456,1128,1547,24358,909
58211,906,20155,564,17681,150865,2474
19539,7,284,1375,224,8073,60
2222,83,3044,1585,1069,21191,1975
66176,437,5949,316,5305,65578,644
57234,49,503,593,454,7692,49
42550,11,147,927,128,8419,19
17298,1303,27189,1415,17025,268255,10164
22659,62,1712,1324,1143,29707,569
64029,1385,14552,377,11438,59118,3114
56293,9,196,619,141,5369,55
34241,91,2421,1098,1465,26975,956
30451,112,1127,1164,649,9376,478
6925,28,1448,1531,1095,29802,353
64226,4,53,371,50,1938,3
41304,3057,77961,947,54195,272313,23766
55667,6,108,637,82,3973,26
54045,89,725,690,706,7713,19
12095,0,0,1491,0,3127,0
59902,42,503,507,423,12644,80
54672,2613,27925,666,20396,210649,7529
54179,19,205,685,159,8360,46
33294,50,561,1116,451,10611,110
21918,3207,83918,1334,48321,534991,35597
6162,734,22988,1541,8663,63944,14325
4552,12,357,1561,185,14205,172
36434,8,118,1043,91,3643,27
10161,9,718,1507,425,16992,293
17488,1188,48274,1412,21754,474606,26520
40256,20,467,963,346,24063,121
51152,14,173,778,128,8275,45
2215,634,10737,1585,7852,176672,2885
65799,11,123,328,115,2213,8
21453,151,3542,1341,2592,71237,950
20018,549,13443,1367,8329,115580,5114
32237,2529,54576,1135,35125,286326,19451
35912,60,1830,1058,777,20075,1053
34231,393,4821,1098,3871,38740,950
32472,12,410,1131,220,10303,190
14713,1871,65995,1455,42944,202788,23051
21273,9,481,1344,308,7755,173
54227,136,2070,683,1771,22240,299
8155,2,91,1516,72,8071,19
58265,61,992,562,667,12188,325
52532,19,334,735,275,10258,59
17445,33,1117,1413,664,16012,453
21039,4,147,1349,96,16730,51
36109,142,2457,1053,2325,38710,132
17640,4,104,1409,80,7412,24
2894,46,1706,1579,1176,30613,530
57178,63,1125,588,565,9856,560
2757,115,3235,1581,2271,17198,964
32525,60,1478,1130,875,27334,603
11133,19,496,1499,263,7265,233
51741,4,70,761,52,5508,18
28591,1320,27233,1201,17106,105297,10127
17454,79,1350,1413,852,20006,498
16048,70,2190,1436,1028,10959,1162
57750,23,172,580,162,2744,10
11863,82,2611,1493,1272,40398,1339
11460,70,3541,1497,1400,33571,2141
56876,0,0,602,0,7991,0
8241,35,1977,1516,934,24570,1043
4753,470,18699,1558,12312,142802,6387
9154,6,300,1512,195,15073,105
66187,8,178,316,163,5987,15
11837,86,5364,1493,3169,33535,2195
43155,357,5632,917,4987,48960,645
61602,242,3505,448,3303,31819,202
2661,7,391,1582,286,19589,105
40030,2,84,967,79,7724,5
60068,10,160,502,99,5123,61
53956,281,5789,626,2486,69464,3303
67234,8,219,283,193,7305,26
11003,11,364,1500,219,9836,145
22412,32,702,1328,540,9193,162
21181,840,17682,1346,13164,191693,4518
16158,12,316,1434,206,8235,110
26789,52,2384,1238,1186,21418,1198
52761,54,688,727,551,11397,137
214,47,3004,1601,2037,34670,967
22851,15,396,1320,276,7917,120
27184,33,608,1230,421,14357,187
40096,76,1008,966,826,24615,182
30319,11,214,1167,192,11808,22
37520,30,884,1015,609,37784,275
15527,539,14075,1444,9460,158087,4615
40878,48,1264,954,1089,42425,175
9370,244,4819,1511,2930,79292,1889
22979,29,1105,1318,647,12272,458
51962,36,785,755,674,10345,111
3115,25,926,1577,741,10052,185
30764,1830,50644,1158,33555,207390,17089
16978,22,541,1421,363,21770,178
26754,37,1053,1239,630,11445,423
48581,20,595,848,406,11098,189
12579,8,1065,1485,476,30416,589
7103,285,7594,1529,4954,42037,2640
33392,65,459,1114,421,9224,38
24895,9,513,1279,334,11671,179
630,23,1513,1597,732,44981,781
19240,52,2821,1381,1824,32562,997
18099,1,87,1401,67,5659,20
62567,5,131,417,101,6368,30
58818,961,24146,544,17811,137261,6335
48963,30,549,830,228,12119,321
55772,108,864,634,766,14430,98
15335,534,12071,1447,7233,79208,4838
36736,9,359,1037,284,22718,75
52418,216,2673,740,1747,43124,926
56759,6,66,606,56,4582,10
509,88,2024,1598,1416,16145,608
15152,4226,151669,1450,63035,281791,88634
45054,689,10025,895,7504,100135,2521
6567,20,492,1536,277,20078,215
8637,13,632,1514,427,10988,205
50536,9,83,794,73,3266,10
17967,128,3776,1403,2924,113540,852
32114,138,6778,1137,3310,19726,3468
2676,4414,181713,1581,96137,1140627,85576
28176,664,20955,1209,14376,137982,6579
35872,4,112,1059,64,4129,48
2561,38,1246,1582,892,34266,354
1964,53,979,1587,745,23180,234
67157,3,83,285,75,3449,8
33009,4,163,1121,102,4979,61
10186,376,9007,1506,5163,40477,3844
10038,35,984,1507,602,25183,382
358,4,349,1600,193,10486,156
57821,354,4869,577,3184,27660,1685
9098,62,2165,1512,1441,25822,724
17708,3,99,1408,58,3094,41
9280,251,6925,1512,3505,33581,3420
3912,7,187,1569,147,8440,40
34782,59,2493,1085,1640,39546,853
16385,25,1478,1430,928,14704,550
19757,44,1525,1371,1071,36482,454
30856,106,2412,1156,2063,30794,349
15484,173,6723,1445,4313,50587,2410
36227,16,246,1050,227,12660,19
33931,42,1374,1104,974,34087,400
4756,58,2509,1558,1786,46703,723
36220,5,153,1050,135,14350,18
35844,7,138,1060,88,4813,50
67066,14,242,289,167,3113,75
20807,422,10496,1353,6899,78904,3597
35339,11287,218181,1071,134451,1009371,83730
60265,22,194,495,192,5013,2
2153,108,3168,1586,1932,43927,1236
53435,817,11425,708,8754,122893,2671
45374,500,10250,892,7685,107500,2565
17335,16,427,1415,328,12506,99
61822,20,187,440,161,2525,26
38040,170,3838,1001,2091,71877,1747
12300,35,1632,1489,1071,114603,561
21028,9,399,1349,183,24223,216
40269,354,6228,963,4950,53103,1278
26553,140,4813,1243,2121,40452,2692
6054,6,278,1542,195,18020,83
48015,20,951,860,631,20114,320
455,17,1226,1599,880,22239,346
5436,26,789,1550,348,11315,441
49016,41,313,834,236,7057,77
11375,934,36028,1498,25175,210575,10853
5656,13,344,1547,205,16551,139
33951,377,5695,1104,4970,26571,725
48591,317,5143,847,4419,59213,724
27058,106,2115,1232,1435,19149,680
7070,25,2396,1529,1544,20377,852
64177,17,348,372,321,8625,27
5403,8,199,1550,128,10448,71
6812,157,3653,1533,2360,20796,1293
51489,146,2072,769,1709,23759,363
61963,75,846,435,591,12304,255
67561,493,9460,272,8373,85290,1087
30678,27,707,1160,522,12219,185
55703,279,5087,636,4047,50261,1040
20163,23,1152,1364,856,13951,296
14438,73,1943,1458,1216,30406,727
52858,223,2269,724,1807,8666,462
44749,10,98,899,80,3579,18
33039,531,12091,1121,7147,66692,4944
32611,17,489,1129,377,11779,112
14769,8,270,1455,172,5622,98
11036,404,9198,1500,5687,84513,3511
47243,7,307,868,231,6690,76
20042,71,2058,1366,1341,50089,717
4967,8,296,1555,198,28673,98
23764,12,877,1304,249,11031,628
29707,1982,67156,1180,34653,339540,32503
49212,36,1707,828,651,13804,1056
9427,50,1884,1511,1137,26974,747
64152,203,5009,373,3835,79415,1174
23554,18,363,1308,252,6808,111
40341,34,712,962,593,33570,119
476,7,364,1599,238,16296,126
15568,163,3119,1444,2024,58621,1095
59118,250,4664,534,3571,51455,1093
27073,416,12054,1232,7921,120851,4133
15559,13,644,1444,483,58743,161
51021,5,97,781,78,4160,19
11812,197,4867,1494,2578,44490,2289
5162,5108,247872,1553,106861,980714,141011
7464,72,3227,1524,2424,65164,803
46405,55,1130,881,923,24957,207
8010,433,12621,1517,9685,100999,2936
4331,179,8117,1564,6090,73227,2027
29232,247,5372,1188,3395,29989,1977
18072,203,7872,1401,6096,82765,1776
47376,6478,191589,868,85972,815687,105617
11286,18,593,1498,331,17799,262
54043,111,702,690,600,9821,102
7688,9,471,1521,321,15662,150
30402,1,75,1165,36,5390,39
58962,28,448,540,350,11603,98
58738,45,480,546,433,7900,47
64713,160,2398,338,1692,25959,706
19417,118,5303,1377,3148,37826,2155
57102,10,164,596,70,3920,94
50786,9,73,788,66,3834,7
2121,2075,55976,1586,31788,171624,24188
60270,95,1320,495,1111,11719,209
9620,40,1745,1510,978,22116,767
51763,162,2991,761,1794,51398,1197